COMPLACENCY  	K AH M P L EY S AH N S IY
PHLEGMATIC 	F L EH G M AE T IH K
PROMULGATED 	P R AA M AH L G EY T AH D
PITTANCE 	P IH T AH N S
MISNOMER 	M IH S N OW M ER
CLANNDESTINE  	K L AE N D AH S T AY N
ARMOURY  	AA R M ER IY
QUACKS 	K W AE K S
GENUFACT 	JH EH N Y UW F AH K T
BLATANT 	B L EY T AH N T
COMMISERATE 	K AH M IH S ER EY T
ABANDON	AH B AE N D AH N
ABANDONED	AH B AE N D AH N D
ABILITY	AH B IH L AH T IY
ABLE	EY B AH L
ABOUT	AH B AW T
ABOVE	AH B AH V
ABROAD	AH B R AO D
ABSENCE	AE B S AH N S
ABSENT	AE B S AH N T
ABSOLUTE	AE B S AH L UW T
ABSOLUTELY	AE B S AH L UW T L IY
ABSORB	AH B Z AO R B
ABUSE	AH B Y UW S
ABUSE(2)	AH B Y UW Z
ABUSE	AH B Y UW S
ABUSE(2)	AH B Y UW Z
ACADEMIC	AE K AH D EH M IH K
ACCENT	AH K S EH N T
ACCENT(2)	AE K S EH N T
ACCEPT	AE K S EH P T
ACCEPT(2)	AH K S EH P T
ACCEPTABLE	AE K S EH P T AH B AH L
ACCEPTABLE(2)	AH K S EH P T AH B AH L
ACCESS	AE K S EH S
ACCIDENT	AE K S AH D AH N T
ACCIDENTAL	AE K S AH D EH N T AH L
ACCIDENTAL(2)	AE K S AH D EH N AH L
ACCIDENTALLY	AE K S AH D EH N T AH L IY
ACCIDENTALLY(2)	AE K S AH D EH N AH L IY
SEVER	S EH V ER
DETAIN	D IH T EY N
INCARCERATED	IH N K AA R S ER EY T IH D
STRINGENT	S T R IH N JH AH N T
SHACKLE	SH AE K AH L
BLOATED	B L OW T IH D
BUMPTIOUS	B AH M P SH AH S
CONCEIT	K AH N S IY T
INSOLENT	IH N S AH L AH N T
DOMINEERING	D AA M AH N IH R IH NG
PRETENTIOUS	P R IY T EH N SH AH S
PONTIFICATE	P AA N T IH F AH K EY T
PRESUMPTUOUS	P R IH Z AH M P CH AH W AH S
APPALL	AH P AO L
CRAVEN	K R EY V AH N
DASTARD	D AE S T AH R D
POLTROON	P OW L T R UW N
DAUNT	D AO N T
DIFFIDENT	D IH F AH D AH N T
INTIMIDATE	IH N T IH M IH D EY T
TIMOROUS	T IH M ER AH S
PERTURB	P ER T ER B
WEAKSISTER	W IY K S IH S T ER
APPREHENSIVE	AE P R IH HH EH N S IH V
APPREHENSIVE(2)	AE P R IY HH EH N S IH V
PENSIVE	P EH N S IH V
SCORNFUL	S K AO R N F AH L
INDOLENCE	IH N D AH L AH N S
HEBETUDE	HH EH B AH T Y UW D
SUPINE	S AH P AY N
SUPINE(2)	S UW P AY N
AGGRANDIZE	AH G R AE N D AY Z
DISTEND	D IH S T EH N D
EFFUSIVE	EH F Y UW S IH V
GASCONADE	G AE S K OW N EY D
HYPERBOLE	HH AY P ER B AH L IY
MAGNILOQUENT	M AE G N AH L AA K W AH N T
MOUNTEBANK	M AW N T AH B AH NG K
PANEGYRIC	P EY N JH AY R IH K
TURGID	T ER JH IH D
GUSTO	G AH S T OW
INCLINATION	IH N K L AH N EY SH AH N
EXPURGATE	EH K S P ER JH AH T
PRISTINE	P R IH S T IY N
IMPECCABLE	IH M P EH K AH B AH L
LAVE	L EY V
CODA	K OW D AH
PRODIGAL	P R AA D IH G AH L
PROFUSE	P R AH F Y UW S
SQUANDER	S K W AA N D ER
FRITTER	F R IH T ER
LOITER	L OY T ER
ABATE	AH B EY T
ABSCOND	AE B S K AA N D
ABSTAIN	AH B S T EY N
ABSTAIN(2)	AE B S T EY N
ABYSS	AH B IH S
AESTHATIC	EH S TH AH T AH K
ALLEVIATE	AH L IY V IY EY T
MOLLIFY	M AA L AH F AY
PACIFY	P AE S AH F AY
AMELIORATE	AH M IY L Y ER EY T
ANACHRONISM	AH N AE K R AH N IH Z AH M
ANTAGONIZE	AE N T AE G AH N AY Z
ANTIPATHY	AE N T IH P AH TH IY
APATHY	AE P AH TH IY
ARBITRATE	AA R B AH T R EY T
ARCHAIC	AA R K EY IH K
ARDOR	AA R D ER
ASSUAGE	AH S W EY JH
BANAL	B AH N AA L
BOLSTER	B OW L S T ER
CACOPHONY	K AE K AA F AH N IY
CANDID	K AE N D AH D
CANDID(2)	K AE N D IH D
CAPRICIOUS	K AH P R IH SH AH S
CASTIGATE	K AE S T AH G EY T
CAUSTIC	K AA S T IH K
CAUSTIC(2)	K AO S T IH K
CHAUVINIST	SH OW V AH N AH S T
CHICANERY	SH IH K EY N ER IY
COGENT	K OW JH AH N T
CONDONE	K AH N D OW N
CONVULATED	K AA N V Y AH L EY T AH D
BEWILDER	B IH W IH L D ER
CORROBORATE	K ER AA B ER EY T
CREDULOUS	K R EH JH AH L AH S
CRESCENDO	K R IH SH EH N D OW
DECORUM	D IH K AO R AH M
PANACHE	P AH N AA SH
DEFERENCE	D EH F ER AH N S
DEFERENCE(2)	D EH F R AH N S
DERIDE	D IH R AY D
DESICCATE	D EH S AH K EY T
DESULTORY	D EH S AH L T AO R IY
DIATRIBE	D AY AH T R AY B
DILATE	D AY L EY T
DILATORY	D IH L AH T AO R IY
DILETTANTE	D IH L AH T AA N T
DISABUSE	D IH S AH B Y UW S
DISABUSE(2)	D IH S AH B Y UW Z
DISCERN	D IH S ER N
DISSEMBLE	D IH S EH M B AH L
DISSONANCE	D IH S AH N AH N S
DOGMA	D AA G M AH
DOGMATIC	D AA G M AE T IH K
DOGMATIC(2)	D AO G M AE T IH K
DUPE	D UW P
ECLECTIC	IH K L EH K T IH K
EFFICACY	EH F IH K AE S IY
ELAGY	IY L AH JH IY
ELOQUENT	EH L AH K W AH N T
EMULATE	EH M Y AH L EY T
ENERVATE	EH N ER V EY T
ENGENDER	EH N JH EH N D ER
ENGENDER(2)	IH N JH EH N D ER
ENIGMA	IH N IH G M AH
EQUIVOCATE	IH K W IH V AH K EY T
ERRATIC	IH R AE T IH K
ERUDITE	EH R AH D AY T
ESOTERIC	EH S AH T EH R IH K
ESOTERIC(2)	EH S OW T EH R IH K
ESTIMATE	EH S T AH M AH T
ESTIMATE(2)	EH S T AH M EY T
EULOGY	Y UW L AH JH IY
EUPHEMISM	Y UW F AH M IH Z AH M
ENUMERATE	IH N UW M ER EY T
UPBEAT	AH P B IY T
TWIRLY	T W ER L IY
STOMP	S T AA M P
ANECDOTE	AE N IH K D OW T
INNATE	IH N EY T
ENDEARING	EH N D IY R IH NG
CONSUMMATE	K AA N S AH M AH T
CONSUMMATE(2)	K AA N S AH M EY T
USHER	AH SH ER
MANGLED	M AE NG G AH L D
TRAMPLE	T R AE M P AH L
IMPISH	IH M P IH SH
SLATHERING	S L AE DH ER IH NG
SACRAMENTAL	S AE K R AH M AH N T AH L
SCOOCH	S K UW CH
VIRILITY	V ER IH L AH T IY
ONSLAUGHT	AO N S L AO T
DELUGE	D EH L Y UW JH
UNTENABLE	AH N T EH N AH B AH L
DETERRENT	D IH T ER R AH N T
CESSATION	S EH S EY SH AH N
OBNOXIOUS	AA B N AA K SH AH S
EQUIVOCAL	IH K W IH V AH K AH L
UNDERMINE	AH N D ER M AY N
MERCURIAL	M ER K Y UH R IY AH L
VINDICATE	V IH N D AH K EY T
CHASTISE	CH AE S T AY Z
AMENABLE	AH M EH N AH B AH L
AMENABLE(2)	AH M IY N AH B AH L
QUALIFY	K W AA L AH F AY
DISINTERESTED	D IH S IH N T R IH S T IH D
DISINTERESTED(2)	D IH S IH N R IH S T IH D
UPBRAID	AH P B R EY D
WANTING	W AA N T IH NG
WANTING(2)	W AA N IH NG
PREVARICATE	P R AH V EH R AH K EY T
PROFLIGATE	P R AO F L IH G EY T
COMMENSURATE	K AH M EH N S ER AH T
COMMENSURATE(2)	K AH M EH N S ER IH T
AMBIVALENT	AE M B IH V AH L AH N T
ACRIMONY	AE K R IH M OW N IY
MAINTAIN	M EY N T EY N
VERACIOUS	V AH R EY SH AH S
RESTIVE	R EH S T IH V
ANOMALOUS	AH N AA M AH L AH S
ABERRATION	AE B ER EY SH AH N
GREGARIOUS	G R AH G EH R IY AH S
INVOLVED	IH N V AA L V D
INNOCUOUS	IH N AA K Y UW AH S
GALVANIZE	G AE L V AH N AY Z
AMORPHOUS	AH M AO R F AH S
BELIE	B IH L AY
CALUMNY	K AE L AH M N IY
ICONOCLAST	AY K AA N AH K L AE S T
IMPERTINENT	IH M P ER T AH N AH N T
FRUGAL	F R UW G AH L
PARSIMONIOUS	P AA R S AH M OW N IY AH S
BETRAY	B IH T R EY
INTIMATE	IH N T AH M AH T
INTIMATE(2)	IH N T IH M EY T
INTIMATE(3)	IH N IH M AH T
CENSURE	S EH N SH ER
ARTFUL	AA R T F AH L
EXTANT	EH K S T AH N T
AUSPICIOUS	AA S P IH SH AH S
EGREGIOUS	IH G R IY JH AH S
VENALITY	V IH N AE L IH T IY
LACONIC	L AA K AA N IH K
VENERATED	V EH N ER EY T IH D
PAROCHIAL	P ER OW K IY AH L
DEMUR	D IH M ER
INGENUOUS	IH N JH EH N Y UW AH S
INGENIOUS	IH N JH IY N Y AH S
HARANGUE	HH ER AE NG
PRECLUDE	P R IH K L UW D
PRECLUDE(2)	P R IY K L UW D
PLATITUDE	P L AE T IH T UW D
MAWKISH	M AO K IH SH
RUSTIC	R AH S T IH K
DECOROUS	D EH K ER AH S
CULMINATE	K AH L M IH N EY T
ACME	AE K M IY
PINNACLE	P IH N AH K AH L
GOSSAMER	G AA S AH M ER
GALL	G AO L
GERMANE	JH ER M EY N
QUERULOUS	K W EH R AH L AH S
INCISIVE	IH N S AY S IH V
OBSCURE	AH B S K Y UH R
RECONDITE	R EH K AH N D AY T
PITHY	P IH TH IY
EXACERBATE	IH G Z AE S ER B EY T
TORPOR	T AO R P ER
CULPABILITY	K AH L P AH B IH L IH T IY
DIDACTIC	D AY D AE K T IH K
CHORTLE	CH AO R T AH L
FORTUITOUS	F AO R T UW IH T AH S
PRESCIENCE	P R IY SH IY AH N S
ESHEW	EH SH UW
VOLUBILITY	V AA L AH B IH L AH T IY
BUCOLIC	B Y UW K AA L IH K
CRYPTIC	K R IH P T IH K
VOCIFEROUS	V OW S IH F ER AH S
PERFIDY	P ER F IH D IY
RETICENT	R EH T IH S AH N T
AUDACIOUS	AA D EY SH AH S
LAMBAST	L AE M B AE S T
MITIGATE	M IH T AH G EY T
FRIVOLOUS	F R IH V AH L AH S
INEXORABLE	IH N EH K S ER AH B AH L
MULTITUDINOUS	M AH L T AH T UW D AH N AH S
VIRTUOSO	V ER CH UW OW S OW
ABRIDGE	AH B R IH JH
INSATIABLE	IH N S EY SH AH B AH L
SENILITY	S AH N IH L AH T IY
FACETIOUS	F AH S IY SH AH S
GLUT	G L AH T
VILIFY	V IH L IH F AY
HERETIC	HH EH R AH T IH K
ENTICE	IH N T AY S
DETRIMENTAL	D EH T R AH M EH N T AH L
DETRIMENTAL(2)	D EH T R AH M EH N AH L
VENEER	V AH N IH R
DISSIDENT	D IH S AH D IH N T
GAINSAY	G EY N S EY
SUBVERSIVE	S AH B V ER S IH V
INSURGENT	IH N S ER JH AH N T
ANARCHIST	AE N ER K IH S T
ABYSMAL	AH B IH Z M AH L
ASCETIC	AH S EH T IH K
TENACIOUS	T AH N EY SH AH S
FALLACIOUS	F AH L EY SH AH S
INCONGRUOUS	IH NG K AO NG R UW AH S
DISAFFECTED	D IH S AH F EH K T IH D
CONTRIVE	K AH N T R AY V
STAUNCH	S T AO N CH
SUPPLANT	S AH P L AE N T
JUXTAPOSE	JH AH K S T AH P OW Z
MAGNANIMOUS	M AE G N AE N AH M AH S
ITINERANT	AY T IH N ER AH N T
GUILELESS	G AY L L AH S
REFRACTORY	R AH F R AE K T ER IY
OBSTINATE	AA B S T AH N AH T
OBDURATE	AA B D ER AH T
TREACHEROUS	T R EH CH ER AH S
PRECOCIOUS	P R IH K OW SH AH S
PRECOCIOUS(2)	P R IY K OW SH AH S
VIVACIOUS	V AH V EY SH AH S
VIVID	V IH V AH D
VIVID(2)	V IH V IH D
CONNOISSEUR	K AA N AH S ER
VORACIOUS	V AO R EY SH AH S
AVID	AE V IH D
BLANTANT	B L AE N T AH N T
CONSPICUOUS	K AH N S P IH K Y UW AH S
PETULANT	P EH CH AH L AH N T
WANTON	W AO N T AH N
WANTON(2)	W AA N T AH N
LECHOROUS	L EH CH AH R AH S
EXTORTIONATE	EH K S T AO R SH AH N AH T
EXTORTIONATE(2)	EH K S T AO R SH AH N EY T
SCREED	S K R IY D
VINDICTIVE	V IH N D IH K T IH V
INUNDATE	IH N AH N D EY T
DOGGED	D AO G D
HOUNDED	HH AW N D IH D
PERSECUTE	P ER S AH K Y UW T
SERENDIPITY	S EH R AH N D IH P IH T IY
SUMMIT	S AH M AH T
SUMMIT(2)	S AH M IH T
THOROUGHGOING	TH ER OW G OW IH NG
INDICT	IH N D AY T
AMIABLE	EY M IY AH B AH L
AFFABLE	AE F AH B AH L
AMICABLE	AE M IH K AH B AH L
CONVIVIAL	K AH N V IH V IY AH L
CONGENIAL	K AH N JH IY N Y AH L
GENIAL	JH IY N Y AH L
DEMURE	D IH M Y UH R
AFFLUENT	AE F L UW AH N T
OPULENT	AA P Y AH L AH N T
PENURY	P EH N Y UH R IY
DESTITUTE	D EH S T AH T UW T
INSOLVENT	IH N S AA L V AH N T
INDIGENCE	IH N D IH JH AH N S
THRIFTY	TH R IH F T IY
RETIRING	R IH T AY R IH NG
RETIRING(2)	R IY T AY ER IH NG
RETIRING(3)	R IY T AY R IH NG
REPROBATE	R EH P R AO B EY T
MISCREANT	M IH S K R IY AH N T
DELINQUENT	D IH L IH NG K W AH N T
BEATIFIC	B IY AH T IH F IH K
FERRET	F EH R AH T
RANSACK	R AE N S AE K
WAX	W AE K S
FLUSH	F L AH SH
SANCTIMONIOUS	S AE NG K T AH M OW N IY AH S
UNCONSCIONABLE	AH N K AA N SH AH N AH B AH L
RAPACIOUS	R AH P AE SH IH S
RAPACIOUS(2)	R AH P EY SH IH S
COMPOUND	K AA M P AW N D
COMPOUND(2)	K AH M P AW N D
BALK	B AO K
BALK(2)	B AA L K
STAID	S T EY D
CHAMPION	CH AE M P IY AH N
SORDID	S AO R D AH D
VILE	V AY L
TAWDRY	T AO D R IY
DEFRAY	D IH F R EY
BYZANTINE	B IH Z AH N T AY N
BYZANTINE(2)	B IH Z AH N T IY N
APOGEE	AE P AH JH IY
PERFUNCTORY	P ER F AH NG K T ER IY
INTERMITTENT	IH N T ER M IH T AH N T
PONDEROUS	P AA N D ER AH S
LABORIOUS	L AH B AO R IY AH S
ARDEOUS	AA R D IY AH S
STRENUOUS	S T R EH N Y UW AH S
TAXING	T AE K S IH NG
EXACTING	IH G Z AE K T IH NG
TRITE	T R AY T
CHOLERIC	K AA L ER IH K
IRASCIBLE	IH R AE S IH B AH L
PEEVISH	P IY V IH SH
FRACCTIOUS	F R AE K AH S
FRACTIOUS	F R AE K SH AH S
BILIOUS	B IH L IY AH S
DYSPEPTIC	D IH S P EH P T IH K
SEDULOUS	S EH JH AH L AH S
PEDANTIC	P AH D AE N T IH K
CONSCIENTIOUS	K AA N SH IY EH N SH AH S
PUNCTILIOUS	P AH NG K T IH L IY AH S
FASTIDIOUS	F AE S T IH D IY AH S
ASSIDUOUS	AH S IH D W AH S
PRECARIOUS	P R IY K EH R IY AH S
NADIR	N EY D ER
CHARY	CH AA R IY
DUBIOUS	D UW B IY AH S
QUALM	K W AA M
SNUB	S N AH B
SPURN	S P ER N
REPUDIATE	R IY P Y UW D IY EY T
REFUTE	R IH F Y UW T
DEBUNK	D IH B AH NG K
RESCIND	R IH S IH N D
RESCIND(2)	R IY S IH N D
ABROGATE	AE B R AH G EY T
DISAFFIRM	D IH S AH F ER M
PUSILLANIMOUS	P Y UW S AH L AE N AH M AH S
ANIMOSITY	AE N AH M AA S AH T IY
ENMITY	EH N M AH T IY
ENMITY(2)	EH N M IH T IY
DISSENSION	D IH S EH N SH AH N
AVERSION	AH V ER ZH AH N
RANCOUR	R AE NG K AH R
RESENTMENT	R IH Z EH N T M AH N T
RESENTMENT(2)	R IH Z EH N M AH N T
INDIGNATION	IH N D IH G N EY SH AH N
EXASPERATION	EH K S AE S P ER EY SH AH N
ABHORRENCE	AH B HH AO R AH N S
QUIXOTIC	K W IH K S AA T IH K
UTOPIAN	Y UW T OW P IY AH N
IDYLLIC	AY D IH L IH K
PROTEAN	P R OW T IY AH N
BLINKERED	B L IH NG K ER D
PREJUDICED	P R EH JH AH D AH S T
PREJUDICE	P R EH JH AH D IH S
QUISLING	K W IH Z L IH NG
POLLYANNA	P AA L IY AE N AH
METTLESOME	M EH T AH L S AH M
INTRIPID	IH N T R AY P AH D
UNFLINCHING	AH N F L IH N CH IH NG
EQUANIMITY	IY K W AH N IH M IH T IY
APOTHEOSIS	AH P AA TH IY OW S AH S
EXALT	IH G Z AO L T
EXTOL	IH K S T OW L
DENIGRATE	D EH N AH G R EY T
DENOUNCE	D IH N AW N S
REVILE	R IY V AY L
EXECRATE	IH G Z EH K R EY T
ABOMINATE	AH B AA M AH N EY T
JAUNDICED	JH AO N D IH S T
FACTITIOUS	F AE K T IH SH AH S
VACUOUS	V AE K Y UW AH S
VICARIOUS	V AY K EH R IY AH S
PEREMPTORY	P ER EH M P T ER IY
BRUSQUE	B R AH S K
ELUCIDATE	IH L UW S AH D EY T
ABSTRUSE	AH B S T R UW S
UNFATHOMABLE	AH N F AE DH AH M AH B AH L
ARCANE	AA R K EY N
CLANDENSTINE	K L AE N D EH N Z T AY N
SURREPTITIOUS	S ER AH P T IH SH AH S
ARRIVISTE	AE R AH V AY S T
PARVENU	P AA R V AH N UW
HISTRIONIC	HH IH S T R IY AA N IH K
PROPITIATE	P R OW P IH SH IY AH T
PLACATE	P L EY K EY T
APPEASE	AH P IY Z
SARTORIAL	S AA R T AO R IY AH L
ARCH	AA R CH
FLIPPANT	F L IH P AH N T
FRIVLOUS	F R IH V L AH S
JEJUNE	JH AH JH UW N
SURLY	S ER L IY
SULLEN	S AH L AH N
CONTENTIOUS	K AH N T EH N SH AH S
INVECTIVE	IH N V EH K T IH V
EXCORIATE	EH K S K AO R IY EY T
HEDGE	HH EH JH
IMPETUOUS	IH M P EH CH W AH S
PRECIPITOUS	P R IH S IH P IH T AH S
PRECIPITATE	P R IH S IH P IH T EY T
IMPRUDENT	IH M P R UW D AH N T
IMPROVIDENT	IH M P R AH V AY D AH N T
IMMURE	IH M Y AH R
BROADSIDE	B R AO D S AY D
DENUNCIATION	D IH N AH N S IY EY SH AH N
POLEMIC	P AH L EH M IH K
BROOK	B R UH K
CHIMERA	CH IH M EH R AH
UNPREPOSSESSING	AH N P R IY P AH Z EH S IH NG
BALEFUL	B EY L F AH L
PERNICIOUS	P ER N IH SH AH S
INIMICAL	IH N IH M IH K AH L
SPURIOUS	S P Y UH R IY AH S
SPURIOUS(2)	S P ER IY AH S
COUNTERFEIT	K AW N T ER F IH T
COUNTERFEIT(2)	K AW N ER F IH T
FACSIMILE	F AE K S IH M AH L IY
FAUX	F OW
DUPLICITY	D UW P L IH S IH T IY
ARTIFICE	AA R T AH F IH S
SUBTERFUGE	S AH B T ER F Y UW JH
CHAGRIN	SH AH G R IH N
SPLEEN	S P L IY N
EMPIRICISM	EH M P IH R AH S IH Z AH M
EXPOUND	IH K S P AW N D
PROPOUND	P R AH P AW N D
EXPLICATE	EH K S P L AH K EY T
DELINEATE	D IH L IH N IY EY T
VITRIOLIC	V IH T R IY AA L IH K
BESOTTED	B AH S AA T AH D
OBJURGATE	AA B AH R G EY T
INTERNECINE	IH N T ER N AH S IY N
COTERMINOUS	K OW T ER M AH N AH S
APLOMB	AH P L AA M
NONCHALANT	N AA N SH AH L AA N T
HAUTEUR	HH AO T AH R
SUPERCILIOUS	S UW P ER S IH L IY AH S
CONDESCENSION	K AA N D AH S EH N SH AH N
SMUG	S M AH G
COMPLACENT	K AH M P L EY S AH N T
LAX	L AE K S
SLAPDASH	S L AE P D AE SH
REMISS	R IY M IH S
SLACKEN	S L AE K AH N
MELANCHOLY	M EH L AH N K AA L IY
POIGNANT	P OY N Y AH N T
LUGUBRIOUS	L UW G Y UW B R IY AH S
DOLEFUL	D OW L F AH L
DESOLATION	D EH S AH L EY SH AH N
DESPONDENT	D IH S P AA N D AH N T
FORLORN	F ER L AO R N
DESSICATE	D EH S AH S EY T
IMPUGN	IH M P Y UW N
GUMPTION	G AH M P SH AH N
ACUMEN	AH K Y UW M AH N
PERSPICACIOUS	P ER S P AH K EY SH AH S
PERSPICUOUS	P AH R S IH S Y AH W AH S
BRIDLE	B R AY D AH L
PALATABLE	P AE L AH T AH B AH L
DOUGHTY	D AO T IY
UNDISMAYED	AH N D IH S M EY D
VALIANT	V AE L Y AH N T
FACILE	F AE S AH L
DISCURSIVE	D IH S K ER S IH V
CIRCUMLOCUTORY	S AH R K AH M L AA K Y AH T AO R IY
BROMIDE	B R OW M AY D
PRUDENT	P R UW D AH N T
COMPLAISANT	K AH M P L EY S AH N T
ACQUIESCENT	AE K W IY EH S AH N T
ETHEREAL	IH TH IH R IY AH L
COMPLICIT	K AH M P L IH S AH T
LACHRYMOSE	L AE K R AH M OW Z
INELUCTABLE	IH N IH L AH K T AH B AH L
CANARD	K AH N AA R D
GRAFT	G R AE F T
COUNTERMAND	K OW AH N T AH R M AH N D
QUASH	K W AO SH
VERISIMILITUDE	V EH R AH S AH M IH L AH T UW D
SPLENETIC	S P L IH N EH T IH K
HOODWINK	HH UH D W IH NG K
DELUDE	D IH L UW D
CONCOMITANT	K AA N K AA M AH T AH N T
CONCOMITANT(2)	K AA N K AH M IH T AH N T
PALAVER	P AH L EY V AH R
INCESSANT	IH N S EH S AH N T
UNFLAGGING	AH N F L AE G IH NG
DEMONSTRATIVE	D IH M AA N S T R AH T IH V
EXPANSIVE	IH K S P AE N S IH V
FLAG	F L AE G
ESTIMABLE	EH S T AH M AH B AH L
DESPOT	D EH S P AH T
INFELICITOUS	IH N F IH L IH S AH T AH S
DISSOLUTION	D IH S AH L UW SH AH N
CATACLYSM	K AE T AH K L IH S AH M
HOLOCAUST	HH AO L AH K AO S T
TRIBULATION	T R IH B Y AH L EY SH AH N
ORDEAL	AO R D IY L
ADJUDICATE	AH JH UW D IH K EY T
SURFEIT	S ER F AH T
PROPAGATE	P R AA P AH G EY T
PAUCITY	P AO S AH T IY
DEARTH	D ER TH
ABSOLUTION	AE B S AH L UW SH AH N
CLEMENCY	K L EH M AH N S IY
INSIDIOUS	IH N S IH D IY AH S
BELLIGERENT	B AH L IH JH ER AH N T
PUGNACIOUS	P AH G N AE SH IH S
BELLICOSE	B EH L AH K OW S
TRUCULENT	T R AH K Y AH L AH N T
CONFRONTATIONAL	K AA N F R AH N T EY SH AH N AH L
LANGUID	L AE NG G W AH D
TANTAMOUNT	T AE N T AH M AW N T
FRUSTRATE	F R AH S T R EY T
STYMIE	S T AY M IY
THWART	TH W AO R T
CIRCUMVENT	S ER K AH M V EH N T
IMPEDE	IH M P IY D
DERIVATIVE	D ER IH V AH T IH V
DERIVATIVE(2)	D ER IH V IH T IH V
JUBILANT	JH UW B AH L AH N T
EXULTANT	IH G Z AH L T AH N T
FRENZIED	F R EH N Z IY D
HYSTERICAL	HH IH S T EH R IH K AH L
EXUBERANT	IH G Z UW B ER AH N T
EUPHORIC	Y UW F AO R IH K
QUOTIDIAN	K W AH T IH D IY AH N
TRAVESTY	T R AE V AH S T IY
CHARADE	SH ER EY D
OPAQUE	OW P EY K
APOCRYPHAL	AH P AA K R AH F AH L
PHLEGMATIC	F L EH G M AE T IH K
ESPOUSE	IH S P AW Z
ESPOUSE(2)	IH S P AW S
FORTHCOMING.	F OW R TH K AH M IH NG
IMPLACABLE	IH M P L AE K AH B AH L
RECONCILE	R EH K AH N S AY L
ADMONISH	AE D M AA N IH SH
INTRANSIGENT	IH N T R AE N S AH JH AH N T
INTRANSIGENT(2)	IH N T R AE N Z AH JH AH N T
BURGEON	B ER JH AH N
CONSTRUE	K AH N S T R UW
PROVINCIAL	P R AH V IH N SH AH L
ACERBIC	AH S EH R B IH K
INGRATIATE	IH NG G R EY SH IY EY T
ADULATION	AE JH AH L EY SH AH N
OBSEQUIOUS	AH B S IY K W IY AH S
PEDESTRIAN	P AH D EH S T R IY AH N
TRACTABLE	T R AE K T AH B AH L
TACITURN	T AE S IH T ER N
BRAZEN	B R EY Z AH N
ANTITHETICAL	AE N T AH TH EH T IH K AH L
INSCRUTABLE	IH N S K R UW T AH B AH L
FURTIVE	F ER T IH V
PROFOUND	P R OW F AW N D
PROPITIOUS	P R AH P IH SH AH S
OSTRACIZE	AO S T R AH S AY Z
CONTRITION	K AH N T R IH SH AH N
REBUKE	R IY B Y UW K
REBUKE(2)	R IH B Y UW K
PRETENCE	P R IY T EH N S
POSIT	P AA Z AH T
REPROACH	R IY P R OW CH
PROMISCUOUS	P R OW M IH S K W AH S
PROMISCUOUS(2)	P R AA M IH S K Y UW AH S
DEBAUCHED	D AH B AO CH T
RAFFISH	R AE F IH SH
RAKISH	R EY K IH SH
DIABOLICAL	D AY AH B AA L IH K AH L
INSIPID	IH N S IH P AH D
DESPODENT	D IH S OW D AH N T
DESOLATE	D EH S AH L AH T
DESOLATE(2)	D EH Z AH L AH T
DESOLATE(3)	D EH S AH L EY T
MOROSE	M ER OW S
BECOMING	B IH K AH M IH NG
MELEE	M EY L EY
AMOK.	AE M AH K
ERRATIC.	IH R AE T IH K
EXTENUATING	IH K S T EH N Y UW EY T IH NG
SANGUINE	S AE NG G W IH N
ABOVEBOARD	AH B AH V B AO R D
UNCONCEALED	AH N K AH N S IY L D
RENEGE	R IH N IH G
FLEDGLING	F L EH JH L IH NG
SNIDE	S N AY D
SPITEFUL	S P AY T F AH L
VITUPERATIVE	V AY T UW P ER AH T IH V
VITUPERATIVE(2)	V AH T UW P ER AH T IH V
ELUSIVE	IH L UW S IH V
ASCENDANCY	AH S EH N D AH N S IY
FLOUNDER	F L AW N D ER
INCLEMENT	IH N K L EH M AH N T
INCLEMENT(2)	IH N K L IH M AH N T
MUTED	M Y UW T IH D
RESPITE	R EH S P IH T
GUFFAW	G AH F AO
FETE	F EY T
PROPONENT	P R AH P OW N AH N T
RECREANT	R IH K R IY AH N T
PROVOCATIVE	P R OW V AA K AH T IH V
PASSIVELY	P AE S IH V L IY
COGITATION	K AA JH IH T EY SH AH N
FOIBLE	F OY B AH L
APHORISM	AE F ER IH Z AH M
ASSAIL	AH S EY L
INORDINATE	IH N AO R D AH N IH T
RILE	R AY L
VEX	V EH K S
EERIE	IH R IY
REDRESS	R IY D R EH S
FORTHRIGHT	F AO R TH R AY T
FORESTALL	F AO R S T AO L
PRE-EMPT	P R IY EH M P T
ARROGATE	AE R OW G EY T
PERVASIVE	P ER V EY S IH V
PUNGENT	P AH N JH AH N T
COALESCE	K OW AH L EH S
RENDITION	R EH N D IH SH AH N
TEPID	T EH P IH D
EMACIATED	IH M EY SH IY EY T IH D
WIZENED	W AY Z AH N D
ATTENUATED	AH T EH N Y UW EY T IH D
SCRAWNY	S K R AO N IY
BEMUSE	B IH M Y UW Z
STENTORIAN	S T EH N T AO R IY AH N
SONOROUS	S AA N ER AH S
STRIDENT	S T R AY D AH N T
REGURGITATE	R IH G ER JH AH T EY T
TREPIDATION	T R EH P IH D EY SH AH N
UNHINGED	AH N HH IH N JH D
DISQUIETUDE	D IH S K W AY AH T UW D
RELINQUISH	R IH L IH NG K W IH SH
RELINQUISH(2)	R IY L IH NG K W IH SH
IMPINGE	IH M P IH N JH
APE	EY P
MOCK	M AA K
COMPUNCTION	K AH M P AH NG K SH AH N
ACRID	AE K R IH D
NOXIOUS	N AA K SH AH S
EXHILARATE	IH G Z IH L ER EY T
DEFT	D EH F T
ASTUTE	AH S T UW T
SAGACIOUS	S EY JH AH S IY AH S
INFATUATE	IH N F AE CH UW EY T
UNDERTONE	AH N D ER T OW N
CATEGORICAL	K AE T AH G AA R IH K AH L
CATEGORICAL(2)	K AE T AH G AO R IH K AH L
INTRIGUED	IH N T R IY G D
ENTRUST	EH N T R AH S T
LACKADAISICAL	L AE K AH D EY Z IH K AH L
TETCHY	T EH CH IY
ALLURE	AH L UH R
BEGUILE	B IH G AY L
FELICITOUS	F IH L IH S AH T AH S
SUFFUSE	S AH F Y UW Z
CLEAVETO	K L IY V AH T OW
SCION	S AY AH N
DUDGEON	D AH JH AH N
ANTEDILUVIAN	AE N T EH D AH L UW V IY AH N
SUCCINT	S AH K S AH N T
ABEYANCE	AH B EY AH N S
ABNEGATE	AE B N AH G EY T
RECANT	R IY K AE N T
IMPASSIONED	IH M P AE SH AH N D
VEHEMENT	V IY AH M AH N T
ARDENT	AA R D AH N T
INANE	IH N EY N
SENTENTIOUS	S EH N T EH N T IY AH S
PICAYUNE	P IH K IY Y UW N
GILDING	G IH L D IH NG