AE	EY
ABOLLAE	AH B AA L IY
ABSCISSAE	AE B S IH S IY
ACALEPHAE	AH K AE L AH F IY
ACICULAE	AE S AH K Y UW L IY
ACTINIAE	AE K T IH N IY IY
AE	EY
AECIA	EH SH IY AH
AECIAL	EH SH AH L
AECIDIA	AH S IH D IY AH
AECIDIAL	AH S IH D IY AH L
AECIDIUM	AH S IH D IY AH M
AECIOSPORE	EH S IY AA S AH R
AECIOSPORES	EH S IY AA S AH R Z
AECIUM	EH S IY AH M
AEDES	EH D Z
AEDILE	EH D AH L
AEDILES	EH D AH L Z
AEDINE	AH D AY N
AEGIS	IY JH AH S
AEGISES	IY JH AH S IH Z
AENEOUS	EH N IY AH S
AENEUS	EH N IY AH S
AEOLIAN	EH OW L IY AH N
AEON	IY AA N
AEONIAN	EH OW N IY AH N
AEONIC	IY AA N IH K
AEONS	IY AA N Z
AEPYORNIS	EH P AY AO R N AH S
AEPYORNISES	EH P AY AH R N AY Z AH Z
AEQUORIN	EH K W AH R AH N
AEQUORINS	EH K W AH R AH N Z
AERATE	AE ER AH T
AERATED	AE ER EY T IH D
AERATES	AE ER AH T S
AERATING	AE ER EY T IH NG
AERATION	AE ER EY SH AH N
AERATIONS	AE ER EY SH AH N Z
AERATOR	AE ER AH T ER
AERATORS	AE ER AH T ER Z
AERENCHYMA	AH R EH NG K AH M AH
AERENCHYMAS	AH R EH NG K AH M AH Z
AERENCHYMATA	EH R AH NG K IH M AH T AH
AERIAL	EH R IY AH L
AERIALIST	AE ER IY AH L IH S T
AERIALISTS	AE ER IY AH L IH S T S
AERIALLY	AE ER IY AH L IY
AERIALS	EH R IY AH L Z
AERIE	EH R IY
AERIED	AE ER IY D
AERIER	AE ER IY ER
AERIES	AE ER IY Z
AERIEST	AE ER IY AH S T
AERIFIED	AE ER AH F AY D
AERIFIES	AE ER AH F AY Z
AERIFORM	EH R AH F AH R M
AERIFY	AE ER AH F AY
AERIFYING	AE ER AH F AY IH NG
AERILY	AE ER IY L IY
AERO	EH R OW
AEROBATIC	EH R AH B AE T IH K
AEROBATICS	EH R AH B AE T IH K S
AEROBE	AH R OW B
AEROBES	AH R OW B Z
AEROBIA	AH R OW B IY AH
AEROBIC	EH R OW B IH K
AEROBICALLY	EH R OW B IH K L IY
AEROBICIZE	AE ER OW B IH K AY Z
AEROBICIZED	AE ER OW B IH K AY Z D
AEROBICIZES	AE ER OW B IH K AY Z IH Z
AEROBICIZING	AE ER OW B IH K AY Z IH NG
AEROBICS	ER OW B IH K S
AEROBIOLOGICAL	EH R AH B IY AA L AH JH IH S AH L
AEROBIOLOGIES	AH R AH B IY AA L AH JH AY Z
AEROBIOLOGY	EH R AH B IY AA L AH JH IY
AEROBIOSES	AH R OW B IY OW Z AH Z
AEROBIOSIS	EH R AH B AY OW S AH S
AEROBIUM	AH R OW B IY AH M
AEROBRAKE	EH R AH B R EY K
AEROBRAKED	EH R AH B R EY K T
AEROBRAKES	EH R AH B R EY K S
AEROBRAKING	EH R AH B R EY K AH NG
AERODROME	EH R AH D R OW M
AERODROMES	EH R AH D R OW M Z
AERODUCT	EH R AH D AH K T
AERODUCTS	EH R AH D AH K T S
AERODYNAMIC	EH R OW D AY N AE M IH K
AERODYNAMICAL	AE R OW D AY N AE M IH K AH L
AERODYNAMICALLY	EH R OW D AY N AE M IH K L IY
AERODYNAMICIST	EH R OW D AY N AE M IH S IH S T
AERODYNAMICISTS	EH R OW D AY N AE M IH S IH S T S
AERODYNAMICISTS(2)	EH R OW D AY N AE M IH S IH S
AERODYNAMICS	EH R OW D AY N AE M IH K S
AERODYNE	EH R AH D AY N
AERODYNES	EH R AH D AY N Z
AEROELASTIC	AH R OW AH L AH S T AH K
AEROELASTICITIES	AH R OW AH L AE S T IH S AH T AY Z
AEROELASTICITY	AH R OW AH L AE S T IH S AH T IY
AEROEMBOLISM	EH R OW EH M B AH L IH Z AH M
AEROEMBOLISMS	EH R OW EH M B AH L AH Z AH M Z
AEROFOIL	EH R AH F OY L
AEROFOILS	AH R AA F OW AH L Z
AEROGEL	EH R AH JH AH L
AEROGELS	EH R AH JH AH L Z
AEROGRAM	AH R AA G R AH M
AEROGRAMME	AH R AA G R AH M
AEROGRAMMES	AH R AA G R AH M Z
AEROGRAMS	AH R AA G R AH M Z
AEROLITE	EH R AH L AY T
AEROLITES	EH R AH L AY T S
AEROLITH	EH R AH L AH TH
AEROLITHS	EH R AH L AH TH S
AEROLOGIES	AE ER AA L AH JH IY Z
AEROLOGY	AE ER AA L AH JH IY
AEROMAGNETIC	EH R AH M AE G N AH T AH K
AEROMECHANICS	EH R AH M EH CH AH N AH S Z
AEROMEDICAL	AH R AA M AH D IH S AH L
AEROMEDICINE	AH R AH M EH D AH S AY N
AEROMEDICINES	AH R AH M EH D AH S AY N Z
AEROMETER	AH R AA M AH T AH R
AEROMETERS	AH R AA M AH T AH R Z
AERONAUT	EH R AH N AH T
AERONAUTIC	EH R OW N AA T AH K
AERONAUTICAL	EH R OW N AA T AH K AH L
AERONAUTICAL(2)	EH R AH N AA T AH K AH L
AERONAUTICALLY	AE R AH N AO T IH K AH L IY
AERONAUTICS	EH R AH N AO T IH K S
AERONAUTS	AH R AA N AH Y UW T S
AERONOMER	EH R AH N OW M AH R
AERONOMERS	AH R AA N AH M AH R Z
AERONOMIC	EH R AH N AH M AH K
AERONOMICAL	AH R AA N AH M IH S AH L
AERONOMIES	AH R AA N AH M AY Z
AERONOMIST	AH R AA N AH M AH S T
AERONOMISTS	AH R AA N AH M AH S T S
AERONOMY	AH R AA N AH M IY
AEROPLANE	EH R AH P L EY N
AEROPLANES	EH R AH P L EY N Z
AEROSAT	EH R AH S AH T
AEROSATS	EH R AH Z EY T S
AEROSOL	EH R AH S AA L
AEROSOLIZATION	AE R AH S AO L AH Z EY SH AH N
AEROSOLIZATIONS	AE R AH S AO L AH Z EY SH AH N Z
AEROSOLIZE	AE R AH S AO L AY Z
AEROSOLIZED	AE R AH S AO L AY Z D
AEROSOLIZES	AE R AH S AO L AY Z IH Z
AEROSOLIZING	AE R AH S AO L AY Z IH NG
AEROSOLS	EH R AH S AA L Z
AEROSPACE	EH R OW S P EY S
AEROSPACES	AE R AH S P EY S IH Z
AEROSTAT	EH R OW S T AE T
AEROSTATICS	AH R AA S T AH T AH S Z
AEROSTATS	EH R OW S T AE T S
AEROTHERMODYNAMIC	EH R AH TH AH R M AA D AH N AH M AH K
AEROTHERMODYNAMICS	EH R AH TH AH R M AH D IH N AH M AH S Z
AERUGO	AH R UW G OW
AERUGOS	AH R UW G AH Z
AERY	AE ER IY
AESTHETE	EH S TH IY T
AESTHETES	EH S TH IY T S
AESTHETIC	EH S TH EH T IH K
AESTHETICAL	EH S TH EH T IH K AH L
AESTHETICALLY	EH S TH EH T IH K L IY
AESTHETICIAN	EH S TH AH T IH S IY AH N
AESTHETICIANS	EH S TH AH T IH S IY AH N Z
AESTHETICISM	EH S TH EH T IH K IH Z AH M
AESTHETICISMS	EH S TH EH T IH K IH Z AH M Z
AESTHETICIZE	EH S TH EH T IH K AY Z
AESTHETICIZED	EH S TH EH T IH K AY Z D
AESTHETICIZES	EH S TH EH T IH K AY Z IH Z
AESTHETICIZING	EH S TH EH T IH K AY Z IH NG
AESTHETICS	EH S TH EH T IH K S
AESTIVAL	EY EH S T AH V AH L
AESTIVATE	EY EH S T AH V EY T
AESTIVATED	EY EH S T AH V EY T AH D
AESTIVATES	EY EH S T AH V EY T S
AESTIVATING	EY EH S T AH V EY T AH NG
AESTIVATION	EY EH S T AH V EY SH AH N
AESTIVATIONS	EH S T AH V EY T IY AH N Z
AETHER	AH IY TH ER
AETHERIC	AH IY TH ER IH K
AETHERS	AH IY TH ER Z
AETIOLOGIES	AH T IY AA L AH JH AY Z
AETIOLOGY	AH T IY AA L AH JH IY
AGAPAE	AE G AH P IY
AGORAE	AE G AH R IY
ALAE	AE L IY
ALGAE	AE L JH IY
ALGAECIDE	AE L G AH S AY D
ALGAECIDES	AE L G AH S AY D Z
ALTHAEA	AE L TH IY AH
ALTHAEAS	AE L TH IY AH Z
ALULAE	AH L UW L IY
ALUMNAE	AH L AH M N EY
AMEBAE	AE M AH B IY
AMOEBAE	AH M OW AH B IY
AMPHISBAENA	AE M F AH Z IY N AH
AMPHISBAENAE	AE M F AH Z IY N IY
AMPHISBAENAS	AE M F AH Z IY N AH Z
AMPHISBAENIC	AE M F AH Z IY N AH K
AMPHORAE	AE M F ER IY
AMPULLAE	AE M P UH L IY
AMYGDALAE	AH M IH G D AH L IY
ANABAENA	AE N AH B IY N AH
ANABAENAS	AE N AH B IY N AH Z
ANAEMIA	AH N IY M IY AH
ANAEMIAS	AH N IY M IY AH Z
ANAEMIC	AH N IY M AH K
ANAEROBE	AE N ER OW B
ANAEROBES	AE N ER OW B Z
ANAEROBIC	AE N ER OW B IH K
ANAEROBICALLY	AE N AH R OW B IH K AH L IY
ANAEROBIOSES	AH N AH R OW B IY OW Z AH Z
ANAEROBIOSIS	AH N IY R AH B AY OW S AH S
ANAESTHESIA	AE N IH S TH IY ZH IY AH
ANAESTHESIAS	AE N AH S TH IY ZH AH Z
ANAESTHETIC	AE N AH S TH EH T IH K
ANAESTHETICS	AE N AH S TH EH T IH K S
ANAPAEST	AH N AE P EY AH S T
ANAPAESTS	AE N AH P IY S T S
ANCILLAE	AE N S IH L IY
ANSAE	AE N S IY
ANTAE	AE N T IY
ANTEFIXAE	AE N T AH F IH K S IY
ANTENNAE	AE N T EH N IY
AORTAE	EY AO R T IY
APHAERESES	AE F AH R IY Z AH Z
APHAERESIS	AH F IY R AH S AH S
APHAERETIC	AH F IY R AH T AH K
APHTHAE	AE F TH IY
APOLOGIAE	AE P AH L OW JH IY IY
AQUAE	AE K W IY
ARBORVITAE	AA R B AO R V AH T IY
ARBORVITAES	AA R B AO R V AH T EY Z
ARCHAEA	AA R K IY AH
ARCHAEAL	AA R K EY IY AH L
ARCHAEAN	AA R K IY AH N
ARCHAEANS	AA R K IY AH N Z
ARCHAEBACTERIA	AA R K IY B AH K T IY R IY AH
ARCHAEBACTERIUM	AA R K IY B AH K T IY R IY AH M
ARCHAEOASTRONOMIES	AA R K IY OW S T R AA N AH M AY Z
ARCHAEOASTRONOMY	AA R K IY OW S T R AA N AH M IY
ARCHAEOLOGICAL	AA R K IY AH L AA JH IH K AH L
ARCHAEOLOGICALLY	AA R K IY AH L AA JH IH K AH L IY
ARCHAEOLOGIES	AA R K IY AA L AH JH IY Z
ARCHAEOLOGIST	AA R K IY AA L AH JH IH S T
ARCHAEOLOGISTS	AA R K IY AA L AH JH IH S T S
ARCHAEOLOGY	AA R K IY AA L AH JH IY
ARCHAEOPTERYX	AA R K IY AA P T AH R AH K S
ARCHAEOPTERYXES	AA R K IY AA P T AH R AH K S
AREAE	AE R IY
AREOLAE	AH R IY AH L IY
ARISTAE	AH R IH S T IY
ARMILLAE	AA R M IH L IY
ASPIRATAE	AE S IH R AH T IY
ATHENAEUM	AE TH AH N IY AH M
ATHENAEUMS	AH TH EH N IY AH M Z
AURAE	AO R IY
AUREOLAE	AH R IY AH L IY
AURICULAE	AO R AH K Y UW L IY
AURORAE	AO R AH R IY
AVIFAUNAE	AH V IH F AH N IY
AXILLAE	AE K S IH L IY
BAAED	B AA D
BACCAE	B AE K IY
BALLISTAE	B AE L IH S T IY
BASILICAE	B AH S IH L AH K IY
BEDSONIAE	B IH D S OW N IY IY
BEFLEAED	B IH F L IY D
BIBLIOTHECAE	B AY B L AY AA TH AH K IY
BLAE	B L IY
BLAEBERRIES	B L IY B EH R AY Z
BLAEBERRY	B L IY B EH R IY
BLASTULAE	B L AE S T Y AH L IY
BOUGAINVILLAEA	B AW G EY N V IH L IY AH
BOUGAINVILLAEAS	B AW G EY N V IH L IY AH Z
BRAE	B R EY
BRAES	B R EY Z
BRANCHIAE	B R AE NG K IY IY
BRUCELLAE	B R UW S EH L IY
BULLAE	B UH L IY
BURSAE	B AH R S IY
CAECA	K IY K AH
CAECAL	K IY K AH L
CAECALLY	K IY K AE L IY
CAECILIAN	K IY S IH L IY AH N
CAECILIANS	K IY S IH L IY AH N Z
CAECUM	K IY K AH M
CAEOMA	K IY AH M AH
CAEOMAS	K IY AH M AH Z
CAESAR	S IY Z ER
CAESAREAN	K EY S ER IY N
CAESAREANS	K EY S ER IY N Z
CAESARIAN	K IY Z EH R IY AH N
CAESARIANS	K IY S AE R IY AH N Z
CAESARS	S IY Z ER Z
CAESIUM	K IY S IY AH M
CAESIUMS	K IY S IY AH M Z
CAESPITOSE	K IY S AH T OW Z
CAESTUS	K EY EH S T AH S
CAESTUSES	K IY S T Y UW Z AH Z
CAESURA	K IY S AH R AH
CAESURAE	K IY S AH R IY
CAESURAL	K IY ZH Y AH R AH L
CAESURAS	K IY S AH R AH Z
CAESURIC	K IY ZH Y AH R AH K
CAMERAE	K AE M AH R IY
CANNULAE	K AE N Y AH L IY
CANULAE	K AE N Y AH L IY
CARDIAE	K AA R D IY IY
CARINAE	K AE R AH N IY
CATENAE	K AE T AH N IY
CATHEDRAE	K AH TH EH D R IY
CELLAE	S EH L IY
CERCARIAE	S AH R K AE R IY IY
CESURAE	S EH S AH R IY
CHAETA	CH IY T AH
CHAETAE	CH IY T IY
CHAETAL	CH IY T AH L
CHAETOGNATH	CH IY T AA G N AH TH
CHAETOGNATHS	CH IY T AA G N AH TH S
CHALAZAE	CH AE L AH Z IY
CHAMAEPHYTE	CH AE M AH F AY T
CHAMAEPHYTES	CH AE M AH F AY T S
CHELAE	CH EH L IY
CHELICERAE	CH AH L IH S AH R IY
CHIMAERA	CH AH M IY R AH
CHIMAERAS	CH AH M IY R AH Z
CHIMAERIC	CH AH M IY R AH K
CHIMAERISM	CH IH M AH R IH Z AH M
CHIMAERISMS	CH AH M IY R AH Z AH M Z
CHLAMYDIAE	K L AH M IH D IY IY
CHOANAE	CH OW N IY
CICADAE	S IH K AH D IY
CICHLIDAE	S IH K L AH D IY
CISTERNAE	S IH S T AH R N IY
CLEPSYDRAE	K L EH P S IH D R IY
CLOACAE	K L OW K IY
COAEVAL	K OW AH IY V AH L
COAEVALS	K OW AH IY V AH L Z
COCHLEAE	K OW K L IY
COLEORHIZAE	K OW L IY AO R AH Z IY
COLUMELLAE	K OW L AH M EH L IY
COMAE	K AH M EH
COMATULAE	K AH M AE T Y AH L IY
CONCHAE	K AA N CH IY
CONFERVAE	K AA N F AH R V IY
CONGAED	K AA N G EY D
CONJUNCTIVAE	K AA N JH AH NG K T AH V IY
COPULAE	K OW P Y UW L IY
CORBICULAE	K AA R B IH K Y AH L IY
CORNEAE	K AA R N IY
CORONAE	K OW R AA N IY
CORYPHAEI	K OW R IH F IY IY
CORYPHAEUS	K OW R IH F IY AH S
COSTAE	K AA S T IY
COTTAE	K AA T IY
COXAE	K OW Z IY
CRISTAE	K R IH S T IY
CULPAE	K AH L P IY
CUPOLAED	K Y UW P AH L EY D
CUPULAE	K Y UW P Y AH L IY
CURIAE	K Y UH R IY AY
CUTICULAE	K Y UW T AH K Y UW L IY
CYCLOPAEDIA	S IH K L AH P IY D IY AH
CYCLOPAEDIAS	S IH K L AH P IY D IY AH Z
CYMAE	S IH M IY
CYPSELAE	S IH P S AH L IY
DAEDAL	D IY D AH L
DAEMON	D IY M AH N
DAEMON(2)	D EY M AH N
DAEMONES	D IY M OW N Z
DAEMONIC	D IY M AH N AH K
DAEMONS	D IY M AH N Z
DEAERATE	D IY AE ER AH T
DEAERATED	D IY AE ER EY T IH D
DEAERATES	D IY AE ER AH T S
DEAERATING	D IY AE ER EY T IH NG
DEAERATION	D IY AE ER EY SH AH N
DEAERATIONS	D IY AE ER EY SH AH N Z
DEAERATOR	D IY AE ER AH T ER
DEAERATORS	D IY AE ER AH T ER Z
DECIDUAE	D AH S IH D Y UW IY
DEFLEAED	D IY F L IY D
DIAERESES	D AY AH AH R IY Z AH Z
DIAERESIS	D AY AE IH R AH S AH S
DIAERETIC	D AY AE AH R AH T AH K
DIFFERENTIAE	D IH F AH R EH N T IY IY
DIPLOMAED	D IH P L AH M EY D
DRACAENA	D R AH K IY N AH
DRACAENAS	D R AH K IY N AH Z
DRACHMAE	D R AE CH M IY
DROSOPHILAE	D R AH S AA F AH L IY
ECCLESIAE	EH K L IY S IY IY
ECHIDNAE	AH CH IH D N IY
EMERITAE	AH M EH R AH T IY
ENCAENIA	IH N K IY N Y AH
ENCYCLOPAEDIA	IH N S AY K L AH P IY D IY AH
ENCYCLOPAEDIA(2)	IH N S AY K L OW P IY D IY AH
ENCYCLOPAEDIAS	IH N S IH K L AH P IY D IY AH Z
ENCYCLOPAEDIC	IH N S IH K L AH P IY D AH K
ENDAMEBAE	IH N D AE M AH B IY
ENDAMOEBAE	IH N D AH M OW AH B IY
ENTAMEBAE	IH N T AE M AH B IY
ENTAMOEBAE	IH N T AH M OW AH B IY
ENTOMOFAUNAE	IH N T AH M AA F AH N IY
EPHEMERAE	AH F EH M AH R IY
EPIFAUNAE	AH P IH F AH N IY
EUDAEMON	Y UW D IY M AH N
EUDAEMONISM	Y UW D IY M AH N IH Z AH M
EUDAEMONISMS	Y UW D IY M AH N AH Z AH M Z
EUDAEMONIST	Y UW D IY M AH N AH S T
EUDAEMONISTIC	Y UW D IY M AH N AH S T AH K
EUDAEMONISTS	Y UW D IY M AH N AH S T S
EUDAEMONS	Y UW D IY M AH N Z
EULOGIAE	Y UW L OW JH IY IY
EUPATRIDAE	Y UW P AE T R AH D IY
EXEDRAE	IH G Z EH D R IY
EXTRAEMBRYONIC	EH K S T R AH EH M B R IY AA N IH K
EXUVIAE	IH G Z UW V IY IY
FACETIAE	F AH S IY T IY IY
FACULAE	F AE K Y AH L IY
FAECAL	F IY K AH L
FAECES	F IY S AH Z
FAENA	F IY N AH
FAENAS	F IY N AH Z
FAERIE	F IY R AY
FAERIES	F AE ER IY Z
FAERY	F AE ER IY
FASCIAE	F AE S IY IY
FAUNAE	F AO N IY
FECULAE	F EH K Y AH L IY
FENESTRAE	F AH N EH S T R IY
FERIAE	F IY R IY IY
FERULAE	F AH R UW L IY
FIBRILLAE	F IH B R IH L IY
FIBULAE	F IH B Y AH L IY
FILARIAE	F AH L AE R IY IY
FIMBRIAE	F IH M B R IY IY
FISTULAE	F IH S T Y AH L IY
FLORAE	F L AO R IY
FORMULAE	F AO R M Y AH L AY
FOSSAE	F AA S IY
FOVEAE	F OW V IY
FOVEOLAE	F OW V IY AH L IY
FRAE	F R IY
FRAENA	F R IY N AH
FRAENUM	F R IY N AH M
FRAENUMS	F R IY N AH M Z
FURCRAEA	F AH R K R IY AH
FURCRAEAS	F AH R K R IY AH Z
FURCULAE	F AH R K Y AH L IY
GAE	G AY
GAED	G EY D
GAEING	G IY AH NG
GAEN	G EY AH N
GAES	G EY Z
GALEAE	G EY L IY
GASTRAEA	G AE S T R IY AH
GASTRAEAS	G AE S T R IY AH Z
GASTRULAE	G AE S T R AH L IY
GEMMAE	JH EH M IY
GINGIVAE	JH IH N JH AH V IY
GLABELLAE	G L AH B EH L IY
GLEBAE	G L EH B IY
GLOSSAE	G L AA S IY
GRAECIZE	G R IY S AY Z
GRAECIZED	G R IY S AY Z D
GRAECIZES	G R IY S AY Z AH Z
GRAECIZING	G R IY S AY Z AH NG
GRANDIFLORAE	G R AE N D IH F L AH R IY
GRAVIDAE	G R AE V AH D IY
GUTTAE	G AH T IY
GYNAECEA	JH AH N IY S IY AH
GYNAECEUM	JH AH N IY S IY AH M
GYNAECIA	JH AH N IY SH IY AH
GYNAECIUM	JH AH N IY S IY AH M
GYNAECOLOGIES	JH IH N AH K AA L AH JH AY Z
GYNAECOLOGY	JH IH N AH K AA L AH JH IY
HAE	HH IY
HAECCEITIES	HH IY K S AH T AY Z
HAECCEITY	HH IY K S IY AH T IY
HAED	HH AA D
HAEING	HH IY AH NG
HAEM	HH IY M
HAEMAL	HH IY M AH L
HAEMATAL	HH IY M AH T AH L
HAEMATIC	HH IY M AH T AH K
HAEMATICS	HH IY M AH T AH S Z
HAEMATIN	HH IY M AH T AH N
HAEMATINS	HH IY M AH T AH N Z
HAEMATITE	HH IY M AH T AY T
HAEMATITES	HH IY M AH T AY T S
HAEMIC	HH IY M AH K
HAEMIN	HH IY M AH N
HAEMINS	HH IY M AH N Z
HAEMOID	HH IY M OY D
HAEMS	HH IY M Z
HAEN	HH IY N
HAEREDES	HH IY R IY D Z
HAERES	HH IY R Z
HAES	HH EY Z
HAET	HH IY T
HAETS	HH IY T S
HALLOAED	HH AE L OW D
HENNAED	HH EH N EY D
HEPATICAE	HH AH P AE T AH K IY
HERMAE	HH AH R M IY
HERMAEAN	HH AH R M IY AH N
HERNIAE	HH AH R N IY IY
HETAERA	HH AH T IY R AH
HETAERAE	HH AH T IY R IY
HETAERAS	HH AH T IY R AH Z
HETAERIC	HH AH T IY R AH K
HILLOAED	HH IH L OW D
HOLLAED	HH AA L EY D
HOLLOAED	HH AA L OW D
HOSANNAED	HH AH S AE N EY D
HULLOAED	HH AH L OW D
HUZZAED	HH AH Z EY D
HYAENA	HH AY IY N AH
HYAENAS	HH AY IY N AH Z
HYAENIC	HH AY IY N AH K
HYDRAE	HH IH D R IY
HYDRIAE	HH IH D R IY IY
HYDROMEDUSAE	HH IH D R AH M AH D Y UW S IY
HYPAETHRAL	HH AH P IY TH R AH L
HYPERAESTHESIA	HH AY P AH R EH S TH IY ZH IY AH
HYPERAESTHESIAS	HH AY P AH R EH S TH IY S IY AH Z
HYPERAESTHETIC	HH AY P ER EH S TH EH T IH K
HYPERBOLAE	HH AY P AH R B AA L IY
HYPHAE	HH AY F IY
ICHTHYOFAUNAE	IH CH TH AY AA F AH N IY
INERTIAE	AH N AH R T IY IY
INFAUNAE	IH N F AO N IY
INTIMAE	IH N T IH M IY
ISCHAEMIA	IH S IY M IY AH
ISCHAEMIAS	IH S IY M IY AH Z
JAEGER	JH EH G ER
JAEGER(2)	Y AE G ER
JAEGERS	JH EH G ER Z
JAEGERS(2)	Y AE G ER Z
KAE	K IY
KAES	K EY Z
LACUNAE	L AE K Y AH N IY
LAETRILE	L IY T R AH L
LAETRILES	L IY T R AH L Z
LAEVO	L EY V OW
LAMELLAE	L AH M EH L IY
LAMIAE	L EY M IY IY
LAMINAE	L AE M AH N IY
LARVAE	L AA R V IY
LAURAE	L AO R IY
LEPORIDAE	L AH P AO R AH D IY
LEUKAEMIA	L UW K IY M IY AH
LEUKAEMIAS	L UW K IY M IY AH Z
LEUKAEMOGENESES	L UW K AH M AA JH AH N IY Z AH Z
LEUKAEMOGENESIS	L UW K IY M AH JH IY N AH S AH S
LIBRAE	L IH B R IY
LIGULAE	L IH G Y AH L IY
LINGUAE	L IH N G W IY
LOCUSTAE	L AH K AH S T IY
LORICAE	L AO R AH K IY
LUNULAE	L UW N Y AH L IY
LYTTAE	L IH T IY
MACULAE	M AE K Y AH L IY
MAE	M EY
MAELSTROM	M EY L S T R AH M
MAELSTROMS	M EY L S T R AH M Z
MAENAD	M IY N AH D
MAENADES	M IY N EY D Z
MAENADIC	M IY N AH D AH K
MAENADS	M IY N AH D Z
MAES	M EY Z
MAESTOSO	M IY S T AH S OW
MAESTOSOS	M IY S T AH S AH Z
MAESTRI	M AA EH S T R IY
MAESTRO	M AY S T R OW
MAESTROS	M AY S T R OW Z
MAMMAE	M AE M IY
MAMMILLAE	M AE M IH L IY
MASCARAED	M AE S K AE R AH D
MAXILLAE	M AE K S AH L IY
MAZAEDIA	M AH Z IY D IY AH
MAZAEDIUM	M AH Z IY D IY AH M
MEDIAE	M IY D IY IY
MEDIAEVAL	M IY D IY IY V AH L
MEDIAEVALS	M IY D IY IY V AH L Z
MEDULLAE	M AH D AH L IY
MEDUSAE	M EH D Y AH S IY
MEGAFAUNAE	M AH G AE F AH N IY
MENSAE	M EH N S IY
METACERCARIAE	M EH T AH S AH R K AE R IY IY
METAETHICAL	M EH T AH EH TH IH K AH L
METAETHICS	M EH T AH EH TH IH K S
METOPAE	M EH T AH P IY
MICELLAE	M AH S EH L IY
MICROFAUNAE	M AY K R AH F AO N IY
MICROFILARIAE	M AY K R AH F AH L AE R IY IY
MICROFLORAE	M AY K R OW F L AO R IY
MINAE	M IH N IY
MINUTIAE	M IH N UW SH IY AH
MORAE	M AO R IY
MORULAE	M AH R UW L IY
MUCOSAE	M Y UW K AH S IY
MURAENID	M Y AH R IY N AH D
MURAENIDS	M Y AH R IY N AH D Z
MUSCAE	M AH S IY
MYCOFLORAE	M AH K AA F L AH R IY
MYCORRHIZAE	M AH K AO R AH Z IY
NAE	N IY
NAETHING	N IY DH AH NG
NAETHINGS	N IY TH AH NG Z
NAEVI	N IY V IY
NAEVOID	N IY V OY D
NAEVUS	N IY V AH S
NAUMACHIAE	N AH M AE CH IY IY
NEBULAE	N EH B Y AH L IY
NEURULAE	N Y AH R UW L IY
NONAESTHETIC	N AA N EH S TH EH T IH K
NOVAE	N AA V IY
NOVENAE	N AA V AH N IY
NUCHAE	N AH CH IY
NYMPHAE	N IH M F IY
OCHREAE	AA K R IY
OCREAE	AA K R IY
OLIGOCHAETE	AH L IH G AH CH IY T
OLIGOCHAETES	AH L IH G AH CH IY T S
OOTHECAE	UW TH AH K IY
ORTHOPAEDIC	AO R TH AH P IY D AH K
ORTHOPAEDICS	AO R TH AH P IY D AH S Z
PAEAN	P IY AH N
PAEANISM	P IY AH N IH Z AH M
PAEANISMS	P IY AH N IH Z AH M Z
PAEANS	P IY AH N Z
PAEDIATRIC	P IY D IY AH T R AH K
PAEDIATRICIAN	P IY D IY AE T R IH S IY AH N
PAEDIATRICIANS	P IY D IY AH T R IH S IY AH N Z
PAEDIATRICS	P IY D IY AE T R AH S Z
PAEDOGENESES	P IY D AA JH AH N IY Z AH Z
PAEDOGENESIS	P IY D AH JH IY N AH S AH S
PAEDOGENETIC	P IY D AA JH AH N AH T AH K
PAEDOGENETICALLY	P IY D AH JH AH N EH T AH K AE L IY
PAEDOGENIC	P IY D AH JH AH N AH K
PAEDOMORPHIC	P IY D AH M AH R F AH K
PAEDOMORPHISM	P IY D AH M AH R F IH Z AH M
PAEDOMORPHISMS	P IY D AH M AO R F AH Z AH M Z
PAEDOMORPHOSES	P IY D AA M AH R F OW Z AH Z
PAEDOMORPHOSIS	P IY D AH M AH R F OW S AH S
PAELLA	P IY L AH
PAELLAS	P IY L AH Z
PAEON	P EY IY AH N
PAEONS	P IY AH N Z
PAESAN	P EY Z AH N
PAESANI	P IY S AH N IY
PAESANO	P IY S AH N OW
PAESANOS	P IY S AH N AH Z
PAESANS	P IY S AH N Z
PAJAMAED	P AH JH AA M AH D
PALAESTRA	P AH L IY S T R AH
PALAESTRAE	P AH L IY S T R IY
PALAESTRAS	P AH L IY S T R AH Z
PALEAE	P EY L IY
PALESTRAE	P AH L EH S T R IY
PALPEBRAE	P AE L P EH B R IY
PAPILLAE	P AH P IH L IY
PAPULAE	P AE P Y AH L IY
PARAE	P AE R IY
PARAESTHESIA	P AE R IY S TH IY ZH IY AH
PARAESTHESIAS	P AE R IY S TH IY S IY AH Z
PATELLAE	P AH T EH L IY
PATINAE	P AE T AH N IY
PENNAE	P EH N IY
PENUMBRAE	P AH N AH M B R IY
PERICOPAE	P AH R IH K AH P IY
PERSONAE	P ER S OW N EY
PETECHIAE	P AH T EH K IY IY
PHAETON	F IY T AH N
PHAETONS	F IY T AH N Z
PHYLAE	F IH L IY
PHYLLOXERAE	F IH L AA K S AH R IY
PINNAE	P IH N IY
PINNULAE	P IH N Y AH L IY
PISCINAE	P IH S AH N IY
PLACENTAE	P L AH S EH N T IY
PLANULAE	P L AE N Y AH L IY
PLEURAE	P L UH R IY
PLICAE	P L IH K IY
POLKAED	P OW L K AH D
POLYCHAETE	P AA L AH CH IY T
POLYCHAETES	P AA L AH CH IY T S
POSTCAVAE	P AA S T AH V IY
PRAECIPE	P R IY S AY P
PRAECIPES	P R IY S AY P S
PRAEDIAL	P R IY D IY AH L
PRAEFECT	P R IY F AH K T
PRAEFECTS	P R IY F AH K T S
PRAELECT	P R IY L AH K T
PRAELECTED	P R IY L EH K T AH D
PRAELECTING	P R IY L EH K T AH NG
PRAELECTS	P R IY L AH K T S
PRAEMUNIRE	P R IY M Y AH N AY R
PRAEMUNIRES	P R IY M Y AH N AY R Z
PRAENOMEN	P R IY N AH M AH N
PRAENOMENS	P R IY N AH M AH N Z
PRAENOMINA	P R IY N AA M AH N AH
PRAESIDIA	P R IY S IH D IY AH
PRAESIDIUM	P R IY S IH D IY AH M
PRAESIDIUMS	P R IY S IH D IY AH M Z
PRAETOR	P R IY T ER
PRAETORIAL	P R IY T AO R IY AH L
PRAETORIAN	P R IY T AO R IY AH N
PRAETORIANS	P R IY T AO R IY AH N Z
PRAETORS	P R IY T AH R Z
PRAETORSHIP	P R IY T AH R SH IH P
PRAETORSHIPS	P R IY T AO R SH AH P S
PRECAVAE	P R IY K AE V IY
PREMAXILLAE	P R IY M AE K S AH L IY
PRIMIPARAE	P R AH M IH P AH R IY
PROCTODAEA	P R OW K T AA D IY AH
PROCTODAEUM	P R OW K T AA D IY AH M
PROCTODAEUMS	P R OW K T AA D IY AH M Z
PROPAEDEUTIC	P R OW P IY D AH Y UW T AH K
PROPAEDEUTICS	P R OW P IY D AH Y UW T AH S Z
PROPRAETOR	P R OW P R IY T AH R
PROPRAETORS	P R OW P R IY T AH R Z
PROPYLAEA	P R AA P AH L IY AH
PROPYLAEUM	P R OW P IH L IY AH M
PSOAE	S OW
PTERYLAE	T EH R AH L IY
PUPAE	P Y UW P IY
PYAEMIA	P AY IY M IY AH
PYAEMIAS	P AY IY M IY AH Z
PYAEMIC	P AY IY M AH K
PYGMAEAN	P IH G M IY AH N
QUADRIGAE	K W AA D R AH G IY
QUAERE	K W IY R
QUAERES	K W IY R Z
QUAESTOR	K W IY S T AH R
QUAESTORS	K W IY S T AH R Z
RACHILLAE	R AH CH IH L IY
RADULAE	R AE D Y AH L IY
RANULAE	R AE N Y AH L IY
RAPHAE	R AE F IY
REDIAE	R AH D AY AH
REGGAE	R EH G EY
REGGAES	R IH G EY Z
REGINAE	R AH JH IH N IY
RELIQUIAE	R AH L IH K W IY IY
RETINAE	R AH T IH N IY
RETINULAE	R AH T IH N Y AH L IY
RHAPHAE	R AE F IY
RHUMBAED	R AH M B EY D
RICKETTSIAE	R IH K EH T S IY IY
RUGAE	R UW G IY
RUMBAED	R AH M B EY D
SAE	S IY
SALMONELLAE	S AE L M AH N EH L IY
SALPAE	S AE L P IY
SAMBAED	S AA M B AH D
SAPHENAE	S AE F AH N IY
SCAPULAE	S K AE P Y AH L IY
SCARABAEI	S K AH R AE B IY IY
SCARABAEUS	S K AH R AE B IY AH S
SCARABAEUSES	S K AH R AE B IY UW Z AH Z
SCIAENID	S AY AE AH N AH D
SCIAENIDS	S AY AE AH N AH D Z
SCLERAE	S K L EH R IY
SCOPULAE	S K AA P Y AH L IY
SCORIAE	S K AO R IY IY
SCORPAENID	S K AO R P IY N AH D
SCORPAENIDS	S K AO R P IY N AH D Z
SCYPHISTOMAE	S AH F IH S T AH M IY
SENSILLAE	S EH N S IH L IY
SENTENTIAE	S EH N T EH N T IY IY
SEQUELAE	S EH K W AH L IY
SEROSAE	S EH R AH S IY
SETAE	S EH T IY
SHIGELLAE	SH AH JH EH L IY
SILICULAE	S IH L AH K Y UW L IY
SILIQUAE	S AH L IH K W IY
SILVAE	S IH L V IY
SPAE	S P IY
SPAED	S P AA D
SPAEING	S P IY AH NG
SPAEINGS	S P IY AH NG Z
SPAES	S P EY Z
SPAETZLE	S P IY T S AH L
SPAETZLES	S P IY T S AH L Z
SPELAEAN	S P EH L IY AH N
SPERMATHECAE	S P AH R M AE TH AH K IY
SPICAE	S P IH K IY
SPICULAE	S P IH K Y AH L IY
SPINULAE	S P IH N Y AH L IY
SPIRAEA	S P IH R IY AH
SPIRAEAS	S P IH R IY AH Z
SPIROCHAETE	S P IH R AH CH IY T
SPIROCHAETES	S P IH R AH CH IY T S
SPIRULAE	S P AH R UW L IY
SQUAMAE	S K W AA M IY
SQUILLAE	S K W IH L IY
STANZAED	S T AE N Z EY D
STELAE	S T EH L IY
STOAE	S T OW
STOMODAEA	S T AH M AA D IY AH
STOMODAEAL	S T AA M AH D EY IY AH L
STOMODAEUM	S T AH M AA D IY AH M
STOMODAEUMS	S T AH M AA D IY AH M Z
STRIAE	S T R IY IY
STROBILAE	S T R AA B AH L IY
STRUMAE	S T R UW M IY
SUBAERIAL	S AH B AE ER IY AH L
SUBAERIALLY	S AH B AE ER IY AH L IY
SUBMUCOSAE	S AH B M Y UW K AH S IY
SUBPENAED	S AH B P AH N EY D
SUBPOENAED	S AH P IY N AH D
SUCCUBAE	S AH K Y AH B IY
SUMMAE	S AH M IY
SUNDAE	S AH N D EY
SUNDAES	S AH N D EY Z
SUPERNOVAE	S UW P AH R N AA V IY
SYLVAE	S IH L V IY
SYNAERESES	S IH N AH R IY Z AH Z
SYNAERESIS	S AH N IY R AH S AH S
SYNAESTHESES	S IH N IY S TH IY Z AH Z
SYNAESTHESIA	S IH N IY S TH IY ZH IY AH
SYNAESTHESIAS	S IH N IY S TH IY S IY AH Z
SYNAESTHESIS	S AH N IY S DH AH S AH S
SYNURAE	S IH N Y AH R IY
TAE	T EY
TAE(2)	T AY
TAEL	T IY L
TAELS	T IY L Z
TAENIA	T IY N Y AH
TAENIAE	T IY N IY IY
TAENIAS	T IY N Y AH Z
TAENIASES	T IY N IY EY Z AH Z
TAENIASIS	T IY N Y AH S AH S
TARANTULAE	T AE R AH N T Y UW L IY
TELAE	T EH L IY
TENEBRAE	T AH N EH B R IY
TENIAE	T IY N IY IY
TERRAE	T EH R IY
TESSERAE	T EH S AH R IY
TESTAE	T EH S T IY
THAE	TH IY
THALASSAEMIA	TH AE L AH S IY M IY AH
THALASSAEMIAS	TH AE L AH S IY M IY AH Z
THECAE	TH EH K IY
THERMAE	TH ER M IY
TIARAED	T AY AH R EY D
TIBIAE	T IH B IY IY
TIBIOFIBULAE	T AH B IY AH F AH B Y UW L IY
TOGAE	T AA G IY
TOGAED	T AH G EY D
TORULAE	T AH R UW L IY
TOXAEMIA	T AA K S IY M IY AH
TOXAEMIAS	T AA K S IY M IY AH Z
TOXAEMIC	T AA K S IY M AH K
TRABECULAE	T R AE B AH K Y UW L IY
TRACHEAE	T R AE CH IY
TRICHINAE	T R IH CH AH N IY
TROCHLEAE	T R AA K L IY
TUBAE	T Y UW B IY
TUNICAE	T Y UW N AH K IY
TWAE	T W IY
TWAES	T W EY Z
ULNAE	AH L N IY
ULTRAEFFICIENT	AH L T R AH IH F IH SH AH N T
ULTRAENERGETIC	AH L T R AH EH N ER JH EH T IH K
ULTRAEXCLUSIVE	AH L T R AH IH K S K L UW S IH V
UMBRAE	AH M B R IY
UMBRELLAED	AH M B R EH L AH D
UNAESTHETIC	AH N EH S TH EH T IH K
UNCIAE	AH N S AY AH
UNGULAE	AH N G Y UW L IY
UNIDEAED	AH N AY D IY AH D
URAEI	Y UH R IY IY
URAEMIA	Y AH R IY M IY AH
URAEMIAS	Y AH R IY M IY AH Z
URAEMIC	Y AH R IY M AH K
URAEUS	Y UH R IY AH S
URAEUSES	Y UH R IY UW Z AH Z
URETHRAE	Y AH R EH TH R IY
URSAE	AH R S IY
USNEAE	AH Z N IY
USQUABAE	AH S W AH B IY
USQUABAES	AH S W AH B EY Z
USQUEBAE	AH S W AH B IY
USQUEBAES	AH S W AH B EY Z
UVULAE	Y UW V Y AH L IY
VAGINAE	V AE JH AH N IY
VALLECULAE	V AE L AH K Y UW L IY
VALVULAE	V AE L V Y AH L IY
VENAE	V EH N IY
VERANDAED	V AH R AE N D AH D
VERRUCAE	V EH R AH K IY
VERTEBRAE	V ER T AH B R EY
VESICAE	V EH S AH K IY
VESICULAE	V EH S AH K Y UW L IY
VIBRISSAE	V IH B R IH S IY
VILLAE	V IH L IY
VISAED	V IY Z AH D
VISTAED	V IH S T AH D
VITAE	V AY T AH
VITTAE	V IH T IY
VOMICAE	V AA M AH K IY
VORTICELLAE	V AO R T AH S EH L IY
VULVAE	V AH L V IY
WAE	W IY
WAEFUL	W IY F AH L
WAENESS	W IY N AH S
WAENESSES	W IY N EH S AH Z
WAES	W EY Z
WAESUCK	W IY S AH K
WAESUCKS	W IY S AH K S
ZOEAE	Z OW AH IY
ZONULAE	Z AA N Y AH L IY
ZOOGLEAE	Z UW G L IY
ZOOGLOEAE	Z UW G L OW AH IY
ZOOXANTHELLAE	Z UH K S AH N TH EH L IY
EIKON	IY K AH N
LOOS	L UW Z
BLUB	B L AH B
UDDER	AH D AH R
VOCABLE	V OW K AH B AH L
ENERGETIC	EH N ER JH EH T IH K
JUBA	JH UW B AH
