AI	AY
AI(2)	EY AY
ABIGAIL	AE B AH G EY L
ABIGAILS	AE B AH G EY L Z
ABSTAIN	AH B S T EY N
ABSTAIN(2)	AE B S T EY N
ABSTAINED	AH B S T EY N D
ABSTAINED(2)	AE B S T EY N D
ABSTAINER	AH B S T EY N ER
ABSTAINERS	AH B S T EY N ER Z
ABSTAINING	AH B S T EY N IH NG
ABSTAINING(2)	AE B S T EY N IH NG
ABSTAINS	AH B S T EY N Z
ACCLAIM	AH K L EY M
ACCLAIMED	AH K L EY M D
ACCLAIMER	AH K L EY M ER
ACCLAIMERS	AH K L EY M ER Z
ACCLAIMING	AH K L EY M IH NG
ACCLAIMS	AH K L EY M Z
ACQUAINT	AH K W EY N T
ACQUAINTANCE	AH K W EY N T AH N S
ACQUAINTANCES	AH K W EY N T AH N S IH Z
ACQUAINTANCESHIP	AH K W EY N T AH N S SH IH P
ACQUAINTANCESHIPS	AH K W EY N T AH N S SH IH P S
ACQUAINTED	AH K W EY N T IH D
ACQUAINTED(2)	AH K W EY N IH D
ACQUAINTING	AH K W EY N T IH NG
ACQUAINTS	AH K W EY N T S
AFFAIR	AH F EH R
AFFAIRE	AH F EH R
AFFAIRES	AH F EH R Z
AFFAIRS	AH F EH R Z
AFORESAID	AH F AO R S EH D
AFRAID	AH F R EY D
AGAIN	AH G EH N
AGAIN(2)	AH G EY N
AGAINST	AH G EH N S T
AGAINST(2)	AH G EY N S T
AGAPAI	AE G AH P EY
AGNAIL	AE G N EY L
AGNAILS	AE G N EY AH L Z
AI	AY
AI(2)	EY AY
AIBLINS	EY B L AH N Z
AID	EY D
AIDE	EY D
AIDED	EY D IH D
AIDER	EY D ER
AIDERS	EY D ER Z
AIDES	EY D Z
AIDFUL	EY D F AH L
AIDING	EY D IH NG
AIDLESS	EY D L AH S
AIDMAN	EY D M AE N
AIDMEN	EY D M EH N
AIDS	EY D Z
AIGLET	EY G L AH T
AIGLETS	EY G L AH T S
AIGRET	EY G R AH T
AIGRETS	EY G R AH T S
AIGRETTE	EY G R EH T
AIGRETTES	EY G R EH T S
AIGUILLE	EY G W AH L
AIGUILLES	EY G W AH L Z
AIGUILLETTE	EY G W AH L EH T
AIGUILLETTES	EY G W IH L EH T S
AIKIDO	EY K AH D OW
AIKIDOS	EY K AH D AH Z
AIL	EY L
AILANTHUS	EY L AE N TH AH S
AILANTHUSES	EY L AH N TH UW Z AH Z
AILED	EY L D
AILERON	EY L ER AA N
AILERONS	EY L ER AA N Z
AILING	EY L IH NG
AILMENT	EY L M AH N T
AILMENTS	EY L M AH N T S
AILS	EY L Z
AILUROPHILE	EY L UH R AH F AY L
AILUROPHILE(2)	EY L UH R AH F AY AH L
AILUROPHILES	EY L UH R AH F AY L Z
AILUROPHOBE	EY L UH R AH F OW B
AILUROPHOBES	EY L UH R AH F OW B Z
AILUROPHOBIA	EY L AH R AH F OW B IY AH
AILUROPHOBIAS	EY L AH R AH F OW B IY AH Z
AIM	EY M
AIMED	EY M D
AIMER	EY M ER
AIMERS	EY M ER Z
AIMFUL	EY M F AH L
AIMFULLY	AH IH M F UH L IY
AIMING	EY M IH NG
AIMLESS	EY M L AH S
AIMLESSLY	EY M L AH S L IY
AIMLESSNESS	EY M L AH S N AH S
AIMLESSNESSES	EY M L AH S N AH S IH Z
AIMS	EY M Z
AIN	AH IH N
AINS	AH IH N Z
AINSELL	AH IH N S EH L
AINSELLS	AH IH N S EH L Z
AIOLI	EY AH L IY
AIOLIS	EY AH L AH S
AIR	EH R
AIRBAG	EH R B AE G
AIRBAGS	EH R B AE G Z
AIRBOAT	EH R B OW T
AIRBOATS	EH R B OW T S
AIRBORNE	EH R B AO R N
AIRBOUND	AH IH R B AW N D
AIRBRUSH	AH IH R B R AH SH
AIRBRUSHED	AH IH R B R AH SH T
AIRBRUSHES	AH IH R B R AH SH IH Z
AIRBRUSHING	AH IH R B R AH SH IH NG
AIRBURST	AH IH R B ER S T
AIRBURSTS	AH IH R B ER S T S
AIRBUS	EH R B AH S
AIRBUSES	AH IH R B AH S IH Z
AIRBUSSES	AH IH R B AH S IH Z
AIRCHECK	AH IH R CH EH K
AIRCHECKS	AH IH R CH EH K S
AIRCOACH	AH IH R K OW CH
AIRCOACHES	AH IH R K OW CH IH Z
AIRCRAFT	EH R K R AE F T
AIRCREW	EH R K R UW
AIRCREWS	AH IH R K R UW Z
AIRDATE	AH IH R D EY T
AIRDATES	AH IH R D EY T S
AIRDROME	AE AH R D R OW M
AIRDROMES	AE AH R D R OW M Z
AIRDROP	EH R D R AA P
AIRDROPPED	AH IH R D R AA P T
AIRDROPPING	AH IH R D R AA P IH NG
AIRDROPS	EH R D R AA P S
AIRED	EH R D
AIRER	EH R ER
AIRERS	EH R ER Z
AIREST	EH R AH S T
AIRFARE	EH R F EH R
AIRFARES	EH R F EH R Z
AIRFIELD	EH R F IY L D
AIRFIELDS	EH R F IY L D Z
AIRFLOW	EH R F L OW
AIRFLOWS	EH R F L OW Z
AIRFOIL	EH R F OY L
AIRFOILS	EH R F OY L Z
AIRFRAME	EH R F R EY M
AIRFRAMES	EH R F R EY M Z
AIRFREIGHT	EH R F R EY T
AIRFREIGHTED	AH IH R F R EY T IH D
AIRFREIGHTING	AH IH R F R EY T IH NG
AIRFREIGHTS	AH IH R F R EY T S
AIRGLOW	EH R G L OW
AIRGLOWS	AH IH R G L OW Z
AIRHEAD	EH R HH EH D
AIRHEADED	AH IH R HH EH D IH D
AIRHEADS	AH IH R HH EH D Z
AIRHOLE	AH IH R HH OW L
AIRHOLES	AH IH R HH OW L Z
AIRIER	EH R IY ER
AIRIEST	EH R IY AH S T
AIRILY	EH R IY L IY
AIRINESS	EH R IY N AH S
AIRINESSES	EH R IY N AH S IH Z
AIRING	EH R IH NG
AIRINGS	EH R IH NG Z
AIRLESS	EH R L AH S
AIRLESSNESS	EH R L AH S N AH S
AIRLESSNESSES	EH R L AH S N AH S IH Z
AIRLIFT	EH R L IH F T
AIRLIFTED	EH R L IH F T IH D
AIRLIFTING	EH R L IH F T IH NG
AIRLIFTS	EH R L IH F T S
AIRLIKE	EH R L AY K
AIRLINE	EH R L AY N
AIRLINER	EH R L AY N ER
AIRLINERS	EH R L AY N ER Z
AIRLINES	EH R L AY N Z
AIRMAIL	EH R M EY L
AIRMAILED	AH IH R M EY L D
AIRMAILING	AH IH R M EY L IH NG
AIRMAILS	AH IH R M EY L Z
AIRMAN	EH R M AH N
AIRMANSHIP	AH IH R M AE N SH IH P
AIRMANSHIPS	AH IH R M AE N SH IH P S
AIRMEN	EH R M EH N
AIRMOBILE	AH IH R M OW B AH L
AIRN	AE AH R N
AIRNS	AE AH R N Z
AIRPARK	AH IH R P AA R K
AIRPARKS	AH IH R P AA R K S
AIRPLANE	EH R P L EY N
AIRPLANES	EH R P L EY N Z
AIRPLAY	AH IH R P L EY
AIRPLAYS	AH IH R P L EY Z
AIRPORT	EH R P AO R T
AIRPORTS	EH R P AO R T S
AIRPOST	AH IH R P OW S T
AIRPOSTS	AH IH R P OW S T S
AIRPOWER	EH R P AW ER
AIRPOWERS	AH IH R P AW ER Z
AIRPROOF	AH IH R P R UW F
AIRPROOFED	AH IH R P R UW F T
AIRPROOFING	AH IH R P R UW F IH NG
AIRPROOFS	AH IH R P R UW F S
AIRS	EH R Z
AIRSCAPE	AH IH R S K EY P
AIRSCAPES	AH IH R S K EY P S
AIRSCREW	AH IH R S K R UW
AIRSCREWS	AH IH R S K R UW Z
AIRSHED	AH IH R SH EH D
AIRSHEDS	AH IH R SH EH D Z
AIRSHIP	EH R SH IH P
AIRSHIPS	EH R SH IH P S
AIRSICK	AH IH R S IH K
AIRSICKNESS	AH IH R S IH K N AH S
AIRSICKNESSES	AH IH R S IH K N AH S IH Z
AIRSPACE	EH R S P EY S
AIRSPACES	EH R S P EY S IH Z
AIRSPEED	EH R S P IY D
AIRSPEEDS	AH IH R S P IY D Z
AIRSTREAM	AH IH R S T R IY M
AIRSTREAMS	AH IH R S T R IY M Z
AIRSTRIKE	EH R S T R AY K
AIRSTRIKES	EH R S T R AY K S
AIRSTRIP	EH R S T R IH P
AIRSTRIPS	EH R S T R IH P S
AIRT	AE AH R T
AIRTED	AH IH R T EH D
AIRTH	EH R TH
AIRTHED	EH R TH T
AIRTHING	AH IH R TH IH NG
AIRTHS	EH R TH S
AIRTIGHT	EH R T AY T
AIRTIGHTNESS	AH IH R T AY T N AH S
AIRTIGHTNESSES	AH IH R T AY T N AH S IH Z
AIRTIME	EH R T AY M
AIRTIMES	AH IH R T AY M Z
AIRTING	AE AH R T AH NG
AIRTS	AE AH R T S
AIRWARD	EH R W ER D
AIRWAVE	EH R W EY V
AIRWAVES	EH R W EY V Z
AIRWAY	EH R W EY
AIRWAYS	EH R W EY Z
AIRWISE	EH R W AY Z
AIRWOMAN	AH IH R W UH M AH N
AIRWOMEN	AH IH R W IH M AH N
AIRWORTHIER	EH R W ER DH IY ER
AIRWORTHIEST	EH R W ER DH IY AH S T
AIRWORTHINESS	EH R W ER DH IY N AH S
AIRWORTHINESSES	EH R W ER DH IY N AH S IH Z
AIRWORTHY	EH R W ER DH IY
AIRY	EH R IY
AIS	AY Z
AISLE	AY L
AISLE(2)	AY AH L
AISLED	AY L D
AISLES	AY L Z
AISLES(2)	AY AH L Z
AISLEWAY	AY L W EY
AISLEWAYS	AY L W EY Z
AIT	EY T
AITCH	AH IH CH
AITCHBONE	AH IH CH B OW N
AITCHBONES	AH IH CH B OW N Z
AITCHES	AH IH CH IH Z
AITS	EY T S
AIVER	EY AH V AH R
AIVERS	EY V AH R Z
ALCAIC	AE L K EY AH K
ALCAICS	AE L K EY AH S Z
ALCAIDE	AE L K EY D
ALCAIDES	AE L K EY D Z
ALGEBRAIC	AE L JH AH B R EY IH K
ALGEBRAICALLY	AE L JH AH B R EY IH K L IY
ALGEBRAIST	AE L JH AH B R AH IH S T
ALGEBRAISTS	AE L JH AH B R AH IH S T S
AMAIN	AH M EY N
ANTIAIR	AE N T AY EH R
ANTIAIRCRAFT	AE N T AY EH R K R AE F T
ANTIAIRCRAFTS	AE N T AY AH IH R K R AE F T S
APOTROPAIC	AH P AA T R AH P EY AH K
APOTROPAICALLY	AH P AA T R AH P AH K AE L IY
APPERTAIN	AE P AH R T EY N
APPERTAINED	AE P AH R T EY N D
APPERTAINING	AE P AH R T EY N AH NG
APPERTAINS	AE P AH R T EY N Z
APPRAISAL	AH P R EY Z AH L
APPRAISALS	AH P R EY Z AH L Z
APPRAISE	AH P R EY Z
APPRAISED	AH P R EY Z D
APPRAISEE	AH P R EY Z IY
APPRAISEES	AH P R EY Z IY Z
APPRAISEMENT	AH P R EY Z M AH N T
APPRAISEMENTS	AH P R EY Z M AH N T S
APPRAISER	AH P R EY Z ER
APPRAISERS	AH P R EY Z ER Z
APPRAISES	AH P R EY Z IH Z
APPRAISING	AH P R EY Z IH NG
APPRAISINGLY	AH P R EY Z IH NG L IY
APPRAISIVE	AH P R EY Z IH V
ARAPAIMA	AE R AH P EY M AH
ARAPAIMAS	AE R AH P EY M AH Z
ARCHAIC	AA R K EY IH K
ARCHAICALLY	AA R K EY IH K AH L IY
ARCHAISE	AA R K EY Z
ARCHAISED	AA R K HH EY Z D
ARCHAISES	AA R K HH EY Z IH Z
ARCHAISING	AA R K HH EY Z IH NG
ARCHAISM	AA R K EY IH Z AH M
ARCHAISMS	AA R K EY IH Z AH M Z
ARCHAIST	AA R K EY AH S T
ARCHAISTIC	AA R K EY S T AH K
ARCHAISTS	AA R K EY S T S
ARCHAIZE	AA R K EY AY Z
ARCHAIZED	AA R K EY AY Z D
ARCHAIZES	AA R K EY AY Z IH Z
ARCHAIZING	AA R K EY AY Z IH NG
ARMCHAIR	AA R M CH EH R
ARMCHAIRS	AA R M CH EH R Z
ARRAIGN	ER EY N
ARRAIGNED	ER EY N D
ARRAIGNING	AH R EY N IH NG
ARRAIGNMENT	ER EY N M AH N T
ARRAIGNMENTS	ER EY N M AH N T S
ARRAIGNS	AH R EY N Z
ASCERTAIN	AE S ER T EY N
ASCERTAINABLE	AE S ER T EY N AH B AH L
ASCERTAINED	AE S ER T EY N D
ASCERTAINING	AE S ER T EY N IH NG
ASCERTAINMENT	AE S ER T EY N M AH N T
ASCERTAINMENTS	AE S ER T EY N M AH N T S
ASCERTAINS	AE S ER T EY N Z
ASSAGAI	AE S AH G EY
ASSAGAIED	AE S AH G EY D
ASSAGAIING	AE S AH G EY IH NG
ASSAGAIS	AE S AH G EY Z
ASSAI	AA S AY
ASSAIL	AH S EY L
ASSAILABLE	AH S EY L AH B AH L
ASSAILANT	AH S EY L AH N T
ASSAILANTS	AH S EY L AH N T S
ASSAILED	AH S EY L D
ASSAILER	AH S EY L ER
ASSAILERS	AH S EY L ER Z
ASSAILING	AH S EY L IH NG
ASSAILS	AH S EY L Z
ASSAIS	AE S EY Z
ASSEGAI	AE S AH G EY
ASSEGAIED	AE S AH G EY D
ASSEGAIING	AE S EH G EY AH NG
ASSEGAIS	AE S EH G EY AH S
ATTAIN	AH T EY N
ATTAINABILITIES	AH T EY N AH B IH L AH T EH Z
ATTAINABILITY	AH T EY N AH B IH L AH T EH
ATTAINABLE	AH T EY N AH B AH L
ATTAINDER	AH T EY N D ER
ATTAINDERS	AE T EY N D AH R Z
ATTAINED	AH T EY N D
ATTAINER	AH T EY N ER
ATTAINERS	AH T EY N ER Z
ATTAINING	AH T EY N IH NG
ATTAINMENT	AH T EY N M AH N T
ATTAINMENTS	AH T EY N M AH N T S
ATTAINS	AH T EY N Z
ATTAINT	AE T EY N T
ATTAINTED	AH T EY N T EH D
ATTAINTING	AE T EY N T AH NG
ATTAINTS	AE T EY N T S
ATWAIN	AH T W EY N
AVAIL	AH V EY L
AVAILABILITIES	AH V EY L AH B IH L IH T IY Z
AVAILABILITY	AH V EY L AH B IH L AH T IY
AVAILABILITY(2)	AH V EY L AH B IH L IH T IY
AVAILABLE	AH V EY L AH B AH L
AVAILABLENESS	AH V EY L AH B AH L N AH S
AVAILABLENESSES	AH V EY L AH B AH L N AH S IH Z
AVAILABLY	AH V EY L AH B L IY
AVAILED	AH V EY L D
AVAILING	AH V EY L IH NG
AVAILS	AH V EY L Z
AVENTAIL	AH V EH N T EY L
AVENTAILS	AH V EH N T EY L Z
AWAIT	AH W EY T
AWAITED	AH W EY T IH D
AWAITER	AH W EY T ER
AWAITERS	AH W EY T ER Z
AWAITING	AH W EY T IH NG
AWAITS	AH W EY T S
BAAING	B AA AH NG
BACKSTAIRS	B AE K S T EH R Z
BAIDARKA	B EY D AA R K AH
BAIDARKAS	B EY D AA R K AH Z
BAIL	B EY L
BAILABLE	B EY L AH B AH L
BAILED	B EY L D
BAILEE	B EY L IY
BAILEES	B EY L IY Z
BAILER	B EY L ER
BAILERS	B EY L ER Z
BAILEY	B EY L IY
BAILEYS	B EY L IY Z
BAILIE	B EY L IY
BAILIES	B EY L IY Z
BAILIFF	B EY L IH F
BAILIFFS	B EY L IH F S
BAILIFFSHIP	B EY L AH F SH IH P
BAILIFFSHIPS	B EY L AH F SH IH P S
BAILING	B EY L IH NG
BAILIWICK	B EY L IH W IH K
BAILIWICKS	B EY L AH W AH K S
BAILMENT	B EY L M AH N T
BAILMENTS	B EY L M AH N T S
BAILOR	B EY L ER
BAILORS	B EY L ER Z
BAILOUT	B EY L AW T
BAILOUTS	B EY L AW T S
BAILS	B EY L Z
BAILSMAN	B EY L Z M AE N
BAILSMEN	B EY L Z M EH N
BAIRN	B AE AH R N
BAIRNISH	B AE AH R N AH SH
BAIRNLIER	B AE AH R N L AY AH R
BAIRNLIEST	B AE AH R N L AY AH S T
BAIRNLY	B AE AH R N L IY
BAIRNS	B AE AH R N Z
BAIT	B EY T
BAITED	B EY T IH D
BAITER	B EY T ER
BAITERS	B EY T ER Z
BAITH	B EY TH
BAITING	B EY T IH NG
BAITS	B EY T S
BAIZA	B EY Z AH
BAIZAS	B EY Z AH Z
BAIZE	B EY Z
BAIZES	B EY AY Z AH Z
BALALAIKA	B AE L AH L EY K AH
BALALAIKAS	B AE L AH L EY K AH Z
BANDAID	B AE N D EY D
BANDAIDS	B AE N D EY D Z
BANGTAIL	B AE NG T EY L
BANGTAILS	B AE NG T EY L Z
BANZAI	B AE N Z EY
BANZAIS	B AE N Z EY AH S
BARGAIN	B AA R G AH N
BARGAIN(2)	B AA R G IH N
BARGAINED	B AA R G AH N D
BARGAINER	B AA R G IH N ER
BARGAINERS	B AA R G IH N ER Z
BARGAINING	B AA R G IH N IH NG
BARGAINS	B AA R G AH N Z
BARGAINS(2)	B AA R G IH N Z
BARMAID	B AA R M EY D
BARMAIDS	B AA R M EY D Z
BATTAILOUS	B AE T EY L AH S
BEARBAITING	B AE ER B EY T IH NG
BEARBAITINGS	B AE ER B EY T IH NG Z
BEDCHAIR	B EH D CH EH ER
BEDCHAIRS	B EH D CH EH ER Z
BEDRAIL	B EH D R EY L
BEDRAILS	B EH D R EY L Z
BEFLEAING	B IH F L IY IH NG
BENZOCAINE	B IH N Z AH K EY N
BENZOCAINES	B IH N Z AH K EY N Z
BEPAINT	B IH P EY N T
BEPAINTED	B IH P EY N T IH D
BEPAINTING	B IH P EY N T IH NG
BEPAINTS	B IH P EY N T S
BETAINE	B AH T EY N
BETAINES	B AH T EY N Z
BETWEENBRAIN	B IH T W IY N B R EY N
BETWEENBRAINS	B IH T W IY N B R EY N Z
BEWAIL	B IH W EY L
BEWAILED	B IH W EY L D
BEWAILER	B IH W EY L ER
BEWAILERS	B IH W EY L ER Z
BEWAILING	B IH W EY L IH NG
BEWAILS	B IH W EY L Z
BILLIONAIRE	B IH L Y AH N EH R
BILLIONAIRES	B IH L Y AH N EH R Z
BIOAVAILABILITIES	B AY AH V AH L AH B IH L AH T AY Z
BIOAVAILABILITY	B AY AH V EY AH L AH B IH L AH T IY
BIOAVAILABLE	B AY OW V EY IH L AH B AH L
BIRDBRAIN	B ER D B R EY N
BIRDBRAINED	B ER D B R EY N D
BIRDBRAINS	B ER D B R EY N Z
BLACKMAIL	B L AE K M EY L
BLACKMAILED	B L AE K M EY L D
BLACKMAILER	B L AE K M EY L ER
BLACKMAILERS	B L AE K M EY L ER Z
BLACKMAILING	B L AE K M EY L IH NG
BLACKMAILS	B L AE K M EY L Z
BLACKTAIL	B L AE K T EY L
BLACKTAILS	B L AE K T EY L Z
BLAIN	B L EY N
BLAINS	B L EY N Z
BLOODSTAIN	B L AH D S T EY N
BLOODSTAINED	B L AH D S T EY N D
BLOODSTAINS	B L AH D S T EY N Z
BOARDSAILING	B OW R D S EY L IH NG
BOARDSAILINGS	B OW R D S EY L IH NG Z
BOARDSAILOR	B OW R D S EY L ER
BOARDSAILORS	B OW R D S EY L ER Z
BOATSWAIN	B OW T S W EY N
BOATSWAINS	B OW S AH N Z
BOBTAIL	B AA B T EY L
BOBTAILED	B AA B T EY L D
BOBTAILING	B AA B T EY L IH NG
BOBTAILS	B AA B T EY L Z
BONDMAID	B AA N D M EY D
BONDMAIDS	B AA N D M EY D Z
BONSAI	B AA N S AY
BONSAIS	B AA N S EY AH S
BOUGAINVILLAEA	B AW G EY N V IH L IY AH
BOUGAINVILLAEAS	B AW G EY N V IH L IY AH Z
BOUGAINVILLEA	B UW G EY N V IH L IY AH
BOUGAINVILLEAS	B AW G EY N V IH L IY Z
BOUILLABAISSE	B AW IH L AH B EY S
BOUILLABAISSES	B AW IH L AH B EY S AH Z
BRAID	B R EY D
BRAIDED	B R EY D IH D
BRAIDER	B R EY D ER
BRAIDERS	B R EY D ER Z
BRAIDING	B R EY D IH NG
BRAIDINGS	B R EY D IH NG Z
BRAIDS	B R EY D Z
BRAIL	B R EY L
BRAILED	B R EY AH L D
BRAILING	B R EY L IH NG
BRAILLE	B R EY L
BRAILLED	B R EY L D
BRAILLES	B R EY L Z
BRAILLEWRITER	B R EY L R AY T ER
BRAILLEWRITERS	B R EY L R AY T ER Z
BRAILLING	B R EY L IH NG
BRAILLIST	B R EY L IH S T
BRAILLISTS	B R EY L IH S T S
BRAILS	B R EY AH L Z
BRAIN	B R EY N
BRAINCASE	B R EY N K EY S
BRAINCASES	B R EY N K EY S IH Z
BRAINCHILD	B R EY N CH AY L D
BRAINCHILDREN	B R EY N CH IH L D R AH N
BRAINED	B R EY N D
BRAINIAC	B R EY N IY AH K
BRAINIACS	B R EY N IY AH S
BRAINIER	B R EY N IY ER
BRAINIEST	B R EY N IY AH S T
BRAINILY	B R EY N IY L IY
BRAININESS	B R EY N IY N AH S
BRAININESSES	B R EY N IY N AH S IH Z
BRAINING	B R EY N IH NG
BRAINISH	B R EY N IH SH
BRAINLESS	B R EY N L IH S
BRAINLESSLY	B R EY N L AH S L IY
BRAINLESSNESS	B R EY N L AH S N AH S
BRAINLESSNESSES	B R EY N L AH S N AH S IH Z
BRAINPAN	B R EY N P AE N
BRAINPANS	B R EY N P AE N Z
BRAINPOWER	B R EY N P AW ER
BRAINPOWERS	B R EY N P AW ER Z
BRAINS	B R EY N Z
BRAINSICK	B R EY N S IH K
BRAINSICKLY	B R EY N S IH K L IY
BRAINSTORM	B R EY N S T AO R M
BRAINSTORMED	B R EY N S T AO R M D
BRAINSTORMER	B R EY N S T AO R M ER
BRAINSTORMERS	B R EY N S T AO R M ER Z
BRAINSTORMING	B R EY N S T AO R M IH NG
BRAINSTORMINGS	B R EY N S T AO R M IH NG Z
BRAINSTORMS	B R EY N S T AO R M Z
BRAINTEASER	B R EY N T IY Z ER
BRAINTEASERS	B R EY N T IY Z ER Z
BRAINWASH	B R EY N W AA SH
BRAINWASHED	B R EY N W AA SH T
BRAINWASHER	B R EY N W AA SH ER
BRAINWASHERS	B R EY N W AA SH ER Z
BRAINWASHES	B R EY N W AA SH AH Z
BRAINWASHING	B R EY N W AA SH IH NG
BRAINWASHINGS	B R EY N W AA SH IH NG Z
BRAINY	B R EY N IY
BRAISE	B R EY Z
BRAISED	B R EY Z D
BRAISES	B R EY Z IH Z
BRAISING	B R EY Z IH NG
BRAIZE	B R EY AY Z
BRAIZES	B R EY AY Z IH Z
BRANTAIL	B R AE N T EY L
BRANTAILS	B R AE N T EY L Z
BRIDESMAID	B R AY D Z M EY D
BRIDESMAIDS	B R AY D Z M EY D Z
BRISTLETAIL	B R IH S AH L T EY L
BRISTLETAILS	B R IH S AH L T EY L Z
BROADTAIL	B R AO D T EY L
BROADTAILS	B R AO D T EY L Z
BROMELAIN	B R AA M AH L EY N
BROMELAINS	B R AA M AH L EY N Z
BUCKTAIL	B AH K T EY L
BUCKTAILS	B AH K T EY L Z
BULLBAITING	B UH L B EY T IH NG
BULLBAITINGS	B UH L B EY T IH NG Z
CAID	K EY D
CAIDS	K EY D Z
CAIMAN	K EY M AH N
CAIMANS	K EY M AH N Z
CAIN	K EY N
CAINS	K EY N Z
CAIQUE	K EY K
CAIQUES	K EY K S
CAIRD	K AE AH R D
CAIRDS	K AE AH R D Z
CAIRN	K EH R N
CAIRNED	K AE ER N D
CAIRNGORM	K AE AH R N G AH R M
CAIRNGORMS	K AE AH R N G AH R M Z
CAIRNS	K EH R N Z
CAIRNY	K AE ER N IY
CAISSON	K EY S AH N
CAISSON(2)	K EH S AH N
CAISSONS	K EY S AH N Z
CAISSONS(2)	K EH S AH N Z
CAITIFF	K EY T AH F
CAITIFFS	K EY T AH F S
CAMAIL	K AE M EY L
CAMAILED	K AE M EY L D
CAMAILS	K AE M EY L Z
CAMPAIGN	K AE M P EY N
CAMPAIGNED	K AE M P EY N D
CAMPAIGNER	K AE M P EY N ER
CAMPAIGNERS	K AE M P EY N ER Z
CAMPAIGNING	K AE M P EY N IH NG
CAMPAIGNS	K AE M P EY N Z
CANAILLE	K AH N EY L
CANAILLES	K AH N EY L Z
CANTRAIP	K AE N T R EY P
CANTRAIPS	K AE N T R EY P S
CAPERCAILLIE	K AE P AH R K EY L AY
CAPERCAILLIES	K AH P AH R K EY L AY Z
CAPERCAILZIE	K AE P ER K EY L Z IY
CAPERCAILZIES	K AE P ER K EY L Z IY Z
CAPSAICIN	K AE P S EY S AH N
CAPSAICINS	K AE P S EY S AH N Z
CAPTAIN	K AE P T AH N
CAPTAINCIES	K AE P T AH N S IY Z
CAPTAINCY	K AE P T AH N S IY
CAPTAINED	K AE P T AH N D
CAPTAINING	K AE P T AH N IH NG
CAPTAINS	K AE P T AH N Z
CAPTAINSHIP	K AE P T AH N SH IH P
CAPTAINSHIPS	K AE P T AH N SH IH P S
CARAVANSERAI	K AE R AH V AE N S AH R EY
CARAVANSERAIS	K AE R AH V AE N Z IH R AH IY Z
CATTAIL	K AE T EY L
CATTAILS	K AE T EY L Z
CENTAI	S EH N T EY
CERTAIN	S ER T AH N
CERTAINER	S ER T AH N ER
CERTAINEST	S ER T AH N AH S T
CERTAINLY	S ER T AH N L IY
CERTAINTIES	S ER T AH N T IY Z
CERTAINTY	S ER T AH N T IY
CHAIN	CH EY N
CHAINE	CH EY N
CHAINED	CH EY N D
CHAINES	CH EY N Z
CHAINING	CH EY N IH NG
CHAINMAN	CH EY N M AE N
CHAINMEN	CH EY N M EH N
CHAINS	CH EY N Z
CHAINSAW	CH EY N S AO
CHAINSAWED	CH EY N S AO D
CHAINSAWING	CH EY N S AO IH NG
CHAINSAWS	CH EY N S AO Z
CHAINWHEEL	CH EY N W IY L
CHAINWHEELS	CH EY N W IY L Z
CHAIR	CH EH R
CHAIRED	CH EH R D
CHAIRING	CH EH R IH NG
CHAIRLIFT	CH EH ER L IH F T
CHAIRLIFTS	CH EH ER L IH F T S
CHAIRMAN	CH EH R M AH N
CHAIRMANED	CH EH ER M EY N D
CHAIRMANING	CH EH ER M EY N IH NG
CHAIRMANNED	CH EH ER M AE N D
CHAIRMANNING	CH EH ER M AE N IH NG
CHAIRMANS	CH EH ER M AE N Z
CHAIRMANSHIP	CH EH R M AH N SH IH P
CHAIRMANSHIPS	CH EH R M AH N SH IH P S
CHAIRMEN	CH EH R M IH N
CHAIRPERSON	CH EH R P ER S AH N
CHAIRPERSONS	CH EH ER P ER S AH N Z
CHAIRS	CH EH R Z
CHAIRWOMAN	CH EH R W UH M AH N
CHAIRWOMEN	CH EH R W IH M EH N
CHAISE	SH EY Z
CHAISES	SH EY Z IH Z
CHAMBERLAIN	CH EY M B ER L AH N
CHAMBERLAIN(2)	CH EY M B ER L IH N
CHAMBERLAINS	CH EY M B ER L AH N Z
CHAMBERMAID	CH EY M B ER M EY D
CHAMBERMAIDS	CH EY M B ER M EY D Z
CHAMPAIGN	CH AE M P EY N
CHAMPAIGNS	CH AE M P EY N Z
CHAPLAIN	CH AE P L AH N
CHAPLAINCIES	CH AE P L EY N S AY Z
CHAPLAINCY	CH AE P L EY N S IY
CHAPLAINS	CH AE P L AH N Z
CHARPAI	CH AA R P EY
CHARPAIS	CH AA R P EY Z
CHATELAIN	CH AE T AH L EY N
CHATELAINE	CH AE T AH L EY N
CHATELAINES	CH AE T AH L EY N Z
CHATELAINS	CH AE T AH L EY N Z
CHIEFTAIN	CH IY F T AH N
CHIEFTAINCIES	CH IY F T EY N S AY Z
CHIEFTAINCY	CH IY F T EY N S IY
CHIEFTAINS	CH IY F T AH N Z
CHIEFTAINSHIP	CH IY F T AH N SH IH P
CHIEFTAINSHIPS	CH IY F T AH N SH IH P S
CHIGETAI	CH IH JH AH T EY
CHIGETAIS	CH AH JH EH T EY AH S
CHILBLAIN	CH IH L B L EY N
CHILBLAINS	CH IH L B L EY N Z
CINQUAIN	S IH NG K W EY N
CINQUAINS	S IH NG K W EY N Z
CLAIM	K L EY M
CLAIMABLE	K L EY M AH B AH L
CLAIMANT	K L EY M AH N T
CLAIMANTS	K L EY M AH N T S
CLAIMED	K L EY M D
CLAIMER	K L EY M ER
CLAIMERS	K L EY M ER Z
CLAIMING	K L EY M IH NG
CLAIMS	K L EY M Z
CLAIRAUDIENCE	K L AE AH R AO D IY AH N S
CLAIRAUDIENCES	K L AE AH R AO D IY EH N S AH Z
CLAIRAUDIENT	K L AE AH R AO D IY AH N T
CLAIRAUDIENTLY	K L AE AH R AH D IY N T L IY
CLAIRVOYANCE	K L EH R V OY AH N S
CLAIRVOYANCES	K L AE ER V OY AH N S IH Z
CLAIRVOYANT	K L EH R V OY AH N T
CLAIRVOYANTLY	K L AE ER V OY AH N T L IY
CLAIRVOYANTS	K L AE ER V OY AH N T S
COATTAIL	K OW T T EY L
COATTAILS	K OW T T EY L Z
COCAIN	K OW K EY N
COCAINE	K OW K EY N
COCAINES	K OW K EY N Z
COCAINIZATION	K OW K EY N AH Z EY SH AH N
COCAINIZATIONS	K OW K EY N AH Z EY SH AH N Z
COCAINIZE	K OW K EY N AY Z
COCAINIZED	K OW K EY N AY Z D
COCAINIZES	K OW K EY N AY Z IH Z
COCAINIZING	K OW K EY N AY Z IH NG
COCAINS	K OW K EY N Z
COCAPTAIN	K OW K AE P T AH N
COCAPTAINED	K OW K AE P T AH N D
COCAPTAINING	K OW K AE P T AH N IH NG
COCAPTAINS	K OW K AE P T AH N Z
COCHAIR	K OW CH EH ER
COCHAIRED	K OW CH EH ER D
COCHAIRING	K OW CH EH ER IH NG
COCHAIRMAN	K OW CH EH R M AH N
COCHAIRMEN	K OW CH EH ER M EH N
COCHAIRPERSON	K OW CH EH ER P ER S AH N
COCHAIRPERSONS	K OW CH EH ER P ER S AH N Z
COCHAIRS	K OW CH EH ER Z
COCHAIRWOMAN	K OW CH EH ER W UH M AH N
COCHAIRWOMEN	K OW CH EH ER W IH M AH N
COCKTAIL	K AA K T EY L
COCKTAILED	K AA K T EY L D
COCKTAILING	K AA K T EY L IH NG
COCKTAILS	K AA K T EY L Z
COMMISSIONAIRE	K AH M IH SH AH N AH AY ER
COMMISSIONAIRES	K AH M IH SH AH N AH AY ER Z
COMPLAIN	K AH M P L EY N
COMPLAINANT	K AH M P L EY N AH N T
COMPLAINANTS	K AH M P L EY N AH N T S
COMPLAINED	K AH M P L EY N D
COMPLAINER	K AH M P L EY N ER
COMPLAINERS	K AA M P L EY N ER Z
COMPLAINING	K AH M P L EY N IH NG
COMPLAININGLY	K AH M P L EY N IH NG L IY
COMPLAINS	K AH M P L EY N Z
COMPLAINT	K AH M P L EY N T
COMPLAINTS	K AH M P L EY N T S
COMPLAISANCE	K AH M P L EY S AH N S
COMPLAISANCES	K AH M P L EY S AH N S IH Z
COMPLAISANT	K AH M P L EY S AH N T
COMPLAISANTLY	K AH M P L EY S AH N T L IY
CONCESSIONAIRE	K AH N S EH SH AH N EH R
CONCESSIONAIRES	K AH N S EH SH AH N EH R Z
CONGAING	K AA N G EY AH NG
CONSTRAIN	K AH N S T R EY N
CONSTRAINED	K AH N S T R EY N D
CONSTRAINEDLY	K AH N S T R EY N AH D L IY
CONSTRAINING	K AH N S T R EY N IH NG
CONSTRAINS	K AH N S T R EY N Z
CONSTRAINT	K AH N S T R EY N T
CONSTRAINTS	K AH N S T R EY N T S
CONTAIN	K AH N T EY N
CONTAINABLE	K AH N T EY N AH B AH L
CONTAINED	K AH N T EY N D
CONTAINER	K AH N T EY N ER
CONTAINERBOARD	K AH N T EY N ER B AO R D
CONTAINERBOARDS	K AH N T EY N ER B OW R D Z
CONTAINERISATION	K AH N T EY N AH R IY Z EY SH AH N
CONTAINERISATIONS	K AH N T EY N AH R IY Z EY SH AH N Z
CONTAINERISE	K AA N T EY N AH R AY Z
CONTAINERISED	K AH N T EY N AH R IY Z D
CONTAINERISES	K AH N T EY N AH R IY Z IH Z
CONTAINERISING	K AH N T EY N AH R IY Z IH NG
CONTAINERIZATION	K AH N T EY N ER AH Z EY SH AH N
CONTAINERIZATIONS	K AH N T EY N ER AH Z EY SH AH N Z
CONTAINERIZE	K AH N T EY N ER AY Z
CONTAINERIZED	K AH N T EY N ER AY Z D
CONTAINERIZES	K AH N T EY N ER AY Z IH Z
CONTAINERIZING	K AH N T EY N ER AY Z IH NG
CONTAINERLESS	K AH N T EY N ER L AH S
CONTAINERPORT	K AH N T EY N ER P OW R T
CONTAINERPORTS	K AH N T EY N ER P OW R T S
CONTAINERS	K AH N T EY N ER Z
CONTAINERSHIP	K AH N T EY N ER SH IH P
CONTAINERSHIPS	K AH N T EY N ER SH IH P S
CONTAINING	K AH N T EY N IH NG
CONTAINMENT	K AH N T EY N M AH N T
CONTAINMENTS	K AH N T EY N M AH N T S
CONTAINS	K AH N T EY N Z
CONTRAIL	K AH N T R EY L
CONTRAILS	K AH N T R EY L Z
CONTRAINDICATE	K AA N T R AH IH N D AH K AH T
CONTRAINDICATED	K AA N T R AH IH N D AH K EY T IH D
CONTRAINDICATES	K AA N T R AH IH N D AH K AH T S
CONTRAINDICATING	K AA N T R AH IH N D AH K EY T IH NG
CONTRAINDICATION	K AA N T R AH IH N D AH K EY SH AH N
CONTRAINDICATIONS	K AA N T R AH IH N D AH K EY SH AH N Z
COPAIBA	K OW P EY B AH
COPAIBAS	K OW P EY B AH Z
CORDWAIN	K AA R D W EY N
CORDWAINER	K AA R D W EY N AH R
CORDWAINERIES	K AA R D W EY N AH R AY Z
CORDWAINERS	K AA R D W EY N AH R Z
CORDWAINERY	K AA R D W AH N EH R IY
CORDWAINS	K AA R D W EY N Z
CORSAIR	K AO R S EH R
CORSAIRS	K AA R S AE AH R Z
COTTONTAIL	K AA T AH N T EY L
COTTONTAILS	K AA T AH N T EY L Z
COUNTERCAMPAIGN	K AW N T ER K AE M P EY N
COUNTERCAMPAIGNS	K AW N T ER K AE M P EY N Z
COUNTERCLAIM	K AW N T ER K L EY M
COUNTERCLAIMED	K AW N T ER K L EY M D
COUNTERCLAIMING	K AW N T ER K L EY M IH NG
COUNTERCLAIMS	K AW N T ER K L EY M Z
COUNTERCOMPLAINT	K AW N T ER K AH M P L EY N T
COUNTERCOMPLAINTS	K AW N T ER K AH M P L EY N T S
COUNTERRAID	K AW N T ER R EY D
COUNTERRAIDED	K AW N T ER R EY D IH D
COUNTERRAIDING	K AW N T ER R EY D IH NG
COUNTERRAIDS	K AW N T ER R EY D Z
COUNTERSTAIN	K AW N T ER S T EY N
COUNTERSTAINED	K AW N T ER S T EY N D
COUNTERSTAINING	K AW N T ER S T EY N IH NG
COUNTERSTAINS	K AW N T ER S T EY N Z
COUNTERVAIL	K AW N T ER V EY L
COUNTERVAILED	K AW N T ER V EY L D
COUNTERVAILING	K AW N T ER V EY L IH NG
COUNTERVAILS	K AW N T ER V EY L Z
COXSWAIN	K AA Z S W EY N
COXSWAINED	K AA Z S W EY N D
COXSWAINING	K AA Z S W EY N AH NG
COXSWAINS	K AA Z S W EY N Z
CRACKBRAIN	K R AE K B R EY N
CRACKBRAINED	K R AE K B R EY N D
CRACKBRAINS	K R AE K B R EY N Z
CREMAINS	K R AH M EY N Z
CROSSHAIR	K R AO S HH EH R
CROSSHAIRS	K R AO S HH EH R Z
CUPOLAING	K Y UW P AA L EY AH NG
CURTAIL	K ER T EY L
CURTAILED	K ER T EY L D
CURTAILER	K ER T EY L ER
CURTAILERS	K ER T EY L ER Z
CURTAILING	K ER T EY L IH NG
CURTAILMENT	K ER T EY L M AH N T
CURTAILMENTS	K ER T EY L M AH N T S
CURTAILS	K ER T EY L Z
CURTAIN	K ER T AH N
CURTAINED	K ER T AH N D
CURTAINING	K ER T AH N IH NG
CURTAINLESS	K ER T AH N L AH S
CURTAINS	K ER T AH N Z
DADAISM	D AA D AA IH Z AH M
DADAISMS	D AA D AA IH Z AH M Z
DADAIST	D AA D AA IH S T
DADAISTIC	D AA D AA IH S T IH K
DADAISTS	D AA D AA IH S T S
DAIKER	D EY K AH R
DAIKERED	D EY K IY R D
DAIKERING	D EY K IY R AH NG
DAIKERS	D EY K AH R Z
DAIKON	D EY K AH N
DAIKONS	D EY K AH N Z
DAILIES	D EY L IY Z
DAILINESS	D EY L IY N AH S
DAILINESSES	D EY L IY N AH S IH Z
DAILY	D EY L IY
DAIMEN	D EY M AH N
DAIMIO	D EY M IY OW
DAIMIOS	D EY M IY AH Z
DAIMON	D EY M AH N
DAIMONES	D EY M OW N Z
DAIMONIC	D EY M AH N AH K
DAIMONS	D EY M AH N Z
DAIMYO	D EY M AY OW
DAIMYOS	D EY M AY AH Z
DAINTIER	D EY N T IY ER
DAINTIES	D EY N T IY Z
DAINTIEST	D EY N T IY AH S T
DAINTILY	D EY N T IY L IY
DAINTINESS	D EY N T IY N AH S
DAINTINESSES	D EY N T IY N AH S IH Z
DAINTY	D EY N T IY
DAIQUIRI	D AE K ER IY
DAIQUIRIS	D EY K W AH R AH S
DAIRIES	D EH R IY Z
DAIRY	D EH R IY
DAIRYING	D EH R IY IH NG
DAIRYINGS	D EH R IY IH NG Z
DAIRYMAID	D EH R IY M EY D
DAIRYMAIDS	D EH R IY M EY D Z
DAIRYMAN	D EH R IY M AE N
DAIRYMEN	D EY R IY M AH N
DAIS	D EY Z
DAISES	D EY AH S IH Z
DAISHIKI	D EY SH AH K IY
DAISHIKIS	D EY AH S HH AY K IY Z
DAISIED	D EY Z IY D
DAISIES	D EY Z IY Z
DAISY	D EY Z IY
DEAIR	D IY EH R
DEAIRED	D IY EH R D
DEAIRING	D IY EH R IH NG
DEAIRS	D IY EH R Z
DEBONAIR	D EH B AH N EH R
DEBONAIRLY	D EH B AH N EH R L IY
DEBONAIRNESS	D EH B AH N EH R N AH S
DEBONAIRNESSES	D EH B AH N EH R N AH S IH Z
DECLAIM	D IH K L EY M
DECLAIMED	D IH K L EY M D
DECLAIMER	D IY K L EY M ER
DECLAIMERS	D IY K L EY M ER Z
DECLAIMING	D IY K L EY M IH NG
DECLAIMS	D IY K L EY M Z
DEFLEAING	D IY F L IY IH NG
DELAINE	D IH L EY N
DELAINES	D AH L EY N Z
DELTAIC	D EH L T EY IH K
DEMIMONDAINE	D AH M IH M AH N D EY N
DEMIMONDAINES	D AH M IH M AH N D EY N Z
DEPAINT	D IY P EY N T
DEPAINTED	D IY P EY N T IH D
DEPAINTING	D IY P EY N T IH NG
DEPAINTS	D IY P EY N T S
DERAIGN	D AH R EY N
DERAIGNED	D AH R EY N D
DERAIGNING	D AH R EY N AH NG
DERAIGNS	D AH R EY N Z
DERAIL	D IH R EY L
DERAILED	D IH R EY L D
DERAILING	D IH R EY L IH NG
DERAILLEUR	D AH R EY L AH R
DERAILLEURS	D AH R EY L IY Y AH R Z
DERAILMENT	D IH R EY L M AH N T
DERAILMENTS	D IH R EY L M AH N T S
DERAILS	D IH R EY L Z
DESPAIR	D IH S P EH R
DESPAIRED	D IH S P EH R D
DESPAIRER	D IH S P EH R ER
DESPAIRERS	D IH S P EH R ER Z
DESPAIRING	D IH S P EH R IH NG
DESPAIRINGLY	D IH S P EH R IH NG L IY
DESPAIRS	D IH S P EH R Z
DESTAIN	D IY S T EY N
DESTAINED	D IY S T EY N D
DESTAINING	D IY S T EY N IH NG
DESTAINS	D IY S T EY N Z
DETAIL	D IH T EY L
DETAIL(2)	D IY T EY L
DETAILED	D IH T EY L D
DETAILEDLY	D IH T EY L AH D L IY
DETAILEDNESS	D IH T EY L AH D N AH S
DETAILEDNESSES	D IH T EY L AH D N AH S IH Z
DETAILER	D IY T EY L ER
DETAILERS	D IH T EY L ER Z
DETAILING	D IH T EY L IH NG
DETAILS	D IH T EY L Z
DETAILS(2)	D IY T EY L Z
DETAIN	D IH T EY N
DETAINED	D IH T EY N D
DETAINEE	D IY T EY N IY
DETAINEES	D IH T EY N IY Z
DETAINER	D IH T EY N ER
DETAINERS	D IH T EY N ER Z
DETAINING	D IH T EY N IH NG
DETAINMENT	D IH T EY N M AH N T
DETAINMENTS	D IH T EY N M AH N T S
DETAINS	D IH T EY N Z
DETRAIN	D IY T R EY N
DETRAINED	D IY T R EY N D
DETRAINING	D IY T R EY N IH NG
DETRAINMENT	D IY T R EY N M AH N T
DETRAINMENTS	D IY T R EY N M AH N T S
DETRAINS	D IY T R EY N Z
DIPLOMAING	D IH P L AA M EY AH NG
DISCLAIM	D IH S K L EY M
DISCLAIMED	D IH S K L EY M D
DISCLAIMER	D IH S K L EY M ER
DISCLAIMERS	D IH S K L EY M ER Z
DISCLAIMING	D IH S K L EY M IH NG
DISCLAIMS	D IH S K L EY M Z
DISDAIN	D IH S D EY N
DISDAINED	D IH S D EY N D
DISDAINFUL	D IH S D EY N F AH L
DISDAINFULLY	D IH S D EY N F AH L IY
DISDAINFULNESS	D IH S D EY N F AH L N AH S
DISDAINFULNESSES	D IH S D EY N F AH L N AH S IH Z
DISDAINING	D IH S D EY N IH NG
DISDAINS	D IH S D EY N Z
DISENTAIL	D IH S IH N T EY L
DISENTAILED	D IH S IH N T EY L D
DISENTAILING	D IH S IH N T EY L IH NG
DISENTAILS	D IH S IH N T EY L Z
DISPRAISE	D IH S P R EY Z
DISPRAISED	D IH S P R EY Z D
DISPRAISER	D IH S P R EY Z ER
DISPRAISERS	D IH S P R EY Z ER Z
DISPRAISES	D IH S P R EY Z IH Z
DISPRAISING	D IH S P R EY Z IH NG
DISPRAISINGLY	D IH S P R EY Z IH NG L IY
DISREPAIR	D IH S R IH P EH R
DISREPAIRS	D IH S R IH P EH R Z
DISTAIN	D IH S T EY N
DISTAINED	D IH S T EY N D
DISTAINING	D IH S T EY N IH NG
DISTAINS	D IH S T EY N Z
DISTRAIN	D IH S T R EY N
DISTRAINABLE	D IH S T R EY N AH B AH L
DISTRAINED	D IH S T R EY N D
DISTRAINER	D IH S T R EY N ER
DISTRAINERS	D IH S T R EY N ER Z
DISTRAINING	D IH S T R EY N IH NG
DISTRAINOR	D IH S T R EY N ER
DISTRAINORS	D IH S T R EY N ER Z
DISTRAINS	D IH S T R EY N Z
DISTRAINT	D IH S T R EY N T
DISTRAINTS	D IH S T R EY N T S
DISTRAIT	D IH S T R EY T
DISTRAITE	D IH S T R EY T
DOCTRINAIRE	D AA K T R AH N EH R
DOCTRINAIRES	D AA K T R AH N EH R Z
DOCTRINAIRISM	D AA K T R AH N EH R IH Z AH M
DOCTRINAIRISMS	D AA K T R AH N EH R IH Z AH M Z
DOMAIN	D OW M EY N
DOMAINS	D OW M EY N Z
DOORNAIL	D AO R N EY L
DOORNAILS	D OW R N EY L Z
DOVETAIL	D AH V T EY L
DOVETAILED	D AH V T EY L D
DOVETAILING	D AH V T EY L IH NG
DOVETAILS	D AH V T EY L Z
DOWNSTAIRS	D AW N S T EH R Z
DRACHMAI	D R AE CH M EY
DRAIL	D R EY L
DRAILS	D R EY AH L Z
DRAIN	D R EY N
DRAINAGE	D R EY N AH JH
DRAINAGE(2)	D R EY N IH JH
DRAINAGES	D R EY N IH JH IH Z
DRAINED	D R EY N D
DRAINER	D R EY N ER
DRAINERS	D R EY N ER Z
DRAINING	D R EY N IH NG
DRAINPIPE	D R EY N P AY P
DRAINPIPES	D R EY N P AY P S
DRAINS	D R EY N Z
DRIVETRAIN	D R AY V T R EY N
DRIVETRAINS	D R AY V T R EY N Z
DUCKTAIL	D AH K T EY L
DUCKTAILS	D AH K T EY L Z
DUMBWAITER	D AH M W EY T ER
DUMBWAITERS	D AH M W EY T ER Z
ECLAIR	EH K L AH AH R
ECLAIRCISSEMENT	EH K L AH AH R S IH S M AH N T
ECLAIRCISSEMENTS	EH K L AH AH R S IH S AH M AH N T S
ECLAIRS	EH K L AH AH R Z
EDUTAINMENT	EH D Y AH T EY N M AH N T
EDUTAINMENTS	EH D Y AH T EY N M AH N T S
ELAIN	AH L EY N
ELAINS	AH L EY N Z
EMAIL	IY M EY L
EMAILED	IY M EY L D
EMAILING	IY M EY L IH NG
EMAILS	IY M EY L Z
ENCHAIN	EH N CH EY N
ENCHAINED	EH N CH EY N D
ENCHAINING	EH N CH EY N IH NG
ENCHAINMENT	EH N CH EY N M AH N T
ENCHAINMENTS	EH N CH EY N M AH N T S
ENCHAINS	EH N CH EY N Z
ENDBRAIN	EH N D B R EY N
ENDBRAINS	EH N D B R EY N Z
ENGRAIL	EH N G R EY L
ENGRAILED	EH N G R EY L D
ENGRAILING	EH N G R EY L IH NG
ENGRAILS	EH N G R EY L Z
ENGRAIN	EH N G R EY N
ENGRAINED	EH N G R EY N D
ENGRAINING	EH N G R EY N IH NG
ENGRAINS	EH N G R EY N Z
ENTAIL	EH N T EY L
ENTAILED	IH N T EY L D
ENTAILER	IH N T EY L ER
ENTAILERS	IH N T EY L ER Z
ENTAILING	IH N T EY L IH NG
ENTAILMENT	IH N T EY L M AH N T
ENTAILMENTS	IH N T EY L M AH N T S
ENTAILS	IH N T EY L Z
ENTERTAIN	EH N T ER T EY N
ENTERTAIN(2)	EH N ER T EY N
ENTERTAINED	EH N T ER T EY N D
ENTERTAINED(2)	EH N ER T EY N D
ENTERTAINER	EH N T ER T EY N ER
ENTERTAINER(2)	EH N ER T EY N ER
ENTERTAINERS	EH N T ER T EY N ER Z
ENTERTAINERS(2)	EH N ER T EY N ER Z
ENTERTAINING	EH N T ER T EY N IH NG
ENTERTAINING(2)	EH N ER T EY N IH NG
ENTERTAININGLY	EH N T ER T EY N IH NG L IY
ENTERTAINMENT	EH N T ER T EY N M AH N T
ENTERTAINMENT(2)	EH N ER T EY N M AH N T
ENTERTAINMENTS	EH N T ER T EY N M AH N T S
ENTERTAINMENTS(2)	EH N ER T EY N M AH N T S
ENTERTAINS	EH N T ER T EY N Z
ENTERTAINS(2)	EH N ER T EY N Z
ENTRAILS	EH N T R AH L Z
ENTRAIN	EH N T R EY N
ENTRAINED	EH N T R EY N D
ENTRAINER	EH N T R EY N ER
ENTRAINERS	EH N T R EY N ER Z
ENTRAINING	EH N T R EY N IH NG
ENTRAINMENT	EH N T R EY N M AH N T
ENTRAINMENTS	EH N T R EY N M AH N T S
ENTRAINS	EH N T R EY N Z
EUCAINE	Y UW K EY N
EUCAINES	Y UW K EY N Z
EUDAIMONISM	Y UW D EY M AH N IH Z AH M
EUDAIMONISMS	Y UW D EY M AH N AH Z AH M Z
EXCLAIM	IH K S K L EY M
EXCLAIMED	IH K S K L EY M D
EXCLAIMER	IH K S K L EY M ER
EXCLAIMERS	IH K S K L EY M ER Z
EXCLAIMING	IH K S K L EY M IH NG
EXCLAIMS	IH K S K L EY M Z
EXPLAIN	IH K S P L EY N
EXPLAINABLE	IH K S P L EY N AH B AH L
EXPLAINED	IH K S P L EY N D
EXPLAINER	IH K S P L EY N ER
EXPLAINERS	IH K S P L EY N ER Z
EXPLAINING	IH K S P L EY N IH NG
EXPLAINS	IH K S P L EY N Z
EXTRAORDINAIRE	EH K S T R AH AO R D IH N EH R
EYESTRAIN	AY S T R EY N
EYESTRAINS	AY S T R EY N Z
FAIENCE	F EY AH N S
FAIENCES	F EY AH N S IH Z
FAIL	F EY L
FAILED	F EY L D
FAILING	F EY L IH NG
FAILINGLY	F EY L IH NG L IY
FAILINGS	F EY L IH NG Z
FAILLE	F EY L
FAILLES	F EY L Z
FAILS	F EY L Z
FAILURE	F EY L Y ER
FAILURES	F EY L Y ER Z
FAIN	F EY N
FAINEANT	F EY N IY AH N T
FAINEANTS	F EY N IY N T S
FAINER	F EY N AH R
FAINEST	F EY N AH S T
FAINT	F EY N T
FAINTED	F EY N T IH D
FAINTER	F EY N T ER
FAINTERS	F EY N T ER Z
FAINTEST	F EY N T AH S T
FAINTHEARTED	F EY N T HH AA R T IH D
FAINTHEARTEDLY	F EY N T HH AA R T AH D L IY
FAINTHEARTEDNESS	F EY N T HH AA R T AH D N AH S
FAINTHEARTEDNESSES	F EY N T HH AA R T AH D N AH S IH Z
FAINTING	F EY N T IH NG
FAINTISH	F EY N T IH SH
FAINTISHNESS	F EY N T IH SH N AH S
FAINTISHNESSES	F EY N T IH SH N AH S IH Z
FAINTLY	F EY N T L IY
FAINTNESS	F EY N T N AH S
FAINTNESSES	F EY N T N AH S IH Z
FAINTS	F EY N T S
FAIR	F EH R
FAIRED	F EH R D
FAIRER	F EH R ER
FAIREST	F EH R IH S T
FAIRGROUND	F EH R G R AW N D
FAIRGROUNDS	F EH R G R AW N D Z
FAIRIES	F EH R IY Z
FAIRING	F EH R IH NG
FAIRINGS	F EH R IH NG Z
FAIRISH	F EH R IH SH
FAIRISHLY	F EH R IH SH L IY
FAIRLEAD	F EH R L IY D
FAIRLEADER	F EH R L IY D ER
FAIRLEADERS	F EH R L IY D ER Z
FAIRLEADS	F EH R L IY D Z
FAIRLY	F EH R L IY
FAIRNESS	F EH R N AH S
FAIRNESSES	F EH R N AH S IH Z
FAIRS	F EH R Z
FAIRWAY	F EH R W EY
FAIRWAYS	F EH R W EY Z
FAIRY	F EH R IY
FAIRYISM	F AE ER IY IH Z AH M
FAIRYISMS	F AE ER IY IH Z AH M Z
FAIRYLAND	F EH R IY L AE N D
FAIRYLANDS	F AE ER IY L AE N D Z
FAIRYLIKE	F AE ER IY L AY K
FAITH	F EY TH
FAITHED	F EY TH T
FAITHFUL	F EY TH F AH L
FAITHFULLY	F EY TH F AH L IY
FAITHFULNESS	F EY TH F AH L N EH S
FAITHFULNESSES	F EY TH F AH L N AH S IH Z
FAITHFULS	F EY TH F AH L Z
FAITHING	F EY TH IH NG
FAITHLESS	F EY TH L AH S
FAITHLESSLY	F EY TH L AH S L IY
FAITHLESSNESS	F EY TH L AH S N AH S
FAITHLESSNESSES	F EY TH L AH S N AH S IH Z
FAITHS	F EY TH S
FAITOUR	F EY T AH R
FAITOURS	F EY T OW Y AH R Z
FANTAIL	F AE N T EY L
FANTAILS	F AE N T EY L Z
FARADAIC	F AE R AH D EY AH K
FEATHERBRAIN	F EH DH ER B R EY N
FEATHERBRAINED	F EH DH ER B R EY N D
FEATHERBRAINS	F EH DH ER B R EY N Z
FINGERNAIL	F IH NG G ER N EY L
FINGERNAILS	F IH NG G ER N EY L Z
FISHTAIL	F IH SH T EY L
FISHTAILED	F IH SH T EY L D
FISHTAILING	F IH SH T EY L IH NG
FISHTAILS	F IH SH T EY L Z
FLAIL	F L EY L
FLAILED	F L EY L D
FLAILING	F L EY L IH NG
FLAILS	F L EY L Z
FLAIR	F L EH R
FLAIRS	F L EH R Z
FLOODPLAIN	F L AH D P L EY N
FLOODPLAINS	F L AH D P L EY N Z
FOREBRAIN	F AO R B R EY N
FOREBRAINS	F OW R B R EY N Z
FOREORDAIN	F OW R AO R D EY N
FOREORDAINED	F OW R AO R D EY N D
FOREORDAINING	F OW R AO R D EY N IH NG
FOREORDAINS	F OW R AO R D EY N Z
FORESAID	F OW R S EH D
FORESAIL	F OW R S EY L
FORESAILS	F OW R S EY L Z
FORESTAYSAIL	F OW R S T EY S EY L
FORESTAYSAILS	F OW R S T EY S EY L Z
FORMULAIC	F AO R M Y AH L EY IH K
FORMULAICALLY	F AO R M Y AH L EY IH K AH L IY
FOUNTAIN	F AW N T AH N
FOUNTAINED	F AW N T AH N D
FOUNTAINHEAD	F AW N T AH N HH EH D
FOUNTAINHEADS	F AW N T AH N HH EH D Z
FOUNTAINING	F AW N T AH N IH NG
FOUNTAINS	F AW N T AH N Z
FOXTAIL	F AA K S T EY L
FOXTAILS	F AA K S T EY L Z
FRAIL	F R EY L
FRAILER	F R EY L ER
FRAILEST	F R EY L AH S T
FRAILLY	F R EY L IY
FRAILNESS	F R EY L N AH S
FRAILNESSES	F R EY L N AH S IH Z
FRAILS	F R EY L Z
FRAILTIES	F R EY L T IY Z
FRAILTY	F R EY L T IY
FRAISE	F R EY Z
FRAISES	F R EY Z IH Z
FRANGLAIS	F R AE N G L EY AH S
FUNDRAISER	F AH N D R EY Z ER
FUNDRAISERS	F AH N D R EY Z ER Z
FUNDRAISING	F AH N D R EY S IH NG
FUNDRAISINGS	F AH N D R EY Z IH NG Z
FUNFAIR	F AH N F EH R
FUNFAIRS	F AH N F EH R Z
FUSAIN	F Y UW S EY N
FUSAINS	F Y UW S EY N Z
GAIETIES	G EY AH T IY Z
GAIETY	G EY AH T IY
GAIJIN	G EY JH AH N
GAILLARDIA	G EY L AA R D IY AH
GAILLARDIAS	G EY L AA R D IY AH Z
GAILY	G EY L IY
GAIN	G EY N
GAINABLE	G EY N AH B AH L
GAINED	G EY N D
GAINER	G EY N ER
GAINERS	G EY N ER Z
GAINFUL	G EY N F AH L
GAINFULLY	G EY N F AH L IY
GAINFULNESS	G EY N F AH L N AH S
GAINFULNESSES	G EY N F AH L N AH S IH Z
GAINGIVING	G EY N G IH V IH NG
GAINGIVINGS	G EY N G IH V IH NG Z
GAINING	G EY N IH NG
GAINLESS	G EY N L AH S
GAINLIER	G EY N L IY ER
GAINLIEST	G EY N L IY AH S T
GAINLY	G EY N L IY
GAINS	G EY N Z
GAINSAID	G EY N S EH D
GAINSAY	G EY N S EY
GAINSAYER	G EY N S EY ER
GAINSAYERS	G EY N S EY ER Z
GAINSAYING	G EY N S EY IH NG
GAINSAYS	G EY N S EY Z
GAINST	G EY N S T
GAIT	G EY T
GAITED	G EY T IH D
GAITER	G EY T ER
GAITERS	G EY T ER Z
GAITING	G EY T IH NG
GAITS	G EY T S
GLAIKET	G L EY K AH T
GLAIKIT	G L EY K AH T
GLAIR	G L AE AH R
GLAIRE	G L AE AH R
GLAIRED	G L AE AH R D
GLAIRES	G L AE AH R Z
GLAIRIER	G L AE AH R AY AH R
GLAIRIEST	G L AE AH R AY AH S T
GLAIRING	G L AE AH R AH NG
GLAIRS	G L AE AH R Z
GLAIRY	G L EY R IY
GLAIVE	G L EY AH V
GLAIVED	G L EY AH V D
GLAIVES	G L EY AH V Z
GRAIL	G R EY L
GRAILS	G R EY L Z
GRAIN	G R EY N
GRAINED	G R EY N D
GRAINER	G R EY N ER
GRAINERS	G R EY N ER Z
GRAINFIELD	G R EY N F IY L D
GRAINFIELDS	G R EY N F IY L D Z
GRAINIER	G R EY N IY ER
GRAINIEST	G R EY N IY AH S T
GRAININESS	G R EY N IY N AH S
GRAININESSES	G R EY N IY N AH S IH Z
GRAINING	G R EY N IH NG
GRAINS	G R EY N Z
GRAINY	G R EY N IY
GRAYMAIL	G R EY M EY L
GRAYMAILS	G R EY M EY L Z
GREASEPAINT	G R IY S P EY N T
GREASEPAINTS	G R IY S P EY N T S
GREENMAIL	G R IY N M EY L
GREENMAILED	G R IY N M EY L D
GREENMAILER	G R IY N M EY L ER
GREENMAILERS	G R IY N M EY L ER Z
GREENMAILING	G R IY N M EY L IH NG
GREENMAILS	G R IY N M EY L Z
GRISAILLE	G R AH S EY L
GRISAILLES	G R AH S EY L Z
GROSGRAIN	G R AA Z R EY N
GROSGRAINS	G R AA Z R EY N Z
GUAIAC	G Y UW EY AH K
GUAIACOL	G Y UW EY AH K AH L
GUAIACOLS	G Y UW EY AH K AH L Z
GUAIACS	G Y UW EY AH S
GUAIACUM	G Y UW EY AH K AH M
GUAIACUMS	G Y UW EY AH K AH M Z
GUAIOCUM	G Y UW EY AH K AH M
GUAIOCUMS	G Y UW EY AH K AH M Z
GUARDRAIL	G AA R D R EY L
GUARDRAILS	G AA R D R EY L Z
HAIK	HH EY K
HAIKA	HH EY K AH
HAIKS	HH EY K S
HAIKU	HH AY K UW
HAIKUS	HH AY K UW Z
HAIL	HH EY L
HAILED	HH EY L D
HAILER	HH EY L ER
HAILERS	HH EY L ER Z
HAILING	HH EY L IH NG
HAILS	HH EY L Z
HAILSTONE	HH EY L S T OW N
HAILSTONES	HH EY L S T OW N Z
HAILSTORM	HH EY L S T AO R M
HAILSTORMS	HH EY L S T AO R M Z
HAIR	HH EH R
HAIRBALL	HH EH R B AO L
HAIRBALLS	HH EH R B AO L Z
HAIRBAND	HH EH R B AE N D
HAIRBANDS	HH EH R B AE N D Z
HAIRBREADTH	HH EH R B R EH D TH
HAIRBREADTHS	HH EH R B R EH D TH S
HAIRBRUSH	HH EH R B R AH SH
HAIRBRUSHES	HH EH R B R AH SH IH Z
HAIRCAP	HH EH R K AE P
HAIRCAPS	HH EH R K AE P S
HAIRCLOTH	HH EH R K L AO TH
HAIRCLOTHS	HH EH R K L AO TH S
HAIRCUT	HH EH R K AH T
HAIRCUTS	HH EH R K AH T S
HAIRCUTTER	HH EH R K AH T ER
HAIRCUTTERS	HH EH R K AH T ER Z
HAIRCUTTING	HH EH R K AH T IH NG
HAIRCUTTINGS	HH EH R K AH T IH NG Z
HAIRDO	HH EH R D UW
HAIRDOS	HH EH R D UW Z
HAIRDRESSER	HH EH R D R EH S ER
HAIRDRESSERS	HH EH R D R EH S ER Z
HAIRDRESSING	HH EH R D R EH S IH NG
HAIRDRESSINGS	HH EH R D R EH S IH NG Z
HAIRED	HH EH R D
HAIRIER	HH EY R IY ER
HAIRIEST	HH EY R IY AH S T
HAIRINESS	HH EH R IY N AH S
HAIRINESSES	HH EY R IY N AH S IH Z
HAIRLESS	HH EH R L AH S
HAIRLESSNESS	HH EH R L AH S N AH S
HAIRLESSNESSES	HH EH R L AH S N AH S IH Z
HAIRLIKE	HH EH R L AY K
HAIRLINE	HH EH R L AY N
HAIRLINES	HH EH R L AY N Z
HAIRLOCK	HH EH R L AA K
HAIRLOCKS	HH EH R L AA K S
HAIRNET	HH EH R N EH T
HAIRNETS	HH EH R N EH T S
HAIRPIECE	HH EH R P IY S
HAIRPIECES	HH EH R P IY S IH Z
HAIRPIN	HH EH R P IH N
HAIRPINS	HH EH R P IH N Z
HAIRS	HH EH R Z
HAIRSBREADTH	HH EH R Z B R EH D TH
HAIRSBREADTHS	HH EH R Z B R EH D TH S
HAIRSPLITTER	HH EH R S P L IH T ER
HAIRSPLITTERS	HH EH R S P L IH T ER Z
HAIRSPLITTING	HH EH R S P L IH T IH NG
HAIRSPLITTINGS	HH EH R S P L IH T IH NG Z
HAIRSPRING	HH EH R S P R IH NG
HAIRSPRINGS	HH EH R S P R IH NG Z
HAIRSTREAK	HH EH R S T R IY K
HAIRSTREAKS	HH EH R S T R IY K S
HAIRSTYLE	HH EH R S T AY L
HAIRSTYLES	HH EH R S T AY L Z
HAIRSTYLING	HH EH R S T AY L IH NG
HAIRSTYLINGS	HH EH R S T AY L IH NG Z
HAIRSTYLIST	HH EH R S T AY L IH S T
HAIRSTYLISTS	HH EH R S T AY L IH S T S
HAIRWORK	HH EH R W ER K
HAIRWORKS	HH EH R W ER K S
HAIRWORM	HH EH R W ER M
HAIRWORMS	HH EH R W ER M Z
HAIRY	HH EH R IY
HALLOAING	HH AE L OW AH NG
HANDMAID	HH AE N D M EY D
HANDMAIDEN	HH AE N D M EY D AH N
HANDMAIDENS	HH AE N D M EY D AH N Z
HANDMAIDS	HH AE N D M EY D Z
HANDRAIL	HH AE N D R EY L
HANDRAILING	HH AE N D R EY L IH NG
HANDRAILINGS	HH AE N D R EY L IH NG Z
HANDRAILS	HH AE N D R EY L Z
HANGNAIL	HH AE NG N EY L
HANGNAILS	HH AE NG N EY L Z
HAREBRAINED	HH EH R B R EY N D
HEADSAIL	HH EH D S EY L
HEADSAILS	HH EH D S EY L Z
HEADWAITER	HH EH D W EY T ER
HEADWAITERS	HH EH D W EY T ER Z
HEBRAIZATION	HH EH B R EY AH Z EY SH AH N
HEBRAIZATIONS	HH EH B R AH Z EY T IY AH N Z
HEBRAIZE	HH EH B R EY AY Z
HEBRAIZED	HH EH B R EY AY Z D
HEBRAIZES	HH EH B R EY AY Z AH Z
HEBRAIZING	HH EH B R EY AY Z AH NG
HENNAING	HH EH N EY AH NG
HERMAI	HH AH R M EY
HETAIRA	HH AH T AE AH R AH
HETAIRAI	HH AH T AE AH R EY
HETAIRAS	HH AH T AE AH R AH Z
HIGHCHAIR	HH AY CH EH ER
HIGHCHAIRS	HH AY CH EH ER Z
HIGHTAIL	HH AY T EY L
HIGHTAILED	HH AY T EY L D
HIGHTAILING	HH AY T EY L IH NG
HIGHTAILS	HH AY T EY L Z
HILLOAING	HH IH L OW AH NG
HINDBRAIN	HH AY N D B R EY N
HINDBRAINS	HH AY N D B R EY N Z
HOBNAIL	HH AA B N EY L
HOBNAILED	HH AA B N EY L D
HOBNAILING	HH AA B N EY L IH NG
HOBNAILS	HH AA B N EY L Z
HOLLAING	HH AA L EY AH NG
HOLLANDAISE	HH AA L AH N D EY Z
HOLLANDAISES	HH AA L AH N D EY Z AH Z
HOLLOAING	HH AA L OW AH NG
HORNTAIL	HH AO R N T EY L
HORNTAILS	HH AO R N T EY L Z
HORSEHAIR	HH AO R S HH EH R
HORSEHAIRS	HH AO R S HH EH R Z
HORSETAIL	HH AO R S T EY L
HORSETAILS	HH AO R S T EY L Z
HOSANNAING	HH AH S AE N EY AH NG
HOUSEMAID	HH AW S M EY D
HOUSEMAIDS	HH AW S M EY D Z
HOUSEPAINTER	HH AW S P EY N T ER
HOUSEPAINTERS	HH AW S P EY N T ER Z
HOUSETRAIN	HH AW S T R EY N
HOUSETRAINED	HH AW S T R EY N D
HOUSETRAINING	HH AW S T R EY N IH NG
HOUSETRAINS	HH AW S T R EY N Z
HULLOAING	HH AH L OW AH NG
HUZZAING	HH AH Z EY AH NG
IBOGAINE	AY B OW G EY N
IBOGAINE(2)	AY B AH G EY N
IBOGAINES	IH B AH G EY N Z
IMPAINT	IH M P EY N T
IMPAINTED	IH M P EY N T IH D
IMPAINTING	IH M P EY N T IH NG
IMPAINTS	IH M P EY N T S
IMPAIR	IH M P EH R
IMPAIRED	IH M P EH R D
IMPAIRER	IH M P EH R ER
IMPAIRERS	IH M P EH R ER Z
IMPAIRING	IH M P EH R IH NG
IMPAIRMENT	IH M P EH R M AH N T
IMPAIRMENTS	IH M P EH R M AH N T S
IMPAIRS	IH M P EH R Z
INEXPLAINABLE	IH N IH K S P L EY N AH B AH L
INFOTAINMENT	IH N F OW T EY N M AH N T
INFOTAINMENTS	IH N F AH T EY N M AH N T S
INGRAIN	IH N G R EY N
INGRAINED	IH N G R EY N D
INGRAINEDLY	IH N G R EY N AH D L IY
INGRAINING	IH N G R EY N IH NG
INGRAINS	IH N G R EY N Z
INLAID	IH N L EY D
INTERAVAILABILITIES	IH N T ER AH V EY L AH B IH L AH T EH Z
INTERAVAILABILITY	IH N T ER AH V EY L AH B IH L AH T EH
INTERCHAIN	IH N T ER CH EY N
INTERCHAINED	IH N T ER CH EY N D
INTERCHAINING	IH N T ER CH EY N IH NG
INTERCHAINS	IH N T ER CH EY N Z
INTERFAITH	IH N T ER F EY TH
INTERLAID	IH N T ER L EY D
INTERMOUNTAIN	IH N T ER M AW N T IH N
INTERSTRAIN	IH N T ER S T R EY N
INTERSTRAINS	IH N T ER S T R EY N Z
IRRECLAIMABLE	IH R IY K L EY M AH B AH L
IRRECLAIMABLY	IH R IY K L EY M AH B L IY
JAIL	JH EY L
JAILBAIT	JH EY L B EY T
JAILBIRD	JH EY L B ER D
JAILBIRDS	JH EY L B ER D Z
JAILBREAK	JH EY L B R EY K
JAILBREAKS	JH EY L B R EY K S
JAILED	JH EY L D
JAILER	JH EY L ER
JAILERS	JH EY L ER Z
JAILHOUSE	JH EY L HH AW S
JAILHOUSES	JH EY L HH AW S IH Z
JAILING	JH EY L IH NG
JAILOR	JH EY L ER
JAILORS	JH EY L ER Z
JAILS	JH EY L Z
JAPONAISERIE	JH AE P AH N AH S IY R AY
JAPONAISERIES	JH AE P AH N EY S AH R AY Z
JEZAIL	JH AH Z EY L
JEZAILS	JH EH Z EY AH L Z
KAIAK	K EY AH K
KAIAKS	K EY AH K S
KAIF	K EY F
KAIFS	K EY F S
KAIL	K EY L
KAILS	K EY AH L Z
KAILYARD	K EY L AY AH R D
KAILYARDS	K EY L AY AH R D Z
KAIN	K EY N
KAINIT	K EY N AH T
KAINITE	K EY N AY T
KAINITES	K EY N AY T S
KAINITS	K EY N AH T S
KAINS	K EY N Z
KAISER	K AY Z ER
KAISERDOM	K AY Z ER D AH M
KAISERDOMS	K AY Z ER D AH M Z
KAISERIN	K AY Z ER IH N
KAISERINS	K AY Z ER IH N Z
KAISERISM	K AY Z ER IH Z AH M
KAISERISMS	K AY Z ER IH Z AH M Z
KAISERS	K AY Z ER Z
KAMAAINA	K AH M AA AH N AH
KAMAAINAS	K AH M AA AH N AH Z
KORAI	K AO R EY
KRAIT	K R EY T
KRAITS	K R EY T S
LACKADAISICAL	L AE K AH D EY Z IH K AH L
LACKADAISICALLY	L AE K AH D EY Z IH K AH L IY
LAIC	L EY AH K
LAICAL	L EY IH S AH L
LAICALLY	L EY K AE L IY
LAICH	L EY CH
LAICHS	L EY CH S
LAICISE	L EY S AY Z
LAICISED	L EY IH S AH S T
LAICISES	L EY S AY Z AH Z
LAICISING	L EY S AY Z AH NG
LAICISM	L EY AH S IH Z AH M
LAICISMS	L EY S AH Z AH M Z
LAICIZATION	L EY IH S AH Z EY SH AH N
LAICIZATIONS	L EY S AH Z EY T IY AH N Z
LAICIZE	L EY AH S AY Z
LAICIZED	L EY AH S AY Z D
LAICIZES	L EY AH S AY Z AH Z
LAICIZING	L EY AH S AY Z AH NG
LAICS	L EY AH S Z
LAID	L EY D
LAIGH	L EY
LAIGHS	L EY Z
LAIN	L EY N
LAIR	L EH R
LAIRD	L EH R D
LAIRDLY	L AE AH R D L IY
LAIRDS	L AE AH R D Z
LAIRED	L EH R D
LAIRING	L EH R IH NG
LAIRS	L EH R Z
LAITANCE	L EY T AH N S
LAITANCES	L EY T AE N S AH Z
LAITH	L EY TH
LAITHLY	L EY TH L IY
LAITIES	L EY AH T IY Z
LAITY	L EY AH T IY
LAMEBRAIN	L EY M B R EY N
LAMEBRAINED	L EY M B R EY N D
LAMEBRAINS	L EY M B R EY N Z
LANAI	L AH N AY
LANAIS	L AE N EY AH S
LEGERDEMAIN	L EH JH ER D AH M EY N
LEGERDEMAINS	L EH G ER D IY M EY N Z
LEGIONNAIRE	L IY JH AH N EH R
LEGIONNAIRES	L IY JH AH N EH R Z
LIAISE	L AY AH AY Z
LIAISED	L AY AH AH S T
LIAISES	L AY AH AY Z AH Z
LIAISING	L AY AH AY Z AH NG
LIAISON	L IY EY Z AA N
LIAISONS	L IY EY S AA N Z
LIDOCAINE	L IH D AH K EY N
LIDOCAINES	L IH D AH K EY N Z
LITAI	L IH T EY
LONGHAIR	L AO NG HH EH R
LONGHAIRED	L AO NG HH EH R D
LONGHAIRS	L AO NG HH EH R Z
LUGSAIL	L AH G S EY L
LUGSAILS	L AH G S EY L Z
LUMINAIRE	L UW M IH N AH AH R
LUMINAIRES	L UW M IH N AH AH R Z
LYONNAISE	L AY AH N EY Z
MAID	M EY D
MAIDEN	M EY D AH N
MAIDENHAIR	M EY D AH N HH EH R
MAIDENHAIRS	M EY D AH N HH EH R Z
MAIDENHEAD	M EY D AH N HH EH D
MAIDENHEADS	M EY D AH N HH EH D Z
MAIDENHOOD	M EY D AH N HH UH D
MAIDENHOODS	M EY D AH N HH UH D Z
MAIDENLINESS	M EY D AH N L IY N AH S
MAIDENLINESSES	M EY D AH N L IY N AH S IH Z
MAIDENLY	M EY D AH N L IY
MAIDENS	M EY D AH N Z
MAIDHOOD	M EY D HH UH D
MAIDHOODS	M EY D HH UH D Z
MAIDISH	M EY D IH SH
MAIDS	M EY D Z
MAIDSERVANT	M EY D S ER V AH N T
MAIDSERVANTS	M EY D S ER V AH N T S
MAIEUTIC	M EY AH Y UW T AH K
MAIGRE	M EY G AH R
MAIHEM	M EY HH AH M
MAIHEMS	M EY HH AH M Z
MAIL	M EY L
MAILABILITIES	M EY L AH B IH L AH T EH Z
MAILABILITY	M EY L AH B IH L AH T EH
MAILABLE	M EY L AH B AH L
MAILBAG	M EY L B AE G
MAILBAGS	M EY L B AE G Z
MAILBOMB	M EY L B AA M
MAILBOMBED	M EY L B AA M D
MAILBOMBING	M EY L B AA M IH NG
MAILBOMBS	M EY L B AA M Z
MAILBOX	M EY L B AA K S
MAILBOXES	M EY L B AA K S IH Z
MAILE	M EY L
MAILED	M EY L D
MAILER	M EY L ER
MAILERS	M EY L ER Z
MAILES	M EY AH L Z
MAILING	M EY L IH NG
MAILINGS	M EY L IH NG Z
MAILL	M EY L
MAILLESS	M EY L AH S
MAILLOT	M EY L AA T
MAILLOTS	M EY L AA T S
MAILLS	M EY L Z
MAILMAN	M EY L M AE N
MAILMEN	M EY L M EH N
MAILS	M EY L Z
MAIM	M EY M
MAIMED	M EY M D
MAIMER	M EY M ER
MAIMERS	M EY M ER Z
MAIMING	M EY M IH NG
MAIMS	M EY M Z
MAIN	M EY N
MAINFRAME	M EY N F R EY M
MAINFRAMES	M EY N F R EY M Z
MAINLAND	M EY N L AE N D
MAINLAND(2)	M EY N L AH N D
MAINLANDER	M EY N L AE N D ER
MAINLANDERS	M EY N L AE N D ER Z
MAINLANDS	M EY N L AE N D Z
MAINLINE	M EY N L AY N
MAINLINED	M EY N L AY N D
MAINLINES	M EY N L AY N Z
MAINLINING	M EY N L AY N IH NG
MAINLY	M EY N L IY
MAINMAST	M EY N M AE S T
MAINMASTS	M EY N M AE S T S
MAINS	M EY N Z
MAINSAIL	M EY N S EY L
MAINSAILS	M EY N S EY L Z
MAINSHEET	M EY N SH IY T
MAINSHEETS	M EY N SH IY T S
MAINSPRING	M EY N S P R IH NG
MAINSPRINGS	M EY N S P R IH NG Z
MAINSTAY	M EY N S T EY
MAINSTAYS	M EY N S T EY Z
MAINSTREAM	M EY N S T R IY M
MAINSTREAMED	M EY N S T R IY M D
MAINSTREAMING	M EY N S T R IY M IH NG
MAINSTREAMS	M EY N S T R IY M Z
MAINTAIN	M EY N T EY N
MAINTAINABILITIES	M EY N T EY N AH B IH L AH T EH Z
MAINTAINABILITY	M EY N T EY N AH B IH L AH T EH
MAINTAINABLE	M EY N T EY N AH B AH L
MAINTAINED	M EY N T EY N D
MAINTAINER	M EY N T EY N ER
MAINTAINERS	M EY N T EY N ER Z
MAINTAINING	M EY N T EY N IH NG
MAINTAINS	M EY N T EY N Z
MAINTENANCE	M EY N T AH N AH N S
MAINTENANCE(2)	M EY N T N AH N S
MAINTENANCES	M EY N T AH N AH N S IH Z
MAINTOP	M EY N T AA P
MAINTOPS	M EY N T AA P S
MAIOLICA	M EY AA L AH K AH
MAIOLICAS	M EY AA L AH K AH Z
MAIR	M EH R
MAIRS	M EH R Z
MAISONETTE	M EY Z AO N EH T
MAISONETTES	M EY Z AO N EH T S
MAIST	M EY AH S T
MAISTS	M EY S T S
MAIZE	M EY Z
MAIZES	M EY AY Z AH Z
MALAISE	M AE L EY Z
MALAISES	M AE L EY Z IH Z
MAROCAIN	M AE R AH K EY N
MAROCAINS	M AE R AH K EY N Z
MASCARAING	M AE S K AE R AH IH NG
MAYONNAISE	M EY AH N EY Z
MAYONNAISES	M EY AH N EY Z IH Z
MEDAILLON	M IY D AH IH L AO N
MEDAILLONS	M IY D AH IH L AO N Z
MEDICAID	M EH D AH K EY D
MEDICAIDS	M EH D IH K EY D Z
MERMAID	M ER M EY D
MERMAIDS	M ER M EY D Z
METICAIS	M AH T IH K EY AH S
MIDAIR	M IH D EH R
MIDAIRS	M IH D EH R Z
MIDBRAIN	M IH D B R EY N
MIDBRAINS	M IH D B R EY N Z
MIGRAINE	M AY G R EY N
MIGRAINES	M AY G R EY N Z
MIGRAINOUS	M IH G R EY N AH S
MILKMAID	M IH L K M EY D
MILKMAIDS	M IH L K M EY D Z
MILLIONAIRE	M IH L Y AH N EH R
MILLIONAIRES	M IH L Y AH N EH R Z
MILLIONAIRESS	M IH L Y AH N EH R AH S
MILLIONAIRESSES	M IH L Y AH N EH R AH S IH Z
MISAIM	M IH S EY M
MISAIMED	M IH S EY M D
MISAIMING	M IH S EY M IH NG
MISAIMS	M IH S EY M Z
MISAPPRAISAL	M IH S AH P R EY Z AH L
MISAPPRAISALS	M IH S AH P R EY Z AH L Z
MISCLAIM	M IH S K L EY M
MISCLAIMED	M IH S K L EY M D
MISCLAIMING	M IH S K L EY M IH NG
MISCLAIMS	M IH S K L EY M Z
MISFAITH	M IH S F EY TH
MISFAITHS	M IH S F EY TH S
MISLAID	M IH S L EY D
MISLAIN	M IH S L EY N
MISPAINT	M IH S P EY N T
MISPAINTED	M IH S P EY N T IH D
MISPAINTING	M IH S P EY N T IH NG
MISPAINTS	M IH S P EY N T S
MISRAISE	M IH S R EY Z
MISRAISED	M IH S R EY Z D
MISRAISES	M IH S R EY Z IH Z
MISRAISING	M IH S R EY Z IH NG
MISSAID	M IH S EH D
MISTRAIN	M IH S T R EY N
MISTRAINED	M IH S T R EY N D
MISTRAINING	M IH S T R EY N IH NG
MISTRAINS	M IH S T R EY N Z
MOHAIR	M OW HH EH R
MOHAIRS	M AA HH AH AH R Z
MOIRAI	M OY R EY
MONORAIL	M AA N ER EY L
MONORAILS	M AA N ER EY L Z
MOONSAIL	M UW N S EY L
MOONSAILS	M UW N S EY L Z
MORAINAL	M ER EY N AH L
MORAINE	M ER EY N
MORAINES	M AH R EY N Z
MORAINIC	M AH R EY N IH K
MORTMAIN	M AO R T M EY N
MORTMAINS	M AO R T M EY N Z
MOSAIC	M OW Z EY IH K
MOSAICALLY	M OW Z EY IH K AH L IY
MOSAICISM	M OW Z EY IH K IH Z AH M
MOSAICISMS	M OW Z EY IH K IH Z AH M Z
MOSAICIST	M OW Z EY IH K IH S T
MOSAICISTS	M OW Z EY IH K IH S T S
MOSAICKED	M OW Z EY IH K T
MOSAICKING	M OW Z EY IH K IH NG
MOSAICLIKE	M OW Z EY IH K L AY K
MOSAICS	M OW Z EY IH K S
MOUNTAIN	M AW N T AH N
MOUNTAINEER	M AW N T IH N IH R
MOUNTAINEERING	M AW N T IH N IH R IH NG
MOUNTAINEERINGS	M AW N T AH N IH R IH NG Z
MOUNTAINEERS	M AW N T IH N IH R Z
MOUNTAINOUS	M AW N T AH N AH S
MOUNTAINOUSLY	M AW N T AH N AH S L IY
MOUNTAINOUSNESS	M AW N T AH N AH S N AH S
MOUNTAINOUSNESSES	M AW N T AH N AH S N AH S IH Z
MOUNTAINS	M AW N T AH N Z
MOUNTAINSIDE	M AW N T AH N S AY D
MOUNTAINSIDES	M AW N T AH N S AY D Z
MOUNTAINTOP	M AW N T AH N T AA P
MOUNTAINTOPS	M AW N T AH N T AA P S
MOUNTAINY	M AW N T AH N IY
MULTIBILLIONAIRE	M AH L T AY B IH L Y AH N AH AY ER
MULTIBILLIONAIRES	M AH L T AY B IH L Y AH N AH AY ER Z
MULTICHAIN	M AH L T AY CH EY N
MULTIDOMAIN	M AH L T AY D OW M EY N
MULTIGRAIN	M AH L T AY G R EY N
MULTIGRAINS	M AH L T AY G R EY N Z
MULTIMILLIONAIRE	M AH L T IY M IH L Y AH N EH R
MULTIMILLIONAIRE(2)	M AH L T AY M IH L Y AH N EH R
MULTIMILLIONAIRES	M AH L T IY M IH L Y AH N EH R Z
MULTIMILLIONAIRES(2)	M AH L T AY M IH L Y AH N EH R Z
MURRAIN	M AH R EY N
MURRAINS	M AH R EY N Z
NAIAD	N EY AH D
NAIADES	N EY EY D Z
NAIADS	N EY AH D Z
NAIF	N EY F
NAIFS	N EY F S
NAIL	N EY L
NAILBRUSH	N EY L B R AH SH
NAILBRUSHES	N EY L B R AH SH IH Z
NAILED	N EY L D
NAILER	N EY L ER
NAILERS	N EY L ER Z
NAILFOLD	N EY L F OW L D
NAILFOLDS	N EY L F OW L D Z
NAILHEAD	N EY L HH EH D
NAILHEADS	N EY L HH EH D Z
NAILING	N EY L IH NG
NAILS	N EY L Z
NAILSET	N EY L S EH T
NAILSETS	N EY L S EH T S
NAINSOOK	N EY N S AH K
NAINSOOKS	N EY N S AH K S
NAIRA	N EH R AH
NAIRAS	N AE AH R AH Z
NAIVE	N AY IY V
NAIVELY	N AA IY V L IY
NAIVENESS	N AA IY V N AH S
NAIVENESSES	N AA IY V N AH S IH Z
NAIVER	N AA IY V ER
NAIVES	N AA IY V Z
NAIVEST	N AA IY V AH S T
NAIVETE	N AA IY V AH T EY
NAIVETES	N AA IY V AH T EY Z
NAIVETIES	N AA IY V AH T EY IY Z
NAIVETY	N AA IY V AH T EY IY
NAVAID	N AH V EY D
NAVAIDS	N AH V EY D Z
NILGAI	N IH L G EY
NILGAIS	N IH L G EY AH S
NILGHAI	N IH L EY
NILGHAIS	N IH L EY AH S
NONAVAILABILITIES	N AA N AH V EY L AH B IH L AH T EH Z
NONAVAILABILITY	N AA N AH V EY L AH B IH L AH T EH
NONDAIRY	N AA N D EH R IY
NONDOCTRINAIRE	N AA N D AA K T R AH N EH R
NONENTERTAINMENT	N AA N EH N T ER T EY N M AH N T
NONENTERTAINMENTS	N AA N EH N T ER T EY N M AH N T S
NONMAINSTREAM	N AA N M EY N S T R IY M
NONPAID	N AA N P EY D
NONRAILROAD	N AA N R EY L R OW D
NOVOCAINE	N AA V AH K EY N
NOVOCAINES	N AA V AH K EY N Z
NURSEMAID	N ER S M EY D
NURSEMAIDS	N ER S M EY D Z
NYLGHAI	N IH L EY
NYLGHAIS	N IH L EY AH S
OBTAIN	AH B T EY N
OBTAINABILITIES	AH B T EY N AH B IH L AH T EH Z
OBTAINABILITY	AH B T EY N AH B IH L AH T EH
OBTAINABLE	AH B T EY N AH B AH L
OBTAINED	AH B T EY N D
OBTAINER	AH B T EY N ER
OBTAINERS	AH B T EY N ER Z
OBTAINING	AH B T EY N IH NG
OBTAINMENT	AH B T EY N M AH N T
OBTAINMENTS	AH B T EY N M AH N T S
OBTAINS	AH B T EY N Z
ORDAIN	AO R D EY N
ORDAINED	AO R D EY N D
ORDAINER	AO R D EY N ER
ORDAINERS	AO R D EY N ER Z
ORDAINING	AO R D EY N IH NG
ORDAINMENT	AO R D EY N M AH N T
ORDAINMENTS	AO R D EY N M AH N T S
ORDAINS	AO R D EY N Z
OUABAIN	AW AH B EY N
OUABAINS	AW AH B EY N Z
OUTBARGAIN	AW T B AA R G AH N
OUTBARGAINED	AW T B AA R G AH N D
OUTBARGAINING	AW T B AA R G AH N IH NG
OUTBARGAINS	AW T B AA R G AH N Z
OUTGAIN	AW T G EY N
OUTGAINED	AW T G EY N D
OUTGAINING	AW T G EY N IH NG
OUTGAINS	AW T G EY N Z
OUTLAID	AW T L EY D
OUTLAIN	AW T L EY N
OUTPAINT	AW T P EY N T
OUTPAINTED	AW T P EY N T IH D
OUTPAINTING	AW T P EY N T IH NG
OUTPAINTS	AW T P EY N T S
OUTRAISE	AW T R EY Z
OUTRAISED	AW T R EY Z D
OUTRAISES	AW T R EY Z IH Z
OUTRAISING	AW T R EY Z IH NG
OUTSAIL	AW T S EY L
OUTSAILED	AW T S EY L D
OUTSAILING	AW T S EY L IH NG
OUTSAILS	AW T S EY L Z
OUTWAIT	AW T W EY T
OUTWAITED	AW T W EY T IH D
OUTWAITING	AW T W EY T IH NG
OUTWAITS	AW T W EY T S
OVERCLAIM	OW V ER K L EY M
OVERCLAIMED	OW V ER K L EY M D
OVERCLAIMING	OW V ER K L EY M IH NG
OVERCLAIMS	OW V ER K L EY M Z
OVERENTERTAINED	OW V ER EH N T ER T EY N D
OVEREXPLAIN	OW V ER IH K S P L EY N
OVEREXPLAINED	OW V ER IH K S P L EY N D
OVEREXPLAINING	OW V ER IH K S P L EY N IH NG
OVEREXPLAINS	OW V ER IH K S P L EY N Z
OVERLAID	OW V ER L EY D
OVERLAIN	OW V ER L EY N
OVERPAID	OW V ER P EY D
OVERPLAID	OW V ER P L AE D
OVERPLAIDED	OW V ER P L AE D IH D
OVERPLAIDS	OW V ER P L AE D Z
OVERPRAISE	OW V ER P R EY Z
OVERPRAISED	OW V ER P R EY Z D
OVERPRAISES	OW V ER P R EY Z IH Z
OVERPRAISING	OW V ER P R EY Z IH NG
OVERSTRAIN	OW V ER S T R EY N
OVERSTRAINED	OW V ER S T R EY N D
OVERSTRAINING	OW V ER S T R EY N IH NG
OVERSTRAINS	OW V ER S T R EY N Z
OVERTRAIN	OW V ER T R EY N
OVERTRAINED	OW V ER T R EY N D
OVERTRAINING	OW V ER T R EY N IH NG
OVERTRAINS	OW V ER T R EY N Z
OXTAIL	AA K S T EY L
OXTAILS	AA K S T EY L Z
PAID	P EY D
PAIK	P EY K
PAIKED	P EY K T
PAIKING	P EY K AH NG
PAIKS	P EY K S
PAIL	P EY L
PAILFUL	P EY L F AH L
PAILFULS	P EY L F AH L Z
PAILLARD	P EY L AA R D
PAILLARDS	P EY L AA R D Z
PAILLETTE	P EY L EH T
PAILLETTES	P EY L EH T S
PAILS	P EY L Z
PAILSFUL	P EY L Z F AH L
PAIN	P EY N
PAINCH	P EY N CH
PAINCHES	P EY N CH AH Z
PAINED	P EY N D
PAINFUL	P EY N F AH L
PAINFULLER	P EY N F AH L ER
PAINFULLEST	P EY N F AH L AH S T
PAINFULLY	P EY N F AH L IY
PAINFULNESS	P EY N F AH L N AH S
PAINFULNESSES	P EY N F AH L N AH S IH Z
PAINING	P EY N IH NG
PAINKILLER	P EY N K IH L ER
PAINKILLERS	P EY N K IH L ER Z
PAINKILLING	P EY N K IH L IH NG
PAINLESS	P EY N L AH S
PAINLESSLY	P EY N L AH S L IY
PAINLESSNESS	P EY N L AH S N AH S
PAINLESSNESSES	P EY N L AH S N AH S IH Z
PAINS	P EY N Z
PAINSTAKING	P EY N S T EY K IH NG
PAINSTAKINGLY	P EY N S T EY K IH NG L IY
PAINSTAKINGS	P EY N S T EY K IH NG Z
PAINT	P EY N T
PAINTBRUSH	P EY N T B R AH SH
PAINTBRUSHES	P EY N T B R AH SH IH S
PAINTED	P EY N T AH D
PAINTED(2)	P EY N T IH D
PAINTED(3)	P EY N AH D
PAINTED(4)	P EY N IH D
PAINTER	P EY N T ER
PAINTER(2)	P EY N ER
PAINTERLINESS	P EY N T ER L IY N AH S
PAINTERLINESSES	P EY N T ER L IY N AH S IH Z
PAINTERLY	P EY N T ER L IY
PAINTERLY(2)	P EY N ER L IY
PAINTERS	P EY N T ER Z
PAINTERS(2)	P EY N ER Z
PAINTIER	P EY N T IY ER
PAINTIEST	P EY N T IY AH S T
PAINTING	P EY N T IH NG
PAINTING(2)	P EY N IH NG
PAINTINGS	P EY N T IH NG Z
PAINTINGS(2)	P EY N IH NG Z
PAINTS	P EY N T S
PAINTWORK	P EY N T W ER K
PAINTWORKS	P EY N T W ER K S
PAINTY	P EY N T IY
PAIR	P EH R
PAIRED	P EH R D
PAIRING	P EH R IH NG
PAIRINGS	P EH R IH NG Z
PAIRS	P EH R Z
PAISA	P EY S AH
PAISAN	P EY AH S AH N
PAISANA	P EY S AH N AH
PAISANAS	P EY S AH N AH Z
PAISANO	P EY S AH N OW
PAISANOS	P EY S AH N AH Z
PAISANS	P EY S AH N Z
PAISAS	P EY S AH Z
PAISE	P EY Z
PAISLEY	P EY Z L IY
PAISLEYS	P EY Z L EY Z
PALAIS	P AH L EY
PANTYWAIST	P AE N T IY W EY S T
PANTYWAISTS	P AE N T IY W EY S T S
PAPAIN	P AA P AH IH N
PAPAINS	P AA P AH IH N Z
PARADISAIC	P AH R AE D AH S EY AH K
PARADISAICAL	P AA R AH D IH S AH AY S AH L
PARADISAICALLY	P AA R AH D IH S AH AY S AH L IY
PARAINFLUENZA	P AA R AH IH N F L UW EH N Z AH
PARAINFLUENZAS	P AA R AH IH N F L UW EH N Z AH Z
PARASAILING	P AA R AH S EY L IH NG
PARASAILINGS	P AA R AH S EY L IH NG Z
PARFAIT	P AA R F EY
PARFAITS	P AA R F EY Z
PEARMAIN	P AE ER M EY N
PEARMAINS	P AE ER M EY N Z
PENEPLAIN	P EH N AH P L EY N
PENEPLAINS	P EH N AH P L EY N Z
PERTAIN	P ER T EY N
PERTAINED	P ER T EY N D
PERTAINING	P ER T EY N IH NG
PERTAINS	P ER T EY N Z
PETSAI	P EH T S EY
PETSAIS	P EH T S EY Z
PHARISAIC	F AE R AH S EY AH K
PHARISAICAL	F AH R IH S EY IH S AH L
PHARISAICALLY	F AE R AH S AH K AE L IY
PHARISAICALNESS	F AE R AH S AH K AE L N AH S
PHARISAICALNESSES	F AE R AH S AH K AE L N EH S AH Z
PHARISAISM	F AE R IH S EY IH Z AH M
PHARISAISMS	F AE R AH S EY Z AH M Z
PHENACAINE	F EH N AH K EY N
PHENACAINES	F EH N AH K EY N Z
PHOTOMOSAIC	F OW T OW M OW Z EY IH K
PHOTOMOSAICS	F OW T OW M OW Z EY IH K S
PHOTORECONNAISSANCE	F OW T OW R IH K AA N AH Z AH N S
PHOTORECONNAISSANCES	F OW T OW R IH K AA N AH Z AH N S IH Z
PHOTOVOLTAIC	F OW T AH V OW L T EY IH K
PHOTOVOLTAICS	F OW T OW V OW L T EY IH K S
PIGTAIL	P IH G T EY L
PIGTAILED	P IH G T EY L D
PIGTAILS	P IH G T EY L Z
PINTAIL	P IH N T EY L
PINTAILS	P IH N T EY L Z
PLAICE	P L EY AH S
PLAICES	P L EY AH S
PLAID	P L AE D
PLAIDED	P L AE D IH D
PLAIDS	P L AE D Z
PLAIN	P L EY N
PLAINCHANT	P L EY N CH AE N T
PLAINCHANTS	P L EY N CH AE N T S
PLAINCLOTHES	P L EY N K L OW Z
PLAINCLOTHESMAN	P L EY N K L OW DH Z M AE N
PLAINCLOTHESMEN	P L EY N K L OW DH Z M EH N
PLAINED	P L EY N D
PLAINER	P L EY N ER
PLAINEST	P L EY N AH S T
PLAINING	P L EY N IH NG
PLAINLY	P L EY N L IY
PLAINNESS	P L EY N AH S
PLAINNESSES	P L EY N AH S IH Z
PLAINS	P L EY N Z
PLAINSMAN	P L EY N Z M AE N
PLAINSMEN	P L EY N Z M EH N
PLAINSONG	P L EY N S AO NG
PLAINSONGS	P L EY N S AO NG Z
PLAINSPOKEN	P L EY N S P OW K AH N
PLAINSPOKENNESS	P L EY N S P OW K AH N AH S
PLAINSPOKENNESSES	P L EY N S P OW K AH N AH S IH Z
PLAINT	P L EY N T
PLAINTEXT	P L EY N T EH K S T
PLAINTEXTS	P L EY N T EH K S T S
PLAINTFUL	P L EY N T F AH L
PLAINTIFF	P L EY N T AH F
PLAINTIFF(2)	P L EY N AH F
PLAINTIFFS	P L EY N T IH F S
PLAINTIFFS(2)	P L EY N IH F S
PLAINTIVE	P L EY N T IH V
PLAINTIVE(2)	P L EY N IH V
PLAINTIVELY	P L EY N T AY V L IY
PLAINTIVELY(2)	P L EY N AY V L IY
PLAINTIVENESS	P L EY N T IH V N AH S
PLAINTIVENESSES	P L EY N T IH V N AH S IH Z
PLAINTS	P L EY N T S
PLAISTER	P L EY S T ER
PLAISTERED	P L EY S T ER D
PLAISTERING	P L EY S T ER IH NG
PLAISTERS	P L EY S T ER Z
PLAIT	P L EY T
PLAITED	P L EY T AH D
PLAITER	P L EY T AH R
PLAITERS	P L EY T AH R Z
PLAITING	P L EY T IH NG
PLAITINGS	P L EY T AH NG Z
PLAITS	P L EY T S
PLANTAIN	P L AE N T AH N
PLANTAINS	P L AE N T AH N Z
PLEINAIRISM	P L IY N AH AH R IH Z AH M
PLEINAIRISMS	P L IY N AE AH R AH Z AH M Z
PLEINAIRIST	P L IY N AE AH R AH S T
PLEINAIRISTS	P L IY N AE AH R AH S T S
POLKAING	P OW L K AH IH NG
POLONAISE	P AA L AH N EY Z
POLONAISES	P AA L AH N EY Z IH Z
PONYTAIL	P OW N IY T EY L
PONYTAILED	P OW N IY T EY L D
PONYTAILS	P OW N IY T EY L Z
PORCELAIN	P AO R S AH L AH N
PORCELAINIZE	P OW R S AH L AH N AY Z
PORCELAINIZED	P OW R S AH L AH N AY Z D
PORCELAINIZES	P OW R S AH L AH N AY Z IH Z
PORCELAINIZING	P OW R S AH L AH N AY Z IH NG
PORCELAINLIKE	P OW R S AH L AH N L AY K
PORCELAINS	P AO R S AH L AH N Z
PORTRAIT	P AO R T R AH T
PORTRAITIST	P OW R T R AH T IH S T
PORTRAITISTS	P OW R T R AH T IH S T S
PORTRAITS	P AO R T R AH T S
PORTRAITURE	P OW R T R AH CH ER
PORTRAITURES	P OW R T R AH CH ER Z
POSTPAID	P OW S T P EY D
PRAIRIE	P R EH R IY
PRAIRIES	P R EY R IY Z
PRAISE	P R EY Z
PRAISED	P R EY Z D
PRAISER	P R EY Z ER
PRAISERS	P R EY Z ER Z
PRAISES	P R EY Z IH Z
PRAISEWORTHILY	P R EY Z W ER DH IY L IY
PRAISEWORTHINESS	P R EY Z W ER DH IY N AH S
PRAISEWORTHINESSES	P R EY Z W ER DH IY N AH S IH Z
PRAISEWORTHY	P R EY Z W ER DH IY
PRAISING	P R EY Z IH NG
PREORDAIN	P R IY AO R D EY N
PREORDAINED	P R IY AO R D EY N D
PREORDAINING	P R IY AO R D EY N IH NG
PREORDAINMENT	P R IY AO R D EY N M AH N T
PREORDAINMENTS	P R IY AO R D EY N M AH N T S
PREORDAINS	P R IY AO R D EY N Z
PREPAID	P R IY P EY D
PRETRAIN	P R IY T R EY N
PRETRAINED	P R IY T R EY N D
PRETRAINING	P R IY T R EY N IH NG
PRETRAINS	P R IY T R EY N Z
PREVAIL	P R IH V EY L
PREVAIL(2)	P R IY V EY L
PREVAILED	P R IH V EY L D
PREVAILED(2)	P R IY V EY L D
PREVAILING	P R IH V EY L IH NG
PREVAILING(2)	P R IY V EY L IH NG
PREVAILS	P R IH V EY L Z
PREVAILS(2)	P R IY V EY L Z
PROCAINE	P R OW K EY N
PROCAINES	P R OW K EY N Z
PROCHAIN	P R OW CH EY N
PROCLAIM	P R OW K L EY M
PROCLAIMED	P R OW K L EY M D
PROCLAIMER	P R OW K L EY M ER
PROCLAIMERS	P R OW K L EY M ER Z
PROCLAIMING	P R OW K L EY M IH NG
PROCLAIMS	P R OW K L EY M Z
PROSAIC	P R OW Z EY IH K
PROSAICALLY	P R OW Z EY IH K AH L IY
PROSAISM	P R OW S EY AH Z AH M
PROSAISMS	P R OW S EY Z AH M Z
PROSAIST	P R OW S EY AH S T
PROSAISTS	P R OW S EY S T S
PSOAI	S OW IY
PTOMAIN	T AH M EY N
PTOMAINE	T OW M EY N
PTOMAINES	T OW M EY N Z
PTOMAINS	T AH M EY N Z
PUSHCHAIR	P UH SH CH EH ER
PUSHCHAIRS	P UH SH CH EH ER Z
QAID	K EY D
QAIDS	K EY D Z
QUAI	K EY
QUAICH	K W EY CH
QUAICHES	K W EY CH AH Z
QUAICHS	K W EY CH S
QUAIGH	K W EY
QUAIGHS	K W EY Z
QUAIL	K W EY L
QUAILED	K W EY AH L D
QUAILING	K W EY AH L AH NG
QUAILS	K W EY L Z
QUAINT	K W EY N T
QUAINTER	K W EY N T ER
QUAINTEST	K W EY N T AH S T
QUAINTLY	K W EY N T L IY
QUAINTNESS	K W EY N T N AH S
QUAINTNESSES	K W EY N T N AH S IH Z
QUAIS	K W EY AH S
QUATRAIN	K W AA T R EY N
QUATRAINS	K W AA T R EY N Z
QUESTIONNAIRE	K W EH S CH AH N EH R
QUESTIONNAIRES	K W EH S CH AH N EH R Z
QUILLAI	K W IH L EY
QUILLAIA	K W IH L EY AH
QUILLAIAS	K W IH L EY AH Z
QUILLAIS	K W IH L EY AH S
QUINTAIN	K W IH N T AH IH N
QUINTAINS	K W IH N T AH IH N Z
QUITCLAIM	K W IH T K L EY M
QUITCLAIMED	K W IH T K L EY M D
QUITCLAIMING	K W IH T K L EY M IH NG
QUITCLAIMS	K W IH T K L EY M Z
RAIA	R AA Y AH
RAIAS	R EY AH Z
RAID	R EY D
RAIDED	R EY D IH D
RAIDER	R EY D ER
RAIDERS	R EY D ER Z
RAIDING	R EY D IH NG
RAIDS	R EY D Z
RAIL	R EY L
RAILBIRD	R EY L B ER D
RAILBIRDS	R EY L B ER D Z
RAILBUS	R EY L B AH S
RAILBUSES	R EY L B AH S IH Z
RAILBUSSES	R EY L B AH S IH Z
RAILCAR	R EY L K AA R
RAILCARS	R EY L K AA R Z
RAILED	R EY L D
RAILER	R EY L ER
RAILERS	R EY L ER Z
RAILHEAD	R EY L HH EH D
RAILHEADS	R EY L HH EH D Z
RAILING	R EY L IH NG
RAILINGS	R EY L IH NG Z
RAILLERIES	R EY L AH R IY Z
RAILLERY	R EY L AH R IY
RAILROAD	R EY L R OW D
RAILROADED	R EY L R OW D IH D
RAILROADER	R EY L R OW D ER
RAILROADERS	R EY L R OW D ER Z
RAILROADING	R EY L R OW D IH NG
RAILROADINGS	R EY L R OW D IH NG Z
RAILROADS	R EY L R OW D Z
RAILS	R EY L Z
RAILWAY	R EY L W EY
RAILWAYS	R EY L W EY Z
RAIMENT	R EY M AH N T
RAIMENTS	R EY M AH N T S
RAIN	R EY N
RAINBAND	R EY N B AE N D
RAINBANDS	R EY N B AE N D Z
RAINBIRD	R EY N B ER D
RAINBIRDS	R EY N B ER D Z
RAINBOW	R EY N B OW
RAINBOWLIKE	R EY N B AW L AY K
RAINBOWS	R EY N B OW Z
RAINCHECK	R EY N CH EH K
RAINCHECKS	R EY N CH EH K S
RAINCOAT	R EY N K OW T
RAINCOATS	R EY N K OW T S
RAINDROP	R EY N D R AA P
RAINDROPS	R EY N D R AA P S
RAINED	R EY N D
RAINFALL	R EY N F AO L
RAINFALLS	R EY N F AO L Z
RAINFOREST	R AY N F AO R AH S T
RAINFORESTS	R AY N F AO R AH S T S
RAINIER	R EY N IH R
RAINIEST	R EY N IY AH S T
RAINILY	R EY N IY L IY
RAINING	R EY N IH NG
RAINLESS	R EY N L AH S
RAINMAKER	R EY N M EY K ER
RAINMAKERS	R EY N M EY K ER Z
RAINMAKING	R EY N M EY K IH NG
RAINMAKINGS	R EY N M EY K IH NG Z
RAINOUT	R EY N AW T
RAINOUTS	R EY N AW T S
RAINPROOF	R EY N P R UW F
RAINS	R EY N Z
RAINSPOUT	R EY N S P AW T
RAINSPOUTS	R EY N S P AW T S
RAINSQUALL	R EY N S K W AO L
RAINSQUALLS	R EY N S K W AO L Z
RAINSTORM	R EY N S T AO R M
RAINSTORMS	R EY N S T AO R M Z
RAINWASH	R EY N W AA SH
RAINWASHED	R EY N W AA SH T
RAINWASHES	R EY N W AA SH IH Z
RAINWASHING	R EY N W AA SH IH NG
RAINWATER	R EY N W AO T ER
RAINWATERS	R EY N W AO T ER Z
RAINWEAR	R EY N W AE ER
RAINY	R EY N IY
RAISABLE	R EY Z AH B AH L
RAISE	R EY Z
RAISED	R EY Z D
RAISER	R EY Z ER
RAISERS	R EY Z ER Z
RAISES	R EY Z AH Z
RAISES(2)	R EY Z IH Z
RAISIN	R EY Z IH N
RAISING	R EY Z IH NG
RAISINGS	R EY Z IH NG Z
RAISINS	R EY Z AH N Z
RAISINS(2)	R EY Z IH N Z
RAISINY	R EY Z AH N IY
RAISONNE	R EY S AH N
RATTAIL	R AE T EY L
RATTAILS	R AE T EY L Z
RATTLEBRAIN	R AE T AH L B R EY N
RATTLEBRAINED	R AE T AH L B R EY N D
RATTLEBRAINS	R AE T AH L B R EY N Z
REACQUAINT	R IY AH K W EY N T
REACQUAINTED	R IY AH K W EY N T IH D
REACQUAINTING	R IY AH K W EY N T IH NG
REACQUAINTS	R IY AH K W EY N T S
REAPPRAISAL	R IY AH P R EY Z AH L
REAPPRAISALS	R IY AH P R EY Z AH L Z
REAPPRAISE	R IY AH P R EY Z
REAPPRAISED	R IY AH P R EY Z D
REAPPRAISES	R IY AH P R EY Z IH Z
REAPPRAISING	R IY AH P R EY Z IH NG
REASSAIL	R IY AH S EY L
REASSAILED	R IY AH S EY L D
REASSAILING	R IY AE S EY L IH NG
REASSAILS	R IY AH S EY L Z
REATTAIN	R IY AH T EY N
REATTAINED	R IY AH T EY N D
REATTAINING	R IY AH T EY N IH NG
REATTAINS	R IY AH T EY N Z
REAVAIL	R IY AH V EY L
REAVAILED	R IY AH V EY L D
REAVAILING	R IY AH V EY L IH NG
REAVAILS	R IY AH V EY L Z
REBAIT	R IY B EY T
REBAITED	R IY B EY T IH D
REBAITING	R IY B EY T IH NG
REBAITS	R IY B EY T S
RECLAIM	R IY K L EY M
RECLAIMABLE	R IY K L EY M AH B AH L
RECLAIMED	R IY K L EY M D
RECLAIMING	R IY K L EY M IH NG
RECLAIMS	R IY K L EY M Z
RECONNAISSANCE	R IY K AA N AH S AH N S
RECONNAISSANCES	R IH K AA N AH Z AH N S IH Z
REDBAIT	R EH D B EY T
REDBAITED	R EH D B EY T IH D
REDBAITING	R EH D B EY T IH NG
REDBAITS	R EH D B EY T S
REDTAIL	R EH D T EY L
REDTAILS	R EH D T EY L Z
REFRAIN	R IH F R EY N
REFRAINED	R IH F R EY N D
REFRAINING	R IH F R EY N IH NG
REFRAINMENT	R IH F R EY N M AH N T
REFRAINMENTS	R IH F R EY N M AH N T S
REFRAINS	R IH F R EY N Z
REGAIN	R IH G EY N
REGAINED	R IY G EY N D
REGAINER	R IY G EY N ER
REGAINERS	R IY G EY N ER Z
REGAINING	R IH G EY N IH NG
REGAINS	R IY G EY N Z
RELAID	R IY L EY D
REMAIL	R IY M EY L
REMAILED	R IY M EY L D
REMAILING	R IY M EY L IH NG
REMAILS	R IY M EY L Z
REMAIN	R IH M EY N
REMAIN(2)	R IY M EY N
REMAINDER	R IH M EY N D ER
REMAINDER(2)	R IY M EY N D ER
REMAINDERED	R IH M EY N D ER D
REMAINDERING	R IH M EY N D ER IH NG
REMAINDERS	R IH M EY N D ER Z
REMAINED	R IH M EY N D
REMAINED(2)	R IY M EY N D
REMAINING	R IH M EY N IH NG
REMAINING(2)	R IY M EY N IH NG
REMAINS	R IH M EY N Z
REMAINS(2)	R IY M EY N Z
RENAIL	R IY N EY L
RENAILED	R IY N EY L D
RENAILING	R IY N EY L IH NG
RENAILS	R IY N EY L Z
RENAISSANCE	R EH N AH S AA N S
RENAISSANCES	R EH N AH S AA N S IH Z
REOBTAIN	R IY AH B T EY N
REOBTAINED	R IY AH B T EY N D
REOBTAINING	R IY AH B T EY N IH NG
REOBTAINS	R IY AH B T EY N Z
REORDAIN	R IY AO R D EY N
REORDAINED	R IY AO R D EY N D
REORDAINING	R IY AO R D EY N IH NG
REORDAINS	R IY AO R D EY N Z
REPAID	R IY P EY D
REPAINT	R IY P EY N T
REPAINTED	R IY P EY N T AH D
REPAINTING	R IY P EY N T IH NG
REPAINTS	R IY P EY N T S
REPAIR	R IH P EH R
REPAIRABILITIES	R IH P EH R AH B IH L AH T EH Z
REPAIRABILITY	R IH P EH R AH B IH L AH T EH
REPAIRABLE	R IH P EH R AH B AH L
REPAIRED	R IH P EH R D
REPAIRED(2)	R IY P EH R D
REPAIRER	R IH P EH R ER
REPAIRERS	R IH P EH R ER Z
REPAIRING	R IH P EH R IH NG
REPAIRING(2)	R IY P EH R IH NG
REPAIRMAN	R IH P EH R M AE N
REPAIRMAN(2)	R IY P EH R M AE N
REPAIRMEN	R IH P EH R M EH N
REPAIRS	R IH P EH R Z
REPAIRS(2)	R IY P EH R Z
RERAISE	R IY R EY Z
RERAISED	R IY R EY Z D
RERAISES	R IY R EY Z IH Z
RERAISING	R IY R EY Z IH NG
RESAID	R IY S EH D
RESAIL	R IY S EY L
RESAILED	R IY S EY L D
RESAILING	R IY S EY L IH NG
RESAILS	R IY S EY L Z
RESTRAIN	R IY S T R EY N
RESTRAINABLE	R IY S T R EY N AH B AH L
RESTRAINED	R IY S T R EY N D
RESTRAINEDLY	R IY S T R EY N AH D L IY
RESTRAINER	R IY S T R EY N ER
RESTRAINERS	R IY S T R EY N ER Z
RESTRAINING	R IY S T R EY N IH NG
RESTRAINS	R IY S T R EY N Z
RESTRAINT	R IH S T R EY N T
RESTRAINT(2)	R IY S T R EY N T
RESTRAINTS	R IH S T R EY N T S
RESTRAINTS(2)	R IY S T R EY N T S
RETAIL	R IY T EY L
RETAILED	R IY T EY L D
RETAILER	R IY T EY L ER
RETAILERS	R IY T EY L ER Z
RETAILING	R IY T EY L IH NG
RETAILINGS	R IY T EY L IH NG Z
RETAILOR	R IY T EY L ER
RETAILORED	R IY T EY L ER D
RETAILORING	R IY T EY L ER IH NG
RETAILORS	R IY T EY L ER Z
RETAILS	R IY T EY L Z
RETAIN	R IH T EY N
RETAIN(2)	R IY T EY N
RETAINED	R IH T EY N D
RETAINED(2)	R IY T EY N D
RETAINER	R IH T EY N ER
RETAINER(2)	R IY T EY N ER
RETAINERS	R IH T EY N ER Z
RETAINING	R IH T EY N IH NG
RETAINING(2)	R IY T EY N IH NG
RETAINS	R IH T EY N Z
RETAINS(2)	R IY T EY N Z
RETRAIN	R IY T R EY N
RETRAINABLE	R IY T R EY N AH B AH L
RETRAINED	R IY T R EY N D
RETRAINING	R IY T R EY N IH NG
RETRAINS	R IY T R EY N Z
RHUMBAING	R AH M B EY AH NG
RINGTAIL	R IH NG T EY L
RINGTAILS	R IH NG T EY L Z
ROCAILLE	R AH K EY L
ROCAILLES	R AH K EY L Z
ROMAINE	R OW M EY N
ROMAINES	R AH M EY N Z
RUBAIYAT	R UW B EY AY AH T
RUMBAING	R AH M B EY AH NG
SAICE	S EY AH S
SAICES	S EY AH S
SAID	S EH D
SAIDS	S EH D Z
SAIGA	S EY G AH
SAIGAS	S EY G AH Z
SAIL	S EY L
SAILABLE	S EY L AH B AH L
SAILBOARD	S EY L B OW R D
SAILBOARDING	S EY L B OW R D IH NG
SAILBOARDINGS	S EY L B OW R D IH NG Z
SAILBOARDS	S EY L B OW R D Z
SAILBOAT	S EY L B OW T
SAILBOATER	S EY L B OW T ER
SAILBOATERS	S EY L B OW T ER Z
SAILBOATING	S EY L B OW T IH NG
SAILBOATINGS	S EY L B OW T IH NG Z
SAILBOATS	S EY L B OW T S
SAILCLOTH	S EY L K L AO TH
SAILCLOTHS	S EY L K L AO TH S
SAILED	S EY L D
SAILER	S EY L ER
SAILERS	S EY L ER Z
SAILFISH	S EY L F IH SH
SAILFISHES	S EY L F IH SH IH Z
SAILING	S EY L IH NG
SAILINGS	S EY L IH NG Z
SAILOR	S EY L ER
SAILORLY	S EY L ER L IY
SAILORS	S EY L ER Z
SAILPLANE	S EY L P L EY N
SAILPLANED	S EY L P L EY N D
SAILPLANER	S EY L P L EY N ER
SAILPLANERS	S EY L P L EY N ER Z
SAILPLANES	S EY L P L EY N Z
SAILPLANING	S EY L P L EY N IH NG
SAILS	S EY L Z
SAIMIN	S EY M AH N
SAIMINS	S EY M AH N Z
SAIN	S EY N
SAINED	S EY N D
SAINFOIN	S EY N F OY N
SAINFOINS	S EY N F OY N Z
SAINING	S EY N AH NG
SAINS	S EY N Z
SAINT	S EY N T
SAINTDOM	S EY N T D AH M
SAINTDOMS	S EY N T D AH M Z
SAINTED	S EY N T IH D
SAINTHOOD	S EY N T HH UH D
SAINTHOODS	S EY N T HH UH D Z
SAINTING	S EY N T IH NG
SAINTLIER	S EY N T L IY ER
SAINTLIEST	S EY N T L IY AH S T
SAINTLIKE	S EY N T L AY K
SAINTLINESS	S EY N T L IY N AH S
SAINTLINESSES	S EY N T L IY N AH S IH Z
SAINTLY	S EY N T L IY
SAINTS	S EY N T S
SAINTSHIP	S EY N T SH IH P
SAINTSHIPS	S EY N T SH IH P S
SAITH	S EY TH
SAITHE	S EY DH
SAIYID	S EY IY AH D
SAIYIDS	S EY IY AH D Z
SAMBAING	S AA M B AH IH NG
SAMURAI	S AE M UH R AY
SAMURAI(2)	S AE M ER AY
SAMURAIS	S AE M ER AY Z
SAMURAIS(2)	S AE M ER IH Z
SANDPAINTING	S AE N D P EY N T IH NG
SANDPAINTINGS	S AE N D P EY N T IH NG Z
SCATTERBRAIN	S K AE T ER B R EY N
SCATTERBRAINED	S K AE T ER B R EY N D
SCATTERBRAINS	S K AE T ER B R EY N Z
SCISSORTAIL	S IH Z ER T EY L
SCISSORTAILS	S IH Z ER T EY L Z
SCRAICH	S K R EY CH
SCRAICHED	S K R EY CH T
SCRAICHING	S K R EY CH AH NG
SCRAICHS	S K R EY CH S
SCRAIGH	S K R EY
SCRAIGHED	S K R EY D
SCRAIGHING	S K R EY AH NG
SCRAIGHS	S K R EY Z
SEATRAIN	S IY T R EY N
SEATRAINS	S IY T R EY N Z
SEMIPORCELAIN	S EH M IY P OW R S AH L AH N
SEMIPORCELAINS	S EH M IY P OW R S AH L AH N Z
SEMITRAILER	S EH M IY T R EY L ER
SEMITRAILER(2)	S EH M IH T R EY L ER
SEMITRAILERS	S EH M IY T R EY L ER Z
SERAI	S EH R EY
SERAIL	S AH R EY L
SERAILS	S EH R EY AH L Z
SERAIS	S IH R AH IY Z
SEXTAIN	S EH K S T EY N
SEXTAINS	S EH K S T EY N Z
SHAIRD	SH AE AH R D
SHAIRDS	SH AE AH R D Z
SHAIRN	SH AE AH R N
SHAIRNS	SH AE AH R N Z
SHAITAN	SH EY T AH N
SHAITANS	SH EY T AH N Z
SHANGHAI	SH AE NG HH AY
SHANGHAIED	SH AH N EY D
SHANGHAIER	SH AE N EY AH R
SHANGHAIERS	SH AE N EY AH R Z
SHANGHAIING	SH AE N EY AH NG
SHANGHAIS	SH AE N EY AH S
SHAVETAIL	SH EY V T EY L
SHAVETAILS	SH EY V T EY L Z
SHIRTTAIL	SH ER T EY L
SHIRTTAILS	SH ER T EY L Z
SHIRTWAIST	SH ER T W EY S T
SHIRTWAISTS	SH ER T W EY S T S
SHORTHAIR	SH AO R T HH EH R
SHORTHAIRED	SH AO R T HH EH R D
SHORTHAIRS	SH AO R T HH EH R Z
SKYSAIL	S K AY S EY L
SKYSAILS	S K AY S EY L Z
SLAIN	S L EY N
SLAINTE	S L EY N T
SNAIL	S N EY L
SNAILED	S N EY L D
SNAILING	S N EY L IH NG
SNAILLIKE	S N EY L AY K
SNAILS	S N EY L Z
SOLITAIRE	S AA L AH T EH R
SOLITAIRES	S AH L IH T AH AH R Z
SOOTHSAID	S UW TH S EY D
SOPAIPILLA	S AA P AH P IH L AH
SOPAIPILLAS	S AA P AH P IH L AH Z
SPAIL	S P EY L
SPAILS	S P EY AH L Z
SPAIT	S P EY T
SPAITS	S P EY T S
SPONDAIC	S P AA N D EY AH K
SPONDAICS	S P AA N D EY AH S Z
SPRAIN	S P R EY N
SPRAINED	S P R EY N D
SPRAINING	S P R EY N IH NG
SPRAINS	S P R EY N Z
SPRINGTAIL	S P R IH NG T EY L
SPRINGTAILS	S P R IH NG T EY L Z
SPRITSAIL	S P R IH T S EY L
SPRITSAILS	S P R IH T S EY AH L Z
STAID	S T EY D
STAIDER	S T EY D ER
STAIDEST	S T EY D AH S T
STAIDLY	S T EY D L IY
STAIDNESS	S T EY D N AH S
STAIDNESSES	S T EY D N AH S IH Z
STAIG	S T EY G
STAIGS	S T EY G Z
STAIN	S T EY N
STAINABILITIES	S T EY N AH B IH L AH T EH Z
STAINABILITY	S T EY N AH B IH L AH T EH
STAINABLE	S T EY N AH B AH L
STAINED	S T EY N D
STAINER	S T EY N ER
STAINERS	S T EY N ER Z
STAINING	S T EY N IH NG
STAINLESS	S T EY N L AH S
STAINLESSES	S T EY N L AH S IH Z
STAINLESSLY	S T EY N L AH S L IY
STAINPROOF	S T EY N P R UW F
STAINS	S T EY N Z
STAIR	S T EH R
STAIRCASE	S T EH R K EY S
STAIRCASES	S T EH R K EY S IH Z
STAIRS	S T EH R Z
STAIRWAY	S T EH R W EY
STAIRWAYS	S T EH R W EY Z
STAIRWELL	S T EH R W EH L
STAIRWELLS	S T EH R W EH L Z
STAITHE	S T EY DH
STAITHES	S T EY TH S
STANZAIC	S T AE N Z EY AH K
STAYSAIL	S T EY S EY L
STAYSAILS	S T EY S EY L Z
STELAI	S T EH L EY
STOAI	S T OW IY
STRAIGHT	S T R EY T
STRAIGHTAWAY	S T R EY T AH W EY
STRAIGHTAWAYS	S T R EY T AH W EY Z
STRAIGHTBRED	S T R EY T B R EH D
STRAIGHTBREDS	S T R EY T B R EH D Z
STRAIGHTED	S T R EY T IH D
STRAIGHTEDGE	S T R EY T EH JH
STRAIGHTEDGES	S T R EY T EH JH IH Z
STRAIGHTEN	S T R EY T AH N
STRAIGHTENED	S T R EY T AH N D
STRAIGHTENER	S T R EY T AH N ER
STRAIGHTENERS	S T R EY T AH N ER Z
STRAIGHTENING	S T R EY T AH N IH NG
STRAIGHTENING(2)	S T R EY T N IH NG
STRAIGHTENS	S T R EY T AH N Z
STRAIGHTER	S T R EY T ER
STRAIGHTEST	S T R EY T AH S T
STRAIGHTFORWARD	S T R EY T F AO R W ER D
STRAIGHTFORWARDLY	S T R EY T F AO R W ER D L IY
STRAIGHTFORWARDNESS	S T R EY T F AO R W ER D N AH S
STRAIGHTFORWARDNESSES	S T R EY T F AO R W ER D N AH S IH Z
STRAIGHTFORWARDS	S T R EY T F AO R W ER D Z
STRAIGHTING	S T R EY T IH NG
STRAIGHTISH	S T R EY T IH SH
STRAIGHTJACKET	S T R EY T JH AE K AH T
STRAIGHTJACKETED	S T R EY T JH AE K AH T IH D
STRAIGHTJACKETING	S T R EY T JH AE K AH T IH NG
STRAIGHTJACKETS	S T R EY T JH AE K AH T S
STRAIGHTLACED	S T R EY T L EY S T
STRAIGHTLY	S T R EY T L IY
STRAIGHTNESS	S T R EY T N AH S
STRAIGHTNESSES	S T R EY T N AH S IH Z
STRAIGHTS	S T R EY T S
STRAIGHTWAY	S T R EY T W EY
STRAIN	S T R EY N
STRAINED	S T R EY N D
STRAINER	S T R EY N ER
STRAINERS	S T R EY N ER Z
STRAINING	S T R EY N IH NG
STRAINS	S T R EY N Z
STRAIT	S T R EY T
STRAITEN	S T R EY T AH N
STRAITENED	S T R EY T AH N D
STRAITENING	S T R EY T AH N IH NG
STRAITENS	S T R EY T AH N Z
STRAITER	S T R EY T ER
STRAITEST	S T R EY T AH S T
STRAITJACKET	S T R EY T JH AE K AH T
STRAITJACKETED	S T R EY T JH AE K AH T IH D
STRAITJACKETING	S T R EY T JH AE K AH T IH NG
STRAITJACKETS	S T R EY T JH AE K AH T S
STRAITLACED	S T R EY T L EY S T
STRAITLACEDLY	S T R EY T L EY S AH D L IY
STRAITLACEDNESS	S T R EY T L EY S AH D N AH S
STRAITLACEDNESSES	S T R EY T L EY S AH D N AH S IH Z
STRAITLY	S T R EY T L IY
STRAITNESS	S T R EY T N AH S
STRAITNESSES	S T R EY T N AH S IH Z
STRAITS	S T R EY T S
STRAVAIG	S T R AH V EY G
STRAVAIGED	S T R AH V EY JH D
STRAVAIGING	S T R AH V EY JH AH NG
STRAVAIGS	S T R AH V EY G Z
STUNSAIL	S T AH N S EY L
STUNSAILS	S T AH N S EY L Z
SUBPENAING	S AH B P EH N EY AH NG
SUBPOENAING	S AH P IY N AH IH NG
SUPERBILLIONAIRE	S UW P ER B IH L Y AH N AH AY ER
SUPERBILLIONAIRES	S UW P ER B IH L Y AH N AH AY ER Z
SUPERLAIN	S UW P ER L EY N
SUPERMILLIONAIRE	S UW P ER M IH L Y AH N EH R
SUPERMILLIONAIRES	S UW P ER M IH L Y AH N EH R Z
SUSTAIN	S AH S T EY N
SUSTAINABILITIES	S AH S T EY N AH B IH L AH T EH Z
SUSTAINABILITY	S AH S T EY N AH B IH L IH T IY
SUSTAINABLE	S AH S T EY N AH B AH L
SUSTAINED	S AH S T EY N D
SUSTAINEDLY	S AH S T EY N AH D L IY
SUSTAINER	S AH S T EY N ER
SUSTAINERS	S AH S T EY N ER Z
SUSTAINING	S AH S T EY N IH NG
SUSTAINS	S AH S T EY N Z
SUZERAIN	S UW Z AH R EY N
SUZERAINS	S UW Z AH R EY N Z
SUZERAINTIES	S UW Z AH R AH N T IY Z
SUZERAINTY	S UW Z AH R AH N T IY
SWAIL	S W EY L
SWAILS	S W EY L Z
SWAIN	S W EY N
SWAINISH	S W EY N AH SH
SWAINISHNESS	S W EY N IH SH N AH S
SWAINISHNESSES	S W EY N IH SH N EH S AH Z
SWAINS	S W EY N Z
SWALLOWTAIL	S W AA L OW T EY L
SWALLOWTAILS	S W AA L OW T EY L Z
SWORDTAIL	S OW R D T EY L
SWORDTAILS	S OW R D T EY L Z
TAFFRAIL	T AE F R EY L
TAFFRAILS	T AE F R EY AH L Z
TAIGA	T EY G AH
TAIGAS	T EY G AH Z
TAIGLACH	T EY G L AH CH
TAIL	T EY L
TAILBACK	T EY L B AE K
TAILBACKS	T EY L B AE K S
TAILBOARD	T EY L B OW R D
TAILBOARDS	T EY L B OW R D Z
TAILBONE	T EY L B OW N
TAILBONES	T EY L B OW N Z
TAILCOAT	T EY L K OW T
TAILCOATED	T EY L K OW T IH D
TAILCOATS	T EY L K OW T S
TAILED	T EY L D
TAILENDER	T EY L EH N D ER
TAILENDERS	T EY L EH N D ER Z
TAILER	T EY L ER
TAILERS	T EY L ER Z
TAILFAN	T EY L F AE N
TAILFANS	T EY L F AE N Z
TAILGATE	T EY L G EY T
TAILGATED	T EY L G EY T IH D
TAILGATER	T EY L G EY T ER
TAILGATERS	T EY L G EY T ER Z
TAILGATES	T EY L G EY T S
TAILGATING	T EY L G EY T IH NG
TAILING	T EY L IH NG
TAILINGS	T EY L IH NG Z
TAILLAMP	T EY L AE M P
TAILLAMPS	T EY L AE M P S
TAILLE	T EY L
TAILLES	T EY L Z
TAILLESS	T EY L AH S
TAILLEUR	T EY L AH R
TAILLEURS	T EY L IY Y AH R Z
TAILLIGHT	T EY L AY T
TAILLIGHTS	T EY L AY T S
TAILLIKE	T EY L AY K
TAILOR	T EY L ER
TAILORBIRD	T EY L ER B ER D
TAILORBIRDS	T EY L ER B ER D Z
TAILORED	T EY L ER D
TAILORING	T EY L ER IH NG
TAILORINGS	T EY L ER IH NG Z
TAILORS	T EY L ER Z
TAILPIECE	T EY L P IY S
TAILPIECES	T EY L P IY S IH Z
TAILPIPE	T EY L P AY P
TAILPIPES	T EY L P AY P S
TAILPLANE	T EY L P L EY N
TAILPLANES	T EY L P L EY N Z
TAILRACE	T EY L R EY S
TAILRACES	T EY L R EY S IH Z
TAILS	T EY L Z
TAILSKID	T EY L S K IH D
TAILSKIDS	T EY L S K IH D Z
TAILSLIDE	T EY L S L AY D
TAILSLIDES	T EY L S L AY D Z
TAILSPIN	T EY L S P IH N
TAILSPINS	T EY L S P IH N Z
TAILWATER	T EY L W AO T ER
TAILWATERS	T EY L W AO T ER Z
TAILWIND	T EY L W IH N D
TAILWINDS	T EY L W IH N D Z
TAIN	T EY N
TAINS	T EY N Z
TAINT	T EY N T
TAINTED	T EY N T IH D
TAINTING	T EY N T IH NG
TAINTLESS	T EY N T L AH S
TAINTS	T EY N T S
TAIPAN	T EY P AH N
TAIPANS	T EY P AH N Z
TALLAISIM	T AE L EY S AH M
TAXPAID	T AE K S P EY D
TEARSTAIN	T IH ER S T EY N
TEARSTAINED	T IH ER S T EY N D
TEARSTAINS	T IH ER S T EY N Z
TENAIL	T EH N EY L
TENAILLE	T AH N EY L
TENAILLES	T AH N EY L Z
TENAILS	T EH N EY L Z
TERAI	T EH R EY
TERAIS	T EH R EY AH S
TERRAIN	T ER EY N
TERRAINS	T ER EY N Z
TETRACAINE	T EH T R AH K EY N
TETRACAINES	T EH T R AH K EY N Z
THAIRM	TH AE AH R M
THAIRMS	TH AE AH R M Z
THEBAINE	TH AH B EY N
THEBAINES	TH AH B EY N Z
THUMBNAIL	TH AH M N EY L
THUMBNAILS	TH AH M N EY L Z
TOENAIL	T OW N EY L
TOENAILED	T OW N EY L D
TOENAILING	T OW N EY L IH NG
TOENAILS	T OW N EY L Z
TOPSAIL	T AA P S EY L
TOPSAILS	T AA P S EY L Z
TRAIK	T R EY K
TRAIKED	T R EY K T
TRAIKING	T R EY K AH NG
TRAIKS	T R EY K S
TRAIL	T R EY L
TRAILBLAZER	T R EY L B L EY Z ER
TRAILBLAZERS	T R EY L B L EY Z ER Z
TRAILBLAZING	T R EY L B L EY Z IH NG
TRAILBREAKER	T R EY L B R EY K ER
TRAILBREAKERS	T R EY L B R EY K ER Z
TRAILED	T R EY L D
TRAILER	T R EY L ER
TRAILERABLE	T R EY L ER AH B AH L
TRAILERED	T R EY L ER D
TRAILERING	T R EY L ER IH NG
TRAILERINGS	T R EY L ER IH NG Z
TRAILERIST	T R EY L ER IH S T
TRAILERISTS	T R EY L ER IH S T S
TRAILERITE	T R EY L AH R AY T
TRAILERITES	T R EY L AH R AY T S
TRAILERS	T R EY L ER Z
TRAILHEAD	T R EY L HH EH D
TRAILHEADS	T R EY L HH EH D Z
TRAILING	T R EY L IH NG
TRAILLESS	T R EY L AH S
TRAILS	T R EY L Z
TRAILSIDE	T R EY L S AY D
TRAIN	T R EY N
TRAINABILITIES	T R EY N AH B IH L AH T EH Z
TRAINABILITY	T R EY N AH B IH L AH T EH
TRAINABLE	T R EY N AH B AH L
TRAINBAND	T R EY N B AE N D
TRAINBANDS	T R EY N B AE N D Z
TRAINBEARER	T R EY N B AE ER ER
TRAINBEARERS	T R EY N B AE ER ER Z
TRAINED	T R EY N D
TRAINEE	T R EY N IY
TRAINEES	T R EY N IY Z
TRAINEESHIP	T R EY N IY SH IH P
TRAINEESHIPS	T R EY N IY SH IH P S
TRAINER	T R EY N ER
TRAINERS	T R EY N ER Z
TRAINFUL	T R EY N F AH L
TRAINFULS	T R EY N F AH L Z
TRAINING	T R EY N IH NG
TRAININGS	T R EY N IH NG Z
TRAINLOAD	T R EY N L OW D
TRAINLOADS	T R EY N L OW D Z
TRAINMAN	T R EY N M AE N
TRAINMEN	T R EY N M AH N
TRAINS	T R EY N Z
TRAINWAY	T R EY N W EY
TRAINWAYS	T R EY N W EY Z
TRAIPSE	T R EY P S
TRAIPSED	T R EY P S T
TRAIPSES	T R EY P S IH Z
TRAIPSING	T R EY P S IH NG
TRAIT	T R EY T
TRAITOR	T R EY T ER
TRAITORESS	T R EY T ER AH S
TRAITORESSES	T R EY T ER AH S IH Z
TRAITOROUS	T R EY T ER AH S
TRAITOROUSLY	T R EY T ER AH S L IY
TRAITORS	T R EY T ER Z
TRAITRESS	T R EY T R AH S
TRAITRESSES	T R EY T R EH S AH Z
TRAITS	T R EY T S
TRANSMOUNTAIN	T R AE N S M AW N T AH N
TRAVAIL	T R AH V EY L
TRAVAILED	T R AE V EY AH L D
TRAVAILING	T R AH V EY AH L AH NG
TRAVAILS	T R AH V EY L Z
TREENAIL	T R IY N EY L
TREENAILS	T R IY N EY L Z
TRENAIL	T R AH N EY L
TRENAILS	T R EH N EY AH L Z
TRIPLETAIL	T R IH P AH L T EY L
TRIPLETAILS	T R IH P AH L T EY L Z
TRISKAIDEKAPHOBIA	T R IH S EY D AH K AH F OW B IY AH
TRISKAIDEKAPHOBIAS	T R IH S EY D AH K AH F OW B IY AH Z
TROCHAIC	T R AA CH EY AH K
TROCHAICS	T R AA CH EY AH S Z
TRYSAIL	T R AY S EY L
TRYSAILS	T R AY S EY L Z
TUBAIST	T UW B AH IH S T
TUBAISTS	T UW B AH IH S T S
TWAIN	T W EY N
TWAINS	T W EY N Z
UINTAITE	UW N T EY T
UINTAITES	UW N T EY T S
ULTRAISM	AH L T R EY IH Z AH M
ULTRAISMS	AH L T R AH IH Z AH M Z
ULTRAIST	AH L T R EY AH S T
ULTRAISTIC	AH L T R AH IH S T AH K
ULTRAISTS	AH L T R AH IH S T S
UMBRELLAING	AH M B R EH L AH IH NG
UNACQUAINTED	AH N AH K W EY N T IH D
UNAFRAID	AH N AH F R EY D
UNAI	AH N EY
UNAIDED	AH N EY D IH D
UNAIMED	AH N EY M D
UNAIRED	AH N EH R D
UNAIS	AH N EY AH S
UNASSAILABILITIES	AH N AH S EY L AH B IH L AH T EH Z
UNASSAILABILITY	AH N AH S EY L AH B IH L AH T EH
UNASSAILABLE	AH N AH S EY L AH B AH L
UNASSAILABLENESS	AH N AH S EY L AH B AH L N AH S
UNASSAILABLENESSES	AH N AH S EY L AH B AH L N AH S IH Z
UNASSAILABLY	AH N AH S EY L AH B L IY
UNASSAILED	AH N AH S EY L D
UNATTAINABLE	AH N AH T EY N AH B AH L
UNAVAILABILITIES	AH N AH V EY L AH B IH L AH T EH Z
UNAVAILABILITY	AH N AH V EY L AH B IH L IH T IY
UNAVAILABLE	AH N AH V EY L AH B AH L
UNAVAILING	AH N AH V EY L IH NG
UNAVAILINGLY	AH N AH V EY L IH NG L IY
UNAVAILINGNESS	AH N AH V EY L IH NG N AH S
UNAVAILINGNESSES	AH N AH V EY L IH NG N AH S IH Z
UNBRAID	AH N B R EY D
UNBRAIDED	AH N B R EY D IH D
UNBRAIDING	AH N B R EY D IH NG
UNBRAIDS	AH N B R EY D Z
UNCERTAIN	AH N S ER T AH N
UNCERTAINLY	AH N S ER T AH N L IY
UNCERTAINNESS	AH N S ER T AH N AH S
UNCERTAINNESSES	AH N S ER T AH N AH S IH Z
UNCERTAINTIES	AH N S ER T AH N T IY Z
UNCERTAINTY	AH N S ER T AH N T IY
UNCHAIN	AH N CH EY N
UNCHAINED	AH N CH EY N D
UNCHAINING	AH N CH EY N IH NG
UNCHAINS	AH N CH EY N Z
UNCLAIMED	AH N K L EY M D
UNCOMPLAINING	AH N K AH M P L EY N IH NG
UNCOMPLAININGLY	AH N K AH M P L EY N IH NG L IY
UNCONSTRAINED	AH N K AH N S T R EY N D
UNCONSTRAINT	AH N K AH N S T R EY N T
UNCONSTRAINTS	AH N K AH N S T R EY N T S
UNCONTAINABLE	AH N K AH N T EY N AH B AH L
UNCURTAINED	AH N K ER T AH N D
UNDERLAID	AH N D ER L EY D
UNDERLAIN	AH N D ER L EY N
UNDERPAID	AH N D ER P EY D
UNDERPAINTING	AH N D ER P EY N T IH NG
UNDERPAINTINGS	AH N D ER P EY N T IH NG Z
UNDOCTRINAIRE	AH N D AA K T R AH N EH R
UNDRAINED	AH N D R EY N D
UNEXPLAINABLE	AH N IH K S P L EY N AH B AH L
UNEXPLAINED	AH N IH K S P L EY N D
UNFAILING	AH N F EY L IH NG
UNFAILINGLY	AH N F EY L IH NG L IY
UNFAIR	AH N F EH R
UNFAIR(2)	AO N F EH R
UNFAIRER	AH N F EH R ER
UNFAIREST	AH N F EH R AH S T
UNFAIRLY	AH N F EH R L IY
UNFAIRNESS	AH N F EH R N AH S
UNFAIRNESSES	AH N F EH R N AH S IH Z
UNFAITH	AH N F EY TH
UNFAITHFUL	AH N F EY TH F AH L
UNFAITHFULLY	AH N F EY TH F AH L IY
UNFAITHFULNESS	AH N F EY TH F AH L N AH S
UNFAITHFULNESSES	AH N F EY TH F AH L N AH S IH Z
UNFAITHS	AH N F EY TH S
UNGAINLIER	AH N G EY N L IY ER
UNGAINLIEST	AH N G EY N L IY AH S T
UNGAINLINESS	AH N G EY N L IY N AH S
UNGAINLINESSES	AH N G EY N L IY N AH S IH Z
UNGAINLY	AH N G EY N L IY
UNHAILED	AH N HH EY L D
UNHAIR	AH N HH EH R
UNHAIRED	AH N HH EH R D
UNHAIRING	AH N HH EH R IH NG
UNHAIRS	AH N HH EH R Z
UNIMPAIRED	AH N IH M P EH R D
UNLAID	AH N L EY D
UNNAIL	AH N EY L
UNNAILED	AH N EY L D
UNNAILING	AH N EY L IH NG
UNNAILS	AH N EY L Z
UNOBTAINABLE	AH N AH B T EY N AH B AH L
UNPAID	AH N P EY D
UNPAINTED	AH N P EY N T IH D
UNPAIRED	AH N P EH R D
UNPLAIT	AH N P L EY T
UNPLAITED	AH N P L EY T AH D
UNPLAITING	AH N P L EY T AH NG
UNPLAITS	AH N P L EY T S
UNRAISED	AH N R EY Z D
UNRECLAIMABLE	AH N R IY K L EY M AH B AH L
UNRECLAIMED	AH N R IY K L EY M D
UNREPAID	AH N R IY P EY D
UNREPAIR	AH N R IH P EH R
UNREPAIRS	AH N R IH P EH R Z
UNRESTRAINED	AH N R IY S T R EY N D
UNRESTRAINEDLY	AH N R IY S T R EY N AH D L IY
UNRESTRAINEDNESS	AH N R IY S T R EY N AH D N AH S
UNRESTRAINEDNESSES	AH N R IY S T R EY N AH D N AH S IH Z
UNRESTRAINT	AH N R IH S T R EY N T
UNRESTRAINTS	AH N R IH S T R EY N T S
UNSAID	AH N S EH D
UNSTAINED	AH N S T EY N D
UNSTRAINED	AH N S T R EY N D
UNSUSTAINABLE	AH N S AH S T EY N AH B AH L
UNTAINTED	AH N T EY N T IH D
UNTRAINED	AH N T R EY N D
UPBRAID	AH P B R EY D
UPBRAIDED	AH P B R EY D IH D
UPBRAIDER	AH P B R EY D ER
UPBRAIDERS	AH P B R EY D ER Z
UPBRAIDING	AH P B R EY D IH NG
UPBRAIDS	AH P B R EY D Z
UPRAISE	AH P R EY Z
UPRAISED	AH P R EY Z D
UPRAISER	AH P R EY Z ER
UPRAISERS	AH P R EY Z ER Z
UPRAISES	AH P R EY Z IH Z
UPRAISING	AH P R EY Z IH NG
UPSADAISY	AH P S AH D EY Z IY
UPSTAIR	AH P S T EH R
UPSTAIRS	AH P S T EH R Z
VAIL	V EY L
VAILED	V EY L D
VAILING	V EY L IH NG
VAILS	V EY L Z
VAIN	V EY N
VAINER	V EY N ER
VAINEST	V EY N AH S T
VAINGLORIES	V EY N G L OW R IY Z
VAINGLORIOUS	V EY N G L OW R IY AH S
VAINGLORIOUSLY	V EY N G L OW R IY AH S L IY
VAINGLORIOUSNESS	V EY N G L OW R IY AH S N AH S
VAINGLORIOUSNESSES	V EY N G L OW R IY AH S N AH S IH Z
VAINGLORY	V EY N G L OW R IY
VAINLY	V EY N L IY
VAINNESS	V EY N AH S
VAINNESSES	V EY N AH S IH Z
VAIR	V AE AH R
VAIRS	V AE AH R Z
VENTAIL	V EH N T EY L
VENTAILS	V EH N T EY L Z
VERVAIN	V AH R V EY N
VERVAINS	V AH R V EY N Z
VILLAIN	V IH L AH N
VILLAINESS	V IH L AH N AH S
VILLAINESSES	V IH L AH N AH S IH Z
VILLAINIES	V IH L AH N IY Z
VILLAINOUS	V IH L AH N AH S
VILLAINOUSLY	V IH L AH N AH S L IY
VILLAINOUSNESS	V IH L AH N AH S N AH S
VILLAINOUSNESSES	V IH L AH N AH S N AH S IH Z
VILLAINS	V IH L AH N Z
VILLAINY	V IH L AH N IY
VINAIGRETTE	V AH N EY G R EH T
VINAIGRETTES	V AH N EY G R EH T S
VIRELAI	V IH R AH L EY
VIRELAIS	V AH R EH L EY AH S
VISAING	V IY Z AH IH NG
VITRAIN	V IH T R EY N
VITRAINS	V IH T R EY N Z
VOLTAIC	V OW L T EY IH K
VOLTAISM	V OW L T EY IH Z AH M
VOLTAISMS	V OW L T EY Z AH M Z
WAGTAIL	W AE G T EY L
WAGTAILS	W AE G T EY L Z
WAIF	W EY F
WAIFED	W EY F T
WAIFING	W EY F AH NG
WAIFLIKE	W EY F L AY K
WAIFS	W EY F S
WAIL	W EY L
WAILED	W EY L D
WAILER	W EY L ER
WAILERS	W EY L ER Z
WAILFUL	W EY L F AH L
WAILFULLY	W EY L F AH L IY
WAILING	W EY L IH NG
WAILS	W EY L Z
WAILSOME	W EY L S AH M
WAIN	W EY N
WAINS	W EY N Z
WAINSCOT	W EY N S K AA T
WAINSCOTED	W EY N S K AA T IH D
WAINSCOTING	W EY N S K AA T IH NG
WAINSCOTINGS	W EY N S K AA T IH NG Z
WAINSCOTS	W EY N S K AA T S
WAINSCOTTED	W EY N S K AA T IH D
WAINSCOTTING	W EY N S K AO T IH NG
WAINSCOTTINGS	W EY N S K AA T IH NG Z
WAINWRIGHT	W EY N R AY T
WAINWRIGHTS	W EY N W R AY T S
WAIR	W AE AH R
WAIRED	W AE AH R D
WAIRING	W AE AH R AH NG
WAIRS	W AE AH R Z
WAIST	W EY S T
WAISTBAND	W EY S T B AE N D
WAISTBANDS	W EY S T B AE N D Z
WAISTCOAT	W EY S T K OW T
WAISTCOATED	W EY S T K OW T IH D
WAISTCOATS	W EY S T K OW T S
WAISTED	W EY S T IH D
WAISTER	W EY S T ER
WAISTERS	W EY S T ER Z
WAISTING	W EY S T IH NG
WAISTINGS	W EY S T IH NG Z
WAISTLINE	W EY S T L AY N
WAISTLINES	W EY S T L AY N Z
WAISTS	W EY S T S
WAIT	W EY T
WAITED	W EY T IH D
WAITER	W EY T ER
WAITERS	W EY T ER Z
WAITING	W EY T IH NG
WAITINGS	W EY T IH NG Z
WAITPERSON	W EY T P ER S AH N
WAITPERSONS	W EY T P ER S AH N Z
WAITRESS	W EY T R AH S
WAITRESSED	W EY T R AH S T
WAITRESSES	W EY T R AH S IH Z
WAITRESSING	W EY T R AH S IH NG
WAITS	W EY T S
WAITSTAFF	W EY T S T AE F
WAITSTAFFS	W EY T S T AE F S
WAIVE	W EY V
WAIVED	W EY V D
WAIVER	W EY V ER
WAIVERS	W EY V ER Z
WAIVES	W EY V Z
WAIVING	W EY V IH NG
WALLYDRAIGLE	W AA L AH D R EY G AH L
WALLYDRAIGLES	W AA L AH D R EY G AH L Z
WASSAIL	W AH Z EY L
WASSAILED	W AH Z EY L D
WASSAILER	W AH Z EY L ER
WASSAILERS	W AH Z EY L ER Z
WASSAILING	W AH Z EY L IH NG
WASSAILS	W AH Z EY L Z
WAYLAID	W EY L EY D
WHEELCHAIR	W IY L CH EH R
WHEELCHAIR(2)	HH W IY L CH EH R
WHEELCHAIRS	W IY L CH EH R Z
WHEELCHAIRS(2)	HH W IY L CH EH R Z
WHIPTAIL	W IH P T EY L
WHIPTAILS	W IH P T EY L Z
WHITEBAIT	W AY T B EY T
WHITEBAITS	W AY T B EY T S
WHITETAIL	W AY T T EY L
WHITETAIL(2)	HH W AY T T EY L
WHITETAIL(3)	HH W AY T EY L
WHITETAILS	W AY T EY L Z
WIREHAIR	W AY ER HH EH R
WIREHAIRED	W AY ER HH EH R D
WIREHAIRS	W AY ER HH EH R Z
WRAITH	R EY TH
WRAITHLIKE	R EY TH L AY K
WRAITHS	R EY TH S
YAIRD	Y AE AH R D
YAIRDS	Y AE AH R D Z
YELLOWTAIL	Y EH L OW T EY L
YELLOWTAILS	Y EH L OW T EY L Z
ZABAIONE	Z AE B EY OW N
ZABAIONES	Z AE B EY OW N Z
ZAIBATSU	Z EY B AE T S UW
ZAIKAI	Z EY K EY
ZAIKAIS	Z EY K EY AH S
ZAIRE	Z AY IH R
ZAIRES	Z AE AH R Z
ZEBRAIC	Z IY B R AH IH K
ZENAIDA	Z IH N EY D AH
ZENAIDAS	Z AH N EY D AH Z
ZILLIONAIRE	Z IH L Y AH N EH R
ZILLIONAIRES	Z IH L IY AA N AH AH R Z
PACER	P EY S ER
HOBGOBLIN	HH AA B AA B L AH N
IVERMECTIN	IH V AH R M EH K T AH N
IHRAM	IH R AH M
LI	L IY
IBOGAINE	AY B OW G EY N
IBOGAINE(2)	AY B AH G EY N
RYA	R AY AH
