AU	OW
ABLAUT	AE B L AH T
ABLAUTS	AE B L AH Y UW T S
ABOIDEAU	AH B OY D IY UW
ABOIDEAUS	AH B OY D IY AH S
ABOIDEAUX	AH B OY D IY AH K S
ABOITEAU	AH B OY T IY UW
ABOITEAUS	AH B OY T IY AH S
ABOITEAUX	AH B OY T IY AH K S
ACAUDAL	AE K AH D AH L
ACAUDATE	AE K AH D EY T
ACAULESCENT	AE K EY AH L EH S AH N T
ACAULINE	AE K AH L AY N
ACAULOSE	AE K AH L OW Z
ACAULOUS	AH K EY AH L AH S
AERONAUT	EH R AH N AH T
AERONAUTIC	EH R OW N AA T AH K
AERONAUTICAL	EH R OW N AA T AH K AH L
AERONAUTICAL(2)	EH R AH N AA T AH K AH L
AERONAUTICALLY	AE R AH N AO T IH K AH L IY
AERONAUTICS	EH R AH N AO T IH K S
AERONAUTS	AH R AA N AH Y UW T S
ALLOSAURUS	AE L AH S EY Y AH R AH S
ALLOSAURUSES	AE L AA S AH R UW Z AH Z
AMAUROSES	AE M AH R OW Z AH Z
AMAUROSIS	AH M EY Y AH R OW S AH S
AMAUROTIC	AE M AH R AH T AH K
ANKYLOSAUR	AE NG K IH L AH S AH R
ANKYLOSAURS	AE NG K IH L AH S EY Y AH R Z
ANKYLOSAURUS	AE NG K IH L AH S EY Y AH R AH S
ANKYLOSAURUSES	AE NG K AH L AA S AH R UW Z AH Z
ANTIAUTHORITARIAN	AE N T AY AH TH AO R AH T EH R IY AH N
ANTIAUTHORITARIANISM	AE N T AY AH TH AO R AH T EH R IY AH N IH Z AH M
ANTIAUTHORITARIANISMS	AE N T AY AH TH AO R AH T EH R IY AH N IH Z AH M Z
ANTIAUTHORITY	AE N T AY AH TH AO R AH T IY
ANTIAUXIN	AE N T AY AO K S AH N
ANTIAUXINS	AE N T AY AO K S AH N Z
ANTIBUREAUCRATIC	AE N T AY B Y UH R AH K R AE T IH K
ANTIFRAUD	AE N T IY F R AA D
ANTIFRAUD(2)	AE N T AY F R AA D
ANTINAUSEA	AE N T AY N AO Z IY AH
APATOSAURUS	AH P AE T AH S EY Y AH R AH S
APATOSAURUSES	AH P AH T AA S AH R UW Z AH Z
APPLAUD	AH P L AO D
APPLAUDABLE	AH P L AO D AH B AH L
APPLAUDABLY	AH P L AO D AH B L IY
APPLAUDED	AH P L AO D IH D
APPLAUDER	AH P L AO D ER
APPLAUDERS	AH P L AO D ER Z
APPLAUDING	AH P L AO D IH NG
APPLAUDS	AH P L AO D Z
APPLAUSE	AH P L AO Z
APPLAUSES	AH P L AO Z IH Z
APPLESAUCE	AE P AH L S AO S
APPLESAUCES	AE P AH L S AO S IH Z
AQUANAUT	AA K W AH N AA T
AQUANAUTS	AA K W AH N AA T S
ARAUCARIA	AE R AH K AE R IY AH
ARAUCARIAN	AE R AH K EH R IY AH N
ARAUCARIAS	AE R AH K AE R IY AH Z
ARCHOSAUR	AA R K AH S AH R
ARCHOSAURIAN	AA R K AH S AH Y UH R IY AH N
ARCHOSAURS	AA R K AH S EY Y AH R Z
ARGONAUT	AA R G AH N AO T
ARGONAUTS	AA R G AH N AO T S
ASSAULT	AH S AO L T
ASSAULTED	AH S AO L T IH D
ASSAULTER	AH S AO L T ER
ASSAULTERS	AH S AO L T ER Z
ASSAULTING	AH S AO L T IH NG
ASSAULTIVE	AH S AO L T IH V
ASSAULTIVELY	AH S AO L T IH V L IY
ASSAULTIVENESS	AH S AO L T IH V N AH S
ASSAULTIVENESSES	AH S AO L T IH V N AH S IH Z
ASSAULTS	AH S AO L T S
ASTRONAUT	AE S T R AH N AA T
ASTRONAUTIC	AE S T R AH N AA T IH K
ASTRONAUTICAL	AE S T R AH N AA T IH K AH L
ASTRONAUTICALLY	AE S T R AH N AO T IH K AH L IY
ASTRONAUTICS	AE S T R AH N AA T IH K S
ASTRONAUTS	AE S T R AH N AO T S
AUBADE	AH B EY D
AUBADES	AH B EY D Z
AUBERGE	AO B AH R JH
AUBERGES	AH B AH R JH AH Z
AUBERGINE	AO B AH R JH AY N
AUBERGINES	AO B AH R JH AY N Z
AUBRETIA	AO B R IY SH IY AH
AUBRETIAS	AO B R IY T IY AH Z
AUBRIETA	AO B R IY T AH
AUBRIETAS	AO B R IY T AH Z
AUBURN	AA B ER N
AUBURNS	AO B ER N Z
AUCTION	AA K SH AH N
AUCTION(2)	AO K SH AH N
AUCTIONED	AO K SH AH N D
AUCTIONEER	AA K SH AH N IH R
AUCTIONEERS	AO K SH AH N IH R Z
AUCTIONING	AO K SH AH N IH NG
AUCTIONS	AA K SH AH N Z
AUCTIONS(2)	AO K SH AH N Z
AUCTORIAL	AO K T AO R IY AH L
AUCUBA	AO K Y UW B AH
AUCUBAS	AO K Y UW B AH Z
AUDACIOUS	AA D EY SH AH S
AUDACIOUSLY	AO D AH S IY AH S L IY
AUDACIOUSNESS	AO D AH S IY AH S N AH S
AUDACIOUSNESSES	AO D AH S IY AH S N AH S IH Z
AUDACITIES	AO D AE S AH T IY Z
AUDACITY	AA D AE S AH T IY
AUDAD	AO D AH D
AUDADS	AO D AH D Z
AUDIAL	AO D IY AH L
AUDIBILITIES	AO D AH B IH L AH T IY Z
AUDIBILITY	AO D AH B IH L AH T IY
AUDIBLE	AA D AH B AH L
AUDIBLES	AA D AH B AH L Z
AUDIBLY	AA D AH B L IY
AUDIENCE	AA D IY AH N S
AUDIENCE(2)	AO D IY AH N S
AUDIENCES	AA D IY AH N S AH Z
AUDIENCES(2)	AO D IY AH N S AH Z
AUDIENT	AO D IY AH N T
AUDIENTS	AO D IY AH N T S
AUDILE	AO D AH L
AUDILES	AO D AH L Z
AUDING	AO D AH NG
AUDINGS	AO D AH NG Z
AUDIO	AA D IY OW
AUDIOBOOK	AO D IY OW B UH K
AUDIOBOOKS	AO D IY OW B UH K S
AUDIOCASSETTE	AH D IY AA K AH S EH T
AUDIOCASSETTES	AH D IY AH K AE S EH T S
AUDIOGENIC	AO D IY OW JH IY N IH K
AUDIOGRAM	AO D IY OW G R AE M
AUDIOGRAMS	AO D IY OW G R AE M Z
AUDIOLOGIC	AO D IY OW L AA JH IH K
AUDIOLOGICAL	AO D IY OW L AA JH IH K AH L
AUDIOLOGIES	AO D IY AA L AH JH IY Z
AUDIOLOGIST	AO D IY AA L AH JH AH S T
AUDIOLOGISTS	AO D IY AA L AH JH AH S T S
AUDIOLOGY	AO D IY AA L AH JH IY
AUDIOMETER	AO D IY OW M IY T ER
AUDIOMETERS	AO D IY OW M IY T ER Z
AUDIOMETRIC	AO D IY OW M EH T R IH K
AUDIOMETRIES	AO D IY OW M IY T ER IY Z
AUDIOMETRY	AO D IY OW M IY T ER IY
AUDIOPHILE	AO D IY OW F IY L
AUDIOPHILES	AO D IY OW F IY L Z
AUDIOS	AO D IY OW Z
AUDIOTAPE	AO D IY OW T EY P
AUDIOTAPES	AO D IY OW T EY P S
AUDIOVISUAL	AO D IY OW V IH ZH UW AH L
AUDIOVISUALS	AO D IY OW V IH ZH AH W AH L Z
AUDIT	AO D IH T
AUDITABLE	AO D AH T AH B AH L
AUDITED	AO D IH T IH D
AUDITING	AA D AH T IH NG
AUDITION	AA D IH SH AH N
AUDITIONED	AO D IH SH AH N D
AUDITIONING	AA D IH SH AH N IH NG
AUDITIONS	AO D IH SH AH N Z
AUDITIVE	AO D AH T IH V
AUDITIVES	AO D AH T IH V Z
AUDITOR	AO D IH T ER
AUDITORIA	AO D AH T AO R IY AH
AUDITORIES	AO D AH T ER IY Z
AUDITORILY	AO D AH T ER IY L IY
AUDITORIUM	AO D AH T AO R IY AH M
AUDITORIUMS	AO D IH T AO R IY AH M Z
AUDITORS	AA D AH T ER Z
AUDITORY	AO D IH T AO R IY
AUDITS	AA D AH T S
AUGEND	AO JH AH N D
AUGENDS	AO JH AH N D Z
AUGER	AO G ER
AUGERS	AO G ER Z
AUGHT	AO T
AUGHTS	AO T S
AUGITE	AH JH AY T
AUGITES	AH JH AY T S
AUGITIC	AO JH AH T AH K
AUGMENT	AO G M EH N T
AUGMENTATION	AA G M EH N T EY SH AH N
AUGMENTATIONS	AO G M EH N T EY SH AH N Z
AUGMENTATIVE	AO G M EH N T AH T IH V
AUGMENTATIVES	AO G M EH N T AH T IH V Z
AUGMENTED	AA G M EH N T AH D
AUGMENTER	AO G M EH N T ER
AUGMENTERS	AO G M EH N T ER Z
AUGMENTING	AO G M EH N T IH NG
AUGMENTOR	AO G M EH N T ER
AUGMENTORS	AO G M EH N T ER Z
AUGMENTS	AO G M EH N T S
AUGUR	AO G ER
AUGURAL	AO G ER AH L
AUGURED	AO G ER D
AUGURER	AO G ER ER
AUGURERS	AO G ER ER Z
AUGURIES	AO G ER IY Z
AUGURING	AO G ER IH NG
AUGURS	AO G ER Z
AUGURY	AO G ER IY
AUGUST	AA G AH S T
AUGUST(2)	AO G AH S T
AUGUSTER	AO G AH S T ER
AUGUSTEST	AO G AH S T AH S T
AUGUSTLY	AO G AH S T L IY
AUGUSTNESS	AO G AH S T N AH S
AUGUSTNESSES	AO G AH S T N AH S IH Z
AUK	AO K
AUKLET	AO K L AH T
AUKLETS	AO K L AH T S
AUKS	AO K S
AULD	AO L D
AULDER	AO L D AH R
AULDEST	AO L D AH S T
AULIC	EY AH L AH K
AUNT	AE N T
AUNT(2)	AO N T
AUNTHOOD	AE N T HH UH D
AUNTHOODS	AE N T HH UH D Z
AUNTIE	AE N T IY
AUNTIE(2)	AO N T IY
AUNTIES	AE N T IY Z
AUNTLIER	AE N T L IY ER
AUNTLIEST	AE N T L IY AH S T
AUNTLIKE	AE N T L AY K
AUNTLY	AE N T L IY
AUNTS	AE N T S
AUNTS(2)	AO N T S
AUNTY	AE N T IY
AURA	AO R AH
AURAE	AO R IY
AURAL	AO R AH L
AURALLY	AO R AH L IY
AURAR	EY Y AH R AH R
AURAS	AO R AH Z
AURATE	EY Y AH R EY T
AURATED	AO R AH T EH D
AUREATE	AO R IY EY T
AUREI	AO R IY
AUREOLA	AH R IY AH L AH
AUREOLAE	AH R IY AH L IY
AUREOLAS	AH R IY AH L AH Z
AUREOLE	AA R IY OW L
AUREOLED	AO R IY OW L D
AUREOLES	AO R IY OW L Z
AUREOLING	AO R IY OW L AH NG
AURES	EY Y AH R Z
AUREUS	AO R IY AH S
AURIC	EY Y AH R AH K
AURICLE	AO R AH K AH L
AURICLED	AO R AH K AH L D
AURICLES	AO R AH K AH L Z
AURICULA	AO R AH K Y UW L AH
AURICULAE	AO R AH K Y UW L IY
AURICULAR	EY Y AH R IH S Y AH L AH R
AURICULAS	AO R AH K Y UW L AH Z
AURICULATE	EY Y AH R IH S AH L EY T
AURIFEROUS	AH R IH F AH R AH S
AURIFORM	AO R AH F AH R M
AURIS	EY Y AH R AH S
AURIST	EY Y AH R AH S T
AURISTS	AO R AH S T S
AUROCHS	AO R AH CH S
AUROCHSES	AH R AA CH S AH Z
AURORA	ER AO R AH
AURORAE	AO R AH R IY
AURORAL	ER AO R AH L
AURORAS	AH R OW R AH Z
AUROREAN	AH R AO R IY AH N
AUROUS	EY Y AH R AH S
AURUM	AO R AH M
AURUMS	AO R AH M Z
AUSCULTATE	AO S AH L T EY T
AUSCULTATED	AO S AH L T EY T AH D
AUSCULTATES	AO S AH L T EY T S
AUSCULTATING	AO S AH L T EY T AH NG
AUSCULTATION	AO S AH L T EY SH AH N
AUSCULTATIONS	AO S AH L T EY T IY AH N Z
AUSCULTATORY	AO S AH L T AH T AO R IY
AUSFORM	AO S AH R M
AUSFORMED	AO S AH R M D
AUSFORMING	AO S AO R M AH NG
AUSFORMS	AO S AH R M Z
AUSLANDER	AW S L AH N D ER
AUSLANDERS	AO Z L AE N D AH R Z
AUSPEX	AO S AH K S
AUSPICE	AO S P IH S
AUSPICES	AO S P IH S IH Z
AUSPICIOUS	AA S P IH SH AH S
AUSPICIOUSLY	AO S P IH SH AH S L IY
AUSPICIOUSNESS	AO S P IH SH AH S N AH S
AUSPICIOUSNESSES	AO S P IH SH AH S N AH S IH Z
AUSTENITE	AO S T AH N AY T
AUSTENITES	AO S T AH N AY T S
AUSTENITIC	AO S T AH N AH T AH K
AUSTERE	AO S T IH R
AUSTERELY	AO S T IH R L IY
AUSTERENESS	AO S T IH ER N AH S
AUSTERENESSES	AO S T IH ER N AH S IH Z
AUSTERER	AO S T IH ER ER
AUSTEREST	AO S T IH ER AH S T
AUSTERITIES	AO S T EH R AH T IY Z
AUSTERITY	AO S T EH R IH T IY
AUSTRAL	AO S T R AH L
AUSTRALES	AO S T R EY L Z
AUSTRALOPITHECINE	AO S T R EY L OW P IH TH AH S AY N
AUSTRALOPITHECINES	AO S T R AH L AH P IH TH AH S AY N Z
AUSTRALS	AO S T R AH L Z
AUSUBO	AH S UW B OW
AUSUBOS	AH S UW B AH Z
AUTACOID	EY Y UW T AH S OY D
AUTACOIDS	AO T AH K OY D Z
AUTARCHIC	AO T AH R K AH K
AUTARCHICAL	AH T AA R K IH S AH L
AUTARCHIES	AH T AA R K AY Z
AUTARCHY	EY Y AH T AA R K IY
AUTARKIC	AO T AH R K AH K
AUTARKICAL	AH T AA R K IH S AH L
AUTARKIES	AH T AA R K AY Z
AUTARKY	AH T AA R K IY
AUTECISM	AO T AH S IH Z AH M
AUTECISMS	AO T AH S AH Z AH M Z
AUTECOLOGICAL	AO T AH K AA L AH JH IH S AH L
AUTECOLOGIES	AO T AH K AA L AH JH AY Z
AUTECOLOGY	AO T AH K AA L AH JH IY
AUTEUR	AO T AH R
AUTEURIST	AH T IY Y AH R AH S T
AUTEURISTS	AO T Y UW R AH S T S
AUTEURS	AH T IY Y AH R Z
AUTHENTIC	AH TH EH N T IH K
AUTHENTIC(2)	AO TH EH N T IH K
AUTHENTIC(3)	AO TH EH N IH K
AUTHENTIC(4)	AH TH EH N IH K
AUTHENTICALLY	AO TH EH N T IH K L IY
AUTHENTICALLY(2)	AO TH EH N IH K L IY
AUTHENTICATE	AO TH EH N T AH K EY T
AUTHENTICATED	AO TH EH N T AH K EY T AH D
AUTHENTICATES	AO TH EH N T IH K AH T S
AUTHENTICATING	AO TH EH N T AH K EY T IH NG
AUTHENTICATION	AO TH EH N T AH K EY SH AH N
AUTHENTICATIONS	AO TH EH N T AH K EY SH AH N Z
AUTHENTICATOR	AO TH EH N T IH K AH T ER
AUTHENTICATORS	AO TH EH N T IH K AH T ER Z
AUTHENTICITIES	AO TH EH N T IH S AH T IY Z
AUTHENTICITY	AO TH AH N T IH S IH T IY
AUTHOR	AO TH ER
AUTHORED	AO TH ER D
AUTHORESS	AO TH ER AH S
AUTHORESSES	AO TH ER AH S IH Z
AUTHORIAL	AO TH ER IY AH L
AUTHORING	AO TH ER IH NG
AUTHORISE	AO TH AH R AY Z
AUTHORISED	AO TH ER IY Z D
AUTHORISES	AO TH ER IY Z IH Z
AUTHORISING	AO TH ER IY Z IH NG
AUTHORITARIAN	AH TH AO R AH T EH R IY AH N
AUTHORITARIANISM	AH TH AO R AH T EH R IY AH N IH Z AH M
AUTHORITARIANISMS	AH TH AO R AH T EH R IY AH N IH Z AH M Z
AUTHORITARIANS	AH TH AO R AH T EH R IY AH N Z
AUTHORITATIVE	AH TH AO R AH T EY T IH V
AUTHORITATIVELY	AH TH AO R AH T EY T IH V L IY
AUTHORITATIVENESS	AH TH AO R AH T EY T IH V N AH S
AUTHORITATIVENESSES	AH TH AO R AH T EY T IH V N AH S IH Z
AUTHORITIES	AH TH AO R AH T IY Z
AUTHORITY	AH TH AO R AH T IY
AUTHORIZATION	AO TH ER AH Z EY SH AH N
AUTHORIZATIONS	AO TH ER AH Z EY SH AH N Z
AUTHORIZE	AO TH ER AY Z
AUTHORIZED	AO TH ER AY Z D
AUTHORIZER	AO TH ER AY Z ER
AUTHORIZERS	AO TH ER AY Z ER Z
AUTHORIZES	AO TH ER AY Z IH Z
AUTHORIZING	AO TH ER AY Z IH NG
AUTHORS	AO TH ER Z
AUTHORSHIP	AO TH ER SH IH P
AUTHORSHIPS	AO TH ER SH IH P S
AUTISM	AO T IH Z AH M
AUTISMS	AO T IH Z AH M Z
AUTISTIC	AO T IH S T IH K
AUTISTICALLY	AO T IH S T IH K AH L IY
AUTISTICS	AO T IH S T IH K S
AUTO	AO T OW
AUTOANTIBODIES	AO T OW AE N T IH B AA D IY Z
AUTOANTIBODY	AO T OW AE N T IH B AA D IY
AUTOBAHN	AO T OW B AA N
AUTOBAHNEN	AH T AA B AH N AH N
AUTOBAHNS	AO T AH B AH N Z
AUTOBIOGRAPHER	AO T AH B AY AA G R AH F ER
AUTOBIOGRAPHERS	AO T OW B AY AA G R AH F ER Z
AUTOBIOGRAPHIC	AO T AH B AY AH G R AE F IH K
AUTOBIOGRAPHICAL	AO T AH B AY AH G R AE F IH K AH L
AUTOBIOGRAPHICALLY	AO T AH B AY AH G R AE F IH K AH L IY
AUTOBIOGRAPHIES	AO T AH B AY AA G R AH F IY Z
AUTOBIOGRAPHY	AO T AH B AY AA G R AH F IY
AUTOBUS	AO T OW B AH S
AUTOBUSES	AO T OW B AH S IH Z
AUTOBUSSES	AO T OW B AH S IH Z
AUTOCADE	AO T AH K EY D
AUTOCADES	AO T AH K EY D Z
AUTOCATALYSES	AO T OW K EY T AH L IY Z IH Z
AUTOCATALYSIS	AO T OW K EY T AH L IY Z IY Z
AUTOCATALYTIC	AO T OW K AE T AH L IH T IH K
AUTOCATALYTICALLY	AO T OW K AE T AH L IH T IH K AH L IY
AUTOCEPHALIES	AO T AH S EH F AH L AY Z
AUTOCEPHALOUS	AO T AH S EH F AH L AH S
AUTOCEPHALY	AO T AH S EH F AH L IY
AUTOCHTHON	AH T AA CH TH AH N
AUTOCHTHONES	AO T AH CH TH OW N Z
AUTOCHTHONOUS	AH T AA CH TH AH N AH S
AUTOCHTHONOUSLY	AH T AA CH TH AA N OW AH S L IY
AUTOCHTHONS	AH T AA CH TH AH N Z
AUTOCLAVE	AO T OW K L EY V
AUTOCLAVED	AO T AH K L EY V D
AUTOCLAVES	AO T AH K L EY V Z
AUTOCLAVING	AO T AH K L EY V AH NG
AUTOCOID	AO T AH K OY D
AUTOCOIDS	AO T AH K OY D Z
AUTOCORRELATION	AO T OW K AO R AH L EY SH AH N
AUTOCORRELATIONS	AO T OW K AO R AH L EY SH AH N Z
AUTOCRACIES	AO T AA K R AH S IY Z
AUTOCRACY	AO T AA K R AH S IY
AUTOCRAT	AO T AH K R AE T
AUTOCRATIC	AO T AH K R AE T IH K
AUTOCRATICAL	AO T AH K R AE T IH K AH L
AUTOCRATICALLY	AO T AH K R AE T IH K AH L IY
AUTOCRATS	AO T AH K R AE T S
AUTOCROSS	AO T OW K R AO S
AUTOCROSSES	AO T OW K R AO S IH Z
AUTODIDACT	AO T OW D IH D AE K T
AUTODIDACTIC	AO T OW D IH D AE K T IH K
AUTODIDACTS	AO T OW D IH D AE K T S
AUTODYNE	AO T AH D AY N
AUTODYNES	AO T AH D AY N Z
AUTOECIOUS	AH T OW AH SH AH S
AUTOECIOUSLY	AO T OW AH S IY OW AH S L IY
AUTOECISM	AO T OW AH S IH Z AH M
AUTOECISMS	AH T OW AH S AH Z AH M Z
AUTOED	AO T OW D
AUTOEROTIC	AO T OW IH R AA T IH K
AUTOEROTICISM	AO T OW IH R AA T IH K IH Z AH M
AUTOEROTICISMS	AO T OW IH R AA T IH K IH Z AH M Z
AUTOEROTISM	AO T AH R AH T IH Z AH M
AUTOEROTISMS	AH T AH R AH T AH Z AH M Z
AUTOGAMIES	AO T OW G EY M IY Z
AUTOGAMOUS	AO T OW G EY M AH S
AUTOGAMY	AO T OW G EY M IY
AUTOGENIC	AO T OW JH IY N IH K
AUTOGENIES	AO T OW JH IY N IY Z
AUTOGENOUS	AO T OW JH IY N AH S
AUTOGENOUSLY	AO T OW JH IY N AH S L IY
AUTOGENY	AO T OW JH IY N IY
AUTOGIRO	AH T AA JH AH R OW
AUTOGIROS	AH T AA JH AH R AH Z
AUTOGRAFT	AO T OW G R AE F T
AUTOGRAFTED	AO T OW G R AE F T IH D
AUTOGRAFTING	AO T OW G R AE F T IH NG
AUTOGRAFTS	AO T OW G R AE F T S
AUTOGRAPH	AO T AH G R AE F
AUTOGRAPHED	AO T AH G R AE F T
AUTOGRAPHIC	AO T AH G R AE F IH K
AUTOGRAPHICALLY	AO T AH G R AE F IH K AH L IY
AUTOGRAPHIES	AO T AH G R AE F IY Z
AUTOGRAPHING	AO T AH G R AE F IH NG
AUTOGRAPHS	AO T AH G R AE F S
AUTOGRAPHY	AO T AH G R AE F IY
AUTOGYRO	AO T OW JH AY R OW
AUTOGYROS	AO T OW JH AY R OW Z
AUTOHYPNOSES	AH T AA HH AH P N OW Z AH Z
AUTOHYPNOSIS	AO T OW HH IH P N OW S AH S
AUTOHYPNOTIC	AO T OW HH IH P N AA T IH K
AUTOIMMUNE	AO T OY M Y UW N
AUTOIMMUNITIES	AO T OW IH M Y UW N AH T IY Z
AUTOIMMUNITY	AO T OW IH M Y UW N AH T IY
AUTOIMMUNIZATION	AO T OW IH M Y UW N AH Z EY SH AH N
AUTOIMMUNIZATIONS	AO T OW IH M Y UW N AH Z EY SH AH N Z
AUTOINFECTION	AO T OW IH N F EH K SH AH N
AUTOINFECTIONS	AO T OW IH N F EH K SH AH N Z
AUTOING	AO T OW IH NG
AUTOINTOXICATION	AO T OW IH N T AA K S IH K EY SH AH N
AUTOINTOXICATIONS	AO T OW IH N T AA K S IH K EY SH AH N Z
AUTOLOADING	AO T OW L OW D IH NG
AUTOLOGOUS	AO T OW L AA G AH S
AUTOLYSATE	AO T OW L IY Z AH T
AUTOLYSATES	AO T OW L IY Z AH T S
AUTOLYSE	AO T AH L AY Z
AUTOLYSED	AO T OW L IY Z D
AUTOLYSES	AO T OW L IY Z IH Z
AUTOLYSING	AO T OW L IY Z IH NG
AUTOLYSIS	AO T OW L IY Z IY Z
AUTOLYTIC	AO T AH L AH T AH K
AUTOLYZATE	AH T AA L AH Z EY T
AUTOLYZATES	AH T AA L AH Z EY T S
AUTOLYZE	AO T AH L AY Z
AUTOLYZED	AO T AH L AY Z D
AUTOLYZES	AO T AH L AY Z AH Z
AUTOLYZING	AO T OW L IY Z IH NG
AUTOMAKER	AO T OW M EY K ER
AUTOMAKERS	AO T OW M EY K ER Z
AUTOMAN	AO T OW M AE N
AUTOMATA	AO T AA M AH T AH
AUTOMATABLE	AO T AH M EY T AH B AH L
AUTOMATE	AO T AH M EY T
AUTOMATED	AO T AH M EY T IH D
AUTOMATES	AO T AH M EY T S
AUTOMATIC	AO T AH M AE T IH K
AUTOMATIC(2)	AO T OW M AE T IH K
AUTOMATICALLY	AO T AH M AE T IH K L IY
AUTOMATICALLY(2)	AO T OW M AE T IH K L IY
AUTOMATICITIES	AO T AH M AE T IH K AH T IY Z
AUTOMATICITY	AO T AH M AE T IH K AH T IY
AUTOMATICS	AO T AH M AE T IH K S
AUTOMATING	AO T AH M EY T IH NG
AUTOMATION	AO T AH M EY SH AH N
AUTOMATIONS	AO T AH M EY SH AH N Z
AUTOMATISM	AO T AH M EY T IH Z AH M
AUTOMATISMS	AO T AH M EY T IH Z AH M Z
AUTOMATIST	AO T AH M EY T IH S T
AUTOMATISTS	AO T AH M EY T IH S T S
AUTOMATIZATION	AO T AH M EY T AH Z EY SH AH N
AUTOMATIZATIONS	AO T AH M EY T AH Z EY SH AH N Z
AUTOMATIZE	AO T AH M EY T AY Z
AUTOMATIZED	AO T AH M EY T AY Z D
AUTOMATIZES	AO T AH M EY T AY Z IH Z
AUTOMATIZING	AO T AH M EY T AY Z IH NG
AUTOMATON	AO T AA M AH T AA N
AUTOMATONS	AO T AA M AH T AA N Z
AUTOMEN	AO T OW M EH N
AUTOMOBILE	AO T AH M OW B IY L
AUTOMOBILED	AO T AH M OW B IY L D
AUTOMOBILES	AO T AH M OW B IY L Z
AUTOMOBILING	AO T AH M OW B IY L IH NG
AUTOMOBILIST	AO T AH M OW B IY L IH S T
AUTOMOBILISTS	AO T AH M OW B IY L IH S T S
AUTOMOBILITIES	AO T AH M OW B IY L AH T IY Z
AUTOMOBILITY	AO T AH M OW B IY L AH T IY
AUTOMORPHISM	AO T OW M AO R F IH Z AH M
AUTOMORPHISMS	AO T OW M AO R F IH Z AH M Z
AUTOMOTIVE	AO T AH M OW T IH V
AUTONOMIC	AO T AH N AA M IH K
AUTONOMICALLY	AO T AH N AA M IH K AH L IY
AUTONOMIES	AO T AA N AH M IY Z
AUTONOMIST	AH T AA N AH M AH S T
AUTONOMISTS	AH T AA N AH M AH S T S
AUTONOMOUS	AO T AA N AH M AH S
AUTONOMOUSLY	AO T AA N OW M AH S L IY
AUTONOMY	AO T AA N AH M IY
AUTONOMY(2)	AH T AA N AH M IY
AUTOPILOT	AO T OW P AY L AH T
AUTOPILOTS	AO T OW P AY L AH T S
AUTOPOLYPLOID	AO T AH P AA L AH P L OY D
AUTOPOLYPLOIDIES	AH T AA P AH L IH P L OY D AY Z
AUTOPOLYPLOIDS	AH T AH P AA L AH P L OY D Z
AUTOPOLYPLOIDY	AH T AH P AA L AH P L OY D IY
AUTOPSIC	AO T AH P S AH K
AUTOPSIED	AO T AA P S IY D
AUTOPSIES	AO T AA P S IY Z
AUTOPSY	AO T AA P S IY
AUTOPSYING	AO T AA P S IY IH NG
AUTORADIOGRAM	AO T OW R EY D IY OW G R AE M
AUTORADIOGRAMS	AO T OW R EY D IY OW G R AE M Z
AUTORADIOGRAPH	AA T OW R EY D IY OW G R AE F
AUTORADIOGRAPHIC	AO T OW R EY D IY OW G R AE F IH K
AUTORADIOGRAPHIES	AO T OW R EY D IY AA G R AH F IY Z
AUTORADIOGRAPHS	AO T OW R EY D IY OW G R AE F S
AUTORADIOGRAPHY	AO T OW R EY D IY AA G R AH F IY
AUTOROTATE	AO T OW R OW T AH T
AUTOROTATED	AO T OW R OW T EY T IH D
AUTOROTATES	AO T OW R OW T AH T S
AUTOROTATING	AO T OW R OW T EY T IH NG
AUTOROTATION	AO T OW R OW T EY SH AH N
AUTOROTATIONS	AO T OW R OW T EY SH AH N Z
AUTOROUTE	AO T OW R UW T
AUTOROUTES	AO T OW R UW T S
AUTOS	AO T OW Z
AUTOSEXING	AO T OW S EH K S IH NG
AUTOSOMAL	AO T OW S AH M AH L
AUTOSOMALLY	AO T OW S AH M AH L IY
AUTOSOME	AO T OW S AH M
AUTOSOMES	AO T OW S AH M Z
AUTOSTRADA	AH T AA S T R AH D AH
AUTOSTRADAS	AH T AA S T R AH D AH Z
AUTOSTRADE	AO T OW Z T R EY D
AUTOSUGGEST	AO T OW S AH G JH EH S T
AUTOSUGGESTED	AO T OW S AH G JH EH S T IH D
AUTOSUGGESTING	AO T OW S AH G JH EH S T IH NG
AUTOSUGGESTION	AO T OW S AH G JH EH S SH AH N
AUTOSUGGESTIONS	AO T OW S AH G JH EH S SH AH N Z
AUTOSUGGESTS	AO T OW S AH G JH EH S T S
AUTOTELIC	AO T AH T AH L AH K
AUTOTETRAPLOID	AO T AH T EH T R AH P L OY D
AUTOTETRAPLOIDIES	AH T AH T EH T R AE P L OY D AY Z
AUTOTETRAPLOIDS	AH T AH T EH T R AH P L OY D Z
AUTOTETRAPLOIDY	AH T AH T EH T R AH P L OY D IY
AUTOTOMIES	AO T OW T OW M IY Z
AUTOTOMIZE	AO T OW T OW M AY Z
AUTOTOMIZED	AO T OW T OW M AY Z D
AUTOTOMIZES	AO T OW T OW M AY Z IH Z
AUTOTOMIZING	AO T OW T OW M AY Z IH NG
AUTOTOMOUS	AO T OW T OW M AH S
AUTOTOMY	AO T OW T OW M IY
AUTOTRANSFORMER	AO T OW T R AE N S F AO R M ER
AUTOTRANSFORMERS	AO T OW T R AE N S F AO R M ER Z
AUTOTRANSFUSION	AO T OW T R AE N S F Y UW ZH AH N
AUTOTRANSFUSIONS	AO T OW T R AE N S F Y UW ZH AH N Z
AUTOTROPH	AH T AA T R AH F
AUTOTROPHIC	AO T AH T R OW F IH K
AUTOTROPHICALLY	AH T AA T R AA F AH K AE L IY
AUTOTROPHIES	AO T OW T R OW F IY Z
AUTOTROPHS	AH T AA T R AH F S
AUTOTROPHY	AO T OW T R OW F IY
AUTOTYPE	AO T OW T AY P
AUTOTYPES	AO T OW T AY P S
AUTOTYPIES	AO T OW T AY P IY Z
AUTOTYPY	AO T OW T AY P IY
AUTOWORKER	AO T OW W ER K ER
AUTOWORKERS	AO T OW W ER K ER Z
AUTOXIDATION	AH T AA K S AH D EY SH AH N
AUTOXIDATIONS	AH T AA K S AH D EY T IY AH N Z
AUTUMN	AO T AH M
AUTUMNAL	AO T AH M N AH L
AUTUMNALLY	AO T AH M N AH L IY
AUTUMNS	AO T AH M Z
AUTUNITE	AO T Y AH N AY T
AUTUNITES	AO T Y AH N AY T S
AUXESES	AO K S IY Z AH Z
AUXESIS	AO K S AH S AH S
AUXETIC	AO K S AH T AH K
AUXETICS	AO K S AH T AH S Z
AUXILIARIES	AO G Z IH L Y AH R IY Z
AUXILIARY	AA G Z IH L Y ER IY
AUXILIARY(2)	AA G Z IH L IY EH R IY
AUXIN	AO K S AH N
AUXINIC	AO K S AH N AH K
AUXINS	AO K S AH N Z
AUXOTROPH	AO K S AA T R AH F
AUXOTROPHIC	AO K S AA T R AH F AH K
AUXOTROPHIES	AO K S AA T R AH F AY Z
AUXOTROPHS	AO K S AA T R AH F S
AUXOTROPHY	AO K S AA T R AH F IY
AVAUNT	AE V AH N T
AVIFAUNA	AH V IH F AH N AH
AVIFAUNAE	AH V IH F AH N IY
AVIFAUNAL	AH V IH F AH N AH L
AVIFAUNAS	AH V IH F AH N AH Z
BACCALAUREATE	B AE K AH L AO R IY AH T
BACCALAUREATES	B AE K AH L AO R IY EY T S
BACKHAUL	B AE K HH AO L
BACKHAULED	B AE K HH AO L D
BACKHAULING	B AE K HH AO L IH NG
BACKHAULS	B AE K HH AO L Z
BALISAUR	B AE L AH S AH R
BALISAURS	B AE L AH S EY Y AH R Z
BANAUSIC	B AE N AH Y UW S IH K
BANDEAU	B AE N D IY UW
BANDEAUS	B AE N D IY AH S
BANDEAUX	B AE N D IY AH K S
BATEAU	B AE T OW
BATEAUX	B EY T IY AH K S
BATTEAU	B AE T IY UW
BATTEAUX	B AE T IY AH K S
BAUBEE	B AH B IY IY
BAUBEES	B AH B IY Z
BAUBLE	B AO B AH L
BAUBLES	B AO B AH L Z
BAUD	B AO D
BAUDEKIN	B AO D AH K AH N
BAUDEKINS	B AO D AH K AH N Z
BAUDRONS	B AO D R AH N Z
BAUDRONSES	B AO D R AA N S AH Z
BAUDS	B AO D Z
BAUHINIA	B AH HH IH N Y AH
BAUHINIAS	B AH HH IH N Y AH Z
BAULK	B AO K
BAULKED	B AO K T
BAULKIER	B AO L K AY AH R
BAULKIEST	B AO L K AY AH S T
BAULKING	B AO K AH NG
BAULKS	B AO K S
BAULKY	B AO L K IY
BAUSOND	B AO S AH N D
BAUXITE	B AO K S AY T
BAUXITES	B AO K S AY T S
BAUXITIC	B AO K S AH T AH K
BEAU	B OW
BEAUCOUP	B OW K UW
BEAUISH	B OW IH SH
BEAUS	B OW Z
BEAUT	B AH AO T
BEAUTEOUS	B Y UW T IY AH S
BEAUTEOUSLY	B Y UW T IY AH S L IY
BEAUTEOUSNESS	B Y UW T IY AH S N AH S
BEAUTEOUSNESSES	B Y UW T IY AH S N AH S IH Z
BEAUTICIAN	B Y UW T IH SH AH N
BEAUTICIANS	B AH AH T IH S IY AH N Z
BEAUTIES	B Y UW T IY Z
BEAUTIFICATION	B IH AH Y UW T AH F AH K EY SH AH N
BEAUTIFICATIONS	B AH AO T AH F AH K EY T IY AH N Z
BEAUTIFIED	B AH AO T AH F AY D
BEAUTIFIER	B AH AH T IH F AY AH R
BEAUTIFIERS	B AH AO T AH F IY R Z
BEAUTIFIES	B AH AO T AH F AY Z
BEAUTIFUL	B Y UW T AH F AH L
BEAUTIFULER	B Y UW T IY F AH L ER
BEAUTIFULEST	B Y UW T IY F AH L AH S T
BEAUTIFULLY	B Y UW T AH F L IY
BEAUTIFULNESS	B Y UW T IY F AH L N AH S
BEAUTIFULNESSES	B Y UW T IY F AH L N AH S IH Z
BEAUTIFY	B Y UW T IH F AY
BEAUTIFYING	B AH AH T IH F AY AH NG
BEAUTS	B IH AH Y UW T S
BEAUTY	B Y UW T IY
BEAUX	B OW
BECAUSE	B IH K AO Z
BECAUSE(2)	B IH K AH Z
BECAUSE(3)	B IH K AA Z
BEDAUB	B IH D AO B
BEDAUBED	B IH D AO B D
BEDAUBING	B IH D AO B IH NG
BEDAUBS	B IH D AO B Z
BELAUD	B IH L AO D
BELAUDED	B IH L AO D IH D
BELAUDING	B IH L AO D IH NG
BELAUDS	B IH L AO D Z
BICAUDAL	B IY IH K AO D AH L
BINAURAL	B IH N AO R AH L
BINAURALLY	B IH N AO R AH L IY
BLAUBOK	B L AO B AH K
BLAUBOKS	B L AO B AH K S
BORDEAUX	B AO R D OW
BORDEREAU	B AO R D IY R IY UW
BORDEREAUX	B AO R D IY R IY AH K S
BOXHAUL	B AA K S HH AO L
BOXHAULED	B AA K S HH AO L D
BOXHAULING	B AA K S HH AO L IH NG
BOXHAULS	B AA K S HH AO L Z
BRAUNITE	B R AH N AY T
BRAUNITES	B R AH N AY T S
BRAUNSCHWEIGER	B R AO N S W EY JH AH R
BRAUNSCHWEIGERS	B R AO N S W EY JH AH R Z
BRONTOSAUR	B R AA N T AH S AH R
BRONTOSAURS	B R AA N T AH S EY Y AH R Z
BRONTOSAURUS	B R AO N T AH S AO R AH S
BRONTOSAURUS(2)	B R AO N AH S AO R AH S
BRONTOSAURUSES	B R AA N T AA S AH R UW Z AH Z
BUREAU	B Y UH R OW
BUREAUCRACIES	B Y UH R AA K R AH S IY Z
BUREAUCRACY	B Y UH R AA K R AH S IY
BUREAUCRAT	B Y UH R AH K R AE T
BUREAUCRAT(2)	B Y UH R OW K R AE T
BUREAUCRATESE	B Y UH R AH K R AE T IY Z
BUREAUCRATESES	B Y UH R OW K R EY T S IH Z
BUREAUCRATIC	B Y UH R AH K R AE T IH K
BUREAUCRATICALLY	B Y UH R AH K R AE T IH K AH L IY
BUREAUCRATISE	B Y AH R IY AH K R AH T AY Z
BUREAUCRATISED	B Y UH R AH K R AE T IY Z D
BUREAUCRATISES	B Y UH R AH K R AE T IY Z IH Z
BUREAUCRATISING	B Y UH R AH K R AE T IY Z IH NG
BUREAUCRATISM	B Y UH R AH K R AE T IH Z AH M
BUREAUCRATISMS	B Y UH R AH K R AE T IH Z AH M Z
BUREAUCRATIZATION	B Y UH R AH K R AE T AH Z EY SH AH N
BUREAUCRATIZATIONS	B Y UH R AH K R AE T AH Z EY SH AH N Z
BUREAUCRATIZE	B Y UH R AH K R AE T AY Z
BUREAUCRATIZED	B Y UH R AH K R AE T AY Z D
BUREAUCRATIZES	B Y UH R AH K R AE T AY Z IH Z
BUREAUCRATIZING	B Y UH R AH K R AE T AY Z IH NG
BUREAUCRATS	B Y UH R AH K R AE T S
BUREAUCRATS(2)	B Y UH R OW K R AE T S
BUREAUS	B Y UH R OW Z
BUREAUX	B Y UH R IY AH K S
CARNAUBA	K AA R N AO B AA
CARNAUBAS	K AA R N AH B AH Z
CATERWAUL	K AE T ER W AA L
CATERWAULED	K AH T AH R W EY AH L D
CATERWAULING	K AH T AH R W EY AH L AH NG
CATERWAULS	K AH T AH R W EY AH L Z
CAUCUS	K AO K AH S
CAUCUS(2)	K AA K AH S
CAUCUSED	K AO K AH S T
CAUCUSES	K AO K AH S IH Z
CAUCUSING	K AO K AH S IH NG
CAUCUSSED	K AO K AH S T
CAUCUSSES	K AO K AH S IH Z
CAUCUSSING	K AO K AH S IH NG
CAUDAD	K AO D AH D
CAUDAL	K AA D AH L
CAUDAL(2)	K AO D AH L
CAUDALLY	K AH D AE L IY
CAUDATE	K AH D EY T
CAUDATED	K AH D EY T AH D
CAUDATES	K AH D EY T S
CAUDEX	K AO D AH K S
CAUDEXES	K AO D AH K S
CAUDICES	K AO D AH S
CAUDILLISMO	K AO D AH L IH Z M OW
CAUDILLISMOS	K AO D AH L IH Z M AH Z
CAUDILLO	K AO D IH L OW
CAUDILLOS	K AH D IH L AH Z
CAUDLE	K AO D AH L
CAUDLES	K AO D AH L Z
CAUGHT	K AA T
CAUGHT(2)	K AO T
CAUL	K AA L
CAUL(2)	K AO L
CAULD	K AO L D
CAULDRON	K AA L D R AH N
CAULDRON(2)	K AO L D R AH N
CAULDRONS	K AO L D R AH N Z
CAULDS	K AO L D Z
CAULES	K EY AH L Z
CAULICLE	K AO L AH K AH L
CAULICLES	K AO L AH K AH L Z
CAULIFLOWER	K AA L AH F L AW ER
CAULIFLOWERET	K AO L AH F L OW AH R AH T
CAULIFLOWERETS	K AO L AH F L OW AH R AH T S
CAULIFLOWERS	K AO L IH F L AW ER Z
CAULINE	K AH L AY N
CAULIS	K EY AH L AH S
CAULK	K AA K
CAULK(2)	K AO K
CAULKED	K AO K T
CAULKER	K AO K AH R
CAULKERS	K AO L K AH R Z
CAULKING	K AO K IH NG
CAULKINGS	K AO L K AH NG Z
CAULKS	K AO K S
CAULS	K EY AH L Z
CAUSABLE	K AO Z AH B AH L
CAUSAL	K AO Z AH L
CAUSALGIA	K AH S AE L JH IY AH
CAUSALGIAS	K AH S AE L JH IY AH Z
CAUSALGIC	K AO S AH L JH AH K
CAUSALITIES	K AO Z AE L IH T IY Z
CAUSALITY	K AO Z AA L IH T IY
CAUSALLY	K AO Z AH L IY
CAUSALS	K AO Z AH L Z
CAUSATION	K AO Z EY SH AH N
CAUSATIONS	K AO Z EY SH AH N Z
CAUSATIVE	K AA Z AH T IH V
CAUSATIVE(2)	K AO Z AH T IH V
CAUSATIVELY	K AO Z AH T IH V L IY
CAUSATIVES	K AO Z AH T IH V Z
CAUSE	K AA Z
CAUSE(2)	K AO Z
CAUSED	K AA Z D
CAUSED(2)	K AO Z D
CAUSELESS	K AO Z L AH S
CAUSER	K AO Z ER
CAUSERIE	K AO Z ER IY
CAUSERIES	K AO Z AH R IY Z
CAUSERS	K AO Z ER Z
CAUSES	K AA Z AH Z
CAUSES(2)	K AO Z IH Z
CAUSEWAY	K AA Z W EY
CAUSEWAY(2)	K AO Z W EY
CAUSEWAYED	K AO Z W EY D
CAUSEWAYING	K AO Z W EY IH NG
CAUSEWAYS	K AO Z W EY Z
CAUSEY	K AO Z IY
CAUSEYS	K AO Z IY Z
CAUSING	K AA Z IH NG
CAUSING(2)	K AO Z IH NG
CAUSTIC	K AA S T IH K
CAUSTIC(2)	K AO S T IH K
CAUSTICALLY	K AO S T AH K AE L IY
CAUSTICITIES	K AO S T IH S AH T AY Z
CAUSTICITY	K AO S T IH S AH T IY
CAUSTICS	K AO S T AH S Z
CAUTERIES	K AO T AH R AY Z
CAUTERIZATION	K AO T ER IH Z EY SH AH N
CAUTERIZATIONS	K AO T AH R AY Z EY SH AH N Z
CAUTERIZE	K AO T ER AY Z
CAUTERIZED	K AO T ER AY Z D
CAUTERIZES	K AO T ER AY Z IH Z
CAUTERIZING	K AO T ER AY Z IH NG
CAUTERY	K EY Y AH T EH R IY
CAUTION	K AA SH AH N
CAUTION(2)	K AO SH AH N
CAUTIONARY	K AO SH AH N EH R IY
CAUTIONED	K AA SH AH N D
CAUTIONED(2)	K AO SH AH N D
CAUTIONING	K AO SH AH N IH NG
CAUTIONS	K AO SH AH N Z
CAUTIOUS	K AO SH AH S
CAUTIOUSLY	K AO SH AH S L IY
CAUTIOUSNESS	K AO SH AH S N AH S
CAUTIOUSNESSES	K AO SH AH S N AH S IH Z
CENTAUR	S EH N T AO R
CENTAUREA	S EH N T AH Y UH R IY AH
CENTAUREAS	S EH N T AH Y UH R IY AH Z
CENTAURIES	S EH N T AH R AY Z
CENTAURS	S EH N T AO R Z
CENTAURY	S EH N T AH R IY
CHAPEAU	CH EY P IY UW
CHAPEAUS	CH EY P IY AH S
CHAPEAUX	CH EY P IY AH K S
CHATEAU	SH AE T OW
CHATEAUBRIAND	CH EY T IY AH B R IY AH N D
CHATEAUBRIANDS	CH EY T IY AH B R IY AH N D Z
CHATEAUS	SH AE T OW Z
CHATEAUX	SH AH T OW
CHAUFER	CH AO F AH R
CHAUFERS	CH AO F AH R Z
CHAUFFER	CH AO F AH R
CHAUFFERS	CH AO F AH R Z
CHAUFFEUR	SH OW F ER
CHAUFFEURED	SH OW F ER D
CHAUFFEURING	SH OW F ER IH NG
CHAUFFEURS	SH OW F ER Z
CHAULMOOGRA	CH AO L M UW G R AH
CHAULMOOGRAS	CH AO L M UW G R AH Z
CHAUNT	CH AO N T
CHAUNTED	CH AO N T AH D
CHAUNTER	CH AO N T AH R
CHAUNTERS	CH AO N T AH R Z
CHAUNTING	CH AO N T AH NG
CHAUNTS	CH AO N T S
CHAUSSES	CH AO S AH Z
CHAUSSURE	CH AO SH Y AH R
CHAUSSURES	CH AO SH Y AH R Z
CHAUTAUQUA	SH AH T AO K W AH
CHAUTAUQUAS	SH AH T AO K W AH Z
CHAUVINISM	SH OW V AH N IH Z AH M
CHAUVINISMS	CH AO V AH N AH Z AH M Z
CHAUVINIST	SH OW V AH N AH S T
CHAUVINISTIC	CH OW V AH N IH S T IH K
CHAUVINISTICALLY	CH AO V AH N IH S T AH K AE L IY
CHAUVINISTS	SH OW V AH N AH S T S
CHEMOAUTOTROPHIC	K EH M OW AH T AA T R AH F AH K
CHEMOAUTOTROPHIES	K EH M OW AH T AA T R AH F AY Z
CHEMOAUTOTROPHY	K EH M OW AH T AA T R AH F IY
CHIAUS	CH AY AH AH S
CHIAUSES	CH AY AH UW Z AH Z
CLAIRAUDIENCE	K L AE AH R AO D IY AH N S
CLAIRAUDIENCES	K L AE AH R AO D IY EH N S AH Z
CLAIRAUDIENT	K L AE AH R AO D IY AH N T
CLAIRAUDIENTLY	K L AE AH R AH D IY N T L IY
CLAUCHT	K L AO CH T
CLAUDICATION	K L AO D AH S EY SH AH N
CLAUDICATIONS	K L AO D AH K EY T IY AH N Z
CLAUGHT	K L AO T
CLAUGHTED	K L AO T AH D
CLAUGHTING	K L AO T AH NG
CLAUGHTS	K L AO T S
CLAUSAL	K L AO Z AH L
CLAUSE	K L AO Z
CLAUSES	K L AO Z AH Z
CLAUSES(2)	K L AO Z IH Z
CLAUSTRA	K L AO S T R AH
CLAUSTRAL	K L AO S T R AH L
CLAUSTROPHOBE	K L AO S T R AH F OW B
CLAUSTROPHOBES	K L AO S T R AH F OW B Z
CLAUSTROPHOBIA	K L AO S T R AH F OW B IY AH
CLAUSTROPHOBIAS	K L AO S T R AH F OW B IY AH Z
CLAUSTROPHOBIC	K L AO S T R AH F OW B IH K
CLAUSTROPHOBICALLY	K L AO S T R AH F AA B AH K AE L IY
CLAUSTRUM	K L AO S T R AH M
CLUBHAUL	K L AH B HH AO L
CLUBHAULED	K L AH B HH AO L D
CLUBHAULING	K L AH B HH AO L IH NG
CLUBHAULS	K L AH B HH AO L Z
COAUTHOR	K OW AA TH ER
COAUTHORED	K OW AA TH ER D
COAUTHORING	K OW AA TH ER IH NG
COAUTHORS	K OW AA TH ER Z
COAUTHORSHIP	K OW AO TH ER SH IH P
COAUTHORSHIPS	K OW AO TH ER SH IH P S
COSMONAUT	K AO Z M AH N AO T
COSMONAUTS	K AO Z M AH N AO T S
COTEAU	K OW T IY UW
COTEAUS	K OW T IY AH S
COTEAUX	K OW T IY AH K S
COTYLOSAUR	K OW T IH L AH S AH R
COTYLOSAURS	K OW T IH L AH S EY Y AH R Z
COUNTERASSAULT	K AW N T ER AH S AO L T
COUNTERASSAULTS	K AW N T ER AH S AO L T S
COUTEAU	K OW Y UW T IY UW
COUTEAUX	K OW Y UW T IY AH K S
CRAUNCH	K R AO N CH
CRAUNCHED	K R AO N CH T
CRAUNCHES	K R AO N CH AH Z
CRAUNCHING	K R AO N CH AH NG
DAUB	D AO B
DAUBE	D AO B
DAUBED	D AO B D
DAUBER	D AW B ER
DAUBERIES	D AO B AH R IY Z
DAUBERS	D AO B ER Z
DAUBERY	D AO B AH R IY
DAUBES	D AO B Z
DAUBIER	D AO B IY ER
DAUBIEST	D AO B IY AH S T
DAUBING	D AO B IH NG
DAUBRIES	D AO B R IY Z
DAUBRY	D AO B R IY
DAUBS	D AO B Z
DAUBY	D AO B IY
DAUGHTER	D AO T ER
DAUGHTERLESS	D AO T ER L AH S
DAUGHTERS	D AO T ER Z
DAUNDER	D AO N D AH R
DAUNDERED	D AO N D IY R D
DAUNDERING	D AO N D IY R AH NG
DAUNDERS	D AO N D AH R Z
DAUNOMYCIN	D AH N AA M AH S AH N
DAUNOMYCINS	D AH N AA M AH S AH N Z
DAUNORUBICIN	D AO N AH R UW B AH S AH N
DAUNORUBICINS	D AO N AH R UW B AH S AH N Z
DAUNT	D AO N T
DAUNTED	D AO N T IH D
DAUNTER	D AO N T ER
DAUNTERS	D AO N T ER Z
DAUNTING	D AO N T IH NG
DAUNTINGLY	D AO N T IH NG L IY
DAUNTLESS	D AO N T L AH S
DAUNTLESSLY	D AO N T L AH S L IY
DAUNTLESSNESS	D AO N T L AH S N AH S
DAUNTLESSNESSES	D AO N T L AH S N AH S IH Z
DAUNTS	D AO N T S
DAUPHIN	D AW F IH N
DAUPHINE	D AO F IY N
DAUPHINES	D AO F IY N Z
DAUPHINS	D AO F AH N Z
DAUT	D AO T
DAUTED	D EY Y UW T AH D
DAUTIE	D AO T AY
DAUTIES	D AH T AY Z
DAUTING	D EY Y UW T AH NG
DAUTS	D EY Y UW T S
DEBAUCH	D AH B AO CH
DEBAUCHED	D AH B AO CH T
DEBAUCHEE	D AH B AO CH IY
DEBAUCHEES	D AH B AO CH IY Z
DEBAUCHER	D AH B AO CH ER
DEBAUCHERIES	D AH B AO CH AH R IY Z
DEBAUCHERS	D AH B AO CH ER Z
DEBAUCHERY	D AH B AO CH ER IY
DEBAUCHES	D AH B AO CH IH Z
DEBAUCHING	D AH B AO CH IH NG
DEFAULT	D IH F AO L T
DEFAULTED	D IH F AO L T IH D
DEFAULTER	D IH F AO L T ER
DEFAULTERS	D IH F AO L T ER Z
DEFAULTING	D IH F AO L T IH NG
DEFAULTS	D IH F AO L T S
DEFRAUD	D IH F R AO D
DEFRAUDED	D IH F R AO D IH D
DEFRAUDER	D IY F R AO D ER
DEFRAUDERS	D IY F R AO D ER Z
DEFRAUDING	D IH F R AO D IH NG
DEFRAUDS	D IY F R AO D Z
DEGAUSS	D IY G AW S
DEGAUSSED	D IY G AW S T
DEGAUSSER	D IY G AW S ER
DEGAUSSERS	D IY G AW S ER Z
DEGAUSSES	D IY G AW S IH Z
DEGAUSSING	D IY G AW S IH NG
DEPAUPERATE	D IY P AO P ER AH T
DIAPAUSE	D AY AH P AH Z
DIAPAUSED	D AY AE P EY AH S T
DIAPAUSES	D AY AE P AH Z AH Z
DIAPAUSING	D AY AE P AH Z AH NG
DINOSAUR	D AY N AH S AO R
DINOSAURIAN	D IH N AH S AH Y UH R IY AH N
DINOSAURS	D AY N AH S AO R Z
DISTRAUGHT	D IH S T R AO T
DISTRAUGHTLY	D IH S T R AO T L IY
DOWNHAUL	D AW N HH AO L
DOWNHAULS	D AW N HH AO L Z
DRAUGHT	D R AE F T
DRAUGHTED	D R AE F T IH D
DRAUGHTIER	D R AE F T IY ER
DRAUGHTIEST	D R AE F T IY AH S T
DRAUGHTING	D R AE F T IH NG
DRAUGHTS	D R AE F T S
DRAUGHTSMAN	D R AE F T S M AE N
DRAUGHTSMEN	D R AE F T S M EH N
DRAUGHTY	D R AE F T IY
EAU	OW
EAUX	OW
EAUX(2)	OW Z
ECAUDATE	EH K AH D EY T
EISTEDDFODAU	IY S T EH D F AH D AH
ELECTROHYDRAULIC	AH L EH K T R AH HH IH D R EY AH L AH K
ENCAUSTIC	IH N K AO S T AH K
ENCAUSTICS	IH N K AO S T AH S Z
ENTOMOFAUNA	IH N T AH M AA F AH N AH
ENTOMOFAUNAE	IH N T AH M AA F AH N IY
ENTOMOFAUNAS	IH N T AH M AA F AH N AH Z
EPAULET	EH P AH L EH T
EPAULETS	EH P AH L EH T S
EPAULETTE	EH P EY AH L EH T
EPAULETTED	EH P AH L EH T IH D
EPAULETTES	AH P EY AH L EH T S
EPIFAUNA	AH P IH F AH N AH
EPIFAUNAE	AH P IH F AH N IY
EPIFAUNAL	AH P IH F AH N AH L
EPIFAUNAS	AH P IH F AH N AH Z
EUPHAUSIID	Y UW F AH S IY D
EUPHAUSIIDS	Y UW F AH S IY D Z
EXHAUST	IH G Z AO S T
EXHAUSTED	IH G Z AO S T IH D
EXHAUSTER	IH G Z AO S T ER
EXHAUSTERS	IH G Z AO S T ER Z
EXHAUSTIBILITIES	IH G Z AO S T AH B IH L AH T IY Z
EXHAUSTIBILITY	IH G Z AO S T AH B IH L AH T IY
EXHAUSTIBLE	IH G Z AO S T AH B AH L
EXHAUSTING	IH G Z AO S T IH NG
EXHAUSTION	IH G Z AO S CH AH N
EXHAUSTIONS	IH G Z AO S SH AH N Z
EXHAUSTIVE	IH G Z AO S T IH V
EXHAUSTIVELY	IH G Z AA S T IH V L IY
EXHAUSTIVENESS	IH G Z AO S T IH V N AH S
EXHAUSTIVENESSES	IH G Z AO S T IH V N AH S IH Z
EXHAUSTIVITIES	IH G Z AO S T IH V AH T IY Z
EXHAUSTIVITY	IH G Z AO S T IH V AH T IY
EXHAUSTLESS	IH G Z AO S T L AH S
EXHAUSTLESSLY	IH G Z AO S T L AH S L IY
EXHAUSTLESSNESS	IH G Z AO S T L AH S N AH S
EXHAUSTLESSNESSES	IH G Z AO S T L AH S N AH S IH Z
EXHAUSTS	IH G Z AO S T S
EXTRAUTERINE	EH K S T R AH UW T AH R AY N
FABLIAU	F AE B L IY AH
FABLIAUX	F AE B L IY AH K S
FAUBOURG	F AH B OW R G
FAUBOURGS	F AO B AH R G Z
FAUCAL	F AO K AH L
FAUCALS	F AO K AH L Z
FAUCES	F AO S AH Z
FAUCET	F AO S AH T
FAUCETS	F AO S AH T S
FAUCIAL	F AO SH AH L
FAUGH	F AO
FAULD	F AO L D
FAULDS	F AO L D Z
FAULT	F AO L T
FAULTED	F AO L T IH D
FAULTFINDER	F AO L T F AY N D ER
FAULTFINDERS	F AO L T F AY N D ER Z
FAULTFINDING	F AO L T F AY N D IH NG
FAULTFINDINGS	F AO L T F AY N D IH NG Z
FAULTIER	F AO L T IY ER
FAULTIEST	F AO L T IY AH S T
FAULTILY	F AO L T IY L IY
FAULTINESS	F AO L T IY N AH S
FAULTINESSES	F AO L T IY N AH S IH Z
FAULTING	F AO L T IH NG
FAULTLESS	F AO L T L AH S
FAULTLESSLY	F AO L T L AH S L IY
FAULTLESSNESS	F AO L T L AH S N AH S
FAULTLESSNESSES	F AO L T L AH S N AH S IH Z
FAULTS	F AO L T S
FAULTY	F AO L T IY
FAUN	F AO N
FAUNA	F AO N AH
FAUNAE	F AO N IY
FAUNAL	F AA N AH L
FAUNAL(2)	F AO N AH L
FAUNALLY	F AH N AE L IY
FAUNAS	F AO N AH Z
FAUNISTIC	F AO N AH S T AH K
FAUNISTICALLY	F AH N IH S T AH K AE L IY
FAUNLIKE	F AO N L AY K
FAUNS	F AO N Z
FAUTEUIL	F AO T Y UW AH L
FAUTEUILS	F AO T Y UW AH L Z
FAUVE	F AO V
FAUVES	F AO V Z
FAUVISM	F AH V IH Z AH M
FAUVISMS	F AO V AH Z AH M Z
FAUVIST	F AO V AH S T
FAUVISTS	F AO V AH S T S
FAUX	F OW
FLAMBEAU	F L AE M B IY UW
FLAMBEAUS	F L AE M B IY AH S
FLAMBEAUX	F L AE M B IY AH K S
FLAUNT	F L AO N T
FLAUNTED	F L AO N T IH D
FLAUNTER	F L AO N T ER
FLAUNTERS	F L AO N T ER Z
FLAUNTIER	F L AO N T IY ER
FLAUNTIEST	F L AO N T IY AH S T
FLAUNTING	F L AO N T IH NG
FLAUNTINGLY	F L AO N T IH NG L IY
FLAUNTS	F L AO N T S
FLAUNTY	F L AO N T IY
FLAUTIST	F L AW T AH S T
FLAUTISTS	F L AW T AH S T S
FOOTFAULT	F UH T F AO L T
FOOTFAULTED	F UH T F AO L T IH D
FOOTFAULTING	F UH T F AO L T IH NG
FOOTFAULTS	F UH T F AO L T S
FRAUD	F R AO D
FRAUDS	F R AO D Z
FRAUDULENCE	F R AO D Y AH L AH N S
FRAUDULENCES	F R AO D Y AH L EH N S AH Z
FRAUDULENT	F R AO JH AH L AH N T
FRAUDULENTLY	F R AO D UW L AH N T L IY
FRAUDULENTNESS	F R AO D Y AH L EH N T N AH S
FRAUDULENTNESSES	F R AO D Y AH L EH N T N EH S AH Z
FRAUGHT	F R AO T
FRAUGHTED	F R AO T AH D
FRAUGHTING	F R AO T AH NG
FRAUGHTS	F R AO T S
FRAULEIN	F R AH L IY N
FRAULEINS	F R AH L IY N Z
FRICANDEAU	F R AH K AE N D IY UW
FRICANDEAUS	F R AH K AE N D IY AH S
FRICANDEAUX	F R AH K AE N D IY AH K S
GALLIMAUFRIES	G AE L AH M AO F R AY Z
GALLIMAUFRY	G AE L AH M AO F R IY
GATEAU	G AA T OW
GATEAUS	G EY T IY AH S
GATEAUX	G EY T IY AH K S
GAUCHE	G OW SH
GAUCHELY	G OW SH L IY
GAUCHENESS	G OW SH N AH S
GAUCHENESSES	G OW SH N AH S IH Z
GAUCHER	G OW SH ER
GAUCHERIE	G OW SH AH R IY
GAUCHERIES	G OW SH AH R IY Z
GAUCHEST	G OW SH AH S T
GAUCHO	G AW CH OW
GAUCHOS	G AW CH OW Z
GAUD	G AO D
GAUDERIES	G AO D AH R IY Z
GAUDERY	G AO D AH R IY
GAUDIER	G AO D IY ER
GAUDIES	G AO D IY Z
GAUDIEST	G AO D IY AH S T
GAUDILY	G AO D IY L IY
GAUDINESS	G AO D IY N AH S
GAUDINESSES	G AO D IY N AH S IH Z
GAUDS	G AO D Z
GAUDY	G AO D IY
GAUFFER	G AO F AH R
GAUFFERED	G AO F IY R D
GAUFFERING	G AO F IY R AH NG
GAUFFERS	G AO F AH R Z
GAUGE	G EY JH
GAUGED	G EY JH D
GAUGER	G EY JH ER
GAUGERS	G EY JH ER Z
GAUGES	G EY JH AH Z
GAUGES(2)	G EY JH IH Z
GAUGING	G EY JH IH NG
GAULT	G AO L T
GAULTS	G AO L T S
GAUM	G AO M
GAUMED	G AO M D
GAUMING	G AO M AH NG
GAUMS	G AO M Z
GAUN	G AO N
GAUNT	G AO N T
GAUNTER	G AO N T ER
GAUNTEST	G AO N T AH S T
GAUNTLET	G AO N T L AH T
GAUNTLETED	G AO N T L AH T IH D
GAUNTLETING	G AO N T L AH T IH NG
GAUNTLETS	G AO N T L AH T S
GAUNTLY	G AO N T L IY
GAUNTNESS	G AO N T N AH S
GAUNTNESSES	G AO N T N AH S IH Z
GAUNTRIES	G AO N T R IY Z
GAUNTRY	G AO N T R IY
GAUR	G AO R
GAURS	G EY Y AH R Z
GAUSS	G AW S
GAUSSES	G AW S IH Z
GAUZE	G AO Z
GAUZELIKE	G AO Z L AY K
GAUZES	G AO Z IH Z
GAUZIER	G AO Z IY ER
GAUZIEST	G AO Z IY AH S T
GAUZILY	G AO Z IY L IY
GAUZY	G AO Z IY
GHAUT	G AO T
GHAUTS	G EY Y UW T S
GLAUCOMA	G L AO K OW M AH
GLAUCOMAS	G L AW K OW M AH Z
GLAUCONITE	G L AO K AH N AY T
GLAUCONITES	G L AO K AH N AY T S
GLAUCONITIC	G L AO K AH N AH T AH K
GLAUCOUS	G L AO K AH S
GLAUCOUSNESS	G L AH K AW Z N AH S
GLAUCOUSNESSES	G L AH K AW Z N EH S AH Z
GODDAUGHTER	G AA D AO T ER
GODDAUGHTERS	G AA D AO T ER Z
GRANDAUNT	G R AE N D AE N T
GRANDAUNTS	G R AE N D AE N T S
GRANDDAUGHTER	G R AE N D AO T ER
GRANDDAUGHTERS	G R AE N D AO T ER Z
GRAUPEL	G R AO P AH L
GRAUPELS	G R AO P AH L Z
HADROSAUR	HH AE D R AH S AH R
HADROSAURS	HH AE D R AH S EY Y AH R Z
HAMAUL	HH AE M AH L
HAMAULS	HH AE M EY AH L Z
HAUBERK	HH AO B AH R K
HAUBERKS	HH AO B AH R K S
HAUGH	HH AO
HAUGHS	HH AO Z
HAUGHTIER	HH AO T IY ER
HAUGHTIEST	HH AO T IY AH S T
HAUGHTILY	HH AO T IH L IY
HAUGHTINESS	HH AO T IY N AH S
HAUGHTINESSES	HH AO T IY N AH S IH Z
HAUGHTY	HH AO T IY
HAUL	HH AO L
HAULAGE	HH AO L IH JH
HAULAGES	HH AO L IH JH IH Z
HAULED	HH AO L D
HAULER	HH AO L ER
HAULERS	HH AO L ER Z
HAULIER	HH AO L IY ER
HAULIERS	HH AO L IY ER Z
HAULING	HH AO L IH NG
HAULM	HH AO L M
HAULMIER	HH AO L M AY AH R
HAULMIEST	HH AO L M AY AH S T
HAULMS	HH AO L M Z
HAULMY	HH AO L M IY
HAULS	HH AO L Z
HAULYARD	HH AO L Y AA R D
HAULYARDS	HH AO L Y AA R D Z
HAUNCH	HH AO N CH
HAUNCHED	HH AO N CH T
HAUNCHES	HH AO N CH IH Z
HAUNT	HH AO N T
HAUNTED	HH AO N T AH D
HAUNTED(2)	HH AO N T IH D
HAUNTER	HH AO N T ER
HAUNTERS	HH AO N T ER Z
HAUNTING	HH AO N T IH NG
HAUNTINGLY	HH AO N T IH NG L IY
HAUNTS	HH AO N T S
HAUSEN	HH AW Z AH N
HAUSENS	HH AO S AH N Z
HAUSFRAU	HH AO S R AH
HAUSFRAUEN	HH AO S R AH AH N
HAUSFRAUS	HH AO S R EY AH S
HAUSTELLA	HH AO S T EH L AH
HAUSTELLUM	HH AO S T EH L AH M
HAUSTORIA	HH AO S T AO R IY AH
HAUSTORIAL	HH AO S T AO R IY AH L
HAUSTORIUM	HH AO S T AO R IY AH M
HAUT	HH AO T
HAUTBOIS	HH AO T B OW AH S
HAUTBOY	HH AO T B OW IY
HAUTBOYS	HH AO T B OY Z
HAUTE	HH OW T
HAUTE(2)	HH AH T
HAUTEUR	HH AO T AH R
HAUTEURS	HH AH T IY Y AH R Z
HEAUME	HH IY UW M
HEAUMES	HH IY UW M Z
HETEROAUXIN	HH EH T AH R OW AH K S AH N
HETEROAUXINS	HH EH T AH R OW AH K S AH N Z
HOLOCAUST	HH AO L AH K AO S T
HOLOCAUSTS	HH AO L AH K AO S T S
HORSELAUGH	HH AO R S L AE F
HORSELAUGHS	HH AO R S L AE F S
HYDRAULIC	HH AY D R AO L IH K
HYDRAULICALLY	HH AY D R AO L IH K AH L IY
HYDRAULICS	HH AY D R AO L IH K S
HYPERCAUTIOUS	HH AY P ER K AO SH AH S
HYPOCAUST	HH IH P AH K AH S T
HYPOCAUSTS	HH IH P AH K AH S T S
ICHTHYOFAUNA	IH CH TH AY AA F AH N AH
ICHTHYOFAUNAE	IH CH TH AY AA F AH N IY
ICHTHYOFAUNAL	IH CH TH AY AA F AH N AH L
ICHTHYOFAUNAS	IH CH TH AY AA F AH N AH Z
ICHTHYOSAUR	IH CH TH AY AH S AH R
ICHTHYOSAURIAN	IH CH TH AY AH S AH Y UH R IY AH N
ICHTHYOSAURIANS	IH CH TH AY AH S AO R IY AH N Z
ICHTHYOSAURS	IH CH TH AY AH S EY Y AH R Z
ILLAUDABLE	IH L AO D AH B AH L
ILLAUDABLY	IH L AO D AH B L IY
IMAUM	AH M AO M
IMAUMS	AH M AO M Z
IMPLAUSIBILITIES	IH M P L AO Z AH B IH L AH T IY Z
IMPLAUSIBILITY	IH M P L AO Z AH B IH L AH T IY
IMPLAUSIBLE	IH M P L AO Z AH B AH L
IMPLAUSIBLY	IH M P L AO Z AH B L IY
INAUDIBILITIES	IH N AO D AH B IH L AH T IY Z
INAUDIBILITY	IH N AO D AH B IH L AH T IY
INAUDIBLE	IH N AO D AH B AH L
INAUDIBLY	IH N AO D AH B L IY
INAUGURAL	IH N AO G ER AH L
INAUGURAL(2)	IH N AO G Y ER AH L
INAUGURALS	IH N AO G ER AH L Z
INAUGURATE	IH N AO G Y AH R EY T
INAUGURATED	IH N AO G Y ER EY T IH D
INAUGURATED(2)	IH N AO G ER EY T IH D
INAUGURATES	IH N AO G Y AH R EY T S
INAUGURATING	IH N AO G Y AH R EY T IH NG
INAUGURATION	IH N AO G Y AH R EY SH AH N
INAUGURATIONS	IH N AO G Y AH R EY SH AH N Z
INAUGURATOR	IH N AO G ER AH T ER
INAUGURATORS	IH N AO G ER AH T ER Z
INAUSPICIOUS	IH N AW S P IH SH IH S
INAUSPICIOUSLY	IH N AO S P IH SH AH S L IY
INAUSPICIOUSNESS	IH N AO S P IH SH AH S N AH S
INAUSPICIOUSNESSES	IH N AO S P IH SH AH S N AH S IH Z
INAUTHENTIC	IH N AO TH EH N T IH K
INAUTHENTICITIES	IH N AO TH EH N T IH S AH T IY Z
INAUTHENTICITY	IH N AO TH EH N T IH S AH T IY
INCAUTION	IH N K AO SH AH N
INCAUTIONS	IH N K AO SH AH N Z
INCAUTIOUS	IH N K AO SH AH S
INCAUTIOUSLY	IH N K AO SH AH S L IY
INCAUTIOUSNESS	IH N K AO SH AH S N AH S
INCAUTIOUSNESSES	IH N K AO SH AH S N AH S IH Z
INEXHAUSTIBILITIES	IH N IH G Z AO S T AH B IH L AH T IY Z
INEXHAUSTIBILITY	IH N IH G Z AO S T AH B IH L AH T IY
INEXHAUSTIBLE	IH N IH G Z AO S T AH B AH L
INEXHAUSTIBLENESS	IH N IH G Z AO S T AH B AH L N AH S
INEXHAUSTIBLENESSES	IH N IH G Z AO S T AH B AH L N AH S IH Z
INEXHAUSTIBLY	IH N IH G Z AO S T AH B L IY
INFAUNA	IH N F AO N AH
INFAUNAE	IH N F AO N IY
INFAUNAL	IH N F AO N AH L
INFAUNAS	IH N F AO N AH Z
INHAUL	IH N HH AO L
INHAULER	IH N HH AO L ER
INHAULERS	IH N HH AO L ER Z
INHAULS	IH N HH AO L Z
INSTAURATION	IH N S T EY Y AH R EY SH AH N
INSTAURATIONS	IH N S T AH R EY T IY AH N Z
INTRAUTERINE	IH N T R AH Y UW T ER IH N
JAMBEAU	JH AE M B OW
JAMBEAUX	JH AE M B IY AH K S
JAUK	JH AO K
JAUKED	JH AO K T
JAUKING	JH AO K AH NG
JAUKS	JH AO K S
JAUNCE	JH AO N S
JAUNCED	JH AO N S T
JAUNCES	JH AO N S AH Z
JAUNCING	JH AO N S AH NG
JAUNDICE	JH AO N D AH S
JAUNDICED	JH AO N D IH S T
JAUNDICES	JH AO N D AH S
JAUNDICING	JH AO N D IH S AH NG
JAUNT	JH AO N T
JAUNTED	JH AO N T IH D
JAUNTIER	JH AO N T IY ER
JAUNTIEST	JH AO N T IY AH S T
JAUNTILY	JH AO N T AH L IY
JAUNTINESS	JH AO N T IY N AH S
JAUNTINESSES	JH AO N T IY N AH S IH Z
JAUNTING	JH AO N T IH NG
JAUNTS	JH AO N T S
JAUNTY	JH AO N T IY
JAUP	JH AO P
JAUPED	JH AO P T
JAUPING	JH AO P AH NG
JAUPS	JH AO P S
JUGGERNAUT	JH AH G ER N AO T
JUGGERNAUTS	JH AH JH AH R N AH Y UW T S
KAURI	K AO R IY
KAURIES	K AH R AY Z
KAURIS	K EY Y AH R AH S
KAURY	K AO R IY
KEELHAUL	K IY L HH AO L
KEELHAULED	K IY L HH AO L D
KEELHAULING	K IY L HH AO L IH NG
KEELHAULS	K IY L HH AO L Z
KIAUGH	K AY AH UW
KIAUGHS	K AY AH AH Z
KILOBAUD	K IH L AH B AH D
KILOBAUDS	K IH L AH B AH D Z
KILOGAUSS	K IH L AH G AW S
KILOGAUSSES	K IH L AH G AW S IH Z
KNAUR	N AO R
KNAURS	N EY Y AH R Z
KRAUT	K R AW T
KRAUTS	K R AW T S
LANDAU	L AE N D AW
LANDAULET	L AE N D AW L AH T
LANDAULETS	L AE N D AW L AH T S
LANDAUS	L AE N D AW Z
LANGLAUF	L AE N G L AH F
LANGLAUFER	L AE N G L AH F AH R
LANGLAUFERS	L AE N G L AH F AH R Z
LANGLAUFS	L AE N G L AH F S
LAUAN	L AO AH N
LAUANS	L AO AH N Z
LAUD	L AO D
LAUDABLE	L AO D AH B AH L
LAUDABLENESS	L AO D AH B AH L N AH S
LAUDABLENESSES	L AO D AH B AH L N AH S IH Z
LAUDABLY	L AO D AH B L IY
LAUDANUM	L AO D AH N AH M
LAUDANUMS	L AO D AH N AH M Z
LAUDATION	L AO D EY SH AH N
LAUDATIONS	L AO D EY SH AH N Z
LAUDATIVE	L AO D AH T IH V
LAUDATOR	L AO D AH T ER
LAUDATORS	L AO D AH T ER Z
LAUDATORY	L AO D AH T AO R IY
LAUDED	L AO D IH D
LAUDER	L AO D ER
LAUDER(2)	L AW D ER
LAUDERS	L AO D ER Z
LAUDING	L AO D IH NG
LAUDS	L AO D Z
LAUGH	L AE F
LAUGHABLE	L AE F AH B AH L
LAUGHABLENESS	L AE F AH B AH L N AH S
LAUGHABLENESSES	L AE F AH B AH L N AH S IH Z
LAUGHABLY	L AE F AH B L IY
LAUGHED	L AE F T
LAUGHER	L AA K ER
LAUGHERS	L AE F ER Z
LAUGHING	L AE F IH NG
LAUGHINGLY	L AE F IH NG L IY
LAUGHINGS	L AE F IH NG Z
LAUGHINGSTOCK	L AE F IH NG S T AA K
LAUGHINGSTOCKS	L AE F IH NG S T AA K S
LAUGHS	L AE F S
LAUGHTER	L AE F T ER
LAUGHTERS	L AE F T ER Z
LAUNCE	L AO N S
LAUNCES	L AO N S AH Z
LAUNCH	L AO N CH
LAUNCHED	L AO N CH T
LAUNCHER	L AO N CH ER
LAUNCHERS	L AO N CH ER Z
LAUNCHES	L AO N CH AH Z
LAUNCHES(2)	L AO N CH IH Z
LAUNCHING	L AO N CH IH NG
LAUNCHPAD	L AO N CH P AE D
LAUNCHPADS	L AO N CH P AE D Z
LAUNDER	L AO N D ER
LAUNDERED	L AO N D ER D
LAUNDERER	L AO N D ER ER
LAUNDERERS	L AO N D ER ER Z
LAUNDERETTE	L AO N D ER EH T
LAUNDERETTES	L AO N D ER EH T S
LAUNDERING	L AO N D ER IH NG
LAUNDERS	L AO N D ER Z
LAUNDRESS	L AO N D R AH S
LAUNDRESSES	L AO N D R EH S AH Z
LAUNDRETTE	L AO N D R EH T
LAUNDRETTES	L AO N D R EH T S
LAUNDRIES	L AO N D R IY Z
LAUNDROMAT	L AO N D R AH M AE T
LAUNDROMATS	L AO N D R AH M AE T S
LAUNDRY	L AO N D R IY
LAUNDRYMAN	L AO N D R IY M AE N
LAUNDRYMEN	L AO N D R IY M EH N
LAURA	L AO R AH
LAURAE	L AO R IY
LAURAS	L AA V R AH Z
LAUREATE	L AO R IY AH T
LAUREATED	L AO R IY AH T IH D
LAUREATES	L AO R IY AH T S
LAUREATESHIP	L AO R IY AH T SH IH P
LAUREATESHIPS	L AO R IY AH T SH IH P S
LAUREATING	L AO R IY AH T IH NG
LAUREATION	L AO R IY AH SH AH N
LAUREATIONS	L AO R IY AH SH AH N Z
LAUREL	L AO R AH L
LAURELED	L AO R AH L D
LAURELING	L AO R AH L IH NG
LAURELLED	L AO R AH L D
LAURELLING	L AO R AH L IH NG
LAURELS	L AO R AH L Z
LAUWINE	L AH W AY N
LAUWINES	L AH W AY N Z
LEBENSRAUM	L EY B AH N Z R AW M
LEBENSRAUMS	L EY B AH N Z R AW M Z
LEPRECHAUN	L EH P ER K AO N
LEPRECHAUNISH	L EH P R EH CH AH N AH SH
LEPRECHAUNS	L EH P ER K AO N Z
LIEBFRAUMILCH	L IY B F R AH M AH L CH
LIEBFRAUMILCHS	L IY B F R AH M AH L CH S
LUAU	L UW AW
LUAUS	L UW W EY AH S
MAGNETOPAUSE	M AE G N EH T AH P AH Z
MAGNETOPAUSES	M AE G N AH T AA P AH Z AH Z
MANSLAUGHTER	M AE N S L AO T ER
MANSLAUGHTERS	M AE N S L AO T ER Z
MANTEAU	M AE N T IY UW
MANTEAUS	M AE N T IY AH S
MANTEAUX	M AE N T IY AH K S
MARAUD	M ER AO D
MARAUDED	M AH R AO D IH D
MARAUDER	M ER AO D ER
MARAUDERS	M ER AO D ER Z
MARAUDING	M ER AO D IH NG
MARAUDS	M AH R AO D Z
MASSASAUGA	M AE S AE S AH G AH
MASSASAUGAS	M AE S AE S AH G AH Z
MAUD	M AO D
MAUDLIN	M AO D L IH N
MAUDS	M AO D Z
MAUGER	M AO G ER
MAUGRE	M AO G AH R
MAUL	M AO L
MAULED	M AO L D
MAULER	M AO L ER
MAULERS	M AO L ER Z
MAULING	M AO L IH NG
MAULS	M AO L Z
MAULSTICK	M AO L S T IH K
MAULSTICKS	M AO L S T IH K S
MAUMET	M AO M AH T
MAUMETRIES	M AH M EH T R AY Z
MAUMETRY	M AH M EH T R IY
MAUMETS	M AO M AH T S
MAUN	M AO N
MAUND	M AO N D
MAUNDER	M AO N D AH R
MAUNDERED	M AO N D IY R D
MAUNDERER	M AO N D IY R AH R
MAUNDERERS	M AO N D AH R AH R Z
MAUNDERING	M AO N D ER IH NG
MAUNDERS	M AO N D AH R Z
MAUNDIES	M AO N D AY Z
MAUNDS	M AO N D Z
MAUNDY	M AO N D IY
MAUSOLEA	M AH S OW L IY AH
MAUSOLEUM	M AO S AH L IY AH M
MAUSOLEUMS	M AO S AH L IY AH M Z
MAUT	M AO T
MAUTS	M EY Y UW T S
MAUVE	M AO V
MAUVES	M OW V Z
MEERSCHAUM	M IH R S AH M
MEERSCHAUMS	M IH R S AH M Z
MEGAFAUNA	M AH G AE F AH N AH
MEGAFAUNAE	M AH G AE F AH N IY
MEGAFAUNAL	M AH G AE F AH N AH L
MEGAFAUNAS	M AH G AE F AH N AH Z
MENOPAUSAL	M EH N AH P AW Z AH L
MENOPAUSE	M EH N AH P AW Z
MENOPAUSES	M AH N AA P AH Z AH Z
MESOPAUSE	M EH S AH P AH Z
MESOPAUSES	M AH S AA P AH Z AH Z
MIAUL	M AY AH AH L
MIAULED	M AY AH AH L D
MIAULING	M AY AE AH L AH NG
MIAULS	M AY AH AH L Z
MICROFAUNA	M AY K R OW F AO N AH
MICROFAUNAE	M AY K R AH F AO N IY
MICROFAUNAL	M AY K R AH F AO N AH L
MICROFAUNAS	M AY K R OW F AO N AH Z
MINAUDIERE	M IH N AH D IY R
MINAUDIERES	M IH N AH D IY R Z
MISGAUGE	M IH S G EY JH
MISGAUGED	M IH S G EY JH D
MISGAUGES	M IH S G EY JH IH Z
MISGAUGING	M IH S G EY JH IH NG
MISTAUGHT	M IH S T AO T
MONAURAL	M AA N AO R AH L
MONAURALLY	M AA N AO R AH L IY
MORCEAU	M AO R S IY UW
MORCEAUX	M AO R S IY AH K S
MOSASAUR	M AA S AH S AH R
MOSASAURS	M AA S AH S EY Y AH R Z
MULTIAUTHOR	M AH L T AY AO TH ER
MULTICAUSAL	M AH L T AY K AO Z AH L
NAUGHT	N AO T
NAUGHTIER	N AO T IY ER
NAUGHTIEST	N AO T IY AH S T
NAUGHTILY	N AO T IY L IY
NAUGHTINESS	N AO T IY N AH S
NAUGHTINESSES	N AO T IY N AH S IH Z
NAUGHTS	N AO T S
NAUGHTY	N AO T IY
NAUMACHIA	N AH M AE CH IY AH
NAUMACHIAE	N AH M AE CH IY IY
NAUMACHIAS	N AH M AE CH IY AH Z
NAUMACHIES	N AO M AH CH AY Z
NAUMACHY	N AO M AH CH IY
NAUPLIAL	N AO P L IY AH L
NAUPLII	N AO P L IY
NAUPLIUS	N AO P L AY AH S
NAUSEA	N AO Z IY AH
NAUSEANT	N AO Z IY AH N T
NAUSEANTS	N AH S IY N T S
NAUSEAS	N AO Z IY AH Z
NAUSEATE	N AO Z IY EY T
NAUSEATED	N AO Z IY EY T AH D
NAUSEATES	N AO ZH IY EY T S
NAUSEATING	N AO ZH IY EY T IH NG
NAUSEATINGLY	N AO ZH IY EY T IH NG L IY
NAUSEOUS	N AO SH AH S
NAUSEOUSLY	N AH S IY OW AH S L IY
NAUSEOUSNESS	N AO S IY AW Z N AH S
NAUSEOUSNESSES	N AO S IY AW Z N EH S AH Z
NAUTCH	N AO CH
NAUTCHES	N AO CH AH Z
NAUTICAL	N AO T AH K AH L
NAUTICALLY	N AO T IH K AH L IY
NAUTILI	N AO T AH L IY
NAUTILOID	N EY Y UW T AH L OY D
NAUTILOIDS	N AO T AH L OY D Z
NAUTILUS	N AO T AH L AH S
NAUTILUSES	N AO T AH L AH S IH Z
NILGAU	N IH L G AH
NILGAUS	N IH L G EY AH S
NILGHAU	N IH L AH
NILGHAUS	N IH L EY AH S
NONAUDITORY	N AA N AO D AH T ER IY
NONAUTHOR	N AA N AO TH ER
NONAUTHORITARIAN	N AA N AH TH AO R AH T EH R IY AH N
NONAUTHORS	N AA N AO TH ER Z
NONAUTOMATED	N AA N AO T AH M EY T IH D
NONAUTOMATIC	N AA N AO T AH M AE T IH K
NONAUTOMOTIVE	N AA N AO T OW M OW T IH V
NONAUTONOMOUS	N AH N AH T AA N AH M AH S
NONCAUSAL	N AA N K AO Z AH L
NONCHAUVINIST	N AA N CH AO V AH N AH S T
NONCHAUVINISTS	N AA N CH AO V AH N AH S T S
NONDIAPAUSING	N AA N D AY AE P AH Z AH NG
NOUVEAU	N UW V OW
NUDICAUL	N Y UW D AH K AH L
NYLGHAU	N IH L AH
NYLGHAUS	N IH L EY AH S
OCEANAUT	OW S IY N AH T
OCEANAUTS	OW S IY N AH Y UW T S
ONSLAUGHT	AO N S L AO T
ONSLAUGHTS	AO N S L AO T S
OUTCAUGHT	AW T K AO T
OUTHAUL	AW T HH AO L
OUTHAULS	AW T HH AO L Z
OUTLAUGH	AW T L AE F
OUTLAUGHED	AW T L AE F T
OUTLAUGHING	AW T L AE F IH NG
OUTLAUGHS	AW T L AE F S
OUTVAUNT	AW T V AH N T
OUTVAUNTED	AW T V AO N T AH D
OUTVAUNTING	AW T V AO N T AH NG
OUTVAUNTS	AW T V AH N T S
OVERCAUTION	OW V ER K AO SH AH N
OVERCAUTIONED	OW V ER K AO SH AH N D
OVERCAUTIONING	OW V ER K AO SH AH N IH NG
OVERCAUTIONS	OW V ER K AO SH AH N Z
OVERCAUTIOUS	OW V ER K AO SH AH S
OVERHAUL	OW V ER HH AO L
OVERHAULED	OW V ER HH AO L D
OVERHAULING	OW V ER HH AO L IH NG
OVERHAULS	OW V ER HH AO L Z
OVERSAUCE	OW V ER S AO S
OVERSAUCED	OW V ER S AO S T
OVERSAUCES	OW V ER S AO S IH Z
OVERSAUCING	OW V ER S AO S IH NG
OVERSLAUGH	OW V ER Z L AE F
OVERSLAUGHED	OW V ER Z L AE F T
OVERSLAUGHING	OW V ER Z L AE F IH NG
OVERSLAUGHS	OW V ER Z L AE F S
PADAUK	P AE D AH K
PADAUKS	P AE D AH K S
PAUCITIES	P AO S AH T IY Z
PAUCITY	P AO S AH T IY
PAUGHTY	P AO T IY
PAULDRON	P AO L D R AH N
PAULDRONS	P AO L D R AH N Z
PAULIN	P AO L IH N
PAULINS	P AO L AH N Z
PAULOWNIA	P AH L OW N IY AH
PAULOWNIAS	P AH L OW N IY AH Z
PAUNCH	P AO N CH
PAUNCHED	P AO N CH T
PAUNCHES	P AO N CH IH Z
PAUNCHIER	P AO N CH IY ER
PAUNCHIEST	P AO N CH IY AH S T
PAUNCHINESS	P AO N CH IY N AH S
PAUNCHINESSES	P AO N CH IY N AH S IH Z
PAUNCHY	P AO N CH IY
PAUPER	P AO P ER
PAUPERED	P AO P ER D
PAUPERING	P AO P ER IH NG
PAUPERISM	P AO P ER IH Z AH M
PAUPERISMS	P AO P ER IH Z AH M Z
PAUPERIZE	P AO P ER AY Z
PAUPERIZED	P AO P ER AY Z D
PAUPERIZES	P AO P ER AY Z IH Z
PAUPERIZING	P AO P ER AY Z IH NG
PAUPERS	P AO P ER Z
PAUPIETTE	P AO P AY EH T
PAUPIETTES	P AO P AY EH T S
PAUSAL	P AO Z AH L
PAUSE	P AO Z
PAUSED	P AO Z D
PAUSER	P AO Z ER
PAUSERS	P AO Z ER Z
PAUSES	P AO Z AH Z
PAUSES(2)	P AO Z IH Z
PAUSING	P AO Z IH NG
PELYCOSAUR	P AH L IH K AH S AH R
PELYCOSAURS	P AH L IH K AH S EY Y AH R Z
PHOTOAUTOTROPH	F AA T OW AH T AA T R AH F
PHOTOAUTOTROPHIC	F AA T OW AH T AA T R AH F AH K
PHOTOAUTOTROPHICALLY	F AH T OW AH T AA T R AA F AH K AE L IY
PHOTOAUTOTROPHS	F AA T OW AH T AA T R AH F S
PILAU	P IH L AH
PILAUS	P IH L EY AH S
PLATEAU	P L AE T OW
PLATEAUED	P L AE T OW D
PLATEAUING	P L AH T OW IH NG
PLATEAUS	P L AE T OW Z
PLATEAUX	P L EY T IY AH K S
PLAUDIT	P L AO D IH T
PLAUDITS	P L AO D IH T S
PLAUSIBILITIES	P L AO Z AH B IH L AH T IY Z
PLAUSIBILITY	P L AO Z IH B IH L IH T IY
PLAUSIBLE	P L AO Z AH B AH L
PLAUSIBLENESS	P L AO Z AH B AH L N AH S
PLAUSIBLENESSES	P L AO Z AH B AH L N AH S IH Z
PLAUSIBLY	P L AO Z AH B L IY
PLAUSIVE	P L AO Z IH V
PLESIOSAUR	P L IY S IY AH S AH R
PLESIOSAURS	P L IY S IY AH S EY Y AH R Z
PORTMANTEAU	P AO R T M AE N T IY UW
PORTMANTEAUS	P AO R T M AE N T IY AH S
PORTMANTEAUX	P AO R T M AE N T IY AH K S
POSTBACCALAUREATE	P AA S T B AH K AH L AO R IY EY T
POSTFAULT	P OW S T F AO L T
POSTHOLOCAUST	P OW S T HH AA L AH K AO S T
POSTINAUGURAL	P OW S T IH N AO G ER AH L
POSTLAUNCH	P OW S T L AO N CH
POSTMENOPAUSAL	P AA S T M AH N AH P EY AH S AH L
POSTTRAUMATIC	P OW S T R AO M AE T IH K
PRAU	P R AO
PRAUS	P R EY AH S
PREAUDIT	P R IY AO D AH T
PREAUDITS	P R IY AO D AH T S
PRECAUTION	P R IY K AO SH AH N
PRECAUTIONARY	P R IH K AO SH AH N EH R IY
PRECAUTIONED	P R IY K AO SH AH N D
PRECAUTIONING	P R IY K AO SH AH N IH NG
PRECAUTIONS	P R IY K AO SH AH N Z
PREINAUGURAL	P R IY IH N AO G ER AH L
PRELAUNCH	P R IY L AO N CH
PREMENOPAUSAL	P R IY M AH N AH P EY AH S AH L
PRESLAUGHTER	P R IY S L AO T ER
PROSAUROPOD	P R OW S AO R AH P AH D
PROSAUROPODS	P R OW S AO R AH P AH D Z
PTEROSAUR	T EH R AH S AH R
PTEROSAURS	T EH R AH S EY Y AH R Z
QUAHAUG	K W AA HH AH G
QUAHAUGS	K W AA HH AH G Z
RADIOAUTOGRAPH	R EY D IY OW AO T AH G R AE F
RADIOAUTOGRAPHIC	R EY D IY OW AO T AH G R AE F IH K
RADIOAUTOGRAPHIES	R EY D IY OW AO T AH G R AE F IY Z
RADIOAUTOGRAPHS	R EY D IY OW AO T AH G R AE F S
RADIOAUTOGRAPHY	R EY D IY OW AO T AH G R AE F IY
RAUCITIES	R AO S AH T AY Z
RAUCITY	R AO S AH T IY
RAUCOUS	R AO K AH S
RAUCOUSLY	R AO K AH S L IY
RAUCOUSNESS	R AO K AH S N AH S
RAUCOUSNESSES	R AO K AH S N AH S IH Z
RAUNCH	R AO N CH
RAUNCHES	R AO N CH AH Z
RAUNCHIER	R AO NG K AY AH R
RAUNCHIEST	R AO NG K AY AH S T
RAUNCHILY	R AO NG K AH L IY
RAUNCHINESS	R AO NG K AH N AH S
RAUNCHINESSES	R AO NG K AH N EH S AH Z
RAUNCHY	R AO N CH IY
RAUWOLFIA	R AH W OW L F IY AH
RAUWOLFIAS	R AH W OW L F IY AH Z
REAUTHORIZATION	R IY AO TH ER IH Z EY SH AH N
REAUTHORIZATIONS	R IY AO TH ER AH Z EY SH AH N Z
REAUTHORIZE	R IY AO TH ER AY Z
REAUTHORIZED	R IY AO TH ER AY Z D
REAUTHORIZES	R IY AO TH ER AY Z IH Z
REAUTHORIZING	R IY AO TH ER AY Z IH NG
RECHAUFFE	R AH CH AO F
RECHAUFFES	R AH CH AO F S
REGAUGE	R IY G EY JH
REGAUGED	R IY G EY JH D
REGAUGES	R IY G EY JH IH Z
REGAUGING	R IY G EY JH IH NG
RELAUNCH	R IY L AO N CH
RELAUNCHED	R IY L AO N CH T
RELAUNCHES	R IY L AO N CH IH Z
RELAUNCHING	R IY L AO N CH IH NG
RESEAU	R AH S IY UW
RESEAUS	R AH S IY AH S
RESEAUX	R AH S IY AH K S
RESTAURANT	R EH S T ER AA N T
RESTAURANT(2)	R EH S T R AA N T
RESTAURANTEUR	R EH S T R AA N T ER
RESTAURANTEURS	R EH S T R AA N T ER Z
RESTAURANTS	R EH S T ER AA N T S
RESTAURANTS(2)	R EH S T R AA N T S
RESTAURATEUR	R EH S T ER AH T ER
RESTAURATEUR(2)	R EH S T R AH T ER
RESTAURATEURS	R EH S T ER AH T ER Z
RESTAURATEURS(2)	R EH S T R AH T ER Z
RETAUGHT	R IY T AO T
RIGAUDON	R IH G AH D AH N
RIGAUDONS	R IH G AH D AH N Z
ROMAUNT	R AA M AH N T
ROMAUNTS	R AA M AH N T S
RONDEAU	R AA N D OW
RONDEAUX	R AA N D IY AH K S
ROQUELAURE	R AA K W AH L EY Y AH R
ROQUELAURES	R AA K W AH L EY Y AH R Z
ROULEAU	R UW L OW
ROULEAUS	R AW L IY AH S
ROULEAUX	R AW L IY AH K S
ROUSSEAU	R UW S OW
ROUSSEAUS	R AW S IY AH S
SAU	S AO
SAUCE	S AO S
SAUCEBOAT	S AO S B OW T
SAUCEBOATS	S AO S B OW T S
SAUCEBOX	S AO S B AA K S
SAUCEBOXES	S AO S B AA K S IH Z
SAUCED	S AO S T
SAUCEPAN	S AO S P AE N
SAUCEPANS	S AO S P AE N Z
SAUCER	S AO S ER
SAUCERLIKE	S AO S ER L AY K
SAUCERS	S AO S ER Z
SAUCES	S AO S AH Z
SAUCES(2)	S AO S IH Z
SAUCH	S AO CH
SAUCHS	S AO CH S
SAUCIER	S AO S IY ER
SAUCIEST	S AO S IY AH S T
SAUCILY	S AO S IY L IY
SAUCINESS	S AO S IY N AH S
SAUCINESSES	S AO S IY N AH S IH Z
SAUCING	S AO S IH NG
SAUCY	S AO S IY
SAUERBRATEN	S AO AH R B R EY T AH N
SAUERBRATENS	S AO AH R B R AH T AH N Z
SAUERKRAUT	S AW ER K R AW T
SAUERKRAUTS	S AW ER K R AW T S
SAUGER	S AO JH AH R
SAUGERS	S AO JH AH R Z
SAUGH	S AO
SAUGHS	S AO Z
SAUGHY	S AO IY
SAUL	S AO L
SAULS	S AO L Z
SAULT	S AO L T
SAULTS	S AO L T S
SAUNA	S AO N AH
SAUNAS	S AO N AH Z
SAUNTER	S AO N T ER
SAUNTERED	S AO N T IY R D
SAUNTERER	S AO N T IY R AH R
SAUNTERERS	S AO N T AH R AH R Z
SAUNTERING	S AO N T IY R AH NG
SAUNTERS	S AO N T AH R Z
SAUREL	S AO R AH L
SAURELS	S AO R AH L Z
SAURIAN	S EY Y UH R IY AH N
SAURIANS	S AO R IY AH N Z
SAURIES	S AH R AY Z
SAURISCHIAN	S AH R IH S IY AH N
SAURISCHIANS	S AH R IH S IY AH N Z
SAUROPOD	S AO R AH P AH D
SAUROPODS	S AO R AH P AH D Z
SAURY	S AO R IY
SAUSAGE	S AO S AH JH
SAUSAGE(2)	S AO S IH JH
SAUSAGES	S AO S IH JH IH Z
SAUTE	S AO T EY
SAUTED	S AO T EY D
SAUTEED	S AO T EY D
SAUTEING	S AO T EY IH NG
SAUTERNE	S OW T ER N
SAUTERNES	S OW T ER N Z
SAUTES	S AO T EY Z
SAUTOIR	S AH T OY R
SAUTOIRE	S AH T OY R
SAUTOIRES	S AH T OY R Z
SAUTOIRS	S AH T OY R Z
SCAUP	S K AO P
SCAUPER	S K AO P AH R
SCAUPERS	S K AO P AH R Z
SCAUPS	S K AO P S
SCAUR	S K AO R
SCAURS	S K EY Y AH R Z
SCHNAUZER	SH N AW Z ER
SCHNAUZERS	S K N AO Z AH R Z
SCUPPAUG	S K AH P AH G
SCUPPAUGS	S K AH P AH G Z
SEMIAUTOBIOGRAPHICAL	S EH M IY AO T AH B AY AH G R AE F IH K AH L
SEMIAUTOMATIC	S EH M IY AO T AH M AE T IH K
SEMIAUTOMATIC(2)	S EH M AY AO T AH M AE T IH K
SEMIAUTOMATIC(3)	S EH M IH AO T AH M AE T IH K
SEMIAUTOMATICALLY	S EH M IY AO T AH M AE T IH K AH L IY
SEMIAUTOMATICS	S EH M IY AO T AH M AE T IH K S
SEMIAUTONOMOUS	S AH M IY AH T AA N AH M AH S
SHAUGH	SH AO
SHAUGHS	SH AO Z
SHAUL	SH AO L
SHAULED	SH EY AH L D
SHAULING	SH EY AH L AH NG
SHAULS	SH EY AH L Z
SLAUGHTER	S L AO T ER
SLAUGHTERED	S L AO T ER D
SLAUGHTERER	S L AO T ER ER
SLAUGHTERERS	S L AO T ER ER Z
SLAUGHTERHOUSE	S L AO T ER HH AW S
SLAUGHTERHOUSES	S L AO T ER HH AW S IH Z
SLAUGHTERING	S L AO T ER IH NG
SLAUGHTEROUS	S L AO T ER AH S
SLAUGHTEROUSLY	S L AO T ER AH S L IY
SLAUGHTERS	S L AO T ER Z
SOMERSAULT	S AH M ER S AO L T
SOMERSAULTED	S AH M ER S AO L T IH D
SOMERSAULTING	S AH M ER S AO L T IH NG
SOMERSAULTS	S AH M ER S AO L T S
STAUMREL	S T AO M R AH L
STAUMRELS	S T AO M R AH L Z
STAUNCH	S T AO N CH
STAUNCHED	S T AO N CH T
STAUNCHER	S T AO N CH ER
STAUNCHES	S T AO N CH IH Z
STAUNCHEST	S T AO N CH AH S T
STAUNCHING	S T AO N CH IH NG
STAUNCHLY	S T AO N CH L IY
STAUNCHNESS	S T AO N CH N AH S
STAUNCHNESSES	S T AO N CH N AH S IH Z
STAUROLITE	S T AO R AH L AY T
STAUROLITES	S T AO R AH L AY T S
STAUROLITIC	S T AO R AH L AH T AH K
STEGOSAUR	S T EH G AH S AH R
STEGOSAURS	S T EH G AH S EY Y AH R Z
STEGOSAURUS	S T EH G AH S AO R AH S
STEGOSAURUSES	S T AH G AA S AH R UW Z AH Z
STEPDAUGHTER	S T EH P D AO T ER
STEPDAUGHTERS	S T EH P D AO T ER Z
SUBAUDIBLE	S AH B AO D AH B AH L
SUBAUDIBLY	S AH B AO D AH B L IY
SUBAUDITION	S AH B AO D IH SH AH N
SUBAUDITIONS	S AH B AO D IH SH AH N Z
SUBCAUSE	S AH B K AO Z
SUBCAUSES	S AH B K AO Z IH Z
SUMMERSAULT	S AH M AH R S AH L T
SUMMERSAULTED	S AH M AH R S AO L T AH D
SUMMERSAULTING	S AH M AH R S AO L T AH NG
SUMMERSAULTS	S AH M AH R S AH L T S
SUPERBUREAUCRAT	S UW P ER B Y UH R AH K R AE T
SUPERBUREAUCRATS	S UW P ER B Y UH R AH K R AE T S
SUPERCAUTIOUS	S UW P ER K AO SH AH S
TABLEAU	T AH B L OW
TABLEAUS	T AE B L OW Z
TABLEAUX	T AH B L OW
TAMARAU	T AE M AH R AH
TAMARAUS	T AH M AE R EY AH S
TARPAULIN	T AA R P AH L AH N
TARPAULINS	T AA R P AH L AH N Z
TAU	T AW
TAUGHT	T AO T
TAUNT	T AO N T
TAUNTED	T AO N T IH D
TAUNTER	T AO N T ER
TAUNTERS	T AO N T ER Z
TAUNTING	T AO N T IH NG
TAUNTINGLY	T AO N T IH NG L IY
TAUNTS	T AO N T S
TAUPE	T AO P
TAUPES	T AO P S
TAURINE	T AH R AY N
TAURINES	T AH R AY N Z
TAUS	T AW Z
TAUT	T AO T
TAUTAUG	T AO T AH G
TAUTAUGS	T AO T AH G Z
TAUTED	T AO T IH D
TAUTEN	T AO T AH N
TAUTENED	T AO T AH N D
TAUTENING	T AO T AH N IH NG
TAUTENS	T AO T AH N Z
TAUTER	T AO T ER
TAUTEST	T AO T AH S T
TAUTING	T AO T IH NG
TAUTLY	T AO T L IY
TAUTNESS	T AO T N AH S
TAUTNESSES	T AO T N AH S IH Z
TAUTOG	T AO T AH G
TAUTOGS	T AO T AH G Z
TAUTOLOGICAL	T AH T AA L AH JH IH S AH L
TAUTOLOGICALLY	T AO T AH L AA JH AH K AE L IY
TAUTOLOGIES	T AO T AA L AH JH IY Z
TAUTOLOGOUS	T AH T AA L AH G AH S
TAUTOLOGOUSLY	T AO T AH L AA G OW AH S L IY
TAUTOLOGY	T AO T AA L AH JH IY
TAUTOMER	T AH T OW M AH R
TAUTOMERIC	T AO T AH M AH R AH K
TAUTOMERISM	T AO T AH M AH R IH Z AH M
TAUTOMERISMS	T AH T AA M AH R AH Z AH M Z
TAUTOMERS	T AO T AH M AH R Z
TAUTONYM	T AO T AH N AH M
TAUTONYMIES	T AH T AA N AH M AY Z
TAUTONYMS	T AO T AH N AH M Z
TAUTONYMY	T AH T AA N AH M IY
TAUTS	T AO T S
THAUMATURGE	TH AO M AH T AH R JH
THAUMATURGES	TH AO M AH T AH R JH AH Z
THAUMATURGIC	TH AO M AH T AH R JH AH K
THAUMATURGIES	TH AO M AH T AH R JH AY Z
THAUMATURGIST	TH AO M AH T AH R JH AH S T
THAUMATURGISTS	TH AO M AH T AH R JH AH S T S
THAUMATURGY	TH AO M AH T AH R JH IY
THESAURAL	DH AH Z AO R AH L
THESAURI	TH EH S AH R IY
THESAURUS	TH AH S AO R AH S
THESAURUSES	TH IH S AO R AH S IH Z
TIMARAU	T IH M AH R AH
TIMARAUS	T AH M AE R EY AH S
TONNEAU	T AA N IY UW
TONNEAUS	T AA N IY AH S
TONNEAUX	T AA N IY AH K S
TRAUCHLE	T R AO K L
TRAUCHLED	T R AO K L D
TRAUCHLES	T R AO K L Z
TRAUCHLING	T R AO K L AH NG
TRAUMA	T R AO M AH
TRAUMAS	T R AO M AH Z
TRAUMATA	T R AO M AH T AH
TRAUMATIC	T R AO M AE T IH K
TRAUMATICALLY	T R AH M AE T IH K AH L IY
TRAUMATISE	T R AO M AH T AY Z
TRAUMATISED	T R AH M EY T AH S T
TRAUMATISES	T R AO M AH T AY Z AH Z
TRAUMATISING	T R AO M AH T AY Z AH NG
TRAUMATISM	T R AO M AH T IH Z AH M
TRAUMATISMS	T R AO M AH T AH Z AH M Z
TRAUMATIZATION	T R AO M AH T AH Z EY SH AH N
TRAUMATIZATIONS	T R AO M AH T AH Z EY T IY AH N Z
TRAUMATIZE	T R AO M AH T AY Z
TRAUMATIZED	T R AO M AH T AY Z D
TRAUMATIZES	T R AO M AH T AY Z AH Z
TRAUMATIZING	T R AO M AH T AY Z AH NG
TROPOPAUSE	T R AA P AH P AO Z
TROPOPAUSES	T R AH P AA P AH Z AH Z
TROUSSEAU	T R AW S IY UW
TROUSSEAUS	T R AW S IY AH S
TROUSSEAUX	T R AW S IY AH K S
TRUMEAU	T R UW M IY UW
TRUMEAUX	T R UW M IY AH K S
TYRANNOSAUR	T AH R AE N AH S AH R
TYRANNOSAURS	T AH R AE N AH S EY Y AH R Z
TYRANNOSAURUS	T IH R AE N AH S AO R AH S
TYRANNOSAURUSES	T AH R AE N AA S AH R UW Z AH Z
ULTRACAUTIOUS	AH L T R AH K AO SH AH S
UMLAUT	AH M L AH T
UMLAUTED	AH M L AH Y UW T AH D
UMLAUTING	AH M L AH Y UW T AH NG
UMLAUTS	AH M L AH Y UW T S
UNAU	AH N AO
UNAUDITED	AH N AO D AH T IH D
UNAUS	AH N EY AH S
UNAUTHENTIC	AH N AO TH EH N T IH K
UNAUTHORIZED	AH N AO TH ER AY Z D
UNAUTOMATED	AH N AO T AH M EY T IH D
UNBEAUTIFUL	AH N B Y UW T IY F AH L
UNBEAUTIFULLY	AH N B Y UW T IY F AH L IY
UNBUREAUCRATIC	AH N B Y UH R AH K R AE T IH K
UNCAUGHT	AH N K AO T
UNCAUSED	AH N K AO Z D
UNCHAUVINISTIC	AH N CH AO V AH N AH S T AH K
UNDAUNTABLE	AH N D AO N T AH B AH L
UNDAUNTED	AH N D AO N T IH D
UNDAUNTEDLY	AH N D AO N T AH D L IY
UNLAUNDERED	AH N L AO N D ER D
UNPLAUSIBLE	AH N P L AO Z AH B AH L
UNTAUGHT	AH N T AO T
USAUNCE	Y UW S AH N S
USAUNCES	Y UW S AO N S AH Z
USQUEBAUGH	AH S W AH B AH
USQUEBAUGHS	AH S W AH B AH Z
VAU	V AO
VAUDEVILLE	V AA D V IH L
VAUDEVILLES	V AO D V IH L Z
VAUDEVILLIAN	V AA D V IH L Y AH N
VAUDEVILLIANS	V AO D AH V IH L IY AH N Z
VAULT	V AO L T
VAULTED	V AO L T IH D
VAULTER	V AO L T ER
VAULTERS	V AO L T ER Z
VAULTIER	V AO L T IY ER
VAULTIEST	V AO L T IY AH S T
VAULTING	V AO L T IH NG
VAULTINGLY	V AO L T IH NG L IY
VAULTINGS	V AO L T IH NG Z
VAULTS	V AO L T S
VAULTY	V AO L T IY
VAUNT	V AO N T
VAUNTED	V AO N T IH D
VAUNTER	V AO N T AH R
VAUNTERS	V AO N T AH R Z
VAUNTFUL	V AO N T AH L
VAUNTIE	V AO N T AY
VAUNTING	V AO N T AH NG
VAUNTINGLY	V AO N T IH NG L IY
VAUNTS	V AO N T S
VAUNTY	V AO N T IY
VAUS	V EY AH S
WAUCHT	W AO CH T
WAUCHTED	W AO CH T AH D
WAUCHTING	W AO CH T AH NG
WAUCHTS	W AO CH T S
WAUGH	W AO
WAUGHT	W AO T
WAUGHTED	W AO T AH D
WAUGHTING	W AO T AH NG
WAUGHTS	W AO T S
WAUK	W AO K
WAUKED	W AO K T
WAUKING	W AO K AH NG
WAUKS	W AO K S
WAUL	W AO L
WAULED	W EY AH L D
WAULING	W EY AH L AH NG
WAULS	W EY AH L Z
WAUR	W AO R
WELTANSCHAUUNG	V EH L T AA N SH AW AH NG
WELTANSCHAUUNGEN	V EH L T AA N SH AW AH NG AH N
WELTANSCHAUUNGS	V EH L T AA N SH AW AH NG Z
WHAUP	W AO P
WHAUPS	W AO P S
WILLIWAU	W IH L AH W AH
WILLIWAUS	W IH L IH W EY AH S
YAUD	Y AO D
YAUDS	Y AO D Z
YAULD	Y AO L D
YAUP	Y AO P
YAUPED	Y AO P T
YAUPER	Y AO P AH R
YAUPERS	Y AO P AH R Z
YAUPING	Y AO P AH NG
YAUPON	Y AO P AH N
YAUPONS	Y AO P AH N Z
YAUPS	Y AO P S
YAUTIA	Y AO SH IY AH
YAUTIAS	Y AO T IY AH Z
ADHERE	AH D HH IH R
WAEFUL	W IY F AH L
REWORD	R IY W ER D
EF	EH F
OOSPERM	UW S AH R M
EAVE	IY V
FULCRA	F UH L K R AH
