AY	EY
AY(2)	AY
AFFRAY	AE F R EY IY
AFFRAYED	AE F R EY D
AFFRAYER	AE F R EY AH R
AFFRAYERS	AE F R EY AH R Z
AFFRAYING	AE F R EY AH NG
AFFRAYS	AE F R EY Z
AIRPLAY	AH IH R P L EY
AIRPLAYS	AH IH R P L EY Z
AIRWAY	EH R W EY
AIRWAYS	EH R W EY Z
AISLEWAY	AY L W EY
AISLEWAYS	AY L W EY Z
ALCAYDE	AE L K EY D
ALCAYDES	AE L K EY D Z
ALLAY	AH L EY
ALLAYED	AH L EY D
ALLAYER	AH L EY ER
ALLAYERS	AH L EY ER Z
ALLAYING	AH L EY IH NG
ALLAYS	AH L EY Z
ALLEYWAY	AE L IY W EY
ALLEYWAYS	AE L IY W EY Z
ALWAY	AE L W EY IY
ALWAYS	AO L W EY Z
ALWAYS(2)	AO L W IY Z
ANTIGAY	AE N T AY G EY
ANTIGAY(2)	AE N T IY G EY
ANYWAY	EH N IY W EY
ANYWAYS	EH N IY W EY Z
ARCHWAY	AA R CH W EY
ARCHWAYS	AA R CH W EY Z
AREAWAY	AH R IY AH W EY
AREAWAYS	AH R IY AH W EY Z
ARRAY	ER EY
ARRAYAL	AH R EY AH L
ARRAYALS	AH R EY AH L Z
ARRAYED	ER EY D
ARRAYER	AH R EY ER
ARRAYERS	AH R EY ER Z
ARRAYING	ER EY IH NG
ARRAYS	ER EY Z
ASHTRAY	AE SH T R EY
ASHTRAYS	AE SH T R EY Z
ASSAY	AE S IY
ASSAYED	AE S EY D
ASSAYER	AE S EY ER
ASSAYERS	AE S EY ER Z
ASSAYING	AE S EY IH NG
ASSAYS	AE S EY Z
ASTRAY	AH S T R EY
ATALAYA	AA T AA L EY AH
ATALAYAS	AH T AE L EY AH Z
AWAY	AH W EY
AWAYNESS	AH W EY N AH S
AWAYNESSES	AH W EY N AH S IH Z
AY	EY
AY(2)	AY
AYAH	EY AH
AYAHS	EY AH Z
AYAHUASCA	EY AE HH Y UW AE S AH
AYAHUASCAS	EY AE HH Y UW AE S AH Z
AYATOLLAH	AY AH T OW L AH
AYATOLLAHS	AY AH T AA L AA Z
AYE	AY
AYES	AY Z
AYIN	EY AH N
AYINS	EY AH N Z
AYS	EY Z
AYURVEDA	EY AH R V AH D AH
AYURVEDAS	EY AH R V AH D AH Z
BACKSTAY	B AE K S T EY
BACKSTAYS	B AE K S T EY Z
BALLPLAYER	B AO L P L EY ER
BALLPLAYERS	B AO L P L EY ER Z
BAY	B EY
BAYADEER	B EY EY D IH R
BAYADEERS	B EY EY D IH R Z
BAYADERE	B EY EY D AH R
BAYADERES	B EY AH D IY R Z
BAYAMO	B EY AH M OW
BAYAMOS	B EY AH M AH Z
BAYARD	B EY ER D
BAYARDS	B EY AH R D Z
BAYBERRIES	B EY B EH R IY Z
BAYBERRY	B EY B EH R IY
BAYED	B EY D
BAYING	B EY IH NG
BAYMAN	B EY M AH N
BAYMEN	B EY M EH N
BAYONET	B EY AH N EH T
BAYONETED	B EY AH N AH T IH D
BAYONETING	B EY AH N AH T IH NG
BAYONETS	B EY AH N EH T S
BAYONETTED	B EY AH N AH T IH D
BAYONETTING	B EY AH N AH T IH NG
BAYOU	B AY UW
BAYOUS	B AY UW Z
BAYS	B EY Z
BAYWOOD	B EY W UH D
BAYWOODS	B EY W UH D Z
BELAY	B IH L EY
BELAYED	B IH L EY D
BELAYING	B IH L EY IH NG
BELAYS	B IH L EY Z
BELTWAY	B EH L T W EY
BELTWAYS	B EH L T W EY Z
BENDAY	B IY AH N D EY
BENDAYED	B IY AH N D EY D
BENDAYING	B IY AH N D EY IH NG
BENDAYS	B IY AH N D EY Z
BENDWAYS	B EH N D W EY Z
BETRAY	B IH T R EY
BETRAYAL	B IH T R EY AH L
BETRAYALS	B IH T R EY AH L Z
BETRAYED	B IH T R EY D
BETRAYER	B IH T R EY ER
BETRAYERS	B IH T R EY ER Z
BETRAYING	B IH T R EY IH NG
BETRAYS	B IH T R EY Z
BEWRAY	B AH R EY IY
BEWRAYED	B AH R EY D
BEWRAYER	B AH R EY AH R
BEWRAYERS	B AH R EY AH R Z
BEWRAYING	B AH R EY AH NG
BEWRAYS	B AH R EY Z
BIKEWAY	B AY K Y UW EY IY
BIKEWAYS	B AY K Y UW EY Z
BILAYER	B AY L EY ER
BILAYERS	B AY L EY ER Z
BIOASSAY	B AY OW S EY IY
BIOASSAYED	B AY OW S EY D
BIOASSAYING	B AY OW S EY AH NG
BIOASSAYS	B AY OW S EY Z
BIRTHDAY	B ER TH D EY
BIRTHDAYS	B ER TH D EY Z
BLUEJAY	B L UW JH EY
BLUEJAYS	B L UW JH EY Z
BOBSTAY	B AA B S T EY
BOBSTAYS	B AA B S T EY Z
BRAY	B R EY
BRAYED	B R EY D
BRAYER	B R EY ER
BRAYERS	B R EY ER Z
BRAYING	B R EY IH NG
BRAYS	B R EY Z
BREAKAWAY	B R EY K AH W EY
BREAKAWAYS	B R EY K AH W EY Z
BREAKSAWAY	B R EY K S AH W EY
BREEZEWAY	B R IY Z W EY
BREEZEWAYS	B R IY Z W EY Z
BRICKLAYER	B R IH K L EY ER
BRICKLAYERS	B R IH K L EY ER Z
BRICKLAYING	B R IH K L EY IH NG
BRICKLAYINGS	B R IH K L EY IH NG Z
BUCKAYRO	B AH K EY R OW
BUCKAYROS	B AH K EY R AH Z
BYPLAY	B AY P L EY
BYPLAYS	B AY P L EY Z
BYWAY	B AY W EY
BYWAYS	B AY W EY Z
CABLEWAY	K EY B AH L W EY
CABLEWAYS	K EY B AH L W EY Z
CALISAYA	K AH L IH S EY AH
CALISAYAS	K AH L IH S EY AH Z
CARAWAY	K AE R AH W EY
CARAWAY(2)	K EH R AH W EY
CARAWAYS	K AE R AH W EY Z
CARDPLAYER	K AA R D P L EY ER
CARDPLAYERS	K AA R D P L EY ER Z
CARRIAGEWAY	K AE R IH JH W EY
CARRIAGEWAYS	K AE R IH JH W EY Z
CASTAWAY	K AE S T AH W EY
CASTAWAYS	K AE S T AH W EY Z
CAUSEWAY	K AA Z W EY
CAUSEWAY(2)	K AO Z W EY
CAUSEWAYED	K AO Z W EY D
CAUSEWAYING	K AO Z W EY IH NG
CAUSEWAYS	K AO Z W EY Z
CAY	K EY
CAYENNE	K AY EH N
CAYENNE(2)	K EY EH N
CAYENNED	K EY EH N D
CAYENNES	K EY EH N Z
CAYMAN	K EY M AH N
CAYMANS	K EY M AH N Z
CAYS	K EY Z
CAYUSE	K EY UW Z
CAYUSES	K AY UW S AH Z
CHAMBRAY	CH AE M B R EY IY
CHAMBRAYS	CH AE M B R EY Z
CHARDONNAY	CH AA R D AA N EY
CHARDONNAYS	CH AA R D AA N EY Z
CHAY	CH EY IY
CHAYOTE	CH EY OW T
CHAYOTES	CH EY OW T S
CHAYS	CH EY Z
CLAY	K L EY
CLAYBANK	K L EY B AE NG K
CLAYBANKS	K L EY B AE NG K S
CLAYED	K L EY D
CLAYEY	K L EY IY
CLAYIER	K L EY IY ER
CLAYIEST	K L EY IY AH S T
CLAYING	K L EY IH NG
CLAYISH	K L EY IH SH
CLAYLIKE	K L EY L AY K
CLAYMORE	K L EY M AO R
CLAYMORES	K L EY M AO R EY Z
CLAYPAN	K L EY P AE N
CLAYPANS	K L EY P AE N Z
CLAYS	K L EY Z
CLAYWARE	K L EY W EH R
CLAYWARES	K L EY W EH R Z
COGWAY	K AA G W EY
COGWAYS	K AA G W EY Z
COMPANIONWAY	K AH M P AE N Y AH N W EY
COMPANIONWAYS	K AH M P AE N Y AH N W EY Z
COPAYMENT	K OW P EY M AH N T
COPAYMENTS	K OW P EY M AH N T S
CORNERWAYS	K AO R N ER W EY Z
COUNTERPLAY	K AW N T ER P L EY
COUNTERPLAYER	K AW N T ER P L EY ER
COUNTERPLAYERS	K AW N T ER P L EY ER Z
COUNTERPLAYS	K AW N T ER P L EY Z
CRAWLWAY	K R AO L W EY
CRAWLWAYS	K R AO L W EY Z
CRAYFISH	K R EY F IH SH
CRAYFISHES	K R EY F AH SH AH Z
CRAYOLA	K R EY AH L AH
CRAYOLAS	K R EY AH L AH Z
CRAYON	K R EY AA N
CRAYONED	K R EY AA N D
CRAYONING	K R EY AA N IH NG
CRAYONIST	K R EY AA N IH S T
CRAYONISTS	K R EY AA N IH S T S
CRAYONS	K R EY AA N Z
CROSSWAY	K R AO S W EY
CROSSWAYS	K R AO S W EY Z
CULLAY	K AH L EY IY
CULLAYS	K AH L EY Z
CUTAWAY	K AH T AH W EY
CUTAWAYS	K AH T AH W EY Z
DARESAY	D EH R S EY
DAY	D EY
DAYBED	D EY B EH D
DAYBEDS	D EY B EH D Z
DAYBOOK	D EY B UH K
DAYBOOKS	D EY B UH K S
DAYBREAK	D EY B R EY K
DAYBREAKS	D EY B R EY K S
DAYDREAM	D EY D R IY M
DAYDREAMED	D EY D R IY M D
DAYDREAMER	D EY D R IY M ER
DAYDREAMERS	D EY D R IY M ER Z
DAYDREAMING	D EY D R IY M IH NG
DAYDREAMLIKE	D EY D R IY M L AY K
DAYDREAMS	D EY D R IY M Z
DAYDREAMT	D EY D R EH M T
DAYFLIES	D EY F L AY Z
DAYFLOWER	D EY F L AW ER
DAYFLOWERS	D EY F L AW ER Z
DAYFLY	D EY F L AY
DAYGLOW	D EY G L OW
DAYGLOWS	D EY G L OW Z
DAYLIGHT	D EY L AY T
DAYLIGHTED	D EY L AY T IH D
DAYLIGHTING	D EY L AY T IH NG
DAYLIGHTINGS	D EY L AY T IH NG Z
DAYLIGHTS	D EY L AY T S
DAYLILIES	D EY L IY L IY Z
DAYLILY	D EY L IY L IY
DAYLIT	D EY L IH T
DAYLONG	D EY L AO NG
DAYMARE	D EY M EH R
DAYMARES	D EY M EH R Z
DAYROOM	D EY R UW M
DAYROOMS	D EY R UW M Z
DAYS	D EY Z
DAYSHIFT	D EY SH IH F T
DAYSHIFTS	D EY SH IH F T S
DAYSIDE	D EY S AY D
DAYSIDES	D EY S AY D Z
DAYSMAN	D EY Z M AE N
DAYSMEN	D EY Z M EH N
DAYSTAR	D EY S T AA R
DAYSTARS	D EY S T AA R Z
DAYTIME	D EY T AY M
DAYTIMES	D EY T AY M Z
DAYTRADER	D EY T R EY D ER
DAYTRADERS	D EY T R EY D ER Z
DAYWORK	D EY W ER K
DAYWORKS	D EY W ER K S
DECAY	D IH K EY
DECAYED	D IH K EY D
DECAYER	D IH K EY ER
DECAYERS	D IH K EY ER Z
DECAYING	D IH K EY IH NG
DECAYS	D AH K EY Z
DEEJAY	D IY EH JH EY IY
DEEJAYS	D IY AH JH EY Z
DEFRAY	D IH F R EY
DEFRAYABLE	D IH F R EY AH B AH L
DEFRAYAL	D IH F R EY AH L
DEFRAYALS	D IH F R EY AH L Z
DEFRAYED	D IH F R EY D
DEFRAYER	D IH F R EY ER
DEFRAYERS	D IH F R EY ER Z
DEFRAYING	D IH F R EY IH NG
DEFRAYS	D IH F R EY Z
DELAY	D IH L EY
DELAYED	D IH L EY D
DELAYER	D IY L EY ER
DELAYERS	D IY L EY ER Z
DELAYING	D IH L EY IH NG
DELAYS	D IH L EY Z
DERAY	D IY R EY
DERAYS	D IY R EY Z
DISARRAY	D IH S ER EY
DISARRAY(2)	D IH S AH R EY
DISARRAYED	D IH S AH R EY D
DISARRAYING	D IH S AH R EY IH NG
DISARRAYS	D IH S AH R EY Z
DISMAY	D IH S M EY
DISMAYED	D IH S M EY D
DISMAYING	D IH S M EY IH NG
DISMAYINGLY	D IH S M EY IH NG L IY
DISMAYS	D IH S M EY Z
DISPLAY	D IH S P L EY
DISPLAYABLE	D IH S P L EY AH B AH L
DISPLAYED	D IH S P L EY D
DISPLAYING	D IH S P L EY IH NG
DISPLAYS	D IH S P L EY Z
DOMESDAY	D OW M Z D EY
DOMESDAYS	D OW M Z D EY Z
DOOMSAYER	D UW M S EY ER
DOOMSAYERS	D UW M S EY ER Z
DOOMSAYING	D UW M S EY IH NG
DOOMSAYINGS	D UW M S EY IH NG Z
DOOMSDAY	D UW M Z D EY
DOOMSDAYER	D UW M Z D EY ER
DOOMSDAYERS	D UW M Z D EY ER Z
DOOMSDAYS	D UW M Z D EY Z
DOORWAY	D AO R W EY
DOORWAYS	D AO R W EY Z
DOWNPLAY	D AW N P L EY
DOWNPLAYED	D AW N P L EY D
DOWNPLAYING	D AW N P L EY IH NG
DOWNPLAYS	D AW N P L EY Z
DRAY	D R EY
DRAYAGE	D R EY AH JH
DRAYAGES	D R EY AH JH AH Z
DRAYED	D R EY D
DRAYING	D R EY AH NG
DRAYMAN	D R EY M AH N
DRAYMEN	D R EY M AH N
DRAYS	D R EY Z
DRIVEWAY	D R AY V W EY
DRIVEWAYS	D R AY V W EY Z
EDGEWAYS	EH JH W EY Z
EMBAY	IH M B EY
EMBAYED	IH M B EY D
EMBAYING	IH M B EY IH NG
EMBAYMENT	EH M B EY M AH N T
EMBAYMENTS	IH M B EY M AH N T S
EMBAYS	IH M B EY Z
ENDWAYS	EH N D W EY Z
ENTRANCEWAY	EH N T R AH N S W EY
ENTRANCEWAYS	EH N T R AH N S W EY Z
ENTRYWAY	EH N T R IY W EY
ENTRYWAYS	EH N T R IY W EY Z
ESSAY	EH S EY
ESSAYED	EH S EY D
ESSAYER	EH S EY ER
ESSAYERS	EH S EY ER Z
ESSAYING	EH S EY IH NG
ESSAYIST	EH S EY IH S T
ESSAYISTIC	EH S EY IH S T IH K
ESSAYISTS	EH S EY IH S T S
ESSAYS	EH S EY Z
ESTRAY	EH S T R EY IY
ESTRAYED	EH S T R EY D
ESTRAYING	EH S T R EY AH NG
ESTRAYS	EH S T R EY Z
EVERYDAY	EH V R IY D EY
EVERYDAYNESS	EH V R IY D EY N AH S
EVERYDAYNESSES	EH V R IY D EY N AH S IH Z
EVERYWAY	IY V AH R IY W EY
EXPRESSWAY	IH K S P R EH S W EY
EXPRESSWAYS	IH K S P R EH S W EY Z
FADEAWAY	F EY D AH W EY
FADEAWAYS	F EY D AH W EY Z
FAIRWAY	F EH R W EY
FAIRWAYS	F EH R W EY Z
FALLAWAY	F AO L AH W EY
FALLAWAYS	F AO L AH W EY Z
FARADAY	F AE R AH D EY
FARADAYS	F AA R AH D EY Z
FARAWAY	F AA R AH W EY
FAY	F EY
FAYALITE	F EY AH L AY T
FAYALITES	F EY AH L AY T S
FAYED	F EY D
FAYING	F EY IH NG
FAYS	F EY Z
FEDAYEE	F EH D EY IY IY
FEDAYEEN	F AH D EY IY AH N
FIRECLAY	F AY ER K L EY
FIRECLAYS	F AY ER K L EY Z
FISHWAY	F IH SH W EY
FISHWAYS	F IH SH W EY Z
FLATWAYS	F L AE T W EY Z
FLAY	F L EY
FLAYED	F L EY D
FLAYER	F L EY AH R
FLAYERS	F L EY AH R Z
FLAYING	F L EY AH NG
FLAYS	F L EY Z
FLOODWAY	F L AH D W EY
FLOODWAYS	F L AH D W EY Z
FLYAWAY	F L AY AH W EY
FLYAWAYS	F L AY AH W EY Z
FLYWAY	F L AY W EY
FLYWAYS	F L AY W EY Z
FOLDAWAY	F OW L D AH W EY
FOLKWAY	F OW K W EY
FOLKWAYS	F OW K W EY Z
FOODWAYS	F UW D W EY Z
FOOTWAY	F UH T W EY
FOOTWAYS	F UH T W EY Z
FORAY	F AO R EY
FORAYED	F AO R EY D
FORAYER	F AO R EY ER
FORAYERS	F AO R EY ER Z
FORAYING	F AO R EY IH NG
FORAYS	F AO R EY Z
FOREBAY	F OW R B EY
FOREBAYS	F OW R B EY Z
FOREPLAY	F AO R P L EY
FOREPLAYS	F OW R P L EY Z
FORESTAY	F OW R S T EY
FORESTAYS	F OW R S T EY Z
FORESTAYSAIL	F OW R S T EY S EY L
FORESTAYSAILS	F OW R S T EY S EY L Z
FRAY	F R EY
FRAYED	F R EY D
FRAYING	F R EY IH NG
FRAYINGS	F R EY IH NG Z
FRAYS	F R EY Z
FREEWAY	F R IY W EY
FREEWAYS	F R IY W EY Z
GAINSAY	G EY N S EY
GAINSAYER	G EY N S EY ER
GAINSAYERS	G EY N S EY ER Z
GAINSAYING	G EY N S EY IH NG
GAINSAYS	G EY N S EY Z
GAMAY	G AE M EY IY
GAMAYS	G AH M EY Z
GANGWAY	G AE NG W EY
GANGWAYS	G AE NG W EY Z
GATEWAY	G EY T W EY
GATEWAYS	G EY T W EY Z
GAY	G EY
GAYAL	G EY AH L
GAYALS	G EY AH L Z
GAYER	G EY ER
GAYEST	G EY AH S T
GAYETIES	G EY AH T IY Z
GAYETY	G EY AH T IY
GAYLY	G EY L IY
GAYNESS	G EY N AH S
GAYNESSES	G EY N AH S IH Z
GAYS	G EY Z
GAYWINGS	G EY W IH NG Z
GETAWAY	G EH T AH W EY
GETAWAYS	G EH T AH W EY Z
GIVEAWAY	G IH V AH W EY
GIVEAWAYS	G IH V AH W EY Z
GOOMBAY	G UW M B EY IY
GOOMBAYS	G UW M B EY Z
GRAY	G R EY
GRAYBACK	G R EY B AE K
GRAYBACKS	G R EY B AE K S
GRAYBEARD	G R EY B IY R D
GRAYBEARDS	G R EY B IY R D Z
GRAYED	G R EY D
GRAYER	G R EY ER
GRAYEST	G R EY IH S T
GRAYFISH	G R EY F IH SH
GRAYFISHES	G R EY F IH SH IH Z
GRAYING	G R EY IH NG
GRAYISH	G R EY IH SH
GRAYLAG	G R EY L AE G
GRAYLAGS	G R EY L AE G Z
GRAYLING	G R EY L IH NG
GRAYLINGS	G R EY L IH NG Z
GRAYLY	G R EY L IY
GRAYMAIL	G R EY M EY L
GRAYMAILS	G R EY M EY L Z
GRAYNESS	G R EY N AH S
GRAYNESSES	G R EY N AH S IH Z
GRAYOUT	G R EY AW T
GRAYOUTS	G R EY AW T S
GRAYS	G R EY Z
GRAYWACKE	G R EY W AH K
GRAYWACKES	G R EY W AH K S
GREENWAY	G R IY N W EY
GREENWAYS	G R IY N W EY Z
GUANAY	G Y UW AE N EY IY
GUANAYS	G Y UW AH N EY Z
GUAYABERA	G W AY AH B EH R AH
GUAYABERAS	G Y UW EY AE B AH R AH Z
GUAYULE	G Y UW EY UW L
GUAYULES	G Y UW EY AH L Z
GUIDEWAY	G AY D W EY
GUIDEWAYS	G AY D W EY Z
GUNPLAY	G AH N P L EY
GUNPLAYS	G AH N P L EY Z
HALFWAY	HH AE F W EY
HALLWAY	HH AO L W EY
HALLWAYS	HH AO L W EY Z
HATCHWAY	HH AE CH W EY
HATCHWAYS	HH AE CH W EY Z
HAY	HH EY
HAYCOCK	HH EY K AA K
HAYCOCKS	HH EY K AA K S
HAYED	HH EY D
HAYER	HH EY ER
HAYERS	HH EY ER Z
HAYFIELD	HH EY F IY L D
HAYFIELDS	HH EY F IY L D Z
HAYFORK	HH EY F AO R K
HAYFORKS	HH EY F AO R K S
HAYING	HH EY IH NG
HAYINGS	HH EY IH NG Z
HAYLAGE	HH EY L AH JH
HAYLAGES	HH EY L AE G Z
HAYLOFT	HH EY L AO F T
HAYLOFTS	HH EY L AO F T S
HAYMAKER	HH EY M EY K ER
HAYMAKERS	HH EY M EY K ER Z
HAYMOW	HH EY M AW
HAYMOWS	HH EY M AW Z
HAYRACK	HH EY R AE K
HAYRACKS	HH EY R AE K S
HAYRICK	HH EY R AH K
HAYRICKS	HH EY R AH K S
HAYRIDE	HH EY R AY D
HAYRIDES	HH EY R AY D Z
HAYS	HH EY Z
HAYSEED	HH EY S IY D
HAYSEEDS	HH EY S IY D Z
HAYSTACK	HH EY S T AE K
HAYSTACKS	HH EY S T AE K S
HAYWARD	HH EY W ER D
HAYWARDS	HH EY W ER D Z
HAYWIRE	HH EY W AY R
HAYWIRES	HH EY W AY ER Z
HEADSTAY	HH EH D S T EY
HEADSTAYS	HH EH D S T EY Z
HEADWAY	HH EH D W EY
HEADWAYS	HH EH D W EY Z
HEARSAY	HH IY R S EY
HEARSAYS	HH IH ER S EY Z
HEREAWAY	HH IY R IY W EY IY
HEREAWAYS	HH IY R AH W EY Z
HEYDAY	HH EY D EY
HEYDAYS	HH EY D EY Z
HIDEAWAY	HH AY D AH W EY
HIDEAWAYS	HH AY D AH W EY Z
HIGHWAY	HH AY W EY
HIGHWAYMAN	HH AY W EY M AE N
HIGHWAYMEN	HH AY W EY M EH N
HIGHWAYS	HH AY W EY Z
HOGMANAY	HH AA G M AA N AH IY
HOGMANAYS	HH AA G M AA N AH IY Z
HOGMENAY	HH AA G M EH N EY IY
HOGMENAYS	HH AA G M AH N EY Z
HOLIDAY	HH AA L AH D EY
HOLIDAY(2)	HH AA L IH D EY
HOLIDAYED	HH AA L AH D EY D
HOLIDAYER	HH AA L AH D EY ER
HOLIDAYERS	HH AA L AH D EY ER Z
HOLIDAYING	HH AA L AH D EY IH NG
HOLIDAYMAKER	HH AA L AH D EY M EY K ER
HOLIDAYMAKERS	HH AA L AH D EY M EY K ER Z
HOLIDAYS	HH AA L AH D EY Z
HOLYDAY	HH OW L IY D EY
HOLYDAYS	HH OW L IY D EY Z
HOMESTAY	HH OW M S T EY
HOMESTAYS	HH OW M S T EY Z
HOORAY	HH UH R EY
HOORAYED	HH UH R EY D
HOORAYING	HH UH R EY IH NG
HOORAYS	HH UH R EY Z
HORSEPLAY	HH AO R S P L EY
HORSEPLAYER	HH AO R S P L EY ER
HORSEPLAYERS	HH AO R S P L EY ER Z
HORSEPLAYS	HH AO R S P L EY Z
HURRAY	HH AH R EY
HURRAYED	HH UH R EY D
HURRAYING	HH UH R EY IH NG
HURRAYS	HH UH R EY Z
IMMUNOASSAY	IH M Y AH N OW S EY IY
IMMUNOASSAYABLE	IH M Y AH N OW S EY AH B AH L
IMMUNOASSAYS	IH M Y AH N OW S EY Z
INLAY	IH N L EY
INLAYER	IH N L EY ER
INLAYERS	IH N L EY ER Z
INLAYING	IH N L EY IH NG
INLAYS	IH N L EY Z
INTERLAY	IH N T ER L EY
INTERLAYER	IH N T ER L EY ER
INTERLAYERED	IH N T ER L EY ER D
INTERLAYERING	IH N T ER L EY ER IH NG
INTERLAYERS	IH N T ER L EY ER Z
INTERLAYING	IH N T ER L EY IH NG
INTERLAYS	IH N T ER L EY Z
INTERPLAY	IH N T ER P L EY
INTERPLAYED	IH N T ER P L EY D
INTERPLAYING	IH N T ER P L EY IH NG
INTERPLAYS	IH N T ER P L EY Z
INTRADAY	IH N T R AH D EY
JACKSTAY	JH AE K S T EY
JACKSTAYS	JH AE K S T EY Z
JAMBALAYA	JH AE M B AE L EY AH
JAMBALAYAS	JH AE M B AE L EY AH Z
JAY	JH EY
JAYBIRD	JH EY B ER D
JAYBIRDS	JH EY B ER D Z
JAYGEE	JH EY JH IY IY
JAYGEES	JH EY JH IY Z
JAYHAWKER	JH EY HH AO K ER
JAYHAWKERS	JH EY HH AO K ER Z
JAYS	JH EY Z
JAYVEE	JH EY V IY IY
JAYVEES	JH EY V IY Z
JAYWALK	JH EY W AO K
JAYWALKED	JH EY W AO K T
JAYWALKER	JH EY W AO K ER
JAYWALKERS	JH EY W AO K ER Z
JAYWALKING	JH EY W AO K IH NG
JAYWALKS	JH EY W AO K S
KABAYA	K AE B EY AH
KABAYAS	K AE B EY AH Z
KAY	K EY
KAYAK	K AY AE K
KAYAKED	K EY EY K T
KAYAKER	K AY AE K ER
KAYAKERS	K AY AE K ER Z
KAYAKING	K AY AE K IH NG
KAYAKINGS	K EY AH K AH NG Z
KAYAKS	K AY AE K S
KAYLES	K EY L Z
KAYO	K EY OW
KAYOED	K EY OW D
KAYOES	K EY OW Z
KAYOING	K EY OW IH NG
KAYOS	K EY OW Z
KAYS	K EY Z
KEYWAY	K IY W EY
KEYWAYS	K IY W EY Z
LACKADAY	L AE K AH D EY
LANEWAY	L EY N W EY
LANEWAYS	L EY N W EY Z
LAY	L EY
LAYABOUT	L EY AH B AW T
LAYABOUTS	L EY AH B AW T S
LAYAWAY	L EY AH W EY
LAYAWAYS	L EY AH W EY Z
LAYED	L EY D
LAYER	L EY ER
LAYERAGE	L EY ER IH JH
LAYERAGES	L EY ER IH JH IH Z
LAYERED	L EY ER D
LAYERING	L EY ER IH NG
LAYERINGS	L EY ER IH NG Z
LAYERS	L EY ER Z
LAYETTE	L EY EH T
LAYETTES	L EY EH T S
LAYING	L EY IH NG
LAYMAN	L EY M AH N
LAYMEN	L EY M AH N
LAYOFF	L EY AO F
LAYOFFS	L EY AO F S
LAYOUT	L EY AW T
LAYOUTS	L EY AW T S
LAYOVER	L EY OW V ER
LAYOVERS	L EY OW V ER Z
LAYPEOPLE	L EY P IY P AH L
LAYPERSON	L EY P ER S IH N
LAYPERSONS	L EY P ER S AH N Z
LAYS	L EY Z
LAYUP	L EY AH P
LAYUPS	L EY AH P S
LAYWOMAN	L EY W UH M AH N
LAYWOMEN	L EY W IH M AH N
LEASTWAYS	L IY S T W EY Z
LECHAYIM	L EH CH EY AH M
LECHAYIMS	L EH CH EY AH M Z
LEEWAY	L IY W EY
LEEWAYS	L IY W EY Z
LEHAYIM	L EH HH EY AH M
LEHAYIMS	L EH HH EY AH M Z
LENGTHWAYS	L EH NG TH W EY Z
LIFEWAY	L AY F W EY
LIFEWAYS	L AY F W EY Z
LOGWAY	L AA G W EY
LOGWAYS	L AA G W EY Z
LONGWAYS	L AO NG W EY Z
MAINSTAY	M EY N S T EY
MAINSTAYS	M EY N S T EY Z
MANSLAYER	M AE N S L EY ER
MANSLAYERS	M AE N S L EY ER Z
MARGAY	M AA R G EY
MARGAYS	M AA R G EY Z
MAY	M EY
MAYA	M AY AH
MAYAN	M AY AH N
MAYAPPLE	M EY AE P AH L
MAYAPPLES	M EY AE P AH L Z
MAYAS	M EY AH Z
MAYBE	M EY B IY
MAYBES	M EY B IY Z
MAYBUSH	M EY B UH SH
MAYBUSHES	M EY B UH SH IH Z
MAYDAY	M EY D EY
MAYDAYS	M EY D EY Z
MAYED	M EY D
MAYEST	M EY AH S T
MAYFLIES	M EY F L AY Z
MAYFLOWER	M EY F L AW ER
MAYFLOWERS	M EY F L AW ER Z
MAYFLY	M EY F L AY
MAYHAP	M EY HH AE P
MAYHEM	M EY HH EH M
MAYHEMS	M EY HH EH M Z
MAYING	M EY IH NG
MAYINGS	M EY IH NG Z
MAYO	M EY OW
MAYONNAISE	M EY AH N EY Z
MAYONNAISES	M EY AH N EY Z IH Z
MAYOR	M EY ER
MAYORAL	M EY ER AH L
MAYORALTIES	M EY AO R AH L T AY Z
MAYORALTY	M EY ER AH L T IY
MAYORESS	M EY ER AH S
MAYORESSES	M EY ER AH S IH Z
MAYORS	M EY ER Z
MAYOS	M EY AA S
MAYPOLE	M EY P OW L
MAYPOLES	M EY P OW L Z
MAYPOP	M EY P AA P
MAYPOPS	M EY P AA P S
MAYS	M EY Z
MAYST	M EY S T
MAYVIN	M EY V AH N
MAYVINS	M EY V AH N Z
MAYWEED	M EY W IY D
MAYWEEDS	M EY W IY D Z
MIDDAY	M IH D D EY
MIDDAYS	M IH D EY Z
MIDWAY	M IH D W EY
MIDWAYS	M IH D W EY Z
MINELAYER	M AY N L EY ER
MINELAYERS	M AY N L EY ER Z
MISASSAY	M IH S AE S EY
MISASSAYED	M IH S AE S EY D
MISASSAYING	M IH S AE S EY IH NG
MISASSAYS	M IH S AE S EY Z
MISLAY	M IH S L EY
MISLAYER	M IH S L EY ER
MISLAYERS	M IH S L EY ER Z
MISLAYING	M IH S L EY IH NG
MISLAYS	M IH S L EY Z
MISPLAY	M IH S P L EY
MISPLAYED	M IH S P L EY D
MISPLAYING	M IH S P L EY IH NG
MISPLAYS	M IH S P L EY Z
MISSAY	M IH S EY
MISSAYING	M IH S EY IH NG
MISSAYS	M IH S EY Z
MONOLAYER	M AA N OW L EY ER
MONOLAYERS	M AA N OW L EY ER Z
MORAY	M ER EY
MORAY(2)	M AO R EY
MORAYS	M ER EY Z
MORAYS(2)	M AO R EY Z
MOTORWAY	M OW T ER W EY
MOTORWAYS	M OW T ER W EY Z
MULTILAYER	M AH L T IY L EY ER
MULTILAYERED	M AH L T IY L EY ER D
MULTIPLAYER	M AH L T IY P L EY ER
NAY	N EY
NAYS	N EY Z
NAYSAYER	N EY S EY ER
NAYSAYERS	N EY S EY ER Z
NONGAY	N AA N G EY
NONGAYS	N AA N G EY Z
NONPAYING	N AA N P EY IH NG
NONPAYMENT	N AA N P EY M AH N T
NONPAYMENTS	N AA N P EY M AH N T S
NONPLAY	N AA N P L EY
NONPLAYING	N AA N P L EY IH NG
NONPLAYS	N AA N P L EY Z
NONREPAYABLE	N AA N R IY P EY AH B AH L
NOONDAY	N UW N D EY
NOONDAYS	N UW N D EY Z
NOSEGAY	N OW Z G EY
NOSEGAYS	N OW Z G EY Z
NOWADAYS	N AW AH D EY Z
NOWAY	N OW EY IY
NOWAYS	N OW EY Z
OFAY	AA F EY IY
OFAYS	AH F EY Z
OILWAY	OY L W EY
OILWAYS	OY L W EY Z
OKAY	OW K EY
OKAYED	OW K EY D
OKAYING	OW K EY IH NG
OKAYS	OW K EY Z
ORFRAY	AO R F R EY IY
ORFRAYS	AO R F R EY Z
OUTLAY	AW T L EY
OUTLAYING	AW T L EY IH NG
OUTLAYS	AW T L EY Z
OUTPLAY	AW T P L EY
OUTPLAYED	AW T P L EY D
OUTPLAYING	AW T P L EY IH NG
OUTPLAYS	AW T P L EY Z
OUTPRAY	AW T P R EY
OUTPRAYED	AW T P R EY D
OUTPRAYING	AW T P R EY IH NG
OUTPRAYS	AW T P R EY Z
OUTSTAY	AW T S T EY
OUTSTAYED	AW T S T EY D
OUTSTAYING	AW T S T EY IH NG
OUTSTAYS	AW T S T EY Z
OVERLAY	OW V ER L EY
OVERLAYING	OW V ER L EY IH NG
OVERLAYS	OW V ER L EY Z
OVERPAY	OW V ER P EY
OVERPAYING	OW V ER P EY IH NG
OVERPAYMENT	OW V ER P EY M AH N T
OVERPAYMENTS	OW V ER P EY M AH N T S
OVERPAYS	OW V ER P EY Z
OVERPLAY	OW V ER P L EY
OVERPLAYED	OW V ER P L EY D
OVERPLAYING	OW V ER P L EY IH NG
OVERPLAYS	OW V ER P L EY Z
OVERSTAY	OW V ER S T EY
OVERSTAYED	OW V ER S T EY D
OVERSTAYING	OW V ER S T EY IH NG
OVERSTAYS	OW V ER S T EY Z
PALEWAYS	P EY L W EY Z
PAPAYA	P AH P AY AH
PAPAYAN	P AE P EY AH N
PAPAYAS	P AH P AY AH Z
PARKWAY	P AA R K W EY
PARKWAYS	P AA R K W EY Z
PARLAY	P AA R L EY
PARLAYED	P AA R L EY D
PARLAYING	P AA R L EY IH NG
PARLAYS	P AA R L EY Z
PARTWAY	P AA R T W EY
PASSAGEWAY	P AE S AH JH W EY
PASSAGEWAY(2)	P AE S IH JH W EY
PASSAGEWAYS	P AE S IH JH W EY Z
PATHWAY	P AE TH W EY
PATHWAYS	P AE TH W EY Z
PAY	P EY
PAYABLE	P EY AH B AH L
PAYABLES	P EY AH B AH L Z
PAYABLY	P EY AH B L IY
PAYBACK	P EY B AE K
PAYBACKS	P EY B AE K S
PAYCHECK	P EY CH EH K
PAYCHECKS	P EY CH EH K S
PAYDAY	P EY D EY
PAYDAYS	P EY D EY Z
PAYED	P EY D
PAYEE	P EY IY
PAYEES	P EY IY Z
PAYER	P EY ER
PAYERS	P EY ER Z
PAYGRADE	P EY G R EY D
PAYGRADES	P EY G R EY D Z
PAYING	P EY IH NG
PAYLOAD	P EY L OW D
PAYLOADS	P EY L OW D Z
PAYMASTER	P EY M AE S T ER
PAYMASTERS	P EY M AE S T ER Z
PAYMENT	P EY M AH N T
PAYMENTS	P EY M AH N T S
PAYNIM	P EY N AH M
PAYNIMS	P EY N AH M Z
PAYOFF	P EY AO F
PAYOFFS	P EY AO F S
PAYOLA	P EY OW L AH
PAYOLAS	P EY AH L AH Z
PAYOR	P EY ER
PAYORS	P EY ER Z
PAYOUT	P EY AW T
PAYOUTS	P EY AW T S
PAYROLL	P EY R OW L
PAYROLLS	P EY R OW L Z
PAYS	P EY Z
PAYSTUB	P EY S T AH B
PAYSTUBS	P EY S T AH B Z
PHOTOPLAY	F OW T OW P L EY
PHOTOPLAYS	F OW T OW P L EY Z
PICAYUNE	P IH K IY Y UW N
PICAYUNES	P IH K IY Y UW N Z
PICAYUNISH	P IH K IY Y UW N IH SH
PIRAYA	P IH R EY AH
PIRAYAS	P IH R EY AH Z
PLAY	P L EY
PLAYA	P L AY AH
PLAYABILITIES	P L EY AH B IH L AH T EH Z
PLAYABILITY	P L EY AH B IH L AH T EH
PLAYABLE	P L EY AH B AH L
PLAYACT	P L EY AE K T
PLAYACTED	P L EY AE K T IH D
PLAYACTING	P L EY AE K T IH NG
PLAYACTINGS	P L EY AE K T IH NG Z
PLAYACTS	P L EY AE K T S
PLAYAS	P L AY AH Z
PLAYBACK	P L EY B AE K
PLAYBACKS	P L EY B AE K S
PLAYBILL	P L EY B IH L
PLAYBILLS	P L EY B IH L Z
PLAYBOOK	P L EY B UH K
PLAYBOOKS	P L EY B UH K S
PLAYBOY	P L EY B OY
PLAYBOYS	P L EY B OY Z
PLAYDATE	P L EY D EY T
PLAYDATES	P L EY D EY T S
PLAYDAY	P L EY D EY
PLAYDAYS	P L EY D EY Z
PLAYDOWN	P L EY D AW N
PLAYDOWNS	P L EY D AW N Z
PLAYED	P L EY D
PLAYER	P L EY ER
PLAYERS	P L EY ER Z
PLAYFELLOW	P L EY F EH L OW
PLAYFELLOWS	P L EY F EH L OW Z
PLAYFIELD	P L EY F IY L D
PLAYFIELDS	P L EY F IY L D Z
PLAYFUL	P L EY F AH L
PLAYFULLY	P L EY F AH L IY
PLAYFULNESS	P L EY F AH L N AH S
PLAYFULNESSES	P L EY F AH L N AH S IH Z
PLAYGIRL	P L EY G ER L
PLAYGIRLS	P L EY G ER L Z
PLAYGOER	P L EY G OW ER
PLAYGOERS	P L EY G OW ER Z
PLAYGROUND	P L EY G R AW N D
PLAYGROUND(2)	P L EY G R AW N
PLAYGROUNDS	P L EY G R AW N D Z
PLAYGROUNDS(2)	P L EY G R AW N Z
PLAYHOUSE	P L EY HH AW S
PLAYHOUSES	P L EY HH AW S IH Z
PLAYING	P L EY IH NG
PLAYLAND	P L EY L AE N D
PLAYLANDS	P L EY L AE N D Z
PLAYLESS	P L EY L AH S
PLAYLET	P L EY L AH T
PLAYLETS	P L EY L AH T S
PLAYLIKE	P L EY L AY K
PLAYLIST	P L EY L IH S T
PLAYLISTS	P L EY L IH S T S
PLAYMAKER	P L EY M EY K ER
PLAYMAKERS	P L EY M EY K ER Z
PLAYMAKING	P L EY M EY K IH NG
PLAYMAKINGS	P L EY M EY K IH NG Z
PLAYMATE	P L EY M EY T
PLAYMATES	P L EY M EY T S
PLAYOFF	P L EY AO F
PLAYOFFS	P L EY AO F S
PLAYPEN	P L EY P EH N
PLAYPENS	P L EY P EH N Z
PLAYROOM	P L EY R UW M
PLAYROOMS	P L EY R UW M Z
PLAYS	P L EY Z
PLAYSUIT	P L EY S UW T
PLAYSUITS	P L EY S UW T S
PLAYTHING	P L EY TH IH NG
PLAYTHINGS	P L EY TH IH NG Z
PLAYTIME	P L EY T AY M
PLAYTIMES	P L EY T AY M Z
PLAYWEAR	P L EY W AE ER
PLAYWRIGHT	P L EY R AY T
PLAYWRIGHTING	P L EY R AY T IH NG
PLAYWRIGHTINGS	P L EY R AY T IH NG Z
PLAYWRIGHTS	P L EY R AY T S
PLAYWRITING	P L EY R AY T IH NG
PLAYWRITINGS	P L EY R AY T IH NG Z
POPINJAY	P AA P IH N JH EY
POPINJAYS	P AA P IH N JH EY Z
PORTRAY	P AO R T R EY
PORTRAYAL	P AO R T R EY AH L
PORTRAYALS	P AO R T R EY AH L Z
PORTRAYED	P AO R T R EY D
PORTRAYER	P OW R T R EY ER
PORTRAYERS	P OW R T R EY ER Z
PORTRAYING	P AO R T R EY IH NG
PORTRAYS	P AO R T R EY Z
POSTHOLIDAY	P OW S T HH AA L AH D EY
PRAY	P R EY
PRAYED	P R EY D
PRAYER	P R EH R
PRAYER(2)	P R EY ER
PRAYERFUL	P R EH R F AH L
PRAYERFUL(2)	P R EY ER F AH L
PRAYERFULLY	P R EY ER F AH L IY
PRAYERFULNESS	P R EY ER F AH L N AH S
PRAYERFULNESSES	P R EY ER F AH L N AH S IH Z
PRAYERS	P R EH R Z
PRAYERS(2)	P R EY ER Z
PRAYING	P R EY IH NG
PRAYS	P R EY Z
PREHOLIDAY	P R IY HH AO L IH D EY
PREPAY	P R IY P EY
PREPAYING	P R IY P EY IH NG
PREPAYMENT	P R IY P EY M AH N T
PREPAYMENTS	P R IY P EY M AH N T S
PREPAYS	P R IY P EY Z
QUAY	K IY
QUAY(2)	K EY
QUAYAGE	K W EY AH JH
QUAYAGES	K W EY AH JH AH Z
QUAYLIKE	K W EY L AY K
QUAYS	K W EY Z
QUAYSIDE	K W EY S AY D
QUAYSIDES	K W EY S AY D Z
RACEWAY	R EY S W EY
RACEWAYS	R EY S W EY Z
RADIOIMMUNOASSAY	R EY D IY OY M Y AH N OW S EY IY
RADIOIMMUNOASSAYABLE	R EY D IY OY M Y AH N OW S EY AH B AH L
RADIOIMMUNOASSAYS	R EY D IY OY M Y AH N OW S EY Z
RAILWAY	R EY L W EY
RAILWAYS	R EY L W EY Z
RATEPAYER	R EY T P EY ER
RATEPAYERS	R EY T P EY ER Z
RAY	R EY
RAYA	R EY AH
RAYAH	R EY AH
RAYAHS	R EY AH Z
RAYAS	R EY AH Z
RAYED	R EY D
RAYGRASS	R EY G R AE S
RAYGRASSES	R EY G R AE S IH Z
RAYING	R EY IH NG
RAYLESS	R EY L AH S
RAYLESSNESS	R EY L AH S N AH S
RAYLESSNESSES	R EY L AH S N AH S IH Z
RAYLIKE	R EY L AY K
RAYON	R EY AH N
RAYONS	R EY AO N Z
RAYS	R EY Z
REDBAY	R EH D B EY
REDBAYS	R EH D B EY Z
REDISPLAY	R IY D IH S P L EY
REDISPLAYED	R IY D IH S P L EY D
REDISPLAYING	R IY D IH S P L EY IH NG
REDISPLAYS	R IY D IH S P L EY Z
RELAY	R IY L EY
RELAYED	R IY L EY D
RELAYING	R IY L EY IH NG
RELAYS	R IY L EY Z
REPAY	R IY P EY
REPAYABLE	R IY P EY AH B AH L
REPAYING	R IY P EY IH NG
REPAYMENT	R IY P EY M AH N T
REPAYMENTS	R IY P EY M AH N T S
REPAYS	R IY P EY Z
REPLAY	R IY P L EY
REPLAYED	R IY P L EY D
REPLAYING	R IY P L EY IH NG
REPLAYS	R IY P L EY Z
RESAY	R IY S EY
RESAYING	R IY S EY IH NG
RESAYS	R IY S EY Z
RESPRAY	R IY S P R EY
RESPRAYED	R IY S P R EY D
RESPRAYING	R IY S P R EY IH NG
RESPRAYS	R IY S P R EY Z
ROADWAY	R OW D W EY
ROADWAYS	R OW D W EY Z
ROCKAWAY	R AA K AH W EY
ROCKAWAYS	R AA K AH W EY Z
ROLLAWAY	R OW L AH W EY
ROLLWAY	R OW L W EY
ROLLWAYS	R OW L W EY Z
ROPEWAY	R OW P W EY
ROPEWAYS	R OW P W EY Z
ROSEBAY	R OW Z B EY
ROSEBAYS	R OW Z B EY Z
ROUNDELAY	R AW N D EH L EY IY
ROUNDELAYS	R AW N D AH L EY Z
ROUTEWAY	R UW T W EY
ROUTEWAYS	R UW T W EY Z
RUNAWAY	R AH N AH W EY
RUNAWAYS	R AH N AH W EY Z
RUNWAY	R AH N W EY
RUNWAYS	R AH N W EY Z
SABAYON	S AE B EY AH N
SABAYONS	S AE B EY AH N Z
SASHAY	S AE SH EY
SASHAYED	S AE SH EY D
SASHAYING	S AE SH EY IH NG
SASHAYS	S AE SH EY Z
SATAY	S AE T EY IY
SATAYS	S AH T EY Z
SAY	S EY
SAYABLE	S EY AH B AH L
SAYER	S EY ER
SAYERS	S EY ER Z
SAYEST	S EY AH S T
SAYID	S EY AH D
SAYIDS	S EY AH D Z
SAYING	S EY IH NG
SAYINGS	S EY IH NG Z
SAYONARA	S EY AA N AH R AH
SAYONARAS	S EY AA N AH R AH Z
SAYS	S EH Z
SAYS(2)	S IH Z
SAYST	S EY S T
SAYYID	S AY IH D
SAYYIDS	S EY AH D Z
SCREENPLAY	S K R IY N P L EY
SCREENPLAYS	S K R IY N P L EY Z
SEAWAY	S IY W EY
SEAWAYS	S IY W EY Z
SHAY	SH EY
SHAYS	SH EY Z
SHIPWAY	SH IH P W EY
SHIPWAYS	SH IH P W EY Z
SICKBAY	S IH K B EY
SICKBAYS	S IH K B EY Z
SIDEWAY	S AY D W EY
SIDEWAYS	S AY D W EY Z
SKIDWAY	S K IH D W EY
SKIDWAYS	S K IH D W EY Z
SKYWAY	S K AY W EY
SKYWAYS	S K AY W EY Z
SLANTWAYS	S L AE N T W EY Z
SLAY	S L EY
SLAYED	S L EY D
SLAYER	S L EY ER
SLAYERS	S L EY ER Z
SLAYING	S L EY IH NG
SLAYINGS	S L EY IH NG Z
SLAYS	S L EY Z
SLIDEWAY	S L AY D W EY
SLIDEWAYS	S L AY D W EY Z
SLIPWAY	S L IH P W EY
SLIPWAYS	S L IH P W EY Z
SLUICEWAY	S L UW S W EY
SLUICEWAYS	S L UW S W EY Z
SOMEDAY	S AH M D EY
SOMEWAY	S AA M Y UW EY IY
SOMEWAYS	S AA M Y UW EY Z
SOOTHSAY	S UW TH S EY IY
SOOTHSAYER	S UW TH S EY ER
SOOTHSAYERS	S UW TH S EY ER Z
SOOTHSAYING	S UW TH S EY AH NG
SOOTHSAYINGS	S UW TH S EY AH NG Z
SOOTHSAYS	S UW TH S EY Z
SPAY	S P EY
SPAYED	S P EY D
SPAYING	S P AA IY IH NG
SPAYS	S P AA IY Z
SPEEDWAY	S P IY D W EY
SPEEDWAYS	S P IY D W EY Z
SPILLWAY	S P IH L W EY
SPILLWAYS	S P IH L W EY Z
SPLAY	S P L EY
SPLAYED	S P L EY D
SPLAYFEET	S P L EY F IY T
SPLAYFOOT	S P L EY F UH T
SPLAYFOOTED	S P L EY F UH T IH D
SPLAYING	S P L EY IH NG
SPLAYS	S P L EY Z
SPRAY	S P R EY
SPRAYED	S P R EY D
SPRAYER	S P R EY ER
SPRAYERS	S P R EY ER Z
SPRAYING	S P R EY IH NG
SPRAYS	S P R EY Z
STAIRWAY	S T EH R W EY
STAIRWAYS	S T EH R W EY Z
STANDAWAY	S T AE N D AH W EY
STAY	S T EY
STAYED	S T EY D
STAYER	S T EY ER
STAYERS	S T EY ER Z
STAYING	S T EY IH NG
STAYS	S T EY Z
STAYSAIL	S T EY S EY L
STAYSAILS	S T EY S EY L Z
STEERAGEWAY	S T IH ER EY JH W EY
STEERAGEWAYS	S T IH ER EY JH W EY Z
STERNWAY	S T ER N W EY
STERNWAYS	S T ER N W EY Z
STINGRAY	S T IH NG R EY
STINGRAYS	S T IH NG R EY Z
STOWAWAY	S T OW AH W EY
STOWAWAYS	S T OW AH W EY Z
STRAIGHTAWAY	S T R EY T AH W EY
STRAIGHTAWAYS	S T R EY T AH W EY Z
STRAIGHTWAY	S T R EY T W EY
STRAY	S T R EY
STRAYED	S T R EY D
STRAYER	S T R EY ER
STRAYERS	S T R EY ER Z
STRAYING	S T R EY IH NG
STRAYS	S T R EY Z
SUBWAY	S AH B W EY
SUBWAYED	S AH B W EY D
SUBWAYING	S AH B W EY IH NG
SUBWAYS	S AH B W EY Z
SUPERHIGHWAY	S UW P ER HH AY W EY
SUPERHIGHWAYS	S UW P ER HH AY W EY Z
SUPERLAY	S UW P ER L EY
SUPERPLAYER	S UW P ER P L EY ER
SUPERPLAYERS	S UW P ER P L EY ER Z
SWAY	S W EY
SWAYABLE	S W EY AH B AH L
SWAYBACK	S W EY B AE K
SWAYBACKED	S W EY B AE K T
SWAYBACKS	S W EY B AE K S
SWAYED	S W EY D
SWAYER	S W EY ER
SWAYERS	S W EY ER Z
SWAYFUL	S W EY F AH L
SWAYING	S W EY IH NG
SWAYS	S W EY Z
SWORDPLAY	S AO R D P L EY
SWORDPLAYER	S OW R D P L EY ER
SWORDPLAYERS	S OW R D P L EY ER Z
SWORDPLAYS	S AO R D P L EY Z
TAKEAWAY	T EY K AH W EY
TATOUAY	T AH T AW EY IY
TATOUAYS	T AE T AW EY Z
TAXIWAY	T AE K S IY W EY
TAXIWAYS	T AE K S IY W EY Z
TAXPAYER	T AE K S P EY ER
TAXPAYERS	T AE K S P EY ER Z
TAXPAYING	T AE K S P EY IH NG
TEARAWAY	T IH ER AH W EY
TEARAWAYS	T IH ER AH W EY Z
TELEPLAY	T EH L AH P L EY
TELEPLAYS	T EH L AH P L EY Z
THATAWAY	TH AH T AO EY IY
THOUGHTWAY	TH AO T W EY
THOUGHTWAYS	TH AO T W EY Z
THROUGHWAY	TH R UW W EY
THROUGHWAYS	TH R AW W EY Z
THROWAWAY	TH R OW AH W EY
THROWAWAYS	TH R OW AH W EY Z
THRUWAY	TH R UW W EY
THRUWAYS	TH R AH W EY Z
TIDEWAY	T AY D W EY
TIDEWAYS	T AY D W EY Z
TODAY	T AH D EY
TODAY(2)	T UW D EY
TODAYS	T AH D EY Z
TODAYS(2)	T UW D EY Z
TOKAY	T AA K EY IY
TOKAYS	T AH K EY Z
TOLLWAY	T OW L W EY
TOLLWAYS	T OW L W EY Z
TOWAWAY	T OW AH W EY
TOWAWAYS	T OW AH W EY Z
TRACKLAYER	T R AE K L EY ER
TRACKLAYERS	T R AE K L EY ER Z
TRACKLAYING	T R AE K L EY IH NG
TRACKLAYINGS	T R AE K L EY IH NG Z
TRACKWAY	T R AE K W EY
TRACKWAYS	T R AE K W EY Z
TRAINWAY	T R EY N W EY
TRAINWAYS	T R EY N W EY Z
TRAMWAY	T R AE M W EY
TRAMWAYS	T R AE M W EY Z
TRAY	T R EY
TRAYFUL	T R EY F AH L
TRAYFULS	T R EY F AH L Z
TRAYS	T R EY Z
TWAYBLADE	T W EY B L EY D
TWAYBLADES	T W EY B L EY D Z
UNDERLAY	AH N D ER L EY
UNDERLAYING	AH N D ER L EY IH NG
UNDERLAYMENT	AH N D ER L EY M AH N T
UNDERLAYMENTS	AH N D ER L EY M AH N T S
UNDERLAYS	AH N D ER L EY Z
UNDERPAY	AH N D ER P EY
UNDERPAYING	AH N D ER P EY IH NG
UNDERPAYMENT	AH N D ER P EY M AH N T
UNDERPAYMENTS	AH N D ER P EY M AH N T S
UNDERPAYS	AH N D ER P EY Z
UNDERPLAY	AH N D ER P L EY
UNDERPLAYED	AH N D ER P L EY D
UNDERPLAYING	AH N D ER P L EY IH NG
UNDERPLAYS	AH N D ER P L EY Z
UNDERWAY	AH N D ER W EY
UNDISMAYED	AH N D IH S M EY D
UNLAY	AH N L EY
UNLAYING	AH N L EY IH NG
UNLAYS	AH N L EY Z
UNPAYING	AH N P EY IH NG
UNPLAYABLE	AH N P L EY AH B AH L
UNPLAYED	AH N P L EY D
UNSAY	AH N S EY
UNSAYABLE	AH N S EY AH B AH L
UNSAYING	AH N S EY IH NG
UNSAYS	AH N S EY Z
UNSPRAYED	AH N S P R EY D
UNSTAYED	AH N S T EY D
UNSWAYED	AH N S W EY D
VEEJAY	V IY JH EY IY
VEEJAYS	V IY JH EY Z
VILAYET	V IH L EY AH T
VILAYETS	V IH L EY AH T S
VIRELAY	V AH R EH L EY IY
VIRELAYS	V IH R AH L EY Z
VOUVRAY	V AW V R EY IY
VOUVRAYS	V AW V R EY Z
WALKAWAY	W AO K AH W EY
WALKAWAYS	W AO K AH W EY Z
WALKWAY	W AO K W EY
WALKWAYS	W AO K W EY Z
WASHDAY	W AA SH D EY
WASHDAYS	W AA SH D EY Z
WASTEWAY	W EY S T W EY
WASTEWAYS	W EY S T W EY Z
WATERWAY	W AO T ER W EY
WATERWAYS	W AO T ER W EY Z
WAY	W EY
WAYBILL	W EY B IH L
WAYBILLS	W EY B IH L Z
WAYFARER	W EY F EH R ER
WAYFARERS	W EY F EH R ER Z
WAYFARING	W EY F EH R IH NG
WAYGOING	W EY G OW IH NG
WAYGOINGS	W EY G OW IH NG Z
WAYLAID	W EY L EY D
WAYLAY	W EY L EY
WAYLAYER	W EY L EY ER
WAYLAYERS	W EY L EY ER Z
WAYLAYING	W EY L EY IH NG
WAYLAYS	W EY L EY Z
WAYLESS	W EY L AH S
WAYS	W EY Z
WAYSIDE	W EY S AY D
WAYSIDES	W EY S AY D Z
WAYWARD	W EY W ER D
WAYWARDLY	W EY W ER D L IY
WAYWARDNESS	W EY W ER D N AH S
WAYWARDNESSES	W EY W ER D N AH S IH Z
WAYWORN	W EY W OW R N
WEEKDAY	W IY K D EY
WEEKDAYS	W IY K D EY Z
WELLADAY	W EH L AH D EY
WELLADAYS	W EH L AH D EY Z
WELLAWAY	W EH L AH W EY
WELLAWAYS	W EH L AH W EY Z
WHIPRAY	W IH P R EY
WHIPRAYS	W IH P R EY Z
WIDTHWAY	W IH D TH W EY
WINDWAY	W IH N D W EY
WINDWAYS	W IH N D W EY Z
WIREWAY	W AY ER W EY
WIREWAYS	W AY ER W EY Z
WORDPLAY	W ER D P L EY
WORDPLAYS	W ER D P L EY Z
WORKADAY	W ER K AH D EY
WORKDAY	W ER K D EY
WORKDAYS	W ER K D EY Z
YAY	Y EY
YAYS	Y EY Z
YEASAYER	Y IY S EY AH R
YEASAYERS	Y IY S EY AH R Z
YESTERDAY	Y EH S T ER D EY
YESTERDAY(2)	Y EH S T ER D IY
YESTERDAYS	Y EH S T ER D EY Z
YESTERDAYS(2)	Y EH S T ER D IY Z
ZAYIN	Z EY AH N
ZAYINS	Z EY AH N Z
HM	HH AH M
ROACH	R OW CH
OERSTED	ER S T AH D
KECK	K EH K
JALOP	JH AE L AH P
LO	L OW
WO	W OW
WO(2)	HH W OW
