BE	B IY
ABBE	AE B IY
ABBE(2)	AE B EY
ABBES	AE B Z
ABBESS	AE B AH S
ABBESSES	AE B EH S AH Z
ABBEY	AE B IY
ABBEYS	AE B IY Z
ABEAM	AH B IY M
ABECEDARIAN	AE B AH S AH D EH R IY AH N
ABECEDARIANS	AE B AH S AH D AE R IY AH N Z
ABED	AH B EH D
ABELE	AH B EH L
ABELES	AH B EH L Z
ABELES(2)	EY B AH L IY Z
ABELIA	AH B IY L Y AH
ABELIAN	AH B IY L IY AH N
ABELIAS	AH B IY L Y AH Z
ABELMOSK	AH B EH L M AH S
ABELMOSKS	AH B EH L M AH S
ABERRANCE	AE B EH R AH N S
ABERRANCES	AE B EH R AH N S IH Z
ABERRANCIES	AE B EH R AH N S IY Z
ABERRANCY	AE B EH R AH N S IY
ABERRANT	AE B EH R AH N T
ABERRANTLY	AE B EH R AH N T L IY
ABERRANTS	AE B EH R AH N T S
ABERRATED	AE B EH R EY T IH D
ABERRATION	AE B ER EY SH AH N
ABERRATIONAL	AE B ER EY SH AH N AH L
ABERRATIONS	AE B ER EY SH AH N Z
ABET	AH B EH T
ABETMENT	AH B EH T M AH N T
ABETMENTS	AH B EH T M AH N T S
ABETS	AH B EH T S
ABETTAL	AH B EH T AH L
ABETTALS	AH B EH T AH L Z
ABETTED	AH B EH T IH D
ABETTER	AH B EH T ER
ABETTERS	AH B EH T ER Z
ABETTING	AH B EH T IH NG
ABETTOR	AH B EH T ER
ABETTORS	AH B EH T ER Z
ABEYANCE	AH B EY AH N S
ABEYANCES	AH B EY AH N S IH Z
ABEYANCIES	AH B EY AH N S IY Z
ABEYANCY	AH B EY AH N S IY
ABEYANT	AH B EY AH N T
ABSORBED	AH B Z AO R B D
ABSORBENCIES	AH B Z AO R B AH N S IY Z
ABSORBENCY	AH B Z AO R B AH N S IY
ABSORBENT	AH B Z AO R B AH N T
ABSORBENTS	AH B Z AO R B AH N T S
ABSORBER	AH B Z AO R B ER
ABSORBERS	AH B Z AO R B ER Z
ACERBER	EY S ER B IY ER
ACERBEST	EY S ER B EH S T
ACROPHOBE	AE K R AH F OW B
ACROPHOBES	AE K R AH F OW B Z
ADOBE	AH D OW B IY
ADOBELIKE	AH D OW B IY L AY K
ADOBES	AH D OW B IY Z
ADSORBED	AE D Z AO R B D
ADSORBENT	AE D Z AO R B AH N T
ADSORBENTS	AE D Z AO R B AH N T S
ADSORBER	AE D Z AO R B ER
ADSORBERS	AE D Z AO R B ER Z
AEROBE	AH R OW B
AEROBES	AH R OW B Z
AGORAPHOBE	AH G AO R AH F OW B
AGORAPHOBES	AH G AO R AH F OW B Z
AILUROPHOBE	EY L UH R AH F OW B
AILUROPHOBES	EY L UH R AH F OW B Z
ALBEDO	AE L B AH D OW
ALBEDOES	AE L B AH D OW Z
ALBEDOS	AE L B AH D AH Z
ALBEIT	AO L B IY IH T
ALPHABET	AE L F AH B EH T
ALPHABETED	AE L F AH B EH T IH D
ALPHABETIC	AE L F AH B EH T IH K
ALPHABETICAL	AE L F AH B EH T IH K AH L
ALPHABETICALLY	AE L F AH B EH T IH K L IY
ALPHABETING	AE L F AH B EH T IH NG
ALPHABETIZATION	AE L F AH B EH T AH Z EY SH AH N
ALPHABETIZATIONS	AE L F AH B EH T AH Z EY SH AH N Z
ALPHABETIZE	AE L F AH B AH T AY Z
ALPHABETIZED	AE L F AH B AH T AY Z D
ALPHABETIZER	AE L F AH B EH T AY Z ER
ALPHABETIZERS	AE L F AH B EH T AY Z ER Z
ALPHABETIZES	AE L F AH B AH T AY Z IH Z
ALPHABETIZING	AE L F AH B AH T AY Z IH NG
ALPHABETS	AE L F AH B EH T S
AMBEER	AE M B IH R
AMBEERS	AE M B AH R Z
AMBER	AE M B ER
AMBERGRIS	AE M B ER G R IH S
AMBERGRISES	AE M B AH R G R AY Z AH Z
AMBERIES	AE M B ER IY Z
AMBERINA	AE M B EH R AH N AH
AMBERINAS	AE M B EH R AH N AH Z
AMBERJACK	AE M B ER JH AE K
AMBERJACKS	AE M B ER JH AE K S
AMBEROID	AE M B AH R OY D
AMBEROIDS	AE M B AH R OY D Z
AMBERS	AE M B ER Z
AMBERY	AE M B ER IY
AMEBEAN	AH M IY B IY AH N
AMOEBEAN	AH M OW EH B IY AH N
ANAEROBE	AE N ER OW B
ANAEROBES	AE N ER OW B Z
ANALPHABET	AH N AE L F AH B AH T
ANALPHABETIC	AH N AE L F AH B AH T AH K
ANALPHABETICS	AH N AE L F AE B AH T AH S Z
ANALPHABETISM	AH N AE L F AH B AH T IH Z AH M
ANALPHABETISMS	AE N AH L F AE B AH T AH Z AH M Z
ANALPHABETS	AH N AE L F AH B AH T S
ANTBEAR	AE N T B AE ER
ANTBEARS	AE N T B AE ER Z
ANTEBELLUM	AE N T IH B EH L AH M
ANTECHAMBER	AE N T AH K AE M AH R
ANTECHAMBERS	AE N T AH K AE M B AH R Z
ANTIDIABETIC	AE N T AY D AY AH B EH T IH K
ANTIDIABETICS	AE N T AY D AY AH B EH T IH K S
ANTILIBERAL	AE N T AY L IH B ER AH L
ANTILIBERALISM	AE N T AY L IH B ER AH L IH Z AH M
ANTILIBERALISMS	AE N T AY L IH B ER AH L IH Z AH M Z
ANTILIBERALS	AE N T AY L IH B ER AH L Z
ANTILIBERTARIAN	AE N T AY L IH B ER T EH R IY AH N
ANTILIBERTARIANS	AE N T AY L IH B ER T EH R IY AH N Z
ANTIOBESITIES	AE N T AY OW B IY S AH T IY Z
ANTIOBESITY	AE N T AY OW B IY S AH T IY
ANTITUBERCULAR	AE N T AY T Y AH B AH R K Y AH L AH R
ANTITUBERCULOSIS	AE N T AY T UH B ER K Y AH L OW S AH S
ANTITUBERCULOUS	AE N T AY T Y AH B AH R K Y AH L AH S
ARABESK	AE R AH B AH S
ARABESKS	AE R AH B AH S
ARABESQUE	AE R AH B EH S K
ARABESQUES	AE R AH B EH S K S
ARBELEST	AA R B IY L AH S T
ARBELESTS	AA R B AH L AH S T S
ASBESTIC	AH Z B EH S T IH K
ASBESTOS	AE S B EH S T AH S
ASBESTOSES	AE S B EH S T AH S IH Z
ASBESTOSIS	AE S B EH S T OW S IH S
ASBESTUS	AE Z EH S T AH S
ASBESTUSES	AH Z B EH S T Y UW S IH Z
ASCRIBE	AH S K R AY B
ASCRIBED	AH S K R AY B D
ASCRIBES	AH S K R AY B Z
ASTILBE	AE S T AH L B
ASTILBES	AE S T AH L B Z
ASTROLABE	AE S T R AH L EY B
ASTROLABES	AE S T R AH L EY B Z
AUBERGE	AO B AH R JH
AUBERGES	AH B AH R JH AH Z
AUBERGINE	AO B AH R JH AY N
AUBERGINES	AO B AH R JH AY N Z
BABE	B EY B
BABEL	B AE B AH L
BABELS	B AE B AH L Z
BABES	B EY B Z
BABESIA	B AH B IY ZH IY AH
BABESIAS	B AH B IY S IY AH Z
BABESIOSES	B AH B IY S IY OW Z AH Z
BABESIOSIS	B AE B AH S AY OW S AH S
BACKBEAT	B AE K B IY T
BACKBEATS	B AE K B IY T S
BACKBENCH	B AE K B EH N CH
BACKBENCHER	B AE K B EH N CH ER
BACKBENCHERS	B AE K B EH N CH ER Z
BACKBENCHES	B AE K B EH N CH IH Z
BACKBEND	B AE K B EH N D
BACKBENDS	B AE K B EH N D Z
BACKSTABBED	B AE K S T AE B D
BACKSTABBER	B AE K S T AE B ER
BACKSTABBERS	B AE K S T AE B ER Z
BANEBERRIES	B EY N B EH R IY Z
BANEBERRY	B EY N B EH R IY
BARBE	B AA R B
BARBECUE	B AA R B IH K Y UW
BARBECUED	B AA R B IH K Y UW D
BARBECUER	B AA R B IH K Y UW ER
BARBECUERS	B AA R B IH K Y UW ER Z
BARBECUES	B AA R B IH K Y UW Z
BARBECUING	B AA R B IH K Y UW IH NG
BARBED	B AA R B D
BARBEL	B AA R B EH L
BARBELL	B AA R B EH L
BARBELLS	B AA R B EH L Z
BARBELS	B AA R B AH L Z
BARBEQUE	B AA R B IH K Y UW
BARBEQUED	B AA R B IH K Y UW D
BARBEQUES	B AA R B IH K Y UW Z
BARBEQUING	B AA R B AH K AH NG
BARBER	B AA R B ER
BARBERED	B AA R B ER D
BARBERING	B AA R B ER IH NG
BARBERRIES	B AA R B ER R IY Z
BARBERRY	B AA R B ER R IY
BARBERS	B AA R B ER Z
BARBERSHOP	B AA R B ER SH AA P
BARBERSHOPS	B AA R B ER SH AA P S
BARBES	B AA R B IY Z
BARBET	B AA R B EH T
BARBETS	B AA R B EH T S
BARBETTE	B AA R B EH T
BARBETTES	B AA R B EH T S
BATHROBE	B AE TH R OW B
BATHROBES	B AE TH R OW B Z
BAUBEE	B AH B IY IY
BAUBEES	B AH B IY Z
BAWBEE	B AH B IY IY
BAWBEES	B AH B IY Z
BAYBERRIES	B EY B EH R IY Z
BAYBERRY	B EY B EH R IY
BE	B IY
BEACH	B IY CH
BEACHBOY	B IY CH B OY
BEACHBOYS	B IY CH B OY Z
BEACHCOMB	B IY CH K OW M
BEACHCOMBED	B IY CH K OW M D
BEACHCOMBER	B IY CH K OW M ER
BEACHCOMBERS	B IY CH K OW M ER Z
BEACHCOMBING	B IY CH K OW M IH NG
BEACHCOMBS	B IY CH K OW M Z
BEACHED	B IY CH T
BEACHES	B IY CH AH Z
BEACHES(2)	B IY CH IH Z
BEACHFRONT	B IY CH F R AA N T
BEACHFRONTS	B IY CH F R AA N T S
BEACHGOER	B IY CH G OW ER
BEACHGOERS	B IY CH G OW ER Z
BEACHHEAD	B IY CH HH EH D
BEACHHEADS	B IY CH HH EH D Z
BEACHIER	B IY CH IY ER
BEACHIEST	B IY CH IY AH S T
BEACHING	B IY CH IH NG
BEACHSIDE	B IY CH S AY D
BEACHWEAR	B IY CH W AE ER
BEACHY	B IY CH IY
BEACON	B IY K AH N
BEACONED	B IY K AH N D
BEACONING	B IY K AH N IH NG
BEACONS	B IY K AH N Z
BEAD	B IY D
BEADED	B IY D IH D
BEADIER	B IY D IY ER
BEADIEST	B IY D IY AH S T
BEADILY	B IY D IY L IY
BEADING	B IY D IH NG
BEADINGS	B IY D IH NG Z
BEADLE	B IY D AH L
BEADLES	B IY D AH L Z
BEADLIKE	B IY D L AY K
BEADMAN	B IY D M AE N
BEADMEN	B IY D M EH N
BEADROLL	B IY D R OW L
BEADROLLS	B IY D R OW L Z
BEADS	B IY D Z
BEADSMAN	B IY D Z M AE N
BEADSMEN	B IY D Z M EH N
BEADWORK	B IY D W ER K
BEADWORKS	B IY D W ER K S
BEADY	B IY D IY
BEAGLE	B IY G AH L
BEAGLES	B IY G AH L Z
BEAK	B IY K
BEAKED	B AH EY K T
BEAKER	B IY K ER
BEAKERS	B IY K ER Z
BEAKIER	B AH AE K AY AH R
BEAKIEST	B AH AE K AY AH S T
BEAKLESS	B AH AE K L AH S
BEAKLIKE	B IY K L AY K
BEAKS	B AH AE K S
BEAKY	B AH EY K IY
BEAM	B IY M
BEAMED	B IY M D
BEAMIER	B IH EY M IY ER
BEAMIEST	B IH EY M IY AH S T
BEAMILY	B IH EY M IY L IY
BEAMING	B IY M IH NG
BEAMISH	B IY M IH SH
BEAMISHLY	B IY M IH SH L IY
BEAMLESS	B IY M L AH S
BEAMLIKE	B IY M L AY K
BEAMS	B IY M Z
BEAMY	B IY M IY
BEAN	B IY N
BEANBAG	B IY N B AE G
BEANBAGS	B IY N B AE G Z
BEANBALL	B IY N B AO L
BEANBALLS	B IY N B AO L Z
BEANED	B IY N D
BEANERIES	B IY N AH R IY Z
BEANERY	B IY N AH R IY
BEANIE	B IY N IY
BEANIES	B IY N IY Z
BEANING	B IY N IH NG
BEANLIKE	B IY N L AY K
BEANO	B AH AE N OW
BEANOS	B IY N AA S
BEANPOLE	B IY N P OW L
BEANPOLES	B IY N P OW L Z
BEANS	B IY N Z
BEANSTALK	B IY N S T AO K
BEANSTALKS	B IY N S T AO K S
BEAR	B EH R
BEARABILITIES	B AE ER AH B IH L AH T EH Z
BEARABILITY	B AE ER AH B IH L AH T EH
BEARABLE	B EH R AH B AH L
BEARABLY	B EH R AH B L IY
BEARBAITING	B AE ER B EY T IH NG
BEARBAITINGS	B AE ER B EY T IH NG Z
BEARBERRIES	B AE ER B EH R IY Z
BEARBERRY	B AE ER B EH R IY
BEARCAT	B AE ER K AE T
BEARCATS	B AE ER K AE T S
BEARD	B IH R D
BEARDED	B IH R D AH D
BEARDEDNESS	B IH ER D AH D N AH S
BEARDEDNESSES	B IH ER D AH D N AH S IH Z
BEARDING	B IH ER D IH NG
BEARDLESS	B IH AA R D L AH S
BEARDS	B IH R D Z
BEARDTONGUE	B IH ER D T AH NG
BEARDTONGUES	B IH ER D T AH NG Z
BEARER	B EH R ER
BEARERS	B EH R ER Z
BEARHUG	B AE ER HH AH G
BEARHUGS	B AE ER HH AH G Z
BEARING	B EH R IH NG
BEARINGS	B EH R IH NG Z
BEARISH	B EH R IH SH
BEARISHLY	B EH R IH SH L IY
BEARISHNESS	B EH R IH SH N AH S
BEARISHNESSES	B AE ER IH SH N AH S IH Z
BEARLIKE	B AE ER L AY K
BEARS	B EH R Z
BEARSKIN	B AE ER S K IH N
BEARSKINS	B AE ER S K IH N Z
BEARWOOD	B AE ER W UH D
BEARWOODS	B AE ER W UH D Z
BEAST	B IY S T
BEASTIE	B IY S T IY
BEASTIES	B IY S T IY Z
BEASTINGS	B IY S T IH NG Z
BEASTLIER	B IY S T L IY ER
BEASTLIEST	B IY S T L IY AH S T
BEASTLINESS	B IY S T L IY N AH S
BEASTLINESSES	B IY S T L IY N AH S IH Z
BEASTLY	B IY S T L IY
BEASTS	B IY S T S
BEAT	B IY T
BEATABLE	B IY T AH B AH L
BEATEN	B IY T AH N
BEATER	B IY T ER
BEATERS	B IY T ER Z
BEATIFIC	B IY AH T IH F IH K
BEATIFICALLY	B IY AH T IH F IH K AH L IY
BEATIFICATION	B IY AE T AH F AH K EY SH AH N
BEATIFICATIONS	B IY AE T AH F AH K EY SH AH N Z
BEATIFIED	B IY AE T AH F AY D
BEATIFIES	B IY T AH F AY Z
BEATIFY	B IY AE T AH F AY
BEATIFYING	B IY T AH F AY IH NG
BEATING	B IY T IH NG
BEATINGS	B IY T IH NG Z
BEATITUDE	B IY AE T AH T UW D
BEATITUDES	B IY AE T AH T UW D Z
BEATLESS	B IY T L AH S
BEATNIK	B IY T N IH K
BEATNIKS	B IY T N IH K S
BEATS	B IY T S
BEAU	B OW
BEAUCOUP	B OW K UW
BEAUISH	B OW IH SH
BEAUS	B OW Z
BEAUT	B AH AO T
BEAUTEOUS	B Y UW T IY AH S
BEAUTEOUSLY	B Y UW T IY AH S L IY
BEAUTEOUSNESS	B Y UW T IY AH S N AH S
BEAUTEOUSNESSES	B Y UW T IY AH S N AH S IH Z
BEAUTICIAN	B Y UW T IH SH AH N
BEAUTICIANS	B AH AH T IH S IY AH N Z
BEAUTIES	B Y UW T IY Z
BEAUTIFICATION	B IH AH Y UW T AH F AH K EY SH AH N
BEAUTIFICATIONS	B AH AO T AH F AH K EY T IY AH N Z
BEAUTIFIED	B AH AO T AH F AY D
BEAUTIFIER	B AH AH T IH F AY AH R
BEAUTIFIERS	B AH AO T AH F IY R Z
BEAUTIFIES	B AH AO T AH F AY Z
BEAUTIFUL	B Y UW T AH F AH L
BEAUTIFULER	B Y UW T IY F AH L ER
BEAUTIFULEST	B Y UW T IY F AH L AH S T
BEAUTIFULLY	B Y UW T AH F L IY
BEAUTIFULNESS	B Y UW T IY F AH L N AH S
BEAUTIFULNESSES	B Y UW T IY F AH L N AH S IH Z
BEAUTIFY	B Y UW T IH F AY
BEAUTIFYING	B AH AH T IH F AY AH NG
BEAUTS	B IH AH Y UW T S
BEAUTY	B Y UW T IY
BEAUX	B OW
BEAVER	B IY V ER
BEAVERBOARD	B IY V ER B OW R D
BEAVERBOARDS	B IY V ER B OW R D Z
BEAVERED	B IY V ER D
BEAVERING	B IY V ER IH NG
BEAVERS	B IY V ER Z
BEBEERU	B AH B AH EH R UW
BEBEERUS	B IH B AH IY R AH S
BEBLOOD	B IH B L AH D
BEBLOODED	B IH B L AH D IH D
BEBLOODING	B IH B L AH D IH NG
BEBLOODS	B IH B L AH D Z
BEBOP	B IY B AA P
BEBOPPER	B IY B AA P ER
BEBOPPERS	B IY B AA P ER Z
BEBOPS	B IY B AA P S
BECALM	B IH K AA M
BECALMED	B IH K AA M D
BECALMING	B IH K AA M IH NG
BECALMS	B IH K AA M Z
BECAME	B IH K EY M
BECAME(2)	B IY K EY M
BECAP	B IH K AE P
BECAPPED	B IH K AE P T
BECAPPING	B IH K AE P IH NG
BECAPS	B IH K AE P S
BECARPET	B IH K AA R P AH T
BECARPETED	B IH K AA R P AH T IH D
BECARPETING	B IH K AA R P AH T IH NG
BECARPETS	B IH K AA R P AH T S
BECAUSE	B IH K AO Z
BECAUSE(2)	B IH K AH Z
BECAUSE(3)	B IH K AA Z
BECHALK	B IH CH AO K
BECHALKED	B IH CH AO K T
BECHALKING	B IH CH AO K IH NG
BECHALKS	B IH CH AO K S
BECHAMEL	B AH CH AE M AH L
BECHAMELS	B AH CH AE M AH L Z
BECHANCE	B IH CH AE N S
BECHANCED	B IH CH AE N S T
BECHANCES	B IH CH AE N S IH Z
BECHANCING	B IH CH AE N S IH NG
BECHARM	B IH CH AA R M
BECHARMED	B IH CH AA R M D
BECHARMING	B IH CH AA R M IH NG
BECHARMS	B IH CH AA R M Z
BECK	B EH K
BECKED	B EH K T
BECKET	B EH K AH T
BECKETS	B EH K AH T S
BECKING	B EH K IH NG
BECKON	B EH K AH N
BECKONED	B EH K AH N D
BECKONER	B EH K AH N ER
BECKONERS	B EH K AH N ER Z
BECKONING	B EH K AH N IH NG
BECKONS	B EH K AH N Z
BECKS	B EH K S
BECLAMOR	B IH K L AE M ER
BECLAMORED	B IH K L AE M ER D
BECLAMORING	B IH K L AE M ER IH NG
BECLAMORS	B IH K L AE M ER Z
BECLASP	B IH K L AE S P
BECLASPED	B IH K L AE S P T
BECLASPING	B IH K L AE S P IH NG
BECLASPS	B IH K L AE S P S
BECLOAK	B IH K L OW K
BECLOAKED	B IH K L OW K T
BECLOAKING	B IH K L OW K IH NG
BECLOAKS	B IH K L OW K S
BECLOG	B IH K L AA G
BECLOGGED	B IH K L AA G D
BECLOGGING	B IH K L AA G IH NG
BECLOGS	B IH K L AA G Z
BECLOTHE	B IH K L OW DH
BECLOTHED	B IH K L OW DH D
BECLOTHES	B IH K L OW DH Z
BECLOTHING	B IH K L OW DH IH NG
BECLOUD	B IH K L AW D
BECLOUDED	B IH K L AW D IH D
BECLOUDING	B IH K L AW D IH NG
BECLOUDS	B IH K L AW D Z
BECLOWN	B IH K L AW N
BECLOWNED	B IH K L AW N D
BECLOWNING	B IH K L AW N IH NG
BECLOWNS	B IH K L AW N Z
BECOME	B IH K AH M
BECOMES	B IH K AH M Z
BECOMING	B IH K AH M IH NG
BECOMINGLY	B IH K AH M IH NG L IY
BECOMINGS	B IH K AH M IH NG Z
BECOWARD	B IH K AW ER D
BECOWARDED	B IH K AW ER D IH D
BECOWARDING	B IH K AW ER D IH NG
BECOWARDS	B IH K AW ER D Z
BECRAWL	B IH K R AO L
BECRAWLED	B IH K R AO L D
BECRAWLING	B IH K R AO L IH NG
BECRAWLS	B IH K R AO L Z
BECRIME	B IH K R AY M
BECRIMED	B IH K R AY M D
BECRIMES	B IH K R AY M Z
BECRIMING	B IH K R AY M IH NG
BECROWD	B IH K R AW D
BECROWDED	B IH K R AW D IH D
BECROWDING	B IH K R AW D IH NG
BECROWDS	B IH K R AW D Z
BECRUST	B IH K R AH S T
BECRUSTED	B IH K R AH S T IH D
BECRUSTING	B IH K R AH S T IH NG
BECRUSTS	B IH K R AH S T S
BECUDGEL	B IH K AH JH AH L
BECUDGELED	B IH K AH JH AH L D
BECUDGELING	B IH K AH JH AH L IH NG
BECUDGELLED	B IH K AH JH AH L D
BECUDGELLING	B IH K AH JH AH L IH NG
BECUDGELS	B IH K AH JH AH L Z
BECURSE	B IH K ER S
BECURSED	B IH K ER S T
BECURSES	B IH K ER S IH Z
BECURSING	B IH K ER S IH NG
BECURST	B AH K AH R S T
BED	B EH D
BEDABBLE	B IH D AE B AH L
BEDABBLED	B IH D AE B AH L D
BEDABBLES	B IH D AE B AH L Z
BEDABBLING	B IH D AE B AH L IH NG
BEDAMN	B IH D AE M
BEDAMNED	B IH D AE M D
BEDAMNING	B IH D AE M IH NG
BEDAMNS	B IH D AE M Z
BEDARKEN	B IH D AA R K AH N
BEDARKENED	B IH D AA R K AH N D
BEDARKENING	B IH D AA R K AH N IH NG
BEDARKENS	B IH D AA R K AH N Z
BEDAUB	B IH D AO B
BEDAUBED	B IH D AO B D
BEDAUBING	B IH D AO B IH NG
BEDAUBS	B IH D AO B Z
BEDAZZLE	B IH D AE Z AH L
BEDAZZLED	B IH D AE Z AH L D
BEDAZZLEMENT	B IH D AE Z AH L M AH N T
BEDAZZLEMENTS	B IH D AE Z AH L M AH N T S
BEDAZZLES	B IH D AE Z AH L Z
BEDAZZLING	B IH D AE Z AH L IH NG
BEDBUG	B EH D B AH G
BEDBUGS	B EH D B AH G Z
BEDCHAIR	B EH D CH EH ER
BEDCHAIRS	B EH D CH EH ER Z
BEDCHAMBER	B EH D CH EY M B ER
BEDCHAMBERS	B EH D CH EY M B ER Z
BEDCLOTHES	B EH D K L OW DH Z
BEDCOVER	B EH D K AH V ER
BEDCOVERING	B EH D K AH V ER IH NG
BEDCOVERINGS	B EH D K AH V ER IH NG Z
BEDCOVERS	B EH D K AH V ER Z
BEDDABLE	B EH D AH B AH L
BEDDED	B EH D IH D
BEDDER	B EH D ER
BEDDERS	B EH D ER Z
BEDDING	B EH D IH NG
BEDDINGS	B EH D IH NG Z
BEDEAFEN	B IH D EH F AH N
BEDEAFENED	B IH D EH F AH N D
BEDEAFENING	B IH D EH F AH N IH NG
BEDEAFENS	B IH D EH F AH N Z
BEDECK	B IH D EH K
BEDECKED	B IH D EH K T
BEDECKING	B IH D EH K IH NG
BEDECKS	B IH D EH K S
BEDEL	B IH D EH L
BEDELL	B EH D AH L
BEDELLS	B IH D EH L Z
BEDELS	B AH D EH L Z
BEDEMAN	B IH D IY M AE N
BEDEMEN	B IH D IY M EH N
BEDESMAN	B AH D EH Z M AH N
BEDESMEN	B AH D EH Z M AH N
BEDEVIL	B IH D EH V AH L
BEDEVILED	B IH D EH V AH L D
BEDEVILING	B IH D IY V IY L IH NG
BEDEVILLED	B IH D EH V AH L D
BEDEVILLING	B IH D IY V IH L IH NG
BEDEVILMENT	B IH D IY V IH L M AH N T
BEDEVILMENTS	B IH D IY V IH L M AH N T S
BEDEVILS	B IH D EH V AH L Z
BEDEW	B IH D UW
BEDEWED	B IH D IY W EH D
BEDEWING	B IH D IY W IH NG
BEDEWS	B IH D UW Z
BEDFAST	B EH D F AE S T
BEDFELLOW	B EH D F EH L OW
BEDFELLOWS	B EH D F EH L OW Z
BEDFRAME	B EH D F R EY M
BEDFRAMES	B EH D F R EY M Z
BEDGOWN	B EH D G AW N
BEDGOWNS	B EH D G AW N Z
BEDIAPER	B IH D AY P ER
BEDIAPERED	B IH D AY P ER D
BEDIAPERING	B IH D AY P ER IH NG
BEDIAPERS	B IH D AY P ER Z
BEDIGHT	B AH D AY T
BEDIGHTED	B AH D AY T AH D
BEDIGHTING	B AH D AY T AH NG
BEDIGHTS	B AH D AY T S
BEDIM	B IH D IH M
BEDIMMED	B IH D IH M D
BEDIMMING	B IH D IH M IH NG
BEDIMPLE	B AH D IH M P AH L
BEDIMPLED	B AH D IH M P AH L D
BEDIMPLES	B AH D IH M P AH L Z
BEDIMPLING	B AH D IH M P L AH NG
BEDIMS	B IH D IH M Z
BEDIRTIED	B IH D ER T IY D
BEDIRTIES	B IH D ER T IY Z
BEDIRTY	B IH D ER T IY
BEDIRTYING	B IH D ER T IY IH NG
BEDIZEN	B EH D AY Z AH N
BEDIZENED	B EH D AY Z AH N D
BEDIZENING	B EH D AY Z AH N IH NG
BEDIZENMENT	B EH D AY Z AH N M AH N T
BEDIZENMENTS	B EH D AY Z AH N M AH N T S
BEDIZENS	B EH D AY Z AH N Z
BEDLAM	B EH D L AH M
BEDLAMITE	B IH D L AH M AY T
BEDLAMITES	B IH D L AH M AY T S
BEDLAMP	B EH D L AE M P
BEDLAMPS	B EH D L AE M P S
BEDLAMS	B EH D L AH M Z
BEDLESS	B EH D L AH S
BEDLIKE	B EH D L AY K
BEDMAKER	B EH D M EY K ER
BEDMAKERS	B EH D M EY K ER Z
BEDMATE	B EH D M EY T
BEDMATES	B EH D M EY T S
BEDOTTED	B IH D AA T IH D
BEDOUIN	B EH D OW AH N
BEDOUIN(2)	B EH D UW IH N
BEDOUIN(3)	B EH D AH W AH N
BEDOUINS	B EH D OW AH N Z
BEDOUINS(2)	B EH D UW IH N Z
BEDOUINS(3)	B EH D AH W AH N Z
BEDPAN	B EH D P AE N
BEDPANS	B EH D P AE N Z
BEDPLATE	B EH D P L EY T
BEDPLATES	B EH D P L EY T S
BEDPOST	B EH D P OW S T
BEDPOSTS	B EH D P OW S T S
BEDQUILT	B EH D K W IH L T
BEDQUILTS	B EH D K W IH L T S
BEDRAGGLE	B IH D R AE G AH L
BEDRAGGLED	B IH D R AE G AH L D
BEDRAGGLES	B IH D R AE G AH L Z
BEDRAGGLING	B IH D R AE G AH L IH NG
BEDRAIL	B EH D R EY L
BEDRAILS	B EH D R EY L Z
BEDRAPE	B IH D R EY P
BEDRAPED	B IH D R EY P T
BEDRAPES	B IH D R EY P S
BEDRAPING	B IH D R EY P IH NG
BEDRENCH	B IH D R EH N CH
BEDRENCHED	B IH D R EH N CH T
BEDRENCHES	B IH D R EH N CH IH Z
BEDRENCHING	B IH D R EH N CH IH NG
BEDRID	B EH D R IH D
BEDRIDDEN	B EH D R IH D AH N
BEDRIVEL	B IH D R IH V AH L
BEDRIVELED	B IH D R AY V L EH D
BEDRIVELING	B IH D R AY V L IH NG
BEDRIVELLED	B IH D R IH V AH L D
BEDRIVELLING	B IH D R AH V EH L AH NG
BEDRIVELS	B IH D R IH V AH L Z
BEDROCK	B EH D R AA K
BEDROCKS	B EH D R AA K S
BEDROLL	B EH D R OW L
BEDROLLS	B EH D R OW L Z
BEDROOM	B EH D R UW M
BEDROOMED	B EH D R UW M D
BEDROOMS	B EH D R UW M Z
BEDRUG	B IH D R AH G
BEDRUGGED	B IH D R AH G D
BEDRUGGING	B IH D R AH G IH NG
BEDRUGS	B IH D R AH G Z
BEDS	B EH D Z
BEDSHEET	B EH D SH IY T
BEDSHEETS	B EH D SH IY T S
BEDSIDE	B EH D S AY D
BEDSIDES	B EH D S AY D Z
BEDSIT	B EH D S IH T
BEDSITS	B EH D S IH T S
BEDSONIA	B IH D S OW N Y AH
BEDSONIAE	B IH D S OW N IY IY
BEDSONIAS	B IH D S OW N Y AH Z
BEDSORE	B EH D S OW R
BEDSORES	B EH D S OW R Z
BEDSPREAD	B EH D S P R EH D
BEDSPREADS	B EH D S P R EH D Z
BEDSPRING	B EH D S P R IH NG
BEDSPRINGS	B EH D S P R IH NG Z
BEDSTAND	B EH D S T AE N D
BEDSTANDS	B EH D S T AE N D Z
BEDSTEAD	B EH D S T EH D
BEDSTEADS	B EH D S T EH D Z
BEDSTRAW	B EH D S T R AO
BEDSTRAWS	B EH D S T R AO Z
BEDTICK	B EH D T IH K
BEDTICKS	B EH D T IH K S
BEDTIME	B EH D T AY M
BEDTIMES	B EH D T AY M Z
BEDU	B AH D UW
BEDUIN	B AH D UW N
BEDUINS	B AH D UW N Z
BEDUMB	B IH D AH M
BEDUMBED	B IH D AH M D
BEDUMBING	B IH D AH M IH NG
BEDUMBS	B IH D AH M Z
BEDUNCE	B AH D AH N S
BEDUNCED	B AH D AH N S T
BEDUNCES	B AH D AH N S AH Z
BEDUNCING	B AH D AH N S AH NG
BEDWARD	B EH D W ER D
BEDWARDS	B EH D W ER D Z
BEDWARF	B IH D W AO R F
BEDWARFED	B IH D W AO R F T
BEDWARFING	B IH D W AO R F IH NG
BEDWARFS	B IH D W AO R F S
BEDWETTER	B EH D W EH T ER
BEDWETTERS	B EH D W EH T ER Z
BEE	B IY
BEEBEE	B IY B IY
BEEBEES	B IY B IY Z
BEEBREAD	B IY B R EH D
BEEBREADS	B IY B R EH D Z
BEECH	B IY CH
BEECHDROPS	B IY CH D R AA P S
BEECHEN	B IY CH AH N
BEECHES	B IY CH IH Z
BEECHIER	B IY CH IY ER
BEECHIEST	B IY CH IY AH S T
BEECHNUT	B IY CH N AH T
BEECHNUTS	B IY CH N AH T S
BEECHY	B IY CH IY
BEEF	B IY F
BEEFALO	B AH EH F AH L OW
BEEFALOES	B IY F AE L OW Z
BEEFALOS	B IY F AH L AA S
BEEFCAKE	B IY F K EY K
BEEFCAKES	B IY F K EY K S
BEEFEATER	B IY F IY T ER
BEEFEATERS	B IY F IY T ER Z
BEEFED	B IY F T
BEEFIER	B IY F IY ER
BEEFIEST	B IY F IY AH S T
BEEFILY	B IY F IY L IY
BEEFING	B IY F IH NG
BEEFLESS	B IY F L AH S
BEEFS	B IY F S
BEEFSTEAK	B IY F S T EY K
BEEFSTEAKS	B IY F S T EY K S
BEEFWOOD	B IY F W UH D
BEEFWOODS	B IY F W UH D Z
BEEFY	B IY F IY
BEEHIVE	B IY HH AY V
BEEHIVES	B IY HH AY V Z
BEEKEEPER	B IY K IY P ER
BEEKEEPERS	B IY K IY P ER Z
BEEKEEPING	B IY K IY P IH NG
BEEKEEPINGS	B IY K IY P IH NG Z
BEELIKE	B IY L AY K
BEELINE	B IY L AY N
BEELINED	B IY L AY N D
BEELINES	B IY L AY N Z
BEELINING	B IY L AY N IH NG
BEEN	B IH N
BEEN(2)	B AH N
BEEP	B IY P
BEEPED	B IY P T
BEEPER	B IY P ER
BEEPERS	B IY P ER Z
BEEPING	B IY P IH NG
BEEPS	B IY P S
BEER	B IH R
BEERIER	B IY AH R IY ER
BEERIEST	B IY AH R IY AH S T
BEERS	B IH R Z
BEERY	B IH R IY
BEES	B IY Z
BEESTINGS	B IY AH S T IH NG Z
BEESWAX	B IY Z W AE K S
BEESWAXES	B IY Z W AE K S IH Z
BEESWING	B IY S W IH NG
BEESWINGS	B IY S W IH NG Z
BEET	B IY T
BEETLE	B IY T AH L
BEETLED	B IY T AH L D
BEETLER	B IY T AH L ER
BEETLERS	B IY T AH L ER Z
BEETLES	B IY T AH L Z
BEETLING	B IY T L IH NG
BEETROOT	B IY T R UW T
BEETROOTS	B IY T R UW T S
BEETS	B IY T S
BEEVES	B IH IY V Z
BEEYARD	B IY Y AA R D
BEEYARDS	B IY Y AA R D Z
BEEZER	B AH IY Z AH R
BEEZERS	B AH EH Z AH R Z
BEFALL	B IH F AO L
BEFALLEN	B AH F AA L AH N
BEFALLING	B IH F AO L IH NG
BEFALLS	B IH F AO L Z
BEFELL	B IH F EH L
BEFINGER	B IH F IH NG G ER
BEFINGERED	B IH F IH NG G ER D
BEFINGERING	B IH F IH NG G ER IH NG
BEFINGERS	B IH F IH NG G ER Z
BEFIT	B IH F IH T
BEFITS	B IH F IH T S
BEFITTED	B IH F IH T IH D
BEFITTING	B IH F IH T IH NG
BEFITTINGLY	B IH F IH T IH NG L IY
BEFLAG	B IH F L AE G
BEFLAGGED	B IH F L AE G D
BEFLAGGING	B IH F L AE G IH NG
BEFLAGS	B IH F L AE G Z
BEFLEA	B IH F L IY
BEFLEAED	B IH F L IY D
BEFLEAING	B IH F L IY IH NG
BEFLEAS	B IH F L IY Z
BEFLECK	B IH F L EH K
BEFLECKED	B IH F L EH K T
BEFLECKING	B IH F L EH K IH NG
BEFLECKS	B IH F L EH K S
BEFLOWER	B IH F L AW ER
BEFLOWERED	B IH F L AW ER D
BEFLOWERING	B IH F L AW ER IH NG
BEFLOWERS	B IH F L AW ER Z
BEFOG	B IH F AA G
BEFOGGED	B IH F AA G D
BEFOGGING	B IH F AA G IH NG
BEFOGS	B IH F AA G Z
BEFOOL	B IH F UW L
BEFOOLED	B IH F UW L D
BEFOOLING	B IH F UW L IH NG
BEFOOLS	B IH F UW L Z
BEFORE	B IH F AO R
BEFORE(2)	B IY F AO R
BEFOREHAND	B IH F AO R HH AE N D
BEFORETIME	B IH F OW R T AY M
BEFOUL	B IH F AW L
BEFOULED	B IH F AW L D
BEFOULER	B IH F AW L ER
BEFOULERS	B IH F AW L ER Z
BEFOULING	B IH F AW L IH NG
BEFOULS	B IH F AW L Z
BEFRET	B IH F R EH T
BEFRETS	B IH F R EH T S
BEFRETTED	B IH F R EH T IH D
BEFRETTING	B IH F R EH T IH NG
BEFRIEND	B IH F R EH N D
BEFRIENDED	B IH F R EH N D IH D
BEFRIENDING	B IH F R EH N D IH NG
BEFRIENDS	B IH F R EH N D Z
BEFRINGE	B IH F R IH N JH
BEFRINGED	B IH F R IH N JH D
BEFRINGES	B IH F R IH N JH IH Z
BEFRINGING	B IH F R IH N JH IH NG
BEFUDDLE	B IH F AH D AH L
BEFUDDLED	B IH F AH D AH L D
BEFUDDLEMENT	B IH F AH D AH L M AH N T
BEFUDDLEMENTS	B IH F AH D AH L M AH N T S
BEFUDDLES	B IH F AH D AH L Z
BEFUDDLING	B IH F AH D AH L IH NG
BEG	B EH G
BEGALL	B IH G AO L
BEGALLED	B IH G AO L D
BEGALLING	B IH G AE L IH NG
BEGALLS	B IH G AO L Z
BEGAN	B IH G AE N
BEGAN(2)	B IY G AE N
BEGAT	B IH G AE T
BEGAZE	B IH G EY Z
BEGAZED	B IH G EY Z D
BEGAZES	B IH G EY Z IH Z
BEGAZING	B IH G EY Z IH NG
BEGET	B IH G EH T
BEGETS	B IH G EH T S
BEGETTER	B IH G EH T ER
BEGETTERS	B IH G EH T ER Z
BEGETTING	B IH G EH T IH NG
BEGGAR	B EH G ER
BEGGARED	B EH G ER D
BEGGARIES	B EH G EH R IY Z
BEGGARING	B EH G ER IH NG
BEGGARLINESS	B EH G ER L IY N AH S
BEGGARLINESSES	B EH G ER L IY N AH S IH Z
BEGGARLY	B EH G ER L IY
BEGGARS	B EH G ER Z
BEGGARWEED	B EH G ER W IY D
BEGGARWEEDS	B EH G ER W IY D Z
BEGGARY	B EH G EH R IY
BEGGED	B EH G D
BEGGING	B EH G IH NG
BEGIN	B IH G IH N
BEGINNER	B IH G IH N ER
BEGINNERS	B IH G IH N ER Z
BEGINNING	B IH G IH N IH NG
BEGINNINGS	B IH G IH N IH NG Z
BEGINS	B IH G IH N Z
BEGIRD	B IH G ER D
BEGIRDED	B IH G ER D IH D
BEGIRDING	B IH G ER D IH NG
BEGIRDLE	B IH G ER D AH L
BEGIRDLED	B IH G ER D AH L D
BEGIRDLES	B IH G ER D AH L Z
BEGIRDLING	B IH G ER D L IH NG
BEGIRDS	B IH G ER D Z
BEGIRT	B AH JH AH R T
BEGLAD	B IH G L AE D
BEGLADDED	B IH G L AE D IH D
BEGLADDING	B IH G L AE D IH NG
BEGLADS	B IH G L AE D Z
BEGLAMOR	B IH G L AE M ER
BEGLAMORED	B IH G L AE M ER D
BEGLAMORING	B IH G L AE M ER IH NG
BEGLAMORS	B IH G L AE M ER Z
BEGLAMOUR	B IH G L AE M ER
BEGLAMOURED	B IH G L AE M ER D
BEGLAMOURING	B IH G L AE M ER IH NG
BEGLAMOURS	B IH G L AE M ER Z
BEGLOOM	B IH G L UW M
BEGLOOMED	B IH G L UW M D
BEGLOOMING	B IH G L UW M IH NG
BEGLOOMS	B IH G L UW M Z
BEGONE	B IH G AO N
BEGONIA	B IH G OW N Y AH
BEGONIAS	B IH G OW N Y AH Z
BEGORAH	B AH G AO R AH
BEGORRA	B AH G AO R AH
BEGORRAH	B AH G AO R AH
BEGOT	B IY G AO T
BEGOTTEN	B IY G AO T IH N
BEGRIM	B IH G R IH M
BEGRIME	B IH G R AY M
BEGRIMED	B IH G R AY M D
BEGRIMES	B IH G R AY M Z
BEGRIMING	B IH G R AY M IH NG
BEGRIMMED	B IH G R IH M D
BEGRIMMING	B IH G R IH M IH NG
BEGRIMS	B IH G R IH M Z
BEGROAN	B IH G R OW N
BEGROANED	B IH G R OW N D
BEGROANING	B IH G R OW N IH NG
BEGROANS	B IH G R OW N Z
BEGRUDGE	B IH G R AH JH
BEGRUDGED	B IH G R AH JH D
BEGRUDGES	B IH G R AH JH IH Z
BEGRUDGING	B IH G R AH JH IH NG
BEGRUDGINGLY	B IH G R AH JH IH NG L IY
BEGS	B EH G Z
BEGUILE	B IH G AY L
BEGUILED	B IH G AY L D
BEGUILEMENT	B IH G AY L M AH N T
BEGUILEMENTS	B IH G AY L M AH N T S
BEGUILER	B IH G AY L ER
BEGUILERS	B IH G AY L ER Z
BEGUILES	B IH G AY L Z
BEGUILING	B IH G AY L IH NG
BEGUILINGLY	B IH G AY L IH NG L IY
BEGUINE	B AH G UW N
BEGUINES	B AH G UW N Z
BEGULF	B IH G AH L F
BEGULFED	B IH G AH L F T
BEGULFING	B IH G AH L F IH NG
BEGULFS	B IH G AH L F S
BEGUM	B IH G AH M
BEGUMS	B IH G AH M Z
BEGUN	B IH G AH N
BEGUN(2)	B EY G AH N
BEHALF	B IH HH AE F
BEHALVES	B IH HH AE V Z
BEHAVE	B IH HH EY V
BEHAVED	B IH HH EY V D
BEHAVER	B IH HH EY V ER
BEHAVERS	B IH HH EY V ER Z
BEHAVES	B IH HH EY V Z
BEHAVING	B IH HH EY V IH NG
BEHAVIOR	B IH HH EY V Y ER
BEHAVIORAL	B IH HH EY V Y ER AH L
BEHAVIORAL(2)	B IY HH EY V Y ER AH L
BEHAVIORALLY	B IY HH EY V Y ER AH L IY
BEHAVIORISM	B IH HH EY V Y ER IH Z AH M
BEHAVIORISMS	B IH HH EY V Y ER IH Z AH M Z
BEHAVIORIST	B IH HH EY V Y ER IH S T
BEHAVIORISTIC	B IH HH EY V Y ER IH S T IH K
BEHAVIORISTS	B IH HH EY V Y ER IH S T S
BEHAVIORS	B IH HH EY V Y ER Z
BEHAVIOUR	B IH HH EY V Y ER
BEHAVIOURS	B IH HH EY V Y ER Z
BEHEAD	B IH HH EH D
BEHEAD(2)	B IY HH EH D
BEHEADED	B IH HH EH D IH D
BEHEADING	B IH HH EH D IH NG
BEHEADINGS	B IH HH EH D IH NG Z
BEHEADS	B IH HH EH D Z
BEHELD	B IY HH EH L D
BEHEMOTH	B AH HH IY M AH TH
BEHEMOTH(2)	B IY HH AH M AH TH
BEHEMOTHS	B IH HH IY M AH TH S
BEHEST	B IH HH EH S T
BEHESTS	B AH HH EH S T S
BEHIND	B IH HH AY N D
BEHINDHAND	B IH HH AY N D HH AE N D
BEHINDS	B IH HH AY N D Z
BEHOLD	B IH HH OW L D
BEHOLDEN	B IH HH OW L D AH N
BEHOLDER	B IY HH OW L D ER
BEHOLDERS	B IH HH OW L D ER Z
BEHOLDING	B IH HH OW L D IH NG
BEHOLDS	B IH HH OW L D Z
BEHOOF	B IH HH UW F
BEHOOVE	B IH HH UW V
BEHOOVED	B IH HH UW V D
BEHOOVES	B IH HH UW V Z
BEHOOVING	B IH HH UW V IH NG
BEHOVE	B IH HH OW V
BEHOVED	B IH HH OW V D
BEHOVES	B IH HH OW V Z
BEHOVING	B IH HH OW V IH NG
BEHOWL	B IH HH AW L
BEHOWLED	B IH HH AW L D
BEHOWLING	B IH HH AW L IH NG
BEHOWLS	B IH HH AW L Z
BEIGE	B EY ZH
BEIGES	B EY ZH AH Z
BEIGNET	B AH IH G N AH T
BEIGNETS	B AH IH G N AH T S
BEIGY	B EY ZH IY
BEING	B IY IH NG
BEINGS	B IY IH NG Z
BEJABERS	B IH JH AE B ER Z
BEJEEZUS	B AH JH IY Z AH S
BEJESUS	B IY JH AH Z AH S
BEJEWEL	B IH JH UW AH L
BEJEWELED	B IH JH UW AH L D
BEJEWELING	B IH JH UW AH L IH NG
BEJEWELLED	B IH JH UW AH L D
BEJEWELLING	B IH JH UW AH L IH NG
BEJEWELS	B IH JH UW AH L Z
BEJUMBLE	B IH JH AH M B AH L
BEJUMBLED	B IH JH AH M B AH L D
BEJUMBLES	B IH JH AH M B AH L Z
BEJUMBLING	B IH JH AH M B AH L IH NG
BEKISS	B IH K IH S
BEKISSED	B IH K IH S T
BEKISSES	B IH K IH S IH Z
BEKISSING	B IH K IH S IH NG
BEKNIGHT	B IH N AY T
BEKNIGHTED	B IH N AY T IH D
BEKNIGHTING	B IH N AY T IH NG
BEKNIGHTS	B IH N AY T S
BEKNOT	B IH N AA T
BEKNOTS	B IH N AA T S
BEKNOTTED	B IH N AA T IH D
BEKNOTTING	B IH N AA T IH NG
BEL	B EH L
BELABOR	B IH L EY B ER
BELABORED	B IH L EY B ER D
BELABORING	B IH L EY B ER IH NG
BELABORS	B IH L EY B ER Z
BELABOUR	B IH L EY B ER
BELABOURED	B IH L EY B ER D
BELABOURING	B IH L EY B ER IH NG
BELABOURS	B IH L EY B ER Z
BELACED	B IH L EY S T
BELADIED	B IH L EY D IY D
BELADIES	B IH L EY D IY Z
BELADY	B IH L EY D IY
BELADYING	B IH L EY D IY IH NG
BELATED	B IH L EY T IH D
BELATEDLY	B IH L EY T AH D L IY
BELATEDNESS	B IH L EY T AH D N AH S
BELATEDNESSES	B IH L EY T AH D N AH S IH Z
BELAUD	B IH L AO D
BELAUDED	B IH L AO D IH D
BELAUDING	B IH L AO D IH NG
BELAUDS	B IH L AO D Z
BELAY	B IH L EY
BELAYED	B IH L EY D
BELAYING	B IH L EY IH NG
BELAYS	B IH L EY Z
BELCH	B EH L CH
BELCHED	B EH L CH T
BELCHER	B EH L CH ER
BELCHERS	B EH L CH ER Z
BELCHES	B EH L CH IH Z
BELCHING	B EH L CH IH NG
BELDAM	B EH L D AE M
BELDAME	B EH L D EY M
BELDAMES	B EH L D EY M Z
BELDAMS	B EH L D AE M Z
BELEAGUER	B IH L IY G ER
BELEAGUERED	B IH L IY G ER D
BELEAGUERING	B IH L IY G ER IH NG
BELEAGUERMENT	B IH L IY G ER M AH N T
BELEAGUERMENTS	B IH L IY G ER M AH N T S
BELEAGUERS	B IH L IY G ER Z
BELEAP	B IH L IY P
BELEAPED	B IH L IY P T
BELEAPING	B IH L IY P IH NG
BELEAPS	B IH L IY P S
BELEAPT	B IH L EH P T
BELEMNITE	B AH L EH M N AY T
BELEMNITES	B AH L EH M N AY T S
BELFRIED	B EH L F R IY D
BELFRIES	B EH L F R IY Z
BELFRY	B EH L F R IY
BELGA	B IH L G AA
BELGAS	B EH L G AE S
BELIE	B IH L AY
BELIED	B IH L AY D
BELIEF	B IH L IY F
BELIEFS	B IH L IY F S
BELIER	B EH L Y ER
BELIERS	B IH L AY ER Z
BELIES	B IH L AY Z
BELIEVABILITIES	B AH L IY V AH B IH L AH T EH Z
BELIEVABILITY	B AH L IY V AH B IH L IH T IY
BELIEVABLE	B AH L IY V AH B AH L
BELIEVABLY	B AH L IY V AH B L IY
BELIEVE	B IH L IY V
BELIEVED	B IH L IY V D
BELIEVER	B IH L IY V ER
BELIEVERS	B IH L IY V ER Z
BELIEVES	B IH L IY V Z
BELIEVING	B IH L IY V IH NG
BELIKE	B IH L AY K
BELIQUOR	B IH L IH K ER
BELIQUORED	B IH L IH K ER D
BELIQUORING	B IH L IH K ER IH NG
BELIQUORS	B IH L IH K ER Z
BELITTLE	B IH L IH T AH L
BELITTLED	B IH L IH T AH L D
BELITTLEMENT	B IH L IH T AH L M AH N T
BELITTLEMENTS	B IH L IH T AH L M AH N T S
BELITTLER	B IH L IH T AH L ER
BELITTLERS	B IH L IH T AH L ER Z
BELITTLES	B IH L IH T AH L Z
BELITTLING	B IH L IH T AH L IH NG
BELITTLING(2)	B IH L IH T L IH NG
BELIVE	B IH L IH V
BELL	B EH L
BELLADONNA	B EH L AH D AA N AH
BELLADONNAS	B EH L AH D AA N AH Z
BELLBIRD	B EH L B ER D
BELLBIRDS	B EH L B ER D Z
BELLBOY	B EH L B OY
BELLBOYS	B EH L B OY Z
BELLE	B EH L
BELLED	B EH L D
BELLEEK	B IH L IY K
BELLEEKS	B IH L IY K S
BELLES	B EH L Z
BELLETRIST	B IH L EH T R AH S T
BELLETRISTIC	B IH L EH T R AH S T AH K
BELLETRISTS	B IH L EH T R AH S T S
BELLFLOWER	B EH L F L AW ER
BELLFLOWERS	B EH L F L AW ER Z
BELLHOP	B EH L HH AA P
BELLHOPS	B EH L HH AA P S
BELLICOSE	B EH L AH K OW S
BELLICOSELY	B IH L AH K OW Z L IY
BELLICOSITIES	B EH L IH K AA S AH T IY Z
BELLICOSITY	B EH L IH K AA S AH T IY
BELLIED	B EH L IY D
BELLIES	B EH L IY Z
BELLIGERENCE	B AH L IH JH ER AH N S
BELLIGERENCES	B AH L IH JH ER AH N S IH Z
BELLIGERENCIES	B AH L IH JH ER AH N S IY Z
BELLIGERENCY	B AH L IH JH ER AH N S IY
BELLIGERENT	B AH L IH JH ER AH N T
BELLIGERENTLY	B AH L IH JH ER AH N T L IY
BELLIGERENTS	B AH L IH JH ER AH N T S
BELLING	B EH L IH NG
BELLMAN	B EH L M AH N
BELLMEN	B EH L M EH N
BELLOW	B EH L OW
BELLOWED	B EH L OW D
BELLOWER	B EH L OW ER
BELLOWERS	B EH L OW ER Z
BELLOWING	B EH L OW IH NG
BELLOWS	B EH L OW Z
BELLPULL	B EH L P UH L
BELLPULLS	B EH L P UH L Z
BELLS	B EH L Z
BELLWETHER	B EH L W EH DH ER
BELLWETHERS	B EH L W EH DH ER Z
BELLWORT	B IH L W AH R T
BELLWORTS	B IH L W AH R T S
BELLY	B EH L IY
BELLYACHE	B EH L IY EY K
BELLYACHED	B EH L IY EY K T
BELLYACHER	B EH L IY EY K ER
BELLYACHERS	B EH L IY EY K ER Z
BELLYACHES	B EH L IY EY K S
BELLYACHING	B EH L IY EY K IH NG
BELLYBAND	B EH L IY B AE N D
BELLYBANDS	B EH L IY B AE N D Z
BELLYBUTTON	B EH L IY B AH T AH N
BELLYBUTTONS	B EH L IY B AH T AH N Z
BELLYFUL	B EH L IY F AH L
BELLYFULS	B EH L IY F AH L Z
BELLYING	B EH L IY IH NG
BELONG	B IH L AO NG
BELONGED	B IH L AO NG D
BELONGING	B IH L AO NG IH NG
BELONGINGNESS	B IH L AO NG IH NG N AH S
BELONGINGNESSES	B IH L AO NG IH NG N AH S IH Z
BELONGINGS	B IH L AO NG IH NG Z
BELONGS	B IH L AO NG Z
BELOVED	B IH L AH V D
BELOVED(2)	B IH L AH V AH D
BELOVEDS	B IH L AH V D Z
BELOW	B IH L OW
BELOW(2)	B IY L OW
BELOWDECKS	B IH L OW D EH K S
BELOWGROUND	B IH L OW G R AW N D
BELOWS	B IH L OW Z
BELS	B EH L Z
BELT	B EH L T
BELTED	B EH L T AH D
BELTED(2)	B EH L T IH D
BELTER	B EH L T ER
BELTERS	B EH L T ER Z
BELTING	B EH L T IH NG
BELTINGS	B EH L T IH NG Z
BELTLESS	B EH L T L AH S
BELTLINE	B EH L T L AY N
BELTLINES	B EH L T L AY N Z
BELTS	B EH L T S
BELTWAY	B EH L T W EY
BELTWAYS	B EH L T W EY Z
BELUGA	B IH L UW G AH
BELUGAS	B AH L UW G AH Z
BELVEDERE	B EH L V AH D IH R
BELVEDERE(2)	B EH L V IH D IH R
BELVEDERES	B EH L V AH D IH ER Z
BELYING	B IH L AY IH NG
BEMA	B AH M AA
BEMADAM	B IH M AE D AH M
BEMADAMED	B IH M AH D AE M D
BEMADAMING	B IH M AH D AE M IH NG
BEMADAMS	B IH M AE D AH M Z
BEMADDEN	B IH M AE D AH N
BEMADDENED	B IH M AE D AH N D
BEMADDENING	B IH M AE D AH N IH NG
BEMADDENS	B IH M AE D AH N Z
BEMAS	B AH M AE Z
BEMATA	B AH M AE T AH
BEMEAN	B IH M IY N
BEMEANED	B IH M IY N D
BEMEANING	B IH M IY N IH NG
BEMEANS	B IH M IY N Z
BEMEDALED	B IH M EH D AH L D
BEMEDALLED	B IH M EH D AH L D
BEMINGLE	B IH M IH NG G AH L
BEMINGLED	B IH M IH NG G AH L D
BEMINGLES	B IH M IH NG G AH L Z
BEMINGLING	B IH M IH NG G AH L IH NG
BEMIRE	B AH M AY R
BEMIRED	B AH M AY R D
BEMIRES	B AH M AY R Z
BEMIRING	B AH M AY R AH NG
BEMIST	B IH M IH S T
BEMISTED	B IH M IH S T EH D
BEMISTING	B IH M IH S T IH NG
BEMISTS	B IH M IH S T S
BEMIX	B IH M IH K S
BEMIXED	B IH M IH K S T
BEMIXES	B IH M IH K S IH Z
BEMIXING	B IH M IH K S IH NG
BEMIXT	B AH M IH K S T
BEMOAN	B IH M OW N
BEMOANED	B IH M OW N D
BEMOANING	B IH M OW N IH NG
BEMOANS	B IH M OW N Z
BEMOCK	B IH M AA K
BEMOCKED	B IH M AA K T
BEMOCKING	B IH M AA K IH NG
BEMOCKS	B IH M AA K S
BEMUDDLE	B IH M AH D AH L
BEMUDDLED	B IH M AH D AH L D
BEMUDDLES	B IH M AH D AH L Z
BEMUDDLING	B IH M AH D AH L IH NG
BEMURMUR	B IH M ER M ER
BEMURMURED	B IH M ER M ER D
BEMURMURING	B IH M ER M ER IH NG
BEMURMURS	B IH M ER M ER Z
BEMUSE	B IH M Y UW Z
BEMUSED	B IH M Y UW Z D
BEMUSEDLY	B IH M Y UW Z AH D L IY
BEMUSEMENT	B EH M Y UW S M AH N T
BEMUSEMENTS	B IH M Y UW Z M AH N T S
BEMUSES	B IH M Y UW Z IH Z
BEMUSING	B IH M Y UW Z IH NG
BEMUZZLE	B IH M AH Z AH L
BEMUZZLED	B IH M AH Z AH L D
BEMUZZLES	B IH M AH Z AH L Z
BEMUZZLING	B IH M AH Z AH L IH NG
BEN	B EH N
BENAME	B IH N EY M
BENAMED	B IH N EY M D
BENAMES	B IH N EY M Z
BENAMING	B IH N EY M IH NG
BENCH	B EH N CH
BENCHED	B EH N CH T
BENCHER	B EH N CH ER
BENCHERS	B EH N CH ER Z
BENCHES	B EH N CH IH Z
BENCHING	B EH N CH IH NG
BENCHLAND	B EH N CH L AE N D
BENCHLANDS	B EH N CH L AE N D Z
BENCHMARK	B EH N CH M AA R K
BENCHMARKING	B EH N CH M AA R K IH NG
BENCHMARKINGS	B EH N CH M AA R K IH NG Z
BENCHMARKS	B EH N CH M AA R K S
BENCHWARMER	B EH N CH W AO R M ER
BENCHWARMERS	B EH N CH W AO R M ER Z
BEND	B EH N D
BENDABLE	B EH N D AH B AH L
BENDAY	B IY AH N D EY
BENDAYED	B IY AH N D EY D
BENDAYING	B IY AH N D EY IH NG
BENDAYS	B IY AH N D EY Z
BENDED	B EH N D IH D
BENDEE	B EH N D IY
BENDEES	B EH N D IY Z
BENDER	B EH N D ER
BENDERS	B EH N D ER Z
BENDING	B EH N D IH NG
BENDS	B EH N D Z
BENDWAYS	B EH N D W EY Z
BENDWISE	B EH N D W AY Z
BENDY	B EH N D IY
BENDYS	B EH N D IY Z
BENE	B EH N AH
BENEATH	B IH N IY TH
BENEDICK	B EH N AH D IH K
BENEDICKS	B AH N EH D AH K S
BENEDICT	B EH N AH D IH K T
BENEDICTION	B EH N AH D IH K SH AH N
BENEDICTIONS	B EH N AH D IH K SH AH N Z
BENEDICTORY	B EH N AH D IH K T ER IY
BENEDICTS	B AH N EH D AH K T S
BENEFACTION	B AH N AH F AE K AH N
BENEFACTIONS	B AH N AH F AE K T IY AH N Z
BENEFACTOR	B EH N AH F AE K T ER
BENEFACTORS	B EH N AH F AE K T ER Z
BENEFACTRESS	B AH N AH F AE K T R AH S
BENEFACTRESSES	B AH N AH F AE K T R EH S AH Z
BENEFIC	B AH N IY F AH K
BENEFICE	B AH N IY F AH S
BENEFICED	B AH N IY F AH S T
BENEFICENCE	B AH N EH F AH S AH N S
BENEFICENCES	B AH N EH F AH S AH N S IH Z
BENEFICENT	B EH N AH F IH SH AH N T
BENEFICENTLY	B AH N EH F AH S EH N T L IY
BENEFICES	B AH N IY F AH S
BENEFICIAL	B EH N AH F IH SH AH L
BENEFICIALLY	B EH N AH F IH SH AH L IY
BENEFICIALNESS	B EH N AH F IH SH AH L N AH S
BENEFICIALNESSES	B EH N AH F IH SH AH L N AH S IH Z
BENEFICIARIES	B EH N AH F IH SH IY EH R IY Z
BENEFICIARY	B EH N AH F IH SH IY EH R IY
BENEFICIATE	B AH N AH F IH S AY EY T
BENEFICIATED	B AH N AH F IH S AY EY T AH D
BENEFICIATES	B AH N AH F IH S AY EY T S
BENEFICIATING	B AH N AH F IH S AY EY T AH NG
BENEFICIATION	B AH N AH F IH S AY EY SH AH N
BENEFICIATIONS	B AH N EH F AH S IY EY T IY AH N Z
BENEFICING	B AH N AH F IH S AH NG
BENEFIT	B EH N AH F IH T
BENEFITED	B EH N AH F IH T IH D
BENEFITER	B EH N AH F IH T ER
BENEFITERS	B EH N AH F IH T ER Z
BENEFITING	B EH N AH F IH T IH NG
BENEFITS	B EH N AH F IH T S
BENEFITTED	B EH N AH F IH T IH D
BENEFITTING	B EH N AH F IH T IH NG
BENEMPT	B AH N EH M P T
BENEMPTED	B AH N EH M P T AH D
BENES	B EH N IY S
BENEVOLENCE	B AH N EH V AH L AH N S
BENEVOLENCES	B AH N EH V AH L AH N S IH Z
BENEVOLENT	B AH N EH V AH L AH N T
BENEVOLENTLY	B AH N EH V AH L AH N T L IY
BENEVOLENTNESS	B AH N EH V AH L AH N T N AH S
BENEVOLENTNESSES	B AH N EH V AH L AH N T N AH S IH Z
BENGALINE	B IH N G AH L AY N
BENGALINES	B IH N G AH L AY N Z
BENIGHTED	B IH N AY T IH D
BENIGHTEDLY	B IH N AY T AH D L IY
BENIGHTEDNESS	B IH N AY T AH D N AH S
BENIGHTEDNESSES	B IH N AY T AH D N AH S IH Z
BENIGN	B IH N AY N
BENIGNANCIES	B IH N AY N AH N S IY Z
BENIGNANCY	B IH N AY N AH N S IY
BENIGNANT	B IH N AY N AH N T
BENIGNANTLY	B IH N AY N AH N T L IY
BENIGNITIES	B IH N AY N AH T IY Z
BENIGNITY	B IH N AY N AH T IY
BENIGNLY	B AH N AY N L IY
BENISON	B IY AH N IY Z AO N
BENISONS	B IY AH N IY Z AO N Z
BENJAMIN	B EH N JH AH M AH N
BENJAMINS	B EH N JH AH M AH N Z
BENNE	B EH N
BENNES	B EH N Z
BENNET	B EH N IH T
BENNETS	B IY AH N EH T S
BENNI	B IH N IY
BENNIES	B IY AH N IY Z
BENNIS	B EH N IH S
BENNY	B EH N IY
BENOMYL	B AH N AA M AH L
BENOMYLS	B AH N AA M AH L Z
BENS	B EH N Z
BENT	B EH N T
BENTHAL	B IY AH N TH AH L
BENTHIC	B IY AH N TH IH K
BENTHONIC	B IY AH N T HH OW N IH K
BENTHOS	B IY AH N TH AA S
BENTHOSES	B IY AH N T HH OW Z IH Z
BENTONITE	B EH N T AH N AY T
BENTONITES	B IH N T AH N AY T S
BENTONITIC	B IH N T AA N AH T AH K
BENTS	B IY AH N T S
BENTWOOD	B IY AH N T W UH D
BENTWOODS	B IY AH N T W UH D Z
BENUMB	B IH N AH M
BENUMBED	B IH N AH M D
BENUMBING	B IH N AH M IH NG
BENUMBS	B IH N AH M Z
BENZAL	B EH N Z AH L
BENZALDEHYDE	B IH N Z AE L D AH HH AY D
BENZALDEHYDES	B IH N Z AE L D AH HH AY D Z
BENZANTHRACENE	B IH N Z AE N TH R AH S IY N
BENZANTHRACENES	B IH N Z AE N TH R AH S IY N Z
BENZENE	B EH N Z IY N
BENZENES	B EH N Z IY N Z
BENZENOID	B IH N Z AH N OY D
BENZIDIN	B IH N Z IH D AH N
BENZIDINE	B IH N Z AH D AY N
BENZIDINES	B IH N Z AH D AY N Z
BENZIDINS	B IH N Z IH D AH N Z
BENZIMIDAZOLE	B IH N Z AH M IH D AH Z OW L
BENZIMIDAZOLES	B IH N Z AH M IH D AH Z OW L Z
BENZIN	B IH N Z IH N
BENZINE	B EH N Z IY N
BENZINES	B IH N Z AY N Z
BENZINS	B IH N Z IH N Z
BENZOAPYRENE	B IH N Z OW P AH R IY N
BENZOAPYRENES	B IH N Z OW P AH R IY N Z
BENZOATE	B IH N Z OW EY T
BENZOATES	B IH N Z OW EY T S
BENZOCAINE	B IH N Z AH K EY N
BENZOCAINES	B IH N Z AH K EY N Z
BENZODIAZEPINE	B EH N Z OW D IY AE Z AH P IY N
BENZODIAZEPINES	B IH N Z AH D IY AE Z AH P AY N Z
BENZOFURAN	B IH N Z AA F Y AH R AH N
BENZOFURANS	B IH N Z AA F Y AH R AH N Z
BENZOIC	B IH N Z OW AH K
BENZOIN	B IH N Z OY N
BENZOINS	B IH N Z OY N Z
BENZOL	B IH N Z AA L
BENZOLE	B IH N Z OW L
BENZOLES	B IH N Z OW L Z
BENZOLS	B IH N Z AA L Z
BENZOPHENONE	B IH N Z AA F AH N OW N
BENZOPHENONES	B IH N Z AA F AH N OW N Z
BENZOYL	B IH N Z OY L
BENZOYLS	B IH N Z OY L Z
BENZYL	B IH N Z IH L
BENZYLIC	B IH N Z AY L AH K
BENZYLS	B IH N Z IH L Z
BEPAINT	B IH P EY N T
BEPAINTED	B IH P EY N T IH D
BEPAINTING	B IH P EY N T IH NG
BEPAINTS	B IH P EY N T S
BEPIMPLE	B IH P IH M P AH L
BEPIMPLED	B IH P IH M P AH L D
BEPIMPLES	B IH P IH M P AH L Z
BEPIMPLING	B IH P IH M P L IH NG
BEQUEATH	B IH K W IY TH
BEQUEATHAL	B IH K W IY TH AH L
BEQUEATHALS	B IH K W IY TH AH L Z
BEQUEATHED	B AH K W IY TH T
BEQUEATHING	B IH K W IY TH IH NG
BEQUEATHS	B IH K W IY TH S
BEQUEST	B IH K W EH S T
BEQUESTS	B IH K W EH S T S
BERAKE	B IH R EY K
BERAKED	B IH R EY K T
BERAKES	B IH R EY K S
BERAKING	B IH R EY K IH NG
BERASCAL	B IH R AE S K AH L
BERASCALED	B IH R AE S K AH L D
BERASCALING	B IH R AE S K AH L IH NG
BERASCALS	B IH R AE S K AH L Z
BERATE	B IH R EY T
BERATED	B IH R EY T IH D
BERATES	B IH R EY T S
BERATING	B IH R EY T IH NG
BERBERIN	B IY ER B IY ER IH N
BERBERINE	B IH R B AH R AY N
BERBERINES	B IH R B AH R AY N Z
BERBERINS	B IY ER B IY ER IH N Z
BERBERIS	B IY ER B IY AH R IY Z
BERBERISES	B IY ER B IH R AY Z IH Z
BERCEUSE	B IH R S UW Z
BERCEUSES	B IH R S UW Z AH Z
BERDACHE	B IH R D AE CH
BERDACHES	B IH R D AE CH AH Z
BEREAVE	B ER IY V
BEREAVED	B ER IY V D
BEREAVEMENT	B ER IY V M AH N T
BEREAVEMENTS	B IH R IY V M AH N T S
BEREAVER	B IH R IY V ER
BEREAVERS	B IH R IY V ER Z
BEREAVES	B IH R IY V Z
BEREAVING	B IH R IY V IH NG
BEREFT	B ER EH F T
BERET	B EH R AH T
BERET(2)	B EH R EY T
BERETS	B EH R AH T S
BERETS(2)	B EH R EY Z
BERETTA	B ER EH T AH
BERETTAS	B ER EH T AH S
BERG	B ER G
BERGAMOT	B IH R G AE M AH T
BERGAMOTS	B IH R G AE M AH T S
BERGERE	B IH R JH IH R
BERGERES	B IH R JH IY R Z
BERGS	B ER G Z
BERHYME	B IH R AY M
BERHYMED	B IH R AY M D
BERHYMES	B IH R AY M Z
BERHYMING	B IH R AY M IH NG
BERIBBONED	B IH R IH B AH N D
BERIBERI	B EH R IY B EH R IY
BERIBERIS	B EH R IY B EH R IY Z
BERIME	B IH R AY M
BERIMED	B IH R AY M D
BERIMES	B IH R AY M Z
BERIMING	B IH R AY M IH NG
BERINGED	B IH R IH NG D
BERKELIUM	B IH R K IY L IY AH M
BERKELIUMS	B IH R K IY L IY AH M Z
BERLIN	B ER L IH N
BERLINE	B IY ER L AY N
BERLINES	B IY ER L AY N Z
BERLINS	B ER L IH N Z
BERM	B ER M
BERME	B IH R M IY
BERMES	B AH R M Z
BERMS	B ER M Z
BERMUDAS	B ER M Y UW D AH Z
BERNICLE	B IH R N IH K AH L
BERNICLES	B IH R N IH K AH L Z
BEROBED	B IH R OW B D
BEROUGED	B IH R UW ZH D
BERRETTA	B IH R EH T AH
BERRETTAS	B IH R EH T AH Z
BERRIED	B EH R IY D
BERRIES	B EH R IY Z
BERRY	B EH R IY
BERRYING	B EH R IY IH NG
BERRYLIKE	B EH R IY L AY K
BERSEEM	B IY ER S IY M
BERSEEMS	B IY ER S IY M Z
BERSERK	B ER S ER K
BERSERKER	B IH R S AH R K AH R
BERSERKERS	B IH R S AH R K AH R Z
BERSERKLY	B IH R S AH R K L IY
BERSERKS	B IH R S AH R K S
BERTH	B ER TH
BERTHA	B ER TH AH
BERTHAS	B ER TH AH Z
BERTHED	B ER TH T
BERTHING	B ER TH IH NG
BERTHS	B ER TH S
BERTHS(2)	B ER DH Z
BERYL	B EH R AH L
BERYLINE	B IY AH R IY L AY N
BERYLLIUM	B ER IH L IY AH M
BERYLLIUMS	B AH R IH L IY AH M Z
BERYLS	B EH R AH L Z
BESCORCH	B IH S K AO R CH
BESCORCHED	B IH S K AO R CH T
BESCORCHES	B IH S K AO R CH IH Z
BESCORCHING	B IH S K AO R CH IH NG
BESCOUR	B IH S K AW ER
BESCOURED	B IH S K AW ER D
BESCOURING	B IH S K AW ER IH NG
BESCOURS	B IH S K AW ER Z
BESCREEN	B IH S K R IY N
BESCREENED	B IH S K R IY N D
BESCREENING	B IH S K R IY N IH NG
BESCREENS	B IH S K R IY N Z
BESEECH	B IY S IY CH
BESEECHED	B IY S IY CH T
BESEECHES	B IH S IY CH IH Z
BESEECHING	B IY S IY CH IH NG
BESEECHINGLY	B IH S IY CH IH NG L IY
BESEEM	B IH S IY M
BESEEMED	B IH S IY M D
BESEEMING	B IH S IY M IH NG
BESEEMS	B IH S IY M Z
BESET	B IH S EH T
BESETMENT	B IH S EH T M AH N T
BESETMENTS	B IH S EH T M AH N T S
BESETS	B IH S EH T S
BESETTER	B IH S EH T ER
BESETTERS	B IH S EH T ER Z
BESETTING	B IH S EH T IH NG
BESHADOW	B IH SH AE D OW
BESHADOWED	B IH SH AE D OW D
BESHADOWING	B IH SH AE D OW IH NG
BESHADOWS	B IH SH AE D OW Z
BESHAME	B IH SH EY M
BESHAMED	B IH SH EY M D
BESHAMES	B IH SH EY M Z
BESHAMING	B IH SH EY M IH NG
BESHIVER	B IH SH IH V ER
BESHIVERED	B IH SH IH V ER D
BESHIVERING	B IH SH IH V ER IH NG
BESHIVERS	B IH SH IH V ER Z
BESHOUT	B IH SH AW T
BESHOUTED	B IH SH AW T IH D
BESHOUTING	B IH SH AW T IH NG
BESHOUTS	B IH SH AW T S
BESHREW	B IH SH R UW
BESHREWED	B IH SH R UW D
BESHREWING	B IH SH R UW IH NG
BESHREWS	B IH SH R UW Z
BESHROUD	B IH SH R AW D
BESHROUDED	B IH SH R AW D IH D
BESHROUDING	B IH SH R AW D IH NG
BESHROUDS	B IH SH R AW D Z
BESIDE	B IH S AY D
BESIDE(2)	B IY S AY D
BESIDES	B IH S AY D Z
BESIDES(2)	B IY S AY D Z
BESIEGE	B IH S IY JH
BESIEGED	B IH S IY JH D
BESIEGER	B IH S IY JH ER
BESIEGERS	B IH S IY JH ER Z
BESIEGES	B IH S IY JH IH Z
BESIEGING	B IH S IY JH IH NG
BESLAVED	B IH S L EY V D
BESLIME	B IH S L AY M
BESLIMED	B IH S L AY M D
BESLIMES	B IH S L AY M Z
BESLIMING	B IH S L AY M IH NG
BESMEAR	B IH S M IH ER
BESMEARED	B IH S M IH ER D
BESMEARING	B IH S M IH ER IH NG
BESMEARS	B IH S M IH ER Z
BESMILE	B IH S M AY L
BESMILED	B IH S M AY L D
BESMILES	B IH S M AY L Z
BESMILING	B IH S M AY L IH NG
BESMIRCH	B IH S M ER CH
BESMIRCHED	B IH S M ER CH T
BESMIRCHES	B IH S M ER CH IH Z
BESMIRCHING	B IH S M ER CH IH NG
BESMOKE	B IH S M OW K
BESMOKED	B IH S M OW K T
BESMOKES	B IH S M OW K S
BESMOKING	B IH S M OW K IH NG
BESMOOTH	B IH S M UW DH
BESMOOTHED	B IH S M UW DH D
BESMOOTHING	B IH S M UW DH IH NG
BESMOOTHS	B IH S M UW DH Z
BESMUDGE	B IH S M AH JH
BESMUDGED	B IH S M AH JH D
BESMUDGES	B IH S M AH JH IH Z
BESMUDGING	B IH S M AH JH IH NG
BESMUT	B IH S M AH T
BESMUTS	B EH Z M Y UW T S
BESMUTTED	B IH S M AH T AH D
BESMUTTING	B IH S M AH T AH NG
BESNOW	B IH S N OW
BESNOWED	B IH S N OW D
BESNOWING	B IH S N OW IH NG
BESNOWS	B IH S N OW Z
BESOM	B AH S AA M
BESOMS	B S AH M Z
BESOOTHE	B IH S UW DH
BESOOTHED	B IH S UW DH D
BESOOTHES	B IH S UW DH Z
BESOOTHING	B IH S UW DH IH NG
BESOT	B AH S AA T
BESOTS	B AH S AA T S
BESOTTED	B AH S AA T AH D
BESOTTING	B AH S AA T AH NG
BESOUGHT	B IH S AO T
BESPAKE	B IH S EY K
BESPATTER	B IH S P AE T ER
BESPATTERED	B IH S P AE T ER D
BESPATTERING	B IH S P AE T ER IH NG
BESPATTERS	B IH S P AE T ER Z
BESPEAK	B IH S P IY K
BESPEAKING	B IH S P IY K IH NG
BESPEAKS	B IH S P IY K S
BESPECTACLED	B IH S P EH K T AH K AH L D
BESPOKE	B IH S P OW K
BESPOKEN	B IH S P OW K AH N
BESPOUSE	B IH S P AW S
BESPOUSED	B IH S P AW S T
BESPOUSES	B IH S P AW S IH Z
BESPOUSING	B IH S P AW S IH NG
BESPREAD	B IH S P R EH D
BESPREADING	B IH S P R EH D IH NG
BESPREADS	B IH S P R EH D Z
BESPRENT	B EH S R AH N T
BESPRINKLE	B IH S P R IH NG K AH L
BESPRINKLED	B IH S P R IH NG K AH L D
BESPRINKLES	B IH S P R IH NG K AH L Z
BESPRINKLING	B IH S P R IH NG K AH L IH NG
BEST	B EH S T
BESTEAD	B IH S T EH D
BESTEADED	B IH S T EH D IH D
BESTEADING	B IH S T EH D IH NG
BESTEADS	B IH S T EH D Z
BESTED	B EH S T IH D
BESTIAL	B EH S CH AH L
BESTIALITIES	B EH S CH AH L AH T IY Z
BESTIALITY	B EH S CH AE L IH T IY
BESTIALIZE	B EH S CH AH L AY Z
BESTIALIZED	B EH S CH AH L AY Z D
BESTIALIZES	B EH S CH AH L AY Z IH Z
BESTIALIZING	B EH S CH AH L AY Z IH NG
BESTIALLY	B EH S CH AH L IY
BESTIARIES	B EH S T IY EH R IY Z
BESTIARY	B EH S T IY EH R IY
BESTING	B EH S T IH NG
BESTIR	B IH S T ER
BESTIRRED	B IH S T ER D
BESTIRRING	B IH S T ER IH NG
BESTIRS	B IH S T ER Z
BESTOW	B IH S T OW
BESTOWAL	B IH S T OW AH L
BESTOWALS	B IH S T OW AH L Z
BESTOWED	B IH S T OW D
BESTOWING	B IH S T OW IH NG
BESTOWS	B IH S T OW Z
BESTREW	B IH S T R UW
BESTREWED	B EH S T R IY W EH D
BESTREWING	B EH S T R IY W IH NG
BESTREWN	B IH S T R UW N
BESTREWS	B IH S T R UW Z
BESTRID	B EH S T R IH D
BESTRIDDEN	B EH S T R IH D AH N
BESTRIDE	B IH S T R AY D
BESTRIDES	B IH S T R AY D Z
BESTRIDING	B IH S T R AY D IH NG
BESTRODE	B IH S T R OW D
BESTROW	B EH S T R OW
BESTROWED	B EH S T R OW D
BESTROWING	B EH S T R OW IH NG
BESTROWN	B IH S T R OW N
BESTROWS	B EH S T R OW Z
BESTS	B EH S T S
BESTSELLER	B EH S T S EH L ER
BESTSELLER(2)	B EH S EH L ER
BESTSELLERDOM	B EH S T S EH L ER D AH M
BESTSELLERDOMS	B EH S T S EH L ER D AH M Z
BESTSELLERS	B EH S T S EH L ER Z
BESTSELLERS(2)	B EH S EH L ER Z
BESTUD	B IH S T AH D
BESTUDDED	B IH S T AH D IH D
BESTUDDING	B IH S T AH D IH NG
BESTUDS	B IH S T AH D Z
BESWARM	B IH S W AO R M
BESWARMED	B IH S W AO R M D
BESWARMING	B IH S W AO R M IH NG
BESWARMS	B IH S W AO R M Z
BET	B EH T
BETA	B EY T AH
BETAINE	B AH T EY N
BETAINES	B AH T EY N Z
BETAKE	B IY T EY K
BETAKEN	B IH T EY K AH N
BETAKES	B IH T EY K S
BETAKING	B IH T EY K IH NG
BETAS	B EY T AH Z
BETATRON	B AH T AE T R AH N
BETATRONS	B AH T AE T R AH N Z
BETATTER	B IH T AE T ER
BETATTERED	B IH T AE T ER D
BETATTERING	B IH T AE T ER IH NG
BETATTERS	B IH T AE T ER Z
BETAXED	B IH T AE K S T
BETEL	B EH T AH L
BETELNUT	B AH T EH L N AH T
BETELNUTS	B AH T EH L N Y UW T S
BETELS	B AH T EH L Z
BETH	B EH TH
BETHANK	B IH TH AE NG K
BETHANKED	B IH TH AE NG K T
BETHANKING	B IH TH AE NG K IH NG
BETHANKS	B IH TH AE NG K S
BETHEL	B EH TH AH L
BETHEL(2)	B EH TH EH L
BETHELS	B EH TH AH L Z
BETHESDA	B AH TH EH Z D AH
BETHESDAS	B AH TH EH Z D AH Z
BETHINK	B IH TH IH NG K
BETHINKING	B IH TH IH NG K IH NG
BETHINKS	B IH TH IH NG K S
BETHORN	B IH TH AO R N
BETHORNED	B IH TH AO R N D
BETHORNING	B IH TH AO R N IH NG
BETHORNS	B IH TH AO R N Z
BETHOUGHT	B IH TH AO T
BETHS	B IY IH TH S
BETHUMP	B IH TH AH M P
BETHUMPED	B IH TH AH M P T
BETHUMPING	B IH TH AH M P IH NG
BETHUMPS	B IH TH AH M P S
BETIDE	B IH T AY D
BETIDED	B IH T AY D IH D
BETIDES	B IH T AY D Z
BETIDING	B IH T AY D IH NG
BETIME	B IH T AY M
BETIMES	B IH T AY M Z
BETISE	B AH T AY Z
BETISES	B EH T IY Z IH Z
BETOKEN	B IH T OW K AH N
BETOKENED	B IH T OW K AH N D
BETOKENING	B IH T OW K AH N IH NG
BETOKENS	B IH T OW K AH N Z
BETON	B IH T AH N
BETONIES	B IH T OW N IY Z
BETONS	B IH T AH N Z
BETONY	B IH T OW N IY
BETOOK	B IH T UH K
BETRAY	B IH T R EY
BETRAYAL	B IH T R EY AH L
BETRAYALS	B IH T R EY AH L Z
BETRAYED	B IH T R EY D
BETRAYER	B IH T R EY ER
BETRAYERS	B IH T R EY ER Z
BETRAYING	B IH T R EY IH NG
BETRAYS	B IH T R EY Z
BETROTH	B IH T R AO TH
BETROTHAL	B IH T R AO TH AH L
BETROTHALS	B IH T R AO TH AH L Z
BETROTHED	B IH T R AO TH T
BETROTHEDS	B IH T R AO TH T S
BETROTHING	B IH T R AO TH IH NG
BETROTHS	B IH T R AO TH S
BETS	B EH T S
BETTA	B EH T AH
BETTAS	B IH T AE Z
BETTED	B EH T IH D
BETTER	B EH T ER
BETTERED	B EH T ER D
BETTERING	B EH T ER IH NG
BETTERMENT	B EH T ER M AH N T
BETTERMENTS	B EH T ER M AH N T S
BETTERS	B EH T ER Z
BETTING	B EH T IH NG
BETTOR	B EH T ER
BETTORS	B EH T ER Z
BETWEEN	B IH T W IY N
BETWEEN(2)	B IY T W IY N
BETWEENBRAIN	B IH T W IY N B R EY N
BETWEENBRAINS	B IH T W IY N B R EY N Z
BETWEENNESS	B IH T W IY N AH S
BETWEENNESSES	B IH T W IY N EH S AH Z
BETWEENTIMES	B IH T W IY N T AY M Z
BETWEENWHILES	B IH T W IY N W AH L Z
BETWIXT	B IY T W IH K S T
BEUNCLED	B IH AH NG K AH L D
BEVATRON	B AH V AE T R AH N
BEVATRONS	B AH V AE T R AH N Z
BEVEL	B EH V AH L
BEVELED	B EH V AH L D
BEVELER	B EH V AH L ER
BEVELERS	B EH V AH L ER Z
BEVELING	B EH V AH L IH NG
BEVELLED	B EH V AH L D
BEVELLER	B EH V AH L ER
BEVELLERS	B EH V AH L ER Z
BEVELLING	B EH V AH L IH NG
BEVELS	B EH V AH L Z
BEVERAGE	B EH V ER IH JH
BEVERAGE(2)	B EH V R IH JH
BEVERAGES	B EH V R IH JH IH Z
BEVIES	B EH V IY Z
BEVOMIT	B IH V AA M AH T
BEVOMITED	B IH V AA M AH T IH D
BEVOMITING	B IH V AA M AH T IH NG
BEVOMITS	B IH V AA M AH T S
BEVOR	B IY V AH R
BEVORS	B AH V AO R Z
BEVY	B EH V IY
BEWAIL	B IH W EY L
BEWAILED	B IH W EY L D
BEWAILER	B IH W EY L ER
BEWAILERS	B IH W EY L ER Z
BEWAILING	B IH W EY L IH NG
BEWAILS	B IH W EY L Z
BEWARE	B IH W EH R
BEWARED	B IH W EH R D
BEWARES	B IH W EH R Z
BEWARING	B IH W EH R IH NG
BEWEARIED	B IH W IH R IY D
BEWEARIES	B IH W IH R IY Z
BEWEARY	B IH W IH R IY
BEWEARYING	B IH W IH R IY IH NG
BEWEEP	B IH W IY P
BEWEEPING	B IH W IY P IH NG
BEWEEPS	B IH W IY P S
BEWEPT	B IH W EH P T
BEWHISKERED	B IH W IH S K ER D
BEWIG	B IH W IH G
BEWIGGED	B IH W IH G D
BEWIGGING	B IH W IH G IH NG
BEWIGS	B IH W IH G Z
BEWILDER	B IH W IH L D ER
BEWILDERED	B IH W IH L D ER D
BEWILDEREDLY	B IH W IH L D ER AH D L IY
BEWILDEREDNESS	B IH W IH L D ER AH D N AH S
BEWILDEREDNESSES	B IH W IH L D ER AH D N AH S IH Z
BEWILDERING	B IH W IH L D ER IH NG
BEWILDERINGLY	B IH W IH L D ER IH NG L IY
BEWILDERMENT	B IH W IH L D ER M AH N T
BEWILDERMENTS	B IH W IH L D ER M AH N T S
BEWILDERS	B IH W IH L D ER Z
BEWINGED	B IH W IH NG D
BEWITCH	B IH W IH CH
BEWITCHED	B IH W IH CH T
BEWITCHERIES	B IH W IH CH AH R IY Z
BEWITCHERY	B IH W IH CH AH R IY
BEWITCHES	B IH W IH CH IH Z
BEWITCHING	B IH W IH CH IH NG
BEWITCHINGLY	B IH W IH CH IH NG L IY
BEWITCHMENT	B IH W IH CH M AH N T
BEWITCHMENTS	B IH W IH CH M AH N T S
BEWORM	B IH W ER M
BEWORMED	B IH W ER M D
BEWORMING	B IH W ER M IH NG
BEWORMS	B IH W ER M Z
BEWORRIED	B IH W ER IY D
BEWORRIES	B IH W ER IY Z
BEWORRY	B IH W ER IY
BEWORRYING	B IH W ER IY IH NG
BEWRAP	B IH R AE P
BEWRAPPED	B IH R AE P T
BEWRAPPING	B IH R AE P IH NG
BEWRAPS	B IH R AE P S
BEWRAPT	B AH R AE P T
BEWRAY	B AH R EY IY
BEWRAYED	B AH R EY D
BEWRAYER	B AH R EY AH R
BEWRAYERS	B AH R EY AH R Z
BEWRAYING	B AH R EY AH NG
BEWRAYS	B AH R EY Z
BEY	B EY
BEYLIC	B IH Y L AH K
BEYLICS	B IH Y L IH S Z
BEYLIK	B IH Y L IH K
BEYLIKS	B IH Y L AY K S
BEYOND	B IH AA N D
BEYOND(2)	B IY AO N D
BEYOND(3)	B IH AO N D
BEYONDS	B IY AA N D Z
BEYS	B IY IY Z
BEZANT	B IY Z AH N T
BEZANTS	B AH Z AE N T S
BEZAZZ	B AH Z AE Z
BEZAZZES	B AH Z AE Z AH Z
BEZEL	B AH Z EH L
BEZELS	B AH Z EH L Z
BEZIL	B AH Z IH L
BEZILS	B IY Z AH L Z
BEZIQUE	B AH Z IH K
BEZIQUES	B AH Z IH K S
BEZOAR	B AH Z OW AH R
BEZOARS	B AH Z OW R Z
BEZZANT	B EH Z AH N T
BEZZANTS	B IH Z AE N T S
BIBBED	B IH B D
BIBBER	B IH B ER
BIBBERIES	B IH B AH R IY Z
BIBBERS	B IH B ER Z
BIBBERY	B IH B AH R IY
BIBELOT	B AY B IH L AA T
BIBELOTS	B AY B IH L AA T S
BILBERRIES	B AY L B EH R AY Z
BILBERRY	B AY L B EH R IY
BILOBED	B AY L OW B D
BLABBED	B L AE B D
BLABBER	B L AE B ER
BLABBERED	B L AE B ER D
BLABBERING	B L AE B ER IH NG
BLABBERMOUTH	B L AE B ER M AW TH
BLABBERMOUTHS	B L AE B ER M AW TH S
BLABBERS	B L AE B ER Z
BLACKBERRIES	B L AE K B EH R IY Z
BLACKBERRY	B L AE K B EH R IY
BLAEBERRIES	B L IY B EH R AY Z
BLAEBERRY	B L IY B EH R IY
BLOBBED	B L AA B D
BLOWTUBE	B L OW T UW B
BLOWTUBES	B L OW T UW B Z
BLUBBED	B L AH B D
BLUBBER	B L AH B ER
BLUBBERED	B L AH B ER D
BLUBBERING	B L AH B ER IH NG
BLUBBERS	B L AH B ER Z
BLUBBERY	B L AH B ER IY
BLUEBEARD	B L UW B IY R D
BLUEBEARDS	B L UW B IH ER D Z
BLUEBELL	B L UW B EH L
BLUEBELLS	B L UW B EH L Z
BLUEBERRIES	B L UW B EH R IY Z
BLUEBERRY	B L UW B EH R IY
BLURBED	B L ER B EH D
BOBBED	B AA B D
BOBBER	B AA B ER
BOBBERIES	B AA B AH R IY Z
BOBBERS	B AA B ER Z
BOBBERY	B AA B AH R IY
BOBECHE	B AA B AH CH
BOBECHES	B AA B AH CH AH Z
BOGBEAN	B AO G B IY N
BOGBEANS	B AO G B IY N Z
BOMBE	B AA M
BOMBED	B AA M D
BOMBER	B AA M ER
BOMBERS	B AA M ER Z
BOMBES	B AA M Z
BOMBESIN	B AA M B AH S AH N
BOMBESINS	B AA M B AH S AH N Z
BONNYCLABBER	B AA N IH K L AE B AH R
BONNYCLABBERS	B AA N AH K L AE B AH R Z
BOOBED	B UW B EH D
BOXBERRIES	B AA K S B EH R IY Z
BOXBERRY	B AA K S B EH R IY
BOYSENBERRIES	B OY S EH N B EH R IY Z
BOYSENBERRY	B OY S EH N B EH R IY
BRIBE	B R AY B
BRIBED	B R AY B D
BRIBEE	B R AY B IY
BRIBEES	B R AY B IY Z
BRIBER	B R AY B ER
BRIBERIES	B R AY B AH R IY Z
BRIBERS	B R AY B ER Z
BRIBERY	B R AY B ER IY
BRIBES	B R AY B Z
BROWBEAT	B R AW B IY T
BROWBEATEN	B R AW B IY T AH N
BROWBEATING	B R AW B IY T IH NG
BROWBEATS	B R AW B IY T S
BUCKBEAN	B AH K B IY N
BUCKBEANS	B AH K B IY N Z
BUFFALOBERRIES	B AH F AH L OW B EH R IY Z
BUFFALOBERRY	B AH F AH L OW B EH R IY
BUGBEAR	B AH G B AE ER
BUGBEARS	B AH G B AE ER Z
BULBED	B AH L B D
BULBEL	B UH L B AH L
BULBELS	B UH L B AH L Z
BUMBERSHOOT	B AH M B IY ER SH UW T
BUMBERSHOOTS	B AH M B IY ER SH UW T S
BUMBLEBEE	B AH M B AH L B IY
BUMBLEBEES	B AH M B AH L B IY Z
BUNCHBERRIES	B AH N CH B EH R IY Z
BUNCHBERRY	B AH N CH B EH R IY
BUNCOMBE	B AH N K OW M
BUNCOMBES	B AH N K OW M Z
CABBED	K AE B D
CABER	K AE B ER
CABERNET	K AE B ER N EY
CABERNETS	K AE B ER N EH T S
CABERNETS(2)	K AE B ER N EY Z
CABERS	K AE B ER Z
CABESTRO	K AH B EH S T R OW
CABESTROS	K AH B EH S T R AH Z
CABEZON	K AE B AH Z AH N
CABEZONE	K AE B AH Z OW N
CABEZONES	K AE B AH Z OW N Z
CABEZONS	K AE B AH Z AH N Z
CALIBER	K AE L AH B ER
CALIBERS	K AE L AH B ER Z
CAMBER	K AE M B ER
CAMBERED	K AE M B IY ER D
CAMBERING	K AE M B IY ER IH NG
CAMBERS	K AE M B IY ER Z
CANDLEBERRIES	K AE N D AH L B EH R IY Z
CANDLEBERRY	K AE N D AH L B EH R IY
CARIBE	K AA R IY B
CARIBES	K AH R AY B Z
CASCABEL	K AE S AH B AH L
CASCABELS	K AE S AH B AH L Z
CASEBEARER	K EY S B AE ER ER
CASEBEARERS	K EY S B AE ER ER Z
CEREBELLA	S EH R AH B EH L AH
CEREBELLAR	S EH R AH B EH L AH R
CEREBELLUM	S EH R AH B EH L AH M
CEREBELLUMS	S EH R AH B EH L AH M Z
CHALYBEATE	CH AH L AY B IY EY T
CHALYBEATES	CH AH L AY B IY EY T S
CHAMBER	CH EY M B ER
CHAMBERED	CH EY M B ER D
CHAMBERING	CH EY M B ER IH NG
CHAMBERLAIN	CH EY M B ER L AH N
CHAMBERLAIN(2)	CH EY M B ER L IH N
CHAMBERLAINS	CH EY M B ER L AH N Z
CHAMBERMAID	CH EY M B ER M EY D
CHAMBERMAIDS	CH EY M B ER M EY D Z
CHAMBERS	CH EY M B ER Z
CHEBEC	CH EH B AH K
CHEBECS	CH EH B AH K S
CHECKERBERRIES	CH EH K ER B EH R IY Z
CHECKERBERRY	CH EH K ER B EH R IY
CHEMISORBED	SH AH M IY Z ER B EH D
CHIFFOROBE	CH IH F AH R OW B
CHIFFOROBES	CH IH F AH R OW B Z
CHILDBEARING	CH AY L D B EH R IH NG
CHILDBEARINGS	CH AY L D B AE ER IH NG Z
CHILDBED	CH AY L D B EH D
CHILDBEDS	CH AY L D B EH D Z
CHINABERRIES	CH AY N AH B EH R IY Z
CHINABERRY	CH AY N AH B EH R IY
CHLOROBENZENE	K L AH R AA B AH N Z IY N
CHLOROBENZENES	K L AH R AA B AH N Z IY N Z
CHOKEBERRIES	CH OW K B EH R IY Z
CHOKEBERRY	CH OW K B EH R IY
CHROMOPHOBE	K R AA M AH F OW B
CHRYSOBERYL	K R AH S AA B AH R AH L
CHRYSOBERYLS	K R AH S AA B AH R AH L Z
CICISBEI	S AH S IH Z IY
CICISBEISM	S AH S IH Z IY IH Z AH M
CICISBEISMS	S IH S AH Z IY Z AH M Z
CICISBEO	S AH S IH Z IY OW
CICISBEOS	S AH S IH Z IY AH Z
CIRCUMSCRIBE	S ER K AH M S K R AY B
CIRCUMSCRIBED	S ER K AH M S K R AY B D
CIRCUMSCRIBES	S ER K AH M S K R AY B Z
CLABBER	K L AE B AH R
CLABBERED	K L AE B IY R D
CLABBERING	K L AE B IY R AH NG
CLABBERS	K L AE B AH R Z
CLAMBER	K L AE M B ER
CLAMBERED	K L AE M B ER D
CLAMBERER	K L AE M B ER ER
CLAMBERERS	K L AE M B ER ER Z
CLAMBERING	K L AE M B ER IH NG
CLAMBERS	K L AE M B ER Z
CLAUSTROPHOBE	K L AO S T R AH F OW B
CLAUSTROPHOBES	K L AO S T R AH F OW B Z
CLIMBED	K L AY M D
CLIMBER	K L AY M ER
CLIMBERS	K L AY M ER Z
CLOBBER	K L AA B ER
CLOBBERED	K L AA B ER D
CLOBBERING	K L AA B ER IH NG
CLOBBERS	K L AA B ER Z
CLOUDBERRIES	K L AW D B EH R IY Z
CLOUDBERRY	K L AW D B EH R IY
CLUBBED	K L AH B D
CLUBBER	K L AH B ER
CLUBBERS	K L AH B ER Z
CLUMBER	K L AH M AH R
CLUMBERS	K L AH M B AH R Z
COBBER	K AA B AH R
COBBERS	K AA B EH R Z
COBELLIGERENT	K OW B AH L IH JH ER AH N T
COBELLIGERENTS	K OW B AH L IH JH ER AH N T S
COBWEBBED	K AA B W EH B D
COMBE	K OW M
COMBED	K OW M D
COMBER	K OW M ER
COMBERS	K OW M ER Z
COMBES	K OW M Z
COMEMBER	K OW M EH M B ER
COMEMBERS	K OW M EH M B ER Z
COMPUTERPHOBE	K AA M P Y UW T AH R F OW B
COMPUTERPHOBES	K AA M P Y UW T AH R F OW B Z
CONFABBED	K AA N F AE B D
CONGLOBE	K AH N G L OW B
CONGLOBED	K AH N G L OW B D
CONGLOBES	K AH N G L OW B Z
CONSCRIBE	K AH N S K R AY B
CONSCRIBED	K AH N S K R AY B D
CONSCRIBES	K AH N S K R AY B Z
COOMBE	K UW M B
COOMBE(2)	K UW M
COOMBES	K UW M B Z
COOMBES(2)	K UW M Z
CORALBELLS	K AO R AH L B EH L Z
CORALBERRIES	K AO R AH L B EH R IY Z
CORALBERRY	K AO R AH L B EH R IY
CORBEIL	K AO R B AY L
CORBEILLE	K AA R B IY L
CORBEILLES	K AA R B IY L Z
CORBEILS	K AA R B IY AH L Z
CORBEL	K AO R B AH L
CORBELED	K AA R B IY L D
CORBELING	K AA R B IY L AH NG
CORBELINGS	K AA R B EH L AH NG Z
CORBELLED	K AO R B AH L D
CORBELLING	K AA R B EH L AH NG
CORBELS	K AA R B EH L Z
CORYMBED	K OW R IH M D
COWBELL	K AW B EH L
COWBELLS	K AW B EH L Z
COWBERRIES	K AW B EH R IY Z
COWBERRY	K AW B EH R IY
CRABBED	K R AE B D
CRABBEDNESS	K R AE B AH D N AH S
CRABBEDNESSES	K R AE B AH D N AH S IH Z
CRABBER	K R AE B ER
CRABBERS	K R AE B ER Z
CRAMBE	K R AE M B IY
CRAMBES	K R AE M B IY Z
CRANBERRIES	K R AE N B EH R IY Z
CRANBERRY	K R AE N B EH R IY
CRIBBED	K R IH B D
CRIBBER	K R IH B ER
CRIBBERS	K R IH B ER Z
CROSSBEAM	K R AO S B IY M
CROSSBEAMS	K R AO S B IY M Z
CROSSBEARER	K R AO S B AE ER ER
CROSSBEARERS	K R AO S B AE ER ER Z
CROWBERRIES	K R OW B EH R IY Z
CROWBERRY	K R OW B EH R IY
CRUMBED	K R AH M D
CRUMBER	K R AH M ER
CRUMBERS	K R AH M ER Z
CRYOPROBE	K R AY AH P R OW B
CRYOPROBES	K R AY AH P R OW B Z
CUBE	K Y UW B
CUBEB	K Y UW B AH B
CUBEBS	K Y UW B AH B Z
CUBED	K Y UW B D
CUBER	K Y UW B ER
CUBERS	K Y UW B ER Z
CUBES	K Y UW B Z
CUCUMBER	K Y UW K AH M B ER
CUCUMBERS	K Y UW K AH M B ER Z
CUDBEAR	K AH D B AE ER
CUDBEARS	K AH D B AE ER Z
CUMBER	K AH M B ER
CUMBERBUND	K AH M B AH R B AH N D
CUMBERBUNDS	K AH M B AH R B AH N D Z
CUMBERED	K AH M B ER D
CUMBERER	K AH M B ER ER
CUMBERERS	K AH M B ER ER Z
CUMBERING	K AH M B ER IH NG
CUMBERS	K AH M B ER Z
CUMBERSOME	K AH M B ER S AH M
CUMBERSOMELY	K AH M B ER S AH M L IY
CUMBERSOMENESS	K AH M B ER S AH M N AH S
CUMBERSOMENESSES	K AH M B ER S AH M N AH S IH Z
CUPBEARER	K AH P B AE ER ER
CUPBEARERS	K AH P B AE ER ER Z
CURBED	K ER B D
CURBER	K ER B ER
CURBERS	K ER B ER Z
CURRYCOMBED	K ER IY K OW M D
CYBERNATED	S IH B AH R N EY T AH D
CYBERNATION	S IH B AH R N EY SH AH N
CYBERNATIONS	S IH B AH R N EY T IY AH N Z
CYBERNETIC	S AH B AH R N AH T AH K
CYBERNETICAL	S AH B AH R N AH T IH S AH L
CYBERNETICALLY	S AH B AH R N EH T AH K AE L IY
CYBERNETICIAN	S AH B AH R N AH T IH S IY AH N
CYBERNETICIANS	S AH B AH R N AH T IH S IY AH N Z
CYBERNETICIST	S AH B AH R N AH T IH S AH S T
CYBERNETICISTS	S IH B AH R N EH T AH S AH S T S
CYBERNETICS	S AH B AH R N AH T AH S Z
CYBERPUNK	S AH B AH R P AH NG K
CYBERPUNKS	S AH B AH R P AH NG K S
CYBERSPACE	S AY B ER S P EY S
CYBERSPACES	S AH B AH R S AH S AH Z
DABBED	D AE B D
DABBER	D AE B ER
DABBERS	D AE B ER Z
DAHABEAH	D AH HH EY B IY AH
DAHABEAHS	D AE HH AH B IY Z
DAUBE	D AO B
DAUBED	D AO B D
DAUBER	D AW B ER
DAUBERIES	D AO B AH R IY Z
DAUBERS	D AO B ER Z
DAUBERY	D AO B AH R IY
DAUBES	D AO B Z
DAYBED	D EY B EH D
DAYBEDS	D EY B EH D Z
DEADBEAT	D EH D B IY T
DEADBEATS	D EH D B IY T S
DEATHBED	D EH TH B EH D
DEATHBEDS	D EH TH B EH D Z
DEBEAK	D IH B AH AE K
DEBEAKED	D IH B AH EY K T
DEBEAKING	D IY B IH AH K IH NG
DEBEAKS	D IH B AH AE K S
DEBENTURE	D AH B EH N CH ER
DEBENTURES	D AH B EH N CH ER Z
DECIBEL	D EH S AH B EH L
DECIBELS	D EH S AH B AH L Z
DECUMBENT	D AH K AH M B AH N T
DEERBERRIES	D IH ER B EH R IY Z
DEERBERRY	D IH ER B EH R IY
DELIBERATE	D IH L IH B ER AH T
DELIBERATE(2)	D IH L IH B ER EY T
DELIBERATE(3)	D IH L IH B R AH T
DELIBERATED	D IH L IH B ER EY T IH D
DELIBERATELY	D IH L IH B ER AH T L IY
DELIBERATELY(2)	D IH L IH B R AH T L IY
DELIBERATENESS	D IH L IH B AH R AH T N AH S
DELIBERATENESSES	D IH L IH B AH R AH T N AH S IH Z
DELIBERATES	D IH L IH B ER EY T S
DELIBERATES(2)	D IH L IH B R EY T S
DELIBERATING	D IH L IH B ER EY T IH NG
DELIBERATION	D IH L IH B ER EY SH AH N
DELIBERATIONS	D IH L IH B ER EY SH AH N Z
DELIBERATIVE	D IH L IH B ER EY T IH V
DELIBERATIVE(2)	D IH L IH B R AH T IH V
DELIBERATIVELY	D IH L IH B AH R AH T IH V L IY
DELIBERATIVENESS	D IH L IH B AH R AH T IH V N AH S
DELIBERATIVENESSES	D IH L IH B AH R AH T IH V N AH S IH Z
DEMOBBED	D IY M AA B D
DESCRIBE	D IH S K R AY B
DESCRIBED	D IH S K R AY B D
DESCRIBER	D IY S K R AY B ER
DESCRIBERS	D IY S K R AY B ER Z
DESCRIBES	D IH S K R AY B Z
DESORBED	D IY S AO R B D
DEWBERRIES	D UW B EH R IY Z
DEWBERRY	D UW B EH R IY
DIABETES	D AY AH B IY T IY Z
DIABETIC	D AY AH B EH T IH K
DIABETICS	D AY AH B EH T IH K S
DIABETOGENIC	D AY AH B EH T AH JH AH N AH K
DIABETOLOGIST	D AY AH B AH T AA L AH JH AH S T
DIABETOLOGISTS	D AY AH B AH T AA L AH JH AH S T S
DIATRIBE	D AY AH T R AY B
DIATRIBES	D AY AH T R AY B Z
DIBBED	D IH B D
DIBBER	D IH B AH R
DIBBERS	D IH B AH R Z
DIBENZOFURAN	D AH B EH N Z AA F Y AH R AH N
DIBENZOFURANS	D IH B AH N Z AA F Y AH R AH N Z
DICHLOROBENZENE	D IH K L AH R AA B AH N Z IY N
DICHLOROBENZENES	D IH K L AH R AA B AH N Z IY N Z
DIETHYLSTILBESTROL	D AY EH TH AH L S T IH L D EH S T R AO L
DIETHYLSTILBESTROLS	D AY EH TH AH L S T IH L D EH S T R AO L Z
DINGLEBERRIES	D IH N G L AH B EH R AY Z
DINGLEBERRY	D IH N G L AH B EH R IY
DINITROBENZENE	D AH N IH T R AA B AH N Z IY N
DINITROBENZENES	D AH N IH T R AA B AH N Z IY N Z
DISBELIEF	D IH S B IH L IY F
DISBELIEFS	D IH S B AH L IY F S
DISBELIEVE	D IH S B IH L IY V
DISBELIEVED	D IH S B AH L IY V D
DISBELIEVER	D IH S B AH L IY V ER
DISBELIEVERS	D IH S B AH L IY V ER Z
DISBELIEVES	D IH S B AH L IY V Z
DISBELIEVING	D IH S B IH L IY V IH NG
DISBENEFIT	D IH S B EH N AH F IH T
DISBENEFITS	D IH S B EH N AH F IH T S
DISENCUMBER	D IH S EH N K AH M B ER
DISENCUMBERED	D IH S EH N K AH M B ER D
DISENCUMBERING	D IH S EH N K AH M B ER IH NG
DISENCUMBERS	D IH S EH N K AH M B ER Z
DISMEMBER	D IH S M EH M B ER
DISMEMBERED	D IH S M EH M B ER D
DISMEMBERING	D IH S M EH M B ER IH NG
DISMEMBERMENT	D IH S M EH M B ER M AH N T
DISMEMBERMENTS	D IH S M EH M B ER M AH N T S
DISMEMBERS	D IH S M EH M B ER Z
DISOBEDIENCE	D IH S AH B IY D IY AH N S
DISOBEDIENCE(2)	D IH S OW B IY D IY AH N S
DISOBEDIENCES	D IH S OW B IY D IY AH N S IH Z
DISOBEDIENT	D IH S AH B IY D IY AH N T
DISOBEDIENT(2)	D IH S OW B IY D IY AH N T
DISOBEDIENTLY	D IH S OW B IY D IY AH N T L IY
DISOBEY	D IH S AH B EY
DISOBEYED	D IH S OW B EY D
DISOBEYER	D IH S OW B EY ER
DISOBEYERS	D IH S OW B EY ER Z
DISOBEYING	D IH S OW B EY IH NG
DISOBEYS	D IH S OW B EY Z
DISREMEMBER	D IH S R IH M EH M B ER
DISREMEMBERED	D IH S R IH M EH M B ER D
DISREMEMBERING	D IH S R IH M EH M B ER IH NG
DISREMEMBERS	D IH S R IH M EH M B ER Z
DISROBE	D IH S R OW B
DISROBED	D IH S R OW B D
DISROBER	D IH S R OW B ER
DISROBERS	D IH S R OW B ER Z
DISROBES	D IH S R OW B Z
DISTURBED	D IH S T ER B D
DISTURBER	D IH S T ER B ER
DISTURBERS	D IH S T ER B ER Z
DIVEBOMBED	D AY V B AA M D
DJEBEL	JH EH B AH L
DJEBELS	JH EH B AH L Z
DOBBER	D AA B AH R
DOBBERS	D AA B AH R Z
DOGBERRIES	D AO G B EH R IY Z
DOGBERRY	D AO G B EH R IY
DOORBELL	D AO R B EH L
DOORBELLS	D OW R B EH L Z
DOWNBEAT	D AW N B IY T
DOWNBEATS	D AW N B IY T S
DOWSABEL	D AW Z AH B EH L
DOWSABELS	D AW Z AH B EH L Z
DRABBED	D R AE B D
DRABBER	D R AE B ER
DRABBEST	D R AE B AH S T
DRABBET	D R AE B EH T
DRABBETS	D R AE B EH T S
DRAWTUBE	D R AO T UW B
DRAWTUBES	D R AO T UW B Z
DRIBBED	D R IH B D
DRUBBED	D R AH B D
DRUBBER	D R AH B AH R
DRUBBERS	D R AH B AH R Z
DRUMBEAT	D R AH M B IY T
DRUMBEATER	D R AH M B IY T ER
DRUMBEATERS	D R AH M B IY T ER Z
DRUMBEATING	D R AH M B IY T IH NG
DRUMBEATINGS	D R AH M B IY T IH NG Z
DRUMBEATS	D R AH M B IY T S
DUBBED	D AH B D
DUBBER	D AH B ER
DUBBERS	D AH B ER Z
DUMBBELL	D AH M B EH L
DUMBBELLS	D AH M B EH L Z
DUMBED	D AH M D
DUMBER	D AH M ER
DUMBEST	D AH M AH S T
EARLOBE	IH ER L OW B
EARLOBES	IH ER L OW B Z
EBBED	EH B AH D
EBBET	EH B AH T
EBBETS	EH B AH T S
EGGBEATER	EH G B IY T ER
EGGBEATERS	EH G B IY T ER Z
ELDERBERRIES	EH L D ER B EH R IY Z
ELDERBERRY	EH L D ER B EH R IY
EMBED	IH M B EH D
EMBEDDED	EH M B EH D IH D
EMBEDDING	IH M B EH D IH NG
EMBEDDINGS	IH M B EH D IH NG Z
EMBEDMENT	IH M B EH D M AH N T
EMBEDMENTS	IH M B EH D M AH N T S
EMBEDS	IH M B EH D Z
EMBELLISH	IH M B EH L IH SH
EMBELLISHED	EH M B EH L IH SH T
EMBELLISHER	IH M B EH L IH SH ER
EMBELLISHERS	IH M B EH L IH SH ER Z
EMBELLISHES	EH M B EH L IH SH AH Z
EMBELLISHING	EH M B EH L IH SH IH NG
EMBELLISHMENT	EH M B EH L IH SH M AH N T
EMBELLISHMENTS	IH M B EH L IH SH M AH N T S
EMBER	EH M B ER
EMBERS	EH M B ER Z
EMBEZZLE	IH M B EH Z AH L
EMBEZZLED	IH M B EH Z AH L D
EMBEZZLEMENT	EH M B EH Z AH L M AH N T
EMBEZZLEMENTS	IH M B EH Z AH L M AH N T S
EMBEZZLER	IH M B EH Z AH L ER
EMBEZZLER(2)	EH M B EH Z L ER
EMBEZZLERS	IH M B EH Z AH L ER Z
EMBEZZLERS(2)	EH M B EH Z L ER Z
EMBEZZLES	IH M B EH Z AH L Z
EMBEZZLING	IH M B EH Z AH L IH NG
EMBEZZLING(2)	EH M B EH Z L IH NG
EMBEZZLING(3)	IH M B EH Z L IH NG
EMBEZZLING(4)	EH M B EH Z AH L IH NG
ENCUMBER	EH N K AH M B ER
ENCUMBERED	EH N K AH M B ER D
ENCUMBERING	EH N K AH M B ER IH NG
ENCUMBERS	EH N K AH M B ER Z
ENGLOBE	EH N G L OW B
ENGLOBED	EH N G L OW B D
ENGLOBES	EH N G L OW B Z
ENJAMBED	EH N JH AE M B EH D
ENJAMBEMENT	EH N JH AE M B IY M AH N T
ENJAMBEMENTS	EH N JH AE M B IY M AH N T S
ENROBE	EH N R OW B
ENROBED	EH N R OW B D
ENROBER	EH N R OW B ER
ENROBERS	EH N R OW B ER Z
ENROBES	EH N R OW B Z
ENTOMBED	EH N T UW M D
ENWOMBED	EH N W UW M D
EPHEBE	AH F IY B
EPHEBES	AH F IY B Z
ETHYLBENZENE	EH TH AH L B EH N Z IY N
ETHYLBENZENES	EH TH AH L B EH N Z IY N Z
EXUBERANCE	IH G Z UW B ER AH N S
EXUBERANCES	IH G Z UW B ER AH N S IH Z
EXUBERANT	IH G Z UW B ER AH N T
EXUBERANTLY	IH G Z UW B ER AH N T L IY
EXUBERATE	IH G Z UW B ER AH T
EXUBERATED	IH G Z UW B ER EY T IH D
EXUBERATES	IH G Z UW B ER AH T S
EXUBERATING	IH G Z UW B ER EY T IH NG
EYEBEAM	AY B IY M
EYEBEAMS	AY B IY M Z
FARKLEBERRIES	F AA R K L AH B EH R AY Z
FARKLEBERRY	F AA R K L AH B EH R IY
FEATHERBED	F EH DH ER B EH D
FEATHERBEDDED	F EH DH ER B EH D IH D
FEATHERBEDDING	F EH DH ER B EH D IH NG
FEATHERBEDDINGS	F EH DH ER B EH D IH NG Z
FEATHERBEDS	F EH DH ER B EH D Z
FIBBED	F IH B D
FIBBER	F IH B AH R
FIBBERS	F IH B AH R Z
FIBER	F AY B ER
FIBERBOARD	F AY B ER B AO R D
FIBERBOARDS	F AY B ER B OW R D Z
FIBERED	F AY B ER D
FIBERFILL	F AY B ER F IH L
FIBERFILLS	F AY B ER F IH L Z
FIBERGLASS	F AY B ER G L AE S
FIBERGLASSED	F AY B ER G L AE S T
FIBERGLASSES	F AY B ER G L AE S IH Z
FIBERGLASSING	F AY B ER G L AE S IH NG
FIBERIZATION	F AY B ER AH Z EY SH AH N
FIBERIZATIONS	F AY B ER AH Z EY SH AH N Z
FIBERIZE	F AY B ER AY Z
FIBERIZED	F AY B ER AY Z D
FIBERIZES	F AY B ER AY Z IH Z
FIBERIZING	F AY B ER AY Z IH NG
FIBEROPTIC	F AY B ER AA P T IH K
FIBEROPTICS	F AY B ER AA P T IH K S
FIBERS	F AY B ER Z
FIBERSCOPE	F AY B ER S K OW P
FIBERSCOPES	F AY B ER S K OW P S
FILBERT	F IH L B ER T
FILBERTS	F IH L B ER T S
FILIBEG	F IH L AH B AH G
FILIBEGS	F IH L AH B AH G Z
FIREBOMBED	F AY R B AA M D
FLABBERGAST	F L AE B ER G AE S T
FLABBERGASTED	F L AE B ER G AE S T IH D
FLABBERGASTING	F L AE B AH R G AE S T AH NG
FLABBERGASTINGLY	F L AE B AH R G AE S T IH NG L IY
FLABBERGASTS	F L AE B AH R G AH S T S
FLABELLA	F L AH B EH L AH
FLABELLATE	F L AE B AH L EY T
FLABELLIFORM	F L AH B EH L AH F AH R M
FLABELLUM	F L AH B EH L AH M
FLAMBE	F L AE M
FLAMBEAU	F L AE M B IY UW
FLAMBEAUS	F L AE M B IY AH S
FLAMBEAUX	F L AE M B IY AH K S
FLAMBEE	F L AE M B IY IY
FLAMBEED	F L AE M IY D
FLAMBEING	F L AE M IY AH NG
FLAMBES	F L AE M Z
FLASHCUBE	F L AE SH K Y UW B
FLASHCUBES	F L AE SH K Y UW B Z
FLASHTUBE	F L AE SH T UW B
FLASHTUBES	F L AE SH T UW B Z
FLATBED	F L AE T B EH D
FLATBEDS	F L AE T B EH D Z
FLIBBERTIGIBBET	F L IH B AH R T AH JH IH B AH T
FLIBBERTIGIBBETS	F L IH B AH R T AH JH IH B AH T S
FLIBBERTIGIBBETY	F L IH B AH R T AH JH IH B AH T IY
FLOWERBED	F L AW ER B EH D
FLOWERBEDS	F L AW ER B EH D Z
FLUBBED	F L AH B D
FLUBBER	F L AH B ER
FLUBBERS	F L AH B ER Z
FLYBELT	F L AY B EH L T
FLYBELTS	F L AY B EH L T S
FOBBED	F AA B D
FOOTLAMBERT	F UH T L AE M B ER T
FOOTLAMBERTS	F UH T L AE M B ER T S
FORBEAR	F AO R B AE ER
FORBEARANCE	F AO R B EH R AH N S
FORBEARANCES	F AO R B AE ER AH N S IH Z
FORBEARER	F AO R B AE ER ER
FORBEARERS	F AO R B AE ER ER Z
FORBEARING	F AO R B AE ER IH NG
FORBEARS	F AO R B AE ER Z
FOREBEAR	F AO R B EH R
FOREBEARS	F AO R B EH R Z
FRAMBESIA	F R AE M B IY ZH IY AH
FRAMBESIAS	F R AE M B IY S IY AH Z
FREEBEE	F R IY B IY
FREEBEES	F R IY B IY Z
FRISBEE	F R IH S B IY
FRISBEES	F R AY Z B IY Z
FUBBED	F AH B D
FURBEARER	F ER B AE ER ER
FURBEARERS	F ER B AE ER ER Z
FURBELOW	F ER B IH L OW
FURBELOWED	F ER B IH L OW D
FURBELOWING	F ER B IH L OW IH NG
FURBELOWS	F ER B IH L OW Z
GABBED	G AE B D
GABBER	G AE B ER
GABBERS	G AE B ER Z
GABELLE	G AE B AH L
GABELLED	G AE B AH L D
GABELLES	G AE B AH L Z
GABERDINE	G AE B ER D AY N
GABERDINES	G AE B ER D AY N Z
GAMBE	G AE M
GAMBES	G AE M Z
GAMBESON	G AE M B AH S AH N
GAMBESONS	G AE M B AH S AH N Z
GARBED	G AA R B D
GARDEROBE	G AA R D AH R OW B
GARDEROBES	G AA R D AH R OW B Z
GEOPROBE	JH IY AH P R OW B
GEOPROBES	JH IY AH P R OW B Z
GERBERA	JH AH R B AH R AH
GERBERAS	JH AH R B AH R AH Z
GIBBED	JH IH B D
GIBBER	JH IH B AH R
GIBBERED	JH IH B IY R D
GIBBERELLIN	JH IH B AH R EH L AH N
GIBBERELLINS	JH IH B AH R EH L AH N Z
GIBBERING	JH IH B IY R AH NG
GIBBERISH	G IH B ER IH SH
GIBBERISHES	JH IH B EH R AH SH AH Z
GIBBERS	JH IH B AH R Z
GIBBET	JH IH B AH T
GIBBETED	JH IH B AH T IH D
GIBBETING	JH IH B AH T IH NG
GIBBETS	JH IH B AH T S
GIBBETTED	JH IH B AH T IH D
GIBBETTING	JH IH B AH T IH NG
GIBE	JH AY B
GIBED	JH AY B D
GIBER	JH AY B ER
GIBERS	JH AY B ER Z
GIBES	JH AY B Z
GILBERT	G IH L B ER T
GILBERTS	G IH L P ER T S
GLABELLA	G L AH B EH L AH
GLABELLAE	G L AH B EH L IY
GLABELLAR	G L AH B EH L AH R
GLEBE	G L IY B
GLEBES	G L IY B Z
GLIBBER	G L IH B ER
GLIBBEST	G L IH B AH S T
GLOBE	G L OW B
GLOBED	G L OW B D
GLOBEFISH	G L OW B F IH SH
GLOBEFISHES	G L OW B F IH SH IH Z
GLOBEFLOWER	G L OW B F L AW ER
GLOBEFLOWERS	G L OW B F L AW ER Z
GLOBES	G L OW B Z
GOBBED	G AA B D
GOBBET	G AA B EH T
GOBBETS	G AA B EH T S
GOOBER	G UW B AH R
GOOBERS	G UW B AH R Z
GOOSEBERRIES	G UW S B EH R IY Z
GOOSEBERRY	G UW S B EH R IY
GORBELLIES	G AO R B EH L AY Z
GORBELLY	G AO R B EH L IY
GRABBED	G R AE B D
GRABBER	G R AE B ER
GRABBERS	G R AE B ER Z
GRABEN	G R AE B AH N
GRABENS	G R AA B AH N Z
GRAYBEARD	G R EY B IY R D
GRAYBEARDS	G R EY B IY R D Z
GREBE	G R IY B
GREBES	G R IY B Z
GREENBELT	G R IY N B EH L T
GREENBELTS	G R IY N B EH L T S
GROSBEAK	G R OW S B IY K
GROSBEAKS	G R OW S B IY K S
GRUBBED	G R AH B D
GRUBBER	G R AH B ER
GRUBBERS	G R AH B ER Z
GUAYABERA	G W AY AH B EH R AH
GUAYABERAS	G Y UW EY AE B AH R AH Z
GUBERNATORIAL	G UW B ER N AH T AO R IY AH L
GYBE	JH AY B
GYBED	JH AY B D
GYBES	JH AY B Z
HABERDASHER	HH AH B AH R D AH SH AH R
HABERDASHERIES	HH AE B ER D AE SH AH R IY Z
HABERDASHERS	HH AH B AH R D AH SH AH R Z
HABERDASHERY	HH AE B ER D AE SH ER IY
HABERGEON	HH AH B AH R JH AH N
HABERGEONS	HH AH B AH R JH IY AH N Z
HACKBERRIES	HH AE K B EH R IY Z
HACKBERRY	HH AE K B EH R IY
HAGBERRIES	HH AE G EH R AY Z
HAGBERRY	HH AE G EH R IY
HALBERD	HH AE L B AH R D
HALBERDS	HH AE L B AH R D Z
HALBERT	HH AE L B ER T
HALBERTS	HH AE L B AH R T S
HALFBEAK	HH AE L F B IY K
HALFBEAKS	HH AE L F B IY K S
HANDBELL	HH AE N D B EH L
HANDBELLS	HH AE N D B EH L Z
HAREBELL	HH EH R B EH L
HAREBELLS	HH EH R B EH L Z
HARTEBEEST	HH AA R T IY B IY AH S T
HARTEBEESTS	HH AA R T AH B IY S T S
HAUBERK	HH AO B AH R K
HAUBERKS	HH AO B AH R K S
HEARTBEAT	HH AA R T B IY T
HEARTBEATS	HH AA R T B IY T S
HEBE	HH IY B
HEBEPHRENIA	HH EH B AH F R IY N Y AH
HEBEPHRENIAS	HH EH B AH F R IY N Y AH Z
HEBEPHRENIC	HH IY B AH F R EH N IH K
HEBEPHRENICS	HH IY B AH F R EH N IH K S
HEBES	HH IY B Z
HEBETATE	HH EH B AH T EY T
HEBETATED	HH EH B AH T EY T AH D
HEBETATES	HH EH B AH T EY T S
HEBETATING	HH EH B AH T EY T AH NG
HEBETATION	HH EH B AH T EY SH AH N
HEBETATIONS	HH EH B AH T EY T IY AH N Z
HEBETIC	HH EH B AH T AH K
HEBETUDE	HH EH B AH T Y UW D
HEBETUDES	HH EH B AH T Y UW D Z
HEBETUDINOUS	HH EH B AH T Y UW D AH N AH S
HELLBENDER	HH EH L B EH N D ER
HELLBENDERS	HH EH L B EH N D ER Z
HELLBENT	HH EH L B IY AH N T
HERBED	ER B D
HEREINBEFORE	HH IY R IY N B AH F AH R
HEREINBELOW	HH IY R IY N B AH L OW
HIBERNACULA	HH AH B AH R N AH K Y UW L AH
HIBERNACULUM	HH AH B AH R N AH K Y UW L AH M
HIBERNAL	HH AH B AH R N AH L
HIBERNATE	HH AY B ER N EY T
HIBERNATED	HH AY B ER N EY T IH D
HIBERNATES	HH AY B ER N EY T S
HIBERNATING	HH AY B ER N EY T IH NG
HIBERNATION	HH AY B ER N EY SH AH N
HIBERNATIONS	HH AY B ER N EY SH AH N Z
HIBERNATOR	HH AY B ER N EY T ER
HIBERNATORS	HH AY B ER N EY T ER Z
HOBBED	HH AA B D
HOBNOBBED	HH AA B N AA B D
HOBNOBBER	HH AA B N AA B ER
HOBNOBBERS	HH AA B N AA B ER Z
HOMOPHOBE	HH AA M AH F OW B
HOMOPHOBES	HH AA M AH F OW B Z
HONEYBEE	HH AH N IY B IY
HONEYBEES	HH AH N IY B IY Z
HONEYCOMBED	HH AH N IY K OW M D
HOOFBEAT	HH UW F B IY T
HOOFBEATS	HH UW F B IY T S
HORNBEAM	HH AO R N B IY M
HORNBEAMS	HH AO R N B IY M Z
HORSEBEAN	HH AO R S B IY N
HORSEBEANS	HH AO R S B IY N Z
HOTBED	HH AA T B EH D
HOTBEDS	HH AA T B EH D Z
HOWBEIT	HH OW B IY T
HUCKLEBERRIES	HH AH K L AH B EH R AY Z
HUCKLEBERRY	HH AH K AH L B EH R IY
HYPERCUBE	HH AY P ER K Y UW B
HYPERCUBES	HH AY P ER K Y UW B Z
IBEX	AY B EH K S
IBEXES	IH B AH K S
ICEBERG	AY S B ER G
ICEBERGS	AY S B ER G Z
ILLIBERAL	IH L IH B ER AH L
ILLIBERALISM	IH L IH B ER AH L IH Z AH M
ILLIBERALISMS	IH L IH B ER AH L IH Z AH M Z
ILLIBERALITIES	IH L IH B AH R AE L AH T IY Z
ILLIBERALITY	IH L IH B AH R AE L AH T IY
ILLIBERALLY	IH L IH B ER AH L IY
ILLIBERALNESS	IH L IH B ER AH L N AH S
ILLIBERALNESSES	IH L IH B ER AH L N AH S IH Z
IMBECILE	IH M B AH S AH L
IMBECILE(2)	IH M B AH S AY L
IMBECILES	IH M B AH S AH L Z
IMBECILES(2)	IH M B AH S AY L Z
IMBECILIC	IH M B AH S AH L IH K
IMBECILITIES	IH M B AH S AH L AH T IY Z
IMBECILITY	IH M B AH S AH L AH T IY
IMBED	IH M B EH D
IMBEDDED	IH M B EH D IH D
IMBEDDING	IH M B EH D IH NG
IMBEDS	IH M B EH D Z
IMBIBE	IH M B AY B
IMBIBED	IH M B AY B D
IMBIBER	IH M B AY B ER
IMBIBERS	IH M B AY B ER Z
IMBIBES	IH M B AY B Z
IMMUNOSORBENT	IH M Y UW N AH S AO R B AH N T
IMMUNOSORBENTS	IH M Y UW N AH S AO R B AH N T S
INBEING	IH N B IY IH NG
INBEINGS	IH N B IY IH NG Z
INCUMBENCIES	IH N K AH M B EH N S AY Z
INCUMBENCY	IH N K AH M B AH N S IY
INCUMBENT	IH N K AH M B AH N T
INCUMBENTS	IH N K AH M B AH N T S
INCUMBER	IH N K AH M B ER
INCUMBERED	IH N K AH M B ER D
INCUMBERING	IH N K AH M B ER IH NG
INCUMBERS	IH N K AH M B ER Z
INKBERRIES	IH NG K B EH R IY Z
INKBERRY	IH NG K B EH R IY
INSCRIBE	IH N S K R AY B
INSCRIBED	IH N S K R AY B D
INSCRIBER	IH N S K R AY B ER
INSCRIBERS	IH N S K R AY B ER Z
INSCRIBES	IH N S K R AY B Z
INSELBERG	IH N S EH L B AH R G
INSELBERGE	IH N S EH L B AH R JH
INSELBERGS	IH N S EH L B AH R G Z
INTERBED	IH N T ER B EH D
INTERBEDDED	IH N T ER B EH D IH D
INTERBEDDING	IH N T ER B EH D IH NG
INTERBEDS	IH N T ER B EH D Z
INTERBEHAVIOR	IH N T ER B IH HH EY V Y ER
INTERBEHAVIORAL	IH N T ER B IH HH EY V Y ER AH L
INTERBEHAVIORS	IH N T ER B IH HH EY V Y ER Z
INTERFIBER	IH N T ER F AY B ER
INTOMBED	IH N T UW M D
JABBED	JH AE B D
JABBER	JH AE B ER
JABBERED	JH AE B ER D
JABBERER	JH AE B ER ER
JABBERERS	JH AE B ER ER Z
JABBERING	JH AE B ER IH NG
JABBERS	JH AE B ER Z
JABBERWOCKIES	JH AE B AH R W AA K AY Z
JABBERWOCKY	JH AE B AH R W AA K IY
JAMBE	JH AE M B IY
JAMBEAU	JH AE M B OW
JAMBEAUX	JH AE M B IY AH K S
JAMBED	JH AE M B EH D
JAMBES	JH AE M B IY Z
JEBEL	JH EH B AH L
JEBELS	JH EH B AH L Z
JELLYBEAN	JH EH L IY B IY N
JELLYBEANS	JH EH L IY B IY N Z
JETBEAD	JH EH T B IY D
JETBEADS	JH EH T B IY D Z
JEZEBEL	JH EH Z AH B AH L
JEZEBELS	JH EH Z AH B AH L Z
JIBBED	JH IH B D
JIBBER	JH IH B AH R
JIBBERS	JH IH B AH R Z
JIBE	JH AY B
JIBED	JH AY B D
JIBER	JH AY B ER
JIBERS	JH AY B ER Z
JIBES	JH AY B Z
JOBBED	JH AA B D
JOBBER	JH AA B ER
JOBBERIES	JH AA B AH R IY Z
JOBBERS	JH AA B ER Z
JOBBERY	JH AA B AH R IY
JUBE	JH UW B
JUBES	JH UW B Z
JUJUBE	JH UW JH UW B
JUJUBES	JH UW JH UW B IY Z
KABELJOU	K AH B EH L JH UW
KABELJOUS	K AH B EH L JH AH S
KERBED	K AH R B D
KIBBE	K IH B
KIBBEH	K IH B
KIBBEHS	K IH B AH Z
KIBBES	K IH B Z
KIBE	K AY B
KIBEI	K IH B IY
KIBEIS	K AY B IY AH S
KIBES	K AY B Z
KIMBERLITE	K IH M B AH R L AY T
KIMBERLITES	K IH M B AH R L AY T S
KNOBBED	N AA B D
LABEL	L EY B AH L
LABELABLE	L EY B AH L AH B AH L
LABELED	L EY B AH L D
LABELER	L EY B AH L ER
LABELERS	L EY B AH L ER Z
LABELING	L EY B AH L IH NG
LABELING(2)	L EY B L IH NG
LABELLA	L AH B EH L AH
LABELLED	L EY B AH L D
LABELLER	L EY B AH L ER
LABELLERS	L EY B AH L ER Z
LABELLING	L EY B AH L IH NG
LABELLUM	L AH B EH L AH M
LABELS	L EY B AH L Z
LAMBED	L AE M D
LAMBENCIES	L AE M AH N S IY Z
LAMBENCY	L AE M AH N S IY
LAMBENT	L AE M AH N T
LAMBENTLY	L AE M AH N T L IY
LAMBER	L AE M ER
LAMBERS	L AE M ER Z
LAMBERT	L AE M B ER T
LAMBERTS	L AE M B ER T S
LANDLUBBER	L AE N D L AH B AH R
LANDLUBBERLINESS	L AE N D L AH B AH R L AH N AH S
LANDLUBBERLINESSES	L AE N D L AH B AH R L AH N EH S AH Z
LANDLUBBERLY	L AE N D L AH B EH R L IY
LANDLUBBERS	L AE N D L AH B AH R Z
LANGBEINITE	L AE N G AH N AY T
LANGBEINITES	L AE N G AH N AY T S
LEBEN	L EH B AH N
LEBENS	L EH B AH N Z
LEBENSRAUM	L EY B AH N Z R AW M
LEBENSRAUMS	L EY B AH N Z R AW M Z
LIBBER	L IH B AH R
LIBBERS	L IH B AH R Z
LIBECCHIO	L AH B EH K IY OW
LIBECCHIOS	L AH B EH K IY AH Z
LIBECCIO	L AH B EH K S IY OW
LIBECCIOS	L AH B EH K S IY AH Z
LIBEL	L AY B EH L
LIBELANT	L AY B AH L AH N T
LIBELANTS	L AY B AH L AH N T S
LIBELED	L AY B EH L D
LIBELEE	L AY B AH L IY
LIBELEES	L AY B AH L IY Z
LIBELER	L AY B AH L ER
LIBELERS	L AY B AH L ER Z
LIBELING	L AY B AH L IH NG
LIBELIST	L AY B AH L IH S T
LIBELISTS	L AY B AH L IH S T S
LIBELLANT	L AY B AH L AH N T
LIBELLANTS	L AY B AH L AH N T S
LIBELLED	L AY B AH L D
LIBELLEE	L AY B AH L IY
LIBELLEES	L AY B AH L IY Z
LIBELLER	L AY B AH L ER
LIBELLERS	L AY B AH L ER Z
LIBELLING	L AY B AH L IH NG
LIBELLOUS	L AY B AH L AH S
LIBELOUS	L AY B EH L AH S
LIBELS	L AY B AH L Z
LIBER	L AY B AH R
LIBERAL	L IH B ER AH L
LIBERALISE	L AH B EH R AH L AY Z
LIBERALISED	L IH B ER AH L IY Z D
LIBERALISES	L IH B ER AH L IY Z IH Z
LIBERALISING	L IH B ER AH L IY Z IH NG
LIBERALISM	L IH B ER AH L IH Z AH M
LIBERALISMS	L IH B ER AH L IH Z AH M Z
LIBERALIST	L IH B ER AH L IH S T
LIBERALISTIC	L IH B ER AH L IH S T IH K
LIBERALISTS	L IH B ER AH L IH S T S
LIBERALITIES	L IH B AH R AE L AH T IY Z
LIBERALITY	L IH B ER AE L AH T IY
LIBERALIZATION	L IH B ER AH L IH Z EY SH AH N
LIBERALIZATIONS	L IH B ER AH L IH Z EY SH AH N Z
LIBERALIZE	L IH B ER AH L AY Z
LIBERALIZED	L IH B ER AH L AY Z D
LIBERALIZER	L IH B ER AH L AY Z ER
LIBERALIZERS	L IH B ER AH L AY Z ER Z
LIBERALIZES	L IH B ER AH L AY Z IH Z
LIBERALIZING	L IH B ER AH L AY Z IH NG
LIBERALLY	L IH B ER AH L IY
LIBERALNESS	L IH B ER AH L N AH S
LIBERALNESSES	L IH B ER AH L N AH S IH Z
LIBERALS	L IH B ER AH L Z
LIBERATE	L IH B ER EY T
LIBERATED	L IH B ER EY T IH D
LIBERATES	L IH B ER AH T S
LIBERATING	L IH B ER EY T IH NG
LIBERATION	L IH B ER EY SH AH N
LIBERATIONIST	L IH B ER EY SH AH N IH S T
LIBERATIONISTS	L IH B ER EY SH AH N IH S T S
LIBERATIONS	L IH B ER EY SH AH N Z
LIBERATOR	L IH B ER EY T AH R
LIBERATORS	L IH B ER EY T AH R Z
LIBERS	L IH B AH R Z
LIBERTARIAN	L IH B ER T EH R IY AH N
LIBERTARIANISM	L IH B ER T EH R IY AH N IH Z AH M
LIBERTARIANISMS	L IH B ER T EH R IY AH N IH Z AH M Z
LIBERTARIANS	L IH B ER T EH R IY AH N Z
LIBERTIES	L IH B ER T IY Z
LIBERTINAGE	L IH B ER T IY N IH JH
LIBERTINAGES	L IH B ER T IY N IH JH IH Z
LIBERTINE	L IH B ER T IY N
LIBERTINES	L IH B ER T IY N Z
LIBERTINISM	L IH B ER T IY N IH Z AH M
LIBERTINISMS	L IH B ER T IY N IH Z AH M Z
LIBERTY	L IH B ER T IY
LIMBECK	L IH M B AH K
LIMBECKS	L IH M B AH K S
LIMBED	L IH M D
LIMBER	L IH M B ER
LIMBERED	L IH M B ER D
LIMBERER	L IH M B ER ER
LIMBEREST	L IH M B ER AH S T
LIMBERING	L IH M B ER IH NG
LIMBERLY	L IH M B ER L IY
LIMBERNESS	L IH M B ER N AH S
LIMBERNESSES	L IH M B ER N AH S IH Z
LIMBERS	L IH M B ER Z
LINGONBERRIES	L IH N G AA N B EH R AY Z
LINGONBERRY	L IH N G AA N B EH R IY
LOBBED	L AA B D
LOBBER	L AA B ER
LOBBERS	L AA B ER Z
LOBE	L OW B
LOBECTOMIES	L AH B EH K T AH M AY Z
LOBECTOMY	L AH B EH K T AH M IY
LOBED	L OW B D
LOBEFIN	L OW B F IH N
LOBEFINS	L OW B F IH N Z
LOBELIA	L AH B IY L Y AH
LOBELIAS	L AH B IY L Y AH Z
LOBELINE	L OW B L AY N
LOBELINES	L OW B L AY N Z
LOBES	L OW B Z
LOGANBERRIES	L AH G AE N B EH R AY Z
LOGANBERRY	L AH G AE N B EH R IY
LUBBER	L AH B ER
LUBBERLINESS	L AH B AH R L AH N AH S
LUBBERLINESSES	L AH B AH R L AH N EH S AH Z
LUBBERLY	L AH B EH R L IY
LUBBERS	L AH B ER Z
LUBE	L UW B
LUBED	L UW B D
LUBES	L UW B Z
LUMBER	L AH M B ER
LUMBERED	L AH M B ER D
LUMBERER	L AH M B ER ER
LUMBERERS	L AH M B ER ER Z
LUMBERING	L AH M B ER IH NG
LUMBERJACK	L AH M B ER JH AE K
LUMBERJACKS	L AH M B ER JH AE K S
LUMBERMAN	L AH M B ER M AH N
LUMBERMEN	L AH M B ER M EH N
LUMBERS	L AH M B ER Z
LUMBERYARD	L AH M B ER Y AA R D
LUMBERYARDS	L AH M B ER Y AA R D Z
MABE	M EY B
MABES	M EY B Z
MACABER	M AH K EY B AH R
MAILBOMBED	M EY L B AA M D
MANGABEY	M AE N G EY B IY
MANGABEYS	M AE N G AH B EY Z
MAYBE	M EY B IY
MAYBES	M EY B IY Z
MEMBER	M EH M B ER
MEMBERED	M EH M B ER D
MEMBERS	M EH M B ER Z
MEMBERSHIP	M EH M B ER SH IH P
MEMBERSHIPS	M EH M B ER SH IH P S
MICAWBER	M IH K AH B AH R
MICAWBERS	M IH K AH B AH R Z
MICROBE	M AY K R OW B
MICROBEAM	M AY K R OW B IY M
MICROBEAMS	M AY K R OW B IY M Z
MICROBES	M AY K R OW B Z
MICROPROBE	M AY K R OW P R OW B
MICROPROBES	M AY K R OW P R OW B Z
MILLILAMBERT	M IH L AH L AE M B AH R T
MILLILAMBERTS	M IH L AH L AE M B AH R T S
MISBECAME	M IH S B IH K EY M
MISBECOME	M IH S B IH K AH M
MISBECOMES	M IH S B IH K AH M Z
MISBECOMING	M IH S B IH K AH M IH NG
MISBEGAN	M IH S B IH G AE N
MISBEGIN	M IH S B IH G IH N
MISBEGINNING	M IH S B IH G IH N IH NG
MISBEGINS	M IH S B IH G IH N Z
MISBEGOT	M IH S B IH G AA T
MISBEGOTTEN	M IH S B AH G AA T AH N
MISBEGUN	M IH S B IH G AH N
MISBEHAVE	M IH S B AH HH EY V
MISBEHAVE(2)	M IH S B IY HH EY V
MISBEHAVED	M IH S B AH HH EY V D
MISBEHAVED(2)	M IH S B IY HH EY V D
MISBEHAVER	M IH S B IH HH EY V ER
MISBEHAVERS	M IH S B IH HH EY V ER Z
MISBEHAVES	M IH S B AH HH EY V Z
MISBEHAVES(2)	M IH S B IY HH EY V Z
MISBEHAVING	M IH S B AH HH EY V IH NG
MISBEHAVING(2)	M IH S B IY HH EY V IH NG
MISBEHAVIOR	M IH S B AH HH EY V Y ER
MISBEHAVIOR(2)	M IH S B IY HH EY V Y ER
MISBEHAVIORS	M IH S B IH HH EY V Y ER Z
MISBELIEF	M IH S B AH L IY F
MISBELIEFS	M IH S B AH L IY F S
MISBELIEVE	M IH S B AH L IY V
MISBELIEVED	M IH S B AH L IY V D
MISBELIEVER	M IH S B AH L IY V ER
MISBELIEVERS	M IH S B AH L IY V ER Z
MISBELIEVES	M IH S B AH L IY V Z
MISBELIEVING	M IH S B AH L IY V IH NG
MISDESCRIBE	M IH S D IY S K R AY B
MISDESCRIBED	M IH S D IY S K R AY B D
MISDESCRIBES	M IH S D IY S K R AY B Z
MISLABEL	M IH S L EY B AH L
MISLABELED	M IH S L EY B AH L D
MISLABELING	M IH S L EY B AH L IH NG
MISLABELING(2)	M IH S L EY B L IH NG
MISLABELLED	M IH S L EY B AH L D
MISLABELLING	M IH S L EY B AH L IH NG
MISLABELS	M IH S L EY B AH L Z
MISREMEMBER	M IH S R IY M EH M B ER
MISREMEMBERED	M IH S R IY M EH M B ER D
MISREMEMBERING	M IH S R IH M EH M B ER IH NG
MISREMEMBERS	M IH S R IH M EH M B ER Z
MISTRANSCRIBE	M IH S T R AE N S K R AY B
MISTRANSCRIBED	M IH S T R AE N S K R AY B D
MISTRANSCRIBES	M IH S T R AE N S K R AY B Z
MOBBED	M AA B D
MOBBER	M AA B ER
MOBBERS	M AA B ER Z
MOONBEAM	M UW N B IY M
MOONBEAMS	M UW N B IY M Z
MULBERRIES	M UH L B EH R AY Z
MULBERRY	M AH L B EH R IY
MULTICHAMBERED	M AH L T AY CH EY M B ER D
MULTILOBED	M AH L T AY L OW B D
MULTIMEMBER	M AH L T AY M EH M B ER
NABBED	N AE B D
NABBER	N AE B ER
NABBERS	N AE B ER Z
NABE	N EY B
NABES	N EY B Z
NABOBERIES	N AH B AA B AH R AY Z
NABOBERY	N AE B AH B EH R IY
NABOBESS	N AE B AH B AH S
NABOBESSES	N AE B AH B EH S AH Z
NEBENKERN	N AH B EH NG K AH R N
NEBENKERNS	N AH B EH NG K AH R N Z
NEGROPHOBE	N EH G R AH F OW B
NEGROPHOBES	N EH G R AH F OW B Z
NEOLIBERAL	N IY OW L IH B ER AH L
NEOLIBERALISM	N IY OW L IH B ER AH L IH Z AH M
NEOLIBERALISMS	N IY OW L IH B ER AH L IH Z AH M Z
NEOLIBERALS	N IY OW L IH B ER AH L Z
NIBBED	N IH B D
NIGHTCLUBBED	N AY T K L AH B D
NIGHTCLUBBER	N AY T K L AH B ER
NIGHTCLUBBERS	N AY T K L AH B ER Z
NITROBENZENE	N IH T R AA B AH N Z IY N
NITROBENZENES	N IH T R AA B AH N Z IY N Z
NOBELIUM	N OW B EH L IY AH M
NOBELIUMS	N AH B IY L IY AH M Z
NONABSORBENT	N AA N AH B Z AO R B AH N T
NONABSORBENTS	N AA N AH B Z AO R B AH N T S
NONALPHABETIC	N AA N AE L F AH B EH T IH K
NONBEARING	N AA N B AE ER IH NG
NONBEHAVIORAL	N AA N B IH HH EY V Y ER AH L
NONBEING	N AA N B IY IH NG
NONBEINGS	N AA N B IY IH NG Z
NONBELIEF	N AA N B AH L IY F
NONBELIEFS	N AA N B AH L IY F S
NONBELIEVER	N AA N B IH L IY V ER
NONBELIEVERS	N AA N B IH L IY V ER Z
NONBELLIGERENCIES	N AA N B AH L IH JH ER AH N S IY Z
NONBELLIGERENCY	N AA N B AH L IH JH ER AH N S IY
NONBELLIGERENT	N AA N B AH L IH JH ER AH N T
NONBELLIGERENTS	N AA N B AH L IH JH ER AH N T S
NONBETTING	N AA N B EH T IH NG
NONDELIBERATE	N AA N D IH L IH B AH R AH T
NONDIABETIC	N AA N D AY AH B EH T IH K
NONDIABETICS	N AA N D AY AH B EH T IH K S
NONINCUMBENT	N AA N IH N K AH M B AH N T
NONINCUMBENTS	N AA N IH N K AH M B AH N T S
NONMEMBER	N AA N M EH M B ER
NONMEMBERS	N AA N M EH M B ER Z
NONMEMBERSHIP	N AA N M EH M B ER SH IH P
NONMEMBERSHIPS	N AA N M EH M B ER SH IH P S
NONOBESE	N AA N OW B IY S
NONRUBBER	N AA N R AH B ER
NUMBED	N AH M D
NUMBER	N AH M B ER
NUMBERABLE	N AH M B ER AH B AH L
NUMBERED	N AH M B ER D
NUMBERER	N AH M B ER ER
NUMBERERS	N AH M B ER ER Z
NUMBERING	N AH M B ER IH NG
NUMBERLESS	N AH M B ER L AH S
NUMBERS	N AH M B ER Z
NUMBEST	N AH M AH S T
OBE	OW B
OBEAH	OW B IY AH
OBEAHISM	OW B IY IH Z AH M
OBEAHISMS	OW B IY HH AH Z AH M Z
OBEAHS	OW B IY Z
OBEDIENCE	OW B IY D IY AH N S
OBEDIENCES	OW B IY D IY AH N S IH Z
OBEDIENT	OW B IY D IY AH N T
OBEDIENTLY	OW B IY D IY AH N T L IY
OBEDIENTLY(2)	OW B IY D Y AH N T L IY
OBEISANCE	OW B EY S AH N S
OBEISANCES	OW B EY Z AH N S IH Z
OBEISANT	OW B EY Z AH N T
OBEISANTLY	OW B EY Z AH N T L IY
OBELI	AA B AH L IY
OBELIA	OW B EH L IY AH
OBELIAS	AH B IY L Y AH Z
OBELISE	AA B AH L AY Z
OBELISED	AA B AH L AH S T
OBELISES	AA B AH L AY Z AH Z
OBELISING	AA B AH L AY Z AH NG
OBELISK	AA B AH L IH S K
OBELISKS	AA B AH L IH S K S
OBELISM	AA B AH L IH Z AH M
OBELISMS	AA B AH L AH Z AH M Z
OBELIZE	AA B AH L AY Z
OBELIZED	AA B AH L AY Z D
OBELIZES	AA B AH L AY Z AH Z
OBELIZING	AA B AH L AY Z AH NG
OBELUS	AA B AH L AH S
OBES	OW B Z
OBESE	OW B IY S
OBESE(2)	AH B IY S
OBESELY	OW B IY S L IY
OBESITIES	OW B IY S AH T IY Z
OBESITY	OW B IY S AH T IY
OBESITY(2)	AH B IY S AH T IY
OBEY	OW B EY
OBEYABLE	OW B EY AH B AH L
OBEYED	OW B EY D
OBEYER	OW B EY ER
OBEYERS	OW B EY ER Z
OBEYING	OW B EY IH NG
OBEYS	OW B EY Z
OFFBEAT	AO F B IY T
OFFBEATS	AO F B IY T S
OMBER	AA M AH R
OMBERS	AA M B AH R Z
ORBED	AO R B D
OUTBEAM	AW T B IY M
OUTBEAMED	AW T B IY M D
OUTBEAMING	AW T B IY M IH NG
OUTBEAMS	AW T B IY M Z
OUTBEG	AW T B EH G
OUTBEGGED	AW T B EH G D
OUTBEGGING	AW T B EH G IH NG
OUTBEGS	AW T B EH G Z
OUTBRIBE	AW T B R AY B
OUTBRIBED	AW T B R AY B D
OUTBRIBES	AW T B R AY B Z
OUTCLIMBED	AW T K L AY M D
OUTNUMBER	AW T N AH M B ER
OUTNUMBERED	AW T N AH M B ER D
OUTNUMBERING	AW T N AH M B ER IH NG
OUTNUMBERS	AW T N AH M B ER Z
OUTTHROBBED	AW T TH R AA B D
OVERBEAR	OW V ER B AE ER
OVERBEARING	OW V ER B EH R IH NG
OVERBEARINGLY	OW V ER B AE ER IH NG L IY
OVERBEARS	OW V ER B AE ER Z
OVERBEAT	OW V ER B IY T
OVERBEATEN	OW V ER B IY T AH N
OVERBEATING	OW V ER B IY T IH NG
OVERBEATS	OW V ER B IY T S
OVERBED	OW V ER B EH D
OVERBEJEWELED	OW V ER B IY JH UW AH L D
OVERBET	OW V ER B EH T
OVERBETS	OW V ER B EH T S
OVERBETTED	OW V ER B EH T IH D
OVERBETTING	OW V ER B EH T IH NG
OVERDUBBED	OW V ER D AH B D
OVEREMBELLISH	OW V ER IH M B EH L IH SH
OVEREMBELLISHED	OW V ER IH M B EH L IH SH T
OVEREMBELLISHES	OW V ER IH M B EH L IH SH IH Z
OVEREMBELLISHING	OW V ER IH M B EH L IH SH IH NG
OVEREMBELLISHMENT	OW V ER IH M B EH L IH SH M AH N T
OVEREMBELLISHMENTS	OW V ER IH M B EH L IH SH M AH N T S
OVEREXUBERANT	OW V ER IH G Z UW B ER AH N T
OVERPRESCRIBE	OW V ER P R IY S K R AY B
OVERPRESCRIBED	OW V ER P R IY S K R AY B D
OVERPRESCRIBES	OW V ER P R IY S K R AY B Z
OVERSUBSCRIBE	OW V ER S AH B S K R AY B
OVERSUBSCRIBED	OW V ER S AH B S K R AY B D
OVERSUBSCRIBES	OW V ER S AH B S K R AY B Z
PALLBEARER	P AO L B AE ER ER
PALLBEARERS	P AO L B AE ER ER Z
PARADICHLOROBENZENE	P AH R AH D AH K L AH R AA B AH N Z IY N
PARADICHLOROBENZENES	P AH R AH D AH K L AH R AA B AH N Z IY N Z
PARTRIDGEBERRIES	P AA R T R IH JH B EH R IY Z
PARTRIDGEBERRY	P AA R T R IH JH B EH R IY
PEEBEEN	P IY B IY AH N
PEEBEENS	P IY B IY AH N Z
PERTURBED	P ER T ER B D
PHILABEG	F IH L AH B AH G
PHILABEGS	F IH L AH B AH G Z
PHILIBEG	F IH L AH B AH G
PHILIBEGS	F IH L AH B AH G Z
PHOEBE	F IY B IY
PHOEBES	F OW AH B Z
PHOTOTUBE	F OW T OW T UW B
PHOTOTUBES	F OW T OW T UW B Z
PINCHBECK	P IH N CH B EH K
PINCHBECKS	P IH N CH B EH K S
PLEBE	P L IY B
PLEBEIAN	P L AH B IY AH N
PLEBEIANISM	P L IH B IY AH N IH Z AH M
PLEBEIANISMS	P L IH B IY AH N IH Z AH M Z
PLEBEIANLY	P L IH B IY AH N L IY
PLEBEIANS	P L AH B IY AH N Z
PLEBES	P L IY B Z
PLUMBED	P L AH M D
PLUMBER	P L AH M ER
PLUMBERIES	P L AH M AH R IY Z
PLUMBERS	P L AH M ER Z
PLUMBERY	P L AH M AH R IY
POKEBERRIES	P OW K B EH R IY Z
POKEBERRY	P OW K B EH R IY
PORBEAGLE	P AO R B IY G AH L
PORBEAGLES	P AO R B IY G AH L Z
PORTABELLA	P AO R T AH B EH L AH
PORTABELLAS	P AO R T AH B EH L AH Z
PORTABELLO	P AO R T AH B EH L OW
PORTABELLOS	P OW R T AH B EH L AA S
PORTOBELLO	P AO R T AH B EH L OW
PORTOBELLOS	P AO R T AH B EH L AH Z
POSTBELLUM	P AA S T B EH L AH M
POSTLIBERATION	P OW S T L IH B ER EY SH AH N
POSTPUBERTY	P OW S T P Y UW B ER T IY
POSTPUBESCENT	P OW S T P Y UW B EH S AH N T
POSTPUBESCENTS	P OW S T P Y UW B EH S AH N T S
POTBELLIED	P AA T B EH L IY D
POTBELLIES	P AA T B EH L IY Z
POTBELLY	P AA T B EH L IY
PREBEND	P R IY B EH N D
PREBENDAL	P R IY B EH N D AH L
PREBENDARIES	P R IY B EH N D EH R IY Z
PREBENDARY	P R IY B EH N D EH R IY
PREBENDS	P R IY B EH N D Z
PREDIABETES	P R IY D AY AH B IY T IY Z
PREDIABETIC	P R IY D AY AH B EH T IH K
PREDIABETICS	P R IY D AY AH B EH T IH K S
PREFABBED	P R IY F AE B D
PRENUMBER	P R IY N AH M B ER
PRENUMBERED	P R IY N AH M B ER D
PRENUMBERING	P R IY N AH M B ER IH NG
PRENUMBERS	P R IY N AH M B ER Z
PREPUBERAL	P R IY P AH B ER AH L
PREPUBERTAL	P R IY P Y AH B AH R T AH L
PREPUBERTIES	P R IY P Y UW B ER T IY Z
PREPUBERTY	P R IY P Y UW B ER T IY
PREPUBESCENCE	P R IY P Y UW B EH S AH N S
PREPUBESCENCES	P R IY P Y UW B EH S AH N S IH Z
PREPUBESCENT	P R IY P Y UW B EH S AH N T
PREPUBESCENTS	P R IY P Y UW B EH S AH N T S
PRESCRIBE	P R AH S K R AY B
PRESCRIBE(2)	P R IY S K R AY B
PRESCRIBED	P R IY S K R AY B D
PRESCRIBER	P R IY S K R AY B ER
PRESCRIBERS	P R IY S K R AY B ER Z
PRESCRIBES	P R IY S K R AY B Z
PROBE	P R OW B
PROBED	P R OW B D
PROBENECID	P R AA B EH N AH S IH D
PROBENECIDS	P R OW B AH N EH S AH D Z
PROBER	P R OW B ER
PROBERS	P R OW B ER Z
PROBES	P R OW B Z
PROCUMBENT	P R OW K AH M B AH N T
PROSCRIBE	P R OW S K R AY B
PROSCRIBED	P R OW S K R AY B D
PROSCRIBER	P R OW S K R AY B ER
PROSCRIBERS	P R OW S K R AY B ER Z
PROSCRIBES	P R OW S K R AY B Z
PROTUBERANCE	P R OW T UW B ER AH N S
PROTUBERANCE(2)	P R AH T UW B ER AH N S
PROTUBERANCES	P R OW T UW B ER AH N S AH Z
PROTUBERANCES(2)	P R AH T UW B ER AH N S AH Z
PROTUBERANT	P R OW T UW B ER AH N T
PROTUBERANTLY	P R OW T UW B ER AH N T L IY
PROVERBED	P R AA V ER B D
PSEUDOTUBERCULOSES	S UW D OW T Y AH B AH R K Y AH L OW Z AH Z
PSEUDOTUBERCULOSIS	S UW D OW T UH B ER K Y AH L OW S AH S
PUBERAL	P AH B ER AH L
PUBERTAL	P Y UW B AH R T AH L
PUBERTIES	P Y UW B ER T IY Z
PUBERTY	P Y UW B ER T IY
PUBERULENT	P Y UW B EH R AH L AH N T
PUBES	P Y UW B Z
PUBESCENCE	P Y UW B EH S AH N S
PUBESCENCES	P Y UW B EH S AH N S IH Z
PUBESCENT	P Y UW B EH S AH N T
QUODLIBET	K W AA D L AH B AH T
QUODLIBETS	K W AA D L AH B AH T S
RABBET	R AE B AH T
RABBETED	R AE B AH T IH D
RABBETING	R AE B AH T IH NG
RABBETS	R AE B AH T S
RADIOALLERGOSORBENT	R EY D IY OW AH L ER G OW S AO R B AH N T
RADIOLABEL	R EY D IY OW L EY B AH L
RADIOLABELED	R EY D IY OW L EY B AH L D
RADIOLABELING	R EY D IY OW L EY B AH L IH NG
RADIOLABELLED	R EY D IY OW L EY B AH L D
RADIOLABELLING	R EY D IY OW L EY B AH L IH NG
RADIOLABELS	R EY D IY OW L EY B AH L Z
RASPBERRIES	R AE Z B EH R IY Z
RASPBERRY	R AE Z B EH R IY
REABSORBED	R IY AH B Z AO R B D
REBBE	R IY B AH
REBBES	R EH B IY Z
REBEC	R AH B EH K
REBECK	R IY B EH K
REBECKS	R IY B EH K S
REBECS	R AH B EH K S
REBEGAN	R IY B IH G AE N
REBEGIN	R IY B IH G IH N
REBEGINNING	R IY B IH G IH N IH NG
REBEGINS	R IY B IH G IH N Z
REBEGUN	R IY B IH G AH N
REBEL	R EH B AH L
REBEL(2)	R IH B EH L
REBELDOM	R EH B AH L D AH M
REBELDOMS	R EH B AH L D AH M Z
REBELLED	R IH B EH L D
REBELLING	R IH B EH L IH NG
REBELLION	R IH B EH L Y AH N
REBELLIONS	R IH B EH L Y AH N Z
REBELLIOUS	R IH B EH L Y AH S
REBELLIOUS(2)	R AH B EH L Y AH S
REBELLIOUSLY	R IH B EH L Y AH S L IY
REBELLIOUSNESS	R AH B EH L IY AH S N AH S
REBELLIOUSNESSES	R IH B EH L Y AH S N AH S IH Z
REBELS	R EH B AH L Z
REBELS(2)	R IH B EH L Z
RECOMBED	R IY K AH M B EH D
RECUMBENCIES	R AH K AH M B EH N S AY Z
RECUMBENCY	R AH K AH M B EH N S IY
RECUMBENT	R IH K AH M B AH N T
REDESCRIBE	R IY D IY S K R AY B
REDESCRIBED	R IY D IY S K R AY B D
REDESCRIBES	R IY D IY S K R AY B Z
REDUBBED	R IY D AH B D
REHABBED	R AH HH AE B D
REHABBER	R AH HH AE B AH R
REHABBERS	R AH HH AE B AH R Z
RELABEL	R IY L EY B AH L
RELABELED	R IY L EY B AH L D
RELABELING	R IY L EY B AH L IH NG
RELABELLED	R IY L EY B AH L D
RELABELLING	R IY L EY B AH L IH NG
RELABELS	R IY L EY B AH L Z
REMEMBER	R IH M EH M B ER
REMEMBER(2)	R IY M EH M B ER
REMEMBERABILITIES	R IH M EH M B ER AH B IH L AH T EH Z
REMEMBERABILITY	R IH M EH M B ER AH B IH L AH T EH
REMEMBERABLE	R IH M EH M B ER AH B AH L
REMEMBERED	R IH M EH M B ER D
REMEMBERED(2)	R IY M EH M B ER D
REMEMBERER	R IH M EH M B ER ER
REMEMBERERS	R IH M EH M B ER ER Z
REMEMBERING	R IH M EH M B ER IH NG
REMEMBERING(2)	R IY M EH M B ER IH NG
REMEMBERING(3)	R IH M EH M B R IH NG
REMEMBERING(4)	R IY M EH M B R IH NG
REMEMBERS	R IH M EH M B ER Z
REMEMBERS(2)	R IY M EH M B ER Z
RENUMBER	R IY N AH M B ER
RENUMBERED	R IY N AH M B ER D
RENUMBERING	R IY N AH M B ER IH NG
RENUMBERS	R IY N AH M B ER Z
REPLUMBED	R IY P L AH M D
REPROBE	R IY P R OW B
REPROBED	R IY P R OW B EH D
REPROBES	R IY P R OW B Z
RESORBED	R IY S AO R B D
REVERBED	R IY V ER B D
REVERBERANT	R IH V ER B ER AH N T
REVERBERANTLY	R IH V ER B ER AH N T L IY
REVERBERATE	R IH V ER B ER AH T
REVERBERATE(2)	R IH V ER B ER EY T
REVERBERATED	R IH V ER B ER EY T IH D
REVERBERATED(2)	R IY V ER B ER EY T AH D
REVERBERATED(3)	R IY V ER B ER EY T IH D
REVERBERATES	R IH V ER B ER EY T S
REVERBERATING	R IH V ER B ER EY T IH NG
REVERBERATING(2)	R IY V ER B ER EY T IH NG
REVERBERATION	R IY V ER B ER EY SH AH N
REVERBERATIONS	R IH V ER B ER EY SH AH N Z
REVERBERATIVE	R IH V ER B ER AH T IH V
REVERBERATORY	R IH V ER B ER AH T OW R IY
RHOMBENCEPHALA	R AA M B AH N S EH F AH L AH
RHOMBENCEPHALON	R AA M B AH N S EH F AH L AH N
RIBBED	R IH B D
RIBBER	R IH B ER
RIBBERS	R IH B ER Z
RIBES	R AY B IY Z
RIBEYE	R IH B AY
RIBEYES	R IH B AY Z
RIVERBED	R IH V ER B EH D
RIVERBEDS	R IH V ER B EH D Z
ROADBED	R OW D B EH D
ROADBEDS	R OW D B EH D Z
ROBBED	R AA B D
ROBBER	R AA B ER
ROBBERIES	R AA B ER IY Z
ROBBERS	R AA B ER Z
ROBBERY	R AA B ER IY
ROBE	R OW B
ROBED	R OW B D
ROBES	R OW B Z
ROWANBERRIES	R OW AE N B EH R AY Z
ROWANBERRY	R OW AE N B EH R IY
RUBBED	R AH B D
RUBBER	R AH B ER
RUBBERED	R AH B ER D
RUBBERING	R AH B ER IH NG
RUBBERIZE	R AH B ER AY Z
RUBBERIZED	R AH B ER AY Z D
RUBBERIZES	R AH B ER AY Z IH Z
RUBBERIZING	R AH B ER AY Z IH NG
RUBBERLIKE	R AH B ER L AY K
RUBBERNECK	R AH B ER N EH K
RUBBERNECKED	R AH B ER N EH K T
RUBBERNECKER	R AH B ER N EH K ER
RUBBERNECKERS	R AH B ER N EH K ER Z
RUBBERNECKING	R AH B ER N EH K IH NG
RUBBERNECKS	R AH B ER N EH K S
RUBBERS	R AH B ER Z
RUBBERY	R AH B ER IY
RUBE	R UW B
RUBEFACIENT	R UW B F EY S IY AH N T
RUBEFACIENTS	R UW B F EY S IY AH N T S
RUBELLA	R UW B EH L AH
RUBELLAS	R UW B EH L AH Z
RUBELLITE	R UW B AH L AY T
RUBELLITES	R UW B AH L AY T S
RUBEOLA	R UW B IY AH L AH
RUBEOLAR	R UW B IY AH L AH R
RUBEOLAS	R UW B IY AH L AH Z
RUBES	R UW B Z
RUDBECKIA	R AH D EH K IY AH
RUDBECKIAS	R AH D EH K IY AH Z
SABBED	S AE B D
SABE	S EY B
SABED	S EY B D
SABEING	S EY B IY AH NG
SABER	S EY B ER
SABERED	S EY B ER D
SABERING	S EY B ER IH NG
SABERMETRICIAN	S AH B AH R M EH T R IH S IY AH N
SABERMETRICIANS	S AH B AH R M AH T R IH S IY AH N Z
SABERMETRICS	S EY B ER M EH T R IH K S
SABERS	S EY B ER Z
SABES	S EY B Z
SALMONBERRIES	S AE M AH N B EH R IY Z
SALMONBERRY	S AE M AH N B EH R IY
SANBENITO	S AE N B EH N AH T OW
SANBENITOS	S AE N B EH N AH T AH Z
SAPROBE	S AE P R OW B
SAPROBES	S AE P R OW B Z
SAWTIMBER	S AO T IH M B ER
SAWTIMBERS	S AO T IH M B ER Z
SCABBED	S K AE B D
SCREWBEAN	S K R UW B IY N
SCREWBEANS	S K R UW B IY N Z
SCRIBE	S K R AY B
SCRIBED	S K R AY B D
SCRIBER	S K R AY B ER
SCRIBERS	S K R AY B ER Z
SCRIBES	S K R AY B Z
SCRUBBED	S K R AH B D
SCRUBBER	S K R AH B ER
SCRUBBERS	S K R AH B ER Z
SEABEACH	S IY B IY CH
SEABEACHES	S IY B IY CH IH Z
SEABED	S IY B EH D
SEABEDS	S IY B EH D Z
SEATBELT	S IY T B EH L T
SEATBELTS	S IY T B EH L T S
SEEDBED	S IY D B EH D
SEEDBEDS	S IY D B EH D Z
SERVICEBERRIES	S ER V AH S B EH R IY Z
SERVICEBERRY	S ER V AH S B EH R IY
SHADBERRIES	SH AE D EH R AY Z
SHADBERRY	SH AE D EH R IY
SHEBEAN	SH IY B IY AH N
SHEBEANS	SH IY B IY N Z
SHEBEEN	SH IY B IY AH N
SHEBEENS	SH IY B IY N Z
SHEEPBERRIES	SH IY P B EH R IY Z
SHEEPBERRY	SH IY P B EH R IY
SHELTERBELT	SH EH L T ER B EH L T
SHELTERBELTS	SH EH L T ER B EH L T S
SHERBERT	SH ER B ER T
SHERBERTS	SH AH R B AH R T S
SHERBET	SH ER B AH T
SHERBETS	SH AH R B AH T S
SHRUBBERIES	SH R AH B AH R IY Z
SHRUBBERY	SH R AH B ER IY
SICKBED	S IH K B EH D
SICKBEDS	S IH K B EH D Z
SILVERBERRIES	S IH L V ER B EH R IY Z
SILVERBERRY	S IH L V ER B EH R IY
SKIBOBBER	S K IY B AA B ER
SKIBOBBERS	S K IY B AA B ER Z
SLABBED	S L AE B D
SLABBER	S L AE B ER
SLABBERED	S L AE B ER D
SLABBERING	S L AE B ER IH NG
SLABBERS	S L AE B ER Z
SLABBERY	S L AE B AH R IY
SLOBBER	S L AA B ER
SLOBBERED	S L AA B ER D
SLOBBERER	S L AA B ER ER
SLOBBERERS	S L AA B ER ER Z
SLOBBERING	S L AA B ER IH NG
SLOBBERS	S L AA B ER Z
SLOBBERY	S L AA B AH R IY
SLUBBED	S L AH B D
SLUBBER	S L AH B AH R
SLUBBERED	S L AH B IY R D
SLUBBERING	S L AH B IY R AH NG
SLUBBERS	S L AH B AH R Z
SLUGABED	S L AH G AH B EH D
SLUGABEDS	S L AH G AH B EH D Z
SLUMBER	S L AH M B ER
SLUMBERED	S L AH M B ER D
SLUMBERER	S L AH M B ER ER
SLUMBERERS	S L AH M B ER ER Z
SLUMBERING	S L AH M B ER IH NG
SLUMBEROUS	S L AH M B ER AH S
SLUMBERS	S L AH M B ER Z
SLUMBERY	S L AH M B ER IY
SNIBBED	S N IH B D
SNOBBERIES	S N AA B AH R IY Z
SNOBBERY	S N AA B ER IY
SNOWBELL	S N OW B EH L
SNOWBELLS	S N OW B EH L Z
SNOWBELT	S N OW B EH L T
SNOWBELTS	S N OW B EH L T S
SNOWBERRIES	S N OW B EH R IY Z
SNOWBERRY	S N OW B EH R IY
SNUBBED	S N AH B D
SNUBBER	S N AH B ER
SNUBBERS	S N AH B ER Z
SOAPBERRIES	S OW P B EH R IY Z
SOAPBERRY	S OW P B EH R IY
SOBBED	S AA B D
SOBBER	S AA B ER
SOBBERS	S AA B ER Z
SOBEIT	S OW B IY T
SOBER	S OW B ER
SOBERED	S OW B ER D
SOBERER	S OW B ER ER
SOBEREST	S OW B ER AH S T
SOBERING	S OW B ER IH NG
SOBERIZE	S OW B ER AY Z
SOBERIZED	S OW B ER AY Z D
SOBERIZES	S OW B ER AY Z IH Z
SOBERIZING	S OW B ER AY Z IH NG
SOBERLY	S OW B ER L IY
SOBERNESS	S OW B ER N AH S
SOBERNESSES	S OW B ER N AH S IH Z
SOBERS	S OW B ER Z
SOBERSIDED	S OW B ER S AY D IH D
SOBERSIDEDNESS	S OW B ER S AY D AH D N AH S
SOBERSIDEDNESSES	S OW B ER S AY D AH D N AH S IH Z
SOBERSIDES	S OW B ER S AY D Z
SOMBER	S AA M B ER
SOMBERLY	S AA M B ER L IY
SOMBERNESS	S AA M B ER N AH S
SOMBERNESSES	S AA M B ER N AH S IH Z
SORBED	S AO R B D
SORBENT	S AO R B AH N T
SORBENTS	S AO R B AH N T S
SORBET	S AO R B EY
SORBET(2)	S AO R B EH T
SORBETS	S AO R B AH T S
SOWBELLIES	S AW B EH L IY Z
SOWBELLY	S AW B EH L IY
SOYBEAN	S OY B IY N
SOYBEANS	S OY B IY N Z
SQUIBBED	S K W IH B D
STABBED	S T AE B D
STABBER	S T AE B ER
STABBERS	S T AE B ER Z
STILBENE	S T IH L B IY N
STILBENES	S T IH L B IY N Z
STILBESTROL	S T IH L B EH S T R AH L
STILBESTROLS	S T IH L B EH S T R AH L Z
STOBBED	S T AA B D
STOCKJOBBER	S T AA K JH AA B ER
STOCKJOBBERS	S T AA K JH AA B ER Z
STRAWBERRIES	S T R AO B EH R IY Z
STRAWBERRY	S T R AO B EH R IY
STREAMBED	S T R IY M B EH D
STREAMBEDS	S T R IY M B EH D Z
STROBE	S T R OW B
STROBES	S T R OW B Z
STUBBED	S T AH B D
SUBBED	S AH B D
SUBECHO	S AH B EH K OW
SUBECHOES	S AH B EH K OW Z
SUBECONOMIES	S AH B IH K AA N AH M IY Z
SUBECONOMY	S AH B IH K AA N AH M IY
SUBEDIT	S AH B EH D AH T
SUBEDITED	S AH B EH D AH T IH D
SUBEDITING	S AH B EH D AH T IH NG
SUBEDITOR	S AH B EH D AH T ER
SUBEDITORIAL	S AH B EH D AH T OW R IY AH L
SUBEDITORS	S AH B EH D AH T ER Z
SUBEDITS	S AH B EH D AH T S
SUBEMPLOYED	S AH B IH M P L OY IY D
SUBEMPLOYMENT	S AH B IH M P L OY M AH N T
SUBEMPLOYMENTS	S AH B IH M P L OY M AH N T S
SUBENTRIES	S AH B EH N T R IY Z
SUBENTRY	S AH B EH N T R IY
SUBEPIDERMAL	S AH B EH P AH D AH R M AH L
SUBEPOCH	S AH B EH P AH K
SUBEPOCHS	S AH B EH P AH K S
SUBER	S UW B ER
SUBERECT	S AH B IH R EH K T
SUBERIC	S AH B ER IH K
SUBERIN	S AH B ER IH N
SUBERINS	S AH B ER IH N Z
SUBERISE	S AH B AH R AY Z
SUBERISED	S AH B AH R IY Z D
SUBERISES	S AH B AH R IY Z IH Z
SUBERISING	S AH B AH R IY Z IH NG
SUBERIZATION	S AH B ER AH Z EY SH AH N
SUBERIZATIONS	S AH B ER AH Z EY SH AH N Z
SUBERIZE	S AH B ER AY Z
SUBERIZED	S AH B ER AY Z D
SUBERIZES	S AH B ER AY Z IH Z
SUBERIZING	S AH B ER AY Z IH NG
SUBEROSE	S AH B IH R OW S
SUBEROUS	S AH B ER AH S
SUBERS	S AH B ER Z
SUBSCRIBE	S AH B S K R AY B
SUBSCRIBED	S AH B S K R AY B D
SUBSCRIBER	S AH B S K R AY B ER
SUBSCRIBERS	S AH B S K R AY B ER Z
SUBSCRIBES	S AH B S K R AY B Z
SUBTRIBE	S AH B T R AY B
SUBTRIBES	S AH B T R AY B Z
SUBURBED	S AH B ER B D
SUCCUMBED	S AH K AH M D
SUGARBERRIES	SH UH G ER B EH R IY Z
SUGARBERRY	SH UH G ER B EH R IY
SUNBEAM	S AH N B IY M
SUNBEAMS	S AH N B IY M Z
SUNBEAMY	S AH N B IY M IY
SUNBELT	S AH N B EH L T
SUNBELTS	S AH N B EH L T S
SUPERABSORBENT	S UW P ER AH B Z AO R B AH N T
SUPERABSORBENTS	S UW P ER AH B Z AO R B AH N T S
SUPERBER	S UH P ER B ER
SUPERBEST	S UW P ER B EH S T
SUPERBOMBER	S UW P ER B AA M ER
SUPERBOMBERS	S UW P ER B AA M ER Z
SUPERINCUMBENT	S UW P ER IH N K AH M B AH N T
SUPERINCUMBENTLY	S UW P ER IH N K AH M B AH N T L IY
SUPERSCRIBE	S UW P ER S K R AY B
SUPERSCRIBED	S UW P ER S K R AY B D
SUPERSCRIBES	S UW P ER S K R AY B Z
SVEDBERG	S V EH D AH R G
SVEDBERGS	S V EH D AH R G Z
SWABBED	S W AA B D
SWABBER	S W AA B ER
SWABBERS	S W AA B ER Z
SWOBBED	S W AA B D
SWOBBER	S W AA B AH R
SWOBBERS	S W AA B AH R Z
TABBED	T AE B D
TABER	T EY B ER
TABERED	T AE B ER D
TABERING	T AE B ER IH NG
TABERNACLE	T AE B ER N AE K AH L
TABERNACLED	T AE B ER N AE K AH L D
TABERNACLES	T AE B ER N AE K AH L Z
TABERNACLING	T AE B ER N AE K AH L IH NG
TABERNACULAR	T AH B AH R N AH S Y AH L AH R
TABERS	T AE B ER Z
TABES	T EY B Z
TABETIC	T AE B AH T AH K
TABETICS	T AE B AH T AH S Z
TALEBEARER	T EY L B AE ER ER
TALEBEARERS	T EY L B AE ER ER Z
TALEBEARING	T EY L B AE ER IH NG
TALEBEARINGS	T EY L B AE ER IH NG Z
TEABERRIES	T IY B EH R IY Z
TEABERRY	T IY B EH R IY
TECHNOPHOBE	T EH K N OW F OW B
TECHNOPHOBES	T EH K N OW F OW B Z
TEREBENE	T EH R AH B IY N
TEREBENES	T EH R AH B IY N Z
THEBE	TH IY B
THEBES	TH IY B Z
THIABENDAZOLE	TH AY AH B EH N D AH Z OW L
THIABENDAZOLES	TH AY AH B EH N D AH Z OW L Z
THIMBLEBERRIES	TH IH M B AH L B EH R IY Z
THIMBLEBERRY	TH IH M B AH L B EH R IY
THROBBED	TH R AA B D
THROBBER	TH R AA B ER
THROBBERS	TH R AA B ER Z
THUMBED	TH AH M D
TIMBER	T IH M B ER
TIMBERDOODLE	T IH M B AH R D UW D AH L
TIMBERDOODLES	T IH M B AH R D UW D AH L Z
TIMBERED	T IH M B ER D
TIMBERHEAD	T IH M B ER HH EH D
TIMBERHEADS	T IH M B ER HH EH D Z
TIMBERING	T IH M B ER IH NG
TIMBERINGS	T IH M B ER IH NG Z
TIMBERLAND	T IH M B ER L AE N D
TIMBERLANDS	T IH M B ER L AE N D Z
TIMBERLINE	T IH M B ER L AY N
TIMBERLINES	T IH M B ER L AY N Z
TIMBERMAN	T IH M B ER M AH N
TIMBERMEN	T IH M B ER M EH N
TIMBERS	T IH M B ER Z
TIMBERWORK	T IH M B ER W ER K
TIMBERWORKS	T IH M B ER W ER K S
TOMBED	T UW M D
TORCHBEARER	T AO R CH B AE ER ER
TORCHBEARERS	T AO R CH B AE ER ER Z
TRABEATE	T R EY B IY EY T
TRABEATED	T R EY B IY EY T AH D
TRABEATION	T R EY B IY EY SH AH N
TRABEATIONS	T R EY B IY T IY AH N Z
TRABECULA	T R AE B AH K Y UW L AH
TRABECULAE	T R AE B AH K Y UW L IY
TRABECULAR	T R AH B EH K Y AH L AH R
TRABECULAS	T R AE B AH K Y UW L AH Z
TRABECULATE	T R AH B EH K Y AH L EY T
TRAINBEARER	T R EY N B AE ER ER
TRAINBEARERS	T R EY N B AE ER ER Z
TRANSCRIBE	T R AE N S K R AY B
TRANSCRIBED	T R AE N S K R AY B D
TRANSCRIBER	T R AE N S K R AY B ER
TRANSCRIBERS	T R AE N S K R AY B ER Z
TRANSCRIBES	T R AE N S K R AY B Z
TRIBE	T R AY B
TRIBES	T R AY B Z
TRIBESMAN	T R AY B Z M AE N
TRIBESMEN	T R AY B Z M IH N
TRIBESPEOPLE	T R AY B Z P IY P AH L
TRILOBED	T R AH L OW B D
TUBBED	T AH B D
TUBBER	T AH B ER
TUBBERS	T AH B ER Z
TUBE	T UW B
TUBE(2)	T Y UW B
TUBED	T UW B D
TUBELESS	T UW B L AH S
TUBELIKE	T UW B L AY K
TUBENOSE	T UW B N OW Z
TUBENOSES	T UW B N OW Z IH Z
TUBER	T UW B ER
TUBERCLE	T Y UW B AH R K AH L
TUBERCLES	T Y UW B AH R K AH L Z
TUBERCULAR	T Y UW B AH R K Y AH L AH R
TUBERCULARS	T Y UW B AH R K Y UW L AH R Z
TUBERCULATE	T Y UW B AH R K Y AH L EY T
TUBERCULATED	T Y UW B AH R K Y AH L EY T AH D
TUBERCULIN	T Y UW B AH R K Y UW L AH N
TUBERCULINS	T Y UW B AH R K Y UW L AH N Z
TUBERCULOID	T Y UW B AH R K Y AH L OY D
TUBERCULOSES	T Y UW B AH R K Y AH L OW Z AH Z
TUBERCULOSIS	T AH B ER K Y AH L OW S IH S
TUBERCULOSIS(2)	T UW B ER K Y AH L OW S AH S
TUBERCULOSIS(3)	T UW B ER K Y UW L OW S AH S
TUBERCULOUS	T Y UW B AH R K Y AH L AH S
TUBEROID	T UW B R OW AH D
TUBEROSE	T AH B IH R OW S
TUBEROSES	T AH B IH R OW S IH Z
TUBEROSITIES	T AH B IH R OW S AH T IY Z
TUBEROSITY	T AH B IH R OW S AH T IY
TUBEROUS	T UW B ER AH S
TUBERS	T UW B ER Z
TUBES	T UW B Z
TUBEWORK	T UW B W ER K
TUBEWORKS	T UW B W ER K S
TULLIBEE	T AH L AH B IY IY
TULLIBEES	T AH L AH B IY Z
TURBELLARIAN	T AH R B AH L EH R IY AH N
TURBELLARIANS	T AH R B AH L AE R IY AH N Z
TURBETH	T AH R B AH TH
TURBETHS	T AH R B AH TH S
TWINBERRIES	T W IH N B EH R IY Z
TWINBERRY	T W IH N B EH R IY
ULTRALIBERAL	AH L T R AH L IH B ER AH L
ULTRALIBERALISM	AH L T R AH L IH B ER AH L IH Z AH M
ULTRALIBERALISMS	AH L T R AH L IH B ER AH L IH Z AH M Z
ULTRALIBERALS	AH L T R AH L IH B ER AH L Z
UMBEL	AH M B AH L
UMBELED	AH M B IY L D
UMBELLAR	AH M B EH L AH R
UMBELLATE	AH M B AH L EY T
UMBELLED	AH M B AH L D
UMBELLET	AH M B EH L AH T
UMBELLETS	AH M B EH L AH T S
UMBELLIFER	AH M B AH L AY F AH R
UMBELLIFEROUS	AH M B EH L IH F AH R AH S
UMBELLIFERS	AH M B EH L AH F AH R Z
UMBELS	AH M B AH L Z
UMBER	AH M B ER
UMBERED	AH M B ER D
UMBERING	AH M B ER IH NG
UMBERS	AH M B ER Z
UNABSORBED	AH N AH B Z AO R B D
UNABSORBENT	AH N AH B Z AO R B AH N T
UNBARBED	AH N B AA R B D
UNBARBERED	AH N B AA R B ER D
UNBE	AH N B IY
UNBEAR	AH N B AE ER
UNBEARABLE	AH N B EH R AH B AH L
UNBEARABLY	AH N B EH R AH B L IY
UNBEARED	AH N B AE ER D
UNBEARING	AH N B AE ER IH NG
UNBEARS	AH N B AE ER Z
UNBEATABLE	AH N B IY T AH B AH L
UNBEATABLY	AH N B IY T AH B L IY
UNBEATEN	AH N B IY T AH N
UNBEAUTIFUL	AH N B Y UW T IY F AH L
UNBEAUTIFULLY	AH N B Y UW T IY F AH L IY
UNBECOMING	AH N B IH K AH M IH NG
UNBECOMING(2)	AH N B IY K AH M IH NG
UNBECOMINGLY	AH N B IH K AH M IH NG L IY
UNBECOMINGNESS	AH N B IH K AH M IH NG N AH S
UNBECOMINGNESSES	AH N B IH K AH M IH NG N AH S IH Z
UNBEFITTING	AH N B IH F IH T IH NG
UNBEHOLDEN	AH N B IH HH OW L D AH N
UNBEKNOWN	AH N B IH N OW N
UNBEKNOWN(2)	AH N B IY N OW N
UNBEKNOWNST	AH N B IY N OW N S T
UNBELIEF	AH N B AH L IY F
UNBELIEFS	AH N B AH L IY F S
UNBELIEVABLE	AH N B AH L IY V AH B AH L
UNBELIEVABLY	AH N B AH L IY V AH B L IY
UNBELIEVER	AH N B AH L IY V ER
UNBELIEVERS	AH N B AH L IY V ER Z
UNBELIEVING	AH N B AH L IY V IH NG
UNBELIEVINGLY	AH N B AH L IY V IH NG L IY
UNBELLIGERENT	AH N B AH L IH JH ER AH N T
UNBELOVED	AH N B IH L AH V D
UNBELT	AH N B EH L T
UNBELTED	AH N B EH L T IH D
UNBELTING	AH N B EH L T IH NG
UNBELTS	AH N B EH L T S
UNBEMUSED	AH N B IH M Y UW Z D
UNBEND	AH N B EH N D
UNBENDABLE	AH N B EH N D AH B AH L
UNBENDED	AH N B EH N D IH D
UNBENDING	AH N B EH N D IH NG
UNBENDS	AH N B EH N D Z
UNBENIGN	AH N B IH N AY N
UNBENT	AH N B IY AH N T
UNBESEEMING	AH N B IH S IY M IH NG
UNCOMBED	AH N K AH M B EH D
UNCURBED	AH N K ER B D
UNDERBELLIES	AH N D ER B EH L IY Z
UNDERBELLY	AH N D ER B EH L IY
UNDISTURBED	AH N D IH S T ER B D
UNDUBBED	AH N D AH B D
UNEMBELLISHED	AH N IH M B EH L IH SH T
UNENCUMBERED	AH N EH N K AH M B ER D
UNILOBED	Y UW N IH L OW B D
UNLABELED	AH N L EY B AH L D
UNLIBERATED	AH N L IH B ER EY T IH D
UNLIMBER	AH N L IH M B ER
UNLIMBERED	AH N L IH M B ER D
UNLIMBERING	AH N L IH M B ER IH NG
UNLIMBERS	AH N L IH M B ER Z
UNLOBED	AH N L OW B D
UNNUMBERED	AH N AH M B ER D
UNPERTURBED	AH N P ER T ER B D
UNPLUMBED	AH N P L AH M D
UNPROBED	AH N P R OW B EH D
UNREMEMBERED	AH N R IH M EH M B ER D
UNROBE	AH N R OW B
UNROBED	AH N R OW B D
UNROBES	AH N R OW B Z
UNSOBER	AH N S OW B ER
UPBEAR	AH P B AE ER
UPBEARER	AH P B AE ER ER
UPBEARERS	AH P B AE ER ER Z
UPBEARING	AH P B AE ER IH NG
UPBEARS	AH P B AE ER Z
UPBEAT	AH P B IY T
UPBEATS	AH P B IY T S
UPCLIMBED	AH P K L AY M D
VERBENA	V ER B IY N AH
VERBENAS	V ER B IY N AH Z
VIBE	V AY B
VIBES	V AY B Z
WANNABE	W AA N AH B IY
WANNABES	W AA N AH B IY Z
WARDROBE	W AO R D R OW B
WARDROBES	W AO R D R OW B Z
WATERBED	W AO T ER B EH D
WATERBEDS	W AO T ER B EH D Z
WAXBERRIES	W AE K S B EH R IY Z
WAXBERRY	W AE K S B EH R IY
WEBBED	W EH B D
WEBER	W EH B ER
WEBERS	W EH B ER Z
WHITEBEARD	W AY T B IH ER D
WHITEBEARDS	W AY T B IH ER D Z
WHORTLEBERRIES	W AH R T L AH B EH R AY Z
WHORTLEBERRY	W AH R T L AH B EH R IY
WILDEBEEST	W IH L D IY B IY AH S T
WILDEBEESTS	W IH L D AH B IY S T S
WINTERBERRIES	W IH N T ER B EH R IY Z
WINTERBERRY	W IH N T ER B EH R IY
WOBEGONE	W AA B AH G OW N
WOEBEGONE	W OW B IH G AO N
WOEBEGONENESS	W OW B IH G AO N AH S
WOEBEGONENESSES	W OW B IH G AO N AH S IH Z
WOLFBERRIES	W UH L F B EH R IY Z
WOLFBERRY	W UH L F B EH R IY
WOMBED	W UW M D
WORKBENCH	W ER K B EH N CH
WORKBENCHES	W ER K B EH N CH IH Z
XEBEC	Z EH B AH K
XEBECS	Z EH B AH K S
XENOPHOBE	Z EH N AH F OW B
XENOPHOBES	Z EH N AH F OW B Z
YABBER	Y AE B AH R
YABBERED	Y AE B IY R D
YABBERING	Y AE B IY R AH NG
YABBERS	Y AE B AH R Z
YOUNGBERRIES	Y AH NG B EH R IY Z
YOUNGBERRY	Y AH NG B EH R IY
ZEBEC	Z EH B AH K
ZEBECK	Z EH B AH K
ZEBECKS	Z EH B AH K S
ZEBECS	Z EH B AH K S
ZEITGEBER	Z IY T JH IY B AH R
ZEITGEBERS	Z IY T JH AH B AH R Z
ZIBELINE	Z IH B AH L AY N
ZIBELINES	Z IH B AH L AY N Z
ZIBELLINE	Z IH B AH L AY N
ZIBELLINES	Z IH B AH L AY N Z
ZIBET	Z IH B AH T
ZIBETH	Z AY B AH TH
ZIBETHS	Z IH B AH TH S
ZIBETS	Z IH B AH T S
ZOOPHOBE	Z UW F OW B
ZOOPHOBES	Z UW F OW B Z
EEL	IY L
PFUI	F UW
NO	N OW
UXORIAL	AH K S AO R IY AH L
IXIA	IH K S IY AH
VOW	V AW
HE	HH IY
