CA	K AH
CA(2)	S IY EY
CA(3)	K AA
ABACA	AE B AH K AH
ABACAS	AE B AH K AH Z
ABAPICAL	AE B AH P IH S AH L
ABDICABLE	AE B D IH S AH B AH L
ABDICATE	AE B D AH K EY T
ABDICATED	AE B D AH K EY T AH D
ABDICATES	AE B D AH K EY T S
ABDICATING	AE B D IH K EY T IH NG
ABDICATION	AE B D IH K EY SH AH N
ABDICATIONS	AE B D AH K EY T IY AH N Z
ABDICATOR	AE B D AH S EY T AH R
ABDICATORS	AE B D IH K AH T AH R Z
ABIOGENICALLY	EY B IY AH JH EH N AH K AE L IY
ABIOLOGICAL	AH B AY AH L AA JH IH K AH L
ABIOTICALLY	AH B AY AA T IH K AH L IY
ABRACADABRA	AE B R AH K AH D AE B R AH
ABRACADABRAS	AE B R AH K AH D AE B R AH Z
ACACIA	AH K EY SH AH
ACACIAS	AH K EY SH AH Z
ACADEME	AE K AH D IY M
ACADEMES	AE K AH D IY M Z
ACADEMIA	AE K AH D IY M IY AH
ACADEMIAS	AE K AH D IY M IY AH Z
ACADEMIC	AE K AH D EH M IH K
ACADEMICAL	AE K AH D EH M IH K AH L
ACADEMICALLY	AE K AH D EH M IH K L IY
ACADEMICIAN	AE K AH D AH M IH SH AH N
ACADEMICIANS	AE K AH D AH M IH SH AH N Z
ACADEMICIANS(2)	AH K AE D AH M IH SH AH N Z
ACADEMICISM	AE K AH D EH M IH K IH Z AH M
ACADEMICISMS	AE K AH D EH M IH K IH Z AH M Z
ACADEMICS	AE K AH D EH M IH K S
ACADEMIES	AH K AE D AH M IY Z
ACADEMISM	AE K AH D AH M IH Z AH M
ACADEMISMS	AH K AE D AH M AH Z AH M Z
ACADEMY	AH K AE D AH M IY
ACAJOU	AE K AH JH UW
ACAJOUS	AE K AH JH AH S
ACALEPH	AE K AH L AH F
ACALEPHAE	AH K AE L AH F IY
ACALEPHE	AE K AH L AH F
ACALEPHES	AE K AH L AH F S
ACALEPHS	AE K AH L AH F S
ACANTHI	AH K AE N TH IY
ACANTHOCEPHALAN	AH K AE N TH AH S EH F AH L AH N
ACANTHOCEPHALANS	AH K AE N TH AH S EH F AH L AH N Z
ACANTHUS	AH K AE N DH AH S
ACANTHUSES	AH K AE N DH AH S IH Z
ACAPNIA	AH K AE P N IY AH
ACAPNIAS	AH K AE P N IY AH Z
ACARI	AE K AH R IY
ACARIASES	AH K AE R IY EY Z AH Z
ACARIASIS	AE K AH R IY AH S AH S
ACARICIDAL	AH K EH R IH K S AH S AH D AH L
ACARICIDE	AH K AE R AH S AY D
ACARICIDES	AH K AE R AH S AY D Z
ACARID	AH K EH R AH D
ACARIDAN	AH K AE R AH D AH N
ACARIDANS	AH K AE R AH D AH N Z
ACARIDS	AH K EH R AH D Z
ACARINE	AE K AH R AY N
ACARINES	AE K AH R AY N Z
ACAROID	AE K AH R OY D
ACARPOUS	AH K AA R P AH S
ACARUS	AE K AH R AH S
ACATALECTIC	AH K AE T AH L AH K T AH K
ACATALECTICS	AH K AE T AH L EH K T AH S Z
ACAUDAL	AE K AH D AH L
ACAUDATE	AE K AH D EY T
ACAULESCENT	AE K EY AH L EH S AH N T
ACAULINE	AE K AH L AY N
ACAULOSE	AE K AH L OW Z
ACAULOUS	AH K EY AH L AH S
ACCIACCATURA	AE K S IY AH K AE T Y AH R AH
ACCIACCATURAS	AE K S IY AH K AE T Y AH R AH Z
ACCIACCATURE	AE K S IY AH K EY T Y AH R
ACERBICALLY	EY S ER B AY K AO L IY
ACETIFICATION	AH S EH T AH F AH K EY SH AH N
ACETIFICATIONS	AH S EH T AH F AH K EY T IY AH N Z
ACHROMATICALLY	AH K R OW M AE T IH K AH L IY
ACIDIFICATION	AH S IH D AH F AH K EY SH AH N
ACIDIFICATIONS	AE S AH D AH F AH K EY SH AH N Z
ACOUSTICAL	AH K UW S T IH K AH L
ACOUSTICALLY	AH K UW S T IH K L IY
ACROBATICALLY	AE K R AH B AE T IH K AH L IY
ACRONYMICALLY	AH K R OW N IY M AY S AH L IY
ACROSTICAL	AE K R AA S T IH S AH L
ACROSTICALLY	AE K R AA S T AH K AE L IY
ACTINICALLY	AE K T IH N IH K AH L IY
ADENOCARCINOMA	AH D EH N AH K AH R S IH N AH M AH
ADENOCARCINOMAS	AH D EH N AH K AH R S IH N AH M AH Z
ADENOCARCINOMATA	AH D AH N AH K AA R S AH N AA M AH T AH
ADENOCARCINOMATOUS	AH D EH N AH K AA R S AH N AA M AH T AH S
ADIABATICALLY	EY D IY AH B AE T AH K AE L IY
ADJUDICATE	AH JH UW D IH K EY T
ADJUDICATED	AH JH UW D AH K EY T IH D
ADJUDICATES	AH JH UW D IH K AH T S
ADJUDICATING	AH JH UW D IH K EY T IH NG
ADJUDICATION	AH JH UW D AH K EY SH AH N
ADJUDICATIONS	AH JH UW D IH K EY SH AH N Z
ADJUDICATIVE	AH JH UW D IH K AH T IH V
ADJUDICATOR	AH JH UW D IH K AH T ER
ADJUDICATORS	AH JH UW D IH K AH T ER Z
ADJUDICATORY	AH JH UW D IH K AH T OW R IY
ADRENERGICALLY	AE D R AH N AH R JH AH K AE L IY
ADRENOCORTICAL	AE D R EH N AH K AO R T IH S AH L
ADUNCATE	AH D AH N K EY T
ADVOCACIES	AE D V AH K AH S IY Z
ADVOCACY	AE D V AH K AH S IY
ADVOCATE	AE D V AH K AH T
ADVOCATE(2)	AE D V AH K EY T
ADVOCATED	AE D V AH K EY T IH D
ADVOCATES	AE D V AH K AH T S
ADVOCATES(2)	AE D V AH K EY T S
ADVOCATING	AE D V AH K EY T IH NG
ADVOCATION	AE D V AH K EY SH AH N
ADVOCATIONS	AE D V AH K EY SH AH N Z
ADVOCATIVE	AE D V AH K AH T IH V
ADVOCATOR	AE D V AH K AH T ER
ADVOCATORS	AE D V AH K AH T ER Z
AEROBICALLY	EH R OW B IH K L IY
AEROBIOLOGICAL	EH R AH B IY AA L AH JH IH S AH L
AERODYNAMICAL	AE R OW D AY N AE M IH K AH L
AERODYNAMICALLY	EH R OW D AY N AE M IH K L IY
AEROMEDICAL	AH R AA M AH D IH S AH L
AERONAUTICAL	EH R OW N AA T AH K AH L
AERONAUTICAL(2)	EH R AH N AA T AH K AH L
AERONAUTICALLY	AE R AH N AO T IH K AH L IY
AERONOMICAL	AH R AA N AH M IH S AH L
AESTHETICAL	EH S TH EH T IH K AH L
AESTHETICALLY	EH S TH EH T IH K L IY
AFFRICATE	AE F R AH K AH T
AFFRICATES	AE F R AH K AH T S
AFFRICATIVE	AE F R AH S EY T AH V
AFFRICATIVES	AE F R AH S EY T AH V Z
AFTERCARE	AE F T ER K EH R
AFTERCARES	AE F T ER K EH R Z
AGONISTICALLY	AH G AO N IH S T IH K AH L IY
AGRICHEMICAL	AE G R IH K AH M IH S AH L
AGRICHEMICALS	AE G R AH K EH M AH K AH L Z
AGROCHEMICAL	AE G R OW K EH M IH K AH L
AGROCHEMICALS	AE G R OW K EH M IH K AH L Z
AGRONOMICALLY	AE G R AH N AA M AH K AE L IY
AHISTORICAL	AH HH IH S T AO R IH K AH L
AIRSCAPE	AH IH R S K EY P
AIRSCAPES	AH IH R S K EY P S
ALCADE	AE L K EY D
ALCADES	AE L K EY D Z
ALCAHEST	AE L K AH AH S T
ALCAHESTS	AE L K AH HH AH S T S
ALCAIC	AE L K EY AH K
ALCAICS	AE L K EY AH S Z
ALCAIDE	AE L K EY D
ALCAIDES	AE L K EY D Z
ALCALDE	AE L K AH L D
ALCALDES	AE L K AH L D Z
ALCAYDE	AE L K EY D
ALCAYDES	AE L K EY D Z
ALCAZAR	AA L K AH Z AA R
ALCAZARS	AE L K AH Z AH R Z
ALCHEMICAL	AE L K AH M IH S AH L
ALCHEMICALLY	AE L K EH M AH K L IY
ALCHEMISTICAL	AE L K AH M IH S T IH S AH L
ALCOHOLICALLY	AE L K AH HH AO L IH K AH L IY
ALGEBRAICALLY	AE L JH AH B R EY IH K L IY
ALGOLOGICAL	AE L G AA L AH JH IH S AH L
ALGORITHMICALLY	AE L G AH R IH DH AH M IH K AH L IY
ALLEGORICAL	AE L AH G AO R IH K AH L
ALLEGORICALLY	AH L EH JH ER IH K AH L IY
ALLEGORICALNESS	AH L EH JH ER IH K AH L N AH S
ALLEGORICALNESSES	AH L EH JH ER IH K AH L N AH S IH Z
ALLOCABLE	AE L AH K AH B AH L
ALLOCATABLE	AE L AH K AH T AH B AH L
ALLOCATE	AE L AH K EY T
ALLOCATED	AE L AH K EY T IH D
ALLOCATES	AE L AH K EY T S
ALLOCATING	AE L AH K EY T IH NG
ALLOCATION	AE L AH K EY SH AH N
ALLOCATIONS	AE L AH K EY SH AH N Z
ALLOCATOR	AE L AH K EY T ER
ALLOCATORS	AE L AH K EY T ER Z
ALLOPATRICALLY	AE L AH P AE T R AH K AE L IY
ALLOSTERICALLY	AE L AA S T EH R AH K AE L IY
ALLOTYPICALLY	AE L AH T IH P AH K AE L IY
ALOGICAL	AH L AA JH IH K AH L
ALOGICALLY	AH L AA JH IH K AH L IY
ALPACA	AE L P AE K AH
ALPACAS	AE L P AH K AH Z
ALPHABETICAL	AE L F AH B EH T IH K AH L
ALPHABETICALLY	AE L F AH B EH T IH K L IY
ALPHANUMERICAL	AE L F AH N UH M EH R IH K AH L
ALPHANUMERICALLY	AE L F AH N UH M EH R IH K AH L IY
ALTERCATE	AO L T ER K EY T
ALTERCATED	AO L T ER K EY T IH D
ALTERCATES	AO L T ER K EY T S
ALTERCATING	AO L T ER K EY T IH NG
ALTERCATION	AA L T ER K EY SH AH N
ALTERCATIONS	AA L T ER K EY SH AH N Z
ALTRUISTICALLY	AE L T R UH IH S T IH K AH L IY
ALUMINOSILICATE	AH L UW M AH N OW S IH L AH K EY T
ALUMINOSILICATES	AE L AH M IH N AA S IH L AY S AH T S
AMBUSCADE	AE M B AH S K EY D
AMBUSCADED	AE M B AH S K EY D IH D
AMBUSCADER	AE M B AH S K EY D ER
AMBUSCADERS	AE M B AH S K EY D ER Z
AMBUSCADES	AE M B AH S K EY D Z
AMBUSCADING	AE M B AH S K EY D IH NG
AMICABILITIES	AH M AY K AH B AY L AH T IY Z
AMICABILITY	AH M AY K AH B AY L AH T IY
AMICABLE	AE M IH K AH B AH L
AMICABLENESS	AE M IH K AH B AH L N AH S
AMICABLENESSES	AE M IH K AH B AH L N AH S IH Z
AMICABLY	AE M IH K AH B L IY
AMITOTICALLY	AE M AH T AA T AH K AE L IY
AMMONIACAL	AH M OW N IY AE K AH L
AMMONIFICATION	AE M AA N AH F AH K EY SH AH N
AMMONIFICATIONS	AE M AA N AH F AH K EY T IY AH N Z
AMPHITHEATRICAL	AE M F AH TH IY T R IH S AH L
AMPHITHEATRICALLY	AE M F AH TH IY T R AH K AE L IY
AMPLIFICATION	AE M P L AH F AH K EY SH AH N
AMPLIFICATIONS	AE M P L AH F AH K EY SH AH N Z
ANACHRONISTICALLY	AH N AE K R AH N IH S T IH K AH L IY
ANACOLUTHICALLY	AE N AH K AH L AH TH AH K AE L IY
ANAEROBICALLY	AE N AH R OW B IH K AH L IY
ANAGOGICAL	AH N AE G AH JH IH S AH L
ANAGOGICALLY	AE N AH G AA JH AH K AE L IY
ANAGRAMMATICAL	AE N AH G R AE M AH T IH K AH L
ANAGRAMMATICALLY	AE N AH G R AE M AH T IH K AH L IY
ANALOGICAL	AH N AE L AH JH IH S AH L
ANALOGICALLY	AE N AH L AA JH AH K AE L IY
ANALYTICAL	AE N AH L IH T IH K AH L
ANALYTICALLY	AE N AH L IH T IH K L IY
ANAPHORICALLY	AE N AH F AO R AH K AE L IY
ANAPHYLACTICALLY	AE N AH F AH L AE K T AH K AE L IY
ANARCHICAL	AE N AA R K IH K AH L
ANARCHICALLY	AE N AA R K IH K AH L IY
ANASARCA	AE N AH S AA R K AH
ANASARCAS	AE N AH S AA R K AH Z
ANATOMICAL	AE N AH T AA M IH K AH L
ANATOMICALLY	AE N AH T AA M AH K L IY
ANCHORITICALLY	AE NG K AH R AY T IH K AH L IY
ANECDOTICAL	AE N IH K D OW T IH K AH L
ANECDOTICALLY	AE N IH K D OW T IH K AH L IY
ANEMICALLY	AH N IY M IH K AH L IY
ANESTHETICALLY	AE N AH S TH EH T IH K AH L IY
ANGELICA	AE N JH EH L IH K AH
ANGELICA(2)	AE N JH AH L IY K AH
ANGELICAL	AE N JH EH L IH K AH L
ANGELICALLY	AE N JH EH L IH K L IY
ANGELICAS	AE N JH EH L IH K AH Z
ANGIOCARDIOGRAPHIC	AE N JH IY AH K AA R D IY AA G R AH F AH K
ANGIOCARDIOGRAPHIES	AE N JH IY AH K AA R D IY AA G R AH F AY Z
ANGIOCARDIOGRAPHY	AE N JH IY AH K AA R D IY AA G R AH F IY
ANISOTROPICALLY	AE N AH S AA T R AA P AH K AE L IY
ANODICALLY	AE N OW D IH K AH L IY
ANTAGONISTICALLY	AE N T AE G AH N IH S T IH K AH L IY
ANTHOLOGICAL	AE N TH AA L AH JH IH S AH L
ANTHROPICAL	AE N TH R AH P IH S AH L
ANTHROPOCENTRICALLY	AE N TH R AH P AH S EH N T R AH K AE L IY
ANTHROPOLOGICAL	AE N TH R AH P AH L AA JH AH K AH L
ANTHROPOLOGICALLY	AE N TH R AH P AH L AA JH IH K AH L IY
ANTHROPOMORPHICALLY	AE N TH R AH P AH M AO R F IH K AH L IY
ANTIACADEMIC	AE N T AY AE K AH D EH M IH K
ANTIACADEMICS	AE N T AY AE K AH D EH M IH K S
ANTIBIOTICALLY	AE N T AY B AY AA T IH K AH L IY
ANTICAKING	AE N T AY K EY K IH NG
ANTICALLY	AE N T AY K AO L IY
ANTICANCER	AE N T AY K AE N S ER
ANTICANCER(2)	AE N T IY K AE N S ER
ANTICAPITALISM	AE N T AY K AE P AH T AH L IH Z AH M
ANTICAPITALISMS	AE N T AY K AE P AH T AH L IH Z AH M Z
ANTICAPITALIST	AE N T AY K AE P AH T AH L IH S T
ANTICAPITALISTS	AE N T AY K AE P AH T AH L IH S T S
ANTICAR	AE N T AY K AA R
ANTICARCINOGEN	AE N T AH K AA R S IH N AH JH AH N
ANTICARCINOGENIC	AE N T AH K AA R S IH N AH JH AH N AH K
ANTICARCINOGENS	AE N T AH K AA R S IH N AH JH AH N Z
ANTICARIES	AE N T IH K EH R IY Z
ANTICATALYST	AE N T AY K AE T AH L AH S T
ANTICATALYSTS	AE N T AY K AE T AH L AH S T S
ANTICATHODE	AE N T AY K AE TH OW D
ANTICATHODES	AE N T AY K AE TH OW D Z
ANTICLASSICAL	AE N T AY K L AE S IH K AH L
ANTICLERICAL	AE N T AY K L EH R IH K AH L
ANTICLERICALISM	AE N T AY K L EH R IH K AH L IH Z AH M
ANTICLERICALISMS	AE N T AY K L EH R IH K AH L IH Z AH M Z
ANTICLERICALIST	AE N T AY K L EH R IH K AH L IH S T
ANTICLERICALISTS	AE N T AY K L EH R IH K AH L IH S T S
ANTICLERICALS	AE N T AY K L EH R IH K AH L Z
ANTICLIMACTICAL	AE N T AY K L AY M AE K T IH K AH L
ANTICLIMACTICALLY	AE N T AY K L AY M AE K T IH K AH L IY
ANTIDESERTIFICATION	AE N T AY D EH Z ER T AH F AH K EY SH AH N
ANTIDESICCANT	AE N T AY D IY S IH K AH N T
ANTIDESICCANTS	AE N T AY D IY S IH K AH N T S
ANTIDROMICALLY	AE N T AY D R AA M AH K AE L IY
ANTIEDUCATIONAL	AE N T AY EH JH AH K EY SH AH N AH L
ANTIFERROMAGNETICALLY	AE N T AY F EH R OW M AE G N EH T IH K AH L IY
ANTIGENICALLY	AE N T IH JH AH N IH K AH L IY
ANTIHIERARCHICAL	AE N T AH HH AH R AA R K IH S AH L
ANTIHISTORICAL	AE N T AY HH IH S T AO R IH K AH L
ANTILOGICAL	AE N T AY L AA JH IH K AH L
ANTIMACASSAR	AE N T AH M AE K AH S AH R
ANTIMACASSARS	AE N T AH M AH K AE S AH R Z
ANTIMETAPHYSICAL	AE N T AY M EH T AH F IH Z IH K AH L
ANTIMONARCHICAL	AE N T AY M AA N AA R K IH K AH L
ANTIMUSICAL	AE N T AY M Y UW Z IH K AH L
ANTIPATHETICALLY	AE N T AY P AH TH EH T IH K AH L IY
ANTIPOLITICAL	AE N T AY P AH L IH T IH K AH L
ANTIRADICAL	AE N T AY R AE D IH K AH L
ANTIRADICALISM	AE N T AY R AE D IH K AH L IH Z AH M
ANTIRADICALISMS	AE N T AY R AE D IH K AH L IH Z AH M Z
ANTISEPTICALLY	AE N T AH S EH P T IH K AH L IY
ANTISTROPHICALLY	AE N T AY S T R OW F IY IH K AH L IY
ANTITECHNOLOGICAL	AE N T AY T EH K N AH L AA JH IH K AH L
ANTITHEORETICAL	AE N T AY TH IY AH R EH T IH K AH L
ANTITHETICAL	AE N T AH TH EH T IH K AH L
ANTITHETICALLY	AE N T AH TH EH T IH K AH L IY
AORISTICALLY	AH OW R IH S T IH K AH L IY
APATHETICALLY	AE P AH TH EH T IH K AH L IY
APERIODICALLY	AH P IH R IY AA D IH K AH L IY
APHETICALLY	AH F EH T AH K AE L IY
APHORISTICALLY	AE F AH R IH S T AH K AE L IY
APHRODISIACAL	AE F R AH D AH S IY AH S AH L
APICAL	EY P IH K AH L
APICALLY	EY P IH K AH L IY
APICALS	EY P IH K AH L Z
APOCALYPSE	AH P AA K AH L IH P S
APOCALYPSES	AH P AA K AH L IH P S IH Z
APOCALYPTIC	AH P AA K AH L IH P T IH K
APOCALYPTICAL	AH P AA K AH L IH P T IH K AH L
APOCALYPTICALLY	AH P AA K AH L IH P T IH K AH L IY
APOCALYPTICISM	AH P AA K AH L IH P T IH K IH Z AH M
APOCALYPTICISMS	AH P AA K AH L IH P T IH K IH Z AH M Z
APOCALYPTISM	AH P AA K AH L AH P T IH Z AH M
APOCALYPTISMS	AE P AH K AH L IH P T AH Z AH M Z
APOCALYPTIST	AH P AA K AH L IH P T AH S T
APOCALYPTISTS	AE P AH K AH L IH P T AH S T S
APOCARP	AE P AH K AH R P
APOCARPIES	AE P AH K AA R P AY Z
APOCARPS	AE P AH K AH R P S
APOCARPY	AE P AH K AA R P IY
APODICTICALLY	AE P AH D IH K T AH K AE L IY
APOLITICAL	EY P AH L IH T IH K AH L
APOLITICALLY	AH P AH L IH T IH K AH L IY
APOLOGETICALLY	AH P AA L AH JH EH T IH K L IY
APOMICTICALLY	AE P AH M IH K T AH K AE L IY
APOPLECTICALLY	AE P AH P L EH K T AH K AE L IY
APOSEMATICALLY	AH P OW Z M EY T IH K AH L IY
APOTHECARIES	AH P AA TH AH K EH R IY Z
APOTHECARY	AH P AA TH AH K EH R IY
APOTROPAICALLY	AH P AA T R AH P AH K AE L IY
APPLECART	AE P AH L K AA R T
APPLECARTS	AE P AH L K AA R T S
APPLICABILITIES	AE P L IH K AH B IH L AH T EH Z
APPLICABILITY	AE P L AH K AH B IH L AH T IY
APPLICABLE	AE P L AH K AH B AH L
APPLICANT	AE P L IH K AH N T
APPLICANTS	AE P L IH K AH N T S
APPLICATION	AE P L AH K EY SH AH N
APPLICATIONS	AE P L AH K EY SH AH N Z
APPLICATIVE	AE P L IH K AH T IH V
APPLICATIVELY	AE P L IH K AH T IH V L IY
APPLICATOR	AE P L AH K EY T ER
APPLICATORS	AE P L AH K EY T ER Z
APPLICATORY	AE P L IH K AH T OW R IY
AQUACADE	AE K W AH K EY D
AQUACADES	AE K W AH K EY D Z
AQUATICALLY	AE K W AA T AH K AE L IY
ARABICA	ER AE B IH K AH
ARABICAS	AH R AE B AH K AH Z
ARAUCARIA	AE R AH K AE R IY AH
ARAUCARIAN	AE R AH K EH R IY AH N
ARAUCARIAS	AE R AH K AE R IY AH Z
ARCADE	AA R K EY D
ARCADED	AA R K EY D IH D
ARCADES	AA R K EY D Z
ARCADIA	AA R K EY D IY AH
ARCADIAN	AA R K EY D IY AH N
ARCADIANS	AA R K EY D IY AH N Z
ARCADIAS	AA R K EY D IY AH Z
ARCADING	AA R K EY D IH NG
ARCADINGS	AA R K EY D IH NG Z
ARCANA	AA R K AE N AH
ARCANE	AA R K EY N
ARCANUM	AA R K AH N AH M
ARCANUMS	AA R K AH N AH M Z
ARCATURE	AA R K AH CH ER
ARCATURES	AA R K AH CH ER Z
ARCHAEOLOGICAL	AA R K IY AH L AA JH IH K AH L
ARCHAEOLOGICALLY	AA R K IY AH L AA JH IH K AH L IY
ARCHAICALLY	AA R K EY IH K AH L IY
ARCHDUCAL	AA R K D Y UW K AH L
ARCHEOLOGICAL	AA R K IY AH L AA JH IH K AH L
ARCHEOLOGICALLY	AA R K IY AH L AA JH AH K AE L IY
ARCHETYPICAL	AA R K EH T AH P IH S AH L
ARCHITECTONICALLY	AA R K AH T EH K T AA N IH K AH L IY
ARCTICALLY	AA R K T IH K AH L IY
ARECA	AE R AH K AH
ARECAS	AE R AH K AH Z
ARISTOCRATICALLY	AH R IH S T AH K R AE T IH K AH L IY
ARITHMETICAL	AE R IH TH M EH T IH K AH L
ARITHMETICALLY	AE R IH TH M EH T IH K AH L IY
ARMONICA	AA R M AA N AH K AH
ARMONICAS	AA R M AA N AH K AH Z
ARNICA	AA R N IH K AH
ARNICAS	AA R N IH K AH Z
AROMATICALLY	AE R AH M AE T IH K AH L IY
ARSENICAL	AA R S N IH K AH L
ARSENICALS	AA R S N IH K AH L Z
ARTHRITICALLY	AA R TH R IH T AH K AE L IY
ARTISTICALLY	AA R T IH S T IH K L IY
ASCARIASES	AE S AE R IY EY Z AH Z
ASCARIASIS	AE S AH R IY AH S AH S
ASCARID	AH S K EH R AH D
ASCARIDES	AE S AH R AY D Z
ASCARIDS	AH S K EH R AH D Z
ASCARIS	AH S K EH R IY Z
ASCETICAL	AH S EH T IH K AH L
ASCETICALLY	AH S EH T IH K AH L IY
ASCOCARP	AH Z K OW K AA R P
ASCOCARPIC	AH Z K OW K AA R P IH K
ASCOCARPS	AH Z K OW K AA R P S
ASEPTICALLY	EY S EH P T IH K AH L IY
ASHCAN	AE SH K AE N
ASHCANS	AE SH K AE N Z
ASPHERICAL	AH S F IH ER IH K AH L
ASTHMATICALLY	AH Z TH M EY T IH K AH L IY
ASTROLOGICAL	AE S T R AH L AA JH IH K AH L
ASTROLOGICALLY	AE S T R AH L AA JH AH K AE L IY
ASTRONAUTICAL	AE S T R AH N AA T IH K AH L
ASTRONAUTICALLY	AE S T R AH N AO T IH K AH L IY
ASTRONOMICAL	AE S T R AH N AA M IH K AH L
ASTRONOMICALLY	AE S T R AH N AA M IH K L IY
ASTROPHYSICAL	AH S T R OW F IY IY S IH K AH L
ASTROPHYSICALLY	AH S T R OW F IY IY S IH K AH L IY
ASYMMETRICAL	EY S AH M EH T R IH K AH L
ASYMMETRICALLY	EY S AH M EH T R IH K AH L IY
ASYMPTOMATICALLY	AH S IH M P T AH M AE T IH K AH L IY
ASYMPTOTICALLY	AE S AH M T AA T IH K AH L IY
ASYNDETICALLY	AH S IH N D EH T AH K AE L IY
ATAVISTICALLY	AE T AH V IH S T IH K AH L IY
ATHEISTICAL	EY TH IY IH S T IH K AH L
ATHEISTICALLY	EY TH IY IH S T IH K AH L IY
ATHEORETICAL	AH TH IY AH R EH T IH K AH L
ATHLETICALLY	AE TH L EH T IH K L IY
ATMOSPHERICALLY	AE T M AH S F IH ER IH K AH L IY
ATOMICAL	AH T AA M IH K AH L
ATOMICALLY	AH T AA M IH K AH L IY
ATOMISTICALLY	AE T AH M IH S T IH K AH L IY
ATYPICAL	EY T IH P IH K AH L
ATYPICALITIES	AH T IH P AH K AE L AH T IY Z
ATYPICALITY	AH T IH P AH K AE L AH T IY
ATYPICALLY	EY T IH P IH K AH L IY
AUDIOCASSETTE	AH D IY AA K AH S EH T
AUDIOCASSETTES	AH D IY AH K AE S EH T S
AUDIOLOGICAL	AO D IY OW L AA JH IH K AH L
AUTARCHICAL	AH T AA R K IH S AH L
AUTARKICAL	AH T AA R K IH S AH L
AUTECOLOGICAL	AO T AH K AA L AH JH IH S AH L
AUTHENTICALLY	AO TH EH N T IH K L IY
AUTHENTICALLY(2)	AO TH EH N IH K L IY
AUTHENTICATE	AO TH EH N T AH K EY T
AUTHENTICATED	AO TH EH N T AH K EY T AH D
AUTHENTICATES	AO TH EH N T IH K AH T S
AUTHENTICATING	AO TH EH N T AH K EY T IH NG
AUTHENTICATION	AO TH EH N T AH K EY SH AH N
AUTHENTICATIONS	AO TH EH N T AH K EY SH AH N Z
AUTHENTICATOR	AO TH EH N T IH K AH T ER
AUTHENTICATORS	AO TH EH N T IH K AH T ER Z
AUTISTICALLY	AO T IH S T IH K AH L IY
AUTOBIOGRAPHICAL	AO T AH B AY AH G R AE F IH K AH L
AUTOBIOGRAPHICALLY	AO T AH B AY AH G R AE F IH K AH L IY
AUTOCADE	AO T AH K EY D
AUTOCADES	AO T AH K EY D Z
AUTOCATALYSES	AO T OW K EY T AH L IY Z IH Z
AUTOCATALYSIS	AO T OW K EY T AH L IY Z IY Z
AUTOCATALYTIC	AO T OW K AE T AH L IH T IH K
AUTOCATALYTICALLY	AO T OW K AE T AH L IH T IH K AH L IY
AUTOCRATICAL	AO T AH K R AE T IH K AH L
AUTOCRATICALLY	AO T AH K R AE T IH K AH L IY
AUTOGRAPHICALLY	AO T AH G R AE F IH K AH L IY
AUTOINTOXICATION	AO T OW IH N T AA K S IH K EY SH AH N
AUTOINTOXICATIONS	AO T OW IH N T AA K S IH K EY SH AH N Z
AUTOMATICALLY	AO T AH M AE T IH K L IY
AUTOMATICALLY(2)	AO T OW M AE T IH K L IY
AUTONOMICALLY	AO T AH N AA M IH K AH L IY
AUTOTROPHICALLY	AH T AA T R AA F AH K AE L IY
AVOCADO	AE V AH K AA D OW
AVOCADOES	AE V AH K AA D OW Z
AVOCADOS	AE V AH K AA D OW Z
AVOCATION	AE V AH K EY SH AH N
AVOCATIONAL	AE V AH K EY SH AH N AH L
AVOCATIONALLY	AE V AH K EY SH AH N AH L IY
AVOCATIONS	AE V AH K EY SH AH N Z
AXENICALLY	AE K S AH N IH K AH L IY
AXIOLOGICAL	AE K S IY AH L AA JH IH K AH L
AXIOLOGICALLY	AE K S IY AH L AA JH IH K AH L IY
AXIOMATICALLY	AE K S IY AH M AE T IH K AH L IY
AXISYMMETRICAL	AE K S AH S IH M EH T R IH S AH L
AYAHUASCA	EY AE HH Y UW AE S AH
AYAHUASCAS	EY AE HH Y UW AE S AH Z
BACALAO	B AH K AE L EY OW
BACALAOS	B AH K AE L EY AH Z
BACCA	B AE K AH
BACCAE	B AE K IY
BACCALAUREATE	B AE K AH L AO R IY AH T
BACCALAUREATES	B AE K AH L AO R IY EY T S
BACCARA	B AE K AH R AH
BACCARAS	B AE K AH R AH Z
BACCARAT	B AA K ER AA
BACCARATS	B AA K AH R AA Z
BACCATE	B AE K EY T
BACCATED	B AE K EY T AH D
BACKCAST	B AE K AE S T
BACKCASTS	B AE K AE S T S
BACKSCATTER	B AE K S K AE T ER
BACKSCATTERED	B AE K S K AE T ER D
BACKSCATTERING	B AE K S K AE T ER IH NG
BACKSCATTERINGS	B AE K S K AE T ER IH NG Z
BACKSCATTERS	B AE K S K AE T ER Z
BACTERIOLOGICAL	B AE K T AH R IY AA L AH JH IH S AH L
BACTERIOLOGICALLY	B AE K T IY R IY AH L AA JH AH K AE L IY
BALLCARRIER	B AO L K AE R IY ER
BALLCARRIERS	B AO L K AE R IY ER Z
BALLISTICALLY	B AH L IH S T IH K AH L IY
BALMACAAN	B AE L M AE K EY AH N
BALMACAANS	B AE L M AH K AH N Z
BANKCARD	B AE NG K AA R D
BANKCARDS	B AE NG K AA R D Z
BARBARICALLY	B AA R B AE R IH K AH L IY
BARBICAN	B AA R B AY K AE N
BARBICANS	B AA R B AY K AE N Z
BARCAROLE	B AA R K AH R OW L
BARCAROLES	B AA R K AH R OW L Z
BARCAROLLE	B AA R K AH R AH L
BARCAROLLES	B AA R K AH R AH L Z
BAROMETRICALLY	B AE R AH M EH T R IH K AH L IY
BARRANCA	B AE R AE NG K AH
BARRANCAS	B AE R AE NG K AH Z
BARRICADE	B AE R AH K EY D
BARRICADE(2)	B EH R AH K EY D
BARRICADED	B AE R AH K EY D IH D
BARRICADED(2)	B EH R AH K EY D IH D
BARRICADES	B AE R AH K EY D Z
BARRICADES(2)	B EH R AH K EY D Z
BARRICADING	B AE R AH K EY D IH NG
BARRICADO	B AA R IH K AH D UW
BARRICADOED	B AA R IH K AH D OW D
BARRICADOES	B AA R IH K AH D OW Z
BARRICADOING	B AA R IH K AH D OW IH NG
BASICALLY	B EY S IH K L IY
BASIFICATION	B EY S AH F AH K EY SH AH N
BASIFICATIONS	B EY S AH F AH K EY SH AH N Z
BASILICA	B AH S IH L IH K AH
BASILICA(2)	B AH Z IH L AH K AH
BASILICAE	B AH S IH L AH K IY
BASILICAN	B EY Z AH L IH S AH N
BASILICAS	B AH S IH L AH K AH Z
BATHETICALLY	B AH TH EH T AH K AE L IY
BATHYMETRICAL	B EY DH IY M EH T R IH K AH L
BATHYMETRICALLY	B EY DH IY M EH T R IH K AH L IY
BATHYSCAPH	B AH TH IH S AH F
BATHYSCAPHE	B AH TH IH S AH F
BATHYSCAPHES	B AH TH IH S AH F S
BATHYSCAPHS	B AH TH IH S AH F S
BEARCAT	B AE ER K AE T
BEARCATS	B AE ER K AE T S
BEATIFICALLY	B IY AH T IH F IH K AH L IY
BEATIFICATION	B IY AE T AH F AH K EY SH AH N
BEATIFICATIONS	B IY AE T AH F AH K EY SH AH N Z
BEAUTIFICATION	B IH AH Y UW T AH F AH K EY SH AH N
BEAUTIFICATIONS	B AH AO T AH F AH K EY T IY AH N Z
BECALM	B IH K AA M
BECALMED	B IH K AA M D
BECALMING	B IH K AA M IH NG
BECALMS	B IH K AA M Z
BECAME	B IH K EY M
BECAME(2)	B IY K EY M
BECAP	B IH K AE P
BECAPPED	B IH K AE P T
BECAPPING	B IH K AE P IH NG
BECAPS	B IH K AE P S
BECARPET	B IH K AA R P AH T
BECARPETED	B IH K AA R P AH T IH D
BECARPETING	B IH K AA R P AH T IH NG
BECARPETS	B IH K AA R P AH T S
BECAUSE	B IH K AO Z
BECAUSE(2)	B IH K AH Z
BECAUSE(3)	B IH K AA Z
BEEFCAKE	B IY F K EY K
BEEFCAKES	B IY F K EY K S
BENZOCAINE	B IH N Z AH K EY N
BENZOCAINES	B IH N Z AH K EY N Z
BERASCAL	B IH R AE S K AH L
BERASCALED	B IH R AE S K AH L D
BERASCALING	B IH R AE S K AH L IH NG
BERASCALS	B IH R AE S K AH L Z
BIBLICAL	B IH B L AH K AH L
BIBLICAL(2)	B IH B L IH K AH L
BIBLICALLY	B IH B L IH K AH L IY
BIBLIOGRAPHICAL	B IH B L IY AH G R AE F IH K AH L
BIBLIOGRAPHICALLY	B IH B L IY AH G R AE F IH K AH L IY
BIBLIOMANIACAL	B AY B L AY AH M AH N IY AH S AH L
BIBLIOTHECA	B AY B L AY AA TH AH K AH
BIBLIOTHECAE	B AY B L AY AA TH AH K IY
BIBLIOTHECAL	B AY B L AY AA TH AH K AH L
BIBLIOTHECAS	B AY B L AY AA TH AH K AH Z
BICAMERAL	B AY K AE M AH R AH L
BICAMERALISM	B AY K AE M AH R AH L IH Z AH M
BICAMERALISMS	B AY K AE M AH R AH L IH Z AH M Z
BICARB	B AY K AA R B
BICARBONATE	B AY K AA R B AH N AH T
BICARBONATES	B AY K AA R B AH N AH T S
BICARBS	B AY K AA R B Z
BICAUDAL	B IY IH K AO D AH L
BICONCAVE	B AY K AA N K EY V
BICONCAVITIES	B AY K AH N K AE V AH T IY Z
BICONCAVITY	B AY K AH N K AE V AH T IY
BIFOCAL	B AY F OW K AH L
BIFOCALS	B AY F OW K AH L Z
BIFURCATE	B IH F ER K EY T
BIFURCATE(2)	B AY F ER K EY T
BIFURCATED	B IH F ER K EY T IH D
BIFURCATED(2)	B AY F ER K EY T IH D
BIFURCATES	B AY F ER K EY T S
BIFURCATING	B AY F ER K EY T IH NG
BIFURCATION	B IH F ER K EY SH AH N
BIFURCATION(2)	B AY F ER K EY SH AH N
BIFURCATIONS	B AY F ER K EY SH AH N Z
BILLYCAN	B IH L IY K AE N
BILLYCANS	B IH L IY K AE N Z
BILOCATION	B AY L OW K EY SH AH N
BILOCATIONS	B AY L OW K EY SH AH N Z
BIOCHEMICAL	B AY OW K EH M IH K AH L
BIOCHEMICALLY	B AY OW K EH M IH K AH L IY
BIOCHEMICALS	B AY OW K EH M IH K AH L Z
BIOELECTRICAL	B AY OW AH L EH K T R IH S AH L
BIOETHICAL	B AY OW AH TH IH S AH L
BIOGENETICALLY	B AY AH JH AH N EH T AH K AE L IY
BIOGEOCHEMICAL	B AY AH JH IY AA K AH M IH S AH L
BIOGEOCHEMICALS	B AY OW JH IY AH K EH M AH K AH L Z
BIOGEOGRAPHICAL	B AY OW JH IY AA G R AH F IH S AH L
BIOGRAPHICAL	B AY AH G R AE F IH K AH L
BIOGRAPHICALLY	B AY AH G R AE F IH K AH L IY
BIOLOGICAL	B AY AH L AA JH IH K AH L
BIOLOGICALLY	B AY AH L AA JH IH K L IY
BIOLOGICALS	B AY AH L AA JH IH K AH L Z
BIOMATHEMATICAL	B AY AH M AH TH EH M AH T IH S AH L
BIOMECHANICAL	B AY AH M EH CH AH N IH S AH L
BIOMECHANICALLY	B AY AH M AH CH AE N AH K AE L IY
BIOMEDICAL	B AY OW M EH D IH K AH L
BIOMETEOROLOGICAL	B AY AH M IY T IY AH R AA L AH JH IH S AH L
BIOMETRICAL	B AY AH M EH T R IH S AH L
BIOPHYSICAL	B AY AA F AH Z IH S AH L
BIOSTATISTICAL	B AY AA S T AE T IH S T IH K AH L
BIOSYNTHETICALLY	B AY AH S IH N TH EH T AH K AE L IY
BIOTECHNICAL	B AY AH T EH K N IH S AH L
BIOTECHNOLOGICAL	B AY OW T EH K N AH L AA JH IH K AH L
BIOTICAL	B AY AA T IH K AH L
BIRDCAGE	B ER D K EY JH
BIRDCAGES	B ER D K EY JH IH Z
BIRDCALL	B ER D K AO L
BIRDCALLS	B ER D K AO L Z
BLACKCAP	B L AE K AE P
BLACKCAPS	B L AE K AE P S
BLUECAP	B L UW K AE P
BLUECAPS	B L UW K AE P S
BOBCAT	B AA B K AE T
BOBCATS	B AA B K AE T Z
BOCACCIO	B AH K AE K S IY OW
BOCACCIOS	B AH K AE K S IY AH Z
BOLOMETRICALLY	B OW L OW M EH T R IH K AH L IY
BOMBASTICALLY	B AA M B AE S T IH K AH L IY
BOOKCASE	B UH K K EY S
BOOKCASES	B UH K K EY S IH Z
BOROSILICATE	B IY ER AA S IH L AY S AH T
BOROSILICATES	B IY ER AA S IH L AY S AH T S
BOSCAGE	B AA S AH JH
BOSCAGES	B AA S AH JH AH Z
BOTANICA	B AH T AE N AH K AH
BOTANICAL	B AH T AE N IH K AH L
BOTANICALLY	B AH T AE N AH K AH L IY
BOTANICALLY(2)	B AH T AE N AH K L IY
BOTANICALS	B AH T AE N IH K AH L Z
BOTANICAS	B AH T AE N AH K AH Z
BOURGEOISIFICATION	B UW R ZH W AA AH F AH K EY SH AH N
BOURGEOISIFICATIONS	B UW R ZH W AA AH F AH K EY SH AH N Z
BOXCAR	B AA K S K AA R
BOXCARS	B AA K S K AA R Z
BRADYCARDIA	B R AE D AH K AA R D IY AH
BRADYCARDIA(2)	B R AE D IH K AA R D IY AH
BRADYCARDIAS	B R AE D AH K AA R D IY AH Z
BRAINCASE	B R EY N K EY S
BRAINCASES	B R EY N K EY S IH Z
BRASSICA	B R AE S IH K AH
BRASSICAS	B R AE S IH K AH Z
BRIEFCASE	B R IY F K EY S
BRIEFCASES	B R IY F K EY S IH Z
BROADCAST	B R AO D K AE S T
BROADCASTED	B R AO D K AE S T IH D
BROADCASTER	B R AO D K AE S T ER
BROADCASTERS	B R AO D K AE S T ER Z
BROADCASTING	B R AO D K AE S T IH NG
BROADCASTS	B R AO D K AE S T S
BROADSCALE	B R AO D S K EY L
BROCADE	B R OW K EY D
BROCADED	B R OW K EY D IH D
BROCADES	B R OW K EY D Z
BROCADING	B R OW K EY D IH NG
BROCATEL	B R AA K AH T AH L
BROCATELLE	B R AA K AH T AH L
BROCATELLES	B R AA K AH T AH L Z
BROCATELS	B R AA K AH T AH L Z
BRYOLOGICAL	B R AY AA L AH JH IH S AH L
BUCCAL	B Y UW K AH L
BUCCALLY	B AH K AE L IY
BUCCANEER	B AH K AH N IY R
BUCCANEERED	B AH K EY N AH R D
BUCCANEERING	B AH K EY N AH R AH NG
BUCCANEERISH	B AH K EY N AH R AH SH
BUCCANEERS	B AH K AH N IY R Z
BUCOLICALLY	B Y UW K AA L IH K AH L IY
BUREAUCRATICALLY	B Y UH R AH K R AE T IH K AH L IY
CAB	K AE B
CABAL	K AH B AA L
CABALA	K AE B AH L AH
CABALAS	K AE B AH L AH Z
CABALETTA	K AE B AH L EH T AH
CABALETTAS	K AE B AH L EH T AH Z
CABALISM	K AE B AH L IH Z AH M
CABALISMS	K AE B AH L IH Z AH M Z
CABALIST	K AE B AH L IH S T
CABALISTIC	K AE B AH L IH S T IH K
CABALISTS	K AE B AH L IH S T S
CABALLED	K AE B AH L D
CABALLERO	K AE B AH Y EH R OW
CABALLEROS	K AE B AH L ER AA S
CABALLING	K AE B AH L IH NG
CABALS	K AE B AH L Z
CABANA	K AH B AE N AH
CABANAS	K AH B AE N AH Z
CABARET	K AE B ER EY
CABARETS	K AE B ER EY Z
CABBAGE	K AE B AH JH
CABBAGE(2)	K AE B IH JH
CABBAGED	K AE B IH JH D
CABBAGES	K AE B IH JH IH Z
CABBAGEWORM	K AE B IH JH W ER M
CABBAGEWORMS	K AE B IH JH W ER M Z
CABBAGING	K AE B IH JH IH NG
CABBALA	K AE B AH L AH
CABBALAH	K AE B AH L AH
CABBALAHS	K AE B AH L AH Z
CABBALAS	K AE B AH L AH Z
CABBED	K AE B D
CABBIE	K AE B IY
CABBIES	K AE B IY Z
CABBING	K AE B IH NG
CABBY	K AE B IY
CABDRIVER	K AE B D R AY V ER
CABDRIVERS	K AE B D R AY V ER Z
CABER	K AE B ER
CABERNET	K AE B ER N EY
CABERNETS	K AE B ER N EH T S
CABERNETS(2)	K AE B ER N EY Z
CABERS	K AE B ER Z
CABESTRO	K AH B EH S T R OW
CABESTROS	K AH B EH S T R AH Z
CABEZON	K AE B AH Z AH N
CABEZONE	K AE B AH Z OW N
CABEZONES	K AE B AH Z OW N Z
CABEZONS	K AE B AH Z AH N Z
CABILDO	K AE B IH L D UW
CABILDOS	K AE B IH L D UW Z
CABIN	K AE B AH N
CABINED	K AE B AH N D
CABINET	K AE B AH N AH T
CABINET(2)	K AE B N AH T
CABINETMAKER	K AE B N AH T M EY K ER
CABINETMAKERS	K AE B N AH T M EY K ER Z
CABINETMAKING	K AE B N AH T M EY K IH NG
CABINETMAKINGS	K AE B N AH T M EY K IH NG Z
CABINETRIES	K AE B N AH T R IY Z
CABINETRY	K AE B N AH T R IY
CABINETS	K AE B AH N AH T S
CABINETS(2)	K AE B N AH T S
CABINETWORK	K AE B N AH T W ER K
CABINETWORKS	K AE B N AH T W ER K S
CABINING	K AE B AH N IH NG
CABINS	K AE B AH N Z
CABLE	K EY B AH L
CABLED	K EY B AH L D
CABLEGRAM	K EY B AH L G R AE M
CABLEGRAMS	K EY B AH L G R AE M Z
CABLES	K EY B AH L Z
CABLET	K AE B L AH T
CABLETS	K AE B L AH T S
CABLEWAY	K EY B AH L W EY
CABLEWAYS	K EY B AH L W EY Z
CABLING	K AE B L IH NG
CABMAN	K AE B M AE N
CABMEN	K AE B M EH N
CABOB	K AE B AH B
CABOBS	K AE B AH B Z
CABOCHED	K AE B AH CH T
CABOCHON	K AE B AH CH AH N
CABOCHONS	K AE B AH CH AH N Z
CABOMBA	K AH B AA M B AH
CABOMBAS	K AH B AA M B AH Z
CABOODLE	K AH B UW D AH L
CABOODLES	K AH B UW D AH L Z
CABOOSE	K AH B UW S
CABOOSES	K AH B UW S IH Z
CABOSHED	K AE B AH SH T
CABOTAGE	K AE B AH T IH JH
CABOTAGES	K AH B AA T AH JH AH Z
CABRESTA	K AE B R EH S T AH
CABRESTAS	K AE B R EH S T AH Z
CABRESTO	K AE B R EH S T OW
CABRESTOS	K AE B R EH S T AA S
CABRETTA	K AE B R EH T AH
CABRETTAS	K AE B R EH T AH Z
CABRILLA	K AE B R IH L AH
CABRILLAS	K AE B R IH L AH Z
CABRIOLE	K AE B R IY OW L
CABRIOLES	K AE B R IY OW L Z
CABRIOLET	K AE B R IY OW L EY
CABRIOLET(2)	K AE B R IY OW L EH T
CABRIOLETS	K AE B R IY AH L AH T S
CABS	K AE B Z
CABSTAND	K AE B S T AE N D
CABSTANDS	K AE B S T AE N D Z
CACA	K AE K AH
CACAO	K AH K EY OW
CACAOS	K AH K AW Z
CACAS	K AE K AH Z
CACCIATORE	K AA CH AH T AO R IY
CACHALOT	K AE CH AH L AH T
CACHALOTS	K AE CH AH L AH T S
CACHE	K AE SH
CACHE(2)	K AE SH EY
CACHECTIC	K AE CH AH K T AH K
CACHED	K AE SH T
CACHEPOT	K AE SH P AA T
CACHEPOTS	K AE SH P AA T S
CACHES	K AE SH IH Z
CACHES(2)	K AE SH EY Z
CACHET	K AE SH EY
CACHETED	K AE SH T EH D
CACHETING	K AH CH IY T AH NG
CACHETS	K AE CH AH T S
CACHEXIA	K AH CH EH K S IY AH
CACHEXIAS	K AH CH EH K S IY AH Z
CACHEXIC	K AE CH AH K S AH K
CACHEXIES	K AH CH EH K S AY Z
CACHEXY	K AH CH EH K S IY
CACHING	K AE SH IH NG
CACHINNATE	K AE CH AH N EY T
CACHINNATED	K AE CH AH N EY T AH D
CACHINNATES	K AE CH AH N EY T S
CACHINNATING	K AE CH AH N EY T AH NG
CACHINNATION	K AE CH AH N EY SH AH N
CACHINNATIONS	K AE CH AH N EY T IY AH N Z
CACHOU	K AE CH UW
CACHOUS	K AE SH AH S
CACHUCHA	K AE CH AH CH AH
CACHUCHAS	K AE CH AH CH AH Z
CACIQUE	K AH S IY K
CACIQUES	K AE S AH K S
CACIQUISM	K AE S AH K W IH Z AH M
CACIQUISMS	K AH S IH K W AH Z AH M Z
CACKLE	K AE K AH L
CACKLED	K AE K AH L D
CACKLER	K AE K AH L ER
CACKLERS	K AE K AH L ER Z
CACKLES	K AE K AH L Z
CACKLING	K AE K AH L IH NG
CACKLING(2)	K AE K L IH NG
CACODEMON	K AH K AA D AH M AH N
CACODEMONIC	K AH K AA D AH M AH N AH K
CACODEMONS	K AH K AA D AH M AH N Z
CACODYL	K AE K AH D AH L
CACODYLS	K AE K AH D AH L Z
CACOETHES	K AE K OW AH DH Z
CACOGRAPHICAL	K AH K AA G R AH F IH S AH L
CACOGRAPHIES	K AH K AA G R AH F AY Z
CACOGRAPHY	K AH K AA G R AH F IY
CACOMISTLE	K AE K AH M AH S AH L
CACOMISTLES	K AE K AH M AH S T AH L Z
CACOMIXL	K AE K AH M AH K S L
CACOMIXLS	K AE K AH M AH K S L Z
CACOPHONIES	K AE K AA F AH N IY Z
CACOPHONOUS	K AE K AA F AH N AH S
CACOPHONOUSLY	K AE K AA F AH N AH S L IY
CACOPHONY	K AE K AA F AH N IY
CACTI	K AE K T AY
CACTI(2)	K AE K T IY
CACTOID	K AE K T OY D
CACTUS	K AE K T AH S
CACTUSES	K AE K T Y UW Z AH Z
CACUMINAL	K AE K Y UW M AH N AH L
CAD	K AE D
CADASTER	K AH D AE S T AH R
CADASTERS	K AH D AE S T AH R Z
CADASTRAL	K AH D AE S T R AH L
CADASTRALLY	K AH D AE S T R AE L IY
CADASTRE	K AH D AE S T AH R
CADASTRES	K AH D AE S T AH R Z
CADAVER	K AH D AE V ER
CADAVERIC	K AH D AE V ER IH K
CADAVERINE	K AH D AE V AH R AY N
CADAVERINES	K AH D AE V AH R AY N Z
CADAVEROUS	K AH D AE V ER AH S
CADAVEROUSLY	K AH D AE V ER AH S L IY
CADAVERS	K AH D AE V ER Z
CADDICE	K AE D AH S
CADDICES	K EY D IH K S IH Z
CADDIE	K EY D IY
CADDIED	K AE D IY D
CADDIES	K AE D IY Z
CADDIS	K AE D IY Z
CADDISES	K AE D IY Z IH Z
CADDISH	K EY D IH SH
CADDISHLY	K EY D IH SH L IY
CADDISHNESS	K EY D IH SH N AH S
CADDISHNESSES	K EY D IH SH N AH S IH Z
CADDISWORM	K AE D IY Z W ER M
CADDISWORMS	K AE D IY Z W ER M Z
CADDY	K AE D IY
CADDYING	K AE D IY IH NG
CADE	K EY D
CADELLE	K AE D AH L
CADELLES	K AE D AH L Z
CADENCE	K EY D AH N S
CADENCED	K EY D AH N S T
CADENCES	K EY D AH N S IH Z
CADENCIES	K EY D AH N S IY Z
CADENCING	K EY D AH N S IH NG
CADENCY	K EY D AH N S IY
CADENT	K EY D AH N T
CADENTIAL	K EY D AH N T IY AH L
CADENZA	K AH D EH N Z AH
CADENZAS	K AH D EH N Z AH Z
CADES	K EY D Z
CADET	K AH D EH T
CADETS	K AH D EH T S
CADETSHIP	K AH D EH T SH IH P
CADETSHIPS	K AH D EH T SH IH P S
CADGE	K AE JH
CADGED	K AE JH D
CADGER	K AE JH AH R
CADGERS	K AE JH AH R Z
CADGES	K AE JH AH Z
CADGING	K AE JH AH NG
CADGY	K AE JH IY
CADI	K AE D IY
CADIS	K EY D IY Z
CADMIC	K AE D M AH K
CADMIUM	K AE D M IY AH M
CADMIUMS	K AE D M IY AH M Z
CADRE	K AE D R IY
CADRES	K AE D R IY Z
CADS	K AE D S
CADUCEAN	K AE D Y UW S IY AH N
CADUCEI	K AE D Y AH S IY
CADUCEUS	K AE D Y UW S IY AH S
CADUCITIES	K AE D Y UW S AH T AY Z
CADUCITY	K AE D Y UW S AH T IY
CADUCOUS	K AE D Y UW K AH S
CAECA	K IY K AH
CAECAL	K IY K AH L
CAECALLY	K IY K AE L IY
CAECILIAN	K IY S IH L IY AH N
CAECILIANS	K IY S IH L IY AH N Z
CAECUM	K IY K AH M
CAEOMA	K IY AH M AH
CAEOMAS	K IY AH M AH Z
CAESAR	S IY Z ER
CAESAREAN	K EY S ER IY N
CAESAREANS	K EY S ER IY N Z
CAESARIAN	K IY Z EH R IY AH N
CAESARIANS	K IY S AE R IY AH N Z
CAESARS	S IY Z ER Z
CAESIUM	K IY S IY AH M
CAESIUMS	K IY S IY AH M Z
CAESPITOSE	K IY S AH T OW Z
CAESTUS	K EY EH S T AH S
CAESTUSES	K IY S T Y UW Z AH Z
CAESURA	K IY S AH R AH
CAESURAE	K IY S AH R IY
CAESURAL	K IY ZH Y AH R AH L
CAESURAS	K IY S AH R AH Z
CAESURIC	K IY ZH Y AH R AH K
CAFE	K AH F EY
CAFE(2)	K AE F EY
CAFES	K AE F EY Z
CAFETERIA	K AE F AH T IH R IY AH
CAFETERIAS	K AE F AH T IH R IY AH Z
CAFETORIA	K AE F AH T AO R IY AH
CAFETORIUM	K AE F AH T AO R IY AH M
CAFETORIUMS	K AE F AH T AO R IY AH M Z
CAFF	K AE F
CAFFEIN	K AE F IY N
CAFFEINATED	K AE F IH N EY T AH D
CAFFEINE	K AE F IY N
CAFFEINES	K AE F IY N Z
CAFFEINS	K AE F IY N Z
CAFFS	K AE F S
CAFTAN	K AE F T AE N
CAFTANS	K AE F T AE N Z
CAGE	K EY JH
CAGED	K EY JH D
CAGEFUL	K EY JH F AH L
CAGEFULS	K EY JH F AH L Z
CAGELING	K EY JH L IH NG
CAGELINGS	K EY JH L IH NG Z
CAGER	K EY JH ER
CAGERS	K EY JH ER Z
CAGES	K EY JH IH Z
CAGEY	K EY JH IY
CAGEYNESS	K EY JH IY N AH S
CAGEYNESSES	K EY JH IY N AH S IH Z
CAGIER	K EY JH IY ER
CAGIEST	K EY JH IY AH S T
CAGILY	K EY JH IY L IY
CAGINESS	K EY JH IY N AH S
CAGINESSES	K EY JH IY N AH S IH Z
CAGING	K EY JH IH NG
CAGY	K EY JH IY
CAHIER	K AE HH AY AH R
CAHIERS	K AH HH IY R Z
CAHOOT	K AH HH UW T
CAHOOTS	K AH HH UW T S
CAHOW	K AE HH OW
CAHOWS	K AH HH OW Z
CAID	K EY D
CAIDS	K EY D Z
CAIMAN	K EY M AH N
CAIMANS	K EY M AH N Z
CAIN	K EY N
CAINS	K EY N Z
CAIQUE	K EY K
CAIQUES	K EY K S
CAIRD	K AE AH R D
CAIRDS	K AE AH R D Z
CAIRN	K EH R N
CAIRNED	K AE ER N D
CAIRNGORM	K AE AH R N G AH R M
CAIRNGORMS	K AE AH R N G AH R M Z
CAIRNS	K EH R N Z
CAIRNY	K AE ER N IY
CAISSON	K EY S AH N
CAISSON(2)	K EH S AH N
CAISSONS	K EY S AH N Z
CAISSONS(2)	K EH S AH N Z
CAITIFF	K EY T AH F
CAITIFFS	K EY T AH F S
CAJAPUT	K AE JH AH P AH T
CAJAPUTS	K AE JH AH P Y UW T S
CAJEPUT	K AE JH AH P AH T
CAJEPUTS	K AE JH AH P Y UW T S
CAJOLE	K AH JH OW L
CAJOLED	K AH JH OW L D
CAJOLEMENT	K AH JH OW L M AH N T
CAJOLEMENTS	K AH JH AA L AH M AH N T S
CAJOLER	K AH JH OW L AH R
CAJOLERIES	K AH JH AA L AH R AY Z
CAJOLERS	K AE JH AH L AH R Z
CAJOLERY	K AE JH AH L EH R IY
CAJOLES	K AH JH OW L Z
CAJOLING	K AH JH OW L IH NG
CAJON	K AE JH AH N
CAJONES	K AH JH OW N Z
CAJUPUT	K AH JH UW P AH T
CAJUPUTS	K AH JH UW P Y UW T S
CAKE	K EY K
CAKED	K EY K T
CAKES	K EY K S
CAKEWALK	K EY K W AO K
CAKEWALKED	K EY K W AO K T
CAKEWALKER	K EY K W AO K ER
CAKEWALKERS	K EY K W AO K ER Z
CAKEWALKING	K EY K W AO K IH NG
CAKEWALKS	K EY K W AO K S
CAKEY	K EY K IY
CAKIER	K EY K IY ER
CAKIEST	K EY K IY AH S T
CAKING	K EY K IH NG
CAKY	K EY K IY
CALABASH	K AE L AH B AH SH
CALABASHES	K AH L AE B AH SH AH Z
CALABOOSE	K AE L AH B UW Z
CALABOOSES	K AE L AH B UW Z AH Z
CALADIUM	K AH L EY D IY AH M
CALADIUMS	K AH L EY D IY AH M Z
CALAMANDER	K AE L AH M AE N D ER
CALAMANDERS	K AE L AH M AE N D AH R Z
CALAMAR	K AE L AH M AH R
CALAMARI	K AA L AA M AA R IY
CALAMARIES	K AH L AE M AH R AY Z
CALAMARIS	K AH L AE M AH R AH S
CALAMARS	K AE L AH M AH R Z
CALAMARY	K AE L AH M EH R IY
CALAMI	K AE L AH M IY
CALAMINE	K AE L AH M AY N
CALAMINED	K AE L AH M AY N D
CALAMINES	K AE L AH M AY N Z
CALAMINING	K AE L AH M AY N AH NG
CALAMINT	K AE L AH M AH N T
CALAMINTS	K AE L AH M AH N T S
CALAMITE	K AE L AH M AY T
CALAMITES	K AE L AH M AY T S
CALAMITIES	K AH L AE M AH T IY Z
CALAMITOUS	K AH L AE M AH T AH S
CALAMITOUSLY	K AH L AE M AH T AH S L IY
CALAMITY	K AH L AE M AH T IY
CALAMITY(2)	K AH L AE M IH T IY
CALAMONDIN	K AE L AH M AA N D AH N
CALAMONDINS	K AE L AH M AA N D AH N Z
CALAMUS	K AE L AH M AH S
CALANDO	K AH L AE N D OW
CALASH	K AE L AH SH
CALASHES	K AE L AH SH AH Z
CALATHI	K AE L AH TH IY
CALATHOS	K AE L AH TH AH Z
CALATHUS	K AE L AH TH AH S
CALCANEA	K AE L K EY N IY AH
CALCANEAL	K AE L K EY N IY AH L
CALCANEI	K AE L K AH N IY
CALCANEUM	K AE L K EY N IY AH M
CALCANEUS	K AE L K EY N IY AH S
CALCAR	K AE L S ER
CALCAREOUS	K AE L K AE R IY AH S
CALCAREOUSLY	K AE L K AH R IY OW AH S L IY
CALCARIA	K AE L K AE R IY AH
CALCARS	K AE L S ER Z
CALCEATE	K AE L S IY EY T
CALCES	K AE L S AH Z
CALCIC	K AE L S IH K
CALCICOLE	K AE L S AH K OW L
CALCICOLES	K AE L S AH K OW L Z
CALCICOLOUS	K AE L S IH K AH L AH S
CALCIFEROL	K AE L S IH F AH R AH L
CALCIFEROLS	K AE L S IH F AH R AH L Z
CALCIFEROUS	K AE L S IH F AH R AH S
CALCIFIC	K AE L S IH F AH K
CALCIFICATION	K AE L S AH F AH K EY SH AH N
CALCIFICATIONS	K AE L S AH F AH K EY SH AH N Z
CALCIFIED	K AE L S AH F AY D
CALCIFIES	K AE L S AH F AY Z
CALCIFUGE	K AE L S AH F Y UW JH
CALCIFUGES	K AE L S AH F Y UW JH AH Z
CALCIFUGOUS	K AE L S AH F Y UW G AH S
CALCIFY	K AE L S AH F AY
CALCIFYING	K AE L S AH F AY IH NG
CALCIMINE	K AE L S AH M AY N
CALCIMINED	K AE L S AH M AY N D
CALCIMINES	K AE L S AH M AY N Z
CALCIMINING	K AE L S AH M AY N AH NG
CALCINATION	K AE L S AH N EY SH AH N
CALCINATIONS	K AE L S AH N EY T IY AH N Z
CALCINE	K AE L S AY N
CALCINED	K AE L S AY N D
CALCINES	K AE L S AY N Z
CALCINING	K AE L S AY N AH NG
CALCINOSES	K AE L S AH N OW Z AH Z
CALCINOSIS	K AE L S AH N OW S AH S
CALCITE	K AE L S AY T
CALCITES	K AE L S AY T S
CALCITIC	K AE L S AH T AH K
CALCITONIN	K AE L S IY T AH N IH N
CALCITONINS	K AE L S IY T AH N IH N Z
CALCIUM	K AE L S IY AH M
CALCIUMS	K AE L S IY AH M Z
CALCSPAR	K AE L K S AH R
CALCSPARS	K AE L K S AH R Z
CALCTUFA	K AE L K T Y UW F AH
CALCTUFAS	K AE L K T Y UW F AH Z
CALCTUFF	K AE L K T AH F
CALCTUFFS	K AE L K T AH F S
CALCULABLE	K AE L K Y AH L AH B AH L
CALCULATE	K AE L K Y AH L EY T
CALCULATED	K AE L K Y AH L EY T AH D
CALCULATED(2)	K AE L K Y AH L EY T IH D
CALCULATEDLY	K AE L K Y AH L AH T AH D L IY
CALCULATEDNESS	K AE L K Y AH L AH T AH D N AH S
CALCULATEDNESSES	K AE L K Y AH L AH T AH D N AH S IH Z
CALCULATES	K AE L K Y AH L EY T S
CALCULATING	K AE L K Y AH L EY T IH NG
CALCULATINGLY	K AE L K Y AH L AH T IH NG L IY
CALCULATION	K AE L K Y AH L EY SH AH N
CALCULATIONAL	K AE L K Y AH L EY SH AH N AH L
CALCULATIONS	K AE L K Y AH L EY SH AH N Z
CALCULATOR	K AE L K Y AH L EY T ER
CALCULATORS	K AE L K Y AH L EY T ER Z
CALCULI	K AE L K Y AH L AY
CALCULOUS	K AE L K Y AH L AH S
CALCULUS	K AE L K Y AH L AH S
CALCULUSES	K AE L K Y AH L UW Z AH Z
CALDARIA	K AE L D AE R IY AH
CALDARIUM	K AE L D AE R IY AH M
CALDERA	K AE L D EH R AH
CALDERA(2)	K AO L D EH R AH
CALDERAS	K AE L D AH R AH Z
CALDRON	K AE L D R AH N
CALDRONS	K AE L D R AH N Z
CALECHE	K AE L AH CH
CALECHES	K AE L AH CH AH Z
CALEFACTORIES	K AE L AH F AE K T AH R AY Z
CALEFACTORY	K AE L AH F AH K T AO R IY
CALENDAL	K AH L EH N D AH L
CALENDAR	K AE L AH N D ER
CALENDARED	K AE L AH N D ER D
CALENDARING	K AE L AH N D ER IH NG
CALENDARS	K AE L AH N D ER Z
CALENDER	K AH L EH N D AH R
CALENDERED	K AE L AH N D IY R D
CALENDERER	K AE L AH N D IY R AH R
CALENDERERS	K AH L EH N D AH R AH R Z
CALENDERING	K AE L AH N D IY R AH NG
CALENDERS	K AH L EH N D AH R Z
CALENDRIC	K AE L AH N D R AH K
CALENDRICAL	K AH L EH N D R IH S AH L
CALENDS	K AE L AH N D Z
CALENDULA	K AH L EH JH AH L AH
CALENDULAS	K AE L AH N D Y UW L AH Z
CALENTURE	K AH L EH N T Y AH R
CALENTURES	K AH L EH N T Y AH R Z
CALESA	K AE L AH S AH
CALESAS	K AE L AH S AH Z
CALF	K AE F
CALFLIKE	K AE F L AY K
CALFS	K AE F S
CALFSKIN	K AE F S K IH N
CALFSKINS	K AE F S K IH N Z
CALIBER	K AE L AH B ER
CALIBERS	K AE L AH B ER Z
CALIBRATE	K AE L AH B R EY T
CALIBRATED	K AE L AH B R EY T AH D
CALIBRATES	K AE L AH B R EY T S
CALIBRATING	K AE L AH B R EY T IH NG
CALIBRATION	K AE L AH B R EY SH AH N
CALIBRATIONS	K AE L AH B R EY SH AH N Z
CALIBRATOR	K AE L AH B R EY T ER
CALIBRATORS	K AE L AH B R EY T ER Z
CALIBRE	K AE L AH B ER
CALIBRED	K AE L AH B ER D
CALIBRES	K AE L AH B ER Z
CALICES	K AE L AH S
CALICHE	K AE L AH CH
CALICHES	K AE L AH CH AH Z
CALICLE	K AE L AH K AH L
CALICLES	K AE L AH K AH L Z
CALICO	K AE L AH K OW
CALICOES	K AE L IH K OW Z
CALICOS	K AE L IH K OW Z
CALIF	K AE L IH F
CALIFATE	K AE L AH F EY T
CALIFATES	K AE L AH F EY T S
CALIFORNIUM	K AE L AH F AO R N IY AH M
CALIFORNIUMS	K AE L AH F AO R N IY AH M Z
CALIFS	K AE L AH F S
CALIGINOUS	K AH L IH JH AH N AH S
CALIPASH	K AE L AH P AH SH
CALIPASHES	K AH L IH P AH SH AH Z
CALIPEE	K AE L AH P IY IY
CALIPEES	K AE L AH P IY Z
CALIPER	K AE L AH P ER
CALIPERED	K AE L AH P ER D
CALIPERING	K AE L AH P ER IH NG
CALIPERS	K AE L AH P ER Z
CALIPH	K AE L AH F
CALIPHAL	K AE L AH F AH L
CALIPHATE	K AE L AH F AH T
CALIPHATES	K AE L AH F AH T S
CALIPHS	K AE L AH F S
CALISAYA	K AH L IH S EY AH
CALISAYAS	K AH L IH S EY AH Z
CALISTHENIC	K AE L AH S TH EH N IH K
CALISTHENICS	K AE L AH S TH EH N IH K S
CALIX	K AE L IH K S
CALIX(2)	K EY L AH K S
CALK	K AO K
CALKED	K AE K T
CALKER	K AE K AH R
CALKERS	K AE L K AH R Z
CALKIN	K AE L K IH N
CALKING	K AE K AH NG
CALKINS	K AE L K IH N Z
CALKS	K AE K S
CALL	K AO L
CALLA	K AE L AH
CALLABLE	K AO L AH B AH L
CALLALOO	K AE L AH L UW
CALLALOOS	K AE L AH L UW Z
CALLAN	K AE L AH N
CALLANS	K AE L AH N Z
CALLANT	K AO L AH N T
CALLANTS	K AO L AH N T S
CALLAS	K AE L AH Z
CALLBACK	K AO L B AE K
CALLBACKS	K AO L B AE K S
CALLBOY	K AO L B OY
CALLBOYS	K AO L B OY Z
CALLED	K AO L D
CALLER	K AO L ER
CALLERS	K AO L ER Z
CALLET	K AE L AH T
CALLETS	K AE L AH T S
CALLIGRAPHER	K AH L IH G R AH F ER
CALLIGRAPHERS	K AH L IH G R AH F ER Z
CALLIGRAPHIC	K AE L AH G R AE F IH K
CALLIGRAPHICALLY	K AE L IH G R AE F AH K AE L IY
CALLIGRAPHIES	K AH L IH G R AH F IY Z
CALLIGRAPHIST	K AE L IH G R AH F AH S T
CALLIGRAPHISTS	K AE L IH G R AH F AH S T S
CALLIGRAPHY	K AH L IH G R AH F IY
CALLING	K AO L IH NG
CALLINGS	K AO L IH NG Z
CALLIOPE	K AH L AY AH P IY
CALLIOPES	K AH L AY AH P IY Z
CALLIPEE	K AE L AH P IY IY
CALLIPEES	K AE L AH P IY Z
CALLIPER	K AE L AY P AH R
CALLIPERED	K AE L AH P IY R D
CALLIPERING	K AE L AH P IY R AH NG
CALLIPERS	K AE L AH P AH R Z
CALLIPYGIAN	K AE L IH P AH JH AH N
CALLIPYGOUS	K AE L IH P AH G AH S
CALLITHUMP	K AE L AH TH AH M P
CALLITHUMPIAN	K AE L AH TH AH M P IY AH N
CALLITHUMPS	K AE L AH TH AH M P S
CALLOSE	K AE L OW Z
CALLOSES	K AO L AA S IH Z
CALLOSITIES	K AO L AA S AH T IY Z
CALLOSITY	K AO L AA S AH T IY
CALLOUS	K AE L AH S
CALLOUSED	K AE L AH S T
CALLOUSES	K AE L AH S IH Z
CALLOUSING	K AE L AH S IH NG
CALLOUSLY	K AE L AH S L IY
CALLOUSNESS	K AE L AH S N AH S
CALLOUSNESSES	K AE L AH S N AH S IH Z
CALLOW	K AE L OW
CALLOWER	K AO L OW ER
CALLOWEST	K AO L OW AH S T
CALLOWNESS	K AO L OW N AH S
CALLOWNESSES	K AO L OW N AH S IH Z
CALLS	K AO L Z
CALLUS	K AE L AH S
CALLUSED	K AE L AH S T
CALLUSES	K AE L AH S IH Z
CALLUSING	K AE L AH S IH NG
CALM	K AA M
CALM(2)	K AA L M
CALMATIVE	K AA M AH T IH V
CALMATIVES	K AA M AH T IH V Z
CALMED	K AA M D
CALMED(2)	K AA L M D
CALMER	K AA M ER
CALMER(2)	K AA L M ER
CALMEST	K AA M AH S T
CALMEST(2)	K AA L M AH S T
CALMING	K AA M IH NG
CALMING(2)	K AA L M IH NG
CALMLY	K AA M L IY
CALMLY(2)	K AA L M L IY
CALMNESS	K AA M N AH S
CALMNESS(2)	K AA L M N AH S
CALMNESSES	K AA M N AH S IH Z
CALMODULIN	K AE L M AH D Y UW L AH N
CALMODULINS	K AE L M AH D Y UW L AH N Z
CALMS	K AA M Z
CALMS(2)	K AA L M Z
CALO	K AA L OW
CALOMEL	K AE L AH M AH L
CALOMELS	K AE L AH M AH L Z
CALORIC	K AE L AO R IH K
CALORICALLY	K AH L AO R IH K AH L IY
CALORICS	K AH L AO R IH K S
CALORIE	K AE L AO R IY
CALORIES	K AE L AO R IY Z
CALORIFIC	K AE L AH R IH F AH K
CALORIMETER	K AE L AH R IH M AH T ER
CALORIMETERS	K AE L AH R IH M AH T ER Z
CALORIMETRIC	K AH L AO R AH M EH T R IH K
CALORIMETRICALLY	K AH L AO R AH M EH T R IH K AH L IY
CALORIMETRIES	K AE L AH R AH M EH T R AY Z
CALORIMETRY	K AE L AH R AH M EH T R IY
CALORIZE	K AE L AH R AY Z
CALORIZED	K AE L AH R AY Z D
CALORIZES	K AE L AH R AY Z AH Z
CALORIZING	K AE L AH R AY Z AH NG
CALORY	K EY L AH R IY
CALOS	K AE L AH Z
CALOTTE	K AE L AH T
CALOTTES	K AE L AH T S
CALOTYPE	K AE L AH T AY P
CALOTYPES	K AE L AH T AY P S
CALOYER	K AE L OY AH R
CALOYERS	K AE L OY AH R Z
CALPAC	K AE L P AH K
CALPACK	K AE L P AH K
CALPACKS	K AE L P AH K S
CALPACS	K AE L P AH S
CALQUE	K AE L K
CALQUED	K AE L K T
CALQUES	K AE L K S
CALQUING	K AE L K AH NG
CALTHROP	K AE L TH R AH P
CALTHROPS	K AE L TH R AH P S
CALTRAP	K AE L T R AH P
CALTRAPS	K AE L T R AH P S
CALTROP	K AE L T R AH P
CALTROPS	K AE L T R AH P S
CALUMET	K AE L Y AH M EH T
CALUMETS	K AH L UW M AH T S
CALUMNIATE	K AE L AH M N IY EY T
CALUMNIATED	K AE L AH M N IY EY T IH D
CALUMNIATES	K AE L AH M N IY EY T S
CALUMNIATING	K AE L AH M N IY EY T IH NG
CALUMNIATION	K AE L AH M N IY EY SH AH N
CALUMNIATIONS	K AE L AH M N IY EY SH AH N Z
CALUMNIATOR	K AE L AH M N IY EY T ER
CALUMNIATORS	K AE L AH M N IY EY T ER Z
CALUMNIES	K AE L AH M N IY Z
CALUMNIOUS	K AE L AH M N IY AH S
CALUMNIOUSLY	K AE L AH M N IY AH S L IY
CALUMNY	K AE L AH M N IY
CALUTRON	K AH L AH T R AH N
CALUTRONS	K AH L AH T R AH N Z
CALVADOS	K AE L V AH D AH Z
CALVADOSES	K AE L V AH D OW Z AH Z
CALVARIA	K AE L V AE R IY AH
CALVARIAS	K AE L V AE R IY AH Z
CALVARIES	K AE L V ER IY Z
CALVARIUM	K AE L V AE R IY AH M
CALVARIUMS	K AE L V AE R IY AH M Z
CALVARY	K AE L V ER IY
CALVE	K AE V
CALVED	K AE V D
CALVES	K AE V Z
CALVING	K AE L V IH NG
CALX	K AE L K S
CALXES	K AE L K S
CALYCATE	K AE L AH K EY T
CALYCEAL	K AH L IH S IY AH L
CALYCES	K AH L AY S AH Z
CALYCINE	K AE L AH S AY N
CALYCLE	K AE L AH K AH L
CALYCLES	K AE L AH K AH L Z
CALYCULI	K AE L AH K Y UW L IY
CALYCULUS	K AH L IH K Y AH L AH S
CALYPSO	K AH L IH P S OW
CALYPSOES	K AH L IH P S OW Z
CALYPSONIAN	K AE L AH P S OW N IY AH N
CALYPSONIANS	K AE L AH P S OW N IY AH N Z
CALYPSOS	K AH L IH P S OW Z
CALYPTER	K AH L IH P T AH R
CALYPTERS	K AH L IH P T AH R Z
CALYPTRA	K AH L IH P T R AH
CALYPTRAS	K AH L IH P T R AH Z
CALYX	K AE L IH K S
CALYXES	K AE L AH K S
CALZONE	K AE L Z OW N
CALZONES	K AE L Z OW N Z
CAM	K AE M
CAMAIL	K AE M EY L
CAMAILED	K AE M EY L D
CAMAILS	K AE M EY L Z
CAMARADERIE	K AA M ER AA D ER IY
CAMARADERIES	K AA M AH R AA D AH R IY Z
CAMARILLA	K AE M AH R IH L AH
CAMARILLAS	K AE M AH R IH L AH Z
CAMAS	K AE M AH Z
CAMASES	K AH M EY Z AH Z
CAMASS	K AE M AE S
CAMASSES	K AE M AE S IH Z
CAMBER	K AE M B ER
CAMBERED	K AE M B IY ER D
CAMBERING	K AE M B IY ER IH NG
CAMBERS	K AE M B IY ER Z
CAMBIA	K AE M B IY AH
CAMBIAL	K AE M B AY AH L
CAMBISM	K AE M B IY IH Z AH M
CAMBISMS	K AE M B IY IH Z AH M Z
CAMBIST	K AE M B IY IH S T
CAMBISTS	K AE M B IY IH S T S
CAMBIUM	K AE M B IY AH M
CAMBIUMS	K AE M B IY AH M Z
CAMBOGIA	K AE M B OW JH IY AH
CAMBOGIAS	K AE M B OW JH IY AH Z
CAMBRIC	K AE M B R AH K
CAMBRICS	K AE M B R AH S Z
CAMCORDER	K AE M K AO R D ER
CAMCORDERS	K AE M K AO R D ER Z
CAME	K EY M
CAMEL	K AE M AH L
CAMELBACK	K AE M AH L B AE K
CAMELBACKS	K AE M AH L B AE K S
CAMELEER	K AE M AH L IH R
CAMELEERS	K AE M AH L IH R Z
CAMELIA	K AH M IY L Y AH
CAMELIAS	K AH M IY L Y AH Z
CAMELLIA	K AH M IY L Y AH
CAMELLIAS	K AH M IY L Y AH Z
CAMELOPARD	K AH M EH L AH P AH R D
CAMELOPARDS	K AH M EH L AH P AH R D Z
CAMELS	K AE M AH L Z
CAMEO	K AE M IY OW
CAMEOED	K AE M IY OW D
CAMEOING	K AE M IY OW IH NG
CAMEOS	K AE M IY OW Z
CAMERA	K AE M ER AH
CAMERA(2)	K AE M R AH
CAMERAE	K AE M AH R IY
CAMERAL	K AE M AH R AH L
CAMERAMAN	K AE M ER AH M AH N
CAMERAMEN	K AE M ER AH M EH N
CAMERAPERSON	K AE M R AH P ER S AH N
CAMERAPERSONS	K AE M R AH P ER S AH N Z
CAMERAS	K AE M ER AH Z
CAMERAS(2)	K AE M R AH Z
CAMERAWOMAN	K AE M R AH W UH M AH N
CAMERAWOMEN	K AE M R AH W IH M AH N
CAMERLENGO	K AE M AH R L EH N G OW
CAMERLENGOS	K AE M AH R L EH N G AH Z
CAMES	K EY M Z
CAMION	K AE M IY AH N
CAMIONS	K AE M IY AH N Z
CAMISA	K AE M AH S AH
CAMISADE	K AE M IY Z EY D
CAMISADES	K AE M IY Z EY D Z
CAMISADO	K AE M IY Z AH D UW
CAMISADOES	K AE M IY Z AH D OW Z
CAMISADOS	K AE M IY Z AH D UW Z
CAMISAS	K AE M AH S AH Z
CAMISE	K AH M AY Z
CAMISES	K AE M IY Z IH Z
CAMISIA	K AH M IH ZH IY AH
CAMISIAS	K AH M IH S IY AH Z
CAMISOLE	K AE M AH S OW L
CAMISOLES	K AE M AH S OW L Z
CAMLET	K AE M L AH T
CAMLETS	K AE M L AH T S
CAMOMILE	K AH M OW M AH L
CAMOMILES	K AE M AH M AH L Z
CAMORRA	K AH M AO R AH
CAMORRAS	K AH M AO R AH Z
CAMORRISTA	K AE M AH R IH S T AH
CAMORRISTI	K AE M AH R IH S T IY
CAMOUFLAGE	K AE M AH F L AA ZH
CAMOUFLAGEABLE	K AE M AH F L AA ZH AH B AH L
CAMOUFLAGED	K AE M AH F L AA ZH D
CAMOUFLAGES	K AE M AH F L AA ZH IH Z
CAMOUFLAGIC	K AE M AH F L AA ZH IH K
CAMOUFLAGING	K AE M AH F L AA ZH IH NG
CAMP	K AE M P
CAMPAGNA	K AE M P AE G N AH
CAMPAGNE	K AE M P AH N
CAMPAIGN	K AE M P EY N
CAMPAIGNED	K AE M P EY N D
CAMPAIGNER	K AE M P EY N ER
CAMPAIGNERS	K AE M P EY N ER Z
CAMPAIGNING	K AE M P EY N IH NG
CAMPAIGNS	K AE M P EY N Z
CAMPANILE	K AE M P EY N AH L
CAMPANILES	K AE M P AH N AH L Z
CAMPANILI	K AE M P AE N AH L IY
CAMPANOLOGIES	K AE M P EY N AA L AH JH IY Z
CAMPANOLOGIST	K AE M P EY N AA L AH JH AH S T
CAMPANOLOGISTS	K AE M P EY N AA L AH JH AH S T S
CAMPANOLOGY	K AE M P EY N AA L AH JH IY
CAMPANULA	K AE M P AH N Y UW L AH
CAMPANULAS	K AE M P AH N Y UW L AH Z
CAMPANULATE	K AE M P AE N Y AH L EY T
CAMPCRAFT	K AE M P K R AE F T
CAMPCRAFTS	K AE M P K R AE F T S
CAMPED	K AE M P T
CAMPER	K AE M P ER
CAMPERS	K AE M P ER Z
CAMPESINO	K AE M P EH S AH N OW
CAMPESINOS	K AE M P EH S IY N OW S
CAMPESTRAL	K AE M P EH S T R AH L
CAMPFIRE	K AE M P F AY ER
CAMPFIRES	K AE M P F AY ER Z
CAMPGROUND	K AE M P G R AW N D
CAMPGROUNDS	K AE M P G R AW N D Z
CAMPHENE	K AE M F IY N
CAMPHENES	K AE M F IY N Z
CAMPHINE	K AE M F AY N
CAMPHINES	K AE M F AY N Z
CAMPHIRE	K AE M P HH AY ER
CAMPHIRES	K AE M P HH AY ER Z
CAMPHOL	K AE M F AH L
CAMPHOLS	K AE M F AH L Z
CAMPHOR	K AE M F AH R
CAMPHORACEOUS	K AE M F AH R AH S IY AH S
CAMPHORATE	K AE M F AH R EY T
CAMPHORATED	K AE M F AH R EY T AH D
CAMPHORATES	K AE M F AH R EY T S
CAMPHORATING	K AE M F AH R EY T AH NG
CAMPHORS	K AE M F AH R Z
CAMPI	K AE M P IY
CAMPIER	K AE M P IY ER
CAMPIEST	K AE M P IY AH S T
CAMPILY	K AE M P IY L IY
CAMPINESS	K AE M P IY N AH S
CAMPINESSES	K AE M P IY N AH S IH Z
CAMPING	K AE M P IH NG
CAMPINGS	K AE M P IH NG Z
CAMPION	K AE M P IY AH N
CAMPIONS	K AE M P IY AH N Z
CAMPO	K AE M P OW
CAMPONG	K AE M P AH NG
CAMPONGS	K AE M P AH NG Z
CAMPOREE	K AE M P ER IY
CAMPOREES	K AE M P ER IY Z
CAMPOS	K AE M P OW Z
CAMPS	K AE M P S
CAMPSITE	K AE M P S AY T
CAMPSITES	K AE M P S AY T S
CAMPUS	K AE M P AH S
CAMPUSED	K AE M P AH S T
CAMPUSES	K AE M P AH S AH Z
CAMPUSES(2)	K AE M P AH S IH Z
CAMPUSING	K AE M P AH S IH NG
CAMPY	K AE M P IY
CAMPYLOBACTER	K AE M P IY L AA B AE K T ER
CAMPYLOBACTERS	K AE M P IY L AA B AE K T ER Z
CAMPYLOTROPOUS	K AE M P IY L AA T R OW P AH S
CAMS	K AE M Z
CAMSHAFT	K AE M SH AE F T
CAMSHAFTS	K AE M SH AE F T S
CAN	K AE N
CAN(2)	K AH N
CANAILLE	K AH N EY L
CANAILLES	K AH N EY L Z
CANAKIN	K AE N AH K IH N
CANAKINS	K AE N AH K IH N Z
CANAL	K AH N AE L
CANALED	K AH N AE L D
CANALICULAR	K AE N AH L IH S Y AH L AH R
CANALICULI	K AE N AH L AH K Y UW L IY
CANALICULUS	K AE N AH L IH S AH L AH S
CANALING	K AH N AE L IH NG
CANALISE	K AE N AH L AY Z
CANALISED	K AH N AE L IY Z D
CANALISES	K AH N AE L IY Z IH Z
CANALISING	K AH N AE L IY Z IH NG
CANALIZATION	K AH N AE L AH Z EY SH AH N
CANALIZATIONS	K AH N AE L AH Z EY SH AH N Z
CANALIZE	K AH N AE L AY Z
CANALIZED	K AH N AE L AY Z D
CANALIZES	K AH N AE L AY Z IH Z
CANALIZING	K AH N AE L AY Z IH NG
CANALLED	K AH N AE L D
CANALLER	K AH N AE L ER
CANALLERS	K AH N AE L ER Z
CANALLING	K AH N AE L IH NG
CANALS	K AH N AE L Z
CANAPE	K AE N EY P
CANAPES	K AE N EY P S
CANARD	K AH N AA R D
CANARDS	K AE N AH R D Z
CANARIES	K AH N EH R IY Z
CANARY	K AH N EH R IY
CANASTA	K AH N AE S T AH
CANASTAS	K AH N AE S T AH Z
CANCAN	K AE N K AE N
CANCANS	K AE N K AE N Z
CANCEL	K AE N S AH L
CANCELABLE	K AE N S AH L AH B AH L
CANCELATION	K AE N S AH L EY SH AH N
CANCELATIONS	K AE N S AH L EY SH AH N Z
CANCELED	K AE N S AH L D
CANCELER	K AE N S AH L ER
CANCELERS	K AE N S AH L ER Z
CANCELING	K AE N S AH L IH NG
CANCELING(2)	K AE N S L IH NG
CANCELLABLE	K AE N S AH L AH B AH L
CANCELLATION	K AE N S AH L EY SH AH N
CANCELLATIONS	K AE N S AH L EY SH AH N Z
CANCELLED	K AE N S AH L D
CANCELLER	K AE N S AH L ER
CANCELLERS	K AE N S AH L ER Z
CANCELLING	K AE N S AH L IH NG
CANCELLING(2)	K AE N S L IH NG
CANCELLOUS	K AE N S AH L AH S
CANCELS	K AE N S AH L Z
CANCER	K AE N S ER
CANCEROUS	K AE N S ER AH S
CANCEROUSLY	K AE N S ER AH S L IY
CANCERS	K AE N S ER Z
CANCHA	K AE NG K AH
CANCHAS	K AE NG K AH Z
CANCROID	K AE NG K R OY D
CANCROIDS	K AE NG K R OY D Z
CANDELA	K AE N D EH L AH
CANDELABRA	K AE N D AH L AA B R AH
CANDELABRAS	K AE N D AH L AE B R AH Z
CANDELABRUM	K AE N D IY L AE B R AH M
CANDELABRUMS	K AE N D IY L AE B R AH M Z
CANDELAS	K AE N D AH L AH Z
CANDENT	K AE N D AH N T
CANDESCENCE	K AE N D EH S AH N S
CANDESCENCES	K AE N D AH S EH N S AH Z
CANDESCENT	K AE N D IH S EH N T
CANDID	K AE N D AH D
CANDID(2)	K AE N D IH D
CANDIDA	K AE N D IH D AH
CANDIDACIES	K AE N D AH D AH S IY Z
CANDIDACY	K AE N D IH D AH S IY
CANDIDAS	K AE N D AH D AH Z
CANDIDATE	K AE N D AH D EY T
CANDIDATE(2)	K AE N AH D IH T
CANDIDATES	K AE N D AH D EY T S
CANDIDATES(2)	K AE N AH D IH T S
CANDIDATURE	K AE N D AH D AH CH ER
CANDIDATURES	K AE N D AH D AH CH ER Z
CANDIDER	K AE N D AH D ER
CANDIDEST	K AE N D AH D AH S T
CANDIDIASES	K AE N D IH D IY EY Z AH Z
CANDIDIASIS	K AE N D AH D IY AH S AH S
CANDIDLY	K AE N D IH D L IY
CANDIDNESS	K AE N D AH D N AH S
CANDIDNESSES	K AE N D AH D N AH S IH Z
CANDIDS	K AE N D AH D Z
CANDIED	K AE N D IY D
CANDIES	K AE N D IY Z
CANDLE	K AE N D AH L
CANDLEBERRIES	K AE N D AH L B EH R IY Z
CANDLEBERRY	K AE N D AH L B EH R IY
CANDLED	K AE N D AH L D
CANDLEFISH	K AE N D AH L F IH SH
CANDLEFISHES	K AE N D AH L F IH SH IH Z
CANDLEHOLDER	K AE N D AH L HH OW L D ER
CANDLEHOLDERS	K AE N D AH L HH OW L D ER Z
CANDLELIGHT	K AE N D AH L L AY T
CANDLELIGHTED	K AE N D AH L AY T IH D
CANDLELIGHTER	K AE N D AH L AY T ER
CANDLELIGHTERS	K AE N D AH L AY T ER Z
CANDLELIGHTS	K AE N D AH L AY T S
CANDLELIT	K AE N D AH L IH T
CANDLENUT	K AE N D AH L N AH T
CANDLENUTS	K AE N D AH L N AH T S
CANDLEPIN	K AE N D AH L P IH N
CANDLEPINS	K AE N D AH L P IH N Z
CANDLEPOWER	K AE N D AH L P AW ER
CANDLEPOWERS	K AE N D AH L P AW ER Z
CANDLER	K AE N D AH L ER
CANDLER(2)	K AE N D L ER
CANDLERS	K AE N D AH L ER Z
CANDLES	K AE N D AH L Z
CANDLESNUFFER	K AE N D AH L S N AH F ER
CANDLESNUFFERS	K AE N D AH L S N AH F ER Z
CANDLESTICK	K AE N D AH L S T IH K
CANDLESTICKS	K AE N D AH L S T IH K S
CANDLEWICK	K AE N D AH L W IH K
CANDLEWICKS	K AE N D AH L W IH K S
CANDLEWOOD	K AE N D AH L W UH D
CANDLEWOODS	K AE N D AH L W UH D Z
CANDLING	K AE N D L IH NG
CANDOR	K AE N D ER
CANDORS	K AE N D ER Z
CANDOUR	K AE N D ER
CANDOURS	K AE N D ER Z
CANDY	K AE N D IY
CANDYFLOSS	K AE N D IH F L AH S
CANDYFLOSSES	K AE N D IH F L AA S AH Z
CANDYGRAM	K AE N D IY G R AE M
CANDYGRAMS	K AE N D IY G R AE M Z
CANDYING	K AE N D IY IH NG
CANDYTUFT	K AE N D IY T AH F T
CANDYTUFTS	K AE N D IY T AH F T S
CANE	K EY N
CANEBRAKE	K EY N B R EY K
CANEBRAKES	K EY N B R EY K S
CANED	K EY N D
CANELLA	K AH N EH L AH
CANELLAS	K AH N EH L AH Z
CANEPHOR	K AE N AH F AH R
CANEPHORS	K AE N AH F AH R Z
CANER	K EY N ER
CANERS	K EY N ER Z
CANES	K EY N Z
CANESCENT	K EY N S EH N T
CANEWARE	K EY N W EH R
CANEWARES	K EY N W EH R Z
CANFIELD	K AE N F IY L D
CANFIELDS	K AE N F IY L D Z
CANFUL	K AE N F AH L
CANFULS	K AE N F AH L Z
CANGUE	K AE NG
CANGUES	K AE N G Z
CANICULAR	K AH N IH S Y AH L AH R
CANID	K EY N AH D
CANIDS	K EY N AH D Z
CANIKIN	K AE N AH K AH N
CANIKINS	K AE N AH K AH N Z
CANINE	K EY N AY N
CANINES	K EY N AY N Z
CANING	K EY N IH NG
CANINITIES	K EY N AY N AH T IY Z
CANINITY	K EY N AY N AH T IY
CANISTER	K AE N AH S T ER
CANISTER(2)	K AE N IH S T ER
CANISTERS	K AE N AH S T ER Z
CANISTERS(2)	K AE N IH S T ER Z
CANITIES	K EY N AH T IY Z
CANKER	K AE NG K ER
CANKERED	K AE NG K ER D
CANKERING	K AE NG K ER IH NG
CANKEROUS	K AE NG K ER AH S
CANKERS	K AE NG K ER Z
CANKERWORM	K AE NG K ER W ER M
CANKERWORMS	K AE NG K ER W ER M Z
CANNA	K AE N AH
CANNABIC	K AE N AE B IH K
CANNABIN	K AE N AE B IH N
CANNABINOID	K AE N AE B AH N OY D
CANNABINOIDS	K AE N AE B AH N OY D Z
CANNABINOL	K AE N AE B AH N AH L
CANNABINOLS	K AE N AE B AH N AH L Z
CANNABINS	K AE N AE B IH N Z
CANNABIS	K AE N AH B AH S
CANNABISES	K AE N AE B IY Z IH Z
CANNAS	K AE N AH Z
CANNED	K AE N D
CANNEL	K AE N AH L
CANNELLONI	K AE N EH L AH N IY
CANNELON	K AE N AH L AH N
CANNELONS	K AE N AH L AH N Z
CANNELS	K AE N AH L Z
CANNER	K AE N ER
CANNERIES	K AE N ER IY Z
CANNERS	K AE N ER Z
CANNERY	K AE N ER IY
CANNIBAL	K AE N AH B AH L
CANNIBALISE	K AE N IH B AH L AY Z
CANNIBALISED	K AE N AH B AH L IY Z D
CANNIBALISES	K AE N AH B AH L IY Z IH Z
CANNIBALISING	K AE N AH B AH L IY Z IH NG
CANNIBALISM	K AE N AH B AH L IH Z AH M
CANNIBALISMS	K AE N AH B AH L IH Z AH M Z
CANNIBALISTIC	K AE N AH B AH L IH S T IH K
CANNIBALIZATION	K AE N AH B AH L IH Z EY SH AH N
CANNIBALIZATIONS	K AE N AH B AH L AH Z EY SH AH N Z
CANNIBALIZE	K AE N AH B AH L AY Z
CANNIBALIZED	K AE N AH B AH L AY Z D
CANNIBALIZES	K AE N AH B AH L AY Z IH Z
CANNIBALIZING	K AE N AH B AH L AY Z IH NG
CANNIBALS	K AE N AH B AH L Z
CANNIE	K AE N IY
CANNIER	K AE N IY ER
CANNIEST	K AE N IY AH S T
CANNIKIN	K AE N AH K AH N
CANNIKINS	K AE N AH K AH N Z
CANNILY	K AE N IY L IY
CANNINESS	K AE N IY N AH S
CANNINESSES	K AE N IY N AH S IH Z
CANNING	K AE N IH NG
CANNINGS	K AE N IH NG Z
CANNISTER	K AE N IH S T ER
CANNISTERS	K AE N IH S T ER Z
CANNOLI	K AE N AH L IY
CANNOLIS	K AE N AH L AH S
CANNON	K AE N AH N
CANNONADE	K AE N AH N EY D
CANNONADED	K AE N AH N EY D IH D
CANNONADES	K AE N AH N EY D Z
CANNONADING	K AE N AH N EY D IH NG
CANNONBALL	K AE N AH N B AO L
CANNONBALLED	K AE N AH N B AO L D
CANNONBALLING	K AE N AH N B AO L IH NG
CANNONBALLS	K AE N AH N B AO L Z
CANNONED	K AE N AH N D
CANNONEER	K AE N AH N IH R
CANNONEERS	K AE N AH N IH R Z
CANNONING	K AE N AH N IH NG
CANNONRIES	K AE N AH N R IY Z
CANNONRY	K AE N AH N R IY
CANNONS	K AE N AH N Z
CANNOT	K AE N AA T
CANNOT(2)	K AH N AA T
CANNULA	K AE N Y UW L AH
CANNULAE	K AE N Y AH L IY
CANNULAR	K AE N Y AH L AH R
CANNULAS	K AE N Y UW L AH Z
CANNY	K AE N IY
CANOE	K AH N UW
CANOEABLE	K AH N UW AH B AH L
CANOED	K AH N UW D
CANOEING	K AH N UW IH NG
CANOEIST	K AH N UW AH S T
CANOEISTS	K AH N UW IH S T S
CANOES	K AH N UW Z
CANOLA	K AH N OW L AH
CANOLAS	K AE N AH L AH Z
CANON	K AE N AH N
CANONESS	K AE N AH N AH S
CANONESSES	K AE N AH N AH S IH Z
CANONIC	K AH N AA N AH K
CANONICAL	K AH N AA N AH K AH L
CANONICALLY	K AE N AH N IH K AH L IY
CANONICALS	K AE N AH N IH K AH L Z
CANONICITIES	K AE N AH N IH K S AH T IY Z
CANONICITY	K AE N AH N IH K S AH T IY
CANONISE	K AE N AH N AY Z
CANONISED	K AE N AH N IY Z D
CANONISES	K AE N AH N IY Z IH Z
CANONISING	K AE N AH N IY Z IH NG
CANONIST	K AE N AH N IH S T
CANONISTS	K AE N AH N IH S T S
CANONIZATION	K AE N AH N AH Z EY SH AH N
CANONIZATIONS	K AE N AH N AH Z EY SH AH N Z
CANONIZE	K AE N AH N AY Z
CANONIZED	K AE N AH N AY Z D
CANONIZES	K AE N AH N AY Z IH Z
CANONIZING	K AE N AH N AY Z IH NG
CANONRIES	K AE N AH N R IY Z
CANONRY	K AE N AH N R IY
CANONS	K AE N AH N Z
CANOODLE	K AH N UW D AH L
CANOODLED	K AH N UW D AH L D
CANOODLES	K AH N UW D AH L Z
CANOODLING	K AH N UW D L AH NG
CANOPIED	K AE N AH P IY D
CANOPIES	K AE N AH P IY Z
CANOPY	K AE N AH P IY
CANOPYING	K AE N AH P IY IH NG
CANOROUS	K EY N ER AH S
CANOROUSLY	K EY N ER AH S L IY
CANOROUSNESS	K EY N ER AH S N AH S
CANOROUSNESSES	K EY N ER AH S N AH S IH Z
CANS	K AE N Z
CANSFUL	K AE N Z F AH L
CANSO	K AE N S OW
CANSOS	K AE N Z AA S
CANST	K AE N S T
CANT	K AE N T
CANTABILE	K AE N T AH B AY L
CANTALA	K AE N T AH L AH
CANTALAS	K AE N T AH L AH Z
CANTALOUP	K AE N T AH L UW P
CANTALOUPE	K AE N T AH L OW P
CANTALOUPES	K AE N T AH L OW P S
CANTALOUPS	K AE N T AH L UW P S
CANTANKEROUS	K AE N T AE NG K ER AH S
CANTANKEROUSLY	K AE N T AE NG K ER AH S L IY
CANTANKEROUSNESS	K AE N T AE NG K ER AH S N AH S
CANTANKEROUSNESSES	K AE N T AE NG K ER AH S N AH S IH Z
CANTATA	K AE N T AA T AH
CANTATAS	K AE N T AH T AH Z
CANTATRICE	K AE N T AE T R AY S
CANTATRICES	K AE N T AE T R AY S IH Z
CANTATRICI	K AE N T AE T R AH S IY
CANTDOG	K AE N T D AO G
CANTDOGS	K AE N T D AO G Z
CANTED	K AE N T IH D
CANTEEN	K AE N T IY N
CANTEENS	K AE N T IY N Z
CANTER	K AE N T ER
CANTERED	K AE N T ER D
CANTERING	K AE N T ER IH NG
CANTERS	K AE N T ER Z
CANTHAL	K AE N TH AH L
CANTHARIDES	K AE N TH AH R AY D Z
CANTHARIDIN	K AE N TH ER AH D IH N
CANTHARIDINS	K AE N TH ER AH D IH N Z
CANTHARIS	K AE N TH EH R IY Z
CANTHAXANTHIN	K AE N TH AH K S AE N TH AH N
CANTHAXANTHINS	K AE N TH AH K S AE N TH AH N Z
CANTHI	K AE N TH IY
CANTHUS	K AE N DH AH S
CANTIC	K AE N T IH K
CANTICLE	K AE N T IH K AH L
CANTICLES	K AE N T IH K AH L Z
CANTILENA	K AE N T IH L AH N AH
CANTILENAS	K AE N T IH L AH N AH Z
CANTILEVER	K AE N T AH L IY V ER
CANTILEVERED	K AE N T AH L IY V ER D
CANTILEVERING	K AE N T AH L IY V ER IH NG
CANTILEVERS	K AE N T AH L IY V ER Z
CANTILLATE	K AE N T IH L AH T
CANTILLATED	K AE N T IH L EY T IH D
CANTILLATES	K AE N T IH L AH T S
CANTILLATING	K AE N T IH L EY T IH NG
CANTILLATION	K AE N T IH L EY SH AH N
CANTILLATIONS	K AE N T IH L EY SH AH N Z
CANTINA	K AE N T IY N AH
CANTINAS	K AE N T AH N AH Z
CANTING	K AE N T IH NG
CANTLE	K AE N T AH L
CANTLES	K AE N T AH L Z
CANTO	K AE N T OW
CANTON	K AE N T AH N
CANTONAL	K AE N T AH N AH L
CANTONED	K AE N T AH N D
CANTONING	K AE N T AH N IH NG
CANTONMENT	K AE N T AH N M AH N T
CANTONMENTS	K AE N T AH N M AH N T S
CANTONS	K AE N T AH N Z
CANTOR	K AE N T ER
CANTORIAL	K AE N T OW R IY AH L
CANTORS	K AE N T ER Z
CANTOS	K AE N T OW Z
CANTRAIP	K AE N T R EY P
CANTRAIPS	K AE N T R EY P S
CANTRAP	K AE N T R AE P
CANTRAPS	K AE N T R AE P S
CANTRIP	K AE N T R IH P
CANTRIPS	K AE N T R IH P S
CANTS	K AE N T S
CANTUS	K AE N T AH S
CANTY	K AE N T IY
CANULA	K AE N Y UW L AH
CANULAE	K AE N Y AH L IY
CANULAS	K AE N Y UW L AH Z
CANULATE	K AE N Y AH L EY T
CANULATED	K AE N Y AH L EY T AH D
CANULATES	K AE N Y AH L EY T S
CANULATING	K AE N Y AH L EY T AH NG
CANVAS	K AE N V AH S
CANVASBACK	K AE N V AH S B AE K
CANVASBACKS	K AE N V AH S B AE K S
CANVASED	K AE N V AH S T
CANVASER	K AE N V AH S ER
CANVASERS	K AE N V AH S ER Z
CANVASES	K AE N V AH S IH Z
CANVASING	K AE N V AH S IH NG
CANVASLIKE	K AE N V AH S L AY K
CANVASS	K AE N V AH S
CANVASSED	K AE N V AH S T
CANVASSER	K AE N V AH S ER
CANVASSERS	K AE N V AH S ER Z
CANVASSES	K AE N V AH S IH Z
CANVASSING	K AE N V AH S IH NG
CANYON	K AE N Y AH N
CANYONS	K AE N Y AH N Z
CANZONA	K AE N Z AH N AH
CANZONAS	K AE N Z AH N AH Z
CANZONE	K AE N Z OW N
CANZONES	K AE N Z OW N Z
CANZONET	K AE N Z AH N AH T
CANZONETS	K AE N Z AH N AH T S
CANZONI	K AE N Z AH N IY
CAOUTCHOUC	K EY AW CH AW K
CAOUTCHOUCS	K EY AW CH AW K S
CAP	K AE P
CAPABILITIES	K EY P AH B IH L AH T IY Z
CAPABILITY	K EY P AH B IH L AH T IY
CAPABLE	K EY P AH B AH L
CAPABLENESS	K EY P AH B AH L N AH S
CAPABLENESSES	K EY P AH B AH L N AH S IH Z
CAPABLER	K EY P AH B AH L ER
CAPABLEST	K EY P AH B AH L AH S T
CAPABLY	K EY P AH B L IY
CAPACIOUS	K AH P EY SH AH S
CAPACIOUSLY	K AH P EY SH AH S L IY
CAPACIOUSNESS	K AH P EY SH AH S N AH S
CAPACIOUSNESSES	K AH P EY SH AH S N AH S IH Z
CAPACITANCE	K AH P AE S AH T AH N S
CAPACITANCES	K AH P AE S AH T AH N S IH Z
CAPACITATE	K AH P AE S AH T AH T
CAPACITATED	K AH P AE S AH T EY T IH D
CAPACITATES	K AH P AE S AH T AH T S
CAPACITATING	K AH P AE S AH T EY T IH NG
CAPACITATION	K AH P AE S AH T EY SH AH N
CAPACITATIONS	K AH P AE S AH T EY SH AH N Z
CAPACITIES	K AH P AE S AH T IY Z
CAPACITIES(2)	K AH P AE S IH T IY Z
CAPACITIVE	K AH P AE S AH T IH V
CAPACITIVELY	K AH P AE S AH T IH V L IY
CAPACITOR	K AH P AE S AH T ER
CAPACITORS	K AH P AE S AH T ER Z
CAPACITORS(2)	K AH P AE S IH T ER Z
CAPACITY	K AH P AE S AH T IY
CAPACITY(2)	K AH P AE S IH T IY
CAPARISON	K EY P EH R IY Z AO N
CAPARISONED	K EY P EH R IY Z AO N D
CAPARISONING	K EY P EH R IY Z AO N IH NG
CAPARISONS	K EY P EH R IY Z AO N Z
CAPE	K EY P
CAPED	K EY P T
CAPELAN	K AE P EY L AA N
CAPELANS	K AE P EY L AA N Z
CAPELET	K EY P L AH T
CAPELETS	K EY P L AH T S
CAPELIN	K AE P AH L AH N
CAPELINS	K AE P AH L AH N Z
CAPER	K EY P ER
CAPERCAILLIE	K AE P AH R K EY L AY
CAPERCAILLIES	K AH P AH R K EY L AY Z
CAPERCAILZIE	K AE P ER K EY L Z IY
CAPERCAILZIES	K AE P ER K EY L Z IY Z
CAPERED	K EY P ER D
CAPERER	K EY P ER ER
CAPERERS	K EY P ER ER Z
CAPERING	K EY P ER IH NG
CAPERS	K EY P ER Z
CAPES	K EY P S
CAPESKIN	K EY P S K IH N
CAPESKINS	K EY P S K IH N Z
CAPEWORK	K EY P W ER K
CAPEWORKS	K EY P W ER K S
CAPFUL	K EY P F AH L
CAPFULS	K EY P F AH L Z
CAPH	K AE F
CAPHS	K AE F S
CAPIAS	K EY P IY AH Z
CAPIASES	K EY P IY EY Z AH Z
CAPILLARIES	K AE P AH L EH R IY Z
CAPILLARITIES	K AE P IH L ER AH T IY Z
CAPILLARITY	K AE P IH L ER AH T IY
CAPILLARY	K AE P AH L EH R IY
CAPITA	K AE P IH T AH
CAPITAL	K AE P IH T AH L
CAPITALISE	K AH P IH T AH L AY Z
CAPITALISED	K AE P AH T AH L IY Z D
CAPITALISES	K AE P AH T AH L IY Z IH Z
CAPITALISING	K AE P AH T AH L IY Z IH NG
CAPITALISM	K AE P IH T AH L IH Z AH M
CAPITALISMS	K AE P AH T AH L IH Z AH M Z
CAPITALIST	K AE P AH T AH L IH S T
CAPITALISTIC	K AE P IH T AH L IH S T IH K
CAPITALISTICALLY	K AE P AH T AH L IH S T IH K AH L IY
CAPITALISTS	K AE P AH T AH L IH S T S
CAPITALIZATION	K AE P IH T AH L IH Z EY SH AH N
CAPITALIZATIONS	K AE P IH T AH L IH Z EY SH AH N Z
CAPITALIZE	K AE P AH T AH L AY Z
CAPITALIZED	K AE P IH T AH L AY Z D
CAPITALIZES	K AE P AH T AH L AY Z IH Z
CAPITALIZING	K AE P IH T AH L AY Z IH NG
CAPITALLY	K AE P AH T AH L IY
CAPITALS	K AE P AH T AH L Z
CAPITALS(2)	K AE P IH T AH L Z
CAPITATE	K AE P AH T EY T
CAPITATION	K AE P AH T EY SH AH N
CAPITATIONS	K AE P AH T EY T IY AH N Z
CAPITOL	K AE P IH T AH L
CAPITOLS	K AE P IH T AH L Z
CAPITULA	K AE P AH T Y UW L AH
CAPITULAR	K AH P IH CH AH L ER
CAPITULARIES	K AH P IH CH AH L EH R IY Z
CAPITULARY	K AH P IH CH AH L EH R IY
CAPITULATE	K AH P IH CH UW L EY T
CAPITULATED	K AH P IH CH AH L EY T IH D
CAPITULATES	K AH P IH CH AH L AH T S
CAPITULATING	K AH P IH CH AH L EY T IH NG
CAPITULATION	K AH P IH CH AH L EY SH AH N
CAPITULATIONS	K AH P IH CH AH L EY SH AH N Z
CAPITULUM	K AE P AH T Y UW L AH M
CAPLESS	K EY P L AH S
CAPLET	K EY P L AH T
CAPLETS	K EY P L AH T S
CAPLIN	K AE P L IH N
CAPLINS	K AE P L AH N Z
CAPMAKER	K AE P M EY K ER
CAPMAKERS	K AE P M EY K ER Z
CAPO	K AA P OW
CAPON	K EY P AA N
CAPONATA	K AH P AA N AH T AH
CAPONATAS	K AH P AA N AH T AH Z
CAPONIER	K AE P AO N IY ER
CAPONIERS	K AE P AO N IY ER Z
CAPONIZE	K AE P AO N AY Z
CAPONIZED	K AE P AO N AY Z D
CAPONIZES	K AE P AO N AY Z IH Z
CAPONIZING	K AE P AO N AY Z IH NG
CAPONS	K AE P AO N Z
CAPORAL	K EY P ER AH L
CAPORALS	K EY P ER AH L Z
CAPOS	K AE P AA S
CAPOTE	K AH P OW T
CAPOTES	K AH P OW T S
CAPOUCH	K AH P AW CH
CAPOUCHES	K AH P AW CH AH Z
CAPPED	K AE P T
CAPPELLETTI	K AA P EH L EH T IY
CAPPER	K AE P ER
CAPPERS	K EY P ER Z
CAPPING	K AE P IH NG
CAPPINGS	K AE P IH NG Z
CAPPUCCINO	K AE P UW CH IY N OW
CAPPUCCINOS	K AE P AH K S AH N AH Z
CAPRIC	K AE P R AH K
CAPRICCI	K AE P R IH K S IY
CAPRICCIO	K AE P R IH K S IY OW
CAPRICCIOS	K AE P R IH K S IY AH Z
CAPRICE	K AH P R IY S
CAPRICES	K AH P R IY S AH Z
CAPRICIOUS	K AH P R IH SH AH S
CAPRICIOUSLY	K AH P R IH SH IH S L IY
CAPRICIOUSNESS	K AH P R IH SH AH S N AH S
CAPRICIOUSNESSES	K AH P R IH SH AH S N AH S IH Z
CAPRIFICATION	K AE P R AH F AH K EY SH AH N
CAPRIFICATIONS	K AE P R AH F AH K EY T IY AH N Z
CAPRIFIG	K AE P R AH F AH G
CAPRIFIGS	K AE P R AH F AH G Z
CAPRINE	K AE P R AY N
CAPRIOLE	K AE P R IY OW L
CAPRIOLED	K AE P R IY OW L D
CAPRIOLES	K AE P R IY OW L Z
CAPRIOLING	K AE P R IY OW L AH NG
CAPRIS	K EY P R IY Z
CAPROCK	K AE P R AA K
CAPROCKS	K AE P R AA K S
CAPROLACTAM	K AE P R AH L AE K T AH M
CAPROLACTAMS	K AE P R AH L AE K T AH M Z
CAPS	K AE P S
CAPSAICIN	K AE P S EY S AH N
CAPSAICINS	K AE P S EY S AH N Z
CAPSICIN	K AE P S IH K IH N
CAPSICINS	K AE P S IH K IH N Z
CAPSICUM	K AE P S IH K AH M
CAPSICUMS	K AE P S IH K AH M Z
CAPSID	K AE P S AH D
CAPSIDAL	K AE P S AY D AH L
CAPSIDS	K AE P S AH D Z
CAPSIZE	K AE P S AY Z
CAPSIZED	K AE P S AY Z D
CAPSIZES	K AE P S AY Z IH Z
CAPSIZING	K AE P S AY Z IH NG
CAPSOMER	K EY P S AH M ER
CAPSOMERS	K EY P S AH M ER Z
CAPSTAN	K AE P S T AH N
CAPSTANS	K AE P S T AH N Z
CAPSTONE	K AE P S T OW N
CAPSTONES	K AE P S T OW N Z
CAPSULAR	K AE P S AH L ER
CAPSULATED	K AE P S AH L EY T IH D
CAPSULE	K AE P S AH L
CAPSULED	K AE P S AH L D
CAPSULES	K AE P S AH L Z
CAPSULING	K AE P S AH L IH NG
CAPSULIZE	K AE P S AH L AY Z
CAPSULIZED	K AE P S AH L AY Z D
CAPSULIZES	K AE P S AH L AY Z IH Z
CAPSULIZING	K AE P S AH L AY Z IH NG
CAPTAIN	K AE P T AH N
CAPTAINCIES	K AE P T AH N S IY Z
CAPTAINCY	K AE P T AH N S IY
CAPTAINED	K AE P T AH N D
CAPTAINING	K AE P T AH N IH NG
CAPTAINS	K AE P T AH N Z
CAPTAINSHIP	K AE P T AH N SH IH P
CAPTAINSHIPS	K AE P T AH N SH IH P S
CAPTAN	K AE P T AE N
CAPTANS	K AE P T AE N Z
CAPTION	K AE P SH AH N
CAPTIONED	K AE P SH AH N D
CAPTIONING	K AE P SH AH N IH NG
CAPTIONLESS	K AE P SH AH N L AH S
CAPTIONS	K AE P SH AH N Z
CAPTIOUS	K AE P SH AH S
CAPTIOUSLY	K AE P SH AH S L IY
CAPTIOUSNESS	K AE P SH AH S N AH S
CAPTIOUSNESSES	K AE P SH AH S N AH S IH Z
CAPTIVATE	K AE P T IH V EY T
CAPTIVATED	K AE P T IH V EY T IH D
CAPTIVATES	K AE P T IH V EY T S
CAPTIVATING	K AE P T IH V EY T IH NG
CAPTIVATION	K AE P T IH V EY SH AH N
CAPTIVATIONS	K AE P T IH V EY SH AH N Z
CAPTIVATOR	K AE P T IH V AH T ER
CAPTIVATORS	K AE P T IH V AH T ER Z
CAPTIVE	K AE P T IH V
CAPTIVES	K AE P T IH V Z
CAPTIVITIES	K AE P T IH V AH T IY Z
CAPTIVITY	K AE P T IH V AH T IY
CAPTOPRIL	K AE P T AA P R AH L
CAPTOPRILS	K AE P T AA P R AH L Z
CAPTOR	K AE P T ER
CAPTORS	K AE P T ER Z
CAPTURE	K AE P CH ER
CAPTURED	K AE P CH ER D
CAPTURER	K AE P CH ER ER
CAPTURERS	K AE P CH ER ER Z
CAPTURES	K AE P CH ER Z
CAPTURING	K AE P CH ER IH NG
CAPUCHE	K AE P AH CH
CAPUCHED	K AE P AH CH T
CAPUCHES	K AE P AH CH AH Z
CAPUCHIN	K AE P AH CH AH N
CAPUCHINS	K AE P AH CH AH N Z
CAPUT	K AH P UH T
CAPYBARA	K AH P IH B AH R AH
CAPYBARAS	K AH P IH B AH R AH Z
CAR	K AA R
CARABAO	K AE R AH B AW
CARABAOS	K AE R AH B AW Z
CARABID	K AA R AH B IH D
CARABIDS	K AA R AH B IH D Z
CARABIN	K AA R AH B IH N
CARABINE	K AE R AH B AY N
CARABINEER	K AA R AH B IH N IH R
CARABINEERS	K AA R AH B IH N IH R Z
CARABINER	K AA R AH B IH N ER
CARABINERO	K AE R AH B IH N AH R OW
CARABINEROS	K AA R AH B IH N ER AA S
CARABINERS	K AA R AH B IH N ER Z
CARABINES	K AE R AH B AY N Z
CARABINIER	K AA R AH B IH N IY ER
CARABINIERE	K AH R AE B AH N IY R
CARABINIERI	K AE R AH B AH N IY R IY
CARABINIERS	K AA R AH B IH N IY ER Z
CARABINS	K AA R AH B IH N Z
CARACAL	K AA R EY S AH L
CARACALS	K AA R EY S AH L Z
CARACARA	K AA R AH K AA R AH
CARACARAS	K AH R AE K AH R AH Z
CARACK	K AE R AH K
CARACKS	K AE R AH K S
CARACOL	K AE R AH K AH L
CARACOLE	K AA R AH K OW L
CARACOLED	K AA R AH K OW L D
CARACOLES	K AA R AH K OW L Z
CARACOLING	K AA R AH K OW L IH NG
CARACOLLED	K AE R AH K AH L D
CARACOLLING	K AE R AH K AA L AH NG
CARACOLS	K AE R AH K AH L Z
CARACUL	K AE R AH K AH L
CARACULS	K AE R AH S AH L Z
CARAFE	K AH R AE F
CARAFES	K AH R EY F S
CARAGANA	K AH R AE G AH N AH
CARAGANAS	K AH R AE G AH N AH Z
CARAGEEN	K EH R IH JH AH N
CARAGEENS	K EH R IH JH AH N Z
CARAMBA	K AH R AE M B AH
CARAMBOLA	K AH R AE M B AH L AH
CARAMBOLAS	K AH R AE M B AH L AH Z
CARAMEL	K EH R AH M AH L
CARAMELISE	K AH R AE M AH L AY Z
CARAMELISED	K AA R M AH L IY Z D
CARAMELISES	K AA R M AH L IY Z IH Z
CARAMELISING	K AA R M AH L IY Z IH NG
CARAMELIZE	K EH R AH M AH L AY Z
CARAMELIZED	K EH R AH M AH L AY Z D
CARAMELIZES	K AA R M AH L AY Z IH Z
CARAMELIZING	K AA R M AH L AY Z IH NG
CARAMELS	K AA R M AH L Z
CARANGID	K AH R AE N JH AH D
CARANGIDS	K AH R AE N JH AH D Z
CARAPACE	K AA R AH P EY S
CARAPACES	K AA R AH P EY S IH Z
CARAPAX	K AA R AH P AA K S
CARAPAXES	K AA R AH P AA K S IH Z
CARASSOW	K AH R AE S OW
CARASSOWS	K AH R AE S OW Z
CARAT	K EH R AH T
CARATE	K EH R AH T
CARATES	K EH R AH T S
CARATS	K EH R AH T S
CARAVAN	K AE R AH V AE N
CARAVAN(2)	K EH R AH V AE N
CARAVANED	K AE R AH V AE N D
CARAVANER	K AE R AH V AE N ER
CARAVANERS	K AE R AH V AE N ER Z
CARAVANING	K AE R AH V AE N IH NG
CARAVANNED	K AE R AH V AE N D
CARAVANNER	K AE R AH V AE N ER
CARAVANNERS	K AE R AH V AE N ER Z
CARAVANNING	K AE R AH V AE N IH NG
CARAVANS	K AE R AH V AE N Z
CARAVANS(2)	K EH R AH V AE N Z
CARAVANSARIES	K AE R AH V AE N S AA R IY Z
CARAVANSARY	K AE R AH V AE N Z EH R IY
CARAVANSERAI	K AE R AH V AE N S AH R EY
CARAVANSERAIS	K AE R AH V AE N Z IH R AH IY Z
CARAVEL	K EH R AH V EH L
CARAVELS	K AE R AH V AH L Z
CARAWAY	K AE R AH W EY
CARAWAY(2)	K EH R AH W EY
CARAWAYS	K AE R AH W EY Z
CARB	K AA R B
CARBACHOL	K AA R B AH CH AH L
CARBACHOLS	K AA R B AH CH AH L Z
CARBAMATE	K AA R B AH M EY T
CARBAMATES	K AA R B AH M EY T S
CARBAMIC	K AA R B AH M AH K
CARBAMIDE	K AA R B AH M AY D
CARBAMIDES	K AA R B AH M AY D Z
CARBAMINO	K AA R B AE M AH N OW
CARBAMYL	K AA R B AH M AH L
CARBAMYLS	K AA R B AH M AH L Z
CARBANION	K AA R B EY N Y AH N
CARBANIONS	K AA R B EY N Y AH N Z
CARBARN	K AA R B AA R N
CARBARNS	K AA R B AA R N Z
CARBARYL	K AA R B AH R AH L
CARBARYLS	K AA R B AH R AH L Z
CARBAZOLE	K AA R B AH Z OW L
CARBAZOLES	K AA R B AH Z OW L Z
CARBIDE	K AA R B AY D
CARBIDES	K AA R B AY D Z
CARBINE	K AA R B AY N
CARBINES	K AA R B AY N Z
CARBINOL	K AA R B AH N AH L
CARBINOLS	K AA R B AH N AH L Z
CARBO	K AA R B OW
CARBOCYCLIC	K AA R B AH S AH K L AH K
CARBOHYDRASE	K AA R B AA HH AH D R EY Z
CARBOHYDRASES	K AA R B AA HH AH D R EY Z AH Z
CARBOHYDRATE	K AA R B OW HH AY D R EY T
CARBOHYDRATE(2)	K AA R B OW HH AY D R AH T
CARBOHYDRATES	K AA R B OW HH AY D R EY T S
CARBOLIC	K AA R B AH L AH K
CARBOLICS	K AA R B AH L AH S Z
CARBON	K AA R B AH N
CARBONACEOUS	K AA R B AH N EY S AH S
CARBONADE	K AA R B AH N EY D
CARBONADES	K AA R B AH N EY D Z
CARBONADO	K AA R B AH N AH D UW
CARBONADOED	K AA R B AH N AH D OW D
CARBONADOES	K AA R B AH N AH D OW Z
CARBONADOING	K AA R B AH N AH D OW IH NG
CARBONADOS	K AA R B AH N AH D UW Z
CARBONARA	K AA R B OW N AA R AH
CARBONARAS	K AA R B AA N AH R AH Z
CARBONATE	K AA R B AH N EY T
CARBONATED	K AA R B AH N EY T IH D
CARBONATES	K AA R B AH N EY T S
CARBONATING	K AA R B AH N EY T IH NG
CARBONATION	K AA R B AH N EY SH AH N
CARBONATIONS	K AA R B AH N EY SH AH N Z
CARBONIC	K AA R B AO N IH K
CARBONIFEROUS	K AA R B AH N IH F ER AH S
CARBONIZATION	K AA R B AH N AH Z EY SH AH N
CARBONIZATIONS	K AA R B AH N AH Z EY SH AH N Z
CARBONIZE	K AA R B AH N AY Z
CARBONIZED	K AA R B AH N AY Z D
CARBONIZES	K AA R B AH N AY Z IH Z
CARBONIZING	K AA R B AH N AY Z IH NG
CARBONLESS	K AA R B AH N L AH S
CARBONNADE	K AA R B AH N EY D
CARBONNADES	K AA R B AH N EY D Z
CARBONS	K AA R B AH N Z
CARBONYL	K AA R B AH N IH L
CARBONYLATION	K AA R B AH N IH L EY SH AH N
CARBONYLATIONS	K AA R B AH N IH L EY SH AH N Z
CARBONYLIC	K AA R B AH N IH L IH K
CARBONYLS	K AA R B AH N IH L Z
CARBORA	K AA R B AH R AH
CARBORAS	K AA R B AH R AH Z
CARBOS	K AA R B AH Z
CARBOXYL	K AA R B AA K S AH L
CARBOXYLASE	K AA R B AA K S AH L EY Z
CARBOXYLASES	K AA R B AA K S AH L EY Z AH Z
CARBOXYLATE	K AA R B AA K S IY L EY T
CARBOXYLATED	K AA R B AA K S IY L EY T IH D
CARBOXYLATES	K AA R B AA K S IY L EY T S
CARBOXYLATING	K AA R B AA K S IY L EY T IH NG
CARBOXYLATION	K AA R B AA K S IY L EY SH AH N
CARBOXYLATIONS	K AA R B AA K S IY L EY SH AH N Z
CARBOXYLIC	K AA R B AO K S IH L IH K
CARBOXYLS	K AA R B AA K S AH L Z
CARBOXYMETHYLCELLULOSE	K AA R B AA K S IY M EH TH AH L S EH L Y AH L OW S
CARBOXYMETHYLCELLULOSES	K AA R B AA K S IY M EH TH AH L S EH L Y AH L OW S IH
CARBOXYPEPTIDASE	K AA R B AA K S IY P EH P T AH D EY Z
CARBOXYPEPTIDASES	K AA R B AA K S IY P EH P T AH D EY Z IH Z
CARBOY	K AA R B OY
CARBOYED	K AA R B OY D
CARBOYS	K AA R B OY Z
CARBS	K AA R B Z
CARBUNCLE	K AA R B AH NG K AH L
CARBUNCLED	K AA R B AH NG K AH L D
CARBUNCLES	K AA R B AH NG K AH L Z
CARBUNCULAR	K AA R B AH NG K Y AH L AH R
CARBURET	K AA R B Y AH R AH T
CARBURETED	K AA R B Y ER EH T IH D
CARBURETING	K AA R B Y AH R IY T AH NG
CARBURETION	K AA R B Y ER IY SH AH N
CARBURETIONS	K AA R B Y AH R IY T IY AH N Z
CARBURETOR	K AA R B ER EY T ER
CARBURETORS	K AA R B ER EY T ER Z
CARBURETS	K AA R B Y AH R AH T S
CARBURETTED	K AA R B IY Y ER EH T IH D
CARBURETTER	K AA R B IY Y ER EH T ER
CARBURETTERS	K AA R B IY Y ER EH T ER Z
CARBURETTING	K AA R B IY Y ER EH T IH NG
CARBURETTOR	K AA R B IY Y ER EH T ER
CARBURETTORS	K AA R B IY Y ER EH T ER Z
CARBURISE	K AA R B Y AH R AY Z
CARBURISED	K AA R B EH R IY Z D
CARBURISES	K AA R B EH R IY Z IH Z
CARBURISING	K AA R B EH R IY Z IH NG
CARBURIZATION	K AA R B IY Y ER AH Z EY SH AH N
CARBURIZATIONS	K AA R B IY Y ER AH Z EY SH AH N Z
CARBURIZE	K AA R B IY Y ER AY Z
CARBURIZED	K AA R B IY Y ER AY Z D
CARBURIZES	K AA R B IY Y ER AY Z IH Z
CARBURIZING	K AA R B IY Y ER AY Z IH NG
CARCAJOU	K AA R K AH JH UW
CARCAJOUS	K AA R K AH JH AH S
CARCANET	K AA R K AH N AH T
CARCANETS	K AA R K AH N AH T S
CARCASE	K AA R K EY S
CARCASES	K AA R K EY S IH Z
CARCASS	K AA R K AH S
CARCASSES	K AA R K AH S IH Z
CARCEL	K AA R S AH L
CARCELS	K AA R S AH L Z
CARCINOGEN	K AA R S IH N AH JH AH N
CARCINOGENESES	K AA R S AH N AA JH AH N IY Z AH Z
CARCINOGENESIS	K AA R S AH N AH JH IY N AH S AH S
CARCINOGENIC	K AA R S AH N OW JH EH N IH K
CARCINOGENICITIES	K AA R S IH N AH JH AH N IH S AH T AY Z
CARCINOGENICITY	K AA R S AH N AA JH AH N IH S AH T IY
CARCINOGENS	K AA R S IH N AH JH AH N Z
CARCINOID	K AA R S AH N OY D
CARCINOIDS	K AA R S AH N OY D Z
CARCINOMA	K AA R S AH N OW M AH
CARCINOMAS	K AA R S AH N OW M AH Z
CARCINOMATA	K AA R S AH N AA M AH T AH
CARCINOMATOSES	K AA R S AH N AA M AH T OW Z AH Z
CARCINOMATOSIS	K AA R S IH N AH M AH T OW S AH S
CARCINOMATOUS	K AA R S AH N AA M AH T AH S
CARCINOSARCOMA	K AA R S AH N AH S AA R K AH M AH
CARCINOSARCOMAS	K AA R S AH N AH S AA R K AH M AH Z
CARCINOSARCOMATA	K AA R S IH N AH S AH R K AA M AH T AH
CARD	K AA R D
CARDAMOM	K AA R D AH M AH M
CARDAMOMS	K AA R D AH M AH M Z
CARDAMON	K AA R D AE M AO N
CARDAMONS	K AA R D AE M AO N Z
CARDAMUM	K AA R D AH M AH M
CARDAMUMS	K AA R D AH M AH M Z
CARDBOARD	K AA R D B AO R D
CARDBOARDS	K AA R D B AO R D Z
CARDCASE	K AA R D K EY S
CARDCASES	K AA R D K EY S IH Z
CARDED	K AA R D IH D
CARDER	K AA R D ER
CARDERS	K AA R D ER Z
CARDHOLDER	K AA R D HH OW L D ER
CARDHOLDERS	K AA R D HH OW L D ER Z
CARDIA	K AA R D IY AH
CARDIAC	K AA R D IY AE K
CARDIACS	K AA R D IY AE K S
CARDIAE	K AA R D IY IY
CARDIAS	K AA R D IY AH Z
CARDIGAN	K AA R D IH G AH N
CARDIGANS	K AA R D IH G AH N Z
CARDINAL	K AA R D IH N AH L
CARDINALATE	K AA R D AH N AH L AH T
CARDINALATES	K AA R D AH N AH L AH T S
CARDINALITIES	K AA R D AH N AH L AH T IY Z
CARDINALITY	K AA R D AH N AH L AH T IY
CARDINALLY	K AA R D AH N AH L IY
CARDINALS	K AA R D IH N AH L Z
CARDINALSHIP	K AA R D AH N AH L SH IH P
CARDINALSHIPS	K AA R D AH N AH L SH IH P S
CARDING	K AA R D IH NG
CARDINGS	K AA R D IH NG Z
CARDIOGENIC	K AA R D IY AH JH AH N AH K
CARDIOGRAM	K AA R D IY AA G R AH M
CARDIOGRAMS	K AA R D IY AA G R AH M Z
CARDIOGRAPH	K AA R D IY AA G R AH F
CARDIOGRAPHIC	K AA R D IY AA G R AH F AH K
CARDIOGRAPHIES	K AA R D IY AA G R AH F AY Z
CARDIOGRAPHS	K AA R D IY AA G R AH F S
CARDIOGRAPHY	K AA R D IY AA G R AH F IY
CARDIOID	K AA R D AY OY D
CARDIOIDS	K AA R D IY OY D Z
CARDIOLOGICAL	K AA R D IY AA L AH JH IH S AH L
CARDIOLOGIES	K AA R D IY AA L AH JH IY Z
CARDIOLOGIST	K AA R D IY AA L AH JH IH S T
CARDIOLOGISTS	K AA R D IY AA L AH JH IH S T S
CARDIOLOGY	K AA R D IY AA L AH JH IY
CARDIOMYOPATHIES	K AA R D IY AH M AY AA P AH TH AY Z
CARDIOMYOPATHY	K AA R D IY AH M AY AA P AH TH IY
CARDIOPATHIES	K AA R D IY AA P AH TH AY Z
CARDIOPATHY	K AA R D IY AA P AH TH IY
CARDIOPULMONARY	K AA R D IY OW P UH L M AH N EH R IY
CARDIORESPIRATORY	K AA R D IY AH R EH S AH R AH T AO R IY
CARDIOTHORACIC	K AA R D IY AA TH AH R AH S AH K
CARDIOTONIC	K AA R D IY AH T AH N AH K
CARDIOTONICS	K AA R D IY AA T AH N AH S Z
CARDIOVASCULAR	K AA R D IY OW V AE S K Y AH L ER
CARDITIC	K AA R D AY T IH K
CARDITIDES	K AA R D AH T AY D Z
CARDITIS	K AA R D AH T IY Z
CARDITISES	K AA R D AH T IY Z IH Z
CARDOON	K AA R D UW N
CARDOONS	K AA R D UW AO N Z
CARDPLAYER	K AA R D P L EY ER
CARDPLAYERS	K AA R D P L EY ER Z
CARDS	K AA R D Z
CARDSHARP	K AA R D SH AA R P
CARDSHARPER	K AA R D SH AA R P ER
CARDSHARPERS	K AA R D SH AA R P ER Z
CARDSHARPS	K AA R D SH AA R P S
CARE	K EH R
CARED	K EH R D
CAREEN	K ER IY N
CAREENED	K ER IY N D
CAREENER	K AH R IY N ER
CAREENERS	K AH R IY N ER Z
CAREENING	K ER IY N IH NG
CAREENS	K ER IY N Z
CAREER	K ER IH R
CAREERED	K AH R IH ER D
CAREERER	K AH R IH ER ER
CAREERERS	K AH R IH ER ER Z
CAREERING	K ER IH R IH NG
CAREERISM	K ER IY R IH Z AH M
CAREERISMS	K AH R IH ER IH Z AH M Z
CAREERIST	K ER IH R IH S T
CAREERISTS	K ER IH R IH S T S
CAREERS	K ER IH R Z
CAREFREE	K EH R F R IY
CAREFUL	K EH R F AH L
CAREFULLER	K EH R F AH L ER
CAREFULLEST	K EH R F AH L AH S T
CAREFULLY	K EH R F AH L IY
CAREFULNESS	K EH R F AH L N AH S
CAREFULNESSES	K EH R F AH L N AH S IH Z
CAREGIVER	K EH R G IH V ER
CAREGIVERS	K EH R G IH V ER Z
CAREGIVING	K EH R G IH V IH NG
CAREGIVINGS	K EH R G IH V IH NG Z
CARELESS	K EH R L EH S
CARELESSLY	K EH R L EH S L IY
CARELESSNESS	K EH R L EH S N AH S
CARELESSNESSES	K EH R L AH S N AH S IH Z
CARER	K EH R ER
CARERS	K EH R ER Z
CARES	K EH R Z
CARESS	K ER EH S
CARESSED	K ER EH S T
CARESSER	K AH R EH S ER
CARESSERS	K AH R EH S ER Z
CARESSES	K ER EH S IH Z
CARESSING	K ER EH S IH NG
CARESSINGLY	K AH R EH S IH NG L IY
CARESSIVE	K AH R EH S IH V
CARESSIVELY	K AH R EH S IH V L IY
CARET	K AE R AH T
CARETAKE	K EH R T EY K
CARETAKEN	K EH R T EY K AH N
CARETAKER	K EH R T EY K ER
CARETAKERS	K EH R T EY K ER Z
CARETAKES	K EH R T EY K S
CARETAKING	K EH R T EY K IH NG
CARETAKINGS	K EH R T EY K IH NG Z
CARETOOK	K EH R T UH K
CARETS	K AE R AH T S
CAREWORN	K EH R W OW R N
CAREX	K AE R AH K S
CARFARE	K AA R F EH R
CARFARES	K AA R F EH R Z
CARFUL	K AA R F AH L
CARFULS	K AA R F AH L Z
CARGO	K AA R G OW
CARGOES	K AA R G OW Z
CARGOS	K AA R G OW Z
CARHOP	K AA R HH AA P
CARHOPS	K AA R HH AA P S
CARIBE	K AA R IY B
CARIBES	K AH R AY B Z
CARIBOU	K EH R IH B UW
CARIBOUS	K AE R AH B AH S
CARICATURAL	K AE R IH K AH CH UH R AH L
CARICATURE	K EH R IH K AH CH ER
CARICATURED	K EH R IH K AH CH ER D
CARICATURES	K EH R IH K AH CH ER Z
CARICATURING	K AE R IH K AH CH UH R IH NG
CARICATURIST	K EH R AH K AH CH ER IH S T
CARICATURISTS	K AE R IH K AH CH UH R IH S T S
CARICES	K EH R IH K S IH Z
CARIED	K EH R IY D
CARIES	K EH R IY Z
CARILLON	K EH R AH L AA N
CARILLONNED	K AA R IH L AO N D
CARILLONNEUR	K AE R AH L AA N AH R
CARILLONNEURS	K AH R IH L AA N IY Y AH R Z
CARILLONNING	K AA R IH L AO N IH NG
CARILLONS	K AA R IH L AO N Z
CARINA	K AE R AH N AH
CARINAE	K AE R AH N IY
CARINAL	K AA R IH N AH L
CARINAS	K AE R AH N AH Z
CARINATE	K AA R IH N AH T
CARINATED	K AA R IH N EY T IH D
CARING	K EH R IH NG
CARIOCA	K EH R IY OW K AH
CARIOCAS	K AH R IY AH K AH Z
CARIOGENIC	K AH R IY AH JH AH N AH K
CARIOLE	K AE R IY OW L
CARIOLES	K AE R IY OW L Z
CARIOUS	K EH R IY AH S
CARITAS	K AE R AH T AH Z
CARITASES	K AE R AH T EY Z AH Z
CARJACKER	K AA R JH AE K ER
CARJACKERS	K AA R JH AE K ER Z
CARJACKING	K AA R JH AE K IH NG
CARJACKINGS	K AA R JH AE K IH NG Z
CARK	K AA R K
CARKED	K AA R K T
CARKING	K AA R K IH NG
CARKS	K AA R K S
CARL	K AA R L
CARLE	K AA R AH L
CARLES	K AA R L Z
CARLESS	K AA R L AH S
CARLIN	K AA R L IH N
CARLINE	K AA R L AY N
CARLINES	K AA R L AY N Z
CARLING	K AA R L IH NG
CARLINGS	K AA R L IH NG Z
CARLINS	K AA R L IH N Z
CARLISH	K AA R L IH SH
CARLOAD	K AA R L OW D
CARLOADS	K AA R L OW D Z
CARLS	K AA R L Z
CARMAGNOLE	K AA R M AH G N OW L
CARMAGNOLES	K AA R M AH G N OW L Z
CARMAKER	K AA R M EY K ER
CARMAKERS	K AA R M EY K ER Z
CARMAN	K AA R M AH N
CARMEN	K AA R M AH N
CARMINATIVE	K AA R M AH N AH T IH V
CARMINATIVES	K AA R M AH N AH T IH V Z
CARMINE	K AA R M AY N
CARMINES	K AA R M AH N Z
CARN	K AA R N
CARNAGE	K AA R N IH JH
CARNAGES	K AA R N IH JH IH Z
CARNAL	K AA R N AH L
CARNALITIES	K AA R N AE L AH T IY Z
CARNALITY	K AA R N AE L AH T IY
CARNALLITE	K AA R N AH L AY T
CARNALLITES	K AA R N AH L AY T S
CARNALLY	K AA R N AH L IY
CARNASSIAL	K AA R N AE S IY AH L
CARNASSIALS	K AA R N AE S IY AH L Z
CARNATION	K AA R N EY SH AH N
CARNATIONS	K AA R N EY SH AH N Z
CARNAUBA	K AA R N AO B AA
CARNAUBAS	K AA R N AH B AH Z
CARNELIAN	K AA R N IY L IY AH N
CARNELIANS	K AA R N IY L IY AH N Z
CARNET	K AA R N EH T
CARNETS	K AA R N EH T S
CARNEY	K AA R N IY
CARNEYS	K AA R N IY Z
CARNIE	K AA R N IY
CARNIES	K AA R N IY Z
CARNIFIED	K AA R N AH F AY D
CARNIFIES	K AA R N AH F AY Z
CARNIFY	K AA R N AH F AY
CARNIFYING	K AA R N AH F AY IH NG
CARNITINE	K AA R N AH T AY N
CARNITINES	K AA R N AH T AY N Z
CARNIVAL	K AA R N AH V AH L
CARNIVALS	K AA R N AH V AH L Z
CARNIVORA	K AA R N IH V AH R AH
CARNIVORE	K AA R N IH V AO R
CARNIVORES	K AA R N AH V AO R Z
CARNIVOROUS	K AA R N IH V ER AH S
CARNIVOROUSLY	K AA R N IH V ER AH S L IY
CARNIVOROUSNESS	K AA R N IH V ER AH S N AH S
CARNIVOROUSNESSES	K AA R N IH V ER AH S N AH S IH Z
CARNOTITE	K AA R N AH T AY T
CARNOTITES	K AA R N AH T AY T S
CARNS	K AA R N Z
CARNY	K AA R N IY
CAROACH	K AH R OW CH
CAROACHES	K AH R OW CH AH Z
CAROB	K EH R AH B
CAROBS	K AA R AH B Z
CAROCH	K AE R AH CH
CAROCHE	K ER OW CH
CAROCHES	K AE R AH CH AH Z
CAROL	K AE R AH L
CAROL(2)	K EH R AH L
CAROLED	K AE R AH L D
CAROLER	K AE R AH L ER
CAROLERS	K AE R AH L ER Z
CAROLI	K AE R AH L IY
CAROLING	K AE R AH L IH NG
CAROLLED	K AE R AH L D
CAROLLER	K AE R AH L ER
CAROLLERS	K AE R AH L ER Z
CAROLLING	K AE R AH L IH NG
CAROLS	K EH R AH L Z
CAROLUS	K EH R AH L AH S
CAROLUSES	K AE R AH L Y UW S IH Z
CAROM	K AE R AH M
CAROMED	K AH R OW M D
CAROMING	K AH R OW M AH NG
CAROMS	K AE R AH M Z
CAROTENE	K EH R AH T IY N
CAROTENES	K EH R AH T IY N Z
CAROTENOID	K AH R AA T AH N OY D
CAROTENOIDS	K AH R AA T AH N OY D Z
CAROTID	K ER AA T IH D
CAROTIDS	K AE R AH T AH D Z
CAROTIN	K AE R AH T AH N
CAROTINOID	K AH R AA T AH N OY D
CAROTINOIDS	K AH R AA T AH N OY D Z
CAROTINS	K AE R AH T AH N Z
CAROUSAL	K AH R AW Z AH L
CAROUSALS	K AH R AW Z AH L Z
CAROUSE	K ER AW Z
CAROUSED	K AH R AW Z D
CAROUSEL	K EH R AH S EH L
CAROUSELS	K AH R AW S AH L Z
CAROUSER	K AH R AW Z ER
CAROUSERS	K AH R AW Z ER Z
CAROUSES	K AH R AW Z IH Z
CAROUSING	K ER AW Z IH NG
CARP	K AA R P
CARPACCIO	K AA R P AE K S IY OW
CARPACCIOS	K AA R P AE K S IY AH Z
CARPAL	K AA R P AH L
CARPALE	K AA R P EY L
CARPALIA	K AA R P EY L Y AH
CARPALS	K AA R P AH L Z
CARPED	K AA R P T
CARPEL	K AA R P AH L
CARPELLARY	K AA R P AH L EH R IY
CARPELLATE	K AA R P AH L EY T
CARPELS	K AA R P AH L Z
CARPENTER	K AA R P AH N T ER
CARPENTERED	K AA R P AH N T ER D
CARPENTERING	K AA R P AH N T ER IH NG
CARPENTERS	K AA R P AH N T ER Z
CARPENTRIES	K AA R P AH N T R IY Z
CARPENTRY	K AA R P AH N T R IY
CARPER	K AA R P ER
CARPERS	K AA R P ER Z
CARPET	K AA R P AH T
CARPETBAG	K AA R P AH T B AE G
CARPETBAGGER	K AA R P AH T B AE G ER
CARPETBAGGERIES	K AA R P AH T B AE G AH R IY Z
CARPETBAGGERS	K AA R P AH T B AE G ER Z
CARPETBAGGERY	K AA R P AH T B AE G AH R IY
CARPETBAGGING	K AA R P AH T B AE G IH NG
CARPETBAGS	K AA R P AH T B AE G Z
CARPETED	K AA R P AH T IH D
CARPETING	K AA R P AH T IH NG
CARPETINGS	K AA R P AH T IH NG Z
CARPETS	K AA R P AH T S
CARPETWEED	K AA R P AH T W IY D
CARPETWEEDS	K AA R P AH T W IY D Z
CARPI	K AA R P IY
CARPING	K AA R P IH NG
CARPINGLY	K AA R P IH NG L IY
CARPINGS	K AA R P IH NG Z
CARPOGONIA	K AA R P AH G OW N Y AH
CARPOGONIAL	K AA R P AH G OW N IY AH L
CARPOGONIUM	K AA R P AH G OW N IY AH M
CARPOOL	K AA R P UW L
CARPOOLED	K AA R P UW L D
CARPOOLER	K AA R P UW L ER
CARPOOLERS	K AA R P UW L ER Z
CARPOOLING	K AA R P UW L IH NG
CARPOOLS	K AA R P UW L Z
CARPOPHORE	K AA R P AH F AH R
CARPOPHORES	K AA R P AH F AH R Z
CARPORT	K AA R P AO R T
CARPORTS	K AA R P AO R T S
CARPOSPORE	K AA R P AA S P OW R
CARPOSPORES	K AA R P AA S P OW R Z
CARPS	K AA R P S
CARPUS	K AA R P AH S
CARR	K AA R
CARRACK	K AA R AE K
CARRACKS	K AA R AE K S
CARRAGEEN	K AA R IH JH AH N
CARRAGEENAN	K AE R AH JH IY N AH N
CARRAGEENANS	K AE R AH JH IY N AH N Z
CARRAGEENIN	K AA R IH JH AH N IH N
CARRAGEENINS	K AA R IH JH AH N IH N Z
CARRAGEENS	K AA R IH JH AH N Z
CARRAGHEEN	K AE R AE IY AH N
CARRAGHEENS	K AE R AH IY N Z
CARREFOUR	K AA R IY F OW R
CARREFOURS	K AA R IY F OW R Z
CARREL	K AE R EH L
CARRELL	K AA R EY L
CARRELLS	K AE R AH L Z
CARRELS	K AE R AH L Z
CARRIAGE	K AE R IH JH
CARRIAGE(2)	K EH R AH JH
CARRIAGES	K AE R IH JH IH Z
CARRIAGES(2)	K EH R AH JH AH Z
CARRIAGEWAY	K AE R IH JH W EY
CARRIAGEWAYS	K AE R IH JH W EY Z
CARRIED	K AE R IY D
CARRIED(2)	K EH R IY D
CARRIER	K AE R IY ER
CARRIER(2)	K EH R IY ER
CARRIERS	K AE R IY ER Z
CARRIERS(2)	K EH R IY ER Z
CARRIES	K AE R IY Z
CARRIES(2)	K EH R IY Z
CARRIOLE	K AE R IY OW L
CARRIOLES	K AE R IY OW L Z
CARRION	K EH R IY AH N
CARRIONS	K AA R IY AH N Z
CARRITCH	K AE R AH CH
CARRITCHES	K AE R AH CH AH Z
CARROCH	K AE R AH CH
CARROCHES	K AE R AH CH AH Z
CARROM	K AE R AH M
CARROMED	K AE R OW M D
CARROMING	K AE R OW M AH NG
CARROMS	K AE R AH M Z
CARRONADE	K AE R AH N EY D
CARRONADES	K AE R AH N EY D Z
CARROT	K AE R AH T
CARROT(2)	K EH R AH T
CARROTIER	K AE R AH T IY ER
CARROTIEST	K AE R AH T IY AH S T
CARROTIN	K AE R AH T IH N
CARROTINS	K AE R AH T IH N Z
CARROTS	K AE R AH T S
CARROTS(2)	K EH R AH T S
CARROTTOP	K AE R AH T AA P
CARROTTOPPED	K AE R AH T AA P T
CARROTTOPS	K AE R AH T AA P S
CARROTY	K AE R AH T IY
CARROUSEL	K EH R AH S EH L
CARROUSELS	K AE R AW S AH L Z
CARRS	K AE R Z
CARRY	K AE R IY
CARRY(2)	K EH R IY
CARRYALL	K AE R IY AO L
CARRYALLS	K AE R IY AO L Z
CARRYBACK	K AE R IY B AE K
CARRYBACKS	K AE R IY B AE K S
CARRYFORWARD	K EH R IY F AO R W ER D
CARRYFORWARDS	K EH R IY F AO R W ER D Z
CARRYING	K AE R IY IH NG
CARRYING(2)	K EH R IY IH NG
CARRYON	K AE R IY AO N
CARRYONS	K AE R IY AO N Z
CARRYOUT	K AE R IY AW T
CARRYOUTS	K AE R IY AW T S
CARRYOVER	K EH R Y OW V ER
CARRYOVERS	K AE R IY OW V ER Z
CARS	K AA R Z
CARS(2)	K AA Z
CARSE	K AA R S
CARSES	K AA R Z IH Z
CARSICK	K AA R S IH K
CARSICKNESS	K AA R S IH K N AH S
CARSICKNESSES	K AA R S IH K N AH S IH Z
CART	K AA R T
CARTABLE	K AA R T AH B AH L
CARTAGE	K AA R T IH JH
CARTAGES	K AA R T IH JH IH Z
CARTE	K AA R T
CARTED	K AA R T IH D
CARTEL	K AA R T EH L
CARTELISE	K AA R T AH L AY Z
CARTELISED	K AA R T EH L IY Z D
CARTELISES	K AA R T EH L IY Z IH Z
CARTELISING	K AA R T EH L IY Z IH NG
CARTELIZATION	K AA R T EH L AH Z EY SH AH N
CARTELIZATIONS	K AA R T EH L AH Z EY SH AH N Z
CARTELIZE	K AA R T EH L AY Z
CARTELIZED	K AA R T EH L AY Z D
CARTELIZES	K AA R T EH L AY Z IH Z
CARTELIZING	K AA R T EH L AY Z IH NG
CARTELS	K AA R T EH L Z
CARTER	K AA R T ER
CARTERS	K AA R T ER Z
CARTES	K AA R T S
CARTILAGE	K AA R T AH L AH JH
CARTILAGE(2)	K AA R T AH L IH JH
CARTILAGES	K AA R T AH L IH JH IH Z
CARTILAGINOUS	K AA R T IH L AH JH IH N AH S
CARTING	K AA R T IH NG
CARTLOAD	K AA R T L OW D
CARTLOADS	K AA R T L OW D Z
CARTOGRAPHER	K AA R T AA G R AH F AH R
CARTOGRAPHERS	K AA R T AA G R AH F AH R Z
CARTOGRAPHIC	K AA R T AA G R AH F AH K
CARTOGRAPHICAL	K AA R T AA G R AH F IH S AH L
CARTOGRAPHICALLY	K AA R T AA G R AE F AH K AE L IY
CARTOGRAPHIES	K AA R T AA G R AH F AY Z
CARTOGRAPHY	K AA R T AA G R AH F IY
CARTON	K AA R T AH N
CARTONED	K AA R T AH N D
CARTONING	K AA R T AH N IH NG
CARTONS	K AA R T AH N Z
CARTOON	K AA R T UW N
CARTOONED	K AA R T UW N D
CARTOONING	K AA R T UW N IH NG
CARTOONINGS	K AA R T UW N IH NG Z
CARTOONISH	K AA R T UW N IH SH
CARTOONISHLY	K AA R T UW N IH SH L IY
CARTOONIST	K AA R T UW N AH S T
CARTOONISTS	K AA R T UW N IH S T S
CARTOONLIKE	K AA R T UW N L AY K
CARTOONS	K AA R T UW N Z
CARTOONY	K AA R T UW N IY
CARTOP	K AA R T AA P
CARTOPPER	K AA R T AA P ER
CARTOPPERS	K AA R T AA P ER Z
CARTOUCH	K AA R T AH CH
CARTOUCHE	K AA R T AW CH
CARTOUCHES	K AA R T AH CH IH Z
CARTRIDGE	K AA R T R AH JH
CARTRIDGE(2)	K AA R T R IH JH
CARTRIDGES	K AA R T R AH JH AH Z
CARTS	K AA R T S
CARTULARIES	K AA R T Y UW L AH R AY Z
CARTULARY	K AA R T Y AH L EH R IY
CARTWHEEL	K AA R T W IY L
CARTWHEELED	K AA R T W IY L D
CARTWHEELER	K AA R T W IY L ER
CARTWHEELERS	K AA R T W IY L ER Z
CARTWHEELING	K AA R T W IY L IH NG
CARTWHEELS	K AA R T W IY L Z
CARUNCLE	K AA R AH NG K AH L
CARUNCLES	K AA R AH NG K AH L Z
CARVACROL	K AA R V AE K R AH L
CARVACROLS	K AA R V AE K R AH L Z
CARVE	K AA R V
CARVED	K AA R V D
CARVEL	K AA R V EH L
CARVELS	K AA R V AH L Z
CARVEN	K AA R V AH N
CARVER	K AA R V ER
CARVERS	K AA R V ER Z
CARVES	K AA R V Z
CARVING	K AA R V IH NG
CARVINGS	K AA R V IH NG Z
CARWASH	K AA R W AA SH
CARWASHES	K AA R W AA SH IH Z
CARYATIC	K EH R IY AH T IH K
CARYATID	K EH R IY AH T AH D
CARYATIDES	K AE R IY AE T AH D IY Z
CARYATIDS	K EH R IY AH T AH D Z
CARYOPSES	K AE R AY AA P S AH Z
CARYOPSIDES	K AE R AY AH P S AY D Z
CARYOPSIS	K AE R AY AA P S AH S
CARYOTIN	K AH R AY AH T AH N
CARYOTINS	K AH R AY AH T AH N Z
CASA	K AA S AH
CASABA	K AE S AH B AH
CASABAS	K AE S AH B AH Z
CASAS	K AA S AH Z
CASAVA	K AE S AH V AH
CASAVAS	K AE S AH V AH Z
CASBAH	K AE S B AH
CASBAHS	K AE Z AH Z
CASCABEL	K AE S AH B AH L
CASCABELS	K AE S AH B AH L Z
CASCABLE	K AE S AH B AH L
CASCABLES	K AE S AH B AH L Z
CASCADE	K AE S K EY D
CASCADED	K AE S K EY D IH D
CASCADES	K AE S K EY D Z
CASCADING	K AE S K EY D IH NG
CASCARA	K AE S AH R AH
CASCARAS	K AE S AH R AH Z
CASCARILLA	K AE S AH R IH L AH
CASCARILLAS	K AE S AH R IH L AH Z
CASE	K EY S
CASEASE	K EY S IY Z
CASEASES	K EY S IY Z AH Z
CASEATE	K EY S AH T
CASEATED	K EY S EY T IH D
CASEATES	K EY S AH T S
CASEATING	K EY S EY T IH NG
CASEATION	K EY S EY SH AH N
CASEATIONS	K EY S EY SH AH N Z
CASEBEARER	K EY S B AE ER ER
CASEBEARERS	K EY S B AE ER ER Z
CASEBOOK	K EY S B UH K
CASEBOOKS	K EY S B UH K S
CASED	K EY S T
CASEFIED	K AE S AH F AY D
CASEFIES	K AE S AH F AY Z
CASEFY	K AE S AH F IY
CASEFYING	K AH S EH F AY AH NG
CASEIC	K EY S IH K
CASEIN	K EY S IY N
CASEINATE	K EY S IY N AH T
CASEINATES	K EY S IY N AH T S
CASEINS	K EY S IY N Z
CASELOAD	K EY S L OW D
CASELOADS	K AE S AH L OW D Z
CASEMATE	K EY S M EY T
CASEMATES	K EY S M EY T S
CASEMENT	K EY S M AH N T
CASEMENTS	K EY S M AH N T S
CASEOSE	K EY S IY OW Z
CASEOSES	K EY S AA S IH Z
CASEOUS	K EY S AH S
CASERN	K AE S AH R N
CASERNE	K AE S AH R N
CASERNES	K AE S AH R N Z
CASERNS	K AE S AH R N Z
CASES	K EY S AH Z
CASES(2)	K EY S IH Z
CASETTE	K EY S EH T
CASETTES	K EY S EH T S
CASEWORK	K EY S W ER K
CASEWORKER	K EY S W ER K ER
CASEWORKERS	K EY S W ER K ER Z
CASEWORKS	K EY S W ER K S
CASEWORM	K EY S W ER M
CASEWORMS	K EY S W ER M Z
CASH	K AE SH
CASHABLE	K AE SH AH B AH L
CASHAW	K AE SH AH
CASHAWS	K AE SH AH Z
CASHBOOK	K AE SH B UH K
CASHBOOKS	K AE SH B UH K S
CASHBOX	K AE SH B AA K S
CASHBOXES	K AE SH B AA K S IH Z
CASHED	K AE SH T
CASHES	K AE SH IH Z
CASHEW	K AE SH UW
CASHEWS	K AE SH UW Z
CASHIER	K AE SH IH R
CASHIERED	K AE SH IH R D
CASHIERING	K AE SH IY ER IH NG
CASHIERS	K AE SH IH R Z
CASHING	K AE SH IH NG
CASHLESS	K AE SH L AH S
CASHMERE	K AE ZH M IH R
CASHMERES	K AE ZH M IH R Z
CASHOO	K AE SH UW
CASHOOS	K AH SH UW Z
CASIMERE	K AE S AH M AH R
CASIMERES	K AE S AH M IY R Z
CASIMIRE	K AE S AH M AY R
CASIMIRES	K AE S AH M AY R Z
CASING	K EY S IH NG
CASINGS	K EY S IH NG Z
CASINI	K AE S AH N IY
CASINO	K AH S IY N OW
CASINOS	K AH S IY N OW Z
CASITA	K AE S AH T AH
CASITAS	K AE S AH T AH Z
CASK	K AE S K
CASKED	K AE S K T
CASKET	K AE S K AH T
CASKETED	K AE S K AH T IH D
CASKETING	K AE S K AH T IH NG
CASKETS	K AE S K AH T S
CASKING	K AE S K IH NG
CASKS	K AE S K S
CASKY	K AE S K IY
CASQUE	K AE S
CASQUED	K AE S T
CASQUES	K AE S
CASSABA	K AE S AH B AH
CASSABAS	K AE S AH B AH Z
CASSATA	K AA S AA T AH
CASSATAS	K AE S AH T AH Z
CASSAVA	K AE S AH V AH
CASSAVAS	K AE S AH V AH Z
CASSEROLE	K AE S ER OW L
CASSEROLES	K AE S AH R OW L Z
CASSETTE	K AH S EH T
CASSETTES	K AH S EH T S
CASSIA	K AE SH IY AH
CASSIAS	K AE S IY AH Z
CASSIMERE	K AE S AH M AH R
CASSIMERES	K AE S AH M IY R Z
CASSINO	K AH S IY N OW
CASSINOS	K AE S AH N AH Z
CASSIS	K AE S IH S
CASSISES	K AE S AY Z AH Z
CASSITERITE	K AE S IH T AH R AY T
CASSITERITES	K AE S IH T AH R AY T S
CASSOCK	K AE S AH K
CASSOCKS	K AE S AH K S
CASSOULET	K AE S AW L AH T
CASSOULETS	K AE S AW L AH T S
CASSOWARIES	K AE S OW AH R AY Z
CASSOWARY	K AE S AH W EH R IY
CAST	K AE S T
CASTABILITIES	K AE S T AH B IH L AH T EH Z
CASTABILITY	K AE S T AH B IH L AH T EH
CASTABLE	K AE S T AH B AH L
CASTANET	K AE S T AH N EH T
CASTANETS	K AE S T AH N EH T S
CASTAWAY	K AE S T AH W EY
CASTAWAYS	K AE S T AH W EY Z
CASTE	K AE S T
CASTEISM	K AE S T IH Z AH M
CASTEISMS	K AE S T IH Z AH M Z
CASTELLAN	K AE S T EH L AH N
CASTELLANS	K AE S T EH L AH N Z
CASTELLATED	K AE S T AH L EY T AH D
CASTER	K AE S T ER
CASTERS	K AE S T ER Z
CASTES	K AE S T S
CASTIGATE	K AE S T AH G EY T
CASTIGATED	K AE S T AH G EY T IH D
CASTIGATES	K AE S T AH G EY T S
CASTIGATING	K AE S T AH G EY T IH NG
CASTIGATION	K AE S T AH G EY SH AH N
CASTIGATIONS	K AE S T AH G EY SH AH N Z
CASTIGATOR	K AE S T AH G EY T ER
CASTIGATORS	K AE S T AH G EY T ER Z
CASTING	K AE S T IH NG
CASTINGS	K AE S T IH NG Z
CASTLE	K AE S AH L
CASTLED	K AE S AH L D
CASTLES	K AE S AH L Z
CASTLING	K AE S T L IH NG
CASTOFF	K AE S T AO F
CASTOFFS	K AE S T AO F S
CASTOR	K AE S T ER
CASTOREUM	K AE S T AO R IY AH M
CASTOREUMS	K AE S T AO R IY AH M Z
CASTORS	K AE S T ER Z
CASTRATE	K AE S T R EY T
CASTRATED	K AE S T R EY T IH D
CASTRATES	K AE S T R EY T S
CASTRATI	K AE S T R AH T IY
CASTRATING	K AE S T R EY T IH NG
CASTRATION	K AE S T R EY SH AH N
CASTRATIONS	K AE S T R EY SH AH N Z
CASTRATO	K AE S T R AH T OW
CASTRATOR	K AE S T R AE T ER
CASTRATORS	K AE S T R AE T ER Z
CASTRATORY	K AE S T R AE T ER IY
CASTRATOS	K AE S T R AE T AA S
CASTS	K AE S T S
CASUAL	K AE ZH AH W AH L
CASUALLY	K AE ZH AH W AH L IY
CASUALNESS	K AE ZH AH W AH L N EH S
CASUALNESSES	K AE ZH AH W AH L N AH S IH Z
CASUALS	K AE ZH AH W AH L Z
CASUALTIES	K AE ZH AH W AH L T IY Z
CASUALTIES(2)	K AE ZH AH L T IY Z
CASUALTY	K AE ZH AH W AH L T IY
CASUALTY(2)	K AE ZH AH L T IY
CASUARINA	K AE S W EY R AH N AH
CASUARINAS	K AE S W EY R AH N AH Z
CASUIST	K AH ZH UW W AH S T
CASUISTIC	K AH S UW S T AH K
CASUISTICAL	K AH S UW S T IH S AH L
CASUISTRIES	K AH S UW S T R AY Z
CASUISTRY	K AH S UW S T R IY
CASUISTS	K AH S UW S T S
CASUS	K EY Z AH S
CAT	K AE T
CATABOLIC	K AE T AH B AH L AH K
CATABOLICALLY	K AE T AH B AA L AH K AE L IY
CATABOLISM	K AE T AH B AH L IH Z AH M
CATABOLISMS	K AH T AE B AH L AH Z AH M Z
CATABOLITE	K AH T AE B AH L AY T
CATABOLITES	K AH T AE B AH L AY T S
CATABOLIZE	K AH T AE B AH L AY Z
CATABOLIZED	K AH T AE B AH L AY Z D
CATABOLIZES	K AH T AE B AH L AY Z AH Z
CATABOLIZING	K AH T AE B AH L AY Z AH NG
CATACHRESES	K AE T AH K R IY Z AH Z
CATACHRESIS	K AH T AE K R AH S AH S
CATACHRESTIC	K AH T AE K R AH S T AH K
CATACHRESTICAL	K AH T AE K R EH S T IH S AH L
CATACHRESTICALLY	K AE T AH K R EH S T AH K AE L IY
CATACLYSM	K AE T AH K L IH S AH M
CATACLYSMAL	K AH T AE K L IH Z M AH L
CATACLYSMIC	K AE T AH K L IH Z M IH K
CATACLYSMICALLY	K AE T AH K L IH Z M IH K AH L IY
CATACLYSMS	K AH T AE K L AH Z AH M Z
CATACOMB	K AE T AH K OW M
CATACOMBS	K AE T AH K OW M Z
CATADIOPTRIC	K AH T EY D IY AH P T R AH K
CATADROMOUS	K AH T AE D R AH M AH S
CATAFALQUE	K AE T AH F AH L K
CATAFALQUES	K AE T AH F AH L K S
CATALASE	K AE T AH L EY Z
CATALASES	K AE T AH L EY Z AH Z
CATALATIC	K EY T AH L AH T IH K
CATALECTIC	K AE T AH L AH K T AH K
CATALECTICS	K AE T AH L EH K T AH S Z
CATALEPSIES	K AE T AH L EH P S AY Z
CATALEPSY	K AE T AH L EH P S IY
CATALEPTIC	K AE T AH L AH P T AH K
CATALEPTICALLY	K AE T AH L EH P T AH K AE L IY
CATALEPTICS	K AE T AH L EH P T AH S Z
CATALEXES	K AE T AH L AH K S
CATALEXIS	K AE T AH L EH K S AH S
CATALO	K AE T AH L OW
CATALOES	K AE T AE L OW Z
CATALOG	K AE T AH L AO G
CATALOGED	K AE T AH L AO G D
CATALOGER	K AE T AH L AO G ER
CATALOGERS	K AE T AH L AO G ER Z
CATALOGING	K AE T AH L AO G IH NG
CATALOGS	K AE T AH L AO G Z
CATALOGUE	K AE T AH L AO G
CATALOGUED	K AE T AH L AO G D
CATALOGUER	K AE T AH L AO G ER
CATALOGUERS	K AE T AH L AO G ER Z
CATALOGUES	K AE T AH L AO G Z
CATALOGUING	K AE T AH L AO G IH NG
CATALOS	K EY T AH L AA S
CATALPA	K AH T AE L P AH
CATALPAS	K AH T AE L P AH Z
CATALYSES	K EY T AH L IY Z IH Z
CATALYSIS	K EY T AH L IY Z IY Z
CATALYST	K AE T AH L IH S T
CATALYSTS	K AE T AH L IH S T S
CATALYTIC	K AE T AH L IH T IH K
CATALYTICALLY	K AE T AH L IH T IH K AH L IY
CATALYZE	K AE T AH L AY Z
CATALYZED	K AE T AH L AY Z D
CATALYZER	K AE T AH L AY Z AH R
CATALYZERS	K AH T AE L AH Z AH R Z
CATALYZES	K AE T AH L AY Z AH Z
CATALYZING	K EY T AH L IY Z IH NG
CATAMARAN	K AH T AE M ER AH N
CATAMARANS	K AH T AE M ER AH N Z
CATAMENIA	K AE T AH M IY N Y AH
CATAMENIAL	K AE T AH M EH N IY AH L
CATAMITE	K AE T AH M AY T
CATAMITES	K AE T AH M AY T S
CATAMOUNT	K AE T AH M AW N T
CATAMOUNTS	K AE T AH M AW N T S
CATAPHORA	K AH T AE F AH R AH
CATAPHORAS	K AH T AE F AH R AH Z
CATAPHORESES	K AH T AE F AH R IY Z AH Z
CATAPHORESIS	K AE T AH F AO R AH S AH S
CATAPHORETIC	K AH T AE F AH R AH T AH K
CATAPHORETICALLY	K AE T AH F AH R EH T AH K AE L IY
CATAPHORIC	K AE T AH F AH R AH K
CATAPLASM	K AE T AH P L AE Z AH M
CATAPLASMS	K AE T AH P L AE Z AH M Z
CATAPLEXIES	K AH T AE P L EH K S AY Z
CATAPLEXY	K AH T AE P L EH K S IY
CATAPULT	K AE T AH P AH L T
CATAPULTED	K AE T AH P AH L T IH D
CATAPULTING	K AE T AH P AH L T IH NG
CATAPULTS	K AE T AH P AH L T S
CATARACT	K AE T ER AE K T
CATARACTOUS	K EY T ER AE K T AH S
CATARACTS	K AE T ER AE K T S
CATARRH	K AE T AH R
CATARRHAL	K AH T AE R AH L
CATARRHALLY	K AH T AE R AE L IY
CATARRHINE	K EY T ER R AY N
CATARRHINES	K EY T ER R AY N Z
CATARRHS	K AE T AH R Z
CATASTROPHE	K AH T AE S T R AH F IY
CATASTROPHES	K AH T AE S T R AH F IY Z
CATASTROPHIC	K AE T AH S T R AA F IH K
CATASTROPHICALLY	K AE T AH S T R AA F IH K AH L IY
CATASTROPHISM	K AH T AE S T R AH F IY IH Z AH M
CATASTROPHISMS	K AH T AE S T R AH F IY IH Z AH M Z
CATASTROPHIST	K AH T AE S T R AH F IY IH S T
CATASTROPHISTS	K AH T AE S T R AH F IY IH S T S
CATATONIA	K AE T AH T OW N IY AH
CATATONIAS	K AE T AH T OW N IY AH Z
CATATONIC	K AE T AH T AA N IH K
CATATONICALLY	K AE T AH T OW N IH K AH L IY
CATATONICS	K AE T AH T OW N IH K S
CATAWBA	K AH T AO B AH
CATAWBAS	K AE T AH B AH Z
CATBIRD	K AE T B ER D
CATBIRDS	K AE T B ER D Z
CATBOAT	K AE T B OW T
CATBOATS	K AE T B OW T S
CATBRIER	K AE T B R AY AH R
CATBRIERS	K AE T B R IY R Z
CATCALL	K AE T K AO L
CATCALLED	K AE T K AO L D
CATCALLING	K AE T K AO L IH NG
CATCALLS	K AE T K AO L Z
CATCH	K AE CH
CATCHABLE	K AE CH AH B AH L
CATCHALL	K AE CH AO L
CATCHALLS	K AE CH AO L Z
CATCHER	K AE CH ER
CATCHERS	K AE CH ER Z
CATCHES	K AE CH IH Z
CATCHFLIES	K AE CH F L AY Z
CATCHFLY	K AE CH F L AY
CATCHIER	K AE CH IY ER
CATCHIEST	K AE CH IY AH S T
CATCHING	K AE CH IH NG
CATCHMENT	K AE CH M AH N T
CATCHMENTS	K AE CH M AH N T S
CATCHPENNY	K AE CH P EH N IY
CATCHPHRASE	K AE CH F R EY Z
CATCHPHRASES	K AE CH F R EY Z IH Z
CATCHPOLE	K AE CH P OW L
CATCHPOLES	K AE CH P OW L Z
CATCHPOLL	K AE CH P OW L
CATCHPOLLS	K AE CH P OW L Z
CATCHUP	K AE CH UH P
CATCHUPS	K AE CH AH P S
CATCHWORD	K AE CH W ER D
CATCHWORDS	K AE CH W ER D Z
CATCHY	K AE CH IY
CATCLAW	K AE T K L AO
CATCLAWS	K AE T K L AO Z
CATE	K EY T
CATECHESES	K AE T AH K IY Z AH Z
CATECHESIS	K AH T EH K AH S AH S
CATECHETICAL	K AH T EH K AH T IH S AH L
CATECHIN	K EY T CH IH N
CATECHINS	K EY T CH IH N Z
CATECHISM	K AE T AH K IH Z AH M
CATECHISMAL	K AE T AH K IH Z AH M AH L
CATECHISMS	K AE T AH K IH Z AH M Z
CATECHIST	K AE T AH K AH S T
CATECHISTIC	K AE T AH K AH S T AH K
CATECHISTS	K AE T AH K AH S T S
CATECHIZATION	K AE T AH K AY Z EY SH AH N
CATECHIZATIONS	K AE T AH K AY Z EY SH AH N Z
CATECHIZE	K AE T AH K AY Z
CATECHIZED	K AE T AH K AY Z D
CATECHIZER	K AE T AH K AY Z ER
CATECHIZERS	K AE T AH K AY Z ER Z
CATECHIZES	K AE T AH K AY Z IH Z
CATECHIZING	K AE T AH K AY Z IH NG
CATECHOL	K AE T AH K AH L
CATECHOLAMINE	K AH T AH K AA L AH M AY N
CATECHOLAMINERGIC	K AE T AH K AH L AE M AH N AH R JH AH K
CATECHOLAMINES	K AH T AH K AA L AH M AY N Z
CATECHOLS	K AE T AH K AH L Z
CATECHU	K AE T AH K UW
CATECHUMEN	K EY T CH AH M AH N
CATECHUMENS	K EY T CH AH M AH N Z
CATECHUS	K AE T AH K AH S
CATEGORIC	K EY T G OW R IH K
CATEGORICAL	K AE T AH G AA R IH K AH L
CATEGORICAL(2)	K AE T AH G AO R IH K AH L
CATEGORICALLY	K AE T AH G AA R IH K L IY
CATEGORICALLY(2)	K AE T AH G AO R IH K L IY
CATEGORIES	K AE T AH G AO R IY Z
CATEGORISE	K AE T IY G OW R AY Z
CATEGORISED	K AE T IH G AO R IY Z D
CATEGORISES	K AE T IH G AO R IY Z IH Z
CATEGORISING	K AE T IH G AO R IY Z IH NG
CATEGORIZATION	K AE T AH G ER IH Z EY SH AH N
CATEGORIZATIONS	K AE T IH G AH R AY Z EY SH AH N Z
CATEGORIZE	K AE T AH G ER AY Z
CATEGORIZED	K AE T AH G ER AY Z D
CATEGORIZES	K AE T AH G ER AY Z IH Z
CATEGORIZING	K AE T AH G ER AY Z IH NG
CATEGORY	K AE T AH G AO R IY
CATENA	K AH T IY N AH
CATENAE	K AE T AH N IY
CATENARIES	K EY T AH N EH R IY Z
CATENARY	K EY T AH N EH R IY
CATENAS	K AE T AH N AH Z
CATENATE	K EY T AH N AH T
CATENATED	K EY T AH N EY T IH D
CATENATES	K EY T AH N AH T S
CATENATING	K EY T AH N EY T IH NG
CATENATION	K EY T AH N EY SH AH N
CATENATIONS	K EY T AH N EY SH AH N Z
CATENOID	K AE T AH N OY D
CATENOIDS	K AE T AH N OY D Z
CATER	K EY T ER
CATERAN	K EY T R AE N
CATERANS	K EY T R AE N Z
CATERCORNER	K EY T ER K AO R N ER
CATERCORNERED	K EY T ER K AO R N ER D
CATERED	K EY T ER D
CATERER	K EY T ER ER
CATERERS	K EY T ER ER Z
CATERESS	K EY T ER AH S
CATERESSES	K EY T ER AH S IH Z
CATERING	K EY T ER IH NG
CATERPILLAR	K AE T AH P IH L ER
CATERPILLAR(2)	K AE T ER P IH L ER
CATERPILLARS	K AE T AH P IH L ER Z
CATERS	K EY T ER Z
CATERWAUL	K AE T ER W AA L
CATERWAULED	K AH T AH R W EY AH L D
CATERWAULING	K AH T AH R W EY AH L AH NG
CATERWAULS	K AH T AH R W EY AH L Z
CATES	K EY T S
CATFACE	K AE T F EY S
CATFACES	K AE T F EY S IH Z
CATFACING	K AE T F EY S IH NG
CATFACINGS	K AE T F EY S IH NG Z
CATFALL	K AE T F AO L
CATFALLS	K AE T F AO L Z
CATFIGHT	K AE T F AY T
CATFIGHTS	K AE T F AY T S
CATFISH	K AE T F IH SH
CATFISHES	K AE T F IH SH IH Z
CATGUT	K AE T G AH T
CATGUTS	K AE T G AH T S
CATHARSES	K AH TH AA R S AH Z
CATHARSIS	K AH TH AA R S AH S
CATHARTIC	K AH TH AA R T IH K
CATHARTICS	K AE T HH AA R T IH K S
CATHEAD	K AE T HH EH D
CATHEADS	K AE T HH EH D Z
CATHECT	K AE TH AH K T
CATHECTED	K AH TH EH K T AH D
CATHECTIC	K AE T HH EH K T IH K
CATHECTING	K AH TH EH K T AH NG
CATHECTS	K AE TH AH K T S
CATHEDRA	K AH TH EH D R AH
CATHEDRAE	K AH TH EH D R IY
CATHEDRAL	K AH TH IY D R AH L
CATHEDRALS	K AH TH IY D R AH L Z
CATHEDRAS	K AH TH EH D R AH Z
CATHEPSIN	K AH TH EH P S AH N
CATHEPSINS	K AH TH EH P S AH N Z
CATHETER	K AE TH AH T ER
CATHETERIZATION	K AE TH AH T ER AH Z EY SH AH N
CATHETERIZATIONS	K AE TH AH T ER AH Z EY SH AH N Z
CATHETERIZE	K AE TH AH T ER AY Z
CATHETERIZED	K AE TH AH T ER AY Z D
CATHETERIZES	K AE TH AH T ER AY Z IH Z
CATHETERIZING	K AE TH AH T ER AY Z IH NG
CATHETERS	K AE TH AH T ER Z
CATHEXES	K AE T HH EH K S IH Z
CATHEXIS	K AE T HH EH K S IY Z
CATHODAL	K AE TH OW D AH L
CATHODALLY	K AE TH OW D AH L IY
CATHODE	K AE TH OW D
CATHODES	K AE TH OW D Z
CATHODIC	K AE TH OW D IH K
CATHODICALLY	K AE TH OW D IH K AH L IY
CATHOLIC	K AE TH L IH K
CATHOLICALLY	K AE TH L IH K AH L IY
CATHOLICATE	K AE TH L IH K AH T
CATHOLICATES	K AE TH L IH K AH T S
CATHOLICITIES	K AE TH L IH K AH T IY Z
CATHOLICITY	K AE TH L IH K AH T IY
CATHOLICIZE	K AE TH L IH K AY Z
CATHOLICIZED	K AE TH L IH K AY Z D
CATHOLICIZES	K AE TH L IH K AY Z IH Z
CATHOLICIZING	K AE TH L IH K AY Z IH NG
CATHOLICOI	K AH TH AA L AH K OY
CATHOLICON	K AE TH L IH K AO N
CATHOLICONS	K AE TH L IH K AO N Z
CATHOLICOS	K AE TH L IH K AA S
CATHOLICOSES	K AE TH L IH K AA S IH Z
CATHOLICS	K AE TH L IH K S
CATHOUSE	K AE T HH AW S
CATHOUSES	K AE T HH AW S IH Z
CATION	K EY SH AH N
CATIONIC	K EY SH AH N IH K
CATIONICALLY	K EY SH AH N IH K AH L IY
CATIONS	K EY SH AH N Z
CATKIN	K AE T K AH N
CATKINS	K AE T K AH N Z
CATLIKE	K AE T L AY K
CATLIN	K AE T L IH N
CATLING	K AE T L IH NG
CATLINGS	K AE T L IH NG Z
CATLINS	K AE T L AH N Z
CATMINT	K AE T M IH N T
CATMINTS	K AE T M IH N T S
CATNAP	K AE T N AE P
CATNAPER	K AE T N AE P ER
CATNAPERS	K AE T N AE P ER Z
CATNAPPED	K AE T N AE P T
CATNAPPER	K AE T N AE P ER
CATNAPPERS	K AE T N AE P ER Z
CATNAPPING	K AE T N AE P IH NG
CATNAPS	K AE T N AE P S
CATNIP	K AE T N IH P
CATNIPS	K AE T N IH P S
CATOPTRIC	K AE T AH P T R AH K
CATS	K AE T S
CATSPAW	K AE T S P AO
CATSPAWS	K AE T S P AO Z
CATSUP	K EH CH AH P
CATSUPS	K AE CH AH P S
CATTAIL	K AE T EY L
CATTAILS	K AE T EY L Z
CATTALO	K AE T AH L OW
CATTALOES	K AE T AH L OW Z
CATTALOS	K AE T AH L AA S
CATTED	K AE T IH D
CATTERIES	K AE T AH R IY Z
CATTERY	K AE T AH R IY
CATTIE	K AE T IY
CATTIER	K AE T IY ER
CATTIES	K AE T IY Z
CATTIEST	K AE T IY AH S T
CATTILY	K AE T IY L IY
CATTINESS	K AE T IY N AH S
CATTINESSES	K AE T IY N AH S IH Z
CATTING	K AE T IH NG
CATTISH	K AE T IH SH
CATTLE	K AE T AH L
CATTLEMAN	K AE T AH L M AE N
CATTLEMEN	K AE T AH L M AH N
CATTLEMEN(2)	K AE T AH L M IH N
CATTLEYA	K AE T L EY AH
CATTLEYAS	K AE T L EY AH Z
CATTY	K AE T IY
CATWALK	K AE T W AA K
CATWALK(2)	K AE T W AO K
CATWALKS	K AE T W AO K S
CAUCUS	K AO K AH S
CAUCUS(2)	K AA K AH S
CAUCUSED	K AO K AH S T
CAUCUSES	K AO K AH S IH Z
CAUCUSING	K AO K AH S IH NG
CAUCUSSED	K AO K AH S T
CAUCUSSES	K AO K AH S IH Z
CAUCUSSING	K AO K AH S IH NG
CAUDAD	K AO D AH D
CAUDAL	K AA D AH L
CAUDAL(2)	K AO D AH L
CAUDALLY	K AH D AE L IY
CAUDATE	K AH D EY T
CAUDATED	K AH D EY T AH D
CAUDATES	K AH D EY T S
CAUDEX	K AO D AH K S
CAUDEXES	K AO D AH K S
CAUDICES	K AO D AH S
CAUDILLISMO	K AO D AH L IH Z M OW
CAUDILLISMOS	K AO D AH L IH Z M AH Z
CAUDILLO	K AO D IH L OW
CAUDILLOS	K AH D IH L AH Z
CAUDLE	K AO D AH L
CAUDLES	K AO D AH L Z
CAUGHT	K AA T
CAUGHT(2)	K AO T
CAUL	K AA L
CAUL(2)	K AO L
CAULD	K AO L D
CAULDRON	K AA L D R AH N
CAULDRON(2)	K AO L D R AH N
CAULDRONS	K AO L D R AH N Z
CAULDS	K AO L D Z
CAULES	K EY AH L Z
CAULICLE	K AO L AH K AH L
CAULICLES	K AO L AH K AH L Z
CAULIFLOWER	K AA L AH F L AW ER
CAULIFLOWERET	K AO L AH F L OW AH R AH T
CAULIFLOWERETS	K AO L AH F L OW AH R AH T S
CAULIFLOWERS	K AO L IH F L AW ER Z
CAULINE	K AH L AY N
CAULIS	K EY AH L AH S
CAULK	K AA K
CAULK(2)	K AO K
CAULKED	K AO K T
CAULKER	K AO K AH R
CAULKERS	K AO L K AH R Z
CAULKING	K AO K IH NG
CAULKINGS	K AO L K AH NG Z
CAULKS	K AO K S
CAULS	K EY AH L Z
CAUSABLE	K AO Z AH B AH L
CAUSAL	K AO Z AH L
CAUSALGIA	K AH S AE L JH IY AH
CAUSALGIAS	K AH S AE L JH IY AH Z
CAUSALGIC	K AO S AH L JH AH K
CAUSALITIES	K AO Z AE L IH T IY Z
CAUSALITY	K AO Z AA L IH T IY
CAUSALLY	K AO Z AH L IY
CAUSALS	K AO Z AH L Z
CAUSATION	K AO Z EY SH AH N
CAUSATIONS	K AO Z EY SH AH N Z
CAUSATIVE	K AA Z AH T IH V
CAUSATIVE(2)	K AO Z AH T IH V
CAUSATIVELY	K AO Z AH T IH V L IY
CAUSATIVES	K AO Z AH T IH V Z
CAUSE	K AA Z
CAUSE(2)	K AO Z
CAUSED	K AA Z D
CAUSED(2)	K AO Z D
CAUSELESS	K AO Z L AH S
CAUSER	K AO Z ER
CAUSERIE	K AO Z ER IY
CAUSERIES	K AO Z AH R IY Z
CAUSERS	K AO Z ER Z
CAUSES	K AA Z AH Z
CAUSES(2)	K AO Z IH Z
CAUSEWAY	K AA Z W EY
CAUSEWAY(2)	K AO Z W EY
CAUSEWAYED	K AO Z W EY D
CAUSEWAYING	K AO Z W EY IH NG
CAUSEWAYS	K AO Z W EY Z
CAUSEY	K AO Z IY
CAUSEYS	K AO Z IY Z
CAUSING	K AA Z IH NG
CAUSING(2)	K AO Z IH NG
CAUSTIC	K AA S T IH K
CAUSTIC(2)	K AO S T IH K
CAUSTICALLY	K AO S T AH K AE L IY
CAUSTICITIES	K AO S T IH S AH T AY Z
CAUSTICITY	K AO S T IH S AH T IY
CAUSTICS	K AO S T AH S Z
CAUTERIES	K AO T AH R AY Z
CAUTERIZATION	K AO T ER IH Z EY SH AH N
CAUTERIZATIONS	K AO T AH R AY Z EY SH AH N Z
CAUTERIZE	K AO T ER AY Z
CAUTERIZED	K AO T ER AY Z D
CAUTERIZES	K AO T ER AY Z IH Z
CAUTERIZING	K AO T ER AY Z IH NG
CAUTERY	K EY Y AH T EH R IY
CAUTION	K AA SH AH N
CAUTION(2)	K AO SH AH N
CAUTIONARY	K AO SH AH N EH R IY
CAUTIONED	K AA SH AH N D
CAUTIONED(2)	K AO SH AH N D
CAUTIONING	K AO SH AH N IH NG
CAUTIONS	K AO SH AH N Z
CAUTIOUS	K AO SH AH S
CAUTIOUSLY	K AO SH AH S L IY
CAUTIOUSNESS	K AO SH AH S N AH S
CAUTIOUSNESSES	K AO SH AH S N AH S IH Z
CAVALCADE	K AE V AH L K EY D
CAVALCADES	K AE V AH L K EY D Z
CAVALERO	K AH V AE L AH R OW
CAVALEROS	K EY V AH L ER AA S
CAVALETTI	K AE V AH L EH T IY
CAVALIER	K AE V AH L IH R
CAVALIER(2)	K AE V AH L IY R
CAVALIERED	K EY V AH L IY ER D
CAVALIERING	K EY V AH L IY ER IH NG
CAVALIERISM	K EY V AH L IY ER IH Z AH M
CAVALIERISMS	K EY V AH L IY ER IH Z AH M Z
CAVALIERLY	K AE V AH L IH R L IY
CAVALIERS	K AE V AH L IH R Z
CAVALLA	K AH V AE L AH
CAVALLAS	K AH V AE L AH Z
CAVALLETTI	K AE V AH L EH T IY
CAVALLIES	K EY V AH L IY Z
CAVALLY	K EY V AH L IY
CAVALRIES	K AE V AH L R IY Z
CAVALRY	K AE V AH L R IY
CAVALRYMAN	K AE V AH L R IY M AE N
CAVALRYMEN	K AE V AH L R IY M EH N
CAVATINA	K AH V AE T AH N AH
CAVATINAS	K AH V AE T AH N AH Z
CAVATINE	K AE V AH T AY N
CAVE	K EY V
CAVEAT	K EY V IY AE T
CAVEATED	K EY V IY AE T IH D
CAVEATING	K EY V IY AE T IH NG
CAVEATOR	K EY V IY AE T ER
CAVEATORS	K EY V IY AE T ER Z
CAVEATS	K EY V IY AE T S
CAVED	K EY V D
CAVEFISH	K EY V F IH SH
CAVEFISHES	K EY V F IH SH IH Z
CAVELIKE	K EY V L AY K
CAVEMAN	K EY V M AE N
CAVEMEN	K EY V M EH N
CAVER	K EY V ER
CAVERN	K AE V ER N
CAVERNED	K AE V ER N D
CAVERNICOLOUS	K AH V AH R N IH K AH L AH S
CAVERNING	K AE V ER N IH NG
CAVERNOUS	K AE V ER N AH S
CAVERNOUSLY	K AE V ER N AH S L IY
CAVERNS	K AE V ER N Z
CAVERS	K EY V ER Z
CAVES	K EY V Z
CAVETTI	K AH V EH T IY
CAVETTO	K AH V EH T OW
CAVETTOS	K AH V EH T AH Z
CAVIAR	K AE V IY AA R
CAVIARE	K EY V IY AH R
CAVIARES	K EY V IY AH R Z
CAVIARS	K AE V IY AA R Z
CAVICORN	K AE V AH K AH R N
CAVIE	K EY V IY
CAVIES	K EY V IY Z
CAVIL	K AE V AH L
CAVILED	K EY V AH L D
CAVILER	K EY V AH L AH R
CAVILERS	K AE V AH L AH R Z
CAVILING	K EY V IY L IH NG
CAVILLED	K AE V AH L D
CAVILLER	K AH V IH L AH R
CAVILLERS	K AH V IH L AH R Z
CAVILLING	K AH V IH L AH NG
CAVILS	K EY V AH L Z
CAVING	K EY V IH NG
CAVINGS	K EY V IH NG Z
CAVITARY	K AE V AH T EH R IY
CAVITATE	K AE V AH T EY T
CAVITATED	K AE V AH T EY T AH D
CAVITATES	K AE V AH T EY T S
CAVITATING	K AE V AH T EY T AH NG
CAVITATION	K AE V AH T EY SH AH N
CAVITATIONS	K AE V AH T EY T IY AH N Z
CAVITIED	K AE V AH T IY D
CAVITIES	K AE V IH T IY Z
CAVITY	K AE V AH T IY
CAVORT	K AH V AO R T
CAVORTED	K AH V AO R T IH D
CAVORTER	K AH V AO R T ER
CAVORTERS	K AH V AO R T ER Z
CAVORTING	K AH V AO R T IH NG
CAVORTS	K AH V AO R T S
CAVY	K EY V IY
CAW	K AO
CAWED	K AO D
CAWING	K AO IH NG
CAWS	K AO Z
CAY	K EY
CAYENNE	K AY EH N
CAYENNE(2)	K EY EH N
CAYENNED	K EY EH N D
CAYENNES	K EY EH N Z
CAYMAN	K EY M AH N
CAYMANS	K EY M AH N Z
CAYS	K EY Z
CAYUSE	K EY UW Z
CAYUSES	K AY UW S AH Z
CAZIQUE	K AE Z AH K
CAZIQUES	K AE Z AH K S
CECA	S EH K AH
CECAL	S IY K AH L
CECALLY	S AH K AE L IY
CENTRICALLY	S EH N T R IH K AH L IY
CEPHALICALLY	S AH F AE L AH K AE L IY
CERCARIA	S AH R K AE R IY AH
CERCARIAE	S AH R K AE R IY IY
CERCARIAL	S AH R K AE R IY AH L
CERCARIAS	S AH R K AE R IY AH Z
CERTIFICATE	S ER T IH F IH K AH T
CERTIFICATED	S ER T IH F IH K AH T IH D
CERTIFICATES	S ER T IH F IH K AH T S
CERTIFICATING	S ER T IH F IH K AH T IH NG
CERTIFICATION	S ER T AH F AH K EY SH AH N
CERTIFICATIONS	S ER T AH F AH K EY SH AH N Z
CERTIFICATORY	S ER T IH F IH K AH T ER IY
CERVICAL	S ER V AH K AH L
CERVICAL(2)	S ER V IH K AH L
CHAOTICALLY	K EY AA T IH K AH L IY
CHARACTERISTICALLY	K EH R IH K T ER IH S T IH K L IY
CHARACTEROLOGICAL	CH AH R AE K T AH R AA L AH JH IH S AH L
CHARACTEROLOGICALLY	CH AH R AE K T AH R AH L AA JH AH K AE L IY
CHAUVINISTICALLY	CH AO V AH N IH S T AH K AE L IY
CHEESECAKE	CH IY Z K EY K
CHEESECAKES	CH IY Z K EY K S
CHEMICAL	K EH M IH K AH L
CHEMICALLY	K EH M IH K L IY
CHEMICALS	K EH M IH K AH L Z
CHEMOSURGICAL	K EH M AH S AH R JH IH S AH L
CHEMOTACTICALLY	K EH M AH T AE K T AH K AE L IY
CHEMOTHERAPEUTICALLY	K AH M AA TH AH R EY P Y UW T AH K AE L IY
CHERUBICALLY	CH AH R UW B AH K AE L IY
CHICANE	CH AH K EY N
CHICANED	CH AH K EY N D
CHICANER	CH AH K EY N AH R
CHICANERIES	SH IH K EY N AH R IY Z
CHICANERS	CH IH K AH N AH R Z
CHICANERY	SH IH K EY N ER IY
CHICANES	CH AH K EY N Z
CHICANING	CH AH K EY N AH NG
CHICANO	CH IH K AA N OW
CHICANOS	CH IH K AA N OW Z
CHIMERICAL	K IH M EH R AH K AH L
CHIMERICALLY	CH AY M ER IH K AH L IY
CHIROGRAPHICAL	CH AH R AA G R AH F IH S AH L
CHLOROFLUOROCARBON	K L AO R OW F L AO R OW K AA R B AA N
CHLOROFLUOROCARBONS	K L AO R OW F L AO R OW K AA R B AA N Z
CHOLECALCIFEROL	CH AA L AH K AH L S IH F AH R AH L
CHOLECALCIFEROLS	CH AA L AH K AH L S IH F AH R AH L Z
CHOLERICALLY	CH AH L EH R AH K AE L IY
CHOLINERGICALLY	CH AA L AH N AH R JH AH K AE L IY
CHOREOGRAPHICALLY	K OW R IY AH G R AE F IH K AH L IY
CHORIOCARCINOMA	CH AH R IY AH K AH R S IH N AH M AH
CHORIOCARCINOMAS	CH AH R IY AH K AH R S IH N AH M AH Z
CHORIOCARCINOMATA	CH AH R IY AH K AA R S AH N AA M AH T AH
CHROMATICALLY	K R OW M AE T IH K AH L IY
CHROMATOGRAPHICALLY	K R OW M AE T AH G R AE F IH K AH L IY
CHRONICALLY	K R AA N IH K AH L IY
CHRONICALLY(2)	K R AA N IH K L IY
CHRONOBIOLOGICAL	K R AA N AH B IY AA L AH JH IH S AH L
CHRONOLOGICAL	K R AA N AH L AA JH IH K AH L
CHRONOLOGICALLY	K R AA N AH L AA JH IH K L IY
CHRONOMETRICAL	K R AA N AH M EH T R IH S AH L
CHRONOMETRICALLY	K R AA N AH M EH T R AH K AE L IY
CICADA	S AH K EY D AH
CICADAE	S IH K AH D IY
CICADAS	S IH K EY D AH Z
CICALA	S IH K AA L AH
CICALAS	S IH K AH L AH Z
CICALE	S AH K EY L
CICATRICES	S AH K AE T R AH S
CICATRICIAL	S AH K AE T R IH S IY AH L
CICATRIX	S AH K AE T R AH K S
CICATRIXES	S AH K AE T R AH K S
CICATRIZATION	S AH K AE T R AH Z EY SH AH N
CICATRIZATIONS	S AH K AE T R AH Z EY T IY AH N Z
CICATRIZE	S IH K AH T R AY Z
CICATRIZED	S IH K AH T R AY Z D
CICATRIZES	S IH K AH T R AY Z AH Z
CICATRIZING	S IH K AH T R AY Z AH NG
CINEMATICALLY	S IH N AH M AE T IH K AH L IY
CINEMATOGRAPHICALLY	S AH N EH M AH T AA G R AE F AH K AE L IY
CIRCA	S ER K AH
CIRCADIAN	S ER K EY D IY AH N
CITIFICATION	S AY T AH F AH K EY SH AH N
CITIFICATIONS	S AY T AH F AH K EY SH AH N Z
CITYSCAPE	S IH T IY S K EY P
CITYSCAPES	S IH T IY S K EY P S
CIVICALLY	S IH V IH K AH L IY
CLADISTICALLY	K L AE D IH S T IH K AH L IY
CLADOGENETICALLY	K L AE D AH JH AH N EH T AH K AE L IY
CLARIFICATION	K L EH R AH F AH K EY SH AH N
CLARIFICATIONS	K L EH R IH F IH K EY SH AH N Z
CLASSICAL	K L AE S IH K AH L
CLASSICALITIES	K L AE S IH K AH L AH T IY Z
CLASSICALITY	K L AE S IH K AH L AH T IY
CLASSICALLY	K L AE S IH K L IY
CLASSIFICATION	K L AE S AH F AH K EY SH AH N
CLASSIFICATIONS	K L AE S AH F AH K EY SH AH N Z
CLASSIFICATORY	K L AE S IH F AH K AH T AO R IY
CLAUDICATION	K L AO D AH S EY SH AH N
CLAUDICATIONS	K L AO D AH K EY T IY AH N Z
CLAUSTROPHOBICALLY	K L AO S T R AH F AA B AH K AE L IY
CLERICAL	K L EH R AH K AH L
CLERICAL(2)	K L EH R IH K AH L
CLERICALISM	K L EH R IH K AH L IH Z AH M
CLERICALISMS	K L EH R IH K AH L IH Z AH M Z
CLERICALIST	K L EH R IH K AH L IH S T
CLERICALISTS	K L EH R IH K AH L IH S T S
CLERICALLY	K L EH R IH K AH L IY
CLERICALS	K L EH R IH K AH L Z
CLIMACTICALLY	K L AY M AE K T IH K AH L IY
CLIMATICALLY	K L AY M AH T IH K AH L IY
CLIMATOLOGICAL	K L IH M AH T AA L AH JH IH S AH L
CLIMATOLOGICALLY	K L IH M AH T AH L AA JH AH K AE L IY
CLINICAL	K L IH N AH K AH L
CLINICAL(2)	K L IH N IH K AH L
CLINICALLY	K L IH N IH K AH L IY
CLINICALLY(2)	K L IH N IH K L IY
CLINICOPATHOLOGICAL	K L AH N IH K AH P AH TH AA L AH JH IH S AH L
CLINICOPATHOLOGICALLY	K L AH N AH K AA P AH TH AH L AA JH AH K AE L IY
CLOACA	K L OW K AH
CLOACAE	K L OW K IY
CLOACAL	K L OW AH S AH L
CLOACAS	K L OW K AH Z
CLOUDSCAPE	K L AW D S K EY P
CLOUDSCAPES	K L AW D S K EY P S
COALIFICATION	K OW L AH F AH K EY SH AH N
COALIFICATIONS	K OW L AH F AH K EY SH AH N Z
COCA	K OW K AH
COCAIN	K OW K EY N
COCAINE	K OW K EY N
COCAINES	K OW K EY N Z
COCAINIZATION	K OW K EY N AH Z EY SH AH N
COCAINIZATIONS	K OW K EY N AH Z EY SH AH N Z
COCAINIZE	K OW K EY N AY Z
COCAINIZED	K OW K EY N AY Z D
COCAINIZES	K OW K EY N AY Z IH Z
COCAINIZING	K OW K EY N AY Z IH NG
COCAINS	K OW K EY N Z
COCAPTAIN	K OW K AE P T AH N
COCAPTAINED	K OW K AE P T AH N D
COCAPTAINING	K OW K AE P T AH N IH NG
COCAPTAINS	K OW K AE P T AH N Z
COCARBOXYLASE	K OW K AH R B AA K S AH L EY Z
COCARBOXYLASES	K OW K AH R B AA K S AH L EY Z AH Z
COCARCINOGEN	K OW K AA R S IH N AH JH AH N
COCARCINOGENIC	K OW K AA R S IH N AH JH AH N AH K
COCARCINOGENS	K OW K AA R S IH N AH JH AH N Z
COCAS	K OW K AE Z
COCATALYST	K OW K AE T AH L AH S T
COCATALYSTS	K OW K AE T AH L AH S T S
COCCAL	K AA K AH L
CODICOLOGICAL	K OW D AH K AA L AH JH IH S AH L
CODIFICATION	K AA D AH F AH K EY SH AH N
CODIFICATIONS	K OW D AH F AH K EY SH AH N Z
COEDUCATION	K OW EH JH AH K EY SH AH N
COEDUCATIONAL	K OW EH JH AH K EY SH AH N AH L
COEDUCATIONALLY	K OW EH JH AH K EY SH AH N AH L IY
COEDUCATIONS	K OW EH JH AH K EY SH AH N Z
COELACANTH	S IY L AH K AE N TH
COELACANTHS	K OW EH L AH K AH N TH S
COENZYMATICALLY	K OW EH N Z AH M AE T IH K AH L IY
COFFEECAKE	K AO F IY K EY K
COFFEECAKES	K AO F IY K EY K S
COHOMOLOGICAL	K OW HH OW M OW L AA JH IH K AH L
COLCANNON	K AA L K AE N AH N
COLCANNONS	K AA L K AE N AH N Z
COLLECTIVISTICALLY	K AA L IH K T IH V IH S T IH K AH L IY
COLLOCATE	K AA L AH K EY T
COLLOCATED	K AA L AH K EY T AH D
COLLOCATES	K AA L AH K EY T S
COLLOCATING	K AA L AH K EY T AH NG
COLLOCATION	K AA L AH K EY SH AH N
COLLOCATIONAL	K AA L AH K AH T IY AH N AH L
COLLOCATIONS	K AA L AH K EY T IY AH N Z
COLOCATE	K OW L OW K AH T
COLOCATED	K OW L OW K EY T IH D
COLOCATES	K OW L OW K AH T S
COLOCATING	K OW L OW K EY T IH NG
COLORIMETRICALLY	K OW L AO R AH M EH T R AH K AE L IY
COLORISTICALLY	K AH L ER IH S T IH K AH L IY
COMEDICALLY	K OW M EH D IH K AH L IY
COMICAL	K AA M IH K AH L
COMICALITIES	K AA M IH K AH L AH T IY Z
COMICALITY	K AA M IH K AH L AH T IY
COMICALLY	K AA M IH K AH L IY
COMICALLY(2)	K AA M IH K L IY
COMMODIFICATION	K AH M AA D AH F AH K EY SH AH N
COMMODIFICATIONS	K AH M AA D AH F AH K EY SH AH N Z
COMMONSENSICAL	K AA M AH N S EH N S IH K AH L
COMMONSENSICALLY	K AA M AH N S EH N S IH K AH L IY
COMMUNICABILITIES	K AH M Y UW N AH K AH B IH L AH T EH Z
COMMUNICABILITY	K AH M Y UW N AH K AH B IH L AH T EH
COMMUNICABLE	K AH M Y UW N AH K AH B AH L
COMMUNICABLENESS	K AH M Y UW N AH K AH B AH L N AH S
COMMUNICABLENESSES	K AH M Y UW N AH K AH B AH L N AH S IH Z
COMMUNICABLY	K AH M Y UW N AH K AH B L IY
COMMUNICANT	K AH M Y UW N AH K AH N T
COMMUNICANTS	K AH M Y UW N AH K AH N T S
COMMUNICATE	K AH M Y UW N AH K EY T
COMMUNICATED	K AH M Y UW N AH K EY T IH D
COMMUNICATEE	K AH M Y UW N AH K AH T IY
COMMUNICATEES	K AH M Y UW N AH K AH T IY Z
COMMUNICATES	K AH M Y UW N IH K EY T S
COMMUNICATING	K AH M Y UW N AH K EY T IH NG
COMMUNICATION	K AH M Y UW N AH K EY SH AH N
COMMUNICATIONAL	K AH M Y UW N AH K EY SH AH N AH L
COMMUNICATIONS	K AH M Y UW N AH K EY SH AH N Z
COMMUNICATIVE	K AH M Y UW N AH K AH T IH V
COMMUNICATIVELY	K AH M Y UW N AH K AH T IH V L IY
COMMUNICATIVENESS	K AH M Y UW N AH K AH T IH V N AH S
COMMUNICATIVENESSES	K AH M Y UW N AH K AH T IH V N AH S IH Z
COMMUNICATOR	K AH M Y UW N AH K EY T ER
COMMUNICATORS	K AH M Y UW N AH K EY T ER Z
COMMUNICATORY	K AH M Y UW N AH K AH T OW R IY
COMMUNISTICALLY	K AA M Y AH N IH S T IH K AH L IY
COMPLICACIES	K AA M P L AH K AH S IY Z
COMPLICACY	K AA M P L AH K AH S IY
COMPLICATE	K AA M P L AH K EY T
COMPLICATED	K AA M P L AH K EY T AH D
COMPLICATEDLY	K AA M P L AH K AH T AH D L IY
COMPLICATEDNESS	K AA M P L AH K AH T AH D N AH S
COMPLICATEDNESSES	K AA M P L AH K AH T AH D N AH S IH Z
COMPLICATES	K AA M P L IH K EY T S
COMPLICATING	K AA M P L AH K EY T IH NG
COMPLICATION	K AA M P L AH K EY SH AH N
COMPLICATIONS	K AA M P L AH K EY SH AH N Z
CONCANAVALIN	K AA N K AH N AE V AH L AH N
CONCANAVALINS	K AA N K AH N AE V AH L AH N Z
CONCATENATE	K AH N K AE T AH N EY T
CONCATENATED	K AH N K AE T AH N EY T AH D
CONCATENATES	K AH N K AE T AH N EY T S
CONCATENATING	K AH N K AE T AH N EY T IH NG
CONCATENATION	K AH N K AE T AH N EY SH AH N
CONCATENATIONS	K AH N K EY T AH N EY SH AH N Z
CONCAVE	K AA N K EY V
CONCAVED	K AA N K EY V D
CONCAVES	K AA N K EY V Z
CONCAVING	K AA N K EY V IH NG
CONCAVITIES	K AH N K AE V AH T IY Z
CONCAVITY	K AH N K AE V AH T IY
CONCENTRICALLY	K AH N S EH N T R IH K AH L IY
CONCEPTUALISTICALLY	K AH N S EH P CH AH W AH L IH S T IH K AH L IY
CONDUPLICATE	K AH N D UW P L IH K AH T
CONFISCABLE	K AH N F IH S K AH B AH L
CONFISCATABLE	K AA N F AH S K EY T AH B AH L
CONFISCATE	K AA N F AH S K EY T
CONFISCATED	K AA N F AH S K EY T AH D
CONFISCATES	K AA N F AH S K EY T S
CONFISCATING	K AA N F AH S K EY T IH NG
CONFISCATION	K AA N F AH S K EY SH AH N
CONFISCATIONS	K AA N F AH S K EY SH AH N Z
CONFISCATOR	K AA N F AH S K EY T ER
CONFISCATORS	K AA N F AH S K EY T ER Z
CONFISCATORY	K AH N F IH S K AH T AO R IY
CONFOCAL	K AH N F OW K AH L
CONFOCALLY	K AH N F OW K AH L IY
CONICAL	K AA N IH K AH L
CONICAL(2)	K OW N IH K AH L
CONICALLY	K AA N IH K AH L IY
CONTRAINDICATE	K AA N T R AH IH N D AH K AH T
CONTRAINDICATED	K AA N T R AH IH N D AH K EY T IH D
CONTRAINDICATES	K AA N T R AH IH N D AH K AH T S
CONTRAINDICATING	K AA N T R AH IH N D AH K EY T IH NG
CONTRAINDICATION	K AA N T R AH IH N D AH K EY SH AH N
CONTRAINDICATIONS	K AA N T R AH IH N D AH K EY SH AH N Z
CONVOCATION	K AA N V AH K EY SH AH N
CONVOCATIONAL	K AA N V AH K EY SH AH N AH L
CONVOCATIONS	K AA N V AH K EY SH AH N Z
COONCAN	K UW N K AE N
COONCANS	K UW N K AE N Z
COPYCAT	K AA P IY K AE T
COPYCATS	K AA P IY K AE T S
COPYCATTED	K AA P IY K AE T IH D
COPYCATTING	K AA P IY K AE T IH NG
CORNCAKE	K AO R N K EY K
CORNCAKES	K AO R N K EY K S
CORNIFICATION	K AO R N AH F AH K EY SH AH N
CORNIFICATIONS	K AO R N AH F AH K EY SH AH N Z
CORTICAL	K AO R T AH K AH L
CORTICALLY	K AO R T IH K AH L IY
CORUSCANT	K OW R AH S AH N T
CORUSCATE	K OW R AH S EY T
CORUSCATED	K OW R AH S EY T AH D
CORUSCATES	K OW R AH S EY T S
CORUSCATING	K OW R AH S EY T AH NG
CORUSCATION	K OW R AH S EY SH AH N
CORUSCATIONS	K OW R AH S EY T IY AH N Z
COSECANT	K OW S IY K AE N T
COSECANTS	K OW S IY K AE N T S
COSMETICALLY	K AO Z M EH T IH K L IY
COSMICAL	K AA Z M IH K AH L
COSMICALLY	K AA Z M IH K AH L IY
COSMOCHEMICAL	K AA S M AA K AH M IH S AH L
COSMOGONICAL	K OW S M AA G AO N IH K AH L
FLAB	F L AE B
BUB	B AH B
EPACT	EH P AH K T
GO	G OW
GUV	G AH V
PE	P IY
SOOCHONG	S UW CH AH NG
