CE	S IY
ABDUCE	AE B D Y UW S
ABDUCED	AE B D Y UW S T
ABDUCENS	AE B D Y UW S AH N Z
ABDUCENT	AE B D Y UW S AH N T
ABDUCENTES	AE B D Y UW S AH N T S
ABDUCES	AE B D Y UW S AH Z
ABECEDARIAN	AE B AH S AH D EH R IY AH N
ABECEDARIANS	AE B AH S AH D AE R IY AH N Z
ABERRANCE	AE B EH R AH N S
ABERRANCES	AE B EH R AH N S IH Z
ABEYANCE	AH B EY AH N S
ABEYANCES	AH B EY AH N S IH Z
ABHORRENCE	AH B HH AO R AH N S
ABHORRENCES	AH B HH AO R AH N S IH Z
ABIDANCE	AH B AY D AH N S
ABIDANCES	AH B AY D AH N S IH Z
ABSCESS	AE B S EH S
ABSCESSED	AE B S EH S T
ABSCESSES	AE B S EH S IH Z
ABSCESSING	AE B S EH S IH NG
ABSENCE	AE B S AH N S
ABSENCES	AE B S AH N S IH Z
ABSORBANCE	AH B Z AO R B AH N S
ABSORBANCES	AH B Z AO R B AH N S IH Z
ABSORPTANCE	AH B Z AO R P T AH N S
ABSORPTANCES	AH B Z AO R P T AH N S IH Z
ABSTINENCE	AE B S T AH N AH N S
ABSTINENCES	AE B S T AH N AH N S IH Z
ABUNDANCE	AH B AH N D AH N S
ABUNDANCES	AH B AH N D AH N S IH Z
ACANTHOCEPHALAN	AH K AE N TH AH S EH F AH L AH N
ACANTHOCEPHALANS	AH K AE N TH AH S EH F AH L AH N Z
ACAULESCENT	AE K EY AH L EH S AH N T
ACCEDE	AE K S IY D
ACCEDED	AE K S IY D IH D
ACCEDER	AE K S IY D ER
ACCEDERS	AE K S IY D ER Z
ACCEDES	AE K S IY D Z
ACCEDING	AE K S IY D IH NG
ACCELERANDO	AE K S AH L AH R AE N D OW
ACCELERANDOS	AE K S AH L AH R AE N D AH Z
ACCELERANT	AE K S EH L ER AH N T
ACCELERANTS	AE K S EH L ER AH N T S
ACCELERATE	AE K S EH L ER EY T
ACCELERATED	AE K S EH L ER EY T IH D
ACCELERATES	AE K S EH L ER EY T S
ACCELERATING	AE K S EH L ER EY T IH NG
ACCELERATINGLY	IH K S EH L AH R EY T IH NG L IY
ACCELERATION	AE K S EH L ER EY SH AH N
ACCELERATIONS	IH K S EH L AH R EY SH AH N Z
ACCELERATIVE	IH K S EH L AH R EY T IH V
ACCELERATOR	AE K S EH L ER EY T ER
ACCELERATORS	AE K S EH L ER EY T ER Z
ACCELEROMETER	AE K S EH L ER AA M AH T ER
ACCELEROMETERS	AE K S EH L ER AA M AH T ER Z
ACCENT	AH K S EH N T
ACCENT(2)	AE K S EH N T
ACCENTED	AE K S EH N T IH D
ACCENTING	AE K S EH N T IH NG
ACCENTLESS	AE K S EH N T L AH S
ACCENTOR	AE K S EH N T ER
ACCENTORS	AE K S EH N T ER Z
ACCENTS	AE K S EH N T S
ACCENTUAL	AE K S EH N CH AH W AH L
ACCENTUALLY	AE K S EH N CH AH W AH L IY
ACCENTUATE	AE K S EH N CH UW EY T
ACCENTUATED	AE K S EH N CH UW EY T IH D
ACCENTUATES	AE K S EH N CH UW EY T S
ACCENTUATING	AE K S EH N CH UW EY T IH NG
ACCENTUATION	AE K S EH N CH AH W EY SH AH N
ACCENTUATIONS	AE K S EH N CH AH W EY SH AH N Z
ACCEPT	AE K S EH P T
ACCEPT(2)	AH K S EH P T
ACCEPTABILITIES	AE K S EH P T AH B IH L AH T EH Z
ACCEPTABILITY	AH K S EH P T AH B IH L AH T IY
ACCEPTABLE	AE K S EH P T AH B AH L
ACCEPTABLE(2)	AH K S EH P T AH B AH L
ACCEPTABLENESS	AE K S EH P T AH B AH L N AH S
ACCEPTABLENESSES	AE K S EH P T AH B AH L N AH S IH Z
ACCEPTABLY	AE K S EH P T AH B L IY
ACCEPTABLY(2)	AH K S EH P T AH B L IY
ACCEPTANCE	AE K S EH P T AH N S
ACCEPTANCE(2)	AH K S EH P T AH N S
ACCEPTANCES	AE K S EH P T AH N S IH Z
ACCEPTANT	AE K S EH P T AH N T
ACCEPTATION	AE K S EH P T EY SH AH N
ACCEPTATIONS	AE K S EH P T EY SH AH N Z
ACCEPTED	AE K S EH P T IH D
ACCEPTEDLY	AE K S EH P T AH D L IY
ACCEPTEE	AE K S EH P T IY
ACCEPTEES	AE K S EH P T IY Z
ACCEPTER	AE K S EH P T ER
ACCEPTERS	AE K S EH P T ER Z
ACCEPTING	AE K S EH P T IH NG
ACCEPTING(2)	AH K S EH P T IH NG
ACCEPTINGLY	AE K S EH P T IH NG L IY
ACCEPTINGNESS	AE K S EH P T IH NG N AH S
ACCEPTINGNESSES	AE K S EH P T IH NG N AH S IH Z
ACCEPTIVE	AE K S EH P T IH V
ACCEPTOR	AE K S EH P T ER
ACCEPTORS	AE K S EH P T ER Z
ACCEPTS	AE K S EH P T S
ACCESS	AE K S EH S
ACCESSARIES	AE K S EH S EH R IY Z
ACCESSARY	AE K S EH S EH R IY
ACCESSED	AE K S EH S T
ACCESSES	AE K S EH S IH Z
ACCESSIBILITIES	AE K S EH S AH B IH L AH T IY Z
ACCESSIBILITY	AE K S EH S AH B IH L IH T IY
ACCESSIBLE	AE K S EH S AH B AH L
ACCESSIBLENESS	AE K S EH S AH B AH L N AH S
ACCESSIBLENESSES	AE K S EH S AH B AH L N AH S IH Z
ACCESSIBLY	AE K S EH S AH B L IY
ACCESSING	AE K S EH S IH NG
ACCESSION	AH K S EH SH AH N
ACCESSIONAL	AE K S EH SH AH N AH L
ACCESSIONED	AE K S EH SH AH N D
ACCESSIONING	AE K S EH SH AH N IH NG
ACCESSIONS	AE K S EH SH AH N Z
ACCESSORIAL	AE K S EH S AH R IY AH L
ACCESSORIES	AE K S EH S ER IY Z
ACCESSORISE	AE K S EH S AH R AY Z
ACCESSORISED	AE K S EH S AH R IY Z D
ACCESSORISES	AE K S EH S AH R IY Z IH Z
ACCESSORISING	AE K S EH S AH R IY Z IH NG
ACCESSORIZE	AE K S EH S ER AY Z
ACCESSORIZED	AE K S EH S ER AY Z D
ACCESSORIZES	AE K S EH S ER AY Z IH Z
ACCESSORIZING	AE K S EH S ER AY Z IH NG
ACCESSORY	AE K S EH S ER IY
ACCIDENCE	AE K S AH D AH N S
ACCIDENCES	AE K S AH D AH N S IH Z
ACCOMPLICE	AH K AA M P L AH S
ACCOMPLICES	AH K AA M P L AH S AH Z
ACCORDANCE	AH K AO R D AH N S
ACCORDANCES	AH K AO R D AH N S IH Z
ACE	EY S
ACED	EY S T
ACEDIA	AH S IY D IY AH
ACEDIAS	AH S IY D IY AH Z
ACELDAMA	AH S EH L D AH M AH
ACELDAMAS	AH S EH L D AH M AH Z
ACELLULAR	AH S EH L Y AH L ER
ACENTRIC	AH S EH N T R IH K
ACEPHALOUS	AH S EH F AH L AH S
ACEQUIA	AH S EH K W IY AH
ACEQUIAS	AH S EH K W IY AH Z
ACERATE	EY S ER AH T
ACERATED	EY S ER EY T IH D
ACERB	AE S AH R B
ACERBATE	EY S ER B EY T
ACERBATED	EY S ER B EY T IH D
ACERBATES	EY S ER B EY T S
ACERBATING	EY S ER B EY T IH NG
ACERBER	EY S ER B IY ER
ACERBEST	EY S ER B EH S T
ACERBIC	AH S EH R B IH K
ACERBICALLY	EY S ER B AY K AO L IY
ACERBITIES	EY S ER B IY AH T IY Z
ACERBITY	EY S ER B IY AH T IY
ACEROLA	AH S EH R AH L AH
ACEROLAS	AH S EH R AH L AH Z
ACEROSE	EY S R OW Z
ACEROUS	EY S ER AH S
ACERVATE	AE S AH R V EY T
ACERVULI	AE S AH R V Y UW L IY
ACERVULUS	AH S AH R V Y AH L AH S
ACES	EY S IH Z
ACESCENT	EY S EH N T
ACESCENTS	EY S EH N T S
ACETA	AE S AH T AH
ACETABULA	AE S AH T AH B Y UW L AH
ACETABULAR	EY S T AE B Y AH L ER
ACETABULUM	AE S AH T AH B Y UW L AH M
ACETABULUMS	AE S AH T AH B Y UW L AH M Z
ACETAL	AE S AH T AH L
ACETALDEHYDE	AH S AH T AE L D AH HH AY D
ACETALDEHYDES	AH S AH T AE L D AH HH AY D Z
ACETALS	AE S AH T AH L Z
ACETAMID	EY S T EY M AH D
ACETAMIDE	AH S EH T AH M AY D
ACETAMIDES	AH S EH T AH M AY D Z
ACETAMIDS	EY S T EY M AH D Z
ACETAMINOPHEN	AH S IY T AH M IH N AH F AH N
ACETAMINOPHENS	AE S AH T AH M IH N AH F AH N Z
ACETANILID	AE S AH T AE N AH L AH D
ACETANILIDE	AH S AH T AE N AH L AY D
ACETANILIDES	AH S AH T AE N AH L AY D Z
ACETANILIDS	AE S AH T AE N AH L AH D Z
ACETATE	AE S AH T EY T
ACETATED	AE S AH T EY T IH D
ACETATES	AE S AH T EY T S
ACETAZOLAMIDE	AH S AH T AH Z AA L AH M AY D
ACETAZOLAMIDES	AH S AH T AH Z AA L AH M AY D Z
ACETIC	AH S EH T IH K
ACETIC(2)	AH S IY T IH K
ACETIFICATION	AH S EH T AH F AH K EY SH AH N
ACETIFICATIONS	AH S EH T AH F AH K EY T IY AH N Z
ACETIFIED	AH S EH T AH F AY D
ACETIFIES	AH S EH T AH F AY Z
ACETIFY	AH S EH T AH F AY
ACETIFYING	AE S AH T IH F AY AH NG
ACETIN	EY S T IH N
ACETINS	EY S T IH N Z
ACETONE	AE S AH T OW N
ACETONES	AE S AH T OW N Z
ACETONIC	AE S AH T OW N IH K
ACETONITRILE	AH S EH T AH N IH T R AH L
ACETONITRILES	AH S EH T AH N IH T R AH L Z
ACETOPHENETIDIN	AH S EH T AH F AH N EH T AH D AH N
ACETOPHENETIDINS	AH S EH T AH F AH N EH T AH D AH N Z
ACETOSE	AE S AH T OW Z
ACETOUS	AE S AH T AH S
ACETOXYL	AE S AH T AA K S AH L
ACETOXYLS	AE S AH T AA K S AH L Z
ACETUM	AE S AH T AH M
ACETYL	AE S AH T AH L
ACETYLATE	AH S EH T AH L EY T
ACETYLATED	AH S EH T AH L EY T AH D
ACETYLATES	AH S EH T AH L EY T S
ACETYLATING	AH S EH T AH L EY T AH NG
ACETYLATION	AH S EH T AH L EY SH AH N
ACETYLATIONS	AE S AH T AH L EY T IY AH N Z
ACETYLATIVE	AE S AH T AH L EY T AH V
ACETYLCHOLINE	AH S EH T AH L K OW L IY N
ACETYLCHOLINE(2)	AH S IY T AH L K OW L IY N
ACETYLCHOLINES	AH S AH T IH L CH AH L AY N Z
ACETYLCHOLINESTERASE	AH S AH T AH L CH AH L AH N EH S T AH R EY Z
ACETYLCHOLINESTERASES	AH S AH T AH L CH AH L AH N EH S T AH R EY Z AH Z
ACETYLENE	AH S EH T AH L IY N
ACETYLENES	AH S EH T AH L IY N Z
ACETYLENIC	AH S EH T AH L AH N AH K
ACETYLIC	AE S AH T AH L AH K
ACETYLS	AE S AH T AH L Z
ACETYLSALICYLATE	AE S AH T AH L S AH L IH S AH L EY T
ACETYLSALICYLATES	AE S AH T AH L S AH L IH S AH L EY T S
ACQUAINTANCE	AH K W EY N T AH N S
ACQUAINTANCES	AH K W EY N T AH N S IH Z
ACQUAINTANCESHIP	AH K W EY N T AH N S SH IH P
ACQUAINTANCESHIPS	AH K W EY N T AH N S SH IH P S
ACQUIESCE	AE K W IY EH S
ACQUIESCED	AE K W IY EH S T
ACQUIESCENCE	AE K W IY EH S AH N S
ACQUIESCENCES	AE K W IY EH S AH N S IH Z
ACQUIESCENT	AE K W IY EH S AH N T
ACQUIESCENTLY	AE K W IY EH S AH N T L IY
ACQUIESCES	AE K W IY EH S IH Z
ACQUITTANCE	AH K W IH T AH N S
ACQUITTANCES	AH K W IH T AH N S IH Z
ACROCENTRIC	AE K R AH S AH N T R AH K
ACROCENTRICS	AE K R AH S EH N T R AH S Z
ACTINOMYCES	AE K T IH N AH M AY S AH Z
ACTINOMYCETE	AE K T AH N AA M AH S IY T
ACTINOMYCETES	AE K T AH N AA M AH S IY T S
ACTINOMYCETOUS	AE K T AH N AH M IH S AH T AH S
ACUTANCE	AH K Y UW T AH N S
ACUTANCES	AH K Y UW T AH N S IH Z
ADAMANCE	AH D EY M AH N S
ADAMANCES	AH D EY M AH N S IH Z
ADDUCE	AH D UW S
ADDUCED	AH D UW S T
ADDUCENT	AH D UW S AH N T
ADDUCER	AH D UW S ER
ADDUCERS	AH D UW S ER Z
ADDUCES	AH D UW S IH Z
ADHERENCE	AH D HH IH R AH N S
ADHERENCES	AE D HH IH ER AH N S IH Z
ADJACENCIES	AH JH EY S AH N S IY Z
ADJACENCY	AH JH EY S AH N S IY
ADJACENT	AH JH EY S AH N T
ADJACENTLY	AH JH EY S AH N T L IY
ADMINISTRATRICES	AE D M AH N IH S T R AE T R AH S
ADMITTANCE	AH D M IH T AH N S
ADMITTANCES	AH D M IH T AH N S IH Z
ADOLESCENCE	AE D AH L EH S AH N S
ADOLESCENCE(2)	AE D OW L EH S AH N S
ADOLESCENCES	AE D AH L EH S AH N S IH Z
ADOLESCENT	AE D AH L EH S AH N T
ADOLESCENT(2)	AE D OW L EH S AH N T
ADOLESCENTLY	AE D AH L EH S AH N T L IY
ADOLESCENTS	AE D AH L EH S AH N T S
ADOLESCENTS(2)	AE D OW L EH S AH N T S
ADVANCE	AH D V AE N S
ADVANCED	AH D V AE N S T
ADVANCEMENT	AH D V AE N S M AH N T
ADVANCEMENTS	AH D V AE N S M AH N T S
ADVANCER	AH D V AE N S ER
ADVANCERS	AH D V AE N S ER Z
ADVANCES	AH D V AE N S IH Z
ADVERTENCE	AE D V ER T AH N S
ADVERTENCES	AE D V ER T AH N S IH Z
ADVICE	AE D V AY S
ADVICE(2)	AH D V AY S
ADVICES	AH D V AY S IH Z
AEROSPACE	EH R OW S P EY S
AEROSPACES	AE R AH S P EY S IH Z
AFFIANCE	AH F AY AH N S
AFFIANCED	AH F AY AH N S T
AFFIANCES	AH F AY AH N S IH Z
AFFIRMANCE	AH F ER M AH N S
AFFIRMANCES	AH F ER M AH N S IH Z
AFFLUENCE	AE F L UW AH N S
AFFLUENCES	AE F L UW AH N S IH Z
AFTERPIECE	AE F T ER P IY S
AFTERPIECES	AE F T ER P IY S IH Z
AIRSPACE	EH R S P EY S
AIRSPACES	EH R S P EY S IH Z
ALLEGIANCE	AH L IY JH AH N S
ALLEGIANCES	AH L IY JH AH N S IH Z
ALLIACEOUS	AE L IY AH S IY AH S
ALLIANCE	AH L AY AH N S
ALLIANCES	AH L AY AH N S IH Z
ALLOWANCE	AH L AW AH N S
ALLOWANCED	AH L AW AH N S T
ALLOWANCES	AH L AW AH N S IH Z
ALLSPICE	AO L S P AY S
ALLSPICES	AO L S P AY S IH Z
ALMUCE	AE L M Y UW S
ALMUCES	AE L M Y UW S AH Z
ALTARPIECE	AO L T ER P IY S
ALTARPIECES	AO L T ER P IY S IH Z
AMBIANCE	AE M B IY AH N S
AMBIANCES	AE M B IY AH N S IH Z
AMBIENCE	AE M B IY AH N S
AMBIENCES	AE M B IY AH N S IH Z
AMBIVALENCE	AE M B IH V AH L AH N S
AMBIVALENCES	AE M B IH V AH L AH N S IH Z
AMBSACE	AE M B S AH S
AMBSACES	AE M B S AH S AH Z
AMBULANCE	AE M B Y AH L AH N S
AMBULANCES	AE M B Y AH L AH N S IH Z
AMERCE	AE M AH R S
AMERCED	AE M AH R S T
AMERCEMENT	AH M AH R S M AH N T
AMERCEMENTS	AH M AH R S AH M AH N T S
AMERCER	AH M ER S ER
AMERCERS	AH M ER S ER Z
AMERCES	AH M AH R S AH Z
AMESACE	AE M AH Z AH S
AMESACES	AH M EH Z AH S AH Z
AMICE	AH M AY S
AMICES	AH M AY S IH Z
AMMOCETE	AE M AH S IY T
AMMOCETES	AE M AH S IY T S
AMNIOCENTESES	AE M N IY AA S AH N T IY Z AH Z
AMNIOCENTESIS	AE M N IY OW S EH N T IY S IH S
AMPHIMACER	AE M F IH M AH S AH R
AMPHIMACERS	AE M F IH M AH S AH R Z
ANCESTOR	AE N S EH S T ER
ANCESTORED	AE N S EH S T ER D
ANCESTORING	AE N S EH S T ER IH NG
ANCESTORS	AE N S EH S T ER Z
ANCESTRAL	AE N S EH S T R AH L
ANCESTRALLY	AE N S EH S T R AH L IY
ANCESTRESS	AE N S EH S T R AH S
ANCESTRESSES	AE N S EH S T R EH S AH Z
ANCESTRIES	AE N S EH S T R IY Z
ANCESTRY	AE N S EH S T R IY
ANDROCENTRIC	AE N D R AH S AH N T R AH K
ANENCEPHALIC	AE N EH N S EH F AE L IH K
ANENCEPHALIC(2)	AE N IH N S EH F AH L IH K
ANENCEPHALIES	AH N EH N S EH F AH L AY Z
ANENCEPHALY	AE N IH N S EH F AH L IY
ANGLICE	AE N G L AH S
ANLACE	AE N L AH S
ANLACES	AE N L AH S AH Z
ANNOUNCE	AH N AW N S
ANNOUNCED	AH N AW N S T
ANNOUNCEMENT	AH N AW N S M EH N T
ANNOUNCEMENTS	AH N AW N S M EH N T S
ANNOUNCER	AH N AW N S ER
ANNOUNCERS	AH N AW N S ER Z
ANNOUNCES	AH N AW N S IH Z
ANNOYANCE	AH N OY AH N S
ANNOYANCES	AH N OY AH N S IH Z
ANTECEDE	AE N T AH S IY D
ANTECEDED	AE N T AH S IY D AH D
ANTECEDENCE	AE N T EH S AH D AH N S
ANTECEDENCES	AE N T EH S AH D EH N S AH Z
ANTECEDENT	AE N T EH S AH D AH N T
ANTECEDENT(2)	AE N T IH S IY D AH N T
ANTECEDENTLY	AE N T AH S IY D AH N T L IY
ANTECEDENTS	AE N T IH S IY D AH N T S
ANTECEDENTS(2)	AE N T EH S AH D AH N T S
ANTECEDES	AE N T AH S IY D Z
ANTECEDING	AE N T AH S IY D AH NG
ANTECESSOR	AE N T AH S EH S AH R
ANTECESSORS	AE N T AH S EH S AH R Z
ANTHELICES	AE N TH AH L AH S
ANTHRACENE	AE N TH R AH S IY N
ANTHRACENES	AE N TH R AH S IY N Z
ANTHRACES	AE N TH R AH S AH Z
ANTHROPOCENTRIC	AE N TH R AH P AH S EH N T R IH K
ANTHROPOCENTRICALLY	AE N TH R AH P AH S EH N T R AH K AE L IY
ANTHROPOCENTRICITIES	AE N TH R AA P AH S EH N T R IH S AH T AY Z
ANTHROPOCENTRICITY	AE N TH R AA P AH S EH N T R IH S AH T IY
ANTHROPOCENTRISM	AE N TH R AA P AH S AH N T R IH Z AH M
ANTHROPOCENTRISMS	AE N TH R AH P AH S EH N T R AH Z AH M Z
ANTICANCER	AE N T AY K AE N S ER
ANTICANCER(2)	AE N T IY K AE N S ER
ANTICELLULITE	AE N T AH S EH L AH L AY T
ANTICENSORSHIP	AE N T AY S EH N S ER SH IH P
ANTIMISCEGENATION	AE N T AY M IH S EH JH AH N EY SH AH N
ANTIOBSCENITIES	AE N T AY AA B S EH N AH T IY Z
ANTIOBSCENITY	AE N T AY AA B S EH N AH T IY
ANTIPOLICE	AE N T AY P AH L IY S
ANTIRECESSION	AE N T AY R IY S EH SH AH N
ANTIRECESSIONARY	AE N T AY R IY S EH SH AH N EH R IY
ANTIRECESSIONS	AE N T AY R IY S EH SH AH N Z
ANTISCIENCE	AE N T AY S AY AH N S
ANTISCIENCES	AE N T AY S AY AH N S IH Z
ANTIULCER	AE N T AY AH L S ER
ANTIVIOLENCE	AE N T AY V AY AH L AH N S
ANYPLACE	EH N IY P L EY S
APACE	AH P EY S
APICES	EY P IH K S IH Z
APIECE	AH P IY S
APOTHECE	AE P AH TH IY S
APOTHECES	AE P AH TH IY S AH Z
APPEARANCE	AH P IH R AH N S
APPEARANCES	AH P IH R AH N S AH Z
APPENDICECTOMIES	AE P EH N D AH S EH K T AH M AY Z
APPENDICECTOMY	AE P EH N D AH S EH K T AH M IY
APPENDICES	AH P EH N D IH K S IH Z
APPERCEIVE	AE P AH R S IY AH V
APPERCEIVED	AE P AH R S IY AH V D
APPERCEIVES	AE P AH R S IY AH V Z
APPERCEIVING	AE P AH R S IY AH V AH NG
APPERCEPTION	AE P AH R S EH P AH N
APPERCEPTIONS	AE P AH R S EH P T IY AH N Z
APPERCEPTIVE	AE P AH R S EH P T AH V
APPETENCE	AE P AH T AH N S
APPETENCES	AE P AH T EH N S AH Z
APPLESAUCE	AE P AH L S AO S
APPLESAUCES	AE P AH L S AO S IH Z
APPLIANCE	AH P L AY AH N S
APPLIANCES	AH P L AY AH N S IH Z
APPRENTICE	AH P R EH N T AH S
APPRENTICE(2)	AH P R EH N T IH S
APPRENTICED	AH P R EH N T AH S T
APPRENTICES	AH P R EH N T AH S IH Z
APPRENTICESHIP	AH P R EH N T AH S SH IH P
APPRENTICESHIPS	AH P R EH N T AH S SH IH P S
APPURTENANCE	AE P AH R T AH N AH N S
APPURTENANCES	AE P AH R T AH N AE N S AH Z
ARACEOUS	AH R EY S AH S
ARBORESCENCE	AA R B AH R EH S AH N S
ARBORESCENCES	AA R B AH R AH S EH N S AH Z
ARBORESCENT	AA R B AH R EH S AH N T
ARCED	AA R K T
ARCHDIOCESAN	AA R CH D AY AE S AH S AH N
ARCHDIOCESE	AA R CH D AY AH S AH S
ARCHDIOCESE(2)	AA R CH D AY AH S IY Z
ARCHDIOCESES	AA R CH D AY AH S AH S IH Z
ARENACEOUS	AE R AH N AH S IY AH S
AREOCENTRIC	AH R IY AH S AH N T R AH K
ARGILLACEOUS	AA R JH IH L AH S IY AH S
ARMISTICE	AA R M AH S T AH S
ARMISTICES	AA R M AH S T AH S IH Z
ARROGANCE	EH R AH G AH N S
ARROGANCES	AE R AH G AH N S IH Z
ARTIFICE	AA R T AH F IH S
ARTIFICER	AA R T AH F AH S ER
ARTIFICERS	AA R T AH F AH S ER Z
ARTIFICES	AA R T AH F AH S IH Z
ARUSPICES	AH R AH S AH S
ASCEND	AH S EH N D
ASCENDABLE	AH S EH N D AH B AH L
ASCENDANCE	AH S EH N D AH N S
ASCENDANCES	AH S EH N D AH N S IH Z
ASCENDANCIES	AH S EH N D AH N S IY Z
ASCENDANCY	AH S EH N D AH N S IY
ASCENDANT	AH S EH N D AH N T
ASCENDANTLY	AH S EH N D AH N T L IY
ASCENDANTS	AH S EH N D AH N T S
ASCENDED	AH S EH N D AH D
ASCENDENCE	AH S EH N D AH N S
ASCENDENCES	AH S EH N D AH N S IH Z
ASCENDENCIES	AH S EH N D AH N S IY Z
ASCENDENCY	AH S EH N D AH N S IY
ASCENDENT	AH S EH N D AH N T
ASCENDENTS	AH S EH N D AH N T S
ASCENDER	AH S EH N D ER
ASCENDERS	AH S EH N D ER Z
ASCENDIBLE	AH S EH N D AH B AH L
ASCENDING	AH S EH N D IH NG
ASCENDS	AH S EH N D Z
ASCENSION	AH S EH N SH AH N
ASCENSIONAL	AE S EH N S IY AH N AH L
ASCENSIONS	AE S EH N S IY AH N Z
ASCENSIVE	AE S EH N Z AH V
ASCENT	AH S EH N T
ASCENTS	AH S EH N T S
ASCERTAIN	AE S ER T EY N
ASCERTAINABLE	AE S ER T EY N AH B AH L
ASCERTAINED	AE S ER T EY N D
ASCERTAINING	AE S ER T EY N IH NG
ASCERTAINMENT	AE S ER T EY N M AH N T
ASCERTAINMENTS	AE S ER T EY N M AH N T S
ASCERTAINS	AE S ER T EY N Z
ASCESES	AE S IY Z AH Z
ASCESIS	AE S AH S AH S
ASCETIC	AH S EH T IH K
ASCETICAL	AH S EH T IH K AH L
ASCETICALLY	AH S EH T IH K AH L IY
ASCETICISM	AH S EH T AH S IH Z AH M
ASCETICISMS	AH S EH T AH S IH Z AH M Z
ASCETICS	AH S EH T IH K S
ASCOMYCETE	AE S AA M AH S IY T
ASCOMYCETES	AE S AA M AH S IY T S
ASCOMYCETOUS	AE S AH M IH S AH T AH S
ASKANCE	AH S K AE N S
ASSISTANCE	AH S IH S T AH N S
ASSISTANCES	AH S IH S T AH N S IH Z
ASSONANCE	AE S AH N AH N S
ASSONANCES	AE S AH N AH N S IH Z
ASSURANCE	AH SH UH R AH N S
ASSURANCES	AH SH UH R AH N S IH Z
ASSURANCES(2)	AH SH UH R AH N T S IH Z
ATTENDANCE	AH T EH N D AH N S
ATTENDANCES	AH T EH N D AH N S IH Z
ATTRACTANCE	AH T R AE K T AH N S
ATTRACTANCES	AH T R AE K T AH N S IH Z
AUDIENCE	AA D IY AH N S
AUDIENCE(2)	AO D IY AH N S
AUDIENCES	AA D IY AH N S AH Z
AUDIENCES(2)	AO D IY AH N S AH Z
AUSPICE	AO S P IH S
AUSPICES	AO S P IH S IH Z
AUTOCEPHALIES	AO T AH S EH F AH L AY Z
AUTOCEPHALOUS	AO T AH S EH F AH L AH S
AUTOCEPHALY	AO T AH S EH F AH L IY
AVARICE	AE V ER AH S
AVARICES	AE V AH R AH S IH Z
AVIATRICES	EY V IY AE T R AH S
AVOCET	AE V AH S EH T
AVOCETS	AE V AH S AH T S
AVOIDANCE	AH V OY D AH N S
AVOIDANCES	AH V OY D AH N S IH Z
BACKSPACE	B AE K S P EY S
BACKSPACED	B AE K S P EY S T
BACKSPACES	B AE K S P EY S IH Z
BALANCE	B AE L AH N S
BALANCED	B AE L AH N S T
BALANCER	B AE L AH N S ER
BALANCERS	B AE L AH N S ER Z
BALANCES	B AE L AH N S IH Z
BARBICEL	B AA R B AH S AH L
BARBICELS	B AA R B AH S AH L Z
BAREFACED	B EH R F EY S T
BAREFACEDLY	B EH R F EY S AH D L IY
BAREFACEDNESS	B EH R F EY S AH D N AH S
BAREFACEDNESSES	B EH R F EY S AH D N AH S IH Z
BAROCEPTOR	B AE R AH S EH P T AH R
BAROCEPTORS	B AE R AH S EH P T AH R Z
BARORECEPTOR	B AH R AO R AH S EH P T AH R
BARORECEPTORS	B AE R AH R AH S EH P T AH R Z
BASIDIOMYCETE	B AH S AH D IY AA M AH S IY T
BASIDIOMYCETES	B AH S AH D IY AA M AH S IY T S
BASIDIOMYCETOUS	B AH S IH D IY AH M IH S AH T AH S
BECHANCE	B IH CH AE N S
BECHANCED	B IH CH AE N S T
BECHANCES	B IH CH AE N S IH Z
BEDUNCE	B AH D AH N S
BEDUNCED	B AH D AH N S T
BEDUNCES	B AH D AH N S AH Z
BELACED	B IH L EY S T
BELLIGERENCE	B AH L IH JH ER AH N S
BELLIGERENCES	B AH L IH JH ER AH N S IH Z
BENEFICE	B AH N IY F AH S
BENEFICED	B AH N IY F AH S T
BENEFICENCE	B AH N EH F AH S AH N S
BENEFICENCES	B AH N EH F AH S AH N S IH Z
BENEFICENT	B EH N AH F IH SH AH N T
BENEFICENTLY	B AH N EH F AH S EH N T L IY
BENEFICES	B AH N IY F AH S
BENEVOLENCE	B AH N EH V AH L AH N S
BENEVOLENCES	B AH N EH V AH L AH N S IH Z
BENZANTHRACENE	B IH N Z AE N TH R AH S IY N
BENZANTHRACENES	B IH N Z AE N TH R AH S IY N Z
BERCEUSE	B IH R S UW Z
BERCEUSES	B IH R S UW Z AH Z
BIACETYL	B AY AE S AH T AH L
BIACETYLS	B AY AE S AH T AH L Z
BICE	B AY S
BICENTENARIES	B AY S EH N T AH N EH R IY Z
BICENTENARY	B AY S EH N T IH N EH R IY
BICENTENNIAL	B AY S EH N T EH N IY AH L
BICENTENNIALS	B AY S EH N T EH N IY AH L Z
BICEPS	B AY S EH P S
BICEPSES	B AY S EH P S IH Z
BICES	B IY IH K S IH Z
BIFACE	B AY F EY S
BIFACES	B AY F EY S IH Z
BIOCENOSES	B AY AA S AH N OW Z AH Z
BIOCENOSIS	B AY AA S AH N OW S AH S
BIOLUMINESCENCE	B AY AH L AH M AH N EH S AH N S
BIOLUMINESCENCES	B AY AH L AH M AH N AH S EH N S AH Z
BIOLUMINESCENT	B AY AH L AH M AH N EH S AH N T
BIOSCIENCE	B AY OW S AY AH N S
BIOSCIENCES	B AY OW S AY AH N S IH Z
BIREFRINGENCE	B AY R IH F R IH N JH AH N S
BIREFRINGENCES	B AY R IH F R IH N JH AH N S IH Z
BIRTHPLACE	B ER TH P L EY S
BIRTHPLACES	B ER TH P L EY S IH Z
BLACKFACE	B L AE K F EY S
BLACKFACES	B L AE K F EY S IH Z
BOCCE	B OW CH IY
BOCCE(2)	B OW K AH
BOCCES	B AA K S AH Z
BODICE	B AA D IH S
BODICES	B AA D IH S IH Z
BOLDFACE	B OW L D F EY S
BOLDFACED	B OW L D F EY S T
BOLDFACES	B OW L D F EY S IH Z
BONIFACE	B AA N AH F AH S
BONIFACES	B AA N AH F AH S IH Z
BOOKLICE	B UH K L AY S
BOOTLACE	B UW T L EY S
BOOTLACES	B UW T L EY S IH Z
BORACES	B IY ER EY S IH Z
BOUNCE	B AW N S
BOUNCED	B AW N S T
BOUNCER	B AW N S ER
BOUNCERS	B AW N S ER Z
BOUNCES	B AW N S IH Z
BRACE	B R EY S
BRACED	B R EY S T
BRACELET	B R EY S L AH T
BRACELETS	B R EY S L IH T S
BRACER	B R EY S ER
BRACERO	B R AA CH EH R OW
BRACEROS	B R EY S ER AA S
BRACERS	B R EY S ER Z
BRACES	B R EY S AH Z
BRACES(2)	B R EY S IH Z
BRACHYCEPHALIC	B R AH CH IH S AH F AH L AH K
BRACHYCEPHALIES	B R AE CH AH S EH F AH L AY Z
BRACHYCEPHALY	B R AE CH AH S EH F AH L IY
BRATTICE	B R AE T AH S
BRATTICED	B R AE T AH S T
BRATTICES	B R AE T AH S
BRILLIANCE	B R IH L Y AH N S
BRILLIANCES	B R IH L Y AH N S IH Z
BRISANCE	B R AY Z AH N S
BRISANCES	B R AY Z AE N S AH Z
BRUCELLA	B R UW S EH L AH
BRUCELLAE	B R UW S EH L IY
BRUCELLAS	B R UW S EH L AH Z
BRUCELLOSES	B R UW S AH L OW Z AH Z
BRUCELLOSIS	B R UW S AH L OW S AH S
BULLACE	B UH L EY S
BULLACES	B UH L EY S IH Z
BUOYANCE	B OY AH N S
BUOYANCES	B OY AH N S IH Z
CADDICE	K AE D AH S
CADDICES	K EY D IH K S IH Z
CADENCE	K EY D AH N S
CADENCED	K EY D AH N S T
CADENCES	K EY D AH N S IH Z
CADUCEAN	K AE D Y UW S IY AH N
CADUCEI	K AE D Y AH S IY
CADUCEUS	K AE D Y UW S IY AH S
CALCEATE	K AE L S IY EY T
CALCES	K AE L S AH Z
CALICES	K AE L AH S
CALYCEAL	K AH L IH S IY AH L
CALYCES	K AH L AY S AH Z
CAMPHORACEOUS	K AE M F AH R AH S IY AH S
CANCEL	K AE N S AH L
CANCELABLE	K AE N S AH L AH B AH L
CANCELATION	K AE N S AH L EY SH AH N
CANCELATIONS	K AE N S AH L EY SH AH N Z
CANCELED	K AE N S AH L D
CANCELER	K AE N S AH L ER
CANCELERS	K AE N S AH L ER Z
CANCELING	K AE N S AH L IH NG
CANCELING(2)	K AE N S L IH NG
CANCELLABLE	K AE N S AH L AH B AH L
CANCELLATION	K AE N S AH L EY SH AH N
CANCELLATIONS	K AE N S AH L EY SH AH N Z
CANCELLED	K AE N S AH L D
CANCELLER	K AE N S AH L ER
CANCELLERS	K AE N S AH L ER Z
CANCELLING	K AE N S AH L IH NG
CANCELLING(2)	K AE N S L IH NG
CANCELLOUS	K AE N S AH L AH S
CANCELS	K AE N S AH L Z
CANCER	K AE N S ER
CANCEROUS	K AE N S ER AH S
CANCEROUSLY	K AE N S ER AH S L IY
CANCERS	K AE N S ER Z
CANDESCENCE	K AE N D EH S AH N S
CANDESCENCES	K AE N D AH S EH N S AH Z
CANDESCENT	K AE N D IH S EH N T
CANESCENT	K EY N S EH N T
CANTATRICE	K AE N T AE T R AY S
CANTATRICES	K AE N T AE T R AY S IH Z
CAPACITANCE	K AH P AE S AH T AH N S
CAPACITANCES	K AH P AE S AH T AH N S IH Z
CAPRICE	K AH P R IY S
CAPRICES	K AH P R IY S AH Z
CARAPACE	K AA R AH P EY S
CARAPACES	K AA R AH P EY S IH Z
CARBONACEOUS	K AA R B AH N EY S AH S
CARBOXYMETHYLCELLULOSE	K AA R B AA K S IY M EH TH AH L S EH L Y AH L OW S
CARBOXYMETHYLCELLULOSES	K AA R B AA K S IY M EH TH AH L S EH L Y AH L OW S IH
CARCEL	K AA R S AH L
CARCELS	K AA R S AH L Z
CARICES	K EH R IH K S IH Z
CATFACE	K AE T F EY S
CATFACES	K AE T F EY S IH Z
CAUDICES	K AO D AH S
CEANOTHUS	S IY N AH TH AH S
CEANOTHUSES	S IY N AH TH UW Z AH Z
CEASE	S IY S
CEASED	S IY S T
CEASEFIRE	S IY S F AY ER
CEASEFIRES	S IY S F AY ER Z
CEASELESS	S IY S L IH S
CEASELESSLY	S IY Z L AH S L IY
CEASELESSNESS	S IY S L AH S N AH S
CEASELESSNESSES	S IY S L AH S N AH S IH Z
CEASES	S IY S IH Z
CEASING	S IY S IH NG
CEBID	S EH B AH D
CEBIDS	S EH B AH D Z
CEBOID	S IY B OY D
CEBOIDS	S AH B OY D Z
CECA	S EH K AH
CECAL	S IY K AH L
CECALLY	S AH K AE L IY
CECUM	S EH K AH M
CEDAR	S IY D ER
CEDARBIRD	S IY D ER B ER D
CEDARBIRDS	S IY D ER B ER D Z
CEDARN	S EH D AH R N
CEDARS	S IY D ER Z
CEDARWOOD	S IY D ER W UH D
CEDARWOODS	S IY D ER W UH D Z
CEDE	S IY D
CEDED	S IY D AH D
CEDED(2)	S IY D IH D
CEDER	S IY D ER
CEDERS	S EH D AH R Z
CEDES	S IY D Z
CEDI	S EH D IY
CEDILLA	S AH D IH L AH
CEDILLAS	S AH D IH L AH Z
CEDING	S IY D IH NG
CEDIS	S IY D AH S
CEDULA	S EH D Y UW L AH
CEDULAS	S EH D Y UW L AH Z
CEE	S IY
CEES	S IY Z
CEIBA	S IY B AH
CEIBAS	S IY B AH Z
CEIL	S IY L
CEILED	S IY AH L D
CEILER	S IY AH L AH R
CEILERS	S IY L AH R Z
CEILING	S IY L IH NG
CEILINGED	S EH L IH NG D
CEILINGS	S IY L IH NG Z
CEILOMETER	S IY AH L AA M AH T AH R
CEILOMETERS	S IY L AA M AH T AH R Z
CEILS	S IY AH L Z
CEINTURE	S IY N T Y AH R
CEINTURES	S IY N T Y AH R Z
CEL	S EH L
CEL(2)	S IY IY EH L
CELADON	S EH L AH D AA N
CELADONS	S EH L AH D AH N Z
CELANDINE	S EH L AH N D AY N
CELANDINES	S EH L AH N D AY N Z
CELEB	S AH L EH B
CELEBRANT	S EH L AH B R AH N T
CELEBRANTS	S EH L AH B R AH N T S
CELEBRATE	S EH L AH B R EY T
CELEBRATED	S EH L AH B R EY T IH D
CELEBRATEDNESS	S EH L AH B R AH T AH D N AH S
CELEBRATEDNESSES	S EH L AH B R AH T AH D N AH S IH Z
CELEBRATES	S EH L AH B R EY T S
CELEBRATING	S EH L AH B R EY T IH NG
CELEBRATION	S EH L AH B R EY SH AH N
CELEBRATIONS	S EH L AH B R EY SH AH N Z
CELEBRATOR	S EH L AH B R AH T ER
CELEBRATORS	S EH L AH B R AH T ER Z
CELEBRATORY	S AH L EH B R AH T AO R IY
CELEBRITIES	S AH L EH B R IH T IY Z
CELEBRITY	S AH L EH B R IH T IY
CELEBS	S AH L EH B Z
CELERIAC	S AH L IY R IY AH K
CELERIACS	S AH L IY R IY AH S
CELERIES	S EH L R IY Z
CELERITIES	S AH L EH R AH T IY Z
CELERITY	S AH L EH R AH T IY
CELERY	S EH L ER IY
CELESTA	S IH L EH S T AH
CELESTAS	S AH L EH S T AH Z
CELESTE	S AH L EH S T
CELESTES	S EH L AH S T S
CELESTIAL	S AH L EH S CH AH L
CELESTIALLY	S AH L EH S CH AH L IY
CELESTIALS	S AH L EH S CH AH L Z
CELESTITE	S EH L AH S T AY T
CELESTITES	S EH L AH S T AY T S
CELIAC	S IY L IY AE K
CELIACS	S IY L IY AE K S
CELIBACIES	S AH L IH B AH S AY Z
CELIBACY	S EH L AH B AH S IY
CELIBATE	S EH L IH B AH T
CELIBATES	S EH L AH B EY T S
CELL	S EH L
CELLA	S EH L AH
CELLAE	S EH L IY
CELLAR	S EH L ER
CELLARAGE	S EH L ER IH JH
CELLARAGES	S EH L ER IH JH IH Z
CELLARED	S EH L ER D
CELLARER	S EH L ER ER
CELLARERS	S EH L ER ER Z
CELLARET	S EH L AH R AH T
CELLARETS	S EH L AH R AH T S
CELLARETTE	S EH L ER EH T
CELLARETTES	S EH L ER EH T S
CELLARING	S EH L ER IH NG
CELLARS	S EH L ER Z
CELLBLOCK	S EH L B L AA K
CELLBLOCKS	S EH L B L AA K S
CELLED	S EH L D
CELLI	CH EH L IY
CELLING	S EH L IH NG
CELLIST	CH EH L AH S T
CELLISTS	CH EH L AH S T S
CELLMATE	S EH L M EY T
CELLMATES	S EH L M EY T S
CELLO	CH EH L OW
CELLOBIOSE	S EH L OW B IY OW Z
CELLOBIOSES	S EH L OW B IY OW Z AH Z
CELLOIDIN	S EH L OY D AH N
CELLOIDINS	S EH L OY D AH N Z
CELLOPHANE	S EH L AH F EY N
CELLOPHANES	S EH L AH F EY N Z
CELLOS	S EH L AA S
CELLPHONE	S EH L F OW N
CELLPHONES	S EH L F OW N Z
CELLS	S EH L Z
CELLULAR	S EH L Y AH L ER
CELLULARITIES	S EH L Y AH L ER AH T IY Z
CELLULARITY	S EH L Y AH L ER AH T IY
CELLULASE	S EH L AH L EY Z
CELLULASES	S EH L AH L EY Z AH Z
CELLULE	S EH L UW L
CELLULES	S EH L AH L Z
CELLULITE	S EH L AH L AY T
CELLULITES	S EH L AH L AY T S
CELLULITIS	S EH L AH L AY T AH S
CELLULITISES	S EH L UW L AH T AY Z AH Z
CELLULOID	S EH L AH L OY D
CELLULOIDS	S EH L AH L OY D Z
CELLULOLYTIC	S EH L UW L AH L AH T AH K
CELLULOSE	S EH L Y AH L OW S
CELLULOSES	S EH L Y AH L OW S IH Z
CELLULOSIC	S EH L Y AH L OW S IH K
CELLULOSICS	S EH L Y AH L OW S IH K S
CELOM	S EH L AH M
CELOMATA	S AH L AA M AH T AH
CELOMS	S EH L AH M Z
CELOSIA	CH EH L OW S IY AH
CELOSIAS	S AH L OW S IY AH Z
CELS	S EH L Z
CELT	S EH L T
CELT(2)	K EH L T
CELTS	S EH L T S
CELTS(2)	K EH L T S
CEMBALI	S EH M B AH L IY
CEMBALO	S EH M B AH L OW
CEMBALOS	S EH M B AH L AH Z
CEMENT	S AH M EH N T
CEMENT(2)	S IH M EH N T
CEMENTA	S AH M EH N T AH
CEMENTATION	S IH M EH N T EY SH AH N
CEMENTATIONS	S IH M EH N T EY SH AH N Z
CEMENTED	S IH M EH N T IH D
CEMENTER	S IH M EH N T ER
CEMENTERS	S IH M EH N T ER Z
CEMENTING	S IH M EH N T IH NG
CEMENTITE	S EH M AH N T AY T
CEMENTITES	S EH M AH N T AY T S
CEMENTITIOUS	S IH M EH N T AH T IY AH S
CEMENTS	S IH M EH N T S
CEMENTUM	S AH M EH N T AH M
CEMENTUMS	S AH M EH N T AH M Z
CEMETERIES	S EH M AH T EH R IY Z
CEMETERY	S EH M AH T EH R IY
CEMETERY(2)	S EH M IH T EH R IY
CENACLE	S EH N AH K AH L
CENACLES	S EH N AH K AH L Z
CENOBITE	S EH N AH B AY T
CENOBITES	S EH N AH B AY T S
CENOBITIC	S EH N AH B AH T AH K
CENOSPECIES	S AH N AA S AH S AY Z
CENOTAPH	S EH N AH T AH F
CENOTAPHS	S EH N AH T AH F S
CENOTE	S AH N OW T
CENOTES	S AH N OW T S
CENSE	S EH N S
CENSED	S EH N Z D
CENSER	S EH N S ER
CENSERS	S EH N S AH R Z
CENSES	S EH N S AH Z
CENSING	S EH N S AH NG
CENSOR	S EH N S ER
CENSORED	S EH N S ER D
CENSORIAL	S EH N S OW R IY AH L
CENSORING	S EH N S ER IH NG
CENSORIOUS	S EH N S ER IY AH S
CENSORIOUSLY	S EH N S ER IY AH S L IY
CENSORIOUSNESS	S EH N S ER IY AH S N AH S
CENSORIOUSNESSES	S EH N S ER IY AH S N AH S IH Z
CENSORS	S EH N S ER Z
CENSORSHIP	S EH N S ER SH IH P
CENSORSHIPS	S EH N S ER SH IH P S
CENSUAL	S EH N Z Y AH W AH
CENSURABLE	S EH N CH ER AH B AH L
CENSURE	S EH N SH ER
CENSURED	S EH N SH ER D
CENSURER	S EH N CH ER ER
CENSURERS	S EH N CH ER ER Z
CENSURES	S EH N CH ER Z
CENSURING	S EH N CH ER IH NG
CENSUS	S EH N S AH S
CENSUSED	S EH N S AH S T
CENSUSES	S EH N S AH S IH Z
CENSUSING	S EH N S AH S IH NG
CENT	S EH N T
CENTAI	S EH N T EY
CENTAL	S EH N T AH L
CENTALS	S EH N T AH L Z
CENTARE	S EH N T AH R
CENTARES	S EH N T AH R Z
CENTAS	S EH N T AH Z
CENTAUR	S EH N T AO R
CENTAUREA	S EH N T AH Y UH R IY AH
CENTAUREAS	S EH N T AH Y UH R IY AH Z
CENTAURIES	S EH N T AH R AY Z
CENTAURS	S EH N T AO R Z
CENTAURY	S EH N T AH R IY
CENTAVO	S EH N T AH V OW
CENTAVOS	S EH N T AA V OW S
CENTENARIAN	S EH N T AH N EH R IY AH N
CENTENARIANS	S EH N T AH N EH R IY AH N Z
CENTENARIES	S EH N T AH N EH R IY Z
CENTENARY	S EH N T AH N EH R IY
CENTENNIAL	S EH N T EH N IY AH L
CENTENNIALLY	S EH N T EH N IY AH L IY
CENTENNIALS	S EH N T EH N IY AH L Z
CENTER	S EH N T ER
CENTER(2)	S EH N ER
CENTERBOARD	S EH N T ER B OW R D
CENTERBOARDS	S EH N T ER B OW R D Z
CENTERED	S EH N T ER D
CENTEREDNESS	S EH N T ER AH D N AH S
CENTEREDNESSES	S EH N T ER AH D N AH S IH Z
CENTERFOLD	S EH N T ER F OW L D
CENTERFOLDS	S EH N T ER F OW L D Z
CENTERING	S EH N T ER IH NG
CENTERLESS	S EH N T ER L AH S
CENTERLINE	S EH N T ER L AY N
CENTERLINES	S EH N T ER L AY N Z
CENTERPIECE	S EH N T ER P IY S
CENTERPIECES	S EH N T ER P IY S IH Z
CENTERS	S EH N T ER Z
CENTERS(2)	S EH N ER Z
CENTESES	S EH N T IY Z AH Z
CENTESIMAL	S EH N T EH S AH M AH L
CENTESIMI	S EH N T EH S AH M IY
CENTESIMO	S EH N T EH S AH M OW
CENTESIMOS	S EH N T EH S AH M AH Z
CENTESIS	S EH N T AH S AH S
CENTIARE	S EH N T IY AH R
CENTIARES	S EH N T IY AH R Z
CENTIGRADE	S EH N T AH G R EY D
CENTIGRAM	S EH N T AH G R AE M
CENTIGRAMS	S EH N T IH G R AH M Z
CENTILE	S EH N T AH L
CENTILES	S EH N T AH L Z
CENTILITER	S EH N T AH L AY T AH R
CENTILITERS	S EH N T IH L AH T AH R Z
CENTILLION	S EH N T IH L Y AH N
CENTILLIONS	S EH N T IH L Y AH N Z
CENTIME	S EH N T AY M
CENTIMES	S EH N T AY M Z
CENTIMETER	S EH N T AH M IY T ER
CENTIMETERS	S EH N T AH M IY T ER Z
CENTIMO	S EH N T AH M OW
CENTIMORGAN	S EH N T IH M AO R G AH N
CENTIMORGANS	S EH N T IH M AO R G AH N Z
CENTIMOS	S EH N T IH M AA S
CENTIPEDE	S EH N T IH P IY D
CENTIPEDES	S EH N T AH P IY D Z
CENTNER	S EH N T N ER
CENTNERS	S EH N T N AH R Z
CENTO	S EH N T OW
CENTONES	S EH N T OW N Z
CENTOS	S EH N T AA S
CENTRA	S EH N T R AH
CENTRAL	S EH N T R AH L
CENTRALER	S EH N T R AH L ER
CENTRALEST	S EH N T R AH L AH S T
CENTRALISE	S EH N T R AH L AY Z
CENTRALISED	S EH N T R AH L IY Z D
CENTRALISES	S EH N T R AH L IY Z IH Z
CENTRALISING	S EH N T R AH L IY Z IH NG
CENTRALISM	S EH N T R AH L IH Z AH M
CENTRALISMS	S EH N T R AH L IH Z AH M Z
CENTRALIST	S EH N T R AH L IH S T
CENTRALISTIC	S EH N T R AH L IH S T IH K
CENTRALISTS	S EH N T R AH L IH S T S
CENTRALITIES	S EH N T R AE L AH T IY Z
CENTRALITY	S EH N T AE L IH T IY
CENTRALIZATION	S EH N T R AH L IH Z EY SH AH N
CENTRALIZATIONS	S EH N T R AH L AH Z EY SH AH N Z
CENTRALIZE	S EH N T R AH L AY Z
CENTRALIZED	S EH N T R AH L AY Z D
CENTRALIZER	S EH N T R AH L AY Z ER
CENTRALIZERS	S EH N T R AH L AY Z ER Z
CENTRALIZES	S EH N T R AH L AY Z IH Z
CENTRALIZING	S EH N T R AH L AY Z IH NG
CENTRALLY	S EH N T R AH L IY
CENTRALS	S EH N T R AH L Z
CENTRE	S EH N T ER
CENTRED	S EH N T ER D
CENTRES	S EH N T ER Z
CENTRIC	S EH N T R IH K
CENTRICALLY	S EH N T R IH K AH L IY
CENTRICITIES	S EH N T R IH K AH T IY Z
CENTRICITY	S EH N T R IH K AH T IY
CENTRIFUGAL	S EH N T R IH F Y UW G AH L
CENTRIFUGALLY	S EH N T R IH F Y AH G AH L IY
CENTRIFUGALS	S EH N T R IH F Y AH G AH L Z
CENTRIFUGATION	S EH N T R IH F AH G EY SH AH N
CENTRIFUGATIONS	S EH N T R IH F AH G EY SH AH N Z
CENTRIFUGE	S EH N T R AH F Y UW JH
CENTRIFUGED	S EH N T R AH F Y UW JH D
CENTRIFUGES	S EH N T R AH F Y UW JH IH Z
CENTRIFUGING	S EH N T R AH F Y UW JH IH NG
CENTRING	S EH N T ER IH NG
CENTRINGS	S EH N T ER IH NG Z
CENTRIOLE	S EH N T R IY OW L
CENTRIOLES	S EH N T R IY OW L Z
CENTRIPETAL	S EH N T R IH P AH T AH L
CENTRIPETALLY	S EH N T R AY P T AE L IY
CENTRISM	S EH N T ER IH Z AH M
CENTRISMS	S EH N T ER IH Z AH M Z
CENTRIST	S EH N T R IH S T
CENTRISTS	S EH N T R IH S T S
CENTROID	S EH N T R OW AH D
CENTROIDS	S EH N T R OW AH D Z
CENTROMERE	S EH N T R OW M AH R
CENTROMERES	S EH N T R AH M IY R Z
CENTROMERIC	S EH N T R AH M AH R AH K
CENTROSOME	S EH N T R AH S AH M
CENTROSOMES	S EH N T R AH S AH M Z
CENTROSYMMETRIC	S EH N T R AH S IH M AH T R AH K
CENTRUM	S EH N T R AH M
CENTRUMS	S EH N T R AH M Z
CENTS	S EH N T S
CENTS(2)	S EH N S
CENTU	S EH N T UW
CENTUM	K EH N T AH M
CENTUMS	K EH N T AH M Z
CENTUPLE	S EH N T Y UW P AH L
CENTUPLED	S EH N T AH P L EH D
CENTUPLES	S EH N T AH P AH L Z
CENTUPLING	S EH N T AH P L IH NG
CENTURIES	S EH N CH ER IY Z
CENTURION	S EH N T UH R IY AH N
CENTURIONS	S EH N CH ER IY AH N Z
CENTURY	S EH N CH ER IY
CEORL	S IY AH R L
CEORLISH	S IY AO R L AH SH
CEORLS	S IY AH R L Z
CEP	S EH P
CEPE	S IY P
CEPES	S IY P S
CEPHALAD	S EH F AH L AH D
CEPHALEXIN	S EH F AH L EH K S AH N
CEPHALEXINS	S EH F AH L EH K S AH N Z
CEPHALIC	S EH F AH L AH K
CEPHALICALLY	S AH F AE L AH K AE L IY
CEPHALIN	S EH F AH L AH N
CEPHALINS	S EH F AH L AH N Z
CEPHALIZATION	S EH F AH L AH Z EY SH AH N
CEPHALIZATIONS	S EH F AH L AH Z EY T IY AH N Z
CEPHALOMETRIC	S AH F AE L AH M AH T R AH K
CEPHALOMETRIES	S EH F AH L AH M EH T R AY Z
CEPHALOMETRY	S EH F AH L AH M EH T R IY
CEPHALOPOD	S EH F AH L AH P AA D
CEPHALOPODS	S AH F AE L AH P AH D Z
CEPHALORIDINE	S AH F AH L AO R AH D AY N
CEPHALORIDINES	S AH F AH L AO R AH D AY N Z
CEPHALOSPORIN	S EH F AH L AO S P AO R IH N
CEPHALOSPORINS	S EH F AH L AA S AH R AH N Z
CEPHALOTHIN	S AH F AE L AH TH AH N
CEPHALOTHINS	S AH F AE L AH TH AH N Z
CEPHALOTHORACES	S EH F AH L AH TH AO R AH S AH Z
CEPHALOTHORAX	S EH F AH L AA TH AH R AH K S
CEPHALOTHORAXES	S EH F AH L AA TH AH R AH K S
CEPHEID	S AH F IY D
CEPHEIDS	S AH F IY D Z
CEPS	S EH P S
CERAMAL	S EH R AH M AH L
CERAMALS	S EH R AH M AH L Z
CERAMIC	S ER AE M IH K
CERAMICIST	S AH R AE M IH K IH S T
CERAMICISTS	S AH R AE M IH K IH S T S
CERAMICS	S ER AE M IH K S
CERAMIST	S EH R AH M AH S T
CERAMISTS	S EH R AH M AH S T S
CERASTES	S EH R AH S T S
CERATE	S IY R EY T
CERATED	S IY R EY T AH D
CERATES	S IY R EY T S
CERATIN	S EH R AH T AH N
CERATINS	S EH R AH T AH N Z
CERATOID	S IY R AH T OY D
CERATOPSIAN	S EH R AH T AA P S IY AH N
CERATOPSIANS	S EH R AH T AA P S IY AH N Z
CERCARIA	S AH R K AE R IY AH
CERCARIAE	S AH R K AE R IY IY
CERCARIAL	S AH R K AE R IY AH L
CERCARIAS	S AH R K AE R IY AH Z
CERCI	S AH R S IY
CERCIS	S AH R S AH S
CERCISES	S AH R S AY Z AH Z
CERCUS	S AH R K AH S
CERE	S IH R
CEREAL	S IH R IY AH L
CEREALS	S IH R IY AH L Z
CEREBELLA	S EH R AH B EH L AH
CEREBELLAR	S EH R AH B EH L AH R
CEREBELLUM	S EH R AH B EH L AH M
CEREBELLUMS	S EH R AH B EH L AH M Z
CEREBRA	S AH R EH B R AH
CEREBRAL	S EH R AH B R AH L
CEREBRAL(2)	S ER IY B R AH L
CEREBRALLY	S ER IY B R AH L IY
CEREBRALS	S EH R AH B R AH L Z
CEREBRATE	S EH R AH B R AH T
CEREBRATED	S EH R AH B R EY T IH D
CEREBRATES	S EH R AH B R AH T S
CEREBRATING	S EH R AH B R EY T IH NG
CEREBRATION	S EH R AH B R EY SH AH N
CEREBRATIONS	S EH R AH B R EY SH AH N Z
CEREBRIC	S EH R AH B R IH K
CEREBROSIDE	S AH R EH B R AH S AY D
CEREBROSIDES	S AH R EH B R AH S AY D Z
CEREBROSPINAL	S EH R AH B R AA S AH N AH L
CEREBROVASCULAR	S AH R EH B R AH V AE S Y AH L AH R
CEREBRUM	S AH R EH B R AH M
CEREBRUMS	S AH R EH B R AH M Z
CERECLOTH	S AH R EH K L AH TH
CERECLOTHS	S AH R EH K L AH TH S
CERED	S IY R D
CEREMENT	S IH R M AH N T
CEREMENTS	S EH R AH M AH N T S
CEREMONIAL	S EH R AH M OW N IY AH L
CEREMONIALISM	S EH R AH M OW N IY AH L IH Z AH M
CEREMONIALISMS	S EH R AH M OW N IY AH L IH Z AH M Z
CEREMONIALIST	S EH R AH M OW N IY AH L IH S T
CEREMONIALISTS	S EH R AH M OW N IY AH L IH S T S
CEREMONIALLY	S EH R AH M OW N IY AH L IY
CEREMONIALS	S EH R AH M OW N IY AH L Z
CEREMONIES	S EH R AH M OW N IY Z
CEREMONIOUS	S EH R AH M OW N IY AH S
CEREMONIOUSLY	S EH R AH M OW N IY AH S L IY
CEREMONIOUSNESS	S EH R AH M OW N IY AH S N AH S
CEREMONIOUSNESSES	S EH R AH M OW N IY AH S N AH S IH Z
CEREMONY	S EH R AH M OW N IY
CERES	S IH R IY Z
CEREUS	S IH R IY AH S
CEREUSES	S IY R IY AH Z AH Z
CERIA	S IY R IY AH
CERIAS	S IY R IY AH Z
CERIC	S IY R AH K
CERING	S IY R AH NG
CERIPH	S EH R AH F
CERIPHS	S EH R AH F S
CERISE	S ER IY S
CERISES	S AH R IY S IH Z
CERITE	S AH R AY T
CERITES	S AH R AY T S
CERIUM	S IY R IY AH M
CERIUMS	S IY R IY AH M Z
CERMET	S AH R M AH T
CERMETS	S AH R M AH T S
CERNUOUS	S AH R N Y AH W AH S
CERO	S EH R OW
CEROS	S EH R AH Z
CEROTIC	S EH R AH T AH K
CEROTYPE	S EH R AH T AY P
CEROTYPES	S EH R AH T AY P S
CEROUS	S IY R AH S
CERTAIN	S ER T AH N
CERTAINER	S ER T AH N ER
CERTAINEST	S ER T AH N AH S T
CERTAINLY	S ER T AH N L IY
CERTAINTIES	S ER T AH N T IY Z
CERTAINTY	S ER T AH N T IY
CERTES	S AH R T S
CERTIFIABLE	S ER T AH F AY AH B AH L
CERTIFIABLY	S ER T AH F AY AH B L IY
CERTIFICATE	S ER T IH F IH K AH T
CERTIFICATED	S ER T IH F IH K AH T IH D
CERTIFICATES	S ER T IH F IH K AH T S
CERTIFICATING	S ER T IH F IH K AH T IH NG
CERTIFICATION	S ER T AH F AH K EY SH AH N
CERTIFICATIONS	S ER T AH F AH K EY SH AH N Z
CERTIFICATORY	S ER T IH F IH K AH T ER IY
CERTIFIED	S ER T AH F AY D
CERTIFIER	S ER T AH F AY ER
CERTIFIERS	S ER T AH F AY ER Z
CERTIFIES	S ER T AH F AY Z
CERTIFY	S ER T AH F AY
CERTIFYING	S ER T AH F AY IH NG
CERTIORARI	S ER SH IY AH R AA R IY
CERTIORARIS	S ER SH IY AH R AA R IY Z
CERTITUDE	S ER T AH T UW D
CERTITUDES	S ER T AH T UW D Z
CERULEAN	S AH R UW L IY AH N
CERULEANS	S AH R UW L IY AH N Z
CERULOPLASMIN	S AH R UW L AH P L AE Z M AH N
CERULOPLASMINS	S AH R UW L AH P L AE Z M AH N Z
CERUMEN	S AH R UW M AH N
CERUMENS	S AH R UW M AH N Z
CERUMINOUS	S AH R UW M AH N AH S
CERUSE	S AH R UW Z
CERUSES	S AH R UW Z AH Z
CERUSITE	S EH R AH S AY T
CERUSITES	S EH R AH S AY T S
CERUSSITE	S EH R AH S AY T
CERUSSITES	S EH R AH S AY T S
CERVELAS	S AH R V AH L AH Z
CERVELASES	S AH R V AH L EY Z AH Z
CERVELAT	S ER V AH L AE T
CERVELATS	S ER V AH L AE T S
CERVICAL	S ER V AH K AH L
CERVICAL(2)	S ER V IH K AH L
CERVICES	S AH R V AH S
CERVICITIS	S AH R V AH S AY T AH S
CERVICITISES	S AH R V IH S AH T AY Z AH Z
CERVID	S AH R V AH D
CERVINE	S AH R V AY N
CERVIX	S ER V IH K S
CERVIXES	S AH R V AH K S
CESAREAN	S AH S AE R IY AH N
CESAREANS	S EH S AH R IY N Z
CESARIAN	S IY Z EH R IY AH N
CESARIANS	S AH S AE R IY AH N Z
CESIUM	S IY Z IY AH M
CESIUMS	S IY S IY AH M Z
CESS	S EH S
CESSATION	S EH S EY SH AH N
CESSATIONS	S EH S EY SH AH N Z
CESSED	S EH S T
CESSES	S EH S AH Z
CESSING	S EH S AH NG
CESSION	S EH SH AH N
CESSIONS	S EH SH AH N Z
CESSPIT	S EH S AH T
CESSPITS	S EH S AH T S
CESSPOOL	S EH S P UW L
CESSPOOLS	S EH S UW L Z
CESTA	S EH S T AH
CESTAS	S EH S T AH Z
CESTI	S EH S T IY
CESTODE	S EH S T OW D
CESTODES	S EH S T OW D Z
CESTOI	S EH S T OY
CESTOID	S EH S T OY D
CESTOIDS	S EH S T OY D Z
CESTOS	S EH S T AH Z
CESTUS	S EH S T AH S
CESTUSES	S EH S T Y UW Z AH Z
CESURA	S EH S AH R AH
CESURAE	S EH S AH R IY
CESURAS	S EH S AH R AH Z
CETACEAN	S IH T EY SH AH N
CETACEAN(2)	S IY T EY SH AH N
CETACEANS	S EH T AH S IY N Z
CETACEOUS	S IY T AH S IY AH S
CETANE	S AH T EY N
CETANES	S AH T EY N Z
CETE	S IY T
CETES	S IY T S
CETOLOGIES	S AH T AA L AH JH AY Z
CETOLOGIST	S AH T AA L AH JH AH S T
CETOLOGISTS	S AH T AA L AH JH AH S T S
CETOLOGY	S AH T AA L AH JH IY
CEVICHE	S EH V AH CH
CEVICHES	S EH V AH CH AH Z
CHALCEDONIC	CH AE L S AH D AH N AH K
CHALCEDONIES	CH AE L S EH D AH N AY Z
CHALCEDONY	CH AE L S AH D OW N IY
CHALICE	CH AE L IH S
CHALICED	CH AE L AH S T
CHALICES	CH AE L AH S
CHANCE	CH AE N S
CHANCED	CH AE N S T
CHANCEFUL	CH AE N S F AH L
CHANCEL	CH AE N S AH L
CHANCELLERIES	CH AE N S AH L AH R IY Z
CHANCELLERY	CH AE N S AH L AH R IY
CHANCELLOR	CH AE N S AH L ER
CHANCELLOR(2)	CH AE N S L ER
CHANCELLORIES	CH AE N S AH L ER IY Z
CHANCELLORS	CH AE N S AH L ER Z
CHANCELLORSHIP	CH AE N S AH L ER SH IH P
CHANCELLORSHIPS	CH AE N S AH L ER SH IH P S
CHANCELLORY	CH AE N S AH L ER IY
CHANCELS	CH AE N S AH L Z
CHANCERIES	CH AE N S AH R IY Z
CHANCERY	CH AE N S ER IY
CHANCES	CH AE N S AH Z
CHANCES(2)	CH AE N S IH Z
CHATOYANCE	CH AE T OY AH N S
CHATOYANCES	CH AE T OY AE N S AH Z
CHELICERA	CH AH L IH S AH R AH
CHELICERAE	CH AH L IH S AH R IY
CHELICERAL	CH AH L IH S AH R AH L
CHEMILUMINESCENCE	K EH M AH L AH M AH N EH S AH N S
CHEMILUMINESCENCES	K EH M AH L AH M AH N AH S EH N S AH Z
CHEMILUMINESCENT	K EH M AH L AH M AH N EH S AH N T
CHEMORECEPTION	K AH M AO R AH S EH P AH N
CHEMORECEPTIONS	K EH M AH R AH S EH P T IY AH N Z
CHEMORECEPTIVE	K AH M AO R AH S EH P T AH V
CHEMORECEPTOR	K AH M AO R AH S EH P T AH R
CHEMORECEPTORS	K EH M AH R AH S EH P T AH R Z
CHICER	SH IY K ER
CHICEST	SH IY K AH S T
CHIMNEYPIECE	CH IH M N IY P IY S
CHIMNEYPIECES	CH IH M N IY P IY S IH Z
CHIROMANCER	CH IH R AH M AE N S AH R
CHIROMANCERS	CH IH R AH M AE N S AH R Z
CHOICE	CH OY S
CHOICELY	CH OY S L IY
CHOICENESS	CH OY S N AH S
CHOICENESSES	CH OY S N AH S IH Z
CHOICER	CH OY S ER
CHOICES	CH OY S AH Z
CHOICES(2)	CH OY S IH Z
CHOICEST	CH OY S AH S T
CHROMINANCE	K R OW M AH N AH N S
CHROMINANCES	K R AA M AH N AE N S AH Z
CHROMOCENTER	K R AA M AH S EH N T AH R
CHROMOCENTERS	K R AA M AH S EH N T AH R Z
CICATRICES	S AH K AE T R AH S
CICELIES	S IH S AH L AY Z
CICELY	S IH S AH L IY
CICERO	S IH S ER OW
CICERONE	S IH S ER OW N
CICERONES	S IH S AH R OW N Z
CICERONI	S AH S EH R AH N IY
CICEROS	S IH S AH R AH Z
CILICE	S IH L AH S
CILICES	S IH L AH S
CIMICES	S IH M AH S
CINQUECENTIST	S IH NG K W AH S EH N T AH S T
CINQUECENTISTI	S IH NG K W AH S AH N T IH S T IY
CINQUECENTISTS	S IH NG K W AH S EH N T AH S T S
CINQUECENTO	S IH NG K W AH S EH N T OW
CINQUECENTOS	S IH NG K W AH S EH N T AH Z
CIRCUMCENTER	S ER K AH M S EH N T ER
CIRCUMCENTERS	S ER K AH M S EH N T ER Z
CIRCUMFERENCE	S ER K AH M F R AH N S
CIRCUMFERENCES	S ER K AH M F R AH N S IH Z
CIRCUMJACENT	S AH R K AH M JH AH S AH N T
CIRCUMSTANCE	S ER K AH M S T AE N S
CIRCUMSTANCED	S ER K AH M S T AE N S T
CIRCUMSTANCES	S ER K AH M S T AE N S AH Z
CIRCUMSTANCES(2)	S ER K AH M S T AE N S IH Z
CLADOCERAN	K L AH D AA S AH R AH N
CLADOCERANS	K L AH D AA S AH R AH N Z
CLAIRAUDIENCE	K L AE AH R AO D IY AH N S
CLAIRAUDIENCES	K L AE AH R AO D IY EH N S AH Z
CLAIRVOYANCE	K L EH R V OY AH N S
CLAIRVOYANCES	K L AE ER V OY AH N S IH Z
CLARENCE	K L EH R AH N S
CLARENCES	K L AE R AH N S IH Z
CLEARANCE	K L IH R AH N S
CLEARANCES	K L IH R AH N S IH Z
COACERVATE	K OW AE S AH R V EY T
COACERVATES	K OW AE S AH R V EY T S
COACERVATION	K OW AE S AH R V EY SH AH N
COACERVATIONS	K OW AE S AH R V EY T IY AH N Z
COADJUTRICES	K OW AE JH AH T R AH S
COALESCE	K OW AH L EH S
COALESCED	K OW AH L EH S T
COALESCENCE	K OW AH L EH S AH N S
COALESCENCES	K OW AH L EH S AH N S IH Z
COALESCENT	K OW AH L EH S AH N T
COALESCES	K OW AH L EH S IH Z
COCKATRICE	K AA K AE T R AH S
COCKATRICES	K AA K AE T R AH S
CODEPENDENCE	K OW D IH P EH N D AH N S
CODEPENDENCES	K OW D IH P EH N D AH N S IH Z
CODICES	K OW D AY S IH Z
CODPIECE	K AA D P IY S
CODPIECES	K AA D P IY S IH Z
COERCE	K OW ER S
COERCED	K OW ER S T
COERCER	K OW ER S ER
COERCERS	K OW ER S ER Z
COERCES	K OW ER S IH Z
COEXISTENCE	K OW IH G Z IH S T AH N S
COEXISTENCES	K OW EH G Z IH S T AH N S IH Z
COFINANCE	K OW F AH N AE N S
COFINANCED	K OW F AH N AE N S T
COFINANCES	K OW F AH N AE N S IH Z
COGNIZANCE	K AA G N AH Z AH N S
COGNIZANCES	K AA G N AH Z AH N S IH Z
COGNOSCENTE	K AH N AA S AH N T
COGNOSCENTI	K AA G N AO SH EH N T IY
COHERENCE	K OW HH IH R AH N S
COHERENCES	K OW HH IH ER AH N S IH Z
COINCIDENCE	K OW IH N S IH D AH N S
COINCIDENCES	K OW IH N S AH D AH N S IH Z
COINSURANCE	K OW IH N SH ER AH N S
COINSURANCES	K OW IH N SH UH R AH N S IH Z
COMEUPPANCE	K AH M AH P AH N S
COMEUPPANCES	K AH M AH P AH N S IH Z
COMMENCE	K AH M EH N S
COMMENCED	K AH M EH N S T
COMMENCEMENT	K AH M EH N S M AH N T
COMMENCEMENTS	K AH M EH N S M AH N T S
COMMENCER	K AH M EH N S ER
COMMENCERS	K AH M EH N S ER Z
COMMENCES	K AH M EH N S AH Z
COMMERCE	K AA M ER S
COMMERCED	K AA M ER S T
COMMERCES	K AA M ER S IH Z
COMMONPLACE	K AA M AH N P L EY S
COMMONPLACENESS	K AA M AH N P L EY S N AH S
COMMONPLACENESSES	K AA M AH N P L EY S N AH S IH Z
COMMONPLACES	K AA M AH N P L EY S IH Z
COMPETENCE	K AA M P AH T IH N S
COMPETENCES	K AA M P AH T AH N S IH Z
COMPLACENCE	K AH M P L EY S AH N S
COMPLACENCES	K AH M P L EY S AH N S IH Z
COMPLACENCIES	K AH M P L EY S AH N S IY Z
COMPLACENCY	K AH M P L EY S AH N S IY
COMPLACENT	K AH M P L EY S AH N T
COMPLACENTLY	K AH M P L EY S AH N T L IY
COMPLAISANCE	K AH M P L EY S AH N S
COMPLAISANCES	K AH M P L EY S AH N S IH Z
COMPLIANCE	K AH M P L AY AH N S
COMPLIANCES	K AH M P L AY AH N S IH Z
COMPLICE	K AA M P L AH S
COMPLICES	K AA M P L AH S
CONCEAL	K AH N S IY L
CONCEALABLE	K AH N S IY L AH B AH L
CONCEALED	K AH N S IY L D
CONCEALER	K AH N S IY L ER
CONCEALERS	K AH N S IY L ER Z
CONCEALING	K AH N S IY L IH NG
CONCEALINGLY	K AH N S IY L IH NG L IY
CONCEALMENT	K AH N S IY L M AH N T
CONCEALMENTS	K AH N S IY L M AH N T S
CONCEALS	K AH N S IY L Z
CONCEDE	K AH N S IY D
CONCEDED	K AH N S IY D IH D
CONCEDEDLY	K AH N S IY D AH D L IY
CONCEDER	K AH N S IY D ER
CONCEDERS	K AH N S IY D ER Z
CONCEDES	K AH N S IY D Z
CONCEDING	K AH N S IY D IH NG
CONCEIT	K AH N S IY T
CONCEITED	K AH N S IY T AH D
CONCEITEDLY	K AH N S IY T AH D L IY
CONCEITEDNESS	K AH N S IY T AH D N AH S
CONCEITEDNESSES	K AH N S IY T AH D N AH S IH Z
CONCEITING	K AH N S IY T IH NG
CONCEITS	K AH N S IY T S
CONCEIVABILITIES	K AH N S IY V AH B IH L AH T EH Z
CONCEIVABILITY	K AH N S IY V AH B IH L AH T EH
CONCEIVABLE	K AH N S IY V AH B AH L
CONCEIVABLENESS	K AH N S IY V AH B AH L N AH S
CONCEIVABLENESSES	K AH N S IY V AH B AH L N AH S IH Z
CONCEIVABLY	K AH N S IY V AH B L IY
CONCEIVE	K AH N S IY V
CONCEIVED	K AH N S IY V D
CONCEIVER	K AH N S IY V ER
CONCEIVERS	K AH N S IY V ER Z
CONCEIVES	K AH N S IY V Z
CONCEIVING	K AH N S IY V IH NG
CONCELEBRANT	K AH N S EH L AH B R AH N T
CONCELEBRANTS	K AH N S EH L AH B R AH N T S
CONCELEBRATE	K AH N S EH L AH B R AH T
CONCELEBRATED	K AH N S EH L AH B R EY T IH D
CONCELEBRATES	K AH N S EH L AH B R AH T S
CONCELEBRATING	K AH N S EH L AH B R EY T IH NG
CONCELEBRATION	K AH N S EH L AH B R EY SH AH N
CONCELEBRATIONS	K AH N S EH L AH B R EY SH AH N Z
CONCENT	K AH N S EH N T
CONCENTER	K AH N S EH N T ER
CONCENTERED	K AH N S EH N T ER D
CONCENTERING	K AH N S EH N T ER IH NG
CONCENTERS	K AH N S EH N T ER Z
CONCENTRATE	K AA N S AH N T R EY T
CONCENTRATED	K AA N S AH N T R EY T AH D
CONCENTRATED(2)	K AO N S AH N T R EY T IH D
CONCENTRATEDLY	K AA N S AH N T R EY T AH D L IY
CONCENTRATES	K AA N S AH N T R EY T S
CONCENTRATING	K AA N S AH N T R EY T IH NG
CONCENTRATION	K AA N S AH N T R EY SH AH N
CONCENTRATIONS	K AA N S AH N T R EY SH AH N Z
CONCENTRATIVE	K AA N S AH N T R EY T IH V
CONCENTRATOR	K AA N S AH N T R EY T ER
CONCENTRATORS	K AA N S AH N T R EY T ER Z
CONCENTRIC	K AH N S EH N T R IH K
CONCENTRICALLY	K AH N S EH N T R IH K AH L IY
CONCENTRICITIES	K AH N S EH N T R IH K AH T IY Z
CONCENTRICITY	K AH N S EH N T R IH K AH T IY
CONCENTS	K AH N S EH N T S
CONCEPT	K AA N S EH P T
CONCEPTACLE	K AA N S EH P T AH K AH L
CONCEPTACLES	K AA N S EH P T AH K AH L Z
CONCEPTION	K AH N S EH P SH AH N
CONCEPTIONAL	K AA N S EH P SH AH N AH L
CONCEPTIONS	K AH N S EH P SH AH N Z
CONCEPTIVE	K AA N S EH P T IH V
CONCEPTS	K AA N S EH P T S
CONCEPTS(2)	K AA N S EH P S
CONCEPTUAL	K AH N S EH P CH UW AH L
CONCEPTUALISE	K AA N S EH P T Y UW AH L AY Z
CONCEPTUALISED	K AH N S EH P CH AH W AH L IY Z D
CONCEPTUALISES	K AH N S EH P CH AH W AH L IY Z IH Z
CONCEPTUALISING	K AH N S EH P CH AH W AH L IY Z IH NG
CONCEPTUALISM	K AH N S EH P CH AH W AH L IH Z AH M
CONCEPTUALISMS	K AH N S EH P CH AH W AH L IH Z AH M Z
CONCEPTUALIST	K AH N S EH P CH AH W AH L IH S T
CONCEPTUALISTIC	K AH N S EH P CH AH W AH L IH S T IH K
CONCEPTUALISTICALLY	K AH N S EH P CH AH W AH L IH S T IH K AH L IY
CONCEPTUALISTS	K AH N S EH P CH AH W AH L IH S T S
CONCEPTUALITIES	K AH N S EH P CH AH W AH L AH T IY Z
CONCEPTUALITY	K AH N S EH P CH AH W AH L AH T IY
CONCEPTUALIZATION	K AH N S EH P CH W AH L IH Z EY SH AH N
CONCEPTUALIZATIONS	K AH N S EH P CH AH W AH L AH Z EY SH AH N Z
CONCEPTUALIZE	K AH N S EH P CH AH W AH L AY Z
CONCEPTUALIZED	K AH N S EH P CH AH W AH L AY Z D
CONCEPTUALIZER	K AH N S EH P CH AH W AH L AY Z ER
CONCEPTUALIZERS	K AH N S EH P CH AH W AH L AY Z ER Z
CONCEPTUALIZES	K AH N S EH P CH AH W AH L AY Z IH Z
CONCEPTUALIZING	K AH N S EH P CH AH W AH L AY Z IH NG
CONCEPTUALLY	K AH N S EH P CH UW AH L IY
CONCEPTUS	K AA N S EH P T AH S
CONCEPTUSES	K AA N S EH P T Y UW S IH Z
CONCERN	K AH N S ER N
CONCERNED	K AH N S ER N D
CONCERNING	K AH N S ER N IH NG
CONCERNMENT	K AH N S ER N M AH N T
CONCERNMENTS	K AH N S ER N M AH N T S
CONCERNS	K AH N S ER N Z
CONCERT	K AA N S ER T
CONCERT(2)	K AH N S ER T
CONCERTED	K AH N S ER T AH D
CONCERTED(2)	K AH N S ER T IH D
CONCERTEDLY	K AH N S ER T AH D L IY
CONCERTEDNESS	K AH N S ER T AH D N AH S
CONCERTEDNESSES	K AH N S ER T AH D N AH S IH Z
CONCERTGOER	K AH N S ER T G OW ER
CONCERTGOERS	K AH N S ER T G OW ER Z
CONCERTGOING	K AH N S ER T G OW IH NG
CONCERTGOINGS	K AH N S ER T G OW IH NG Z
CONCERTI	K AH N CH EH R T IY
CONCERTINA	K AA N S ER T IY N AH
CONCERTINAS	K AA N S ER T IY N AH Z
CONCERTING	K AH N S ER T IH NG
CONCERTINI	K AA N S AH R T AH N IY
CONCERTINO	K AA N S AH R T AH N OW
CONCERTINOS	K AH N S ER T IH N AA S
CONCERTIZE	K AH N S ER T AY Z
CONCERTIZED	K AH N S ER T AY Z D
CONCERTIZES	K AH N S ER T AY Z IH Z
CONCERTIZING	K AH N S ER T AY Z IH NG
CONCERTMASTER	K AA N S ER T M AE S T ER
CONCERTMASTERS	K AH N S ER T M AE S T ER Z
CONCERTMEISTER	K AA N S AH R T M IY S T AH R
CONCERTMEISTERS	K AA N S AH R T M IY S T AH R Z
CONCERTO	K AH N CH EH R T OW
CONCERTOS	K AH N CH EH R T OW Z
CONCERTS	K AA N S ER T S
CONCERTS(2)	K AH N S ER T S
CONCESSION	K AH N S EH SH AH N
CONCESSIONAIRE	K AH N S EH SH AH N EH R
CONCESSIONAIRES	K AH N S EH SH AH N EH R Z
CONCESSIONAL	K AH N S EH SH AH N AH L
CONCESSIONARY	K AH N S EH SH AH N EH R IY
CONCESSIONER	K AH N S EH SH AH N ER
CONCESSIONERS	K AH N S EH SH AH N ER Z
CONCESSIONS	K AH N S EH SH AH N Z
CONCESSIVE	K AH N S EH S IH V
CONCESSIVELY	K AH N S EH S IH V L IY
CONCOMITANCE	K AH N K OW M AY T AH N S
CONCOMITANCES	K AH N K OW M AY T AH N S IH Z
CONCORDANCE	K AH N K AO R D AH N S
CONCORDANCES	K AH N K AO R D AH N S IH Z
CONCRESCENCE	K AH N K R EH S AH N S
CONCRESCENCES	K AH N K R EH S AH N S IH Z
CONCRESCENT	K AH N K R EH S AH N T
CONCUPISCENCE	K AA N K Y AH P IH S AH N S
CONCUPISCENCES	K AA N K Y AH P IH S EH N S AH Z
CONCUPISCENT	K AH N K AH P IY Z S EH N T
CONCURRENCE	K AH N K ER AH N S
CONCURRENCES	K AH N K ER AH N S IH Z
CONDESCEND	K AA N D IH S EH N D
CONDESCENDED	K AA N D IH S EH N D IH D
CONDESCENDENCE	K AA N D IH S EH N D AH N S
CONDESCENDENCES	K AA N D IH S EH N D AH N S IH Z
CONDESCENDING	K AA N D IH S EH N D IH NG
CONDESCENDINGLY	K AA N D IH S EH N D IH NG L IY
CONDESCENDS	K AA N D IH S EH N D Z
CONDESCENSION	K AA N D AH S EH N SH AH N
CONDESCENSIONS	K AA N D IH S EH N CH AH N Z
CONDOLENCE	K AH N D OW L AH N S
CONDOLENCES	K AH N D OW L AH N S AH Z
CONDUCE	K AH N D UW S
CONDUCED	K AH N D UW S T
CONDUCER	K AH N D UW S ER
CONDUCERS	K AH N D UW S ER Z
CONDUCES	K AH N D UW S IH Z
CONDUCTANCE	K AA N D AH K T AH N S
CONDUCTANCES	K AA N D AH K T AH N S IH Z
CONFERENCE	K AA N F ER AH N S
CONFERENCE(2)	K AA N F R AH N S
CONFERENCES	K AA N F ER AH N S AH Z
CONFERENCES(2)	K AA N F R AH N S AH Z
CONFERRENCE	K AH N F ER AH N S
CONFERRENCES	K AH N F ER AH N S IH Z
CONFIDENCE	K AA N F AH D EH N S
CONFIDENCES	K AA N F AH D EH N S IH Z
CONFLUENCE	K AA N F L UW AH N S
CONFLUENCES	K AH N F L UW AH N S IH Z
CONFORMANCE	K AH N F AO R M AH N S
CONFORMANCES	K AH N F AO R M AH N S IH Z
CONGRUENCE	K AO N G R UW AH N S
CONGRUENCES	K AH N G R UW AH N S IH Z
CONNIVANCE	K AH N AY V AH N S
CONNIVANCES	K AH N AY V AH N S IH Z
CONSCIENCE	K AA N SH AH N S
CONSCIENCELESS	K AA N CH AH N S L AH S
CONSCIENCES	K AA N CH IH N S IH Z
CONSEQUENCE	K AA N S AH K W AH N S
CONSEQUENCES	K AA N S AH K W EH N S AH Z
CONSISTENCE	K AH N S IH S T AH N S
CONSISTENCES	K AH N S IH S T AH N S IH Z
CONSONANCE	K AA N S AH N AH N S
CONSONANCES	K AA N S AH N AH N S IH Z
CONTINENCE	K AA N T AH N AH N S
CONTINENCES	K AA N T AH N AH N S IH Z
CONTINGENCE	K AH N T IH N JH AH N S
CONTINGENCES	K AH N T IH N JH AH N S IH Z
CONTINUANCE	K AH N T IH N Y UW AH N S
CONTINUANCES	K AH N T IH N Y UW AH N S IH Z
CONTRACEPTION	K AA N T R AH S EH P SH AH N
CONTRACEPTIONS	K AA N T R AH S EH P SH AH N Z
CONTRACEPTIVE	K AA N T R AH S EH P T IH V
CONTRACEPTIVES	K AA N T R AH S EH P T IH V Z
CONTRIVANCE	K AH N T R AY V AH N S
CONTRIVANCES	K AH N T R AY V AH N S IH Z
CONVALESCE	K AA N V AH L EH S
CONVALESCED	K AA N V AH L EH S T
CONVALESCENCE	K AA N V AH L EH S AH N S
CONVALESCENCES	K AA N V AH L EH S AH N S IH Z
CONVALESCENT	K AA N V AH L EH S AH N T
CONVALESCENTS	K AA N V AH L EH S AH N T S
CONVALESCES	K AA N V AH L EH S IH Z
CONVENIENCE	K AH N V IY N Y AH N S
CONVENIENCES	K AH N V IY N Y AH N S IH Z
CONVERGENCE	K AH N V ER JH AH N S
CONVERGENCES	K AH N V ER JH AH N S IH Z
CONVERSANCE	K AH N V ER S AH N S
CONVERSANCES	K AH N V ER S AH N S IH Z
CONVEYANCE	K AH N V EY AH N S
CONVEYANCER	K AH N V EY AH N S ER
CONVEYANCERS	K AH N V EY AH N S ER Z
CONVEYANCES	K AH N V EY AH N S IH Z
CONVINCE	K AH N V IH N S
CONVINCED	K AH N V IH N S T
CONVINCER	K AH N V IH N S ER
CONVINCERS	K AH N V IH N S ER Z
CONVINCES	K AH N V IH N S IH Z
COPACETIC	K OW P AE S AH T AH K
COPARCENARIES	K AA P AA R K AH N EH R IY Z
COPARCENARY	K AA P AA R K AH N EH R IY
COPARCENER	K AA P AA R K AH N ER
COPARCENERS	K AA P AA R K AH N ER Z
COPPICE	K AA P AH S
COPPICED	K AA P IH K S K T
COPPICES	K AA P IH K S IH Z
COPRINCE	K OW P R IH N S
COPRINCES	K OW P R IH N S IH Z
COPROCESSING	K OW P R AA S EH S IH NG
COPROCESSINGS	K OW P R AA S EH S IH NG Z
COPROCESSOR	K OW P R AA S EH S ER
COPROCESSORS	K OW P R AA S EH S ER Z
COPRODUCE	K OW P R AH D UW S
COPRODUCED	K OW P R AH D UW S T
COPRODUCER	K OW P R AH D UW S ER
COPRODUCERS	K OW P R AH D UW S ER Z
COPRODUCES	K OW P R AH D UW S IH Z
CORIACEOUS	K OW R AY AH S IY AH S
CORNICE	K AO R N AY S
CORNICED	K AO R N IH K S T
CORNICES	K AO R N IH K S IH Z
CORPULENCE	K AO R P Y AH L AH N S
CORPULENCES	K AO R P Y AH L AH N S IH Z
CORRESPONDENCE	K AO R AH S P AA N D AH N S
CORRESPONDENCES	K AO R AH S P AA N D AH N S IH Z
CORTICES	K AO R T AH S
COTRANSDUCE	K OW T R AE N S D UW S
COTRANSDUCED	K OW T R AE N S D UW S T
COTRANSDUCES	K OW T R AE N S D UW S IH Z
COUNTENANCE	K AW N T AH N AH N S
COUNTENANCED	K AW N T AH N AH N S T
COUNTENANCER	K AW N T AH N AH N S ER
COUNTENANCERS	K AW N T AH N AH N S ER Z
COUNTENANCES	K AW N T AH N AH N S IH Z
COUNTERBALANCE	K AW N T ER B AE L AH N S
COUNTERBALANCE(2)	K AW N ER B AE L AH N S
COUNTERBALANCED	K AW N T ER B AE L AH N S T
COUNTERBALANCED(2)	K AW N ER B AE L AH N S T
COUNTERBALANCES	K AW N T ER B AE L AH N S IH Z
COUNTERBALANCES(2)	K AW N ER B AE L AH N S IH Z
COUNTEREVIDENCE	K AW N T ER EH V AH D AH N S
COUNTEREVIDENCES	K AW N T ER EH V AH D AH N S IH Z
COUNTERFORCE	K AW N T ER F AO R S
COUNTERFORCES	K AW N T ER F AO R S IH Z
COUNTERINCENTIVE	K AW N T ER IH N S EH N T IH V
COUNTERINCENTIVES	K AW N T ER IH N S EH N T IH V Z
COUNTERINFLUENCE	K AW N T ER IH N F L UW AH N S
COUNTERINFLUENCED	K AW N T ER IH N F L UW AH N S T
COUNTERINFLUENCES	K AW N T ER IH N F L UW AH N S IH Z
COUNTERINSTANCE	K AW N T ER IH N S T AH N S
COUNTERINSTANCES	K AW N T ER IH N S T AH N S IH Z
COUNTERINTELLIGENCE	K AW N T ER IH N T EH L IH JH AH N S
COUNTERINTELLIGENCE(2)	K AW N ER IH N T EH L IH JH AH N S
COUNTERINTELLIGENCES	K AW N T ER IH N T EH L AH JH AH N S IH Z
COUNTERSURVEILLANCE	K AW N T ER S ER V EY L AH N S
COUNTERSURVEILLANCES	K AW N T ER S ER V EY L AH N S IH Z
COUNTERTRANSFERENCE	K AW N T ER T R AE N S F ER AH N S
COUNTERTRANSFERENCES	K AW N T ER T R AE N S F ER AH N S IH Z
COUNTERVIOLENCE	K AW N T ER V AY AH L AH N S
COUNTERVIOLENCES	K AW N T ER V AY AH L AH N S IH Z
COVALENCE	K OW V EY L AH N S
COVALENCES	K OW V EY L AH N S IH Z
COVARIANCE	K OW V EH R IY AH N S
COVARIANCES	K OW V EH R IY AH N S IH Z
COWARDICE	K AW ER D AH S
COWARDICES	K AW ER D AH S IH Z
CRANIOCEREBRAL	K R EY N IY AA S AH R EH B R AH L
CRAWLSPACE	K R AO L S P EY S
CRAWLSPACES	K R AO L S P EY S IH Z
CREDENCE	K R IY D AH N S
CREDENCES	K R EH D AH N S IH Z
CRESCENDI	K R EH S EH N D IY
CRESCENDO	K R IH SH EH N D OW
CRESCENDOED	K R IH SH EH N D OW D
CRESCENDOES	K R IH SH EH N D OW Z
CRESCENDOING	K R IH SH EH N D OW IH NG
CRESCENDOS	K R IH SH EH N D OW Z
CRESCENT	K R EH S AH N T
CRESCENTIC	K R EH S AH N T IH K
CRESCENTS	K R EH S AH N T S
CREVICE	K R EH V AH S
CREVICED	K R EH V AH S T
CREVICES	K R EH V AH S IH Z
CRICETID	K R IH S AH T AH D
CRICETIDS	K R IH S AH T AH D Z
CROCEIN	K R OW S IY N
CROCEINE	K R OW S IY N
CROCEINES	K R OW S IY N Z
CROCEINS	K R OW S IY N Z
CROSSPIECE	K R AO S P IY S
CROSSPIECES	K R AO S P IY S AH Z
CROSSPIECES(2)	K R AO S P IY S IH Z
CRUCES	K R UW S IY Z
CRUSTACEA	K R AH S T EY S IY AH
CRUSTACEAN	K R AH S T EY SH AH N
CRUSTACEANS	K R AH S T EY SH AH N Z
CRUSTACEOUS	K R AH S T EY SH AH S
CULICES	K Y UW L AH S
CURVACEOUS	K ER V EY SH AH S
CYBERSPACE	S AY B ER S P EY S
CYBERSPACES	S AH B AH R S AH S AH Z
CYLICES	S AY L AH S
CYSTICERCI	S IH S T AH S AH R S IY
CYSTICERCOID	S IH S T IH S AH R K OY D
CYSTICERCOIDS	S IH S T IH S AH R K OY D Z
CYSTICERCOSES	S IH S T IH S AH R K OW Z AH Z
CYSTICERCOSIS	S IH S T IH K S ER K OW Z IY Z
CYSTICERCUS	S IH S T AH S AH R K AH S
DACE	D EY S
DACES	D EY S AH Z
DALLIANCE	D AE L IY AH N S
DALLIANCES	D AE L AY AE N S AH Z
DAMASCENE	D AE M AH S IY N
DAMASCENED	D AE M AH S IY N D
DAMASCENES	D AE M AH S IY N Z
DAMASCENING	D AE M AH S IY N IH NG
DANCE	D AE N S
DANCEABLE	D AE N S AH B AH L
DANCED	D AE N S T
DANCER	D AE N S ER
DANCERS	D AE N S ER Z
DANCES	D AE N S AH Z
DANCES(2)	D AE N S IH Z
DECADENCE	D EH K AH D AH N S
DECADENCES	D EH K AH D AH N S IH Z
DECEASE	D IH S IY S
DECEASED	D IH S IY S T
DECEASES	D IY S IY S IH Z
DECEASING	D IY S IY S IH NG
DECEDENT	D EH S IY D AH N T
DECEDENTS	D EH S IY D AH N T S
DECEIT	D IH S IY T
DECEITFUL	D IH S IY T F AH L
DECEITFULLY	D AH S IY T F AH L IY
DECEITFULNESS	D AH S IY T F AH L N AH S
DECEITFULNESSES	D AH S IY T F AH L N AH S IH Z
DECEITS	D IH S IY T S
DECEIVABLE	D IH S IY V AH B AH L
DECEIVE	D IH S IY V
DECEIVED	D IH S IY V D
DECEIVER	D IH S IY V ER
DECEIVERS	D IH S IY V ER Z
DECEIVES	D IH S IY V Z
DECEIVING	D IH S IY V IH NG
DECEIVINGLY	D IH S IY V IH NG L IY
DECELERATE	D IH S EH L ER EY T
DECELERATED	D IH S EH L ER EY T IH D
DECELERATES	D IY S EH L AH R EY T S
DECELERATING	D IH S EH L ER EY T IH NG
DECELERATION	D IH S EH L ER EY SH AH N
DECELERATIONS	D IY S EH L AH R EY SH AH N Z
DECELERATOR	D IY S EH L AH R EY T ER
DECELERATORS	D IY S EH L AH R EY T ER Z
DECEMVIR	D AH S EH M V AH R
DECEMVIRAL	D AH S EH M V AH R AH L
DECEMVIRATE	D AH S EH M V AH R EY T
DECEMVIRATES	D AH S EH M V AH R EY T S
DECEMVIRI	D AH S EH M V AH R IY
DECEMVIRS	D AH S EH M V AH R Z
DECENARIES	D IY S AH N EH R IY Z
DECENARY	D IY S AH N EH R IY
DECENCIES	D IY S AH N S IY Z
DECENCY	D IY S AH N S IY
DECENNIA	D AH S EH N IY AH
DECENNIAL	D AH S EH N IY AH L
DECENNIALLY	D IY S AH N IY AH L IY
DECENNIALS	D IY S AH N IY AH L Z
DECENNIUM	D AH S EH N IY AH M
DECENNIUMS	D AH S EH N IY AH M Z
DECENT	D IY S AH N T
DECENTER	D IY S EH N T ER
DECENTERED	D IY S EH N T ER D
DECENTERING	D IY S EH N T ER IH NG
DECENTERS	D IY S EH N T ER Z
DECENTEST	D IY S AH N T AH S T
DECENTLY	D IY S AH N T L IY
DECENTRALIZATION	D IH S EH N T R AH L IH Z EY SH AH N
DECENTRALIZATIONS	D IY S EH N T R AH L AH Z EY SH AH N Z
DECENTRALIZE	D IH S EH N T R AH L AY Z
DECENTRALIZED	D IH S EH N T R AH L AY Z D
DECENTRALIZES	D IY S EH N T R AH L AY Z IH Z
DECENTRALIZING	D IH S EH N T R AH L AY Z IH NG
DECENTRE	D IY S EH N T ER
DECENTRED	D IY S EH N T ER D
DECENTRES	D IY S EH N T ER Z
DECENTRING	D IY S EH N T ER IH NG
DECEPTION	D IH S EH P SH AH N
DECEPTIONAL	D IH S EH P SH AH N AH L
DECEPTIONS	D IH S EH P SH AH N Z
DECEPTIVE	D IH S EH P T IH V
DECEPTIVELY	D IH S EH P T IH V L IY
DECEPTIVENESS	D IH S EH P T IH V N AH S
DECEPTIVENESSES	D IH S EH P T IH V N AH S IH Z
DECEREBRATE	D IY S EH R AH B R AH T
DECEREBRATED	D IY S EH R AH B R EY T IH D
DECEREBRATES	D IY S EH R AH B R AH T S
DECEREBRATING	D IY S EH R AH B R EY T IH NG
DECEREBRATION	D IY S EH R AH B R EY SH AH N
DECEREBRATIONS	D IY S EH R AH B R EY SH AH N Z
DECERN	D AH S AH R N
DECERNED	D AH S AH R N D
DECERNING	D AH S AH R N AH NG
DECERNS	D AH S AH R N Z
DECERTIFICATION	D IY S ER T AH F AH K EY SH AH N
DECERTIFICATIONS	D IY S ER T AH F AH K EY SH AH N Z
DECERTIFIED	D IY S ER T AH F AY D
DECERTIFIES	D IY S ER T AH F AY Z
DECERTIFY	D IY S ER T AH F AY
DECERTIFYING	D IY S ER T AH F AY IH NG
DECONCENTRATE	D IY K AA N S AH N T R EY T
DECONCENTRATED	D IY K AA N S AH N T R EY T IH D
DECONCENTRATES	D IY K AA N S AH N T R EY T S
DECONCENTRATING	D IY K AA N S AH N T R EY T IH NG
DECONCENTRATION	D IY K AA N S AH N T R EY SH AH N
DECONCENTRATIONS	D IY K AA N S AH N T R EY SH AH N Z
DECRESCENDO	D IY K R IH SH EH N D OW
DECRESCENDOS	D IY K R IH SH EH N D OW Z
DECRESCENT	D IY K R EH S AH N T
DEDUCE	D IH D UW S
DEDUCED	D IH D UW S T
DEDUCES	D IH D UW S IH Z
DEFACE	D IH F EY S
DEFACED	D IH F EY S T
DEFACEMENT	D IY F EY S M AH N T
DEFACEMENTS	D IY F EY S M AH N T S
DEFACER	D IY F EY S ER
DEFACERS	D IY F EY S ER Z
DEFACES	D IY F EY S IH Z
DEFEASANCE	D IH F IY Z AH N S
DEFEASANCES	D IY F IY Z AH N S IH Z
DEFENCE	D IH F EH N S
DEFENCEMAN	D IY F EH N S M AE N
DEFENCEMEN	D IY F EH N S M EH N
DEFENCES	D IY F EH N S IH Z
DEFERENCE	D EH F ER AH N S
DEFERENCE(2)	D EH F R AH N S
DEFERENCES	D EH F AH R AH N S IH Z
DEFERVESCENCE	D AH F AH R V EH S AH N S
DEFERVESCENCES	D AH F AH R V AH S EH N S AH Z
DEFIANCE	D IH F AY AH N S
DEFIANCES	D IH F AY AH N S IH Z
DEFORCE	D IY F OW R S
DEFORCED	D IY F OW R S T
DEFORCEMENT	D IY F OW R S M AH N T
DEFORCEMENTS	D IY F OW R S M AH N T S
DEFORCES	D IY F OW R S IH Z
DEHISCE	D AH HH IH S
DEHISCED	D AH HH IH S T
DEHISCENCE	D AH HH IH S AH N S
DEHISCENCES	D AH HH IH S EH N S AH Z
DEHISCENT	D AH HH IH S AH N T
DEHISCES	D AH HH IH S AH Z
DEICE	D IY AY S
DEICED	D IY AY S T
DEICER	D IY AY S ER
DEICERS	D IY AY S ER Z
DEICES	D IY AY S IH Z
DELIQUESCE	D IH L AH K EH S
DELIQUESCED	D IH L AH K EH S T
DELIQUESCENCE	D IH L AH K EH S AH N S
DELIQUESCENCES	D IH L AH K AH S EH N S AH Z
DELIQUESCENT	D IH L AH K EH S AH N T
DELIQUESCES	D IH L AH K EH S AH Z
DELIVERANCE	D IH L IH V ER AH N S
DELIVERANCE(2)	D IH L IH V R AH N S
DELIVERANCES	D IH L IH V ER AH N S IH Z
DEMULCENT	D AH M UH L S AH N T
DEMULCENTS	D AH M UH L S AH N T S
DENOUNCE	D IH N AW N S
DENOUNCED	D IH N AW N S T
DENOUNCEMENT	D IH N AW N S M AH N T
DENOUNCEMENTS	D IH N AW N S M AH N T S
DENOUNCER	D IH N AW N S ER
DENOUNCERS	D IH N AW N S ER Z
DENOUNCES	D IH N AW N S IH Z
DENTIFRICE	D IH N T IH F R AH S
DENTIFRICES	D IH N T IH F R AH S
DEPENDANCE	D IY P EH N D AE N S
DEPENDANCES	D IY P EH N D AE N S IH Z
DEPENDENCE	D IH P EH N D AH N S
DEPENDENCES	D IH P EH N D AH N S IH Z
DESCEND	D IH S EH N D
DESCENDANT	D IH S EH N D AH N T
DESCENDANTS	D IH S EH N D AH N T S
DESCENDANTS(2)	D IH S EH N IH N T S
DESCENDED	D IH S EH N D AH D
DESCENDED(2)	D IH S EH N D IH D
DESCENDENT	D IH S EH N D AH N T
DESCENDENTS	D IH S EH N D AH N T S
DESCENDER	D IH S EH N D ER
DESCENDERS	D IH S EH N D ER Z
DESCENDIBLE	D IH S EH N D AH B AH L
DESCENDING	D IH S EH N D IH NG
DESCENDS	D IH S EH N D Z
DESCENSION	D IH S EH N Z IY AH N
DESCENSIONS	D IH S EH N S IY AH N Z
DESCENT	D IH S EH N T
DESCENTS	D IH S EH N T S
DESISTANCE	D IH S IH S T AH N S
DESISTANCES	D IH S IH S T AH N S IH Z
DESPONDENCE	D IH S P AA N D AH N S
DESPONDENCES	D IH S P AA N D AH N S IH Z
DETERRENCE	D IH T ER AH N S
DETERRENCES	D IY T EH R AH N S IH Z
DETUMESCENCE	D IH T Y AH M EH S AH N S
DETUMESCENCES	D IH T Y AH M AH S EH N S AH Z
DETUMESCENT	D IH T Y AH M EH S AH N T
DEUCE	D UW S
DEUCED	D IY Y UW S T
DEUCEDLY	D IY Y AH S EH D L IY
DEUCES	D IY Y UW S AH Z
DEVIANCE	D IY V IY AH N S
DEVIANCES	D IY V IY AH N S IH Z
DEVICE	D IH V AY S
DEVICES	D IH V AY S AH Z
DEVICES(2)	D IH V AY S IH Z
DEVOICE	D IY V OY S
DEVOICED	D IY V OY S T
DEVOICES	D IY V OY S IH Z
DEZINCED	D IY Z IH NG K T
DIACETYL	D AY AE S AH T AH L
DIACETYLS	D AY AE S AH T AH L Z
DIATOMACEOUS	D AY AH T AA M EY S AH S
DICE	D AY S
DICED	D AY S T
DICENTRA	D AH S EH N T R AH
DICENTRAS	D AH S EH N T R AH Z
DICENTRIC	D IH S AH N T R AH K
DICENTRICS	D AH S EH N T R AH S Z
DICER	D AY S ER
DICERS	D AY S ER Z
DICES	D AY S IH Z
DICEY	D AY S IY
DIENCEPHALA	D IY N S EH F AH L AH
DIENCEPHALIC	D IY N S AH F AH L AH K
DIENCEPHALON	D IY N S EH F AH L AH N
DIENCEPHALONS	D IY N S EH F AH L AH N Z
DIFFERENCE	D IH F ER AH N S
DIFFERENCE(2)	D IH F R AH N S
DIFFERENCED	D IH F ER AH N S T
DIFFERENCES	D IH F ER AH N S IH Z
DIFFERENCES(2)	D IH F R AH N S AH Z
DIFFIDENCE	D IH F AH D AH N S
DIFFIDENCES	D IH F AH D AH N S IH Z
DIGLYCERIDE	D IH G L IH S AH R AY D
DIGLYCERIDES	D IH G L IH S AH R AY D Z
DIHYDROXYACETONE	D AH HH AH D R AH K S AY AE S AH T OW N
DIHYDROXYACETONES	D AH HH AH D R AH K S AY AE S AH T OW N Z
DILIGENCE	D IH L IH JH AH N S
DILIGENCES	D IH L AH JH AH N S IH Z
DIOCESAN	D AY AA S AH S AH N
DIOCESANS	D AY AE S AH S AH N Z
DIOCESE	D AY AH S IY Z
DIOCESE(2)	D AY AH S AH S
DIOCESES	D AY AH S IY Z
DIOCESES(2)	D AY AH S IY Z AH Z
DIRECTRICE	D AH R EH K T R AY S
DIRECTRICES	D AH R EH K T R AY S IH Z
DISAFFIRMANCE	D IH S AH F ER M AH N S
DISAFFIRMANCES	D IH S AH F ER M AH N S IH Z
DISALLOWANCE	D IH S AH L AW AH N S
DISALLOWANCES	D IH S AH L AW AH N S IH Z
DISAPPEARANCE	D IH S AH P IH R AH N S
DISAPPEARANCE(2)	D IH S AH P IY R AH N S
DISAPPEARANCES	D IH S AH P IH R AH N S IH Z
DISAPPEARANCES(2)	D IH S AH P IY R AH N S IH Z
DISCALCED	D IH S AE L S T
DISCED	D IH S K T
DISCEPT	D IH S EH P T
DISCEPTED	D IH S EH P T AH D
DISCEPTING	D IH S EH P T AH NG
DISCEPTS	D IH S EH P T S
DISCERN	D IH S ER N
DISCERNABLE	D IH S ER N AH B AH L
DISCERNED	D IH S ER N D
DISCERNER	D IH S ER N ER
DISCERNERS	D IH S ER N ER Z
DISCERNIBLE	D IH S ER N AH B AH L
DISCERNIBLY	D IH S ER N AH B L IY
DISCERNING	D IH S ER N IH NG
DISCERNINGLY	D IH S ER N IH NG L IY
DISCERNMENT	D IH S ER N M AH N T
DISCERNMENTS	D IH S ER N M AH N T S
DISCERNS	D IH S ER N Z
DISCONCERT	D IH S K AH N S ER T
DISCONCERTED	D IH S K AH N S ER T IH D
DISCONCERTING	D IH S K AH N S ER T IH NG
DISCONCERTINGLY	D IH S K AH N S ER T IH NG L IY
DISCONCERTMENT	D IH S K AH N S ER T M AH N T
DISCONCERTMENTS	D IH S K AH N S ER T M AH N T S
DISCONCERTS	D IH S K AH N S ER T S
DISCONTINUANCE	D IH S K AH N T IH N Y UW AH N S
DISCONTINUANCES	D IH S K AH N T IH N Y UW AH N S IH Z
DISCORDANCE	D IH S K AO R D AH N S
DISCORDANCES	D IH S K AO R D AH N S IH Z
DISCOUNTENANCE	D IH S K AW N T AH N AH N S
DISCOUNTENANCED	D IH S K AW N T AH N AH N S T
DISCOUNTENANCES	D IH S K AW N T AH N AH N S IH Z
DISGRACE	D IH S G R EY S
DISGRACED	D IH S G R EY S T
DISGRACEFUL	D IH S G R EY S F AH L
DISGRACEFULLY	D IH S G R EY S F AH L IY
DISGRACEFULNESS	D IH S G R EY S F AH L N AH S
DISGRACEFULNESSES	D IH S G R EY S F AH L N AH S IH Z
DISGRACER	D IH S G R EY S ER
DISGRACERS	D IH S G R EY S ER Z
DISGRACES	D IH S G R EY S IH Z
DISINCENTIVE	D IH S IH N S EH N T IH V
DISINCENTIVES	D IH S IH N S EH N T IH V Z
DISINHERITANCE	D IH S IH N HH EH R AH T AH N S
DISINHERITANCES	D IH S IH N HH EH R AH T AH N S IH Z
DISOBEDIENCE	D IH S AH B IY D IY AH N S
DISOBEDIENCE(2)	D IH S OW B IY D IY AH N S
DISOBEDIENCES	D IH S OW B IY D IY AH N S IH Z
DISPLACE	D IH S P L EY S
DISPLACEABLE	D IH S P L EY S AH B AH L
DISPLACED	D IH S P L EY S T
DISPLACEMENT	D IH S P L EY S M AH N T
DISPLACEMENTS	D IH S P L EY S M AH N T S
DISPLACES	D IH S P L EY S IH Z
DISSERVICE	D IH S ER V AH S
DISSERVICEABLE	D IH S ER V AH S AH B AH L
DISSERVICES	D IH S ER V AH S IH Z
DISSEVERANCE	D IH S AH V IH ER AH N S
DISSEVERANCES	D IH S AH V IH ER AH N S IH Z
DISSIDENCE	D IH S AH D IH N S
DISSIDENCES	D IH S AH D AH N S IH Z
DISSONANCE	D IH S AH N AH N S
DISSONANCES	D IH S AH N AH N S IH Z
DISTANCE	D IH S T AH N S
DISTANCED	D IH S T AH N S T
DISTANCES	D IH S T AH N S AH Z
DISTANCES(2)	D IH S T AH N S IH Z
DISTURBANCE	D IH S T ER B AH N S
DISTURBANCES	D IH S T ER B AH N S AH Z
DISTURBANCES(2)	D IH S T ER B AH N S IH Z
DIVERGENCE	D AY V ER JH AH N S
DIVERGENCE(2)	D IH V ER JH AH N S
DIVERGENCES	D AY V ER JH AH N S IH Z
DIVORCE	D IH V AO R S
DIVORCED	D IH V AO R S T
DIVORCEE	D AH V AO R S IY
DIVORCEE(2)	D AH V AO R S EY
DIVORCEES	D AH V OW R S IY Z
DIVORCEMENT	D AH V OW R S M AH N T
DIVORCEMENTS	D AH V OW R S M AH N T S
DIVORCER	D AH V OW R S ER
DIVORCERS	D AH V OW R S ER Z
DIVORCES	D IH V AO R S IH Z
DIVULGENCE	D AH V AH L JH AH N S
DIVULGENCES	D AH V AH L JH AH N S IH Z
DOCENT	D OW S AH N T
DOCENTS	D OW S AH N T S
DOCETIC	D AA S AH T AH K
DOGFACE	D AO G F EY S
DOGFACES	D AO G F EY S IH Z
DOLCE	D OW L CH EY
DOLICHOCEPHALIC	D AA L AH CH AA S AH F AH L AH K
DOLICHOCEPHALIES	D AA L AH CH AH S EH F AH L AY Z
DOLICHOCEPHALY	D AA L AH CH AH S EH F AH L IY
DOMINANCE	D AA M AH N AH N S
DOMINANCES	D AA M AH N AH N S IH Z
DOMINATRICES	D AA M AH N AE T R AH S
DORMICE	D AO R M AY S
DOUCE	D UW S
DOUCELY	D UW S L IY
DOUCEUR	D AW S AH R
DOUCEURS	D AW S IY Y AH R Z
DOUGHFACE	D OW F EY S
DOUGHFACES	D OW F EY S IH Z
DRUPACEOUS	D R UW P AH S IY AH S
DUCE	D UW S
DUCE(2)	D UW CH EY
DUCES	D Y UW S AH Z
DUECENTO	D Y UW AH S EH N T OW
DUECENTOS	D UW S EH N T AA S
DULCET	D AH L S EH T
DULCETLY	D AH L S AH T L IY
DULCETS	D AH L S AH T S
DUNCE	D AH N S
DUNCES	D AH N S AH Z
DURANCE	D UH R AH N S
DURANCES	D UH R AH N S IH Z
EARPIECE	IH R P IY S
EARPIECE(2)	IY R P IY S
EARPIECES	IH R P IY S IH Z
EARPIECES(2)	IY R P IY S IH Z
EBULLIENCE	IH B UH L Y AH N S
EBULLIENCES	IH B UH L Y AH N S IH Z
ECCENTRIC	EH K S EH N T R IH K
ECCENTRICALLY	IH K S EH N T R IH K AH L IY
ECCENTRICITIES	EH K S EH N T R IH S IH T IY Z
ECCENTRICITY	EH K S AH N T R IH S AH T IY
ECCENTRICS	EH K S EH N T R IH K S
ECESIS	IY S AH S AH S
ECESISES	EH S AH S AY Z AH Z
ECHINACEA	EH CH AH N EY S IY AH
ECHINACEAS	EH CH AH N AH S IY Z
EDIFICE	EH D AH F AH S
EDIFICES	EH D AH F AH S IH Z
EDUCE	EH D Y UW S
EDUCED	EH D Y UW S T
EDUCES	EH D Y UW S AH Z
EFFACE	IH F EY S
EFFACEABLE	IH F EY S AH B AH L
EFFACED	IH F EY S T
EFFACEMENT	IH F EY S M AH N T
EFFACEMENTS	IH F EY S M AH N T S
EFFACER	IH F EY S ER
EFFACERS	IH F EY S ER Z
EFFACES	IH F EY S IH Z
EFFERVESCE	EH F AH R V EH S
EFFERVESCED	EH F AH R V EH S T
EFFERVESCENCE	EH F AH R V EH S AH N S
EFFERVESCENCES	EH F AH R V AH S EH N S AH Z
EFFERVESCENT	EH F ER V EH S AH N T
EFFERVESCENTLY	EH F AH R V EH S EH N T L IY
EFFERVESCES	EH F AH R V EH S AH Z
EFFLORESCE	EH F L AH R EH S
EFFLORESCED	EH F L AH R EH S T
EFFLORESCENCE	EH F L AH R EH S AH N S
EFFLORESCENCES	EH F L AH R EH S AH N S IH Z
EFFLORESCENT	EH F L AH R EH S AH N T
EFFLORESCES	EH F L AH R EH S IH Z
EFFLUENCE	EH F L UW AH N S
EFFLUENCES	EH F L UW AH N S IH Z
EFFULGENCE	EH F UH L JH AH N S
EFFULGENCES	EH F UH L JH EH N S AH Z
EGOCENTRIC	IY G OW S EH N T R IH K
EGOCENTRICALLY	IY G OW S EH N T R IH K AH L IY
EGOCENTRICITIES	IY G OW S EH N T R IH K AH T IY Z
EGOCENTRICITY	IY G OW S EH N T R IH K AH T IY
EGOCENTRICS	IY G OW S EH N T R IH K S
EGOCENTRISM	IY G OW S EH N T ER IH Z AH M
EGOCENTRISMS	IY G OW S EH N T ER IH Z AH M Z
ELECTROENCEPHALOGRAM	AH L AH K T R OW EH N S AH F AH L AA G R AH M
ELECTROENCEPHALOGRAMS	AH L AH K T R OW EH N S AH F AH L AA G R AH M Z
ELECTROENCEPHALOGRAPH	AH L AH K T R OW EH N S AH F AH L AA G R AH F
ELECTROENCEPHALOGRAPHER	AH L AH K T R OW EH N S AH F AH L AA G R AH F AH R
ELECTROENCEPHALOGRAPHERS	AH L AH K T R OW EH N S AH F AH L AA G R AH F AH R Z
ELECTROENCEPHALOGRAPHIC	AH L AH K T R OW EH N S AH F AH L AA G R AH F AH K
ELECTROENCEPHALOGRAPHICALLY	AH L AH K T R OW AH N S EH F AH L AA G R AE F AH K AE L IY
ELECTROENCEPHALOGRAPHIES	AH L AH K T R OW EH N S AH F AH L AA G R AH F AY Z
ELECTROENCEPHALOGRAPHS	AH L AH K T R OW EH N S AH F AH L AA G R AH F S
ELECTROENCEPHALOGRAPHY	AH L AH K T R OW EH N S AH F AH L AA G R AH F IY
ELECTROLUMINESCENCE	AH L EH K T R AH L AH M AH N EH S AH N S
ELECTROLUMINESCENCES	AH L EH K T R AH L AH M AH N AH S EH N S AH Z
ELECTROLUMINESCENT	AH L EH K T R AH L AH M AH N EH S AH N T
ELEGANCE	EH L AH G AH N S
ELEGANCES	EH L IH G AH N S IH Z
ELOQUENCE	EH L AH K W AH N S
ELOQUENCES	EH L AH K W AH N S IH Z
EMBRACE	EH M B R EY S
EMBRACE(2)	IH M B R EY S
EMBRACEABLE	IH M B R EY S AH B AH L
EMBRACED	EH M B R EY S T
EMBRACEMENT	IH M B R EY S M AH N T
EMBRACEMENTS	IH M B R EY S M AH N T S
EMBRACEOR	IH M B R EY S ER
EMBRACEORS	IH M B R EY S ER Z
EMBRACER	IH M B R EY S ER
EMBRACERIES	IH M B R EY S AH R IY Z
EMBRACERS	IH M B R EY S ER Z
EMBRACERY	IH M B R EY S AH R IY
EMBRACES	EH M B R EY S IH Z
EMCEE	EH M S IY
EMCEED	IH M S IY D
EMCEEING	EH M S IY IH NG
EMCEES	EH M S IY Z
EMERGENCE	IH M ER JH AH N S
EMERGENCE(2)	IY M ER JH AH N S
EMERGENCES	IH M ER JH AH N S IH Z
EMINENCE	EH M AH N AH N S
EMINENCES	EH M AH N AH N S IH Z
EMITTANCE	IY M IH T AH N S
EMITTANCES	IY M IH T AH N S IH Z
EMPLACE	IH M P L EY S
EMPLACED	IH M P L EY S T
EMPLACEMENT	IH M P L EY S M AH N T
EMPLACEMENTS	IH M P L EY S M AH N T S
EMPLACES	IH M P L EY S IH Z
ENCEINTE	IH N S IY N T
ENCEINTES	IH N S IY N T S
ENCEPHALA	IH N S EH F AH L AH
ENCEPHALITIC	IH N S EH F AH L AH T AH K
ENCEPHALITIDES	IH N S AH F AE L AH T AY D Z
ENCEPHALITIS	EH N S EH F AH L AY T AH S
ENCEPHALITOGEN	IH N S AH F AH L IH T AH JH AH N
ENCEPHALITOGENIC	IH N S EH F AH L IH T AH JH AH N AH K
ENCEPHALITOGENS	IH N S EH F AH L IH T AH JH AH N Z
ENCEPHALOGRAM	IH N S EH F AH L AA G R AH M
ENCEPHALOGRAMS	IH N S EH F AH L AA G R AH M Z
ENCEPHALOGRAPH	IH N S EH F AH L AA G R AH F
ENCEPHALOGRAPHIES	IH N S EH F AH L AA G R AH F AY Z
ENCEPHALOGRAPHS	IH N S EH F AH L AA G R AH F S
ENCEPHALOGRAPHY	IH N S EH F AH L AA G R AH F IY
ENCEPHALOMYELITIDES	IH N S AH F AH L AH M AY EH L AH T AY D Z
ENCEPHALOMYELITIS	IH N S EH F AH L AA M AY AH L AY T AH S
ENCEPHALOMYOCARDITIS	IH N S EH F AH L AH M AY AH K AH R D AY T AH S
ENCEPHALOMYOCARDITISES	IH N S AH F AH L AH M AY AH K AA R D AH T AY Z AH Z
ENCEPHALON	IH N S EH F AH L AH N
ENCEPHALOPATHIC	IH N S AH F AE L AH P AH TH AH K
ENCEPHALOPATHIES	IH N S AH F AH L AA P AH TH AY Z
ENCEPHALOPATHY	EH N S EH F AH L AO P AH TH IY
ENCUMBRANCE	IH N K AH M B R AH N S
ENCUMBRANCER	IH N K AH M B R AH N S ER
ENCUMBRANCERS	IH N K AH M B R AH N S ER Z
ENCUMBRANCES	IH N K AH M B R AH N S IH Z
ENDURANCE	EH N D ER AH N S
ENDURANCES	EH N D UH R AH N S IH Z
ENFACE	EH N F EY S
ENFACED	EH N F EY S T
ENFACES	EH N F EY S IH Z
ENFORCE	EH N F AO R S
ENFORCEABILITIES	EH N F OW R S AH B IH L AH T EH Z
ENFORCEABILITY	EH N F AO R S AH B IH L IH T IY
ENFORCEABLE	EH N F AO R S AH B AH L
ENFORCED	EH N F AO R S T
ENFORCEMENT	EH N F AO R S M AH N T
ENFORCEMENTS	EH N F AO R S M AH N T S
ENFORCER	EH N F AO R S ER
ENFORCERS	EH N F AO R S ER Z
ENFORCES	EH N F AO R S IH Z
ENHANCE	EH N HH AE N S
ENHANCED	EH N HH AE N S T
ENHANCEMENT	EH N HH AE N S M AH N T
ENHANCEMENTS	EH N HH AE N S M AH N T S
ENHANCER	EH N HH AE N S ER
ENHANCERS	IH N HH AE N S ER Z
ENHANCES	EH N HH AE N S IH Z
ENLACE	EH N L EY S
ENLACED	EH N L EY S T
ENLACEMENT	EH N L EY S M AH N T
ENLACEMENTS	EH N L EY S M AH N T S
ENLACES	EH N L EY S IH Z
ENOUNCE	EH N AW N S
ENOUNCED	EH N AW N S T
ENOUNCES	EH N AW N S IH Z
ENSCONCE	IH N S K AA N S
ENSCONCED	IH N S K AA N S T
ENSCONCES	IH N S K AA N S IH Z
ENSORCEL	IH N S AO R S AH L
ENSORCELED	IH N S AO R S IY L D
ENSORCELING	IH N S AO R S IY L AH NG
ENSORCELL	EH N Z ER S EH L
ENSORCELLED	EH N Z ER S EH L D
ENSORCELLING	EH N Z ER S EH L IH NG
ENSORCELLMENT	EH N Z ER S EH L M AH N T
ENSORCELLMENTS	EH N Z ER S EH L M AH N T S
ENSORCELLS	EH N Z ER S EH L Z
ENSORCELS	IH N S AO R S AH L Z
ENTICE	IH N T AY S
ENTICED	IH N T AY S T
ENTICEMENT	IH N T AY S M AH N T
ENTICEMENTS	IH N T AY S M AH N T S
ENTICER	IH N T AY S ER
ENTICERS	IH N T AY S ER Z
ENTICES	IH N T AY S IH Z
ENTRANCE	EH N T R AH N S
ENTRANCED	IH N T R AE N S T
ENTRANCEMENT	EH N T R AH N S M AH N T
ENTRANCEMENTS	EH N T R AH N S M AH N T S
ENTRANCES	EH N T R AH N S AH Z
ENTRANCEWAY	EH N T R AH N S W EY
ENTRANCEWAYS	EH N T R AH N S W EY Z
EPICALYCES	AH P IH K AH L AY S AH Z
EPICEDIA	EH P AH S IY D IY AH
EPICEDIUM	EH P AH S IY D IY AH M
EPICENE	EH P AH S IY N
EPICENES	EH P AH S IY N Z
EPICENISM	EH P IH K AH N IH Z AH M
EPICENISMS	EH P IH K AH N IH Z AH M Z
EPICENTER	EH P AH S EH N T ER
EPICENTERS	EH P AH S EH N T ER Z
EPICENTRAL	EH P IH K EH N T R AH L
EQUIPOLLENCE	EH K W AH P AA L AH N S
EQUIPOLLENCES	EH K W AH P AA L EH N S AH Z
EQUIVALENCE	IH K W IH V AH L AH N S
EQUIVALENCES	IH K W IH V AH L AH N S IH Z
ERICACEOUS	AH R IH S AH S IY AH S
ESPERANCE	EH S AH R AH N S
ESPERANCES	EH S AH R AE N S AH Z
ESSENCE	EH S AH N S
ESSENCES	EH S AH N S IH Z
ESURIENCE	EH ZH Y UH R IY AH N S
ESURIENCES	EH ZH Y UH R IY EH N S AH Z
ETCETERA	EH T S EH T ER AH
ETCETERAS	EH T S EH T AH R AH Z
ETHNOCENTRIC	EH TH N OW S EH N T R IH K
ETHNOCENTRICITIES	EH TH N AH S EH N T R IH S AH T AY Z
ETHNOCENTRICITY	EH TH N AH S EH N T R IH S AH T IY
ETHNOCENTRISM	EH TH N OW S EH N T R IH Z AH M
ETHNOCENTRISMS	EH TH N AH S EH N T R AH Z AH M Z
ETHNOSCIENCE	EH TH N AH SH AH N S
ETHNOSCIENCES	EH TH N AH SH AH N S AH Z
ETHYLENEDIAMINETETRAACETATE	AH TH AH L AH N IY D IY AE M AH N AH T EH T R AA S AH T EY T
ETHYLENEDIAMINETETRAACETATES	AH TH AH L AH N IY D IY AE M AH N AH T EH T R AA S AH T EY T S
EVANESCE	EH V AH N EH S
EVANESCED	EH V AH N EH S T
EVANESCENCE	EH V AH N EH S AH N S
EVANESCENCES	EH V AH N AH S EH N S AH Z
EVANESCENT	EH V AH N EH S AH N T
EVANESCES	EH V AH N EH S AH Z
EVERYPLACE	EH V R IY P L EY S
EVIDENCE	EH V AH D AH N S
EVIDENCED	EH V IH D AH N S T
EVIDENCES	EH V AH D AH N S AH Z
EVINCE	IH V IH N S
EVINCED	IH V IH N S T
EVINCES	IH V IH N S IH Z
EVISCERATE	AH V IH S ER EY T
EVISCERATED	AH V IH S ER EY T IH D
EVISCERATES	AH V IH S AH R EY T S
EVISCERATING	AH V IH S AH R EY T AH NG
EVISCERATION	AH V IH S AH R EY SH AH N
EVISCERATIONS	AH V IH S AH R EY T IY AH N Z
EXACERBATE	IH G Z AE S ER B EY T
EXACERBATED	IH G Z AE S ER B EY T AH D
EXACERBATED(2)	IH G Z AE S ER B EY T IH D
EXACERBATES	IH G Z AE S ER B EY T S
EXACERBATING	IH G Z AE S ER B EY T IH NG
EXACERBATION	IH G Z AE S ER B EY SH AH N
EXACERBATIONS	IH G Z AE S ER B EY SH AH N Z
EXCEED	IH K S IY D
EXCEEDED	IH K S IY D AH D
EXCEEDED(2)	IH K S IY D IH D
EXCEEDER	IH K S IY D ER
EXCEEDERS	IH K S IY D ER Z
EXCEEDING	IH K S IY D IH NG
EXCEEDINGLY	IH K S IY D IH NG L IY
EXCEEDS	IH K S IY D Z
EXCEL	IH K S EH L
EXCELLED	IH K S EH L D
EXCELLENCE	EH K S AH L AH N S
EXCELLENCES	EH K S AH L AH N S IH Z
EXCELLENCIES	EH K S L EH N S IY Z
EXCELLENCY	EH K S L EH N S IY
EXCELLENT	EH K S AH L AH N T
EXCELLENTLY	EH K S AH L AH N T L IY
EXCELLING	EH K S EH L IH NG
EXCELS	IH K S EH L Z
EXCELSIOR	IH K S EH L S IY ER
EXCELSIORS	IH K S EH L S IY ER Z
EXCEPT	IH K S EH P T
EXCEPTED	IH K S EH P T IH D
EXCEPTING	EH K S EH P T IH NG
EXCEPTION	IH K S EH P SH AH N
EXCEPTIONABILITIES	IH K S EH P SH AH N AH B IH L AH T EH Z
EXCEPTIONABILITY	IH K S EH P SH AH N AH B IH L AH T EH
EXCEPTIONABLE	IH K S EH P SH AH N AH B AH L
EXCEPTIONABLY	IH K S EH P SH AH N AH B L IY
EXCEPTIONAL	IH K S EH P SH AH N AH L
EXCEPTIONALISM	IH K S EH P SH AH N AH L IH Z AH M
EXCEPTIONALISMS	IH K S EH P SH AH N AH L IH Z AH M Z
EXCEPTIONALITIES	IH K S EH P SH AH N AH L AH T IY Z
EXCEPTIONALITY	IH K S EH P SH AH N AH L AH T IY
EXCEPTIONALLY	IH K S EH P SH AH N AH L IY
EXCEPTIONALLY(2)	IH K S EH P SH N AH L IY
EXCEPTIONALNESS	IH K S EH P SH AH N AH L N AH S
EXCEPTIONALNESSES	IH K S EH P SH AH N AH L N AH S IH Z
EXCEPTIONS	IH K S EH P SH AH N Z
EXCEPTIVE	IH K S EH P T IH V
EXCEPTS	IH K S EH P T S
EXCERPT	EH K S ER P T
EXCERPTED	EH K S ER P T IH D
EXCERPTER	EH K S ER P T ER
EXCERPTERS	EH K S ER P T ER Z
EXCERPTING	EH K S ER P T IH NG
EXCERPTION	EH K S ER P SH AH N
EXCERPTIONS	EH K S ER P SH AH N Z
EXCERPTOR	EH K S ER P T ER
EXCERPTORS	EH K S ER P T ER Z
EXCERPTS	EH K S ER P T S
EXCESS	EH K S EH S
EXCESS(2)	IH K S EH S
EXCESSED	IH K S EH S T
EXCESSES	EH K S EH S IH Z
EXCESSES(2)	IH K S EH S IH Z
EXCESSING	IH K S EH S IH NG
EXCESSIVE	IH K S EH S IH V
EXCESSIVELY	IH K S EH S IH V L IY
EXCESSIVENESS	EH K S EH S IH V N AH S
EXCESSIVENESSES	EH K S EH S IH V N AH S IH Z
EXCRESCENCE	EH K S K R EH S AH N S
EXCRESCENCES	EH K S K R EH S AH N S IH Z
EXCRESCENCIES	EH K S K R EH S AH N S IY Z
EXCRESCENCY	EH K S K R EH S AH N S IY
EXCRESCENT	EH K S K R EH S AH N T
EXCRESCENTLY	EH K S K R EH S AH N T L IY
EXECUTRICES	IH G Z AH K AH T R AH S
EXIGENCE	IH G Z IH JH AH N S
EXIGENCES	IH G Z IH JH AH N S IH Z
EXISTENCE	EH G Z IH S T AH N S
EXISTENCE(2)	IH G Z IH S T AH N S
EXISTENCES	EH G Z IH S T AH N S IH Z
EXORBITANCE	IH G Z AO R B AH T AH N S
EXORBITANCES	IH G Z AO R B AH T AH N S IH Z
EXPECTANCE	IH K S P EH K T AH N S
EXPECTANCES	IH K S P EH K T AH N S IH Z
EXPEDIENCE	IH K S P IY D IY AH N S
EXPEDIENCES	IH K S P IY D IY AH N S IH Z
EXPERIENCE	IH K S P IH R IY AH N S
EXPERIENCED	IH K S P IH R IY AH N S T
EXPERIENCES	IH K S P IH R IY AH N S IH Z
EXTEROCEPTIVE	IH K S T EH R AH S EH P T AH V
EXTEROCEPTOR	IH K S T EH R AH S EH P T AH R
EXTEROCEPTORS	IH K S T EH R AH S EH P T AH R Z
EXTRACELLULAR	EH K S T R AH S EH L Y AH L ER
EXTRACELLULARLY	EH K S T R AH S EH L Y AH L ER L IY
EXTRAVAGANCE	EH K S T R AE V AH G AH N S
EXTRAVAGANCES	IH K S T R AE V IH G AH N S IH Z
EXUBERANCE	IH G Z UW B ER AH N S
EXUBERANCES	IH G Z UW B ER AH N S IH Z
EXULTANCE	IH G Z AH L T AH N S
EXULTANCES	IH G Z AH L T AH N S IH Z
EYEPIECE	AY P IY S
EYEPIECES	AY P IY S IH Z
FACE	F EY S
FACEABLE	F EY S AH B AH L
FACECLOTH	F EY S K L AO TH
FACECLOTHS	F EY S K L AO TH S
FACED	F EY S T
FACEDOWN	F EY S D AW N
FACEDOWNS	F EY S D AW N Z
FACELESS	F EY S L AH S
FACELESSNESS	F EY S L AH S N AH S
FACELESSNESSES	F EY S L AH S N AH S IH Z
FACELIFT	F EY S L IH F T
FACELIFTED	F EY S L IH F T IH D
FACELIFTING	F EY S L IH F T IH NG
FACELIFTS	F EY S L IH F T S
FACEMASK	F EY S M AE S K
FACEMASKS	F EY S M AE S K S
FACEPLATE	F EY S P L EY T
FACEPLATES	F EY S P L EY T S
FACER	F EY S ER
FACERS	F EY S ER Z
FACES	F EY S AH Z
FACES(2)	F EY S IH Z
FACET	F AE S AH T
FACETE	F AH S IY T
FACETED	F AE S AH T IH D
FACETELY	F AH S IY T L IY
FACETIAE	F AH S IY T IY IY
FACETING	F AE S AH T IH NG
FACETIOUS	F AH S IY SH AH S
FACETIOUSLY	F AH S IY SH AH S L IY
FACETIOUSNESS	F AH S IY SH AH S N AH S
FACETIOUSNESSES	F AH S IY SH AH S N AH S IH Z
FACETS	F AE S AH T S
FACETTED	F AE S AH T IH D
FACETTING	F AE S AH T IH NG
FACEUP	F EY S AH P
FAECES	F IY S AH Z
FAIENCE	F EY AH N S
FAIENCES	F EY AH N S IH Z
FALCES	F AE L S AH Z
FARCE	F AA R S
FARCED	F AA R S T
FARCER	F AA R S ER
FARCERS	F AA R S ER Z
FARCES	F AA R S IH Z
FARCEUR	F AA R S AH R
FARCEURS	F AA R S IY Y AH R Z
FARINACEOUS	F AA R IH N EY S AH S
FASCES	F AE S AH Z
FAUCES	F AO S AH Z
FAUCET	F AO S AH T
FAUCETS	F AO S AH T S
FEASANCE	F IY Z AH N S
FEASANCES	F IY Z AH N S IH Z
FECES	F IY S IY Z
FECULENCE	F IY K Y AH L AH N S
FECULENCES	F IY K Y AH L EH N S AH Z
FENCE	F EH N S
FENCED	F EH N S T
FENCELESS	F EH N S L AH S
FENCELESSNESS	F EH N S L AH S N AH S
FENCELESSNESSES	F EH N S L AH S N AH S IH Z
FENCER	F EH N S ER
FENCEROW	F EH N S R OW
FENCEROWS	F EH N S R OW Z
FENCERS	F EH N S ER Z
FENCES	F EH N S IH Z
FERROCENE	F EH R AH S IY N
FERROCENES	F EH R AH S IY N Z
FESCENNINE	F EH S AH N AY N
FIANCE	F IY AA N S EY
FIANCEE	F IY AE N S IY
FIANCEES	F IY AA N S EY IY Z
FIANCES	F IY AA N S EY Z
FICE	F AY S
FICES	F AY S AH Z
FIELDPIECE	F IY L D P IY S
FIELDPIECES	F IY L D P IY S IH Z
FIERCE	F IH R S
FIERCELY	F IH R S L IY
FIERCENESS	F IH ER S N AH S
FIERCENESSES	F IH ER S N AH S IH Z
FIERCER	F IH R S ER
FIERCEST	F IH R S AH S T
FINANCE	F AH N AE N S
FINANCE(2)	F IH N AE N S
FINANCE(3)	F AY N AE N S
FINANCED	F IH N AE N S T
FINANCED(2)	F AY N AE N S T
FINANCES	F IH N AE N S IH Z
FINANCES(2)	F AY N AE N S IH Z
FIREPLACE	F AY ER P L EY S
FIREPLACED	F AY ER P L EY S T
FIREPLACES	F AY ER P L EY S AH Z
FIREPLACES(2)	F AY R P L EY S IH Z
FLAGRANCE	F L EY G R AH N S
FLAGRANCES	F L EY G R AH N S IH Z
FLAMBOYANCE	F L AE M B OY AH N S
FLAMBOYANCES	F L AE M B OY AH N S IH Z
FLATULENCE	F L AE CH AH L AH N S
FLATULENCES	F L AE CH AH L AH N S IH Z
FLEECE	F L IY S
FLEECED	F L IY S T
FLEECER	F L IY S AH R
FLEECERS	F L IY S AH R Z
FLEECES	F L IY S IH Z
FLOCCED	F L AA K T
FLORENCE	F L AO R AH N S
FLORENCES	F L OW R AH N S IH Z
FLORESCENCE	F L AH R EH S AH N S
FLORESCENCES	F L AO R AH S EH N S AH Z
FLORESCENT	F L AH R EH S AH N T
FLOUNCE	F L AW N S
FLOUNCED	F L AW N S T
FLOUNCES	F L AW N S IH Z
FLUORESCE	F L UH R EH S
FLUORESCE(2)	F L AO R EH S
FLUORESCED	F L UH R EH S T
FLUORESCEIN	F L UH R EH S IY AH N
FLUORESCEINS	F L UH R EH S IY AH N Z
FLUORESCENCE	F L UH R EH S AH N S
FLUORESCENCES	F L UH R EH S AH N S IH Z
FLUORESCENT	F L UH R EH S AH N T
FLUORESCENT(2)	F L AO R EH S AH N T
FLUORESCENTS	F L UH R EH S AH N T S
FLUORESCENTS(2)	F L AO R EH S AH N T S
FLUORESCER	F L UH R EH S ER
FLUORESCERS	F L UH R EH S ER Z
FLUORESCES	F L UH R EH S IH Z
FOLIACEOUS	F OW L IY AH S IY AH S
FOOTPACE	F UH T P EY S
FOOTPACES	F UH T P EY S IH Z
FOOTRACE	F UH T R EY S
FOOTRACES	F UH T R EY S IH Z
FORBEARANCE	F AO R B EH R AH N S
FORBEARANCES	F AO R B AE ER AH N S IH Z
FORBIDDANCE	F AO R B IH D AH N S
FORBIDDANCES	F AO R B IH D AH N S IH Z
FORCE	F AO R S
FORCED	F AO R S T
FORCEDLY	F OW R S AH D L IY
FORCEFUL	F AO R S F AH L
FORCEFULLY	F AO R S F AH L IY
FORCEFULNESS	F AO R S F AH L N AH S
FORCEFULNESSES	F OW R S F AH L N AH S IH Z
FORCELESS	F OW R S L AH S
FORCEMEAT	F OW R S M IY T
FORCEMEATS	F OW R S M IY T S
FORCEPS	F AO R S EH P S
FORCEPSLIKE	F AO R S AH P S L AY K
FORCER	F OW R S ER
FORCERS	F OW R S ER Z
FORCES	F AO R S IH Z
FOREFACE	F OW R F EY S
FOREFACES	F OW R F EY S IH Z
FORNICES	F AO R N AY S IH Z
FORTALICE	F AO R T EY AH L AY S
FORTALICES	F AO R T EY AH L IH K S IH Z
FRAGRANCE	F R EY G R AH N S
FRAGRANCES	F R EY G R AH N S IH Z
FRANKINCENSE	F R AE NG K AH N S EH N S
FRANKINCENSES	F R AE NG K IH N S EH N S IH Z
FRAUDULENCE	F R AO D Y AH L AH N S
FRAUDULENCES	F R AO D Y AH L EH N S AH Z
FREELANCE	F R IY L AE N S
FREELANCED	F R IY L AE N S T
FREELANCER	F R IY L AE N S ER
FREELANCERS	F R IY L AE N S ER Z
FREELANCES	F R IY L AE N S IH Z
FREQUENCE	F R EH K W AH N S
FREQUENCES	F R EH K W EH N S AH Z
FRONTISPIECE	F R AH N T IY Z P IY S
FRONTISPIECES	F R AH N T IY Z P IY S IH Z
FROUNCE	F R AW N S
FROUNCED	F R AW N S T
FROUNCES	F R AW N S AH Z
FRUTESCENT	F R UW T EH S AH N T
FULLFACE	F UH L F EY S
FULLFACES	F UH L F EY S IH Z
FURNACE	F ER N AH S
FURNACED	F ER N AH S T
FURNACES	F ER N AH S IH Z
FURTHERANCE	F ER TH ER AH N S
FURTHERANCES	F Y UH R TH ER AH N S IH Z
FYCE	F AY S
FYCES	F AY S AH Z
GALLINACEOUS	G AO L IH N EY S AH S
GENERATRICES	JH IY N R AE T R AY S IH Z
GENTRICE	JH EH N T R AY S
GENTRICES	JH EH N T R AY S IH Z
GEOCENTRIC	JH IY OW S EH N T R IH K
GEOCENTRICALLY	JH IY OW S EH N T R IH K AH L IY
GEOMANCER	JH IY AH M AE N S AH R
GEOMANCERS	JH IY AH M AE N S AH R Z
GEOSCIENCE	JH IY AH SH AH N S
GEOSCIENCES	JH IY AH SH AH N S AH Z
GLABRESCENT	G L AE B R EH S AH N T
GLACE	G L EY S
GLACEED	G L EY S IY D
GLACEING	G L EY S IY AH NG
GLACES	G L EY S AH Z
GLANCE	G L AE N S
GLANCED	G L AE N S T
GLANCER	G L AE N S ER
GLANCERS	G L AE N S ER Z
GLANCES	G L AE N S IH Z
GLYCERALDEHYDE	G L AH S AH R AE L D AH HH AY D
GLYCERALDEHYDES	G L AH S AH R AE L D AH HH AY D Z
GLYCERIC	G L IH S AH R AH K
GLYCERIDE	G L IH S AH R AY D
GLYCERIDES	G L IH S AH R AY D Z
GLYCERIDIC	G L IH S AH R AH D AH K
GLYCERIN	G L IH S AH R AH N
GLYCERINATE	G L IH S AH R AH N AH T
GLYCERINATED	G L IH S AH R AH N EY T IH D
GLYCERINATES	G L IH S AH R AH N AH T S
GLYCERINATING	G L IH S AH R AH N EY T IH NG
GLYCERINE	G L IH S AH R AH N
GLYCERINES	G L IH S AH R AH N Z
GLYCERINS	G L IH S AH R AH N Z
GLYCEROL	G L IH S ER OW L
GLYCEROLS	G L IH S AH R AO L Z
GLYCERYL	G L IH S AH R AH L
GLYCERYLS	G L IH S AH R AH L Z
GOVERNANCE	G AH V ER N AH N S
GOVERNANCES	G AH V ER N AH N S IH Z
GRACE	G R EY S
GRACED	G R EY S T
GRACEFUL	G R EY S F AH L
GRACEFULLER	G R EY S F AH L ER
GRACEFULLEST	G R EY S F AH L AH S T
GRACEFULLY	G R EY S F AH L IY
GRACEFULNESS	G R EY S F AH L N AH S
GRACEFULNESSES	G R EY S F AH L N AH S IH Z
GRACELESS	G R EY S L AH S
GRACELESSLY	G R EY S L AH S L IY
GRACELESSNESS	G R EY S L AH S N AH S
GRACELESSNESSES	G R EY S L AH S N AH S IH Z
GRACES	G R EY S IH Z
GRANDILOQUENCE	G R AE N D IH L AH K W AH N S
GRANDILOQUENCES	G R AE N D IH L AH K W AH N S IH Z
GRANDNIECE	G R AE N D N IY S
GRANDNIECES	G R AE N D N IY S IH Z
GREENGROCER	G R IY N G R OW S ER
GREENGROCERIES	G R IY N G R OW S R IY Z
GREENGROCERS	G R IY N G R OW S ER Z
GREENGROCERY	G R IY N G R OW S R IY
GRIEVANCE	G R IY V AH N S
GRIEVANCES	G R IY V AH N S AH Z
GRIEVANCES(2)	G R IY V AH N S IH Z
GRIMACE	G R IH M AH S
GRIMACED	G R IH M AH S T
GRIMACER	G R IH M AH S ER
GRIMACERS	G R IH M AH S ER Z
GRIMACES	G R IH M AH S IH Z
GROCER	G R OW S ER
GROCERIES	G R OW S ER IY Z
GROCERIES(2)	G R OW S R IY Z
GROCERS	G R OW S ER Z
GROCERY	G R OW S ER IY
GROCERY(2)	G R OW S R IY
GUIDANCE	G AY D AH N S
GUIDANCES	G AY D AH N S IH Z
GYNAECEA	JH AH N IY S IY AH
GYNAECEUM	JH AH N IY S IY AH M
HACEK	HH AE S AH K
HACEKS	HH AE S AH K S
HACENDADO	HH AH S EH N D AH D OW
HACENDADOS	HH AH S EH N D AH D AH Z
HAECCEITIES	HH IY K S AH T AY Z
HAECCEITY	HH IY K S IY AH T IY
HAIRPIECE	HH EH R P IY S
HAIRPIECES	HH EH R P IY S IH Z
HALFPENCE	HH AE L F AH N S
HALLUCES	HH AE L UW S AH Z
HANCE	HH AE N S
HANCES	HH AE N S AH Z
HAPPENCHANCE	HH AE P AH N CH AE N S
HAPPENCHANCES	HH AE P AH N CH AE N S IH Z
HAPPENSTANCE	HH AE P AH N S T AE N S
HAPPENSTANCES	HH AE P AH N S T AE N S IH Z
HARUSPICES	HH AH R AH S AH S
HEADPIECE	HH EH D P IY S
HEADPIECES	HH EH D P IY S IH Z
HEADRACE	HH EH D R EY S
HEADRACES	HH EH D R EY S IH Z
HEADSPACE	HH EH D S P EY S
HEADSPACES	HH EH D S P EY S IH Z
HEELPIECE	HH IY L P IY S
HEELPIECES	HH IY L P IY S IH Z
HELICES	HH IY L AH S
HELIOCENTRIC	HH IY L IY OW S EH N T R IH K
HEMIACETAL	HH IY M IY AE S AH T AH L
HEMIACETALS	HH IY M IY AE S AH T AH L Z
HEMICELLULOSE	HH AH M AH S EH L AH L OW Z
HEMICELLULOSES	HH AH M AH S EH L AH L OW Z AH Z
HENCE	HH EH N S
HENCEFORTH	HH EH N S F AO R TH
HENCEFORWARD	HH EH N S AH F AO R W AH R D
HEPATOCELLULAR	HH AH P AE T AH S EH L Y AH L AH R
HERBACEOUS	ER B EY SH AH S
HERETRICES	HH AH R EH T R AH S
HERITRICES	HH AH R IH T R AH S
HESITANCE	HH EH Z AH T AH N S
HESITANCES	HH EH Z AH T AH N S IH Z
HETEROCERCAL	HH EH T ER OW S ER K AH L
HINDRANCE	HH IH N D R AH N S
HINDRANCES	HH IH N D R AH N S IH Z
HOMOCERCAL	HH AA M AH S AH R K AH L
HOMOSCEDASTIC	HH AH M AA S AH D AH S T AH K
HOMOSCEDASTICITIES	HH AH M AA S AH D AE S T IH S AH T AY Z
HOMOSCEDASTICITY	HH AH M AA S AH D AE S T IH S AH T IY
HORSERACE	HH AO R S R EY S
HORSERACES	HH AO R S R EY S IH Z
HOSPICE	HH AA S P AH S
HOSPICES	HH AA S P AH S IH Z
HYDROCELE	HH IH D R AH S IY L
HYDROCELES	HH IH D R AH S IY L Z
HYDROCEPHALIC	HH IH D R AA S AH F AH L AH K
HYDROCEPHALICS	HH IH D R AH S EH F AH L AH S Z
HYDROCEPHALIES	HH IH D R AH S EH F AH L AY Z
HYDROCEPHALUS	HH IH D R AH S EH F AH L AH S
HYDROCEPHALUSES	HH IH D R AH S EH F AH L UW Z AH Z
HYDROCEPHALY	HH IH D R AH S EH F AH L IY
HYDROSPACE	HH IH D R AA S AH S
HYDROSPACES	HH IH D R AA S AH S AH Z
HYDROTHORACES	HH IH D R AH TH AO R AH S AH Z
HYPERCALCEMIA	HH AY P AH R K AE L S IY M IY AH
HYPERCALCEMIAS	HH AY P AH R K AE L S IY M IY AH Z
HYPERCALCEMIC	HH AY P AH R K AE L S AH M AH K
HYPERCONCENTRATION	HH AY P ER K AA N S AH N T R EY SH AH N
HYPERCONCENTRATIONS	HH AY P ER K AA N S AH N T R EY SH AH N Z
HYPERGLYCEMIA	HH AY P AH R G L AH S IY M IY AH
HYPERGLYCEMIAS	HH AY P AH R G L AH S IY M IY AH Z
HYPERGLYCEMIC	HH AY P AH R G L IH S AH M AH K
HYPERPRODUCER	HH AY P ER P R AH D UW S ER
HYPERPRODUCERS	HH AY P ER P R AH D UW S ER Z
HYPERSOMNOLENCE	HH AY P ER S AA M N AH L AH N S
HYPERSOMNOLENCES	HH AY P ER S AA M N AH L AH N S IH Z
HYPERSPACE	HH AY P ER S P EY S
HYPERSPACES	HH AY P ER S P EY S IH Z
HYPERSURFACE	HH AY P ER S ER F AH S
HYPERSURFACES	HH AY P ER S ER F AH S IH Z
HYPERSUSCEPTIBILITIES	HH AY P ER S AH S EH P T AH B IH L AH T IY Z
HYPERSUSCEPTIBILITY	HH AY P ER S AH S EH P T AH B IH L AH T IY
HYPERSUSCEPTIBLE	HH AY P ER S AH S EH P T AH B AH L
HYPERURICEMIA	HH AY P AH R Y UH R AH S IY M IY AH
HYPERURICEMIAS	HH AY P AH R Y UH R AH S IY M IY AH Z
HYPERVIGILANCE	HH AY P ER V IH JH AH L AH N S
HYPERVIGILANCES	HH AY P ER V IH JH AH L AH N S IH Z
HYPOCALCEMIA	HH IH P AH K AH L S IY M IY AH
HYPOCALCEMIAS	HH IH P AH K AH L S IY M IY AH Z
HYPOCALCEMIC	HH IH P AH K AE L S AH M AH K
HYPOCENTER	HH IH P AH S EH N T AH R
HYPOCENTERS	HH IH P AH S EH N T AH R Z
HYPOCENTRAL	HH IH P AH S EH N T R AH L
HYPOGLYCEMIA	HH AY P OW G L AY S IY M IY AH
HYPOGLYCEMIAS	HH AH P AA G L AH S IY M IY AH Z
HYPOGLYCEMIC	HH AY P OW G L AY S IY M IH K
HYPOGLYCEMICS	HH AH P AA G L IH S AH M AH S Z
HYRACES	HH AY R AH S AH Z
IBICES	AY B AH S
ICE	AY S
ICEBERG	AY S B ER G
ICEBERGS	AY S B ER G Z
ICEBLINK	AY S B L IH NG K
ICEBLINKS	AY S B L IH NG K S
ICEBOAT	AY S B OW T
ICEBOATER	AY S B OW T ER
ICEBOATERS	AY S B OW T ER Z
ICEBOATING	AY S B OW T IH NG
ICEBOATINGS	AY S B OW T IH NG Z
ICEBOATS	AY S B OW T S
ICEBOUND	AY S B AW N D
ICEBOX	AY S B AA K S
ICEBOXES	AY S B AA K S IH Z
ICEBREAKER	AY S B R EY K ER
ICEBREAKERS	AY S B R EY K ER Z
ICECAP	AY S K AE P
ICECAPS	AY S K AE P S
ICED	AY S T
ICEFALL	AY S F AO L
ICEFALLS	AY S F AO L Z
ICEHOUSE	AY S HH AW S
ICEHOUSES	AY S HH AW S IH Z
ICEKHANA	AH S EH K AH N AH
ICEKHANAS	AH S EH K AH N AH Z
ICELESS	AY S L AH S
ICELIKE	AY S L AY K
ICEMAKER	AY S M EY K ER
ICEMAKERS	AY S M EY K ER Z
ICEMAN	AY S M AE N
ICEMEN	AY S M EH N
ICES	AY S AH Z
ICES(2)	AY S IH Z
IGNESCENT	AH N EH S AH N T
IGNORANCE	IH G N ER AH N S
IGNORANCES	IH G N AH R AH N S IH Z
ILLUMINANCE	IH L UW M AH N AH N S
ILLUMINANCES	IH L UW M AH N AH N S IH Z
IMBALANCE	IH M B AE L AH N S
IMBALANCED	IH M B AE L AH N S T
IMBALANCES	IH M B AE L AH N S IH Z
IMMANENCE	IH M AH N AH N S
IMMANENCES	IH M AH N AH N S IH Z
IMMINENCE	IH M AH N AH N S
IMMINENCES	IH M AH N AH N S IH Z
IMMITTANCE	IH M IH T AH N S
IMMITTANCES	IH M IH T AH N S IH Z
IMMUNOCOMPETENCE	IH M Y UW N AH K AA M P AH T AH N S
IMMUNOCOMPETENCES	IH M Y UW N AH K AA M P AH T EH N S AH Z
IMMUNOFLUORESCENCE	IH M Y UW N AH F L AH W AH R EH S AH N S
IMMUNOFLUORESCENCES	IH M Y UW N AH F L AH W AH R AH S EH N S AH Z
IMMUNOFLUORESCENT	IH M Y UW N AH F L AH W AH R EH S AH N T
IMPATIENCE	IH M P EY SH AH N S
IMPATIENCES	IH M P EY SH AH N S IH Z
IMPEDANCE	IH M P IY D AH N S
IMPEDANCES	IH M P IY D AH N S IH Z
IMPENITENCE	IH M P EH N AH T AH N S
IMPENITENCES	IH M P EH N AH T EH N S AH Z
IMPERCEIVABLE	IH M P ER S IY V AH B AH L
IMPERCEPTIBLE	IH M P ER S EH P T IH B AH L
IMPERCEPTIBLY	IH M P ER S EH P T IH B L IY
IMPERCEPTIVE	IH M P ER S EH P T IH V
IMPERCEPTIVENESS	IH M P ER S EH P T IH V N AH S
IMPERCEPTIVENESSES	IH M P ER S EH P T IH V N AH S IH Z
IMPERCIPIENCE	IH M P AH R S IH P IY AH N S
IMPERCIPIENCES	IH M P AH R S IH P IY EH N S AH Z
IMPERMANENCE	IH M P ER M AH N AH N S
IMPERMANENCES	IH M P ER M AH N AH N S IH Z
IMPERTINENCE	IH M P ER T AH N AH N S
IMPERTINENCES	IH M P ER T AH N AH N S IH Z
IMPORTANCE	IH M P AO R T AH N S
IMPORTANCES	IH M P OW R T AH N S IH Z
IMPOTENCE	IH M P AH T AH N S
IMPOTENCES	IH M P AH T AH N S IH Z
IMPROVIDENCE	IH M P R AA V AH D AH N S
IMPROVIDENCES	IH M P R AA V AH D AH N S IH Z
IMPRUDENCE	IH M P R UW D AH N S
IMPRUDENCES	IH M P R UW D AH N S IH Z
IMPUDENCE	IH M P Y AH D AH N S
IMPUDENCES	IH M P Y AH D AH N S IH Z
IMPUISSANCE	IH M P Y UW AH S AH N S
IMPUISSANCES	IH M P Y UW AH S AH N S IH Z
INACCESSIBILITIES	IH N AE K S EH S AH B IH L AH T IY Z
INACCESSIBILITY	IH N AH K S EH S AH B IH L AH T IY
INACCESSIBLE	IH N AH K S EH S AH B AH L
INACCESSIBLY	IH N AE K S EH S AH B L IY
INADVERTENCE	IH N AH D V ER T AH N S
INADVERTENCE(2)	IH N AE D V ER T AH N S
INADVERTENCES	IH N AE D V ER T AH N S IH Z
INAPPETENCE	AH N AE P AH T AH N S
INAPPETENCES	AH N AE P AH T EH N S AH Z
INCALESCENCE	IH N K AH L EH S AH N S
INCALESCENCES	IH N K AH L AH S EH N S AH Z
INCALESCENT	IH N K AH L EH S AH N T
INCANDESCE	IH N K AH N D EH S
INCANDESCED	IH N K AH N D EH S T
INCANDESCENCE	IH N K AH N D EH S AH N S
INCANDESCENCES	IH N K AH N D EH S AH N S IH Z
INCANDESCENT	IH N K AH N D EH S AH N T
INCANDESCENTLY	IH N K AH N D EH S AH N T L IY
INCANDESCENTS	IH N K AH N D EH S AH N T S
INCANDESCES	IH N K AH N D EH S IH Z
INCARCERATE	IH N K AA R S ER EY T
INCARCERATED	IH N K AA R S ER EY T IH D
INCARCERATES	IH N K AA R S ER EY T S
INCARCERATING	IH N K AA R S ER EY T IH NG
INCARCERATION	IH N K AA R S ER EY SH AH N
INCARCERATIONS	IH N K AA R S AH R EY SH AH N Z
INCENDIARIES	IH N S EH N D IY EH R IY Z
INCENDIARISM	IH N S EH N D IY AH R IH Z AH M
INCENDIARISMS	IH N S EH N D IY AH R AH Z AH M Z
INCENDIARY	IH N S EH N D IY EH R IY
INCENSE	IH N S EH N S
INCENSED	IH N S EH N S T
INCENSES	IH N S EH N S IH Z
INCENSING	IH N S EH N S IH NG
INCENTER	IH N S EH N T ER
INCENTERS	IH N S EH N T ER Z
INCENTIVE	IH N S EH N T IH V
INCENTIVE(2)	IH N S EH N IH V
INCENTIVES	IH N S EH N T IH V Z
INCENTIVES(2)	IH N S IH N IH V Z
INCENTIVIZE	IH N S EH N T IH V AY Z
INCENTIVIZED	IH N S EH N T IH V AY Z D
INCENTIVIZES	IH N S EH N T IH V AY Z IH Z
INCENTIVIZING	IH N S EH N T IH V AY Z IH NG
INCEPT	IH N S EH P T
INCEPTED	IH N S EH P T IH D
INCEPTING	IH N S EH P T IH NG
INCEPTION	IH N S EH P SH AH N
INCEPTIONS	IH N S EH P SH AH N Z
INCEPTIVE	IH N S EH P T IH V
INCEPTIVELY	IH N S EH P T IH V L IY
INCEPTIVES	IH N S EH P T IH V Z
INCEPTOR	IH N S EH P T ER
INCEPTORS	IH N S EH P T ER Z
INCEPTS	IH N S EH P T S
INCERTITUDE	IH N S ER T AH T UW D
INCERTITUDES	IH N S ER T AH T UW D Z
INCESSANCIES	IH N S EH S AH N S IY Z
INCESSANCY	IH N S EH S AH N S IY
INCESSANT	IH N S EH S AH N T
INCESSANTLY	IH N S EH S AH N T L IY
INCEST	IH N S EH S T
INCESTS	IH N S EH S T S
INCESTUOUS	IH N S EH S CH W AH S
INCESTUOUSLY	IH N S EH S CH AH W AH S L IY
INCESTUOUSNESS	IH N S EH S CH AH W AH S N AH S
INCESTUOUSNESSES	IH N S EH S CH AH W AH S N AH S IH Z
INCIDENCE	IH N S AH D AH N S
INCIDENCE(2)	IH N S IH D AH N S
INCIDENCES	IH N S AH D AH N S IH Z
INCIPIENCE	IH N S IH P IY AH N S
INCIPIENCES	IH N S IH P IY AH N S IH Z
INCOGNIZANCE	IH N K AA G N AH Z AH N S
INCOGNIZANCES	IH N K AA G N AH Z AH N S IH Z
INCOHERENCE	IH N K OW HH IH R AH N S
INCOHERENCES	IH N K OW HH IH ER AH N S IH Z
INCOMPETENCE	IH N K AA M P AH T AH N S
INCOMPETENCES	IH N K AA M P AH T AH N S IH Z
INCONCEIVABILITIES	IH N K AH N S IY V AH B IH L AH T EH Z
INCONCEIVABILITY	IH N K AH N S IY V AH B IH L AH T EH
INCONCEIVABLE	IH N K AH N S IY V AH B AH L
INCONCEIVABLENESS	IH N K AH N S IY V AH B AH L N AH S
INCONCEIVABLENESSES	IH N K AH N S IY V AH B AH L N AH S IH Z
INCONCEIVABLY	IH N K AH N S IY V AH B L IY
INCONGRUENCE	IH N K AH N G R UW AH N S
INCONGRUENCES	IH N K AH N G R UW AH N S IH Z
INCONSEQUENCE	IH N K AA N S AH K W AH N S
INCONSEQUENCES	IH N K AA N S AH K W AH N S IH Z
INCONSISTENCE	IH N K AH N S IH S T AH N S
INCONSISTENCES	IH N K AH N S IH S T AH N S IH Z
INCONSONANCE	IH N K AA N S AH N AH N S
INCONSONANCES	IH N K AA N S AH N AH N S IH Z
INCONTINENCE	IH N K AA N T AH N AH N S
INCONTINENCES	IH N K AA N T AH N AH N S IH Z
INCONVENIENCE	IH N K AH N V IY N Y AH N S
INCONVENIENCED	IH N K AH N V IY N Y AH N S T
INCONVENIENCES	IH N K AH N V IY N Y AH N S IH Z
INCRESCENT	IH N K R EH S AH N T
INCURRENCE	IH N K ER AH N S
INCURRENCES	IH N K ER AH N S IH Z
INDECENCIES	IH N D IY S AH N S IY Z
INDECENCY	IH N D IY S AH N S IY
INDECENT	IH N D IY S AH N T
INDECENTER	IH N D IY S EH N T ER
INDECENTEST	IH N D IY S AH N T AH S T
INDECENTLY	IH N D IY S AH N T L IY
INDEHISCENCE	IH N D AH HH IH S AH N S
INDEHISCENCES	IH N D AH HH IH S EH N S AH Z
INDEHISCENT	IH N D AH HH IH S AH N T
INDEPENDENCE	IH N D IH P EH N D AH N S
INDEPENDENCES	IH N D IH P EH N D AH N S IH Z
INDICES	IH N D IH S IY Z
INDICES(2)	IH N D AH S IH Z
INDIFFERENCE	IH N D IH F ER AH N S
INDIFFERENCE(2)	IH N D IH F R AH N S
INDIFFERENCES	IH N D IH F ER AH N S IH Z
INDIGENCE	IH N D IH JH AH N S
INDIGENCES	IH N D IH JH AH N S IH Z
INDISCERNIBLE	IH N D IH S ER N AH B AH L
INDOLENCE	IH N D AH L AH N S
INDOLENCES	IH N D AH L AH N S IH Z
INDUCE	IH N D UW S
INDUCED	IH N D UW S T
INDUCEMENT	IH N D UW S M AH N T
INDUCEMENTS	IH N D UW S M AH N T S
INDUCER	IH N D UW S ER
INDUCERS	IH N D UW S ER Z
INDUCES	IH N D UW S IH Z
INDUCTANCE	IH N D AH K T AH N S
INDUCTANCES	IH N D AH K T AH N S IH Z
INDULGENCE	IH N D AH L JH AH N S
INDULGENCES	IH N D AH L JH AH N S IH Z
INEFFACEABILITIES	IH N IH F EY S AH B IH L AH T EH Z
INEFFACEABILITY	IH N IH F EY S AH B IH L AH T EH
INEFFACEABLE	IH N IH F EY S AH B AH L
INEFFACEABLY	IH N IH F EY S AH B L IY
INELEGANCE	IH N EH L IH G AH N S
INELEGANCES	IH N EH L IH G AH N S IH Z
INEXISTENCE	IH N EH G Z IH S T AH N S
INEXISTENCES	IH N EH G Z IH S T AH N S IH Z
INEXPEDIENCE	IH N IH K S P IY D IY AH N S
INEXPEDIENCES	IH N IH K S P IY D IY AH N S IH Z
INEXPERIENCE	IH N IH K S P IH R IY AH N S
INEXPERIENCED	IH N EH K S P IH R IY AH N S T
INEXPERIENCES	IH N IH K S P IH R IY AH N S IH Z
INFERENCE	IH N F ER AH N S
INFERENCES	IH N F ER EH N S IH Z
INFLORESCENCE	IH N F L AH R EH S AH N S
INFLORESCENCES	IH N F L AH R AH S EH N S AH Z
INFLUENCE	IH N F L UW AH N S
INFLUENCEABLE	IH N F L UW AH N S AH B AH L
INFLUENCED	IH N F L UW AH N S T
INFLUENCES	IH N F L UW AH N S IH Z
INFREQUENCE	IH N F R EH K W AH N S
INFREQUENCES	IH N F R EH K W EH N S AH Z
INHERENCE	IH N HH IH ER AH N S
INHERENCES	IH N HH IH ER AH N S IH Z
INHERITANCE	IH N HH EH R AH T AH N S
INHERITANCES	IH N HH EH R AH T AH N S IH Z
INHERITRICES	IH N HH EH R AH T R AY S IH Z
INJUSTICE	IH N JH AH S T IH S
INJUSTICES	IH N JH AH S T AH S IH Z
INLACE	IH N L EY S
INLACED	IH N L EY S T
INLACES	IH N L EY S IH Z
INNOCENCE	IH N AH S AH N S
INNOCENCES	IH N AH S AH N S IH Z
INNOCENCIES	IH N AH S AH N S IY Z
INNOCENCY	IH N AH S AH N S IY
INNOCENT	IH N AH S AH N T
INNOCENTER	IH N AH S AH N T ER
INNOCENTEST	IH N AH S AH N T AH S T
INNOCENTLY	IH N AH S AH N T L IY
INNOCENTS	IH N AH S AH N T S
INOBSERVANCE	IH N AH B Z ER V AH N S
INOBSERVANCES	IH N AH B Z ER V AH N S IH Z
INSENTIENCE	IH N S EH N CH AH N S
INSENTIENCES	IH N S EH N CH AH N S IH Z
INSIGNIFICANCE	IH N S IH G N Y IH F IH K AH N S
INSIGNIFICANCES	IH N S IH G N IH F IH K AH N S IH Z
INSINCERE	IH N S IH N S IH R
INSINCERELY	IH N S IH N S IH ER L IY
INSINCERITIES	IH N S IH N S EH R AH T IY Z
INSINCERITY	IH N S IH N S EH R AH T IY
INSISTENCE	IH N S IH S T AH N S
INSISTENCES	IH N S IH S T AH N S IH Z
INSOLENCE	IH N S AH L AH N S
INSOLENCES	IH N S AH L AH N S IH Z
INSOUCIANCE	IH N S UW S IY AH N S
INSOUCIANCE(2)	IH N S UW S Y AH N S
INSOUCIANCES	IH N S UW S IY AH N S IH Z
INSTANCE	IH N S T AH N S
INSTANCED	IH N S T AH N S T
INSTANCES	IH N S T AH N S AH Z
INSTANCES(2)	IH N S T AH N S IH Z
INSURANCE	IH N SH UH R AH N S
INSURANCES	IH N SH UH R AH N S IH Z
INSURGENCE	IH N S ER JH AH N S
INSURGENCES	IH N S ER JH AH N S IH Z
INSUSCEPTIBILITIES	IH N S AH S EH P T AH B IH L AH T IY Z
INSUSCEPTIBILITY	IH N S AH S EH P T AH B IH L AH T IY
INSUSCEPTIBLE	IH N S AH S EH P T AH B AH L
INSUSCEPTIBLY	IH N S AH S EH P T AH B L IY
INTELLIGENCE	IH N T EH L AH JH AH N S
INTELLIGENCER	IH N T EH L AH JH AH N S ER
INTELLIGENCERS	IH N T EH L AH JH AH N S ER Z
INTELLIGENCES	IH N T EH L AH JH AH N S IH Z
INTEMPERANCE	IH N T EH M P ER AH N S
INTEMPERANCES	IH N T EH M P ER AH N S IH Z
INTENDANCE	IH N T EH N D AH N S
INTENDANCES	IH N T EH N D AH N S IH Z
INTERCEDE	IH N T ER S IY D
INTERCEDED	IH N T ER S IY D IH D
INTERCEDER	IH N T ER S IY D ER
INTERCEDERS	IH N T ER S IY D ER Z
INTERCEDES	IH N T ER S IY D Z
INTERCEDING	IH N T ER S IY D IH NG
INTERCELL	IH N T ER S EH L
INTERCELLULAR	IH N T ER S EH L Y AH L ER
INTERCENSAL	IH N T AH R S EH N Z AH L
INTERCEPT	IH N T ER S EH P T
INTERCEPT(2)	IH N ER S EH P T
INTERCEPTED	IH N T ER S EH P T AH D
INTERCEPTED(2)	IH N T ER S EH P T IH D
INTERCEPTED(3)	IH N ER S EH P T AH D
INTERCEPTED(4)	IH N ER S EH P T IH D
INTERCEPTER	IH N T ER S EH P T ER
INTERCEPTERS	IH N T ER S EH P T ER Z
INTERCEPTING	IH N T ER S EH P T IH NG
INTERCEPTING(2)	IH N ER S EH P T IH NG
INTERCEPTION	IH N T ER S EH P SH AH N
INTERCEPTION(2)	IH N ER S EH P SH AH N
INTERCEPTIONS	IH N T ER S EH P SH AH N Z
INTERCEPTIONS(2)	IH N ER S EH P SH AH N Z
INTERCEPTOR	IH N T ER S EH P T ER
INTERCEPTOR(2)	IH N ER S EH P T ER
INTERCEPTORS	IH N T ER S EH P T ER Z
INTERCEPTORS(2)	IH N ER S EH P T ER Z
INTERCEPTS	IH N T ER S EH P T S
INTERCEPTS(2)	IH N ER S EH P T S
INTERCESSION	IH N T ER S EH SH AH N
INTERCESSION(2)	IH N ER S EH SH AH N
INTERCESSIONAL	IH N T ER S EH SH AH N AH L
INTERCESSIONS	IH N T ER S EH SH AH N Z
INTERCESSOR	IH N T ER S EH S ER
INTERCESSORS	IH N T ER S EH S ER Z
INTERCESSORY	IH N T ER S EH S ER IY
INTERDEPENDENCE	IH N T ER D AH P EH N D AH N S
INTERDEPENDENCES	IH N T ER D IH P EH N D AH N S IH Z
INTERFACE	IH N T ER F EY S
INTERFACE(2)	IH N ER F EY S
INTERFACED	IH N T ER F EY S T
INTERFACES	IH N T ER F EY S IH Z
INTERFACES(2)	IH N ER F EY S IH Z
INTERFERENCE	IH N T ER F IH R AH N S
INTERFERENCE(2)	IH N ER F IH R AH N S
INTERFERENCES	IH N T ER F IH ER AH N S IH Z
INTERINFLUENCE	IH N T ER IH N F L UW AH N S
INTERINFLUENCED	IH N T ER IH N F L UW AH N S T
INTERINFLUENCES	IH N T ER IH N F L UW AH N S IH Z
INTERLACE	IH N T ER L EY S
INTERLACED	IH N T ER L EY S T
INTERLACEMENT	IH N T ER L EY S M AH N T
INTERLACEMENTS	IH N T ER L EY S M AH N T S
INTERLACES	IH N T ER L EY S IH Z
INTERMITTENCE	IH N T ER M IH T AH N S
INTERMITTENCES	IH N T ER M IH T AH N S IH Z
INTEROCEAN	IH N T ER OW SH AH N
INTEROCEANIC	IH N T ER OW SH IY AE N IH K
INTEROCEPTIVE	IH N T AH R AH S EH P T AH V
INTEROCEPTOR	IH N T AH R AH S EH P T AH R
INTEROCEPTORS	IH N T AH R AH S EH P T AH R Z
INTEROFFICE	IH N T ER AO F AH S
INTERPERCEPTUAL	IH N T ER P ER S EH P CH AH W AH L
INTERSERVICE	IH N T ER S ER V AH S
INTERSPACE	IH N T ER S P EY S
INTERSPACED	IH N T ER S P EY S T
INTERSPACES	IH N T ER S P EY S IH Z
INTERSTICE	IH N T ER S T AH S
INTERSTICES	IH N T ER S T AH S IH Z
INTOLERANCE	IH N T AA L ER AH N S
INTOLERANCES	IH N T AA L ER AH N S IH Z
INTRACELLULAR	IH N T R AH S EH L Y AH L ER
INTRACELLULARLY	IH N T R AH S EH L Y AH L ER L IY
INTRACEREBRAL	IH N T R AH S EH R AH B R AH L
INTRACEREBRALLY	IH N T R AH S EH R AH B R AH L IY
INTRANSIGEANCE	IH N T R AH N S AY JH IY AH N S
INTRANSIGEANCES	IH N T R AH N S AY JH IY AE N S AH Z
INTRANSIGENCE	IH N T R AE N S AH JH AH N S
INTRANSIGENCE(2)	IH N T R AE N S IH JH AH N S
INTRANSIGENCES	IH N T R AE N S AH JH AH N S IH Z
INTRODUCE	IH N T R AH D UW S
INTRODUCE(2)	IH N T R OW D UW S
INTRODUCED	IH N T R AH D UW S T
INTRODUCED(2)	IH N T R OW D UW S T
INTRODUCER	IH N T R AH D UW S ER
INTRODUCERS	IH N T R AH D UW S ER Z
INTRODUCES	IH N T R AH D UW S IH Z
INTRODUCES(2)	IH N T R OW D UW S IH Z
INTUMESCENCE	IH N T Y AH M EH S AH N S
INTUMESCENCES	IH N T Y AH M AH S EH N S AH Z
INTUMESCENT	IH N T Y AH M EH S AH N T
INTUSSUSCEPT	IH N T AH S AH S AH P T
INTUSSUSCEPTED	IH N T AH S AH S EH P T AH D
INTUSSUSCEPTING	IH N T AH S AH S EH P T AH NG
INTUSSUSCEPTION	IH N T AH S AH S EH P AH N
INTUSSUSCEPTIONS	IH N T AH S AH S EH P T IY AH N Z
INTUSSUSCEPTIVE	IH N T AH S AH S EH P T AH V
INTUSSUSCEPTS	IH N T AH S AH S AH P T S
INVARIANCE	IH N V EH R IY AH N S
INVARIANCES	IH N V EH R IY AH N S IH Z
INVOICE	IH N V OY S
INVOICED	IH N V OY S T
INVOICES	IH N V OY S IH Z
IRIDESCENCE	IH R AH D EH S AH N S
IRIDESCENCES	IH R AH D AH S EH N S AH Z
IRIDESCENT	IH R AH D EH S AH N T
IRIDESCENTLY	IH R AH D EH S EH N T L IY
IRRADIANCE	IH R EY D IY AH N S
IRRADIANCES	IH R EY D IY AH N S IH Z
IRRELEVANCE	IH R EH L AH V AH N S
IRRELEVANCES	IH R EH L AH V AH N S IH Z
IRREPLACEABILITIES	IH R IY P L EY S AH B IH L AH T EH Z
IRREPLACEABILITY	IH R IY P L EY S AH B IH L AH T EH
IRREPLACEABLE	IH R AH P L EY S AH B AH L
IRREPLACEABLENESS	IH R IY P L EY S AH B AH L N AH S
IRREPLACEABLENESSES	IH R IY P L EY S AH B AH L N AH S IH Z
IRREPLACEABLY	IH R IY P L EY S AH B L IY
IRREVERENCE	IH R EH V ER AH N S
IRREVERENCES	IH R EH V AH R AH N S IH Z
ISOSCELES	AY S AO S AH L IY Z
ISSUANCE	IH SH UW AH N S
ISSUANCES	IH SH UW AH N S IH Z
ITERANCE	IH T ER AH N S
ITERANCES	IH T ER AH N S IH Z
JAUNCE	JH AO N S
JAUNCED	JH AO N S T
JAUNCES	JH AO N S AH Z
JAUNDICE	JH AO N D AH S
JAUNDICED	JH AO N D IH S T
JAUNDICES	JH AO N D AH S
JOUNCE	JH AW N S
JOUNCED	JH AW N S T
JOUNCES	JH AW N S AH Z
JOYANCE	JH OY AH N S
JOYANCES	JH OY AH N S IH Z
JUBILANCE	JH UW B AH L AH N S
JUBILANCES	JH UW B AH L AH N S IH Z
JUICE	JH UW S
JUICED	JH UW S T
JUICEHEAD	JH UW S HH EH D
JUICEHEADS	JH UW S HH EH D Z
JUICELESS	JH UW S L AH S
JUICER	JH UW S ER
JUICERS	JH UW S ER Z
JUICES	JH UW S AH Z
JUICES(2)	JH UW S IH Z
JURISPRUDENCE	JH UH R AH S P R UW D AH N S
JURISPRUDENCES	JH UH R AH S P R UW D AH N S IH Z
JUSTICE	JH AH S T AH S
JUSTICE(2)	JH AH S T IH S
JUSTICES	JH AH S T AH S AH Z
JUSTICES(2)	JH AH S T IH S IH Z
JUVENESCENCE	JH UW V AH N EH S AH N S
JUVENESCENCES	JH UW V AH N AH S EH N S AH Z
JUVENESCENT	JH UW V AH N EH S AH N T
KYLICES	K AY L AH S
LACE	L EY S
LACED	L EY S T
LACELESS	L EY S L AH S
LACELIKE	L EY S L AY K
LACER	L EY S ER
LACERATE	L AE S ER EY T
LACERATED	L AE S AH R EY T IH D
LACERATES	L AE S AH R EY T S
LACERATING	L AE S AH R EY T IH NG
LACERATION	L AE S ER EY SH AH N
LACERATIONS	L AE S ER EY SH AH N Z
LACERATIVE	L AE S AH R EY T IH V
LACERS	L EY S ER Z
LACERTID	L AH S AH R T AH D
LACERTIDS	L AH S AH R T AH D Z
LACES	L EY S AH Z
LACES(2)	L EY S IH Z
LACEWING	L EY S W IH NG
LACEWINGS	L EY S W IH NG Z
LACEWOOD	L EY S W UH D
LACEWOODS	L EY S W UH D Z
LACEWORK	L EY S W ER K
LACEWORKS	L EY S W ER K S
LACEY	L EY S IY
LAITANCE	L EY T AH N S
LAITANCES	L EY T AE N S AH Z
LANCE	L AE N S
LANCED	L AE N S T
LANCELET	L AE N S L AH T
LANCELETS	L AE N S L AH T S
LANCEOLATE	L AE N S IY AH L EY T
LANCER	L AE N S ER
LANCERS	L AE N S ER Z
LANCES	L AE N S IH Z
LANCET	L AE N S AH T
LANCETED	L AE N S T EH D
LANCETS	L AE N S AH T S
LANCEWOOD	L AE N S W UH D
LANCEWOODS	L AE N S W UH D Z
LARCENER	L AA R S IY N AH R
LARCENERS	L AA R S AH N AH R Z
LARCENIES	L AA R S AH N IY Z
LARCENIST	L AA R S AH N AH S T
LARCENISTS	L AA R S AH N AH S T S
LARCENOUS	L AA R S AH N AH S
LARCENOUSLY	L AA R S EH N OW AH S L IY
LARCENY	L AA R S AH N IY
LATICES	L EY T IH K S IH Z
LATTICE	L AE T AH S
LATTICED	L AE T AH S T
LATTICES	L AE T AH S IH Z
LATTICEWORK	L AE T AH S W ER K
LATTICEWORKS	L AE T AH S W ER K S
LAUNCE	L AO N S
LAUNCES	L AO N S AH Z
LENIENCE	L IY N IY AH N S
LENIENCES	L IY N IY AH N S IH Z
LENTICEL	L EH N T AH S AH L
LENTICELS	L EH N T AH S AH L Z
LEPTOCEPHALI	L EH P T AH S EH F AH L IY
LEPTOCEPHALUS	L EH P T AH S EH F AH L AH S
LETTERSPACE	L EH T ER S P EY S
LETTERSPACES	L EH T ER S P EY S IH Z
LETTUCE	L EH T AH S
LETTUCES	L EH T Y UW S AH Z
LEUCEMIA	L UW S IY M IY AH
LEUCEMIAS	L UW S IY M IY AH Z
LEUCEMIC	L UW S AH M AH K
LICE	L AY S
LICENCE	L AY S AH N S
LICENCED	L AY S AH N S T
LICENCEE	L AY S AH N S IY
LICENCEES	L AY S AH N S IY Z
LICENCER	L AY S AH N S ER
LICENCERS	L AY S AH N S ER Z
LICENCES	L AY S AH N S IH Z
LICENCING	L AY S AH N S IH NG
LICENSABLE	L AY S AH N S AH B AH L
LICENSE	L AY S AH N S
LICENSED	L AY S AH N S T
LICENSEE	L AY S AH N S IY
LICENSEES	L AY S AH N S IY Z
LICENSER	L AY S AH N S ER
LICENSERS	L AY S AH N S ER Z
LICENSES	L AY S AH N S IH Z
LICENSING	L AY S AH N S IH NG
LICENSOR	L AY S AH N S ER
LICENSORS	L AY S AH N S ER Z
LICENSURE	L AY S AH N CH ER
LICENSURES	L AY S AH N CH ER Z
LICENTE	L IH S AH N T
LICENTIATE	L AY S AH N T IY AH T
LICENTIATES	L AY S AH N T IY AH T S
LICENTIOUS	L AY S EH N CH AH S
LICENTIOUSLY	L AY S AH N T IY AH S L IY
LICENTIOUSNESS	L AY S AH N T IY AH S N AH S
LICENTIOUSNESSES	L AY S AH N T IY AH S N AH S IH Z
LICORICE	L IH K ER IH SH
LICORICES	L AY S ER IH K S IH Z
LIGHTFACE	L AY T F EY S
LIGHTFACED	L AY T F EY S T
LIGHTFACES	L AY T F EY S IH Z
LIGNOCELLULOSE	L IH G N AH S EH L AH L OW Z
LIGNOCELLULOSES	L IH G N AH S EH L AH L OW Z AH Z
LIGNOCELLULOSIC	L IH G N AH S AH L UW L AH Z AH K
LIQUESCENT	L AH K EH S AH N T
LIQUORICE	L IH K ER AY S
LIQUORICES	L IH K ER IH K S IH Z
LUCE	L UW S
LUCENCE	L UW S AH N S
LUCENCES	L UW S AH N S IH Z
LUCENCIES	L UW S AH N S IY Z
LUCENCY	L UW S AH N S IY
LUCENT	L UW S IH N T
LUCENTLY	L UW S AH N T L IY
LUCERN	L UW S AH R N
LUCERNE	L UW S ER N
LUCERNES	L UW S AH R N Z
LUCERNS	L UW S AH R N Z
LUCES	L UW S AH Z
LUMINANCE	L UW M AH N AH N S
LUMINANCES	L UW M AH N AH N S IH Z
LUMINESCE	L UW M AH N EH S
LUMINESCED	L UW M AH N EH S T
LUMINESCENCE	L UW M AH N EH S AH N S
LUMINESCENCES	L UW M AH N EH S AH N S IH Z
LUMINESCENT	L UW M AH N EH S AH N T
LUMINESCES	L UW M AH N EH S IH Z
LUXURIANCE	L AH G ZH UH R IY AH N S
LUXURIANCES	L AH G ZH UH R IY AH N S IH Z
LYCEA	L IH S IY AH
LYCEE	L AY S IY IY
LYCEES	L AY S IY Z
LYCEUM	L IH S IY AH M
LYCEUMS	L IH S IY AH M Z
LYNCEAN	L IH N S IY AH N
MACE	M EY S
MACED	M AE K T
MACEDOINE	M AE S AH D OY N
MACEDOINES	M AE S AH D OY N Z
MACER	M EY S AH R
MACERATE	M AE S AH R EY T
MACERATED	M AE S AH R EY T AH D
MACERATES	M AE S AH R EY T S
MACERATING	M AE S AH R EY T AH NG
MACERATION	M AE S AH R EY SH AH N
MACERATIONS	M AE S AH R EY T IY AH N Z
MACERATOR	M AE S AH R EY T AH R
MACERATORS	M AH S EH R AH T AH R Z
MACERS	M AE S AH R Z
MACES	M AE K S
MAGNETORESISTANCE	M AE G N AH T OW R Z IH S T AH N S
MAGNETORESISTANCES	M AE G N AH T OW R Z IH S T AH N S IH Z
MAGNIFICENCE	M AE G N IH F AH S AH N S
MAGNIFICENCES	M AE G N IH F AH S AH N S IH Z
MAGNIFICENT	M AE G N IH F AH S AH N T
MAGNIFICENT(2)	M AE G N IH F IH S AH N T
MAGNIFICENTLY	M AE G N IH F AH S AH N T L IY
MAGNILOQUENCE	M AE G N AH L AA K W AH N S
MAGNILOQUENCES	M AE G N AH L AA K W EH N S AH Z
MAINTENANCE	M EY N T AH N AH N S
MAINTENANCE(2)	M EY N T N AH N S
MAINTENANCES	M EY N T AH N AH N S IH Z
MALEFICENCE	M AH L AH F IH S AH N S
MALEFICENCES	M AH L AH F IH S EH N S AH Z
MALEFICENT	M AH L AH F IH S AH N T
MALEVOLENCE	M AH L EH V AH L AH N S
MALEVOLENCES	M AH L EH V AH L AH N S IH Z
MALFEASANCE	M AE L F IY Z AH N S
MALFEASANCES	M AE L F IY Z AH N S IH Z
MALICE	M AE L AH S
MALICE(2)	M AE L IH S
MALICES	M AE L AH S IH Z
MALIGNANCE	M AH L AY N AH N S
MALIGNANCES	M AH L AY N AH N S IH Z
MALPRACTICE	M AE L P R AE K T AH S
MALPRACTICE(2)	M AE L P R AE K T IH S
MALPRACTICES	M AE L P R AE K T AH S IH Z
MANTELPIECE	M AE N T AH L P IY S
MANTELPIECES	M AE N T AH L P IY S IH Z
MARCEL	M AA R S EH L
MARCELLED	M AA R S EH L D
MARCELLING	M AA R S EH L IH NG
MARCELS	M AA R S EH L Z
MARKETPLACE	M AA R K AH T P L EY S
MARKETPLACE(2)	M AA R K IH T P L EY S
MARKETPLACES	M AA R K AH T P L EY S IH Z
MASTERPIECE	M AE S T ER P IY S
MASTERPIECES	M AE S T ER P IY S AH Z
MASTERPIECES(2)	M AE S T ER P IY S IH Z
MATRICES	M EY T R IH S IH Z
MECHANORECEPTION	M EH CH AH N AO R AH S EH P AH N
MECHANORECEPTIONS	M AH CH AE N AH R AH S EH P T IY AH N Z
MECHANORECEPTIVE	M EH CH AH N AO R AH S EH P T AH V
MECHANORECEPTOR	M EH CH AH N AO R AH S EH P T AH R
MECHANORECEPTORS	M AH CH AE N AH R AH S EH P T AH R Z
MEDIATRICES	M IY D IY AE T R AH S
MENACE	M EH N AH S
MENACE(2)	M EH N IH S
MENACED	M EH N AH S T
MENACED(2)	M EH N IH S T
MENACER	M EH N AH S ER
MENACERS	M EH N AH S ER Z
MENACES	M EH N AH S IH Z
MENACES(2)	M EH N IH S IH Z
MENINGOENCEPHALITIC	M AH N IH N G OW AH N S EH F AH L AH T AH K
MENINGOENCEPHALITIDES	M AH N AH N G OW AH N S AH F AE L AH T AY D Z
MENINGOENCEPHALITIS	M EH N IH N G OW EH N S EH F AH L AY T AH S
MERCENARIES	M ER S AH N EH R IY Z
MERCENARILY	M ER S AH N EH R IY L IY
MERCENARINESS	M ER S AH N EH R IY N AH S
MERCENARINESSES	M ER S AH N EH R IY N AH S IH Z
MERCENARY	M ER S AH N EH R IY
MERCER	M ER S ER
MERCERIES	M ER S ER IY Z
MERCERISE	M AH R S AH R AY Z
MERCERISED	M ER S ER IY Z D
MERCERISES	M ER S ER IY Z IH Z
MERCERISING	M ER S ER IY Z IH NG
MERCERIZATION	M ER S ER AH Z EY SH AH N
MERCERIZATIONS	M ER S ER AH Z EY SH AH N Z
MERCERIZE	M ER S ER AY Z
MERCERIZED	M ER S ER AY Z D
MERCERIZES	M ER S ER AY Z IH Z
MERCERIZING	M ER S ER AY Z IH NG
MERCERS	M ER S ER Z
MERCERY	M ER S ER IY
MERGENCE	M ER JH AH N S
MERGENCES	M ER JH AH N S IH Z
MESALLIANCE	M IY Z AH L IY AH N S
MESALLIANCES	M IY Z AH L IY AH N S IH Z
MESENCEPHALA	M EH S AH N S EH F AH L AH
MESENCEPHALIC	M AH S EH N S AH F AH L AH K
MESENCEPHALON	M EH S AH N S EH F AH L AH N
MESOTHORACES	M EH S AH TH AO R AH S AH Z
METACENTER	M EH T AH S EH N T ER
METACENTERS	M EH T AH S EH N T ER Z
METACENTRIC	M EH T AH S EH N T R IH K
METACENTRICS	M EH T AH S EH N T R IH K S
METACERCARIA	M EH T AH S AH R K AE R IY AH
METACERCARIAE	M EH T AH S AH R K AE R IY IY
METACERCARIAL	M EH T EY S ER K EH R IY AH L
METATHORACES	M EH T AH TH AO R AH S AH Z
METENCEPHALA	M EH T AH N S EH F AH L AH
METENCEPHALIC	M AH T EH N S AH F AH L AH K
METENCEPHALON	M EH T AH N S EH F AH L AH N
METENCEPHALONS	M EH T AH N S EH F AH L AH N Z
METHYLCELLULOSE	M EH TH AH L S EH L Y AH L OW S
METHYLCELLULOSES	M EH TH AH L S EH L Y AH L OW S IH Z
MICACEOUS	M AH K AH S IY AH S
MICE	M AY S
MICELL	M IH S AH L
MICELLA	M AH S EH L AH
MICELLAE	M AH S EH L IY
MICELLAR	M AY S EH L ER
MICELLE	M AY S EH L
MICELLES	M AY S EH L Z
MICELLS	M IH S AH L Z
MICROBALANCE	M AY K R OW B AE L AH N S
MICROBALANCES	M AY K R OW B AE L AH N S IH Z
MICROCEPHALIC	M AY K R AH S EH F AH L AH K
MICROCEPHALICS	M AY K R AH S EH F AH L AH S Z
MICROCEPHALIES	M AY K R AH S EH F AH L AY Z
MICROCEPHALY	M AY K R AH S EH F AH L IY
MICROLUCES	M AY K R AH L UW S AH Z
MICROPROCESSOR	M AY K R OW P R AA S EH S ER
MICROPROCESSORS	M AY K R OW P R AA S EH S ER Z
MIDSPACE	M IH D S P EY S
MIDSPACES	M IH D S P EY S IH Z
MILITANCE	M IH L AH T AH N S
MILITANCES	M IH L AH T AH N S IH Z
MILLILUCES	M IH L AH L UW S AH Z
MILLRACE	M IH L R EY S
MILLRACES	M IH L R EY S IH Z
MINCE	M IH N S
MINCED	M IH N S T
MINCEMEAT	M IH N S M IY T
MINCEMEATS	M IH N S M IY T S
MINCER	M IH N S ER
MINCERS	M IH N S ER Z
MINCES	M IH N S IH Z
MISALLIANCE	M IH S AH L AY AH N S
MISALLIANCES	M IH S AH L AY AH N S IH Z
MISBALANCE	M IH S B AE L AH N S
MISBALANCED	M IH S B AE L AH N S T
MISBALANCES	M IH S B AE L AH N S IH Z
MISCEGENATION	M IH S EH JH AH N EY SH AH N
MISCEGENATIONAL	M IH S EH JH AH N EY SH AH N AH L
MISCEGENATIONS	M IH S EH JH AH N EY SH AH N Z
MISCELLANEA	M IH S EH L EY N IY AH
MISCELLANEOUS	M IH S AH L EY N IY AH S
MISCELLANEOUSLY	M IH S AH L EY N IY AH S L IY
MISCELLANEOUSNESS	M IH S AH L EY N IY AH S N AH S
MISCELLANEOUSNESSES	M IH S AH L EY N IY AH S N AH S IH Z
MISCELLANIES	M IH S AH L EY N IY Z
MISCELLANIST	M IH S EH L AH N AH S T
MISCELLANISTS	M IH S EH L AH N AH S T S
MISCELLANY	M IH S AH L EY N IY
MISCHANCE	M IH S CH AE N S
MISCHANCES	M IH S CH AE N S IH Z
MISCHOICE	M IH S CH OY S
MISCHOICES	M IH S CH OY S IH Z
MISCONCEIVE	M IH S K AH N S IY V
MISCONCEIVED	M IH S K AH N S IY V D
MISCONCEIVER	M IH S K AH N S IY V ER
MISCONCEIVERS	M IH S K AH N S IY V ER Z
MISCONCEIVES	M IH S K AH N S IY V Z
MISCONCEIVING	M IH S K AH N S IY V IH NG
MISCONCEPTION	M IH S K AH N S EH P SH AH N
MISCONCEPTIONS	M IH S K AH N S EH P SH AH N Z
MISFEASANCE	M IH S F IY Z AH N S
MISFEASANCES	M IH S F IY Z AH N S IH Z
MISGUIDANCE	M IH S G AY D AH N S
MISGUIDANCES	M IH S G AY D AH N S IH Z
MISPERCEIVE	M IH S P ER S IY V
MISPERCEIVED	M IH S P ER S IY V D
MISPERCEIVES	M IH S P ER S IY V Z
MISPERCEIVING	M IH S P ER S IY V IH NG
MISPERCEPTION	M IH S P ER S EH P SH AH N
MISPERCEPTIONS	M IH S P ER S EH P SH AH N Z
MISPLACE	M IH S P L EY S
MISPLACED	M IH S P L EY S T
MISPLACEMENT	M IH S P L EY S M AH N T
MISPLACEMENTS	M IH S P L EY S M AH N T S
MISPLACES	M IH S P L EY S IH Z
MISPRICE	M IH S P R AY S
MISPRICED	M IH S P R AY S T
MISPRICES	M IH S P R AY S IH Z
MISPRONOUNCE	M IH S P R AH N AW N S
MISPRONOUNCED	M IH S P R AH N AW N S T
MISPRONOUNCES	M IH S P R AH N AW N S IH Z
MISREFERENCE	M IH S R EH F AH R AH N S
MISREFERENCES	M IH S R EH F AH R AH N S IH Z
MISSPACE	M IH S P EY S
MISSPACED	M IH S P EY S T
MISSPACES	M IH S P EY S IH Z
MISTRACE	M IH S T R EY S
MISTRACED	M IH S T R EY S T
MISTRACES	M IH S T R EY S IH Z
MONOGLYCERIDE	M AH N AA G L IH S AH R AY D
MONOGLYCERIDES	M AH N AA G L IH S AH R AY D Z
MONSTRANCE	M AA N S T R AH N S
MONSTRANCES	M AA N S T R AE N S AH Z
MOONFACED	M UW N F EY S T
MORCEAU	M AO R S IY UW
MORCEAUX	M AO R S IY AH K S
MORTICE	M AO R T AY S
MORTICED	M AO R T IH K S T
MORTICES	M AO R T IH K S IH Z
MOUTHPIECE	M AW TH P IY S
MOUTHPIECES	M AW TH P IY S IH Z
MULTICELL	M AH L T AY S EH L
MULTICELLED	M AH L T AY S EH L D
MULTICELLULAR	M AH L T AY S EH L Y AH L ER
MULTICELLULARITIES	M AH L T AY S EH L Y AH L ER AH T IY Z
MULTICELLULARITY	M AH L T AY S EH L Y AH L ER AH T IY
MULTICENTER	M AH L T IY S EH N T ER
MULTIFACETED	M AH L T IY F AE S AH T IH D
MULTIPIECE	M AH L T AY P IY S
MULTIPROCESSING	M AH L T AY P R AA S EH S IH NG
MULTIPROCESSINGS	M AH L T AY P R AA S EH S IH NG Z
MULTIPROCESSOR	M AH L T IY P R AA S EH S ER
MULTIPROCESSORS	M AH L T AY P R OW S EH S ER Z
MULTISERVICE	M AH L T AY S ER V AH S
MULTISOURCE	M AH L T AY S OW R S
MULTIVALENCE	M AH L T AY V EY L AH N S
MULTIVALENCES	M AH L T AY V EY L AH N S IH Z
MUNIFICENCE	M Y UW N AH F IH S AH N S
MUNIFICENCES	M Y UW N AH F IH S EH N S AH Z
MUNIFICENT	M Y UW N AH F IH S AH N T
MUNIFICENTLY	M Y UW N IH F AH S EH N T L IY
MURICES	M Y UH R AH S
MYCELE	M AH S IY L
MYCELES	M AH S IY L Z
MYCELIA	M AH S IY L Y AH
MYCELIAL	M AH S IY L IY AH L
MYCELIAN	M AH S IY L IY AH N
MYCELIUM	M AH S IY L IY AH M
MYCELOID	M IH S AH L OY D
MYCETOMA	M AH S EH T AH M AH
MYCETOMAS	M AH S EH T AH M AH Z
MYCETOMATA	M IH S AH T AA M AH T AH
MYCETOMATOUS	M IH S AH T AA M AH T AH S
MYCETOPHAGOUS	M AH S EH T AH F EY JH AH S
MYCETOZOAN	M IH S AH T AA Z OW AH N
MYCETOZOANS	M AH S EH T AH Z OW N Z
MYELENCEPHALA	M AY AH L AH N S EH F AH L AH
MYELENCEPHALIC	M AY AH L EH N S AH F AH L AH K
MYELENCEPHALON	M AY AH L AH N S EH F AH L AH N
MYELENCEPHALONS	M AY AH L AH N S EH F AH L AH N Z
MYXOMYCETE	M IH K S AA M AH S IY T
MYXOMYCETES	M IH K S AA M AH S IY T S
NACELLE	N AE S AH L
NACELLES	N AE S AH L Z
NANCE	N AE N S
NANCES	N AE N S AH Z
NARCEIN	N AA R S IY N
NARCEINE	N AA R S IY N
NARCEINES	N AA R S IY N Z
NARCEINS	N AA R S IY N Z
NASCENCE	N EY S AH N S
NASCENCES	N EY S AH N S IH Z
NASCENCIES	N EY S AH N S IY Z
NASCENCY	N EY S AH N S IY
NASCENT	N EY S AH N T
NAVICERT	N AE V AH S AH R T
NAVICERTS	N AE V AH S AH R T S
NECESSARIES	N EH S AH S EH R IY Z
NECESSARILY	N EH S AH S EH R AH L IY
NECESSARY	N EH S AH S EH R IY
NECESSITARIAN	N AH S EH S AH T EH R IY AH N
NECESSITARIANISM	N AH S EH S AH T AE R IY AH N IH Z AH M
NECESSITARIANISMS	N AH S EH S AH T AH R IY AH N AH Z AH M Z
NECESSITARIANS	N AH S EH S AH T AE R IY AH N Z
NECESSITATE	N AH S EH S AH T EY T
NECESSITATED	N AH S EH S AH T EY T AH D
NECESSITATES	N AH S EH S AH T EY T S
NECESSITATING	N AH S EH S IH T EY T IH NG
NECESSITATION	N IH S EH S AH T EY SH AH N
NECESSITATIONS	N IH S EH S AH T EY SH AH N Z
NECESSITIES	N AH S EH S IH T IY Z
NECESSITOUS	N IH S EH S AH T AH S
NECESSITOUSLY	N IH S EH S AH T AH S L IY
NECESSITOUSNESS	N IH S EH S AH T AH S N AH S
NECESSITOUSNESSES	N IH S EH S AH T AH S N AH S IH Z
NECESSITY	N AH S EH S AH T IY
NECESSITY(2)	N AH S EH S IH T IY
NECKLACE	N EH K L AH S
NECKLACES	N EH K L AH S IH Z
NECROMANCER	N EH K R AH M AE N S ER
NECROMANCERS	N EH K R AH M AE N S AH R Z
NEGLIGENCE	N EH G L AH JH AH N S
NEGLIGENCE(2)	N EH G L IH JH AH N S
NEGLIGENCES	N EH G L IH JH AH N S IH Z
NEOCORTICES	N IY AH K AO R T AH S
NESCIENCE	N EH SH AH N S
NESCIENCES	N AH SH AH N S AH Z
NEUROSCIENCE	N Y UH R OW S AY AH N S
NEUROSCIENCES	N Y UH R AH SH AH N S AH Z
NICE	N AY S
NICE(2)	N IY S
NICELY	N AY S L IY
NICENESS	N AY S N AH S
NICENESSES	N AY S N AH S IH Z
NICER	N AY S ER
NICEST	N AY S IH S T
NICETIES	N AY S IH T IY Z
NICETY	N AY S IH T IY
NIECE	N IY S
NIECES	N IY S IH Z
NITROCELLULOSE	N AY T R OW S EH L Y AH L OW S
NITROCELLULOSES	N IH T R AH S EH L AH L OW Z AH Z
NITROGLYCERIN	N AY T R OW G L IH S ER AH N
NITROGLYCERIN(2)	N AY T R AH G L IH S ER AH N
NITROGLYCERIN(3)	N AY CH R AH G L IH S ER AH N
NITROGLYCERINE	N AY T R OW G L IH S ER AH N
NITROGLYCERINE(2)	N AY T R AH G L IH S ER AH N
NITROGLYCERINE(3)	N AY CH R AH G L IH S ER AH N
NITROGLYCERINES	N AY T R OW G L IH S AH R AH N Z
NITROGLYCERINS	N IH T R AH G L IH S AH R AH N Z
NOCENT	N OW S AH N T
NOCICEPTIVE	N OW S IY S EH P T IH V
NONACCEPTANCE	N AA N AE K S EH P T AH N S
NONACCEPTANCES	N AA N AE K S EH P T AH N S IH Z
NONADJACENT	N AA N AH JH EY S AH N T
NONAPPEARANCE	N AA N AH P IH ER AH N S
NONAPPEARANCES	N AA N AH P IH ER AH N S IH Z
NONASCETIC	N AA N AH S EH T IH K
NONASCETICS	N AA N AH S EH T IH K S
NONATTENDANCE	N AA N AH T EH N D AH N S
NONATTENDANCES	N AA N AH T EH N D AH N S IH Z
NONCANCELABLE	N AA N K AE N S AH L AH B AH L
NONCANCEROUS	N AA N K AE N S ER AH S
NONCE	N AA N S
NONCELEBRATION	N AA N S EH L AH B R EY SH AH N
NONCELEBRATIONS	N AA N S EH L AH B R EY SH AH N Z
NONCELEBRITIES	N AA N S AH L EH B R AH T IY Z
NONCELEBRITY	N AA N S AH L EH B R AH T IY
NONCELLULAR	N AA N S EH L Y AH L ER
NONCELLULOSIC	N AA N S EH L Y AH L OW S IH K
NONCENTRAL	N AA N S EH N T R AH L
NONCERTIFICATED	N AA N S ER T IH F IH K AH T IH D
NONCERTIFIED	N AA N S ER T AH F AY D
NONCES	N AA N S IH Z
NONCHALANCE	N AA N SH AH L AA N S
NONCHALANCES	N AA N CH AH L AE N S AH Z
NONCOINCIDENCE	N AA N K OW IH N S AH D AH N S
NONCOINCIDENCES	N AA N K OW IH N S AH D AH N S IH Z
NONCOMPLIANCE	N AA N K AH M P L AY AH N S
NONCOMPLIANCES	N AA N K AH M P L AY AH N S IH Z
NONCONCEPTUAL	N AA N K AH N S EH P CH AH W AH L
NONCONCERN	N AA N K AH N S ER N
NONCONCERNS	N AA N K AH N S ER N Z
NONCONCURRENCE	N AA N K AH N K ER AH N S
NONCONCURRENCES	N AA N K AH N K ER AH N S IH Z
NONCONFERENCE	N AA N K AA N F AH R AH N S
NONCONFERENCES	N AA N K AA N F AH R AH N S IH Z
NONCONFIDENCE	N AA N K AA N F AH D AH N S
NONCONFIDENCES	N AA N K AA N F AH D AH N S IH Z
NONCONFORMANCE	N AA N K AH N F AO R M AH N S
NONCONFORMANCES	N AA N K AH N F AO R M AH N S IH Z
NONDANCE	N AA N D AE N S
NONDANCER	N AA N D AE N S ER
NONDANCERS	N AA N D AE N S ER Z
NONDANCES	N AA N D AE N S IH Z
NONDECEPTIVE	N AA N D IH S EH P T IH V
NONENFORCEABILITIES	N AA N EH N F OW R S AH B IH L AH T EH Z
NONENFORCEABILITY	N AA N EH N F OW R S AH B IH L AH T EH
NONENFORCEMENT	N AA N EH N F OW R S M AH N T
NONENFORCEMENTS	N AA N EH N F OW R S M AH N T S
NONEQUIVALENCE	N AA N IH K W IH V AH L AH N S
NONEQUIVALENCES	N AA N IH K W IH V AH L AH N S IH Z
NONEVIDENCE	N AA N EH V AH D AH N S
NONEVIDENCES	N AA N EH V AH D AH N S IH Z
NONEXISTENCE	N AA N EH G Z IH S T AH N S
NONEXISTENCES	N AA N EH G Z IH S T AH N S IH Z
NONFEASANCE	N AA N F IY Z AH N S
NONFEASANCES	N AA N F IY Z AH N S IH Z
NONFLUORESCENT	N AA N F L UH R EH S AH N T
NONINDEPENDENCE	N AA N IH N D IH P EH N D AH N S
NONINDEPENDENCES	N AA N IH N D IH P EH N D AH N S IH Z
NONINFLUENCE	N AA N IH N F L UW AH N S
NONINFLUENCES	N AA N IH N F L UW AH N S IH Z
NONINSURANCE	N AA N IH N SH UH R AH N S
NONINSURANCES	N AA N IH N SH UH R AH N S IH Z
NONINTERFERENCE	N AA N IH N T ER F IH R AH N S
NONINTERFERENCES	N AA N IH N T ER F IH ER AH N S IH Z
NONNECESSITIES	N AA N IH S EH S AH T IY Z
NONNECESSITY	N AA N IH S EH S AH T IY
NONOBSCENE	N AA N AA B S IY N
NONOBSERVANCE	N AA N AH B Z ER V AH N S
NONOBSERVANCES	N AA N AH B Z ER V AH N S IH Z
NONOCCURRENCE	N AA N AH K ER AH N S
NONOCCURRENCES	N AA N AH K ER AH N S IH Z
NONPERFORMANCE	N AA N P ER F AO R M AH N S
NONPERFORMANCES	N AA N P ER F AO R M AH N S IH Z
NONPOLICE	N AA N P AH L IY S
NONRECEIPT	N AA N R IH S IY T
NONRECEIPTS	N AA N R IH S IY T S
NONRESIDENCE	N AA N R EH Z AH D AH N S
NONRESIDENCES	N AA N R EH Z AH D AH N S IH Z
NONRESISTANCE	N AA N R IH Z IH S T AH N S
NONRESISTANCES	N AA N R IH Z IH S T AH N S IH Z
NONSCIENCE	N AA N S AY AH N S
NONSCIENCES	N AA N S AY AH N S IH Z
NONSENTENCE	N AA N S EH N T AH N S
NONSENTENCES	N AA N S EH N T AH N S IH Z
NONSUCCESS	N AA N S AH K S EH S
NONSUCCESSES	N AA N S AH K S EH S IH Z
NONVIOLENCE	N AA N V AY AH L AH N S
NONVIOLENCES	N AA N V AY AH L AH N S IH Z
NOSEPIECE	N OW Z P IY S
NOSEPIECES	N OW Z P IY S IH Z
NOTICE	N OW T AH S
NOTICE(2)	N OW T IH S
NOTICEABLE	N OW T AH S AH B AH L
NOTICEABLY	N OW T IH S AH B L IY
NOTICED	N OW T IH S T
NOTICER	N OW T AH S ER
NOTICERS	N OW T AH S ER Z
NOTICES	N OW T IH S IH Z
NOVICE	N AA V AH S
NOVICES	N AA V AH S IH Z
NUANCE	N UW AA N S
NUANCED	N UW AA N S T
NUANCES	N UW AA N S IH Z
NUCELLAR	N Y UW S EH L AH R
NUCELLI	N Y UW S EH L IY
NUCELLUS	N Y UW S EH L AH S
NUISANCE	N UW S AH N S
NUISANCES	N UW S AH N S IH Z
NURTURANCE	N ER CH ER AH N S
NURTURANCES	N ER CH ER AH N S IH Z
OBEDIENCE	OW B IY D IY AH N S
OBEDIENCES	OW B IY D IY AH N S IH Z
OBEISANCE	OW B EY S AH N S
OBEISANCES	OW B EY Z AH N S IH Z
OBLANCEOLATE	AA B L AE N S IY AH L EY T
OBSCENE	AA B S IY N
OBSCENE(2)	AH B S IY N
OBSCENELY	AA B S IY N AH L IY
OBSCENELY(2)	AA B S IY N L IY
OBSCENER	AA B S IY N ER
OBSCENEST	AA B S IY N AH S T
OBSCENITIES	AA B S EH N IH T IY Z
OBSCENITY	AH B S EH N IH T IY
OBSERVANCE	AH B Z ER V AH N S
OBSERVANCES	AH B Z ER V AH N S IH Z
OBSOLESCE	AA B S AH L EH S
OBSOLESCED	AA B S AH L EH S T
OBSOLESCENCE	AA B S AH L EH S AH N S
OBSOLESCENCES	AA B S AH L EH S AH N S IH Z
OBSOLESCENT	AA B S AH L EH S AH N T
OBSOLESCENTLY	AA B S AH L EH S AH N T L IY
OBSOLESCES	AA B S AH L EH S IH Z
OCCURRENCE	AH K ER AH N S
OCCURRENCES	AH K ER AH N S IH Z
OCEAN	OW SH AH N
OCEANARIA	OW S AH N AE R IY AH
OCEANARIUM	OW S AH N AE R IY AH M
OCEANARIUMS	OW S AH N AE R IY AH M Z
OCEANAUT	OW S IY N AH T
OCEANAUTS	OW S IY N AH Y UW T S
OCEANFRONT	OW SH AH N F R AH N T
OCEANFRONTS	OW SH AH N F R AH N T S
OCEANGOING	OW SH AH N G OW IH NG
OCEANIC	OW SH IY AE N IH K
OCEANOGRAPHER	OW SH AH N AA G R AH F ER
OCEANOGRAPHERS	OW S AH N AA G R AH F AH R Z
OCEANOGRAPHIC	OW SH AH N AH G R AE F IH K
OCEANOGRAPHICAL	OW SH AH N AH G R AE F IH K AH L
OCEANOGRAPHICALLY	OW SH AH N AH G R AE F IH K AH L IY
OCEANOGRAPHIES	OW SH AH N AA G R AH F IY Z
OCEANOGRAPHY	OW SH AH N AA G R AH F IY
OCEANOLOGIES	OW SH AH N AA L AH JH IY Z
OCEANOLOGIST	OW SH AH N AA L AH JH AH S T
OCEANOLOGISTS	OW SH AH N AA L AH JH AH S T S
OCEANOLOGY	OW SH AH N AA L AH JH IY
OCEANS	OW SH AH N Z
OCELLAR	AH S EH L AH R
OCELLATE	AA S AH L EY T
OCELLI	AH S EH L IY
OCELLUS	AH S EH L AH S
OCELOID	AA S AH L OY D
OCELOT	AA S AH L AA T
OCELOTS	AA S AH L AA T S
OFFENCE	AH F EH N S
OFFENCES	AH F EH N S IH Z
OFFICE	AO F AH S
OFFICEHOLDER	AO F AH S HH OW L D ER
OFFICEHOLDERS	AO F AH S HH OW L D ER Z
OFFICER	AO F AH S ER
OFFICER(2)	AO F IH S ER
OFFICERED	AO F AH S ER D
OFFICERING	AO F AH S ER IH NG
OFFICERS	AO F AH S ER Z
OFFICERS(2)	AO F IH S ER Z
OFFICES	AO F AH S AH Z
OFFICES(2)	AO F AH S IH Z
OLIVACEOUS	OW L AH V AH S IY AH S
OMNICOMPETENCE	AA M N AH K AA M P AH T AH N S
OMNICOMPETENCES	AA M N AH K AA M P AH T EH N S AH Z
OMNIFICENT	AA M N AH F IH S AH N T
OMNIPOTENCE	AA M N IH P AH T AH N S
OMNIPOTENCES	AA M N IH P AH T AH N S IH Z
OMNIPRESENCE	AA M N AH P R EH Z AH N S
OMNIPRESENCES	AA M N IH P R AH Z EH N S AH Z
OMNISCIENCE	AA M N IH SH AH N S
OMNISCIENCES	AA M N IH SH AH N S IH Z
ONCE	W AH N S
ONCES	W AH N S IH Z
ONCHOCERCIASES	AO NG K AH S AH R S IY EY Z AH Z
ONCHOCERCIASIS	AO NG K AH S AH R S IY AH S AH S
OPALESCE	AA P AH L EH S
OPALESCED	AA P AH L EH S T
OPALESCENCE	OW P AH L EH S AH N S
OPALESCENCES	OW P AH L EH S AH N S IH Z
OPALESCENT	OW P AH L EH S AH N T
OPALESCENTLY	OW P AH L EH S AH N T L IY
OPALESCES	AA P AH L EH S AH Z
OPERCELE	AA P AH R S IY L
OPERCELES	AA P AH R S IY L Z
OPULENCE	AA P Y AH L AH N S
OPULENCES	AA P Y AH L AH N S IH Z
ORATRICES	AH R AE T R AH S
ORCEIN	AO R S IY N
ORCEINS	AO R S IY N Z
ORCHIDACEOUS	AO R K AH D EY S AH S
ORDINANCE	AO R D AH N AH N S
ORDINANCES	AO R D AH N AH N S IH Z
ORDNANCE	AO R D N AH N S
ORDNANCES	AO R D N AH N S IH Z
ORDONNANCE	AO R D AA N AH N S
ORDONNANCES	AO R D AA N AE N S AH Z
ORIFICE	AO R AH F AH S
ORIFICES	AO R AH F AH S AH Z
ORRICE	AO R AH S
ORRICES	AO R AH S
ORTHOCENTER	AO R TH AH S EH N T AH R
ORTHOCENTERS	AO R TH AH S EH N T AH R Z
OUNCE	AW N S
OUNCES	AW N S AH Z
OUNCES(2)	AW N S IH Z
OUTBALANCE	AW T B AE L AH N S
OUTBALANCED	AW T B AE L AH N S T
OUTBALANCES	AW T B AE L AH N S IH Z
OUTDANCE	AW T D AE N S
OUTDANCED	AW T D AE N S T
OUTDANCES	AW T D AE N S IH Z
OUTDISTANCE	AW T D IH S T AH N S
OUTDISTANCED	AW T D IH S T AH N S T
OUTDISTANCES	AW T D IH S T AH N S IH Z
OUTFACE	AW T F EY S
OUTFACED	AW T F EY S T
OUTFACES	AW T F EY S IH Z
OUTPACE	AW T P EY S
OUTPACED	AW T P EY S T
OUTPACES	AW T P EY S IH Z
OUTPLACEMENT	AW T P L EY S M AH N T
OUTPLACEMENTS	AW T P L EY S M AH N T S
OUTPRICE	AW T P R AY S
OUTPRICED	AW T P R AY S T
OUTPRICES	AW T P R AY S IH Z
OUTPRODUCE	AW T P R AH D UW S
OUTPRODUCED	AW T P R AH D UW S T
OUTPRODUCES	AW T P R AH D UW S IH Z
OUTRACE	AW T R EY S
OUTRACED	AW T R EY S T
OUTRACES	AW T R EY S IH Z
OUTRANCE	AW T R AH N S
OUTRANCES	AW T R AE N S AH Z
OUTREPRODUCE	AW T R IY P R AH D UW S
OUTREPRODUCED	AW T R IY P R AH D UW S T
OUTREPRODUCES	AW T R IY P R AH D UW S IH Z
OUTVOICE	AW T V OY S
OUTVOICED	AW T V OY S T
OUTVOICES	AW T V OY S IH Z
OVERABUNDANCE	OW V ER AH B AH N D AH N S
OVERABUNDANCES	OW V ER AH B AH N D AH N S IH Z
OVERACCENTUATE	OW V ER AE K S EH N CH AH W AH T
OVERACCENTUATED	OW V ER AE K S EH N CH AH W EY T IH D
OVERACCENTUATES	OW V ER AE K S EH N CH AH W AH T S
OVERACCENTUATING	OW V ER AE K S EH N CH AH W EY T IH NG
OVERBALANCE	OW V ER B AE L AH N S
OVERBALANCED	OW V ER B AE L AH N S T
OVERBALANCES	OW V ER B AE L AH N S IH Z
OVERCENTRALIZATION	OW V ER S EH N T R AH L AH Z EY SH AH N
OVERCENTRALIZATIONS	OW V ER S EH N T R AH L AH Z EY SH AH N Z
OVERCENTRALIZE	OW V ER S EH N T R AH L AY Z
OVERCENTRALIZED	OW V ER S EH N T R AH L AY Z D
OVERCENTRALIZES	OW V ER S EH N T R AH L AY Z IH Z
OVERCENTRALIZING	OW V ER S EH N T R AH L AY Z IH NG
OVERCOMPLIANCE	OW V ER K AH M P L AY AH N S
OVERCOMPLIANCES	OW V ER K AH M P L AY AH N S IH Z
OVERCONCENTRATION	OW V ER K AA N S AH N T R EY SH AH N
OVERCONCENTRATIONS	OW V ER K AA N S AH N T R EY SH AH N Z
OVERCONCERN	OW V ER K AH N S ER N
OVERCONCERNED	OW V ER K AH N S ER N D
OVERCONCERNING	OW V ER K AH N S ER N IH NG
OVERCONCERNS	OW V ER K AH N S ER N Z
OVERCONFIDENCE	OW V ER K AA N F IH D AH N S
OVERCONFIDENCES	OW V ER K AA N F AH D AH N S IH Z
OVERDEPENDENCE	OW V ER D IH P EH N D AH N S
OVERDEPENDENCES	OW V ER D IH P EH N D AH N S IH Z
OVERDOMINANCE	OW V ER D AA M AH N AH N S
OVERDOMINANCES	OW V ER D AA M AH N AH N S IH Z
OVERINDULGENCE	OW V ER IH N D AH L JH AH N S
OVERINDULGENCES	OW V ER IH N D AH L JH AH N S IH Z
OVERISSUANCE	OW V ER IH SH UW AH N S
OVERISSUANCES	OW V ER IH SH UW AH N S IH Z
OVERNICE	OW V ER N AY S
OVERPRICE	OW V ER P R AY S
OVERPRICED	OW V ER P R AY S T
OVERPRICES	OW V ER P R AY S IH Z
OVERPROCESS	OW V ER P R AA S EH S
OVERPROCESSED	OW V ER P R AA S EH S T
OVERPROCESSES	OW V ER P R AA S EH S IH Z
OVERPROCESSING	OW V ER P R AA S EH S IH NG
OVERPRODUCE	OW V ER P R AH D UW S
OVERPRODUCED	OW V ER P R AH D UW S T
OVERPRODUCES	OW V ER P R AH D UW S IH Z
OVERRELIANCE	OW V ER R IH L AY AH N S
OVERRELIANCES	OW V ER R IH L AY AH N S IH Z
OVERSAUCE	OW V ER S AO S
OVERSAUCED	OW V ER S AO S T
OVERSAUCES	OW V ER S AO S IH Z
OVERSERVICE	OW V ER S ER V AH S
OVERSERVICED	OW V ER S ER V AH S T
OVERSERVICES	OW V ER S ER V AH S IH Z
OXALACETATE	AA K S AH L AE S AH T EY T
OXALACETATES	AA K S AH L AE S AH T EY T S
OXALOACETATE	AA K S AH L OW S AH T EY T
OXALOACETATES	AA K S AH L OW S AH T EY T S
OXYACETYLENE	AA K S AY AH S EH T AH L IY N
OZOCERITE	AH Z AA S AH R AY T
OZOCERITES	AH Z AA S AH R AY T S
PACE	P EY S
PACED	P EY S T
PACEMAKER	P EY S M EY K ER
PACEMAKERS	P EY S M EY K ER Z
PACEMAKING	P EY S M EY K IH NG
PACEMAKINGS	P EY S M EY K IH NG Z
PACER	P EY S ER
PACERS	P EY S ER Z
PACES	P EY S IH Z
PACESETTER	P EY S EH T ER
PACESETTERS	P EY S EH T ER Z
PACESETTING	P EY S EH T IH NG
PALACE	P AE L AH S
PALACED	P AE L AH S T
PALACES	P AE L AH S IH Z
PALEFACE	P EY L F EY S
PALEFACES	P EY L F EY S IH Z
PANACEA	P AE N AH S IY AH
PANACEAN	P AH N EY S IY AH N
PANACEAS	P AE N AH S IY AH Z
PANCETTA	P AE N S EH T AH
PANCETTAS	P AE N S EH T AH Z
PAPILIONACEOUS	P AE P IH L Y AH N EY S AH S
PARCEL	P AA R S AH L
PARCELED	P AA R S AH L D
PARCELING	P AA R S AH L IH NG
PARCELING(2)	P AA R S L IH NG
PARCELLED	P AA R S AH L D
PARCELLING	P AA R S AH L IH NG
PARCELS	P AA R S AH L Z
PARCENARIES	P AA R S EH N AH R AY Z
PARCENARY	P AA R S AH N EH R IY
PARCENER	P AA R S IY N AH R
PARCENERS	P AA R S AH N AH R Z
PARLANCE	P AA R L AH N S
PARLANCES	P AA R L AH N S IH Z
PATIENCE	P EY SH AH N S
PATIENCES	P EY SH AH N S IH Z
PEACE	P IY S
PEACEABLE	P IY S AH B AH L
PEACEABLENESS	P IY S AH B AH L N AH S
PEACEABLENESSES	P IY S AH B AH L N AH S IH Z
PEACEABLY	P IY S AH B L IY
PEACED	P IY S T
PEACEFUL	P IY S F AH L
PEACEFULLER	P IY S F AH L ER
PEACEFULLEST	P IY S F AH L AH S T
PEACEFULLY	P IY S F AH L IY
KUCHEN	K AH CH AH N
EUTROPHIC	Y UW T R AH F AH K
BHAKTA	B AA K T AH
UINTAHITE	UW N T AH HH AY T
OITICICA	OY T AH S IY K AH
SEA	S IY
FLAB	F L AE B
