CI	S IY
ABACI	AE B AH S IY
ABBACIES	AE B AH S AY Z
ABBOTCIES	AE B AA T S AY Z
ABDUCING	AE B D Y UW S AH NG
ABERRANCIES	AE B EH R AH N S IY Z
ABEYANCIES	AH B EY AH N S IY Z
ABORTIFACIENT	AH B AO R T AH F EY SH AH N T
ABORTIFACIENTS	AH B AO R T AH F EY SH AH N T S
ABSCISE	AE B S AY Z
ABSCISED	AE B S AH S T
ABSCISES	AE B S AY Z AH Z
ABSCISIN	AE B S AH S AH N
ABSCISING	AE B S AY Z AH NG
ABSCISINS	AE B S AH S AH N Z
ABSCISSA	AE B S IH S AH
ABSCISSAE	AE B S IH S IY
ABSCISSAS	AE B S IH S AH Z
ABSCISSION	AE B S IH S IY AH N
ABSCISSIONS	AE B S IH S IY AH N Z
ABSORBANCIES	AH B Z AO R B AH N S IY Z
ABSORBENCIES	AH B Z AO R B AH N S IY Z
ACACIA	AH K EY SH AH
ACACIAS	AH K EY SH AH Z
ACADEMICIAN	AE K AH D AH M IH SH AH N
ACADEMICIANS	AE K AH D AH M IH SH AH N Z
ACADEMICIANS(2)	AH K AE D AH M IH SH AH N Z
ACADEMICISM	AE K AH D EH M IH K IH Z AH M
ACADEMICISMS	AE K AH D EH M IH K IH Z AH M Z
ACARICIDAL	AH K EH R IH K S AH D AH L
ACARICIDE	AH K AE R AH S AY D
ACARICIDES	AH K AE R AH S AY D Z
ACCIACCATURA	AE K S IY AH K AE T Y AH R AH
ACCIACCATURAS	AE K S IY AH K AE T Y AH R AH Z
ACCIACCATURE	AE K S IY AH K EY T Y AH R
ACCIDENCE	AE K S AH D AH N S
ACCIDENCES	AE K S AH D AH N S IH Z
ACCIDENT	AE K S AH D AH N T
ACCIDENTAL	AE K S AH D EH N T AH L
ACCIDENTAL(2)	AE K S AH D EH N AH L
ACCIDENTALLY	AE K S AH D EH N T AH L IY
ACCIDENTALLY(2)	AE K S AH D EH N AH L IY
ACCIDENTALNESS	AE K S AH D EH N T AH L N AH S
ACCIDENTALNESSES	AE K S AH D EH N T AH L N AH S IH Z
ACCIDENTALS	AE K S AH D EH N T AH L Z
ACCIDENTLY	AE K S AH D AH N T L IY
ACCIDENTS	AE K S AH D AH N T S
ACCIDIA	AE K S IH D IY AH
ACCIDIAS	AE K S IH D IY AH Z
ACCIDIE	AE K S AH D IY
ACCIDIES	AE K S AH D IY Z
ACCIPITER	AE K S AH P AY T AH R
ACCIPITERS	AE K S IH P AH T AH R Z
ACCIPITRINE	AE K S IH P AH T R AY N
ACCIPITRINES	AE K S IH P AH T R AY N Z
ACCOUNTANCIES	AH K AW N T AH N S IY Z
ACCURACIES	AE K Y ER AH S IY Z
ACICULA	AE S AH K Y UW L AH
ACICULAE	AE S AH K Y UW L IY
ACICULAR	AH S IH S Y AH L AH R
ACICULAS	AE S AH K Y UW L AH Z
ACICULUM	AE S AH K Y UW L AH M
ACICULUMS	AE S AH K Y UW L AH M Z
ACID	AE S AH D
ACIDEMIA	AE S AH D IY M IY AH
ACIDEMIAS	AE S AH D IY M IY AH Z
ACIDHEAD	AE S AH D HH EH D
ACIDHEADS	AE S AH D HH EH D Z
ACIDIC	AH S IH D IH K
ACIDIFICATION	AH S IH D AH F AH K EY SH AH N
ACIDIFICATIONS	AE S AH D AH F AH K EY SH AH N Z
ACIDIFIED	AH S IH D AH F AY D
ACIDIFIER	AE S AH D AH F AY ER
ACIDIFIERS	AE S AH D AH F AY ER Z
ACIDIFIES	AH S IH D AH F AY Z
ACIDIFY	AH S IH D AH F AY
ACIDIFYING	AE S AH D AH F AY IH NG
ACIDIMETER	AE S AH D IH M AH T AH R
ACIDIMETERS	AE S AH D IH M AH T AH R Z
ACIDIMETRIC	AH S IH D AH M AH T R AH K
ACIDIMETRIES	AE S AH D AH M EH T R AY Z
ACIDIMETRY	AE S AH D AH M EH T R IY
ACIDITIES	AH S IH D AH T IY Z
ACIDITY	AH S IH D AH T IY
ACIDLY	AE S AH D L IY
ACIDNESS	AE S AH D N AH S
ACIDNESSES	AE S AH D N AH S IH Z
ACIDOPHIL	AH S IH D AH F AH L
ACIDOPHILE	AH S IH D AH F AY L
ACIDOPHILES	AH S IH D AH F AY L Z
ACIDOPHILIC	AH S IH D AH F AY L AH K
ACIDOPHILS	AH S IH D AH F AY L Z
ACIDOSES	AE S AH D AA S IH Z
ACIDOSIS	AE S AH D OW S AH S
ACIDOTIC	AE S AH D AH T AH K
ACIDS	AE S AH D Z
ACIDULATE	AH S IH D Y AH L EY T
ACIDULATED	AH S IH D Y AH L EY T AH D
ACIDULATES	AH S IH D Y AH L EY T S
ACIDULATING	AH S IH D Y AH L EY T AH NG
ACIDULATION	AH S IH D Y AH L EY SH AH N
ACIDULATIONS	AH S IH D Y AH L EY T IY AH N Z
ACIDULENT	AH S IH D Y AH L AH N T
ACIDULOUS	AH S IH JH AH L AH S
ACIDURIA	AE S AH D UH R IY AH
ACIDURIAS	AE S AH D Y UH R IY AH Z
ACIDY	AE S AH D IY
ACIERATE	EY S IY ER AH T
ACIERATED	EY S IY ER EY T IH D
ACIERATES	EY S IY ER AH T S
ACIERATING	EY S IY ER EY T IH NG
ACIFORM	AE S AH F AH R M
ACINAR	AE S AH N AH R
ACING	EY S IH NG
ACINI	AE S AH N IY
ACINIC	AE S AH N AH K
ACINOSE	AE S AH N OW Z
ACINOUS	AE S AH N AH S
ACINUS	AE S AH N AH S
ACOUSTICIAN	AH K AW S T IH S IY AH N
ACOUSTICIANS	AE K AW S T IH S IY AH N Z
ACQUIESCING	AE K W IY EH S IH NG
ACTINOMYCIN	AE K T AH N AA M AH S AH N
ACTINOMYCINS	AE K T AH N AA M AH S AH N Z
ADAMANCIES	AH D EY M AH N S IY Z
ADDUCING	AH D UW S IH NG
ADENOCARCINOMA	AH D EH N AH K AH R S IH N AH M AH
ADENOCARCINOMAS	AH D EH N AH K AH R S IH N AH M AH Z
ADENOCARCINOMATA	AH D AH N AH K AA R S AH N AA M AH T AH
ADENOCARCINOMATOUS	AH D EH N AH K AA R S AH N AA M AH T AH S
ADEQUACIES	AE D IH K W AH S IY Z
ADJACENCIES	AH JH EY S AH N S IY Z
ADJUTANCIES	AE JH AH T AE N S AY Z
ADSCITITIOUS	AE D Z S AY T AH T IY AH S
ADVANCING	AH D V AE N S IH NG
ADVERTENCIES	AE D V ER T AH N S IY Z
ADVOCACIES	AE D V AH K AH S IY Z
AECIA	EH SH IY AH
AECIAL	EH SH AH L
AECIDIA	AH S IH D IY AH
AECIDIAL	AH S IH D IY AH L
AECIDIUM	AH S IH D IY AH M
AECIOSPORE	EH S IY AA S AH R
AECIOSPORES	EH S IY AA S AH R Z
AECIUM	EH S IY AH M
AEROBICIZE	AE ER OW B IH K AY Z
AEROBICIZED	AE ER OW B IH K AY Z D
AEROBICIZES	AE ER OW B IH K AY Z IH Z
AEROBICIZING	AE ER OW B IH K AY Z IH NG
AERODYNAMICIST	EH R OW D AY N AE M IH S IH S T
AERODYNAMICISTS	EH R OW D AY N AE M IH S IH S T S
AERODYNAMICISTS(2)	EH R OW D AY N AE M IH S IH S
AEROELASTICITIES	AH R OW AH L AE S T IH S AH T AY Z
AEROELASTICITY	AH R OW AH L AE S T IH S AH T IY
AEROMEDICINE	AH R AH M EH D AH S AY N
AEROMEDICINES	AH R AH M EH D AH S AY N Z
AESTHETICIAN	EH S TH AH T IH S IY AH N
AESTHETICIANS	EH S TH AH T IH S IY AH N Z
AESTHETICISM	EH S TH EH T IH K IH Z AH M
AESTHETICISMS	EH S TH EH T IH K IH Z AH M Z
AESTHETICIZE	EH S TH EH T IH K AY Z
AESTHETICIZED	EH S TH EH T IH K AY Z D
AESTHETICIZES	EH S TH EH T IH K AY Z IH Z
AESTHETICIZING	EH S TH EH T IH K AY Z IH NG
AFFIANCING	AH F AY AH N S IH NG
AFFICIONADO	AE F IH K S IY AH N AH D UW
AFFICIONADOS	AE F IH K S IY AH N AH D UW Z
AFFLUENCIES	AE F L UW AH N S IY Z
AFICIONADA	AE F AH S IY AA N AH D AH
AFICIONADAS	AE F AH S IY AA N AH D AH Z
AFICIONADO	AH F IY SH Y AH N AA D OW
AFICIONADOS	AH F IH SH AH N AA D OW Z
AGENCIES	EY JH AH N S IY Z
AGNOSTICISM	AE G N AA S T IH K IH Z AH M
AGNOSTICISMS	AE G N AA S T IH K IH Z AH M Z
ALCID	AE L S AH D
ALCIDINE	AE L S AH D AY N
ALCIDS	AE L S IH D Z
ALGAECIDE	AE L G AH S AY D
ALGAECIDES	AE L G AH S AY D Z
ALGICIDAL	AE L JH IH S AH D AH L
ALGICIDE	AE L JH AH S AY D
ALGICIDES	AE L JH AH S AY D Z
ALITERACIES	AH L IH T ER AH S IY Z
ALLERGENICITIES	AO L ER JH IY N IH K S AH T IY Z
ALLERGENICITY	AO L ER JH IY N IH K S AH T IY
ALLICIN	AO L IH K S IH N
ALLICINS	AO L IH K S IH N Z
ALLOWANCING	AH L AW AH N S IH NG
ALOPECIA	AE L AH P IY SH IY AH
ALOPECIAS	AE L AH P IY S IY AH Z
ALOPECIC	AE L AH P AH S AH K
ALTRICIAL	AE L T R IH S IY AH L
AMERCIABLE	AH M ER S IY AH B AH L
AMERCING	AH M AH R S AH NG
AMERICIUM	AE M AH R IH S IY AH M
AMERICIUMS	AE M AH R IH S IY AH M Z
AMICI	AE M AH S IY
AMINOACIDURIA	AH M AH N OW S AH D Y UH R IY AH
AMINOACIDURIAS	AH M AH N OW S AH D Y UH R IY AH Z
AMOXICILLIN	AH M AO K S AH S IH L IH N
AMOXICILLINS	AH M AA K S AH S IH L AH N Z
AMOXYCILLIN	AH M AA K S AH S IH L AH N
AMOXYCILLINS	AH M AA K S AH S IH L AH N Z
AMPICILLIN	AE M P AH S IH L AH N
AMPICILLINS	AE M P AH S IH L AH N Z
ANALCIME	AE N AH L S AY M
ANALCIMES	AE N AH L S AY M Z
ANALCITE	AE N AH L S AY T
ANALCITES	AE N AH L S AY T S
ANALYTICITIES	AE N AH L AH T IH S AH T IY Z
ANALYTICITY	AE N AH L AH T IH S AH T IY
ANCIENT	EY N CH AH N T
ANCIENT(2)	EY N SH AH N T
ANCIENTER	EY N SH AH N T ER
ANCIENTEST	EY N SH AH N T AH S T
ANCIENTLY	EY N SH AH N T L IY
ANCIENTNESS	EY N SH AH N T N AH S
ANCIENTNESSES	EY N SH AH N T N AH S IH Z
ANCIENTRIES	EY N SH AH N T R IY Z
ANCIENTRY	EY N SH AH N T R IY
ANCIENTS	EY N CH AH N T S
ANCIENTS(2)	EY N SH AH N T S
ANCILLA	AE N S IH L AH
ANCILLAE	AE N S IH L IY
ANCILLARIES	AE N S AH L EH R IY Z
ANCILLARY	AE N S AH L EH R IY
ANCILLAS	AE N S IH L AH Z
ANDROECIA	AE N D R OW EH SH IY AH
ANDROECIUM	AE N D R OW EH S IY AH M
ANELASTICITIES	AE N AH L AE S T IH S AH T AY Z
ANELASTICITY	AE N AH L AE S T IH S AH T IY
ANGLICISE	AE N G L AH S AY Z
ANGLICISED	AE NG G AH L IH K S IY Z D
ANGLICISES	AE NG G AH L IH K S IY Z IH Z
ANGLICISING	AE NG G AH L IH K S IY Z IH NG
ANGLICISM	AE NG G AH L IH K S IH Z AH M
ANGLICISMS	AE NG G AH L IH K S IH Z AH M Z
ANGLICIZATION	AE NG G AH L IH K S AH Z EY SH AH N
ANGLICIZATIONS	AE NG G AH L IH K S AH Z EY SH AH N Z
ANGLICIZE	AE NG L IH S AY Z
ANGLICIZED	AE NG L IH S AY Z D
ANGLICIZES	AE NG G AH L IH K S AY Z IH Z
ANGLICIZING	AE NG G AH L IH K S AY Z IH NG
ANNOUNCING	AH N AW N S IH NG
ANNUNCIATE	AH N AH N S IY AH T
ANNUNCIATED	AH N AH N S IY EY T IH D
ANNUNCIATES	AH N AH N S IY AH T S
ANNUNCIATING	AH N AH N S IY EY T IH NG
ANNUNCIATION	AH N AH N S IY EY SH AH N
ANNUNCIATIONS	AH N AH N S IY EY SH AH N Z
ANNUNCIATOR	AH N AH N S IY AH T ER
ANNUNCIATORS	AH N AH N S IY AH T ER Z
ANNUNCIATORY	AH N AH N S IY AH T OW R IY
ANTACID	AE N T AE S AH D
ANTACIDS	AE N T AE S AH D Z
ANTHRACITE	AE N TH R AH S AY T
ANTHRACITES	AE N TH R AH S AY T S
ANTHRACITIC	AE N TH R AH S AH T AH K
ANTHROPOCENTRICITIES	AE N TH R AA P AH S EH N T R IH S AH T AY Z
ANTHROPOCENTRICITY	AE N TH R AA P AH S EH N T R IH S AH T IY
ANTICARCINOGEN	AE N T AH K AA R S IH N AH JH AH N
ANTICARCINOGENIC	AE N T AH K AA R S IH N AH JH AH N AH K
ANTICARCINOGENS	AE N T AH K AA R S IH N AH JH AH N Z
ANTICIGARETTE	AE N T AY S IH G AH R EH T
ANTICIPANT	AE N T IH S AH P AH N T
ANTICIPANTS	AE N T IH S AH P AH N T S
ANTICIPATABLE	AE N T IH S AH P AH T AH B AH L
ANTICIPATE	AE N T IH S AH P EY T
ANTICIPATED	AE N T IH S AH P EY T AH D
ANTICIPATED(2)	AE N T IH S AH P EY T IH D
ANTICIPATES	AE N T IH S AH P EY T S
ANTICIPATING	AE N T IH S AH P EY T IH NG
ANTICIPATION	AE N T IH S AH P EY SH AH N
ANTICIPATIONS	AE N T IH S AH P EY SH AH N Z
ANTICIPATOR	AE N T IH S AH P AH T ER
ANTICIPATORS	AE N T IH S AH P AH T ER Z
ANTICIPATORY	AE N T IH S AH P AH T AO R IY
ANTICITY	AE N T AY S IH T IY
ANTICOMMERCIAL	AE N T AY K AH M ER SH AH L
ANTICOMMERCIALISM	AE N T AY K AH M ER SH AH L IH Z AH M
ANTICOMMERCIALISMS	AE N T AY K AH M ER SH AH L IH Z AH M Z
ANTIFASCISM	AE N T AY F AE SH IH Z AH M
ANTIFASCISMS	AE N T AY F AE SH IH Z AH M Z
ANTIFASCIST	AE N T AY F AE SH AH S T
ANTIFASCISTS	AE N T AY F AE SH AH S T S
ANTIGENICITIES	AE N T IH JH AH N IH K S AH T IY Z
ANTIGENICITY	AE N T IH JH AH N IH K S AH T IY
ANTIMYCIN	AE N T AH M IH S AH N
ANTIMYCINS	AE N T AH M IH S AH N Z
ANTIPESTICIDE	AE N T AY P EH S T AH S AY D
ANTIPIRACIES	AE N T AY P AY R AH S IY Z
ANTIRACISM	AE N T AY R EY S IH Z AH M
ANTIRACISMS	AE N T AY R EY S IH Z AH M Z
ANTIRACIST	AE N T AY R EY S IH S T
ANTIRACISTS	AE N T AY R EY S IH S T S
ANTIROMANTICISM	AE N T AY R OW M AE N T AH S IH Z AH M
ANTIROMANTICISMS	AE N T AY R OW M AE N T AH S IH Z AH M Z
ANTISCIENCE	AE N T AY S AY AH N S
ANTISCIENCES	AE N T AY S AY AH N S IH Z
ANTISCIENTIFIC	AE N T AY S AY AH N T IH F IH K
ANTISOCIAL	AE N T IH S OW SH AH L
ANTISOCIAL(2)	AE N T AY S OW SH AH L
ANTISOCIALIST	AE N T AY S OW SH AH L IH S T
ANTISOCIALISTS	AE N T AY S OW SH AH L IH S T S
ANTISOCIALLY	AE N T AY S OW SH AH L IY
ANTISUICIDE	AE N T AY S UW AH S AY D
APERIODICITIES	AH P IH R IY AH D IH S AH T IY Z
APERIODICITY	AH P IH R IY AH D IH S AH T IY
APOCALYPTICISM	AH P AA K AH L IH P T IH K IH Z AH M
APOCALYPTICISMS	AH P AA K AH L IH P T IH K IH Z AH M Z
APOSTACIES	AH P OW S T AH S IY Z
APOSTOLICITIES	AE P AH S T AA L IH K AH T IY Z
APOSTOLICITY	AE P AH S T AA L IH K AH T IY
APOTHECIA	AE P AH TH IY SH IY AH
APOTHECIAL	AE P AH TH IY SH AH L
APOTHECIUM	AE P AH TH IY S IY AH M
APPENDICITIS	AH P EH N D IH S AY T IH Z
APPENDICITISES	AH P EH N D IH K S AH T IY Z IH Z
APPETENCIES	AE P AH T EH N S AY Z
APPRECIABLE	AH P R IY SH AH B AH L
APPRECIABLY	AH P R IY SH AH B L IY
APPRECIATE	AH P R IY SH IY EY T
APPRECIATED	AH P R IY SH IY EY T IH D
APPRECIATES	AH P R IY SH IY EY T S
APPRECIATING	AH P R IY SH IY EY T IH NG
APPRECIATION	AH P R IY SH IY EY SH AH N
APPRECIATIONS	AH P R IY SH IY EY SH AH N Z
APPRECIATIVE	AH P R IY SH IY EY T IH V
APPRECIATIVE(2)	AH P R IY SH Y AH T IH V
APPRECIATIVELY	AH P R IY SH IY EY T IH V L IY
APPRECIATIVELY(2)	AH P R IY SH Y AH T IH V L IY
APPRECIATIVENESS	AH P R IY SH IY EY T IH V N AH S
APPRECIATIVENESSES	AH P R IY SH IY EY T IH V N AH S IH Z
APPRECIATOR	AH P R IY SH IY EY T ER
APPRECIATORS	AH P R IY SH IY EY T ER Z
APPRECIATORY	AH P R IY SH IY EY T ER IY
APPRENTICING	AH P R EH N T AH S IH NG
ARABICIZATION	AE R AH B IH S AH Z EY SH AH N
ARABICIZATIONS	AH R AE B AH S AH Z EY T IY AH N Z
ARABICIZE	AH R AE B AH S AY Z
ARABICIZED	AH R AE B AH S AY Z D
ARABICIZES	AH R AE B AH S AY Z AH Z
ARABICIZING	AH R AE B AH S AY Z AH NG
ARCIFORM	AA R S AH F AH R M
ARCING	AA R K IH NG
ARDENCIES	AA R D AH N S IY Z
ARISTOCRACIES	AE R AH S T AA K R AH S IY Z
ARITHMETICIAN	AH R IH TH M AH T IH S IY AH N
ARITHMETICIANS	AH R IH TH M AH T IH S IY AH N Z
AROMATICITIES	AE R AH M AE T IH K AH T IY Z
AROMATICITY	AE R AH M AE T IH K AH T IY
ARTICULACIES	AA R T IH K Y AH L AH S IY Z
ARTIFICIAL	AA R T AH F IH SH AH L
ARTIFICIALITIES	AA R T AH F IH SH IY AE L AH T IY Z
ARTIFICIALITY	AA R T AH F IH SH IY AE L AH T IY
ARTIFICIALLY	AA R T AH F IH SH AH L IY
ARTIFICIALNESS	AA R T AH F IH SH AH L N AH S
ARTIFICIALNESSES	AA R T AH F IH SH AH L N AH S IH Z
ASCENDANCIES	AH S EH N D AH N S IY Z
ASCENDENCIES	AH S EH N D AH N S IY Z
ASCETICISM	AH S EH T AH S IH Z AH M
ASCETICISMS	AH S EH T AH S IH Z AH M Z
ASCI	AE S IY
ASCIDIA	AE S IH D IY AH
ASCIDIAN	AE S IH D IY AH N
ASCIDIANS	AE S IH D IY AH N Z
ASCIDIUM	AE S IH D IY AH M
ASCITES	AH Z S AY T S
ASCITIC	AH Z S AY T IH K
ASOCIAL	EY S OW SH AH L
ASSOCIATE	AH S OW S IY AH T
ASSOCIATE(2)	AH S OW S IY EY T
ASSOCIATE(3)	AH S OW SH IY AH T
ASSOCIATE(4)	AH S OW SH IY EY T
ASSOCIATED	AH S OW S IY EY T AH D
ASSOCIATED(2)	AH S OW SH IY EY T AH D
ASSOCIATES	AH S OW S IY AH T S
ASSOCIATES(2)	AH S OW S IY EY T S
ASSOCIATES(3)	AH S OW SH IY AH T S
ASSOCIATES(4)	AH S OW SH IY EY T S
ASSOCIATESHIP	AH S OW S IY AH T SH IH P
ASSOCIATESHIPS	AH S OW S IY AH T SH IH P S
ASSOCIATING	AH S OW S IY EY T IH NG
ASSOCIATION	AH S OW S IY EY SH AH N
ASSOCIATION(2)	AH S OW SH IY EY SH AH N
ASSOCIATIONAL	AH S OW S IY EY SH AH N AH L
ASSOCIATIONISM	AH S OW S IY EY SH AH N IH Z AH M
ASSOCIATIONISMS	AH S OW S IY EY SH AH N IH Z AH M Z
ASSOCIATIONIST	AH S OW S IY EY SH AH N IH S T
ASSOCIATIONISTIC	AH S OW S IY EY SH AH N IH S T IH K
ASSOCIATIONISTS	AH S OW S IY EY SH AH N IH S T S
ASSOCIATIONS	AH S OW S IY EY SH AH N Z
ASSOCIATIONS(2)	AH S OW SH IY EY SH AH N Z
ASSOCIATIVE	AH S OW S IY AH T IH V
ASSOCIATIVELY	AH S OW S IY AH T IH V L IY
ASSOCIATIVITIES	AH S OW S IY AH T IH V AH T IY Z
ASSOCIATIVITY	AH S OW S IY AH T IH V AH T IY
ASTRINGENCIES	AH S T R IH N JH AH N S IY Z
ASTROPHYSICIST	AE S T R OW F IH S IH S IH S T
ASTROPHYSICISTS	AH S T R OW F IY IY S IH K IH S T S
ATHLETICISM	AE TH L EH T IH S IH Z M
ATHLETICISMS	AE TH L EH T AH S IH Z AH M Z
ATROCIOUS	AH T R OW SH AH S
ATROCIOUSLY	AH T R OW SH AH S L IY
ATROCIOUSNESS	AH T R OW SH AH S N AH S
ATROCIOUSNESSES	AH T R OW SH AH S N AH S IH Z
ATROCITIES	AH T R AA S AH T IY Z
ATROCITY	AH T R AA S AH T IY
ATTICISM	AE T IH K IH Z AH M
ATTICISMS	AE T IH K IH Z AH M Z
ATTICIST	AE T IH K IH S T
ATTICISTS	AE T IH K IH S T S
ATTRACTANCIES	AH T R AE K T AH N S IY Z
AUDACIOUS	AA D EY SH AH S
AUDACIOUSLY	AO D AH S IY AH S L IY
AUDACIOUSNESS	AO D AH S IY AH S N AH S
AUDACIOUSNESSES	AO D AH S IY AH S N AH S IH Z
AUDACITIES	AO D AE S AH T IY Z
AUDACITY	AA D AE S AH T IY
AUSPICIOUS	AA S P IH SH AH S
AUSPICIOUSLY	AO S P IH SH AH S L IY
AUSPICIOUSNESS	AO S P IH SH AH S N AH S
AUSPICIOUSNESSES	AO S P IH SH AH S N AH S IH Z
AUSTRALOPITHECINE	AO S T R EY L OW P IH TH AH S AY N
AUSTRALOPITHECINES	AO S T R AH L AH P IH TH AH S AY N Z
AUTECISM	AO T AH S IH Z AH M
AUTECISMS	AO T AH S AH Z AH M Z
AUTHENTICITIES	AO TH EH N T IH S AH T IY Z
AUTHENTICITY	AO TH AH N T IH S IH T IY
AUTOCRACIES	AO T AA K R AH S IY Z
AUTOECIOUS	AH T OW AH SH AH S
AUTOECIOUSLY	AO T OW AH S IY OW AH S L IY
AUTOECISM	AO T OW AH S IH Z AH M
AUTOECISMS	AH T OW AH S AH Z AH M Z
AUTOEROTICISM	AO T OW IH R AA T IH K IH Z AH M
AUTOEROTICISMS	AO T OW IH R AA T IH K IH Z AH M Z
AUTOMATICITIES	AO T AH M AE T IH K AH T IY Z
AUTOMATICITY	AO T AH M AE T IH K AH T IY
AVARICIOUS	AE V AH R IH SH AH S
AVARICIOUSLY	AE V AH R IH SH AH S L IY
AVARICIOUSNESS	AE V AH R IH SH AH S N AH S
AVARICIOUSNESSES	AE V AH R IH SH AH S N AH S IH Z
BACILLAR	B AH S IH L AH R
BACILLARY	B AE S AH L EH R IY
BACILLI	B AH S IH L IY
BACILLUS	B AH S IH L AH S
BACITRACIN	B AH S IH T R AH S AH N
BACITRACINS	B AH S IH T R AH S AH N Z
BACKSPACING	B AE K S P EY S IH NG
BACTERICIDAL	B AE K T AH R IH S AH D AH L
BACTERICIDALLY	B AE K T AH R IH S AH D AE L IY
BACTERICIDE	B AE K T EH R AH S AY D
BACTERICIDES	B AE K T EH R AH S AY D Z
BACTERIOCIN	B AE K T AH R IY AH S AH N
BACTERIOCINS	B AE K T AH R IY AH S AH N Z
BALANCING	B AE L AH N S IH NG
BANKRUPTCIES	B AE NG K R AH P T S IY Z
BARONETCIES	B AE R AH N EH T S AY Z
BASICITIES	B EY S IH K S AH T IY Z
BASICITY	B EY S IH K S AH T IY
BEAUTICIAN	B Y UW T IH SH AH N
BEAUTICIANS	B AH AH T IH S IY AH N Z
BECHANCING	B IH CH AE N S IH NG
BEDUNCING	B AH D AH N S AH NG
BELLIGERENCIES	B AH L IH JH ER AH N S IY Z
BENEFICIAL	B EH N AH F IH SH AH L
BENEFICIALLY	B EH N AH F IH SH AH L IY
BENEFICIALNESS	B EH N AH F IH SH AH L N AH S
BENEFICIALNESSES	B EH N AH F IH SH AH L N AH S IH Z
BENEFICIARIES	B EH N AH F IH SH IY EH R IY Z
BENEFICIARY	B EH N AH F IH SH IY EH R IY
BENEFICIATE	B AH N AH F IH S AY EY T
BENEFICIATED	B AH N AH F IH S AY EY T AH D
BENEFICIATES	B AH N AH F IH S AY EY T S
BENEFICIATING	B AH N AH F IH S AY EY T AH NG
BENEFICIATION	B AH N AH F IH S AY EY SH AH N
BENEFICIATIONS	B AH N EH F AH S IY EY T IY AH N Z
BENEFICING	B AH N AH F IH S AH NG
BENIGNANCIES	B IH N AY N AH N S IY Z
BIBLICISM	B AY B AH L IH K S IH Z AH M
BIBLICISMS	B AY B AH L IH K S IH Z AH M Z
BIBLICIST	B AY B AH L IH K S IH S T
BIBLICISTS	B AY B AH L IH K S IH S T S
BICIPITAL	B AY S IH P AH T AH L
BIFACIAL	B AY F EY SH AH L
BIFACIALLY	B AY F EY SH AH L IY
BIOCIDAL	B AY AA S AH D AH L
BIOCIDE	B AY AH S AY D
BIOCIDES	B AY AH S AY D Z
BIOELECTRICITIES	B AY OW AH L EH K T R IH S AH T AY Z
BIOELECTRICITY	B AY OW AH L EH K T R IH S AH T IY
BIOETHICIST	B AY OW AH TH IH S AH S T
BIOETHICISTS	B AY OW EH TH AH S AH S T S
BIOMATHEMATICIAN	B AY AH M AH TH EH M AH T IH S IY AH N
BIOMATHEMATICIANS	B AY AH M AE TH AH M AH T IH S IY AH N Z
BIOMEDICINE	B AY AH M EH D AH S AY N
BIOMEDICINES	B AY AH M EH D AH S AY N Z
BIOMETRICIAN	B AY AH M EH T R IH S IY AH N
BIOMETRICIANS	B AY AA M AH T R IH S IY AH N Z
BIOPHYSICIST	B AY AA F AH Z IH S AH S T
BIOPHYSICISTS	B AY AH F IH S AH S AH S T S
BIOSCIENCE	B AY OW S AY AH N S
BIOSCIENCES	B AY OW S AY AH N S IH Z
BIOSCIENTIFIC	B AY AA S IY N T IH F AH K
BIOSCIENTIST	B AY AA S IY N T AH S T
BIOSCIENTISTS	B AY AA S IY N T AH S T S
BIOSOCIAL	B AY AH S OW SH AH L
BIOSOCIALLY	B AY AH S OW S IY AE L IY
BIOSTATISTICIAN	B AY AA S T AH T IH S T IH S IY AH N
BIOSTATISTICIANS	B AY AA S T AH T AH S T IH S IY AH N Z
BIRACIAL	B AY R EY SH AH L
BIRACIALISM	B AY R EY SH AH L IH Z AH M
BIRACIALISMS	B AY R EY SH AH L IH Z AH M Z
BLATANCIES	B L EY T AH N S IY Z
BOCACCIO	B AH K AE K S IY OW
BOCACCIOS	B AH K AE K S IY AH Z
BOCCI	B AA K S IY
BOCCIA	B OW CH AH
BOCCIAS	B AA K S IY AH Z
BOCCIE	B AA K S AY
BOCCIES	B AA K S AY Z
BOCCIS	B AA K S AH S
BODACIOUS	B OW D AH S IY AH S
BODACIOUSLY	B OW D AH S IY AH S L IY
BOLDFACING	B OW L D F EY S IH NG
BOMBYCID	B AA M B AH S AH D
BOMBYCIDS	B AA M B AH S AH D Z
BONACI	B AA N AH S IY
BONACIS	B OW N AH S IY Z
BORACIC	B IY ER EY S IH K
BORACITE	B IY ER AH S AY T
BORACITES	B IY ER AH S AY T S
BOUNCIER	B AW N S IY ER
BOUNCIEST	B AW N S IY AH S T
BOUNCILY	B AW N S IY L IY
BOUNCING	B AW N S IH NG
BOUNCINGLY	B AW N S IH NG L IY
BRACING	B R EY S IH NG
BRACINGLY	B R EY S IH NG G L IY
BRACINGS	B R EY S IH NG Z
BRACIOLA	B R EY S IY AH L AH
BRACIOLAS	B R EY S IY AH L AH Z
BRACIOLE	B R EY S IY OW L
BRACIOLES	B R EY S IY OW L Z
BRAGGADOCIO	B R AE G AH D OW SH IY OW
BRAGGADOCIOS	B R AE G AH D OW SH IY OW Z
BRATTICING	B R AE T IH S AH NG
BRECCIA	B R EH K S IY AH
BRECCIAL	B R EH K S IY AH L
BRECCIAS	B R EH K S IY AH Z
BRECCIATE	B R EH K S AY EY T
BRECCIATED	B R EH K S AY EY T AH D
BRECCIATES	B R EH K S AY EY T S
BRECCIATING	B R EH K S AY EY T AH NG
BRECCIATION	B R EH K S AY EY SH AH N
BRECCIATIONS	B R EH K S IY EY T IY AH N Z
BREVETCIES	B R AH V EH T S AY Z
BRILLIANCIES	B R IH L Y AH N S IY Z
BROMOURACIL	B R AH M AH R AH S AH L
BROMOURACILS	B R AA M AH Y UH R AH S AH L Z
BRUCIN	B R UW S AH N
BRUCINE	B R UW S AY N
BRUCINES	B R UW S AY N Z
BRUCINS	B R UW S AH N Z
BUCCINATOR	B AH K S AH N EY T AH R
BUCCINATORS	B AH K S IH N AH T AH R Z
BUOYANCIES	B OY AH N S IY Z
BUREAUCRACIES	B Y UH R AA K R AH S IY Z
CACCIATORE	K AA CH AH T AO R IY
CACIQUE	K AH S IY K
CACIQUES	K AE S AH K S
CACIQUISM	K AE S AH K W IH Z AH M
CACIQUISMS	K AH S IH K W AH Z AH M Z
CADENCIES	K EY D AH N S IY Z
CADENCING	K EY D AH N S IH NG
CADUCITIES	K AE D Y UW S AH T AY Z
CADUCITY	K AE D Y UW S AH T IY
CAECILIAN	K IY S IH L IY AH N
CAECILIANS	K IY S IH L IY AH N Z
CALCIC	K AE L S IH K
CALCICOLE	K AE L S AH K OW L
CALCICOLES	K AE L S AH K OW L Z
CALCICOLOUS	K AE L S IH K AH L AH S
CALCIFEROL	K AE L S IH F AH R AH L
CALCIFEROLS	K AE L S IH F AH R AH L Z
CALCIFEROUS	K AE L S IH F AH R AH S
CALCIFIC	K AE L S IH F AH K
CALCIFICATION	K AE L S AH F AH K EY SH AH N
CALCIFICATIONS	K AE L S AH F AH K EY SH AH N Z
CALCIFIED	K AE L S AH F AY D
CALCIFIES	K AE L S AH F AY Z
CALCIFUGE	K AE L S AH F Y UW JH
CALCIFUGES	K AE L S AH F Y UW JH AH Z
CALCIFUGOUS	K AE L S AH F Y UW G AH S
CALCIFY	K AE L S AH F AY
CALCIFYING	K AE L S AH F AY IH NG
CALCIMINE	K AE L S AH M AY N
CALCIMINED	K AE L S AH M AY N D
CALCIMINES	K AE L S AH M AY N Z
CALCIMINING	K AE L S AH M AY N AH NG
CALCINATION	K AE L S AH N EY SH AH N
CALCINATIONS	K AE L S AH N EY T IY AH N Z
CALCINE	K AE L S AY N
CALCINED	K AE L S AY N D
CALCINES	K AE L S AY N Z
CALCINING	K AE L S AY N AH NG
CALCINOSES	K AE L S AH N OW Z AH Z
CALCINOSIS	K AE L S AH N OW S AH S
CALCITE	K AE L S AY T
CALCITES	K AE L S AY T S
CALCITIC	K AE L S AH T AH K
CALCITONIN	K AE L S IY T AH N IH N
CALCITONINS	K AE L S IY T AH N IH N Z
CALCIUM	K AE L S IY AH M
CALCIUMS	K AE L S IY AH M Z
CALYCINE	K AE L AH S AY N
CANDIDACIES	K AE N D AH D AH S IY Z
CANONICITIES	K AE N AH N IH K S AH T IY Z
CANONICITY	K AE N AH N IH K S AH T IY
CANTATRICI	K AE N T AE T R AH S IY
CAPACIOUS	K AH P EY SH AH S
CAPACIOUSLY	K AH P EY SH AH S L IY
CAPACIOUSNESS	K AH P EY SH AH S N AH S
CAPACIOUSNESSES	K AH P EY SH AH S N AH S IH Z
CAPACITANCE	K AH P AE S AH T AH N S
CAPACITANCES	K AH P AE S AH T AH N S IH Z
CAPACITATE	K AH P AE S AH T AH T
CAPACITATED	K AH P AE S AH T EY T IH D
CAPACITATES	K AH P AE S AH T AH T S
CAPACITATING	K AH P AE S AH T EY T IH NG
CAPACITATION	K AH P AE S AH T EY SH AH N
CAPACITATIONS	K AH P AE S AH T EY SH AH N Z
CAPACITIES	K AH P AE S AH T IY Z
CAPACITIES(2)	K AH P AE S IH T IY Z
CAPACITIVE	K AH P AE S AH T IH V
CAPACITIVELY	K AH P AE S AH T IH V L IY
CAPACITOR	K AH P AE S AH T ER
CAPACITORS	K AH P AE S AH T ER Z
CAPACITORS(2)	K AH P AE S IH T ER Z
CAPACITY	K AH P AE S AH T IY
CAPACITY(2)	K AH P AE S IH T IY
CAPPUCCINO	K AE P UW CH IY N OW
CAPPUCCINOS	K AE P AH K S AH N AH Z
CAPRICCI	K AE P R IH K S IY
CAPRICCIO	K AE P R IH K S IY OW
CAPRICCIOS	K AE P R IH K S IY AH Z
CAPRICIOUS	K AH P R IH SH AH S
CAPRICIOUSLY	K AH P R IH SH IH S L IY
CAPRICIOUSNESS	K AH P R IH SH AH S N AH S
CAPRICIOUSNESSES	K AH P R IH SH AH S N AH S IH Z
CAPSAICIN	K AE P S EY S AH N
CAPSAICINS	K AE P S EY S AH N Z
CAPSICIN	K AE P S IH K IH N
CAPSICINS	K AE P S IH K IH N Z
CAPTAINCIES	K AE P T AH N S IY Z
CARCINOGEN	K AA R S IH N AH JH AH N
CARCINOGENESES	K AA R S AH N AA JH AH N IY Z AH Z
CARCINOGENESIS	K AA R S AH N AH JH IY N AH S AH S
CARCINOGENIC	K AA R S AH N OW JH EH N IH K
CARCINOGENICITIES	K AA R S IH N AH JH AH N IH S AH T AY Z
CARCINOGENICITY	K AA R S AH N AA JH AH N IH S AH T IY
CARCINOGENS	K AA R S IH N AH JH AH N Z
CARCINOID	K AA R S AH N OY D
CARCINOIDS	K AA R S AH N OY D Z
CARCINOMA	K AA R S AH N OW M AH
CARCINOMAS	K AA R S AH N OW M AH Z
CARCINOMATA	K AA R S AH N AA M AH T AH
CARCINOMATOSES	K AA R S AH N AA M AH T OW Z AH Z
CARCINOMATOSIS	K AA R S IH N AH M AH T OW S AH S
CARCINOMATOUS	K AA R S AH N AA M AH T AH S
CARCINOSARCOMA	K AA R S AH N AH S AA R K AH M AH
CARCINOSARCOMAS	K AA R S AH N AH S AA R K AH M AH Z
CARCINOSARCOMATA	K AA R S IH N AH S AH R K AA M AH T AH
CARDIOTHORACIC	K AA R D IY AA TH AH R AH S AH K
CARPACCIO	K AA R P AE K S IY OW
CARPACCIOS	K AA R P AE K S IY AH Z
CATFACING	K AE T F EY S IH NG
CATFACINGS	K AE T F EY S IH NG Z
CATHOLICITIES	K AE TH L IH K AH T IY Z
CATHOLICITY	K AE TH L IH K AH T IY
CATHOLICIZE	K AE TH L IH K AY Z
CATHOLICIZED	K AE TH L IH K AY Z D
CATHOLICIZES	K AE TH L IH K AY Z IH Z
CATHOLICIZING	K AE TH L IH K AY Z IH NG
CAUSTICITIES	K AO S T IH S AH T AY Z
CAUSTICITY	K AO S T IH S AH T IY
CELIBACIES	S AH L IH B AH S AY Z
CENOSPECIES	S AH N AA S AH S AY Z
CENTRICITIES	S EH N T R IH K AH T IY Z
CENTRICITY	S EH N T R IH K AH T IY
CERAMICIST	S AH R AE M IH K IH S T
CERAMICISTS	S AH R AE M IH K IH S T S
CERCI	S AH R S IY
CERCIS	S AH R S AH S
CERCISES	S AH R S AY Z AH Z
CERVICITIS	S AH R V AH S AY T AH S
CERVICITISES	S AH R V IH S AH T AY Z AH Z
CHALCID	CH AE L S AH D
CHALCIDS	CH AE L S AH D Z
CHALCOCITE	CH AE L K AH S AY T
CHALCOCITES	CH AE L K AH S AY T S
CHANCIER	CH AE N S IY ER
CHANCIEST	CH AE N S IY AH S T
CHANCILY	CH AE N S IY L IY
CHANCINESS	CH AE N S IY N AH S
CHANCINESSES	CH AE N S IY N AH S IH Z
CHANCING	CH AE N S IH NG
CHAPLAINCIES	CH AE P L EY N S AY Z
CHARACID	CH AA R AE S AH D
CHARACIDS	CH AA R AE S AH D Z
CHARACIN	CH AE R AH S AH N
CHARACINS	CH AE R AH S AH N Z
CHATOYANCIES	CH AE T OY AE N S AY Z
CHIEFTAINCIES	CH IY F T EY N S AY Z
CHIROMANCIES	CH IH R AH M AE N S AY Z
CHOLECALCIFEROL	CH AA L AH K AH L S IH F AH R AH L
CHOLECALCIFEROLS	CH AA L AH K AH L S IH F AH R AH L Z
CHORIOCARCINOMA	CH AH R IY AH K AH R S IH N AH M AH
CHORIOCARCINOMAS	CH AH R IY AH K AH R S IH N AH M AH Z
CHORIOCARCINOMATA	CH AH R IY AH K AA R S AH N AA M AH T AH
CHROMATICISM	K R OW M AE T IH K IH Z AH M
CHROMATICISMS	K R OW M AE T IH K IH Z AH M Z
CHROMATICITIES	K R OW M AE T IH K AH T IY Z
CHROMATICITY	K R OW M AE T IH K AH T IY
CHRONICITIES	K R AA N IH K AH T IY Z
CHRONICITY	K R AA N IH K AH T IY
CIAO	CH AW
CIBOL	S IH B AH L
CIBOLS	S IH B AH L Z
CIBORIA	S AH B AO R IY AH
CIBORIUM	S AH B AO R IY AH M
CIBOULE	S IH B OW UW L
CIBOULES	S IH B OW AH L Z
CICADA	S AH K EY D AH
CICADAE	S IH K AH D IY
CICADAS	S IH K EY D AH Z
CICALA	S IH K AA L AH
CICALAS	S IH K AH L AH Z
CICALE	S AH K EY L
CICATRICES	S AH K AE T R AH S
CICATRICIAL	S AH K AE T R IH S IY AH L
CICATRIX	S AH K AE T R AH K S
CICATRIXES	S AH K AE T R AH K S
CICATRIZATION	S AH K AE T R AH Z EY SH AH N
CICATRIZATIONS	S AH K AE T R AH Z EY T IY AH N Z
CICATRIZE	S IH K AH T R AY Z
CICATRIZED	S IH K AH T R AY Z D
CICATRIZES	S IH K AH T R AY Z AH Z
CICATRIZING	S IH K AH T R AY Z AH NG
CICELIES	S IH S AH L AY Z
CICELY	S IH S AH L IY
CICERO	S IH S ER OW
CICERONE	S IH S ER OW N
CICERONES	S IH S AH R OW N Z
CICERONI	S AH S EH R AH N IY
CICEROS	S IH S AH R AH Z
CICHLID	S IH K L AH D
CICHLIDAE	S IH K L AH D IY
CICHLIDS	S IH K L AH D Z
CICISBEI	S AH S IH Z IY
CICISBEISM	S AH S IH Z IY IH Z AH M
CICISBEISMS	S IH S AH Z IY Z AH M Z
CICISBEO	S AH S IH Z IY OW
CICISBEOS	S AH S IH Z IY AH Z
CICOREE	S IH K AH R IY IY
CICOREES	S IH K AH R IY Z
CIDER	S AY D ER
CIDERS	S AY D ER Z
CIG	S IH G
CIGAR	S IH G AA R
CIGARET	S IH G AH R EH T
CIGARETS	S IH G AH R EH T S
CIGARETTE	S IH G AH R EH T
CIGARETTES	S IH G AH R EH T S
CIGARILLO	S IH G AH R IH L OW
CIGARILLOS	S IH G AA R IH L AA S
CIGARS	S IH G AA R Z
CIGS	S IH G Z
CIGUATERA	S IH G W AA T AH R AH
CIGUATERAS	S IH G W AA T AH R AH Z
CILANTRO	S IH L AE N T R OW
CILANTROS	S AH L AE N T R AH Z
CILIA	S IH L Y AH
CILIARY	S IH L AY EH R IY
CILIATE	S IH L IY EY T
CILIATED	S IH L IY EY T IH D
CILIATES	S IH L IY AH T S
CILIATION	S IH L IY EY SH AH N
CILIATIONS	S IH L IY EY SH AH N Z
CILICE	S IH L AH S
CILICES	S IH L AH S
CILIUM	S IH L IY AH M
CIMBALOM	S IH M B AH L AH M
CIMBALOMS	S IH M B AH L AH M Z
CIMETIDINE	S AH M EH T AH D AY N
CIMETIDINES	S AH M EH T AH D AY N Z
CIMEX	S IH M AH K S
CIMICES	S IH M AH S
CINCH	S IH N CH
CINCHED	S IH N CH T
CINCHES	S IH N CH IH Z
CINCHING	S IH N CH IH NG
CINCHONA	S IH NG K AH N AH
CINCHONAS	S IH NG K AH N AH Z
CINCHONINE	S IH NG K AH N AY N
CINCHONINES	S IH NG K AH N AY N Z
CINCHONISM	S IH N CH AO N IH Z AH M
CINCHONISMS	S IH N CH AO N IH Z AH M Z
CINCTURE	S IH NG K T Y AH R
CINCTURED	S IH NG K T Y AH R D
CINCTURES	S IH NG K T Y AH R Z
CINCTURING	S IH NG K T Y AH R AH NG
CINDER	S IH N D ER
CINDERBLOCK	S IH N D ER B L AA K
CINDERBLOCKS	S IH N D ER B L AA K S
CINDERED	S IH N D ER D
CINDERING	S IH N D ER IH NG
CINDERS	S IH N D ER Z
CINDERY	S IH N D ER IY
CINE	S AY N
CINEAST	S AH N IY S T
CINEASTE	S AH N IY S T
CINEASTES	S AH N IY S T S
CINEASTS	S AH N IY S T S
CINEMA	S IH N AH M AH
CINEMAGOER	S IH N AH M AH G OW ER
CINEMAGOERS	S IH N AH M AH G OW ER Z
CINEMAS	S IH N AH M AH Z
CINEMATHEQUE	S AH N EH M AH TH AH K
CINEMATHEQUES	S AH N EH M AH TH AH K S
CINEMATIC	S IH N AH M AE T IH K
CINEMATICALLY	S IH N AH M AE T IH K AH L IY
CINEMATIZE	S AH N EH M AH T AY Z
CINEMATIZED	S AH N EH M AH T AY Z D
CINEMATIZES	S AH N EH M AH T AY Z AH Z
CINEMATIZING	S AH N EH M AH T AY Z AH NG
CINEMATOGRAPH	S IH N AH M AH T AA G R AH F
CINEMATOGRAPHER	S IH N IH M AH T AA G R AH F ER
CINEMATOGRAPHERS	S IH N AH M AH T AA G R AH F AH R Z
CINEMATOGRAPHIC	S IH N AH M AH T AA G R AH F AH K
CINEMATOGRAPHICALLY	S AH N EH M AH T AA G R AE F AH K AE L IY
CINEMATOGRAPHIES	S IH N AH M AH T AA G R AH F AY Z
CINEMATOGRAPHS	S IH N AH M AH T AA G R AH F S
CINEMATOGRAPHY	S IH N IH M AH T AA G R AH F IY
CINEOL	S IH N IY AH L
CINEOLE	S IH N IY OW L
CINEOLES	S IH N IY OW L Z
CINEOLS	S IH N IY AH L Z
CINEPLEX	S IH N AH P L EH K S
CINEPLEXES	S AH N EH P L AH K S
CINERARIA	S IH N AH R AE R IY AH
CINERARIAS	S IH N AH R AE R IY AH Z
CINERARIUM	S IH N AH R AE R IY AH M
CINERARY	S IH N AH R EH R IY
CINEREOUS	S AH N IY R IY AH S
CINERIN	S IH N AH R AH N
CINERINS	S IH N AH R AH N Z
CINES	S AY N Z
CINGULA	S IH N G Y UW L AH
CINGULATE	S IH N G Y AH L EY T
CINGULUM	S IH N G Y UW L AH M
CINNABAR	S IH N AH B AA R
CINNABARINE	S IH N AE B AH R AY N
CINNABARS	S IH N AH B AH R Z
CINNAMIC	S IH N AH M AH K
CINNAMON	S IH N AH M AH N
CINNAMONS	S IH N AH M AH N Z
CINNAMYL	S IH N AH M AH L
CINNAMYLS	S IH N AH M AH L Z
CINQUAIN	S IH NG K W EY N
CINQUAINS	S IH NG K W EY N Z
CINQUE	S IH NG K
CINQUECENTIST	S IH NG K W AH S EH N T AH S T
CINQUECENTISTI	S IH NG K W AH S AH N T IH S T IY
CINQUECENTISTS	S IH NG K W AH S EH N T AH S T S
CINQUECENTO	S IH NG K W AH S EH N T OW
CINQUECENTOS	S IH NG K W AH S EH N T AH Z
CINQUEFOIL	S IH NG K W AH F OY L
CINQUEFOILS	S IH NG K W EH F OW AH L Z
CINQUES	S IH NG K W Z
CION	S AY AH N
CIONS	S AY AH N Z
CIOPPINO	S AY AA P AH N OW
CIOPPINOS	S AY AA P AH N AH Z
CIPHER	S AY F ER
CIPHERED	S AY F ER D
CIPHERING	S AY F ER IH NG
CIPHERS	S AY F ER Z
CIPHERTEXT	S AY F ER T EH K S T
CIPHERTEXTS	S AY F ER T EH K S T S
CIPHONIES	S IH F AH N AY Z
CIPHONY	S IH F AH N IY
CIPOLIN	S IH P AH L AH N
CIPOLINS	S IH P AH L AH N Z
CIRCA	S ER K AH
CIRCADIAN	S ER K EY D IY AH N
CIRCINATE	S AH R S AH N EY T
CIRCINATELY	S AH R S AH N EY T L IY
CIRCLE	S ER K AH L
CIRCLED	S ER K AH L D
CIRCLER	S ER K AH L ER
CIRCLERS	S ER K AH L ER Z
CIRCLES	S ER K AH L Z
CIRCLET	S AH R K L AH T
CIRCLETS	S AH R K L AH T S
CIRCLING	S ER K AH L IH NG
CIRCLING(2)	S ER K L IH NG
CIRCUIT	S ER K AH T
CIRCUITAL	S ER K AH T AH L
CIRCUITED	S ER K AH T IH D
CIRCUITIES	S ER K AH T IY Z
CIRCUITING	S ER K AH T IH NG
CIRCUITOUS	S ER K Y UW IH T AH S
CIRCUITOUSLY	S ER K Y UW AH T AH S L IY
CIRCUITOUSNESS	S ER K Y UW AH T AH S N AH S
CIRCUITOUSNESSES	S ER K Y UW AH T AH S N AH S IH Z
CIRCUITRIES	S ER K AH T R IY Z
CIRCUITRY	S ER K AH T R IY
CIRCUITS	S ER K AH T S
CIRCUITY	S ER K AH T IY
CIRCULAR	S ER K Y AH L ER
CIRCULARISE	S AH R K Y UW L AH R AY Z
CIRCULARISED	S ER K Y AH L EH R IY Z D
CIRCULARISES	S ER K Y AH L EH R IY Z IH Z
CIRCULARISING	S ER K Y AH L EH R IY Z IH NG
CIRCULARITIES	S ER K Y AH L AE R AH T IY Z
CIRCULARITY	S ER K Y AH L AE R AH T IY
CIRCULARIZATION	S ER K Y AH L ER AH Z EY SH AH N
CIRCULARIZATIONS	S ER K Y AH L ER AH Z EY SH AH N Z
CIRCULARIZE	S ER K Y AH L ER AY Z
CIRCULARIZED	S ER K Y AH L ER AY Z D
CIRCULARIZES	S ER K Y AH L ER AY Z IH Z
CIRCULARIZING	S ER K Y AH L ER AY Z IH NG
CIRCULARLY	S ER K Y AH L ER L IY
CIRCULARNESS	S ER K Y AH L ER N AH S
CIRCULARNESSES	S ER K Y AH L ER N AH S IH Z
CIRCULARS	S ER K Y AH L ER Z
CIRCULATABLE	S ER K Y AH L AH T AH B AH L
CIRCULATE	S ER K Y AH L EY T
CIRCULATED	S ER K Y AH L EY T AH D
CIRCULATED(2)	S ER K Y AH L EY T IH D
CIRCULATES	S ER K Y AH L EY T S
CIRCULATING	S ER K Y AH L EY T IH NG
CIRCULATION	S ER K Y AH L EY SH AH N
CIRCULATIONS	S ER K Y AH L EY SH AH N Z
CIRCULATIVE	S ER K Y AH L AH T IH V
CIRCULATOR	S ER K Y AH L AH T ER
CIRCULATORS	S ER K Y AH L AH T ER Z
CIRCULATORY	S ER K Y AH L AH T AO R IY
CIRCUMAMBIENT	S ER K AH M AE M B IY AH N T
CIRCUMAMBIENTLY	S ER K AH M AE M B IY AH N T L IY
CIRCUMAMBULATE	S ER K AH M AE M B Y AH L AH T
CIRCUMAMBULATED	S ER K AH M AE M B Y AH L EY T IH D
CIRCUMAMBULATES	S ER K AH M AE M B Y AH L AH T S
CIRCUMAMBULATING	S ER K AH M AE M B Y AH L EY T IH NG
CIRCUMAMBULATION	S ER K AH M AE M B Y AH L EY SH AH N
CIRCUMAMBULATIONS	S ER K AH M AE M B Y AH L EY SH AH N Z
CIRCUMCENTER	S ER K AH M S EH N T ER
CIRCUMCENTERS	S ER K AH M S EH N T ER Z
CIRCUMCIRCLE	S ER K AH M S ER K AH L
CIRCUMCIRCLES	S ER K AH M S ER K AH L Z
CIRCUMCISE	S ER K AH M S AY Z
CIRCUMCISED	S ER K AH M S AY Z D
CIRCUMCISER	S AH R K AH M S AH S AH R
CIRCUMCISERS	S AH R K AH M S IH S AH R Z
CIRCUMCISES	S AH R K AH M S AY Z AH Z
CIRCUMCISING	S AH R K AH M S AY Z AH NG
CIRCUMCISION	S ER K AH M S IH ZH AH N
CIRCUMCISIONS	S ER K AH M S IH ZH AH N Z
CIRCUMFERENCE	S ER K AH M F R AH N S
CIRCUMFERENCES	S ER K AH M F R AH N S IH Z
CIRCUMFERENTIAL	S ER K AH M F ER AH N T IY AH L
CIRCUMFLEX	S ER K AH M F L EH K S
CIRCUMFLEXES	S ER K AH M F L EH K S IH Z
CIRCUMFLUENT	S ER K AH M F L UW AH N T
CIRCUMFLUOUS	S ER K AH M F L UW AH S
CIRCUMFUSE	S ER K AH M F Y UW Z
CIRCUMFUSED	S ER K AH M F Y UW Z D
CIRCUMFUSES	S ER K AH M F Y UW Z IH Z
CIRCUMFUSING	S ER K AH M F Y UW Z IH NG
CIRCUMFUSION	S ER K AH M F Y UW ZH AH N
CIRCUMFUSIONS	S ER K AH M F Y UW ZH AH N Z
CIRCUMJACENT	S AH R K AH M JH AH S AH N T
CIRCUMLOCUTION	S ER K AH M L OW K Y UW SH AH N
CIRCUMLOCUTIONS	S ER K AH M L OW K Y UW SH AH N Z
CIRCUMLOCUTORY	S AH R K AH M L AA K Y AH T AO R IY
CIRCUMLUNAR	S ER K AH M L UW N ER
CIRCUMNAVIGATE	S ER K AH M N AE V AH G EY T
CIRCUMNAVIGATED	S ER K AH M N AE V AH G EY T IH D
CIRCUMNAVIGATES	S ER K AH M N AE V AH G AH T S
CIRCUMNAVIGATING	S ER K AH M N AE V AH G EY T IH NG
CIRCUMNAVIGATION	S ER K AH M N AE V AH G EY SH AH N
CIRCUMNAVIGATIONS	S ER K AH M N AE V AH G EY SH AH N Z
CIRCUMNAVIGATOR	S ER K AH M N AE V AH G AH T ER
CIRCUMNAVIGATORS	S ER K AH M N AE V AH G AH T ER Z
CIRCUMPOLAR	S ER K AH M P OW L ER
CIRCUMSCISSILE	S AH R K AH M S IH S AH L
CIRCUMSCRIBE	S ER K AH M S K R AY B
CIRCUMSCRIBED	S ER K AH M S K R AY B D
CIRCUMSCRIBES	S ER K AH M S K R AY B Z
CIRCUMSCRIBING	S ER K AH M S K R AY B IH NG
CIRCUMSCRIPTION	S ER K AH M S K R IH P SH AH N
CIRCUMSCRIPTIONS	S ER K AH M S K R IH P SH AH N Z
CIRCUMSPECT	S ER K AH M S P EH K T
CIRCUMSPECTION	S ER K AH M S P EH K SH AH N
CIRCUMSPECTIONS	S ER K AH M S P EH K SH AH N Z
CIRCUMSPECTLY	S ER K AH M S P EH K T L IY
CIRCUMSTANCE	S ER K AH M S T AE N S
CIRCUMSTANCED	S ER K AH M S T AE N S T
CIRCUMSTANCES	S ER K AH M S T AE N S AH Z
CIRCUMSTANCES(2)	S ER K AH M S T AE N S IH Z
CIRCUMSTANTIAL	S ER K AH M S T AE N SH AH L
CIRCUMSTANTIALITIES	S AH R K AH M S T AE N T IY AE L AH T AY Z
CIRCUMSTANTIALITY	S AH R K AH M S T AE N T IY AE L AH T IY
CIRCUMSTANTIALLY	S ER K AH M S T AE N SH AH L IY
CIRCUMSTANTIATE	S AH R K AH M S T AE N T AY EY T
CIRCUMSTANTIATED	S AH R K AH M S T AE N T AY EY T AH D
CIRCUMSTANTIATES	S AH R K AH M S T AE N T AY EY T S
CIRCUMSTANTIATING	S AH R K AH M S T AE N T AY EY T AH NG
CIRCUMSTELLAR	S ER K AH M S T EH L ER
CIRCUMVALLATE	S AH R K AH M V AE L EY T
CIRCUMVALLATED	S AH R K AH M V AE L EY T AH D
CIRCUMVALLATES	S AH R K AH M V AE L EY T S
CIRCUMVALLATING	S AH R K AH M V AE L EY T AH NG
CIRCUMVALLATION	S AH R K AH M V AE L EY SH AH N
CIRCUMVALLATIONS	S AH R K AH M V AE L EY T IY AH N Z
CIRCUMVENT	S ER K AH M V EH N T
CIRCUMVENTED	S ER K AH M V EH N T IH D
CIRCUMVENTING	S ER K AH M V EH N T IH NG
CIRCUMVENTION	S ER K AH M V EH N CH AH N
CIRCUMVENTIONS	S ER K AH M V EH N CH AH N Z
CIRCUMVENTS	S ER K AH M V EH N T S
CIRCUMVOLUTION	S AH R K AH M V AA L Y UW T IY AH N
CIRCUMVOLUTIONS	S AH R K AH M V AH L UW T IY AH N Z
CIRCUS	S ER K AH S
CIRCUSES	S ER K AH S AH Z
CIRCUSY	S ER K AH S IY
CIRE	S AY R
CIRES	S AY R Z
CIRQUE	S ER K
CIRQUES	S AH R K S
CIRRATE	S AH R EY T
CIRRHOSES	S AH R OW Z AH Z
CIRRHOSIS	S ER OW S AH S
CIRRHOTIC	S AH R AH T AH K
CIRRHOTICS	S AH R AH T AH S Z
CIRRI	S AH R IY
CIRRIPED	S AH R AY P T
CIRRIPEDS	S AH R AH P AH D Z
CIRROCUMULI	S AH R AA K Y UW M Y UW L IY
CIRROCUMULUS	S AH R AH K Y UW M Y AH L AH S
CIRROSE	S AH R OW Z
CIRROSTRATI	S AH R AA S T R AH T IY
CIRROSTRATUS	S AH R AH S T R EY T AH S
CIRROUS	S AH R AH S
CIRRUS	S IH R AH S
CIRSOID	S IH R Z OY D
CIS	S IH Z
CISALPINE	S IH S AH L P AY N
CISCO	S IH S K OW
CISCOES	S IH S OW Z
CISCOS	S IH S AH Z
CISLUNAR	S IH Z L UW N AH R
CISPLATIN	S IH S L AH T AH N
CISPLATINS	S IH S L AH T AH N Z
CISSIES	S IH S AY Z
CISSOID	S AH S OY D
CISSOIDS	S IH S OY D Z
CISSY	S IH S IY
CIST	S IH S T
CISTERN	S IH S T ER N
CISTERNA	S IH S T AH R N AH
CISTERNAE	S IH S T AH R N IY
CISTERNAL	S IH S T ER N AH L
CISTERNS	S IH S T ER N Z
CISTRON	S IH S T R AH N
CISTRONIC	S IH S T R AH N AH K
CISTRONS	S IH S T R AH N Z
CISTS	S IH S T S
CISTUS	S IH S T AH S
CISTUSES	S IH S T Y UW Z AH Z
CITABLE	S AY T AH B AH L
CITADEL	S IH T AH D EH L
CITADELS	S IH T AH D AH L Z
CITATION	S AY T EY SH AH N
CITATIONAL	S AY T EY SH AH N AH L
CITATIONS	S AY T EY SH AH N Z
CITATOR	S AY T AH T ER
CITATORS	S AY T AH T ER Z
CITATORY	S AY T AH T OW R IY
CITE	S AY T
CITEABLE	S AY T AH B AH L
CITED	S AY T AH D
CITED(2)	S AY T IH D
CITER	S AY T ER
CITERS	S AY T ER Z
CITES	S AY T S
CITHARA	S IH TH AH R AH
CITHARAS	S IH TH AH R AH Z
CITHER	S IH DH AH R
CITHERN	S IH TH AH R N
CITHERNS	S IH TH AH R N Z
CITHERS	S IH TH AH R Z
CITHREN	S IH TH R AH N
CITHRENS	S IH TH R AH N Z
CITIED	S IH T IY D
CITIES	S IH T IY Z
CITIFICATION	S AY T AH F AH K EY SH AH N
CITIFICATIONS	S AY T AH F AH K EY SH AH N Z
CITIFIED	S AY T AH F AY D
CITIFIES	S AY T AH F AY Z
CITIFY	S AY T AH F AY
CITIFYING	S AY T AH F AY IH NG
CITING	S AY T IH NG
CITIZEN	S IH T AH Z AH N
CITIZEN(2)	S IH T IH Z AH N
CITIZENESS	S IH T AH Z AH N AH S
CITIZENESSES	S IH T AH Z AH N AH S IH Z
CITIZENLY	S IH T AH Z AH N L IY
CITIZENRIES	S IH T AH Z AH N R IY Z
CITIZENRY	S IH T IH Z AH N R IY
CITIZENS	S IH T AH Z AH N Z
CITIZENS(2)	S IH T IH Z AH N Z
CITIZENSHIP	S IH T IH Z AH N SH IH P
CITIZENSHIPS	S IH T AH Z AH N SH IH P S
CITOLA	S IH T AH L AH
CITOLAS	S IH T AH L AH Z
CITOLE	S AH T OW L
CITOLES	S AH T OW L Z
CITRAL	S IH T R AH L
CITRALS	S IH T R AH L Z
CITRATE	S IH T R EY T
CITRATED	S IH T R EY T AH D
CITRATES	S IH T R EY T S
CITREOUS	S IH T R IY AH S
CITRIC	S IH T R IH K
CITRICULTURE	S IH T R AH K AH L T Y AH R
CITRICULTURES	S IH T R AH K AH L T Y AH R Z
CITRICULTURIST	S IH T R AH K AH L T Y AH R AH S T
CITRICULTURISTS	S IH T R AH K AH L T Y AH R AH S T S
CITRIN	S IH T R IH N
CITRINE	S IH T R IY N
CITRINES	S IH T R AY N Z
CITRININ	S IH T R AH N AH N
CITRININS	S IH T R AH N AH N Z
CITRINS	S IH T R AH N Z
CITRON	S IH T R AH N
CITRON(2)	S IH T R AH N Z
CITRONELLA	S IH T R AA N EH L AH
CITRONELLAL	S IH T R AH N EH L AH L
CITRONELLALS	S IH T R AH N EH L AH L Z
CITRONELLAS	S IH T R AH N EH L AH Z
CITRONELLOL	S IH T R AH N EH L AH L
CITRONELLOLS	S IH T R AH N EH L AH L Z
CITRONS	S IH T R AH N Z
CITROUS	S IH T R AH S
CITRULLINE	S IH T R AH L AY N
CITRULLINES	S IH T R AH L AY N Z
CITRUS	S IH T R AH S
CITRUSES	S IH T R AH S IH Z
CITRUSY	S IH T R AH S IY
CITTERN	S IH T AH R N
CITTERNS	S IH T AH R N Z
CITY	S IH T IY
CITYFIED	S IH T AH F AY D
CITYSCAPE	S IH T IY S K EY P
CITYSCAPES	S IH T IY S K EY P S
CITYWARD	S IH T IY W ER D
CITYWIDE	S IH T IY W AY D
CIVET	S IH V AH T
CIVETS	S IH V AH T S
CIVIC	S IH V IH K
CIVICALLY	S IH V IH K AH L IY
CIVICISM	S IH V IH K IH Z AH M
CIVICISMS	S IH V IH K IH Z AH M Z
CIVICS	S IH V IH K S
CIVIE	S IH V AY
CIVIES	S AH V AY Z
CIVIL	S IH V AH L
CIVILIAN	S AH V IH L Y AH N
CIVILIANIZATION	S AH V IH L Y AH N AH Z EY SH AH N
CIVILIANIZATIONS	S AH V IH L Y AH N AH Z EY SH AH N Z
CIVILIANIZE	S AH V IH L Y AH N AY Z
CIVILIANIZED	S AH V IH L Y AH N AY Z D
CIVILIANIZES	S AH V IH L Y AH N AY Z IH Z
CIVILIANIZING	S AH V IH L Y AH N AY Z IH NG
CIVILIANS	S AH V IH L Y AH N Z
CIVILISATION	S IH V AH L IY Z EY SH AH N
CIVILISATIONS	S IH V AH L IY Z EY SH AH N Z
CIVILISE	S IH V AH L AY Z
CIVILISED	S IH V AH L IY Z D
CIVILISES	S IH V AH L IY Z IH Z
CIVILISING	S IH V AH L IY Z IH NG
CIVILITIES	S AH V IH L AH T IY Z
CIVILITY	S AH V IH L AH T IY
CIVILIZATION	S IH V AH L IH Z EY SH AH N
CIVILIZATIONAL	S IH V AH L AH Z EY SH AH N AH L
CIVILIZATIONS	S IH V AH L IH Z EY SH AH N Z
CIVILIZE	S IH V AH L AY Z
CIVILIZED	S IH V AH L AY Z D
CIVILIZER	S IH V AH L AY Z ER
CIVILIZERS	S IH V AH L AY Z ER Z
CIVILIZES	S IH V AH L AY Z IH Z
CIVILIZING	S IH V AH L AY Z IH NG
CIVILLY	S IH V IH L IY
CIVISM	S AY V AH Z AH M
CIVISMS	S IH V AH Z AH M Z
CIVVIES	S IH V AY Z
CIVVY	S IH V IY
CLASSICISM	K L AE S IH S IH Z AH M
CLASSICISMS	K L AE S IH K S IH Z AH M Z
CLASSICIST	K L AE S AH S AH S T
CLASSICISTIC	K L AE S AH S AH S T IH K
CLASSICISTS	K L AE S AH S AH S T S
CLASSICIZE	K L AE S IH K S AY Z
CLASSICIZED	K L AE S IH K S AY Z D
CLASSICIZES	K L AE S IH K S AY Z IH Z
CLASSICIZING	K L AE S IH K S AY Z IH NG
CLEMENCIES	K L EH M AH N S IY Z
CLINICIAN	K L IH N IH SH AH N
CLINICIANS	K L IH N IH SH AH N Z
CLIOMETRICIAN	K L AY AH M EH T R IH S IY AH N
CLIOMETRICIANS	K L AY AH M AH T R IH S IY AH N Z
CLONICITIES	K L AA N IH K AH T IY Z
CLONICITY	K L AA N IH K AH T IY
CLOXACILLIN	K L AA K S AH S IH L AH N
CLOXACILLINS	K L AA K S AH S IH L AH N Z
COAGENCIES	K OW EY JH AH N S IY Z
COALESCING	K OW AH L EH S IH NG
COCARCINOGEN	K OW K AA R S IH N AH JH AH N
COCARCINOGENIC	K OW K AA R S IH N AH JH AH N AH K
COCARCINOGENS	K OW K AA R S IH N AH JH AH N Z
COCCI	K AA K S IY
COCCIC	K AA K S AH K
COCCID	K AA K S IH D
COCCIDIA	K AA K S IH D IY AH
COCCIDIOIDOMYCOSES	K AA K S AH D IY OY D AA M AH K OW Z AH Z
COCCIDIOIDOMYCOSIS	K AA K S IH D IY OY D OW M AY K OW S AH S
COCCIDIOSES	K AA K S IH D IY OW Z AH Z
COCCIDIOSIS	K AA K S IH D IY OW S AH S
COCCIDIUM	K AA K S IH D IY AH M
COCCIDS	K AA K S IH D Z
COCINERA	K OW S IH N AH R AH
COCINERAS	K OW S IH N AH R AH Z
CODEPENDENCIES	K OW D IH P EH N D AH N S IY Z
CODICIL	K OW D IH S AH L
CODICILLARY	K OW D IH K S IH L EH R IY
CODICILS	K AH D IH S AH L Z
COEFFICIENT	K OW AH F IH SH AH N T
COEFFICIENTS	K OW AH F IH SH AH N T S
COERCIBLE	K OW ER S AH B AH L
COERCING	K OW ER S IH NG
COERCION	K OW ER SH AH N
COERCIONS	K OW ER SH AH N Z
COERCIVE	K OW ER S IH V
COERCIVELY	K OW ER S IH V L IY
COERCIVENESS	K OW ER S IH V N AH S
COERCIVENESSES	K OW ER S IH V N AH S IH Z
COERCIVITIES	K OW ER S IH V AH T IY Z
COERCIVITY	K OW ER S IH V AH T IY
COFINANCING	K OW F AH N AE N S IH NG
COGENCIES	K OW JH AH N S IY Z
COGNOSCIBLE	K AH N AA S AH B AH L
COHERENCIES	K OW HH IH ER AH N S IY Z
COINCIDE	K OW IH N S AY D
COINCIDED	K OW AH N S AY D AH D
COINCIDENCE	K OW IH N S IH D AH N S
COINCIDENCES	K OW IH N S AH D AH N S IH Z
COINCIDENT	K OW IH N S AH D AH N T
COINCIDENTAL	K OW IH N S AH D EH N T AH L
COINCIDENTALLY	K OW IH N S IH D EH N T AH L IY
COINCIDENTLY	K OW IH N S AH D AH N T L IY
COINCIDES	K OW IH N S AY D Z
COINCIDING	K OW AH N S AY D IH NG
COLCHICINE	K AO L CH AH S IY N
COLCHICINES	K AA L CH AH S AY N Z
COLICIN	K OW L IH K S IH N
COLICINE	K OW L AH S AY N
COLICINES	K OW L AH S AY N Z
COLICINS	K OW L IH K S IH N Z
COLONELCIES	K OW L AH N EH L S AY Z
COMMENCING	K AH M EH N S IH NG
COMMERCIAL	K AH M ER SH AH L
COMMERCIALISE	K AA M AH R S IY AH L AY Z
COMMERCIALISED	K AH M ER SH AH L IY Z D
COMMERCIALISES	K AH M ER SH AH L IY Z IH Z
COMMERCIALISING	K AH M ER SH AH L IY Z IH NG
COMMERCIALISM	K AH M ER SH AH L IH Z AH M
COMMERCIALISMS	K AH M ER SH AH L IH Z AH M Z
COMMERCIALIST	K AH M ER SH AH L IH S T
COMMERCIALISTIC	K AH M ER SH AH L IH S T IH K
COMMERCIALISTS	K AH M ER SH AH L IH S T S
COMMERCIALITIES	K AH M ER SH AH L AH T IY Z
COMMERCIALITY	K AH M ER SH AH L AH T IY
COMMERCIALIZATION	K AH M ER SH AH L IH Z EY SH AH N
COMMERCIALIZATIONS	K AH M ER SH AH L AH Z EY SH AH N Z
COMMERCIALIZE	K AH M ER SH AH L AY Z
COMMERCIALIZED	K AH M ER SH AH L AY Z D
COMMERCIALIZES	K AH M ER SH AH L AY Z IH Z
COMMERCIALIZING	K AH M ER SH AH L AY Z IH NG
COMMERCIALLY	K AH M ER SH AH L IY
COMMERCIALS	K AH M ER SH AH L Z
COMMERCING	K AA M ER S IH NG
COMPETENCIES	K AA M P AH T IH N S IY Z
COMPLACENCIES	K AH M P L EY S AH N S IY Z
COMPLIANCIES	K AH M P L AY AH N S IY Z
COMPLICACIES	K AA M P L AH K AH S IY Z
COMPLICIT	K AH M P L IH S AH T
COMPLICITIES	K AH M P L IH S IH T IY Z
COMPLICITOUS	K AA M P L IH S AH T AH S
COMPLICITY	K AH M P L IH S AH T IY
COMPLICITY(2)	K AH M P L IH S IH T IY
CONCENTRICITIES	K AH N S EH N T R IH K AH T IY Z
CONCENTRICITY	K AH N S EH N T R IH K AH T IY
CONCIERGE	K AA N S IY EH R ZH
CONCIERGES	K OW N S Y EH R ZH IH Z
CONCILIAR	K AH N S IH L IY ER
CONCILIARLY	K AH N S IH L IY ER L IY
CONCILIATE	K AH N S IH L IY EY T
CONCILIATED	K AH N S IH L IY EY T IH D
CONCILIATES	K AH N S IH L IY EY T S
CONCILIATING	K AH N S IH L IY EY T IH NG
CONCILIATION	K AH N S IH L IY EY SH AH N
CONCILIATIONS	K AH N S IH L IY EY SH AH N Z
CONCILIATIVE	K AH N S IH L IY EY T IH V
CONCILIATOR	K AH N S IH L IY EY T ER
CONCILIATORS	K AH N S IH L IY EY T ER Z
CONCILIATORY	K AH N S IH L IY AH T AO R IY
CONCILIATORY(2)	K AH N S IH L Y AH T AO R IY
CONCINNITIES	K AA N S IH N AH T AY Z
CONCINNITY	K AA N S IH N AH T IY
CONCISE	K AH N S AY S
CONCISELY	K AH N S AY S L IY
CONCISENESS	K AH N S AY S N AH S
CONCISENESSES	K AH N S AY S N AH S IH Z
CONCISER	K AH N S AY S ER
CONCISEST	K AH N S AY S AH S T
CONCISION	K AH N S AY ZH AH N
CONCISIONS	K AH N S AY ZH AH N Z
CONCUPISCIBLE	K AA N K Y AH P IH S AH B AH L
CONCURRENCIES	K AH N K ER AH N S IY Z
CONDUCING	K AH N D UW S IH NG
CONDUCIVE	K AH N D UW S IH V
CONDUCIVENESS	K AH N D UW S IH V N AH S
CONDUCIVENESSES	K AH N D UW S IH V N AH S IH Z
CONFEDERACIES	K AH N F EH D ER AH S IY Z
CONFERENCING	K AA N F R AH N S IH NG
CONFERENCINGS	K AA N F AH R AH N S IH NG Z
CONGRUENCIES	K AH N G R UW AH N S IY Z
CONICITIES	K AA N IH K AH T IY Z
CONICITY	K AA N IH K AH T IY
CONSCIENCE	K AA N SH AH N S
CONSCIENCELESS	K AA N CH AH N S L AH S
CONSCIENCES	K AA N CH IH N S IH Z
CONSCIENTIOUS	K AA N SH IY EH N SH AH S
CONSCIENTIOUSLY	K AA N CH IY EH N CH AH S L IY
CONSCIENTIOUSNESS	K AA N CH IY EH N CH AH S N AH S
CONSCIENTIOUSNESSES	K AA N CH IY EH N CH AH S N AH S IH Z
CONSCIONABLE	K AA N CH AH N AH B AH L
CONSCIOUS	K AA N SH AH S
CONSCIOUSES	K AA N SH AH S IH Z
CONSCIOUSLY	K AA N SH AH S L IY
CONSCIOUSNESS	K AA N SH AH S N AH S
CONSCIOUSNESSES	K AA N SH AH S N AH S IH Z
CONSERVANCIES	K AH N S ER V AH N S IY Z
CONSISTENCIES	K AH N S IH S T AH N S IY Z
CONSOCIATE	K AH N S OW SH AH T
CONSOCIATED	K AH N S OW SH EY T IH D
CONSOCIATES	K AH N S OW SH AH T S
CONSOCIATING	K AH N S OW SH EY T IH NG
CONSOCIATION	K AH N S OW SH EY SH AH N
CONSOCIATIONAL	K AH N S OW SH EY SH AH N AH L
CONSOCIATIONS	K AH N S OW SH EY SH AH N Z
CONSONANCIES	K AA N S AH N AH N S IY Z
CONSPECIFIC	K AH N S P IH S IH F IH K
CONSPECIFICS	K AH N S P IH S IH F IH K S
CONSPIRACIES	K AH N S P IH R AH S IY Z
CONSTANCIES	K AA N S T AH N S IY Z
CONSTITUENCIES	K AH N S T IH CH UW AH N S IY Z
CONSULTANCIES	K AH N S AH L T AH N S IY Z
CONTINGENCIES	K AH N T IH N JH AH N S IY Z
CONTUMACIES	K AH N T UW M AH S IY Z
CONTUMACIOUS	K AH N T UW M AH S IY AH S
CONTUMACIOUSLY	K AH N T UW M AH S IY AH S L IY
CONVALESCING	K AA N V AH L EH S IH NG
CONVENIENCIES	K AH N V IY N Y AH N S IY Z
CONVERGENCIES	K AH N V ER JH AH N S IY Z
CONVERSANCIES	K AH N V ER S AH N S IY Z
CONVEYANCING	K AH N V EY AH N S IH NG
CONVEYANCINGS	K AH N V EY AH N S IH NG Z
CONVINCING	K AH N V IH N S IH NG
CONVINCINGLY	K AH N V IH N S IH NG L IY
CONVINCINGNESS	K AH N V IH N S IH NG N AH S
CONVINCINGNESSES	K AH N V IH N S IH NG N AH S IH Z
COPPICING	K AA P IH K S IH NG
COPRINCIPAL	K OW P R IH N S AH P AH L
COPRINCIPALS	K OW P R IH N S AH P AH L Z
COPRODUCING	K OW P R AH D UW S IH NG
CORECIPIENT	K OW R IH S IH P IY AH N T
CORECIPIENTS	K OW R IH S IH P IY AH N T S
CORNETCIES	K AA R N EH T S AY Z
CORNICING	K AO R N IH K S IH NG
CORPULENCIES	K AO R P Y AH L AH N S IY Z
CORRESPONDENCIES	K AO R AH S P AA N D AH N S IY Z
COSMETICIAN	K AA S M AH T IH S IY AH N
COSMETICIANS	K AA S M AH T IH S IY AH N Z
COSMETICIZE	K AA Z M EH T IH K AY Z
COSMETICIZED	K AA Z M EH T IH K AY Z D
COSMETICIZES	K AA Z M EH T IH K AY Z IH Z
COSMETICIZING	K AA Z M EH T IH K AY Z IH NG
COTRANSDUCING	K OW T R AE N S D UW S IH NG
COUNCIL	K AW N S AH L
COUNCILLOR	K AW N S AH L ER
COUNCILLORS	K AW N S AH L ER Z
COUNCILLORSHIP	K AW N S AH L ER SH IH P
COUNCILLORSHIPS	K AW N S AH L ER SH IH P S
COUNCILMAN	K AW N S AH L M AH N
COUNCILMANIC	K AW N S AH L M AE N IH K
COUNCILMEN	K AW N S AH L M EH N
COUNCILOR	K AW N S IH L ER
COUNCILORS	K AW N S IH L ER Z
COUNCILS	K AW N S IH L Z
COUNCILWOMAN	K AW N S IH L W UH M AH N
COUNCILWOMEN	K AW N S IH L W IH M AH N
COUNTENANCING	K AW N T AH N AH N S IH NG
COUNTERBALANCING	K AW N T ER B AE L AH N S IH NG
COUNTERBALANCING(2)	K AW N ER B AE L AH N S IH NG
COUNTERCOMMERCIAL	K AW N T ER K AH M ER SH AH L
COUNTERCONSPIRACIES	K AW N T ER K AH N S P IH R AH S IY Z
COUNTERCRITICISM	K AW N T ER K R IH T AH S IH Z AH M
COUNTERCRITICISMS	K AW N T ER K R IH T AH S IH Z AH M Z
COUNTERINFLUENCING	K AW N T ER IH N F L UW AH N S IH NG
COUNTERINSURGENCIES	K AW N T ER IH N S ER JH AH N S IY Z
COUNTERINSURGENCIES(2)	K AW N ER IH N S ER JH AH N S IY Z
COUNTERSCIENTIFIC	K AW N T ER S AY AH N T IH F IH K
COUNTERTENDENCIES	K AW N T ER T EH N D AH N S IY Z
COVALENCIES	K OW V EY L AH N S IY Z
CRANIOFACIAL	K R EY N IY AH F AH S IY AH L
CRESCIVE	K R EH S IH V
CRESCIVELY	K R EH S IH V L IY
CRITICISE	K R IH T AH S AY Z
CRITICISED	K R IH T IH K IY Z D
CRITICISES	K R IH T IH K IY Z IH Z
CRITICISING	K R IH T IH K IY Z IH NG
CRITICISM	K R IH T IH S IH Z AH M
CRITICISMS	K R IH T IH S IH Z AH M Z
CRITICIZABLE	K R IH T AH S AY Z AH B AH L
CRITICIZE	K R IH T IH S AY Z
CRITICIZED	K R IH T AH S AY Z D
CRITICIZER	K R IH T AH S AY Z ER
CRITICIZERS	K R IH T AH S AY Z ER Z
CRITICIZES	K R IH T IH S AY Z IH Z
CRITICIZING	K R IH T IH S AY Z IH NG
CROCI	K R AA S IY
CROCIDOLITE	K R AH S IH D AH L AY T
CROCIDOLITES	K R AH S IH D AH L AY T S
CROCINE	K R AH S AY N
CRUCIAL	K R UW SH AH L
CRUCIALLY	K R UW SH AH L IY
CRUCIAN	K R UW SH AH N
CRUCIANS	K R UW S IY AH N Z
CRUCIATE	K R UW S AY EY T
CRUCIBLE	K R UW S AH B AH L
CRUCIBLES	K R UW S AH B AH L Z
CRUCIFER	K R UW S AY F AH R
CRUCIFEROUS	K R UW S IH F AH R AH S
CRUCIFERS	K R UW S AH F AH R Z
CRUCIFIED	K R UW S AH F AY D
CRUCIFIES	K R UW S AH F AY Z
CRUCIFIX	K R UW S AH F IH K S
CRUCIFIXES	K R UW S AH F IH K S IH Z
CRUCIFIXION	K R UW S IH F IH K SH AH N
CRUCIFIXIONS	K R UW S AH F IH K SH AH N Z
CRUCIFORM	K R UW S AH F AH R M
CRUCIFORMS	K R UW S AH F AH R M Z
CRUCIFY	K R UW S AH F AY
CRUCIFYING	K R UW S AH F AY IH NG
CRUCIVERBALIST	K R UW S AH V AH R B AH L AH S T
CRUCIVERBALISTS	K R UW S AH V AH R B AH L AH S T S
CRYPTOCOCCI	K R IH P T AH K AA K S IY
CUBICITIES	K Y UW B IH K S AH T IY Z
CUBICITY	K Y UW B IH K S AH T IY
CULICID	K Y UW L AH S AH D
CULICIDS	K Y UW L AH S AH D Z
CULICINE	K Y UW L AH S AY N
CULICINES	K Y UW L AH S AY N Z
CURACIES	K Y UH R AH S IY Z
CURRENCIES	K ER AH N S IY Z
CURVACIOUS	K ER V AH S IY AH S
CYBERNETICIAN	S AH B AH R N AH T IH S IY AH N
CYBERNETICIANS	S AH B AH R N AH T IH S IY AH N Z
CYBERNETICIST	S AH B AH R N AH T IH S AH S T
CYBERNETICISTS	S IH B AH R N EH T AH S AH S T S
CYCLAZOCINE	S IH K L AE Z AH S AY N
CYCLAZOCINES	S IH K L AE Z AH S AY N Z
CYCLICITIES	S IH K L IH K AH T IY Z
CYCLICITY	S IH K L IH K AH T IY
CYNICISM	S IH N IH S IH Z AH M
CYNICISMS	S IH N AH S IH Z AH M Z
CYSTICERCI	S IH S T AH S AH R S IY
CYTOGENETICIST	S IH T AH JH EH N AH T IH S AH S T
CYTOGENETICISTS	S IH T AH JH AH N EH T AH S AH S T S
CYTOPATHOGENICITIES	S AH T AH P AE TH AH JH AH N IH S AH T AY Z
CYTOPATHOGENICITY	S IH T AH P AH TH AA JH AH N IH S AH T IY
CYTOTOXICITIES	S IH T AH T AA K S IH S AH T AY Z
CYTOTOXICITY	S IH T AH T AA K S IH S AH T IY
DANCING	D AE N S IH NG
DAUNOMYCIN	D AH N AA M AH S AH N
DAUNOMYCINS	D AH N AA M AH S AH N Z
DAUNORUBICIN	D AO N AH R UW B AH S AH N
DAUNORUBICINS	D AO N AH R UW B AH S AH N Z
DEACIDIFICATION	D IY AE S AH D AH F AH K EY SH AH N
DEACIDIFICATIONS	D IY AE S AH D AH F AH K EY SH AH N Z
DEACIDIFIED	D IY AE S AH D AH F AY D
DEACIDIFIES	D IY AE S AH D AH F AY Z
DEACIDIFY	D IY AE S AH D AH F AY
DEACIDIFYING	D IY AE S AH D AH F AY IH NG
DECADENCIES	D EH K AH D AH N S IY Z
DECALCIFICATION	D IY K AE L S AH F AH K EY SH AH N
DECALCIFICATIONS	D IY K AE L S AH F AH K EY SH AH N Z
DECALCIFIED	D IY K AE L S AH F AY D
DECALCIFIES	D IY K AE L S AH F AY Z
DECALCIFY	D IY K AE L S AH F AY
DECALCIFYING	D IY K AE L S AH F AY IH NG
DECENCIES	D IY S AH N S IY Z
DECIARE	D AH S AY AH R
DECIARES	D AH S AY AH R Z
DECIBEL	D EH S AH B EH L
DECIBELS	D EH S AH B AH L Z
DECIDABILITIES	D IH S AY D AH B IH L AH T EH Z
DECIDABILITY	D IH S AY D AH B IH L AH T EH
DECIDABLE	D IH S AY D AH B AH L
DECIDE	D IH S AY D
DECIDED	D IH S AY D IH D
DECIDEDLY	D IH S AY D AH D L IY
DECIDEDNESS	D IH S AY D AH D N AH S
DECIDEDNESSES	D IH S AY D AH D N AH S IH Z
DECIDER	D IH S AY D ER
DECIDERS	D IY S AY D ER Z
DECIDES	D IH S AY D Z
DECIDING	D IH S AY D IH NG
DECIDUA	D AH S IH D Y UW AH
DECIDUAE	D AH S IH D Y UW IY
DECIDUAL	D AH S IH D Y AH W AH
DECIDUAS	D AH S IH D Y UW AH Z
DECIDUATE	D AH S IH D Y UW EY T
DECIDUOUS	D IH S IH JH UW AH S
DECIDUOUSNESS	D AH S IH D Y UW AW Z N AH S
DECIDUOUSNESSES	D AH S IH D Y UW AW Z N EH S AH Z
DECIGRAM	D AH S IH G R AH M
DECIGRAMS	D AH S IH G R AH M Z
DECILE	D IY S AH L
DECILES	D IY S AH L Z
DECILITER	D EH S AH L IY T ER
DECILITERS	D AH S IH L AH T AH R Z
DECILLION	D AH S IH L IY AH N
DECILLIONS	D AH S IH L IY AH N Z
DECIMAL	D EH S AH M AH L
DECIMALIZATION	D EH S AH M AH L AH Z EY SH AH N
DECIMALIZATIONS	D EH S AH M AH L AH Z EY SH AH N Z
DECIMALIZE	D EH S AH M AH L AY Z
DECIMALIZED	D EH S AH M AH L AY Z D
DECIMALIZES	D EH S AH M AH L AY Z IH Z
DECIMALIZING	D EH S AH M AH L AY Z IH NG
DECIMALLY	D EH S AH M AH L IY
DECIMALS	D EH S AH M AH L Z
DECIMATE	D EH S AH M EY T
DECIMATED	D EH S AH M EY T IH D
DECIMATES	D IH S AH M EY T S
DECIMATING	D EH S AH M EY T IH NG
DECIMATION	D EH S AH M EY SH AH N
DECIMATIONS	D AH S AH M EY T IY AH N Z
DECIMETER	D AH S IH M AH T AH R
DECIMETERS	D AH S IH M AH T AH R Z
DECIPHER	D IH S AY F ER
DECIPHERABLE	D IY S AY F ER AH B AH L
DECIPHERED	D IH S AY F ER D
DECIPHERER	D IY S AY F ER ER
DECIPHERERS	D IY S AY F ER ER Z
DECIPHERING	D AH S AY F ER IH NG
DECIPHERMENT	D IY S AY F ER M AH N T
DECIPHERMENTS	D IY S AY F ER M AH N T S
DECIPHERS	D IY S AY F ER Z
DECISION	D IH S IH ZH AH N
DECISIONAL	D IH S IH ZH AH N AH L
DECISIONED	D IH S IH ZH AH N D
DECISIONING	D IH S IH ZH AH N IH NG
DECISIONS	D IH S IH ZH AH N Z
DECISIVE	D IH S AY S IH V
DECISIVELY	D IH S AY S IH V L IY
DECISIVENESS	D IH S AY S IH V N AH S
DECISIVENESSES	D AH S AY S IH V N AH S IH Z
DEDUCIBLE	D IH D UW S AH B AH L
DEDUCING	D IH D UW S IH NG
DEFACING	D IH F EY S IH NG
DEFICIENCIES	D IH F IH SH AH N S IY Z
DEFICIENCY	D IH F IH SH AH N S IY
DEFICIENT	D IH F IH SH AH N T
DEFICIENTLY	D IH F IH SH AH N T L IY
DEFICIENTS	D IH F IH SH AH N T S
DEFICIT	D EH F AH S AH T
DEFICITS	D EH F IH S IH T S
DEFORCING	D IY F OW R S IH NG
DEGENERACIES	D IY JH EH N ER AH S IY Z
DEGLACIATED	D IH G L AE S AY EY T AH D
DEGLACIATION	D IH G L AE S AY EY SH AH N
DEGLACIATIONS	D IH G L EY S IY EY T IY AH N Z
DEHISCING	D AH HH IH S AH NG
DEICIDAL	D IY AY S AH D AH L
DEICIDE	D IY AH S AY D
DEICIDES	D IY AH S AY D Z
DEICING	D IY AY S IH NG
DELEGACIES	D EH L IH G AH S IY Z
DELICACIES	D EH L IH K AH S IY Z
DELICIOUS	D IH L IH SH AH S
DELICIOUSLY	D IH L IH SH AH SH L IY
DELICIOUSNESS	D IH L IH SH AH S N AH S
DELICIOUSNESSES	D IH L IH SH AH S N AH S IH Z
DELINQUENCIES	D IH L IH NG K W AH N S IY Z
DELIQUESCING	D IH L AH K EH S AH NG
DEMOCRACIES	D IH M AA K R AH S IY Z
DENOUNCING	D IH N AW N S IH NG
DENUNCIATION	D IH N AH N S IY EY SH AH N
DENUNCIATIONS	D IH N AH N S IY EY SH AH N Z
DENUNCIATIVE	D AH N AH N S AY EY T AH V
DENUNCIATORY	D AH N AH N S AY AH T AO R IY
DEPENDENCIES	D IH P EH N D AH N S IY Z
DEPOLITICIZATION	D IY P AA L AH T IH K AH Z EY SH AH N
DEPOLITICIZATIONS	D IY P AA L AH T IH K AH Z EY SH AH N Z
DEPOLITICIZE	D IY P AA L AH T IH K AY Z
DEPOLITICIZED	D IY P AA L AH T IH K AY Z D
DEPOLITICIZES	D IY P AA L AH T IH K AY Z IH Z
DEPOLITICIZING	D IY P AA L AH T IH K AY Z IH NG
DEPRECIABLE	D IH P R IH SH AH B AH L
DEPRECIATE	D IH P R IY SH IY EY T
DEPRECIATED	D IH P R IY SH IY EY T IH D
DEPRECIATES	D IH P R IY SH IY EY T S
DEPRECIATING	D IH P R IY SH IY EY T IH NG
DEPRECIATINGLY	D IH P R IY SH IY EY T IH NG L IY
DEPRECIATION	D IH P R IY SH IY EY SH AH N
DEPRECIATIONS	D IH P R IY SH IY EY SH AH N Z
DEPRECIATIVE	D IH P R IY SH IY EY T IH V
DEPRECIATOR	D IH P R IY SH IY EY T ER
DEPRECIATORS	D IH P R IY SH IY EY T ER Z
DEPRECIATORY	D IH P R IY SH IY EY T ER IY
DERACINATE	D AH R AE S AH N EY T
DERACINATED	D AH R AE S AH N EY T AH D
DERACINATES	D AH R AE S AH N EY T S
DERACINATING	D AH R AE S AH N EY T AH NG
DERACINATION	D AH R AE S AH N EY SH AH N
DERACINATIONS	D AH R AE S AH N EY T IY AH N Z
DESPONDENCIES	D IH S P AA N D AH N S IY Z
DETERGENCIES	D IH T ER JH AH N S IY Z
DETERMINACIES	D IY T ER M AH N AH S IY Z
DEUCING	D IY Y UW S AH NG
DEVIANCIES	D IY V IY AH N S IY Z
DEVOICING	D IY V OY S IH NG
DEZINCING	D IY Z IH NG K IH NG
DIACID	D AY AH S AH D
DIACIDIC	D AY AH S AH D AH K
DIACIDS	D AY AH S AH D Z
DIAGNOSTICIAN	D AY IH G N AA S T IH SH AH N
DIAGNOSTICIANS	D AY IH G N AA S T IH SH AH N Z
DIALECTICIAN	D AY AH L EH K T IH S IY AH N
DIALECTICIANS	D AY AH L AH K T IH S IY AH N Z
DICIER	D AY S IY ER
DICIEST	D AY S IY AH S T
DICING	D AY S IH NG
DICKCISSEL	D IH K S IH S AH L
DICKCISSELS	D IH K S IH S AH L Z
DIDACTICISM	D IH D AE K T IH K S IH Z AH M
DIDACTICISMS	D IH D AE K T IH K S IH Z AH M Z
DIECIOUS	D IY SH AH S
DIETICIAN	D AY AH T IH SH AH N
DIETICIANS	D IY T IH S IY AH N Z
DIFFERENCING	D IH F ER AH N S IH NG
DIFFICILE	D IY F IH S IY L
DILATANCIES	D AY L EY T AH N S IY Z
DIOECIES	D AY OW AH S AY Z
DIOECIOUS	D AY OW AH SH AH S
DIOECISM	D AY OW AH S IH Z AH M
DIOECISMS	D AY OW AH S AH Z AH M Z
DIPLOCOCCI	D IH P L AH K AA K S IY
DIPLOMACIES	D AH P L OW M AH S IY Z
DISASSOCIATE	D IH S AH S OW SH IY EY T
DISASSOCIATE(2)	D IH S AH S OW S IY EY T
DISASSOCIATED	D IH S AH S OW SH IY EY T AH D
DISASSOCIATED(2)	D IH S AH S OW S IY EY T AH D
DISASSOCIATES	D IH S AH S OW S IY AH T S
DISASSOCIATING	D IH S AH S OW S IY EY T IH NG
DISASSOCIATION	D IH S AH S OW S IY EY SH AH N
DISASSOCIATIONS	D IH S AH S OW S IY EY SH AH N Z
DISCI	D IH S IY
DISCIFORM	D IH S IH F AH R M
DISCING	D IH S K IH NG
DISCIPLE	D IH S AY P AH L
DISCIPLED	D IH S AY P AH L D
DISCIPLES	D IH S AY P AH L Z
DISCIPLESHIP	D IH S AY P AH L SH IH P
DISCIPLESHIPS	D IH S AY P AH L SH IH P S
DISCIPLINABLE	D IH S AH P L AH N AH B AH L
DISCIPLINAL	D IH S AH P L AH N AH L
DISCIPLINARIAN	D IH S IH P L IH N EH R IY AH N
DISCIPLINARIANS	D IH S IH P L IH N EH R IY AH N Z
DISCIPLINARILY	D IH S AH P L AH N EH R IY L IY
DISCIPLINARITIES	D IH S AH P L AH N ER AH T IY Z
DISCIPLINARITY	D IH S AH P L AH N ER AH T IY
DISCIPLINARY	D IH S AH P L AH N EH R IY
DISCIPLINE	D IH S AH P L AH N
DISCIPLINED	D IH S AH P L AH N D
DISCIPLINER	D IH S AH P L AH N ER
DISCIPLINERS	D IH S AH P L AH N ER Z
DISCIPLINES	D IH S AH P L AH N Z
DISCIPLING	D IH S AY P AH L IH NG
DISCIPLINING	D IH S AH P L AH N IH NG
DISCORDANCIES	D IH S K AO R D AH N S IY Z
DISCOUNTENANCING	D IH S K AW N T AH N AH N S IH NG
DISCREPANCIES	D IH S K R EH P AH N S IY Z
DISGRACING	D IH S G R EY S IH NG
DISPLACING	D IH S P L EY S IH NG
DISSOCIABILITIES	D IH S OW SH AH B IH L AH T EH Z
DISSOCIABILITY	D IH S OW SH AH B IH L AH T EH
DISSOCIABLE	D IH S OW SH AH B AH L
DISSOCIAL	D IH S OW SH AH L
DISSOCIATE	D IH S OW S IY EY T
DISSOCIATED	D IH S OW SH EY T IH D
DISSOCIATES	D IH S OW SH AH T S
DISSOCIATING	D IH S OW SH EY T IH NG
DISSOCIATION	D IH S OW S IY EY SH AH N
DISSOCIATIONS	D IH S OW SH EY SH AH N Z
DISSOCIATIVE	D IH S OW SH AH T IH V
DISTANCING	D IH S T AH N S IH NG
DIVERGENCIES	D AY V ER JH AH N S IY Z
DIVORCING	D IH V AO R S IH NG
DOCILE	D AA S AH L
DOCILELY	D AA S AH L IY
DOCILITIES	D AA S AH L AH T IY Z
DOCILITY	D AA S IH L AH T IY
DOLCI	D OW L S IY
DOMESTICITIES	D OW M EH S T IH S AH T IY Z
DOMESTICITY	D OW M EH S T IH S AH T IY
DOMICIL	D AA M AH S AH L
DOMICILE	D AA M AH S AY L
DOMICILED	D AA M AH S AY L D
DOMICILES	D AA M AH S AY L Z
DOMICILIARY	D AA M AH S AY L IY EH R IY
DOMICILIATE	D AA M AH S AY L IY AH T
DOMICILIATED	D AA M AH S AY L IY EY T IH D
DOMICILIATES	D AA M AH S AY L IY AH T S
DOMICILIATING	D AA M AH S AY L IY EY T IH NG
DOMICILIATION	D AA M AH S AY L IY EY SH AH N
DOMICILIATIONS	D AA M AH S AY L IY EY SH AH N Z
DOMICILING	D AA M AH S AY L IH NG
DOMICILS	D AH M IH S AH L Z
DORMANCIES	D AO R M AH N S IY Z
DOXORUBICIN	D AA K S AH R UW B AH S AH N
DOXORUBICINS	D AA K S AH R UW B AH S AH N Z
DRYOPITHECINE	D R AY AH P IH TH AH S AY N
DRYOPITHECINES	D R AY AH P IH TH AH S AY N Z
DUCI	D Y UW S IY
DULCIANA	D UW L CH AE N AH
DULCIANAS	D AH L S IY AH N AH Z
DULCIFIED	D AH L S AH F AY D
DULCIFIES	D AH L S AH F AY Z
DULCIFY	D AH L S AH F AY
DULCIFYING	D AH L S IH F AY AH NG
DULCIMER	D AH L S IH M ER
DULCIMERS	D AH L S AH M AH R Z
DULCIMORE	D AH L S AH M AH R
DULCIMORES	D AH L S AH M AH R Z
DULCINEA	D AH L S IH N IY AH
DULCINEAS	D AH L S AH N IY Z
DUNCICAL	D AH N S IH S AH L
DUNCISH	D AH N S AH SH
DUODECILLION	D Y UW AA D AH S IH L IY AH N
DUODECILLIONS	D Y UW AH D AH S IH L IY AH N Z
DUODECIMAL	D Y UW AH D EH S AH M AH L
DUODECIMALS	D Y UW AH D EH S AH M AH L Z
DUODECIMO	D Y UW AH D EH S AH M OW
DUODECIMOS	D Y UW AH D EH S AH M AH Z
DUPLICITIES	D UW P L IH K AH T IY Z
DUPLICITOUS	D UW P L IH S IH T AH S
DUPLICITOUSLY	D AH P L AH S IH T OW AH S L IY
DUPLICITY	D UW P L IH S IH T IY
DYSTOCIA	D IH S T OW SH IY AH
DYSTOCIAS	D IH S T OW S IY AH Z
EBULLIENCIES	IH B UH L Y AH N S IY Z
ECCENTRICITIES	EH K S EH N T R IH S IH T IY Z
ECCENTRICITY	EH K S AH N T R IH S AH T IY
ECCLESIASTICISM	IH K L IY Z IY AE S T IH K IH Z AH M
ECCLESIASTICISMS	IH K L IY Z IY AE S T IH K IH Z AH M Z
ECHINOCOCCI	EH CH AH N AH K AA K S IY
ECLAIRCISSEMENT	EH K L AH AH R S IH S M AH N T
ECLAIRCISSEMENTS	EH K L AH AH R S IH S AH M AH N T S
ECLECTICISM	EH K L EH K T IH K IH Z AH M
ECLECTICISMS	EH K L EH K T IH K IH Z AH M Z
ECOCIDAL	AH K AA S AH D AH L
ECOCIDE	EH K AH S AY D
ECOCIDES	EH K AH S AY D Z
ECONOMETRICIAN	AH K AA N AH M EH T R IH S IY AH N
ECONOMETRICIANS	AH K AA N AH M AH T R IH S IY AH N Z
ECOSPECIES	AH K AA S AH S AY Z
ECUMENICISM	EH K Y UW M AH N AH S IH Z AH M
ECUMENICISMS	EH K Y AH M EH N AH S AH Z AH M Z
ECUMENICIST	EH K Y UW M AH N IH S AH S T
ECUMENICISTS	EH K Y AH M EH N AH S AH S T S
ECUMENICITIES	EH K Y AH M AH N IH S AH T AY Z
ECUMENICITY	EH K Y UW M AH N IH S AH T IY
EDACIOUS	AH D AH S IY AH S
EDACITIES	AH D AE S AH T AY Z
EDACITY	AH D AH S AH T IY
EDUCIBLE	EH JH AH K AH B AH L
EDUCING	EH D Y UW S AH NG
EFFACING	IH F EY S IH NG
EFFEMINACIES	AH F EH M AH N AH S IY Z
EFFERVESCING	EH F AH R V EH S AH NG
EFFICACIES	EH F IH K AH S IY Z
EFFICACIOUS	EH F AH K EY SH AH S
EFFICACIOUSLY	EH F AH K EY SH AH S L IY
EFFICACIOUSNESS	EH F AH K EY SH AH S N AH S
EFFICACIOUSNESSES	EH F AH K EY SH AH S N AH S IH Z
EFFICACITIES	EH F AH K AE S AH T AY Z
EFFICACITY	EH F IH S AH S AH T IY
EFFICIENCIES	IH F IH SH AH N S IY Z
EFFICIENCY	IH F IH SH AH N S IY
EFFICIENT	IH F IH SH AH N T
EFFICIENTLY	IH F IH SH AH N T L IY
EFFLORESCING	EH F L AH R EH S IH NG
EGOCENTRICITIES	IY G OW S EH N T R IH K AH T IY Z
EGOCENTRICITY	IY G OW S EH N T R IH K AH T IY
ELASTICITIES	IH L AE S T IH S AH T IY Z
ELASTICITY	IY L AE S T IH S AH T IY
ELASTICIZED	IH L AE S T IH K AY Z D
ELECTRICIAN	IH L EH K T R IH SH AH N
ELECTRICIANS	IH L EH K T R IH SH AH N Z
ELECTRICITIES	IH L EH K T R IH S AH T IY Z
ELECTRICITY	IH L EH K T R IH S AH T IY
ELECTROPHILICITIES	AH L EH K T R AH F AH L IH S AH T AY Z
ELECTROPHILICITY	AH L EH K T R AH F AH L IH S AH T IY
ELEGANCIES	EH L IH G AH N S IY Z
ELICIT	IH L IH S IH T
ELICITATION	IH L IH S AH T EY SH AH N
ELICITATIONS	IH L IH S AH T EY SH AH N Z
ELICITED	IH L IH S IH T IH D
ELICITING	IH L IH S AH T IH NG
ELICITOR	IH L IH S AH T ER
ELICITORS	IH L IH S AH T ER Z
ELICITS	IH L IH S AH T S
ELLIPTICITIES	IH L IH P T IH K AH T IY Z
ELLIPTICITY	IH L IH P T IH K AH T IY
ELUCIDATE	IH L UW S AH D EY T
ELUCIDATED	IH L UW S AH D EY T AH D
ELUCIDATES	IH L UW S AH D EY T S
ELUCIDATING	IH L UW S AH D EY T IH NG
ELUCIDATION	IH L UW S AH D EY SH AH N
ELUCIDATIONS	IH L UW S AH D EY SH AH N Z
ELUCIDATIVE	IH L UW S AH D EY T IH V
ELUCIDATOR	IH L UW S AH D EY T ER
ELUCIDATORS	IH L UW S AH D EY T ER Z
EMACIATE	IH M EY SH IY EY T
EMACIATED	IH M EY SH IY EY T IH D
EMACIATES	IH M EY SH IY EY T S
EMACIATING	IH M EY SH IY EY T IH NG
EMACIATION	IH M EY SH IY EY SH AH N
EMACIATIONS	IH M EY SH IY EY SH AH N Z
EMANCIPATE	IH M AE N S AH P EY T
EMANCIPATED	IH M AE N S AH P EY T IH D
EMANCIPATES	IH M AE N S AH P EY T S
EMANCIPATING	IH M AE N S AH P EY T IH NG
EMANCIPATION	IH M AE N S AH P EY SH AH N
EMANCIPATIONIST	IH M AE N S AH P EY SH AH N IH S T
EMANCIPATIONISTS	IH M AE N S AH P EY SH AH N IH S T S
EMANCIPATIONS	IH M AE N S AH P EY SH AH N Z
EMANCIPATOR	IH M AE N S AH P EY T ER
EMANCIPATORS	IH M AE N S AH P EY T ER Z
EMBRACING	EH M B R EY S IH NG
EMBRACINGLY	IH M B R EY S IH NG L IY
EMBRACIVE	IH M B R EY S IH V
EMERGENCIES	IH M ER JH AH N S IY Z
EMERGENCIES(2)	IY M ER JH AH N S IY Z
EMINENCIES	EH M AH N AH N S IY Z
EMPIRICISM	EH M P IH R AH S IH Z AH M
EMPIRICISMS	EH M P IH R AH S IH Z AH M Z
EMPIRICIST	IH M P IH R AH S AH S T
EMPIRICISTS	IH M P IH R IH K IH S T S
EMPLACING	IH M P L EY S IH NG
ENCINA	IH N S IH N AH
ENCINAL	IH N S AY N AH L
ENCINAS	EH N S IH N AH Z
ENCIPHER	EH N S AY F ER
ENCIPHERED	EH N S AY F ER D
ENCIPHERER	EH N S AY F ER ER
ENCIPHERERS	EH N S AY F ER ER Z
ENCIPHERING	EH N S AY F ER IH NG
ENCIPHERMENT	EH N S AY F ER M AH N T
ENCIPHERMENTS	EH N S AY F ER M AH N T S
ENCIPHERS	EH N S AY F ER Z
ENCIRCLE	EH N S ER K AH L
ENCIRCLED	IH N S ER K AH L D
ENCIRCLEMENT	EH N S ER K AH L M AH N T
ENCIRCLEMENTS	EH N S ER K AH L M AH N T S
ENCIRCLES	EH N S ER K AH L Z
ENCIRCLING	EH N S ER K AH L IH NG
ENCIRCLING(2)	EH N S ER K L IH NG
ENDEMICITIES	EH N D IY M AY S AH T IY Z
ENDEMICITY	EH N D IY M AY S AH T IY
ENDOTHECIA	IH N D AH TH IY SH IY AH
ENDOTHECIUM	IH N D AH TH IY S IY AH M
ENFACING	EH N F EY S IH NG
ENFORCING	EH N F AO R S IH NG
ENHANCING	EH N HH AE N S IH NG
ENLACING	EH N L EY S IH NG
ENOUNCING	EH N AW N S IH NG
ENSCONCING	IH N S K AA N S IH NG
ENSIGNCIES	IH N S IH G N S AY Z
ENTEROCOCCI	IH N T EH R AH K AA K S IY
ENTICING	EH N T AY S IH NG
ENTICINGLY	IH N T AY S IH NG L IY
ENTRANCING	EH N T R AH N S IH NG
ENUNCIABLE	IY N AH N S IY AH B AH L
ENUNCIATE	IH N AH N S IY EY T
ENUNCIATE(2)	IY N AH N S IY EY T
ENUNCIATED	IH N AH N S IY EY T IH D
ENUNCIATES	IY N AH N S IY AH T S
ENUNCIATING	IH N AH N S IY EY T IH NG
ENUNCIATION	IY N AH N S IY EY SH AH N
ENUNCIATIONS	IY N AH N S IY EY SH AH N Z
ENUNCIATOR	IY N AH N S IY AH T ER
ENUNCIATORS	IY N AH N S IY AH T ER Z
EPIDEMICITIES	EH P AH D EH M IH K AH T IY Z
EPIDEMICITY	EH P AH D EH M IH K AH T IY
EPISCIA	AH P IH SH IY AH
EPISCIAS	AH P IH S IY AH Z
EPISCOPACIES	AH P IH S AA P AH S AY Z
EQUIVALENCIES	IH K W IH V AH L AH N S IY Z
ERGODICITIES	AH R G AH D IH S AH T AY Z
ERGODICITY	AH R G AH D IH S AH T IY
EROTICISM	ER AA T IH S IH Z AH M
EROTICISMS	IH R AA T IH K IH Z AH M Z
EROTICIST	IH R AA T IH K IH S T
EROTICISTS	IH R AA T IH K IH S T S
EROTICIZATION	IH R AA T IH K AH Z EY SH AH N
EROTICIZATIONS	IH R AA T IH K AH Z EY SH AH N Z
EROTICIZE	IH R AA T IH K AY Z
EROTICIZED	IH R AA T IH K AY Z D
EROTICIZES	IH R AA T IH K AY Z IH Z
EROTICIZING	IH R AA T IH K AY Z IH NG
ERRANCIES	EH ER AH N S IY Z
ERRATICISM	IH R AE T IH K IH Z AH M
ERRATICISMS	IH R AE T IH K IH Z AH M Z
ERYTHROMYCIN	EH R AH TH R AA M AH S AH N
ERYTHROMYCINS	EH R AH TH R AA M AH S AH N Z
ESOTERICISM	EH S AH T EH R IH K IH Z AH M
ESOTERICISMS	EH S AH T EH R IH K IH Z AH M Z
ESPECIAL	AH S P EH SH AH L
ESPECIALLY	AH S P EH SH L IY
ESPECIALLY(2)	AH S P EH SH AH L IY
ESTANCIA	EH S T AE N CH IY AH
ESTANCIAS	EH S T AE N S IY AH Z
ESTHETICIAN	EH S TH AH T IH S IY AH N
ESTHETICIANS	EH S TH AH T IH S IY AH N Z
ESTHETICISM	EH S TH EH T IH K IH Z AH M
ESTHETICISMS	EH S TH EH T IH K IH Z AH M Z
ETHICIAN	AH TH IH S IY AH N
ETHICIANS	AH TH IH S IY AH N Z
ETHICIST	EH TH IH S IH S T
ETHICISTS	EH TH IH S IH S T S
ETHICIZE	EH TH IH K AY Z
ETHICIZED	EH TH IH K AY Z D
ETHICIZES	EH TH IH K AY Z IH Z
ETHICIZING	EH TH IH K AY Z IH NG
ETHNICITIES	EH TH N IH K AH T IY Z
ETHNICITY	EH TH N IH S IH T IY
ETHNOCENTRICITIES	EH TH N AH S EH N T R IH S AH T AY Z
ETHNOCENTRICITY	EH TH N AH S EH N T R IH S AH T IY
ETHNOSCIENCE	EH TH N AH SH AH N S
ETHNOSCIENCES	EH TH N AH SH AH N S AH Z
EUGENICIST	Y UH JH EH N IH K IH S T
EUGENICISTS	Y UH JH EH N IH K IH S T S
EUSTACIES	Y UW S T AH S AY Z
EVANESCING	EH V AH N EH S AH NG
EVIDENCING	EH V AH D AH N S IH NG
EVINCIBLE	IH V IH N S AH B AH L
EVINCING	IH V IH N S IH NG
EVINCIVE	IH V IH N S IH V
EXCELLENCIES	EH K S L EH N S IY Z
EXCIDE	IH K S AY D
EXCIDED	IH K S AY D AH D
EXCIDES	IH K S AY D Z
EXCIDING	IH K S AY D AH NG
EXCIMER	EH K S IH M ER
EXCIMERS	IH K S IH M AH R Z
EXCIPIENT	IH K S IH P IY AH N T
EXCIPIENTS	IH K S AH P IY N T S
EXCIPLE	IH K S IH P AH L
EXCIPLES	IH K S IH P AH L Z
EXCISABLE	EH K S AY Z AH B AH L
EXCISE	EH K S AY S
EXCISE(2)	EH K S AY Z
EXCISED	EH K S AY Z D
EXCISEMAN	EH K S AY Z M AE N
EXCISEMEN	EH K S AY Z M EH N
EXCISES	EH K S AY Z IH Z
EXCISING	EH K S AY Z IH NG
EXCISION	IH K S IH ZH AH N
EXCISIONAL	EH K S AY ZH AH N AH L
EXCISIONS	EH K S AY ZH AH N Z
EXCITABILITIES	IH K S AY T AH B IH L AH T EH Z
EXCITABILITY	IH K S AY T AH B IH L AH T EH
EXCITABLE	IH K S AY T AH B AH L
EXCITABLENESS	IH K S AY T AH B AH L N AH S
EXCITABLENESSES	IH K S AY T AH B AH L N AH S IH Z
EXCITANT	IH K S AY T AH N T
EXCITANTS	IH K S AY T AH N T S
EXCITATION	EH K S AY T EY SH AH N
EXCITATIONS	IH K S AY T EY SH AH N Z
EXCITATIVE	IH K S AY T AH T IH V
EXCITATORY	IH K S AY T AH T OW R IY
EXCITE	IH K S AY T
EXCITED	IH K S AY T AH D
EXCITED(2)	IH K S AY T IH D
EXCITEDLY	IH K S AY T AH D L IY
EXCITEMENT	IH K S AY T M AH N T
EXCITEMENTS	IH K S AY T M AH N T S
EXCITER	IH K S AY T ER
EXCITERS	IH K S AY T ER Z
EXCITES	IH K S AY T S
EXCITING	IH K S AY T IH NG
EXCITINGLY	IH K S AY T IH NG L IY
EXCITON	IH K S IH T AH N
EXCITONIC	IH K S IH T AH N AH K
EXCITONS	IH K S IH T AH N Z
EXCITOR	IH K S AY T ER
EXCITORS	IH K S AY T ER Z
EXCRESCENCIES	EH K S K R EH S AH N S IY Z
EXCRUCIATE	IH K S K R UW SH IY EY T
EXCRUCIATED	IH K S K R UW SH IY EY T IH D
EXCRUCIATES	IH K S K R UW SH IY EY T S
EXCRUCIATING	IH K S K R UW SH IY EY T IH NG
EXCRUCIATINGLY	EH K S K R UW S IY EY T IH NG L IY
EXCRUCIATION	IH K S K R UW SH IY EY SH AH N
EXCRUCIATIONS	IH K S K R UW SH IY EY SH AH N Z
EXERCISABLE	EH K S ER S AY Z AH B AH L
EXERCISE	EH K S ER S AY Z
EXERCISED	EH K S ER S AY Z D
EXERCISER	EH K S ER S AY Z ER
EXERCISERS	EH K S ER S AY Z ER Z
EXERCISES	EH K S ER S AY Z IH Z
EXERCISING	EH K S ER S AY Z IH NG
EXERCITATION	IH G Z AH R S AH T EY SH AH N
EXERCITATIONS	IH G Z AH R S AH T EY T IY AH N Z
EXIGENCIES	EH K S IH JH AH N S IY Z
EXORCISE	EH K S AO R S AY Z
EXORCISED	EH K S AO R S AY Z D
EXORCISER	EH K S AO R S AY Z ER
EXORCISERS	EH K S AO R S AY Z ER Z
EXORCISES	EH K S AO R S AY Z IH Z
EXORCISING	EH K S AO R S AY Z IH NG
EXORCISM	EH K S ER S IH Z AH M
EXORCISMS	EH K S ER S IH Z AH M Z
EXORCIST	EH K S ER S IH S T
EXORCISTIC	IH G Z AO R S AH S T AH K
EXORCISTICAL	IH G Z AO R S IH S T IH S AH L
EXORCISTS	EH K S ER S IH S T S
EXORCIZE	IH G Z AO R S AY Z
EXORCIZED	IH G Z AO R S AY Z D
EXORCIZES	IH G Z AO R S AY Z AH Z
EXORCIZING	IH G Z AO R S AY Z AH NG
EXOTHERMICITIES	EH K S OW TH ER M IH K AH T IY Z
EXOTHERMICITY	EH K S OW TH ER M IH K AH T IY
EXOTICISM	IH G Z AA T IH K IH Z AH M
EXOTICISMS	IH G Z AA T IH K IH Z AH M Z
EXPECTANCIES	IH K S P EH K T AH N S IY Z
EXPEDIENCIES	IH K S P IY D IY AH N S IY Z
EXPERIENCING	IH K S P IH R IY AH N S IH NG
EXPLICIT	IH K S P L IH S AH T
EXPLICITLY	IH K S P L IH S AH T L IY
EXPLICITNESS	IH K S P L IH S AH T N AH S
EXPLICITNESSES	IH K S P L IH S AH T N AH S IH Z
EXPLICITS	IH K S P L IH S AH T S
EXSCIND	IH K S AY N D
EXSCINDED	IH K S AY N D AH D
EXSCINDING	IH K S AY N D AH NG
EXSCINDS	IH K S AY N D Z
EXTRAJUDICIAL	EH K S T R AH JH UH D IH SH AH L
EXTRAJUDICIALLY	EH K S T R AH JH UH D IH SH AH L IY
EXTRAVAGANCIES	IH K S T R AE V IH G AH N S IY Z
EXULTANCIES	IH G Z AH L T AH N S IY Z
FACIA	F EY SH IY AH
FACIAL	F EY SH AH L
FACIALLY	F EY SH AH L IY
FACIALS	F EY SH AH L Z
FACIAS	F EY S IY AH Z
FACIEND	F EY S IY N D
FACIENDS	F EY S IY N D Z
FACIES	F EY S IY Z
FACILE	F AE S AH L
FACILELY	F AE S AH L IY
FACILENESS	F AE S AH L N AH S
FACILENESSES	F AE S AH L N AH S IH Z
FACILITATE	F AH S IH L AH T EY T
FACILITATED	F AH S IH L AH T EY T IH D
FACILITATES	F AH S IH L AH T EY T S
FACILITATING	F AH S IH L AH T EY T IH NG
FACILITATION	F AH S IH L AH T EY SH AH N
FACILITATIONS	F AH S IH L AH T EY SH AH N Z
FACILITATIVE	F AH S IH L AH T AH T IH V
FACILITATOR	F AH S IH L AH T EY T ER
FACILITATORS	F AH S IH L AH T EY T ER Z
FACILITATORY	F AH S IH L AH T AH T OW R IY
FACILITIES	F AH S IH L AH T IY Z
FACILITIES(2)	F AH S IH L IH T IY Z
FACILITY	F AH S IH L IH T IY
FACING	F EY S IH NG
FACINGS	F EY S IH NG Z
FACTICITIES	F AE K T IH K S AH T IY Z
FACTICITY	F AE K T IH K S AH T IY
FALCIFORM	F AE L S AH F AH R M
FALLACIES	F AE L AH S IY Z
FALLACIOUS	F AH L EY SH AH S
FALLACIOUSLY	F AH L EY SH AH S L IY
FALLACIOUSNESS	F AH L EY SH AH S N AH S
FALLACIOUSNESSES	F AH L EY SH AH S N AH S IH Z
FANATICISM	F AH N AE T AH S IH Z AH M
FANATICISMS	F AH N AE T AH S IH Z AH M Z
FANATICIZE	F AH N AE T IH K AY Z
FANATICIZED	F AH N AE T IH K AY Z D
FANATICIZES	F AH N AE T IH K AY Z IH Z
FANATICIZING	F AH N AE T IH K AY Z IH NG
FANCIED	F AE N S IY D
FANCIER	F AE N S IY ER
FANCIERS	F AE N S IY ER Z
FANCIES	F AE N S IY Z
FANCIEST	F AE N S IY AH S T
FANCIFIED	F AE N S AH F AY D
FANCIFIES	F AE N S AH F AY Z
FANCIFUL	F AE N S IH F AH L
FANCIFULLY	F AE N S IY F AH L IY
FANCIFULNESS	F AE N S IY F AH L N AH S
FANCIFULNESSES	F AE N S IY F AH L N AH S IH Z
FANCIFY	F AE N S AH F AY
FANCIFYING	F AE N S IH F AY AH NG
FANCILY	F AE N S IY L IY
FANCINESS	F AE N S IY N AH S
FANCINESSES	F AE N S IY N AH S IH Z
FANTOCCINI	F AE N T AA K S AH N IY
FARCI	F AA R S IY
FARCICAL	F AA R S AH K AH L
FARCICAL(2)	F AA R S IH K AH L
FARCICALITIES	F AA R S IH K AH L AH T IY Z
FARCICALITY	F AA R S IH K AH L AH T IY
FARCICALLY	F AA R S IH K AH L IY
FARCIE	F AA R S IY
FARCIES	F AA R S IY Z
FARCING	F AA R S IH NG
FASCIA	F AE SH IY AH
FASCIAE	F AE S IY IY
FASCIAL	F AE SH AH L
FASCIAS	F AE S IY AH Z
FASCIATE	F AE S AY EY T
FASCIATED	F AE S AY EY T AH D
FASCIATION	F AE S AY EY SH AH N
FASCIATIONS	F AE S IY EY T IY AH N Z
FASCICLE	F AE S IH K AH L
FASCICLED	F AE S IH K AH L D
FASCICLES	F AE S IH K AH L Z
FASCICULAR	F AE S IH K UW L ER
FASCICULARLY	F AE S IH K UW L ER L IY
FASCICULATE	F AE S IH K UW L AH T
FASCICULATED	F AE S IH K UW L EY T IH D
FASCICULATION	F AE S IH K UW L EY SH AH N
FASCICULATIONS	F AE S IH K UW L EY SH AH N Z
FASCICULE	F AE S IH K UW L
FASCICULES	F AE S IH K UW L Z
FASCICULI	F AE S AH K Y UW L IY
FASCICULUS	F AE S IH S AH L AH S
FASCINATE	F AE S AH N EY T
FASCINATED	F AE S AH N EY T AH D
FASCINATED(2)	F AE S AH N EY T IH D
FASCINATES	F AE S AH N EY T S
FASCINATING	F AE S AH N EY T IH NG
FASCINATINGLY	F AE S AH N EY T IH NG L IY
FASCINATION	F AE S AH N EY SH AH N
FASCINATIONS	F AE S AH N EY SH AH N Z
FASCINATOR	F AE S AH N EY T ER
FASCINATORS	F AE S AH N EY T ER Z
FASCINE	F AE S AY N
FASCINES	F AE S AY N Z
FASCIOLIASES	F AE S IY OW L IY EY Z AH Z
FASCIOLIASIS	F AE S IY OW L Y AH S AH S
FASCISM	F AE SH IH Z AH M
FASCISMS	F AE SH IH Z AH M Z
FASCIST	F AE SH IH S T
FASCISTIC	F AE SH AH S T IH K
FASCISTICALLY	F AE SH AH S T IH K AH L IY
FASCISTS	F AE SH IH S T S
FAUCIAL	F AO SH AH L
FECIAL	F IY SH AH L
FECIALS	F IY S IY AH L Z
FEDERACIES	F EH D ER AH S IY Z
FELICIFIC	F IY L AH S IH F AH K
FELICITATE	F AH L IH S IH T EY T
FELICITATED	F IH L IH S AH T EY T IH D
FELICITATES	F IH L IH S AH T AH T S
FELICITATING	F IH L IH S AH T EY T IH NG
FELICITATION	F IH L IH S AH T EY SH AH N
FELICITATIONS	F IH L IH S AH T EY SH AH N Z
FELICITATOR	F IH L IH S AH T AH T ER
FELICITATORS	F IH L IH S AH T AH T ER Z
FELICITIES	F IH L IH S AH T IY Z
FELICITOUS	F IH L IH S AH T AH S
FELICITOUSLY	F IH L IH S AH T AH S L IY
FELICITOUSNESS	F IH L IH S AH T AH S N AH S
FELICITOUSNESSES	F IH L IH S AH T AH S N AH S IH Z
FELICITY	F IH L IH S AH T IY
FEMINACIES	F AH M IH N AH S AY Z
FENCIBLE	F EH N S AH B AH L
FENCIBLES	F EH N S AH B AH L Z
FENCING	F EH N S IH NG
FENCINGS	F EH N S IH NG Z
FERACITIES	F AH R AE S AH T AY Z
FERACITY	F IY R AH S AH T IY
FEROCIOUS	F ER OW SH AH S
FEROCIOUSLY	F ER OW SH IH S L IY
FEROCIOUSNESS	F AH R OW SH AH S N AH S
FEROCIOUSNESSES	F AH R OW SH AH S N AH S IH Z
FEROCITIES	F AH R AA S AH T IY Z
FEROCITY	F ER AA S AH T IY
FERROELECTRICITIES	F EH R OW IH L EH K T R IH S AH T IY Z
FERROELECTRICITY	F EH R OW IH L EH K T R IH S AH T IY
FERVENCIES	F ER V AH N S IY Z
FETICIDE	F EH T AH S AY D
FETICIDES	F EH T AH S AY D Z
FETTUCCINE	F EH T AH CH IY N IY
FETTUCCINI	F EH T AH K S AH N IY
FETTUCINE	F EH T Y AH S AY N
FETTUCINI	F EH T Y UW S AH N IY
FICIN	F IH S AH N
FICINS	F IH S AH N Z
FIDUCIAL	F IH D Y UW SH AH L
FIDUCIALLY	F IH D Y UW S IY AE L IY
FIDUCIARIES	F IH D UW SH IY EH R IY Z
FIDUCIARY	F AH D UW SH IY EH R IY
FILICIDE	F IH L AH S AY D
FILICIDES	F IH L AH S AY D Z
FINANCIAL	F AH N AE N SH AH L
FINANCIAL(2)	F IH N AE N SH AH L
FINANCIAL(3)	F AY N AE N SH AH L
FINANCIALLY	F AH N AE N SH AH L IY
FINANCIALLY(2)	F IH N AE N SH AH L IY
FINANCIALLY(3)	F AY N AE N SH AH L IY
FINANCIER	F IH N AH N S IY R
FINANCIER(2)	F AY N AE N S IY R
FINANCIERS	F IH N AH N S IH R Z
FINANCING	F AH N AE N S IH NG
FINANCING(2)	F IH N AE N S IH NG
FINANCING(3)	F AY N AE N S IH NG
FINANCINGS	F AH N AE N S IH NG Z
FINANCINGS(2)	F IH N AE N S IH NG Z
FINANCINGS(3)	F AY N AE N S IH NG Z
FLACCID	F L AE K S IH D
FLACCID(2)	F L AE K IH D
FLACCIDITIES	F L AE K S IH D AH T AY Z
FLACCIDITY	F L AE K S IH D AH T IY
FLACCIDLY	F L AE K S IH D L IY
FLAGRANCIES	F L EY G R AH N S IY Z
FLAMBOYANCIES	F L AE M B OY AH N S IY Z
FLATULENCIES	F L AE CH AH L AH N S IY Z
FLEECIER	F L IY S AY AH R
FLEECIEST	F L IY S AY AH S T
FLEECILY	F L IY S AH L IY
FLEECING	F L IY S IH NG
FLIPPANCIES	F L IH P AH N S IY Z
FLOCCI	F L AA K S IY
FLOCCING	F L AA K IH NG
FLOUNCIER	F L AW N S IY ER
FLOUNCIEST	F L AW N S IY AH S T
FLOUNCING	F L AW N S IH NG
FLOUNCINGS	F L AW N S IH NG Z
FLUENCIES	F L UW AH N S IY Z
FLUORESCING	F L UH R EH S IH NG
FLUOROURACIL	F L UW W AH R AH R AH S AH L
FLUOROURACILS	F L UW W AH R AH Y UH R AH S AH L Z
FOCACCIA	F OW K AA CH IY AH
FOCACCIAS	F AH K AE K S IY AH Z
FOCI	F OW S AY
FOLACIN	F AA L AH S AH N
FOLACINS	F AA L AH S AH N Z
FORCIBLE	F AO R S AH B AH L
FORCIBLENESS	F OW R S AH B AH L N AH S
FORCIBLENESSES	F OW R S AH B AH L N AH S IH Z
FORCIBLY	F AO R S AH B L IY
FORCING	F AO R S IH NG
FORCIPES	F AO R S AY P S
FRAGRANCIES	F R EY G R AH N S IY Z
FRANCIUM	F R AE N S IY AH M
FRANCIUMS	F R AE N S IY AH M Z
FRATRICIDAL	F R AE T R IH S AH D AH L
FRATRICIDE	F R AE T R AH S AY D
FRATRICIDES	F R AE T R AH S AY D Z
FREELANCING	F R IY L AE N S IH NG
FRENETICISM	F R IH N EH T IH K IH Z AH M
FRENETICISMS	F R IH N EH T IH K IH Z AH M Z
FREQUENCIES	F R IY K W AH N S IY Z
FROUNCING	F R AW N S AH NG
FUCI	F Y UW S IY
FUGACIOUS	F Y UW G AH S IY AH S
FUGACITIES	F Y UW G AE S AH T AY Z
FUGACITY	F Y UW G AH S AH T IY
FUNGICIDAL	F AH N JH AH S AY D AH L
FUNGICIDALLY	F AH N JH AH S AY D AH L IY
FUNGICIDE	F AH N JH AH S AY D
FUNGICIDES	F AH N JH AH S AY D Z
FURNACING	F ER N AH S IH NG
GALLICISM	G AO L IH K S IH Z AH M
GALLICISMS	G AO L IH K S IH Z AH M Z
GALLICIZATION	G AO L IH K S AH Z EY SH AH N
GALLICIZATIONS	G AO L IH K S AH Z EY SH AH N Z
GALLICIZE	G AO L IH K S AY Z
GALLICIZED	G AO L IH K S AY Z D
GALLICIZES	G AO L IH K S AY Z IH Z
GALLICIZING	G AO L IH K S AY Z IH NG
GENETICIST	JH AH N EH T AH S AH S T
GENETICISTS	JH AH N EH T AH S IH S T S
GENOCIDAL	JH EH N AH S AY D AH L
GENOCIDE	JH EH N AH S AY D
GENOCIDES	JH EH N AH S AY D Z
GENTAMICIN	JH EH N T AE M AH S AH N
GENTAMICINS	JH EH N T AE M AH S AH N Z
GEOMANCIES	JH IY AH M AE N S AY Z
GEOMETRICIAN	JH IY AH M EH T R IH S IY AH N
GEOMETRICIANS	JH IY AH M AH T R IH S IY AH N Z
GEOPHYSICIST	JH IY AA F AH Z IH S AH S T
GEOPHYSICISTS	JH IY AH F IH S AH S AH S T S
GEOPOLITICIAN	JH IY AH P AA L AH T IH S IY AH N
GEOPOLITICIANS	JH IY AA P AH L AH T IH S IY AH N Z
GEOSCIENCE	JH IY AH SH AH N S
GEOSCIENCES	JH IY AH SH AH N S AH Z
GEOSCIENTIST	JH IY AH S IY N T AH S T
GEOSCIENTISTS	JH IY AH S IY N T AH S T S
GERIATRICIAN	JH EH R IY AH T R IH SH AH N
GERIATRICIANS	JH EH R IY AH T R IH SH AH N Z
GERMICIDAL	JH ER M IH K S AH D AH L
GERMICIDE	JH ER M AH S AY D
GERMICIDES	JH AH R M AH S AY D Z
GERONTOCRACIES	JH AH R AA N T AA K R AH S IY Z
GLACIAL	G L EY SH AH L
GLACIALLY	G L EY SH AH L IY
GLACIATE	G L EY SH IY EY T
GLACIATE(2)	G L EY S IY EY T
GLACIATED	G L EY SH IY EY T AH D
GLACIATED(2)	G L EY S IY EY T AH D
GLACIATES	G L AE S AY EY T S
GLACIATING	G L AE S AY EY T AH NG
GLACIATION	G L EY SH IY EY SH AH N
GLACIATIONS	G L EY S IY EY T IY AH N Z
GLACIER	G L EY SH ER
GLACIERS	G L EY SH ER Z
GLACIOLOGICAL	G L EY S IY AA L AH JH IH S AH L
GLACIOLOGIES	G L EY S IY AA L AH JH AY Z
GLACIOLOGIST	G L EY S IY AA L AH JH AH S T
GLACIOLOGISTS	G L EY S IY AA L AH JH AH S T S
GLACIOLOGY	G L EY S IY AA L AH JH IY
GLACIS	G L EY S AH S
GLACISES	G L AH S AY Z AH Z
GLANCING	G L AE N S IH NG
GLANCINGLY	G L AE N S IH NG L IY
GLUCINIC	G L UW S AH N AH K
GLUCINUM	G L UW S AH N AH M
GLUCINUMS	G L UW S AH N AH M Z
GLYCIN	G L IH S AH N
GLYCINE	G L AY S IY N
GLYCINE(2)	G L AY S AH N
GLYCINES	G L AH S AY N Z
GLYCINS	G L IH S AH N Z
GNOSTICISM	N AA S T IH S IH Z AH M
GNOSTICISMS	N AA S T AH S AH Z AH M Z
GOITROGENICITIES	G OY T R AH JH AH N IH S AH T AY Z
GOITROGENICITY	G OY T R AA JH AH N IH S AH T IY
GONOCOCCI	G AA N AH K AA K S IY
GOTHICIZE	G OW TH IH K S AY Z
GOTHICIZED	G OW TH IH K S AY Z D
GOTHICIZES	G OW TH IH K S AY Z IH Z
GOTHICIZING	G OW TH IH K S AY Z IH NG
GRACILE	G R AE S AH L
GRACILENESS	G R AH S AY L N AH S
GRACILENESSES	G R AH S IH L AH N EH S AH Z
GRACILES	G R EY S AH L Z
GRACILIS	G R EY S IY L IY Z
GRACILITIES	G R AH S IH L AH T AY Z
GRACILITY	G R EY S IH L AH T IY
GRACING	G R EY S IH NG
GRACIOSO	G R EY S IY AH S OW
GRACIOSOS	G R EY S IY AH S AH Z
GRACIOUS	G R EY SH AH S
GRACIOUSLY	G R EY SH AH S L IY
GRACIOUSNESS	G R EY SH AH S N AH S
GRACIOUSNESSES	G R EY SH AH S N AH S IH Z
GRAECIZE	G R IY S AY Z
GRAECIZED	G R IY S AY Z D
GRAECIZES	G R IY S AY Z AH Z
GRAECIZING	G R IY S AY Z AH NG
GRAMERCIES	G R AH M AH R S AY Z
GRAMICIDIN	G R AE M IH K S AH D IH N
GRAMICIDINS	G R AE M IH K S AH D IH N Z
GRECIANIZE	G R IY SH AH N AY Z
GRECIANIZED	G R IY SH AH N AY Z D
GRECIANIZES	G R IY SH AH N AY Z IH Z
GRECIANIZING	G R IY SH AH N AY Z IH NG
GRECIZE	G R IY S AY Z
GRECIZED	G R IY S AY Z D
GRECIZES	G R IY S AY Z AH Z
GRECIZING	G R IY S AY Z AH NG
GRIMACING	G R IH M AH S IH NG
GYNAECIA	JH AH N IY SH IY AH
GYNAECIUM	JH AH N IY S IY AH M
GYNECIA	JH AH N IY SH IY AH
GYNECIC	JH IH N AH S AH K
GYNECIUM	JH AH N IY S IY AH M
GYNECOCRACIES	JH IH N AH K AA K R AH S IY Z
GYNOECIA	JH IH N OW EH SH IY AH
GYNOECIUM	JH IH N OW EH S IY AH M
GYROFREQUENCIES	JH AY R OW F R IY K W AH N S IY Z
HACIENDA	HH AE S IY EH N D AH
HACIENDADO	HH EY S IY N D AH D OW
HACIENDADOS	HH EY S IY N D AH D AH Z
HACIENDAS	HH EY S IY N D AH Z
HALLUCINATE	HH AH L UW S AH N EY T
HALLUCINATED	HH AH L UW S AH N EY T IH D
HALLUCINATES	HH AH L UW S AH N EY T S
HALLUCINATING	HH AH L UW S AH N EY T IH NG
HALLUCINATING(2)	HH AH L UW S IH N EY T IH NG
HALLUCINATION	HH AH L UW S AH N EY SH AH N
HALLUCINATIONS	HH AH L UW S AH N EY SH AH N Z
HALLUCINATOR	HH AH L UW S AH N AH T ER
HALLUCINATORS	HH AH L UW S AH N AH T ER Z
HALLUCINATORY	HH AH L UW S AH N AH T AO R IY
HALLUCINOGEN	HH AE L AH S IH N AH JH AH N
HALLUCINOGENIC	HH AH L UW S AH N AH JH EH N IH K
HALLUCINOGENICS	HH AE L AH S AH N AA JH AH N AH S Z
HALLUCINOGENS	HH AE L AH S IH N AH JH AH N Z
HALLUCINOSES	HH AE L UW S AH N OW Z AH Z
HALLUCINOSIS	HH AE L UW S AH N OW S AH S
HARMONICIST	HH AA R M AA N IH K IH S T
HARMONICISTS	HH AA R M AA N IH K IH S T S
HELICITIES	HH AH L IH S AH T AY Z
HELICITY	HH IY L IH S AH T IY
HELLACIOUS	HH EH L EY SH AH S
HELLACIOUSLY	HH EH L EY SH AH S L IY
HEPATOTOXICITIES	HH AH P AE T AH T AA K S IH S AH T AY Z
HEPATOTOXICITY	HH AH P AE T AH T AA K S IH S AH T IY
HERBICIDAL	ER B IH K S AH D AH L
HERBICIDALLY	ER B IH K S AH D AH L IY
HERBICIDE	HH ER B IH S AY D
HERBICIDE(2)	ER B IH S AY D
HERBICIDES	ER B AH S AY D Z
HERBICIDES(2)	HH ER B AH S AY D Z
HERMETICISM	HH ER M EH T IH K IH Z AH M
HERMETICISMS	HH ER M EH T IH K IH Z AH M Z
HESITANCIES	HH EH Z AH T AH N S IY Z
HETEROECIOUS	HH EH T AH R OW AH SH AH S
HETEROECISM	HH AH T EH R OW AH S IH Z AH M
HETEROECISMS	HH EH T AH R OW AH S AH Z AH M Z
HEXADECIMAL	HH EH K S AH D EH S AH M AH L
HEXADECIMALS	HH EH K S AH D EH S AH M AH L Z
HEXYLRESORCINOL	HH EH K S IH L R AH S AO R S AH N AH L
HEXYLRESORCINOLS	HH EH K S IH L R AH S AO R S AH N AH L Z
HIRCINE	HH AH R S AY N
HISTORICISM	HH IH S T AO R AH S IH Z AH M
HISTORICISMS	HH IH S T AO R AH S IH Z AH M Z
HISTORICIST	HH IH S T AO R IH K IH S T
HISTORICISTS	HH IH S T AO R IH K IH S T S
HISTORICITIES	HH IH S T AH R IH S AH T IY Z
HISTORICITY	HH IH S T AH R IH S AH T IY
HISTORICIZE	HH IH S T AO R IH K AY Z
HISTORICIZED	HH IH S T AO R IH K AY Z D
HISTORICIZES	HH IH S T AO R IH K AY Z IH Z
HISTORICIZING	HH IH S T AO R IH K AY Z IH NG
HOMICIDAL	HH AA M AH S AY D AH L
HOMICIDALLY	HH AA M AH S AY D AH L IY
HOMICIDE	HH AA M AH S AY D
HOMICIDES	HH AA M AH S AY D Z
HOMOEROTICISM	HH OW M OW IH R AA T IH K IH Z AH M
HOMOEROTICISMS	HH OW M OW IH R AA T IH K IH Z AH M Z
HOMOSCEDASTICITIES	HH AH M AA S AH D AE S T IH S AH T AY Z
HOMOSCEDASTICITY	HH AH M AA S AH D AE S T IH S AH T IY
HOMOSOCIAL	HH OW M OW S OW SH AH L
HOMOSOCIALITIES	HH OW M OW S OW SH IY AE L AH T IY Z
HOMOSOCIALITY	HH OW M OW S OW SH IY AE L AH T IY
HYACINTH	HH AY AH S IH N TH
HYACINTHINE	HH AY AE S AH N TH AY N
HYACINTHS	HH AY AH S IH N TH S
HYDRACID	HH IH D R AH S AH D
HYDRACIDS	HH IH D R AH S AH D Z
HYDRODYNAMICIST	HH IH D R AH D IH N AH M IH S AH S T
HYDRODYNAMICISTS	HH IH D R AH D AH N AE M AH S AH S T S
HYDROELECTRICITIES	HH IH D R OW AH L EH K T R IH S AH T AY Z
HYDROELECTRICITY	HH IH D R OW AH L EH K T R IH S AH T IY
HYDROMANCIES	HH IH D R AH M AE N S AY Z
HYDROPHILICITIES	HH AY D R AH F IH L IH K AH T IY Z
HYDROPHILICITY	HH AY D R AH F IH L IH K AH T IY
HYDROPHOBICITIES	HH AY D R AH F OW B IH K AH T IY Z
HYDROPHOBICITY	HH AY D R AH F OW B IH K AH T IY
HYGROSCOPICITIES	HH IH G R AA S AH P IH S AH T AY Z
HYGROSCOPICITY	HH IH G R AA S AH P IH S AH T IY
HYOSCINE	HH AY AH S AY N
HYOSCINES	HH AY AH S AY N Z
HYPERACID	HH AY P ER AE S AH D
HYPERACIDITIES	HH AY P ER AH S IH D AH T IY Z
HYPERACIDITY	HH AY P ER AH S IH D AH T IY
HYPERCIVILIZED	HH AY P ER S IH V AH L AY Z D
HYPERCONSCIOUS	HH AY P ER K AA N SH AH S
HYPERCONSCIOUSNESS	HH AY P ER K AA N SH AH S N AH S
HYPERCONSCIOUSNESSES	HH AY P ER K AA N SH AH S N AH S IH Z
HYPERCRITICISM	HH AY P ER K R IH T AH S IH Z AH M
HYPERCRITICISMS	HH AY P ER K R IH T AH S IH Z AH M Z
HYPEREFFICIENT	HH AY P ER IH F IH SH AH N T
HYPEREXCITABILITIES	HH AY P ER IH K S AY T AH B IH L AH T EH Z
HYPEREXCITABILITY	HH AY P ER IH K S AY T AH B IH L AH T EH
HYPEREXCITABLE	HH AY P ER IH K S AY T AH B AH L
HYPEREXCITED	HH AY P ER IH K S AY T IH D
HYPEREXCITEMENT	HH AY P ER IH K S AY T M AH N T
HYPEREXCITEMENTS	HH AY P ER IH K S AY T M AH N T S
HYPERTONICITIES	HH AY P ER T AA N IH K AH T IY Z
HYPERTONICITY	HH AY P ER T AA N IH K AH T IY
HYPERVELOCITIES	HH AY P ER V AH L AA S AH T IY Z
HYPERVELOCITY	HH AY P ER V AH L AA S AH T IY
HYPOACID	HH AH P OW S AH D
HYPOTONICITIES	HH IH P AH T AH N IH S AH T AY Z
HYPOTONICITY	HH AH P AA T AH N IH S AH T IY
ICICLE	AY S IH K AH L
ICICLED	AY S IH K AH L D
ICICLES	AY S IH K AH L Z
ICIER	AY S IY ER
ICIEST	AY S IY AH S T
ICILY	AY S IH L IY
ICINESS	AY S IY N AH S
ICINESSES	AY S IY N AH S IH Z
ICING	AY S IH NG
ICINGS	AY S IH NG Z
ICONICITIES	IH K AH N IH S AH T AY Z
ICONICITY	IH K AH N IH S AH T IY
IDIOCIES	IH D IY AH S IY Z
ILLEGITIMACIES	IH L IH JH IH T AH M AH S IY Z
ILLICIT	IH L IH S AH T
ILLICITLY	IH L IH S IH T L IY
ILLICITNESS	IH L AH S IH T N AH S
ILLICITNESSES	IH L AH S IH T N EH S AH Z
ILLITERACIES	IH L IH T ER AH S IY Z
IMBECILE	IH M B AH S AH L
IMBECILE(2)	IH M B AH S AY L
IMBECILES	IH M B AH S AH L Z
IMBECILES(2)	IH M B AH S AY L Z
IMBECILIC	IH M B AH S AH L IH K
IMBECILITIES	IH M B AH S AH L AH T IY Z
IMBECILITY	IH M B AH S AH L AH T IY
IMMACULACIES	IH M AE K Y UW L AH S AY Z
IMMANENCIES	IH M AH N AH N S IY Z
IMMEDIACIES	IH M IY D IY AH S IY Z
IMMINENCIES	IH M AH N AH N S IY Z
IMMISCIBILITIES	IH M AH S AH B IH L AH T AY Z
IMMISCIBILITY	IH M IH S AH B IH L AH T IY
IMMISCIBLE	IH M IH S AH B AH L
IMMODERACIES	IH M OW D ER AH S IY Z
IMMUNODEFICIENCIES	IH M Y AH N AH D AH F AH S IY N S AY Z
IMMUNODEFICIENCY	IH M Y UW N OW D IH F IH SH AH N S IY
IMMUNODEFICIENT	IH M Y AH N AA D AH F IH S IY AH N T
IMMUNOGENETICIST	IH M Y AH N AH JH EH N AH T IH S AH S T
IMMUNOGENETICISTS	IH M Y UW N AH JH AH N EH T AH S AH S T S
IMMUNOGENICITIES	IH M Y UW N AH JH AH N IH S AH T AY Z
IMMUNOGENICITY	IH M Y AH N AA JH AH N IH S AH T IY
IMMUNOPRECIPITATE	IH M Y UW N AH P R AH S IH P AH T EY T
IMMUNOPRECIPITATED	IH M Y UW N AH P R AH S IH P AH T EY T AH D
IMMUNOPRECIPITATES	IH M Y UW N AH P R AH S IH P AH T EY T S
IMMUNOPRECIPITATING	IH M Y UW N AH P R AH S IH P AH T EY T AH NG
IMMUNOPRECIPITATION	IH M Y UW N AH P R AH S IH P AH T EY SH AH N
IMMUNOPRECIPITATIONS	IH M Y UW N AH P R EH S AH P AH T EY T IY AH N Z
IMPERCIPIENCE	IH M P AH R S IH P IY AH N S
IMPERCIPIENCES	IH M P AH R S IH P IY EH N S AH Z
IMPERCIPIENT	IH M P AH R S IH P IY AH N T
IMPERMANENCIES	IH M P ER M AH N AH N S IY Z
IMPERTINENCIES	IH M P ER T AH N AH N S IY Z
IMPLICIT	IH M P L IH S AH T
IMPLICITLY	IH M P L IH S AH T L IY
IMPLICITNESS	IH M P L IH S AH T N AH S
IMPLICITNESSES	IH M P L IH S AH T N AH S IH Z
IMPOLICIES	IH M P AA L AH S IY Z
IMPORTANCIES	IH M P OW R T AH N S IY Z
IMPOTENCIES	IH M P AH T AH N S IY Z
IMPRECISE	IH M P R AH S AY S
IMPRECISELY	IH M P R IH S AY S L IY
IMPRECISENESS	IH M P R IH S AY S N AH S
IMPRECISENESSES	IH M P R IH S AY S N AH S IH Z
IMPRECISION	IH M P R IH S AY ZH AH N
IMPRECISIONS	IH M P R IH S AY ZH AH N Z
IMPUDICITIES	IH M P Y AH D IH K SH AH T IY Z
IMPUDICITY	IH M P Y AH D IH K S AH T IY
INACCURACIES	IH N AE K Y ER AE S IY Z
INADEQUACIES	IH N AE D AH K W AH S IY Z
INADVERTENCIES	IH N AE D V ER T AH N S IY Z
INAPPRECIABLE	IH N AH P R IY SH AH B AH L
INAPPRECIABLY	IH N AH P R IY SH AH B L IY
INAPPRECIATIVE	IH N AH P R IY SH IY EY T IH V
INAPPRECIATIVELY	IH N AH P R IY SH IY EY T IH V L IY
INAPPRECIATIVENESS	IH N AH P R IY SH IY EY T IH V N AH S
INAPPRECIATIVENESSES	IH N AH P R IY SH IY EY T IH V N AH S IH Z
INARTICULACIES	IH N AA R T IH K Y AH L AH S IY Z
INAUSPICIOUS	IH N AW S P IH SH IH S
INAUSPICIOUSLY	IH N AO S P IH SH AH S L IY
INAUSPICIOUSNESS	IH N AO S P IH SH AH S N AH S
INAUSPICIOUSNESSES	IH N AO S P IH SH AH S N AH S IH Z
INAUTHENTICITIES	IH N AO TH EH N T IH S AH T IY Z
INAUTHENTICITY	IH N AO TH EH N T IH S AH T IY
INCANDESCING	IH N K AH N D EH S IH NG
INCAPACITATE	IH N K AH P AE S IH T EY T
INCAPACITATED	IH N K AH P AE S IH T EY T IH D
INCAPACITATES	IH N K AH P AE S AH T AH T S
INCAPACITATING	IH N K AH P AE S IH T EY T IH NG
INCAPACITATION	IH N K AH P AE S IH T EY SH AH N
INCAPACITATIONS	IH N K AH P AE S AH T EY SH AH N Z
INCAPACITIES	IH N K AH P AE S AH T IY Z
INCAPACITY	IH N K AH P AE S AH T IY
INCESSANCIES	IH N S EH S AH N S IY Z
INCIDENCE	IH N S AH D AH N S
INCIDENCE(2)	IH N S IH D AH N S
INCIDENCES	IH N S AH D AH N S IH Z
INCIDENT	IH N S AH D AH N T
INCIDENTAL	IH N S IH D EH N T AH L
INCIDENTALLY	IH N S IH D EH N T AH L IY
INCIDENTALLY(2)	IH N S IH D EH N T L IY
INCIDENTALS	IH N S IH D EH N T AH L Z
INCIDENTS	IH N S AH D AH N T S
INCINERATE	IH N S IH N ER EY T
INCINERATED	IH N S IH N ER EY T IH D
INCINERATES	IH N S IH N AH R EY T S
INCINERATING	IH N S IH N ER EY T IH NG
INCINERATION	IH N S IH N ER EY SH AH N
INCINERATIONS	IH N S IH N AH R EY SH AH N Z
INCINERATOR	IH N S IH N ER EY T ER
INCINERATORS	IH N S IH N ER EY T ER Z
INCIPIENCE	IH N S IH P IY AH N S
INCIPIENCES	IH N S IH P IY AH N S IH Z
INCIPIENCIES	IH N S IH P IY AH N S IY Z
INCIPIENCY	IH N S IH P IY AH N S IY
INCIPIENT	IH N S IH P IY AH N T
INCIPIENTLY	IH N S IH P IY AH N T L IY
INCIPIT	IH N S IH P AH T
INCIPITS	IH N S IH P AH T S
INCISAL	IH N S AY Z AH L
INCISE	IH N S AY Z
INCISED	IH N S AY Z D
INCISES	IH N S AY Z IH Z
INCISING	IH N S AY Z IH NG
INCISION	IH N S IH ZH AH N
INCISIONS	IH N S IH ZH AH N Z
INCISIVE	IH N S AY S IH V
INCISIVELY	IH N S AY S IH V L IY
INCISIVENESS	IH N S AY S IH V N AH S
INCISIVENESSES	IH N S AY S IH V N AH S IH Z
INCISOR	IH N S AY Z ER
INCISORS	IH N S AY Z ER Z
INCISORY	IH N S AY Z ER IY
INCISURE	IH N S AY ZH ER
INCISURES	IH N S AY ZH ER Z
INCITANT	IH N S AY T AH N T
INCITANTS	IH N S AY T AH N T S
INCITATION	IH N S AY T EY SH AH N
INCITATIONS	IH N S AY T EY SH AH N Z
INCITE	IH N S AY T
INCITED	IH N S AY T IH D
INCITEMENT	IH N S AY T M AH N T
INCITEMENTS	IH N S AY T M AH N T S
INCITER	IH N S AY T ER
INCITERS	IH N S AY T ER Z
INCITES	IH N S AY T S
INCITING	IH N S AY T IH NG
INCIVIL	IH N S IH V AH L
INCIVILITIES	IH N S AH V IH L AH T IY Z
INCIVILITY	IH N S IH V IH L IH T IY
INCLEMENCIES	IH N K L EH M AH N S IY Z
INCOERCIBLE	IH N K OW ER S AH B AH L
INCOMPETENCIES	IH N K AA M P AH T AH N S IY Z
INCONCINNITIES	IH N K AH N S IH N AH T AY Z
INCONCINNITY	IH N K AH N S IH N AH T IY
INCONSCIENT	IH N K AH N S AY AH N T
INCONSISTENCIES	IH NG K AA N S IH S T EH N S IY Z
INCONSTANCIES	IH N K AA N S T AH N S IY Z
INCONTINENCIES	IH N K AA N T AH N AH N S IY Z
INCONVENIENCIES	IH N K AH N V IY N Y AH N S IY Z
INCONVENIENCING	IH N K AH N V IY N Y AH N S IH NG
INCONVINCIBLE	IH N K AH N V IH N S AH B AH L
INCUMBENCIES	IH N K AH M B EH N S AY Z
INDECENCIES	IH N D IY S AH N S IY Z
INDECIPHERABLE	IH N D IY S AY F ER AH B AH L
INDECISION	IH N D IH S IH ZH AH N
INDECISIONS	IH N D IH S IH ZH AH N Z
INDECISIVE	IH N D IH S AY S IH V
INDECISIVELY	IH N D AH S AY S IH V L IY
INDECISIVENESS	IH N D EH S IH S IH V N AH S
INDECISIVENESSES	IH N D AH S AY S IH V N AH S IH Z
INDELICACIES	IH N D EH L IH K AH S IY Z
INDEPENDENCIES	IH N D IH P EH N D AH N S IY Z
INDETERMINACIES	IH N D IY T ER M AH N AH S IY Z
INDICIA	IH N D IH S Y AH
INDICIAS	IH N D IH S IY AH Z
INDICIUM	IH N D IH S IY AH M
INDICIUMS	IH N D IH S IY AH M Z
INDIFFERENCIES	IH N D IH F ER AH N S IY Z
INDISCIPLINABLE	IH N D IH S AH P L AH N AH B AH L
INDISCIPLINE	IH N D IH S AH P L AH N
INDISCIPLINED	IH N D IH S AH P L AH N D
INDISCIPLINES	IH N D IH S AH P L AH N Z
INDISSOCIABLE	IH N D IH S OW SH AH B AH L
INDISSOCIABLY	IH N D IH S OW SH AH B L IY
INDOCILE	IH N D AA S AH L
INDOCILITIES	IH N D AA S AH L AH T IY Z
INDOCILITY	IH N D AA S AH L AH T IY
INDOMETHACIN	IH N D AH M EH TH AH S AH N
INDOMETHACINS	IH N D AH M EH TH AH S AH N Z
INDUCIBILITIES	IH N D UW S AH B IH L AH T IY Z
INDUCIBILITY	IH N D UW S AH B IH L AH T IY
INDUCIBLE	IH N D UW S AH B AH L
INDUCING	IH N D UW S IH NG
INEFFICACIES	IH N EH F IH K AH S IY Z
INEFFICACIOUS	IH N EH F AH K EY SH AH S
INEFFICACIOUSLY	IH N EH F AH K EY SH AH S L IY
INEFFICACIOUSNESS	IH N EH F AH K EY SH AH S N AH S
INEFFICACIOUSNESSES	IH N EH F AH K EY SH AH S N AH S IH Z
INEFFICIENCIES	IH N IH F IH SH AH N S IY Z
INEFFICIENCY	IH N IH F IH SH AH N S IY
INEFFICIENT	IH N IH F IH SH AH N T
INEFFICIENTLY	IH N IH F IH SH AH N T L IY
INEFFICIENTS	IH N IH F IH SH AH N T S
INELASTICITIES	IH N IH L AE S T IH S AH T IY Z
INELASTICITY	IH N IH L AE S T IH S AH T IY
INERRANCIES	IH N EH ER AH N S IY Z
INEXPEDIENCIES	IH N IH K S P IY D IY AH N S IY Z
INEXPLICIT	IH N IH K S P L IH S AH T
INFANCIES	IH N F AH N S IY Z
INFANTICIDAL	IH N F AH N T IH K S AH D AH L
INFANTICIDE	IH N F AE N T AH S AY D
INFANTICIDES	IH N F AE N T AH S AY D Z
INFELICITIES	IH N F IH L IH S AH T IY Z
INFELICITOUS	IH N F IH L IH S AH T AH S
INFELICITOUSLY	IH N F IH L IH S AH T AH S L IY
INFELICITY	IH N F IH L IH S AH T IY
INFLUENCING	IH N F L UW AH N S IH NG
INFOMERCIAL	IH N F OW M ER SH AH L
INFOMERCIALS	IH N F OW M ER SH AH L Z
INFRASPECIFIC	IH N F R AH S P IH S IH F IH K
INFREQUENCIES	IH N F R IY K W AH N S IY Z
INHABITANCIES	IH N HH AE B AH T AH N S IY Z
INJUDICIOUS	IH N JH AH D IH SH AH S
INJUDICIOUSLY	IH N JH UH D IH SH AH S L IY
INJUDICIOUSNESS	IH N JH UH D IH SH AH S N AH S
INJUDICIOUSNESSES	IH N JH UH D IH SH AH S N AH S IH Z
INLACING	IH N L EY S IH NG
INNOCENCIES	IH N AH S AH N S IY Z
INNUMERACIES	IH N UW M ER AH S IY Z
INSECTICIDAL	IH N S EH K T AH S AY D AH L
INSECTICIDALLY	IH N S EH K T AH S AY D AH L IY
INSECTICIDE	IH N S EH K T AH S AY D
INSECTICIDES	IH N S EH K T AH S AY D Z
INSIGNIFICANCIES	IH N S IH G N IH F IH K AH N S IY Z
INSISTENCIES	IH N S IH S T AH N S IY Z
INSOCIABILITIES	IH N S OW SH AH B IH L AH T EH Z
INSOCIABILITY	IH N S OW SH AH B IH L AH T EH
INSOCIABLE	IH N S OW SH AH B AH L
INSOCIABLY	IH N S OW SH AH B L IY
INSOLVENCIES	IH N S AA L V AH N S IY Z
INSOUCIANCE	IH N S UW S IY AH N S
INSOUCIANCE(2)	IH N S UW S Y AH N S
INSOUCIANCES	IH N S UW S IY AH N S IH Z
INSOUCIANT	IH N S UW S Y AH N T
INSOUCIANTLY	IH N S UW S IY AH N T L IY
INSTANCIES	IH N S T AH N S IY Z
INSTANCING	IH N S T AH N S IH NG
INSUFFICIENCIES	IH N S AH F IH SH AH N S IY Z
INSUFFICIENCY	IH N S AH F IH SH AH N S IY
INSUFFICIENT	IH N S AH F IH SH AH N T
INSUFFICIENTLY	IH N S AH F IH SH AH N T L IY
INSURGENCIES	IH N S ER JH AH N S IY Z
INTERASSOCIATION	IH N T ER AH S OW S IY EY SH AH N
INTERASSOCIATIONS	IH N T ER AH S OW S IY EY SH AH N Z
INTERCITY	IH N T ER S IH T IY
INTERCITY(2)	IH N ER S IH T IY
INTERDEPENDENCIES	IH N T ER D IH P EH N D AH N S IY Z
INTERDISCIPLINARY	IH N T ER D IH S AH P L AH N EH R IY
INTERFACIAL	IH N T ER F EY SH AH L
INTERFACING	IH N T ER F EY S IH NG
INTERFACINGS	IH N T ER F EY S IH NG Z
INTERGLACIAL	IH N T ER G L EY SH AH L
INTERGLACIALS	IH N T ER G L EY SH AH L Z
INTERINFLUENCING	IH N T ER IH N F L UW AH N S IH NG
INTERLACING	IH N T ER L EY S IH NG
INTERMEDIACIES	IH N T ER M IY D IY AH S IY Z
INTERMITTENCIES	IH N T ER M IH T AH N S IY Z
INTERNECINE	IH N T ER N AH S IY N
INTERNUNCIAL	IH N T AH R N AH N CH AH L
INTERNUNCIO	IH N T AH R N AH N S IY OW
INTERNUNCIOS	IH N T AH R N AH N S IY AH Z
INTERPROVINCIAL	IH N T ER P R OW V IH N SH AH L
INTERRACIAL	IH N T ER R EY SH AH L
INTERRACIALLY	IH N T ER R EY SH AH L IY
INTERSOCIETAL	IH N T ER S AH S AY AH T AH L
INTERSOCIETY	IH N T ER S AH S AY AH T IY
INTERSPACING	IH N T ER S P EY S IH NG
INTERSPECIES	IH N T ER S P IY SH IY Z
INTERSPECIFIC	IH N T ER S P IH S IH F IH K
INTESTACIES	IH N T EH S T AH S IY Z
INTIMACIES	IH N T AH M AH S IY Z
INTRASPECIES	IH N T R AH S P IY SH IY Z
INTRASPECIFIC	IH N T R AH S P AH S IH F AH K
INTRATHORACIC	IH N T R AH TH AO R AH S AH K
INTRATHORACICALLY	IH N T R AH TH AH R AE S AH K AE L IY
INTRICACIES	IH N T R AH K AH S IY Z
INTRODUCING	IH N T R AH D UW S IH NG
INTRODUCING(2)	IH N T R OW D UW S IH NG
INVETERACIES	IH N V EH T ER AH S IY Z
INVINCIBILITIES	IH N V IH N S AH B IH L AH T AY Z
INVINCIBILITY	IH N V IH N S AH B IH L IH T IY
INVINCIBLE	IH N V IH N S AH B AH L
INVINCIBLENESS	IH N V IH N S AH B AH L N AH S
INVINCIBLENESSES	IH N V IH N S AH B AH L N AH S IH Z
INVINCIBLY	IH N V IH N S AH B AH L IY
INVIOLACIES	IH N V AY AH L AH S IY Z
INVISCID	IH N V IH S AH D
INVOICING	IH N V OY S IH NG
IONICITIES	AY AA N IH K AH T IY Z
IONICITY	AY AA N IH K AH T IY
IOTACISM	AY AH T AH S IH Z AH M
IOTACISMS	AY AA T AH S AH Z AH M Z
IRASCIBILITIES	AH R AE S AH B IH L AH T AY Z
IRASCIBILITY	AH R AE S AH B IH L AH T IY
IRASCIBLE	IH R AE S IH B AH L
IRASCIBLENESS	AH R AE S IH B L N AH S
IRASCIBLENESSES	IH R AH S IH B L AH N EH S AH Z
IRASCIBLY	IH R AE S IH B L IY
IRRECONCILABILITIES	IH R EH K AH N S AY L AH B IH L AH T EH Z
IRRECONCILABILITY	IH R EH K AH N S AY L AH B IH L AH T EH
IRRECONCILABLE	IH R EH K AH N S AY L AH B AH L
IRRECONCILABLENESS	IH R EH K AH N S AY L AH B AH L N AH S
IRRECONCILABLENESSES	IH R EH K AH N S AY L AH B AH L N AH S IH Z
IRRECONCILABLES	IH R EH K AH N S AY L AH B AH L Z
IRRECONCILABLY	IH R EH K AH N S AY L AH B L IY
IRREDUCIBILITIES	IH R IH D UW S AH B IH L AH T IY Z
IRREDUCIBILITY	IH R IH D UW S AH B IH L AH T IY
IRREDUCIBLE	IH R IH D UW S AH B AH L
IRREDUCIBLY	IH R IH D UW S AH B L IY
IRRELEVANCIES	IH R EH L AH V AH N S IY Z
IRREPRODUCIBILITIES	IH R IY P R AH D UW S AH B IH L AH T IY Z
IRREPRODUCIBILITY	IH R IY P R AH D UW S AH B IH L AH T IY
IRREPRODUCIBLE	IH R IY P R AH D UW S AH B AH L
ISOCRACIES	AH S AA K R AH S IY Z
ISOLEUCINE	AH S OW L AH S AY N
ISOLEUCINES	AH S OW L AH S AY N Z
ISOTONICITIES	AY S AH T AA N IH K AH T IY Z
ISOTONICITY	AY S AH T AA N IH K AH T IY
ITALICISE	AH T AE L AH S AY Z
ITALICISED	AY T AE L IH K IY Z D
ITALICISES	AY T AE L IH K IY Z IH Z
ITALICISING	AY T AE L IH K IY Z IH NG
ITALICIZATION	AY T AE L IH K AH Z EY SH AH N
ITALICIZATIONS	AY T AE L IH K AH Z EY SH AH N Z
ITALICIZE	AY T AE L AH S AY Z
ITALICIZED	AY T AE L AH S AY Z D
ITALICIZES	AY T AE L AH S AY Z IH Z
ITALICIZING	AY T AE L AH S AY Z IH NG
ITINERANCIES	AY T IH N ER AH N S IY Z
JACINTH	JH AE S IH N TH
JACINTHE	JH AE S IH N TH
JACINTHES	JH AE S AH N DH Z
JACINTHS	JH AE S AH N TH S
JAUNCING	JH AO N S AH NG
JAUNDICING	JH AO N D IH S AH NG
JOUNCIER	JH AW N S AY AH R
JOUNCIEST	JH AW N S AY AH S T
JOUNCING	JH AW N S AH NG
JUDICIAL	JH UW D IH SH AH L
JUDICIALLY	JH UW D IH SH AH L IY
JUDICIARIES	JH UH D IH SH IY EH R IY Z
JUDICIARY	JH UW D IH SH IY EH R IY
JUDICIOUS	JH UW D IH SH AH S
JUDICIOUSLY	JH UW D IH SH IH S L IY
JUDICIOUSNESS	JH UH D IH SH AH S N AH S
JUDICIOUSNESSES	JH UH D IH SH AH S N AH S IH Z
JUICIER	JH UW IH S Y ER
JUICIEST	JH UW S IY AH S T
JUICILY	JH UW S IY L IY
JUICINESS	JH UW S IY N AH S
JUICINESSES	JH UW S IY N AH S IH Z
JUICING	JH UW S IH NG
JUSTICIABILITIES	JH AH S T AH S IY AH B IH L AH T EH Z
JUSTICIABILITY	JH AH S T AH S IY AH B IH L AH T EH
JUSTICIABLE	JH AH S T AH S IY AH B AH L
JUSTICIAR	JH AH S T AH S IY ER
JUSTICIARS	JH AH S T AH S IY ER Z
KAMACITE	K AE M AH S AY T
KAMACITES	K AE M AH S AY T S
KANAMYCIN	K AH N AE M AH S AH N
KANAMYCINS	K AH N AE M AH S AH N Z
KATCINA	K AE T S AH N AH
KATCINAS	K AE T S AH N AH Z
KINETICIST	K AH N EH T IH K IH S T
KINETICISTS	K AH N EH T IH K IH S T S
LACIER	L EY S IY ER
LACIEST	L EY S IY AH S T
LACILY	L EY S IY L IY
LACINESS	L EY S IY N AH S
LACINESSES	L EY S IY N AH S IH Z
LACING	L EY S IH NG
LACINGS	L EY S IH NG Z
LACINIATE	L AH S IH N AY EY T
LACINIATION	L AH S IH N AY EY SH AH N
LACINIATIONS	L AE S AH N IY EY T IY AH N Z
LACTOBACILLI	L AE K T AH B AH S IH L IY
LACTOBACILLUS	L AE K T OW B AH S IH L AH S
LAICISE	L EY S AY Z
LAICISED	L EY IH S AH S T
LAICISES	L EY S AY Z AH Z
LAICISING	L EY S AY Z AH NG
LAICISM	L EY AH S IH Z AH M
LAICISMS	L EY S AH Z AH M Z
LAICIZATION	L EY IH S AH Z EY SH AH N
LAICIZATIONS	L EY S AH Z EY T IY AH N Z
LAICIZE	L EY AH S AY Z
LAICIZED	L EY AH S AY Z D
LAICIZES	L EY AH S AY Z AH Z
LAICIZING	L EY AH S AY Z AH NG
LAMBENCIES	L AE M AH N S IY Z
LANCIERS	L AE N S IY ER Z
LANCINATING	L AE N S AH N EY T AH NG
LANCING	L AE N S IH NG
LARVICIDAL	L AA R V IH S AH D AH L
LARVICIDE	L AA R V AH S AY D
LARVICIDES	L AA R V AH S AY D Z
LASCIVIOUS	L AH S IH V IY AH S
LASCIVIOUSLY	L AH S IH V IY AH S L IY
LASCIVIOUSNESS	L AH S IH V IY AH S N AH S
LASCIVIOUSNESSES	L AH S IH V IY AH S N AH S IH Z
LATENCIES	L EY T AH N S IY Z
LATICIFER	L AE T AH S AY F AH R
LATICIFERS	L AH T IH S AH F AH R Z
LATTICING	L AE T AH S IH NG
LAWRENCIUM	L AO R EH N S IY AH M
LAWRENCIUMS	L AH R EH N S IY AH M Z
LECITHIN	L EH S AH TH AH N
LECITHIN(2)	L EH S IH TH IH N
LECITHINASE	L AH S IH TH AH N EY Z
LECITHINASES	L AH S IH TH AH N EY Z AH Z
LECITHINS	L EH S AH TH AH N Z
LEGACIES	L EH G AH S IY Z
LEGITIMACIES	L IH JH IH T AH M AH S IY Z
LEMNISCI	L EH M N IH S IY
LENIENCIES	L IY N IY AH N S IY Z
LETTERSPACING	L EH T ER S P EY S IH NG
LETTERSPACINGS	L EH T ER S P EY S IH NG Z
LEUCIN	L UW S AH N
LEUCINE	L UW S AY N
LEUCINES	L UW S AY N Z
LEUCINS	L UW S AH N Z
LEUCITE	L UW S AY T
LEUCITES	L UW S AY T S
LEUCITIC	L UW S AH T AH K
LEUCOCIDIN	L UW K AA S AH D AH N
LEUCOCIDINS	L UW K AA S AH D AH N Z
LIBECCIO	L AH B EH K S IY OW
LIBECCIOS	L AH B EH K S IY AH Z
LICENCING	L AY S AH N S IH NG
LICIT	L IH S AH T
LICITLY	L AH S IH T L IY
LIEUTENANCIES	L UW T EH N AH N S IY Z
LIMACINE	L IH M AH S AY N
LINCOMYCIN	L IH NG K AA M AH S AH N
LINCOMYCINS	L IH NG K AA M AH S AH N Z
LINGUISTICIAN	L IH N G W IH S T IH S IY AH N
LINGUISTICIANS	L IH N G W AH S T IH S IY AH N Z
LITERACIES	L IH T ER AH S IY Z
LOCI	L OW K IY
LOCI(2)	L OW K AY
LOCULICIDAL	L AA K Y AH L IH S AH D AH L
LOGICIAN	L OW JH IH SH AH N
LOGICIANS	L AH JH IH S IY AH N Z
LOGICISE	L AA JH AH S AY Z
LOGICISED	L AA JH IH K IY Z D
LOGICISES	L AA JH IH K IY Z IH Z
LOGICISING	L AA JH IH K IY Z IH NG
LOGICIZE	L AA JH IH K AY Z
LOGICIZED	L AA JH IH K AY Z D
LOGICIZES	L AA JH IH K AY Z IH Z
LOGICIZING	L AA JH IH K AY Z IH NG
LOGISTICIAN	L AH JH IH S T IH S IY AH N
LOGISTICIANS	L AA JH AH S T IH S IY AH N Z
LOQUACIOUS	L OW K W EY SH AH S
LOQUACIOUSLY	L OW K W EY SH AH S L IY
LOQUACIOUSNESS	L OW K W EY SH AH S N AH S
LOQUACIOUSNESSES	L OW K W EY SH AH S N AH S IH Z
LOQUACITIES	L OW K W AE S AH T IY Z
LOQUACITY	L OW K W AE S AH T IY
LUBRICIOUS	L UW B R AH K IY AH S
LUBRICIOUSLY	L UW B R AH K IY AH S L IY
LUBRICITIES	L UW B R AH K AH T IY Z
LUBRICITY	L UW B R AH K AH T IY
LUCENCIES	L UW S AH N S IY Z
LUCID	L UW S IH D
LUCIDITIES	L UW S IH D AH T IY Z
LUCIDITY	L UW S IH D IH T IY
LUCIDLY	L UW S AH D L IY
LUCIDNESS	L UW S AH D N AH S
LUCIDNESSES	L UW S AH D N AH S IH Z
LUCIFER	L UW S AH F ER
LUCIFERASE	L UW S IH F AH R EY Z
LUCIFERASES	L UW S IH F AH R EY Z AH Z
LUCIFERIN	L UW S AH F ER IH N
LUCIFERINS	L UW S AH F ER IH N Z
LUCIFEROUS	L UW S AH F ER AH S
LUCIFERS	L UW S AH F ER Z
LUMINESCING	L UW M AH N EH S IH NG
LUNACIES	L UW N AH S AY Z
LUSCIOUS	L AH SH IH S
LUSCIOUSLY	L AH SH AH S L IY
LUSCIOUSNESS	L AH SH AH S N AH S
LUSCIOUSNESSES	L AH SH AH S N AH S IH Z
LUTECIUM	L UW T IY S IY AH M
LUTECIUMS	L UW T IY S IY AH M Z
LYRICISE	L IH R AH S AY Z
LYRICISED	L IH R IH K IY Z D
LYRICISES	L IH R IH K IY Z IH Z
LYRICISING	L IH R IH K IY Z IH NG
LYRICISM	L IH R IH S IH Z AH M
LYRICISMS	L IH R AH S IH Z AH M Z
LYRICIST	L IH R IH S IH S T
LYRICISTS	L IH R IH S IH S T S
LYRICIZE	L IH R IH K AY Z
LYRICIZED	L IH R IH K AY Z D
LYRICIZES	L IH R IH K AY Z IH Z
LYRICIZING	L IH R IH K AY Z IH NG
LYSOGENICITIES	L IH S AH JH AH N IH S AH T AY Z
LYSOGENICITY	L AH S AA JH AH N IH S AH T IY
LYSOLECITHIN	L IH S AH L EH S AH TH AH N
LYSOLECITHINS	L IH S AH L EH S AH TH AH N Z
MACING	M AE K IH NG
MACINTOSH	M AE K AH N T AO SH
MACINTOSHES	M AE K AH N T AO SH IH Z
MAGICIAN	M AH JH IH SH AH N
MAGICIANS	M AH JH IH SH AH N Z
MAGISTRACIES	M AE JH AH S T R AH S IY Z
MALICIOUS	M AH L IH SH AH S
MALICIOUSLY	M AH L IH SH IH S L IY
MALICIOUSNESS	M AH L IH SH AH S N AH S
MALICIOUSNESSES	M AH L IH SH AH S N AH S IH Z
MALIGNANCIES	M AH L IH G N AH N S IY Z
MANCIPLE	M AE N S AH P AH L
MANCIPLES	M AE N S AH P AH L Z
MARSHALCIES	M AA R SH AE L S AY Z
MATHEMATICIAN	M AE TH AH M AH T IH SH AH N
MATHEMATICIANS	M AE TH AH M AH T IH SH AH N Z
MATRICIDAL	M AE T R AY S AH D AH L
MATRICIDE	M AE T R AH S AY D
MATRICIDES	M AE T R AH S AY D Z
MAXILLOFACIAL	M AE K S AH L AH F AH S IY AH L
MECHANICIAN	M EH CH AH N IH S IY AH N
MECHANICIANS	M EH CH AH N IH S IY AH N Z
MEDIACIES	M IY D IY AH S IY Z
MEDICINABLE	M EH D AH S AH N AH B AH L
MEDICINAL	M AH D IH S AH N AH L
MEDICINALLY	M AH D IH S AH N AH L IY
MEDICINALS	M AH D IH S AH N AH L Z
MEDICINE	M EH D AH S AH N
MEDICINED	M EH D AH S AH N D
MEDICINES	M EH D AH S AH N Z
MEDICINING	M EH D AH S AH N IH NG
MEGACITIES	M AH G AE S AH T AY Z
MEGACITY	M IY G AH S AH T IY
MENACING	M EH N AH S IH NG
MENACINGLY	M EH N AH S IH NG L IY
MENDACIOUS	M EH N D EY SH AH S
MENDACIOUSLY	M EH N D EY SH AH S L IY
MENDACIOUSNESS	M EH N D EY SH AH S N AH S
MENDACIOUSNESSES	M EH N D EY SH AH S N AH S IH Z
MENDACITIES	M EH N D EY S AH T IY Z
MENDACITY	M EH N D AE S IH T IY
MENDICANCIES	M EH N D IH K AH N S IY Z
MENDICITIES	M EH N D IH K S AH T IY Z
MENDICITY	M EH N D IH K S AH T IY
MENINGOCOCCI	M AH N IH N G AH K AA K S IY
MENINGOCOCCIC	M AH N IH N G AH K AH K S AH K
MENISCI	M AH N IH S IY
MERCIES	M ER S IY Z
MERCIFUL	M ER S IH F AH L
MERCIFULLY	M ER S IH F AH L IY
MERCIFULNESS	M ER S IY F AH L N AH S
MERCIFULNESSES	M ER S IY F AH L N AH S IH Z
MERCILESS	M ER S AH L AH S
MERCILESSLY	M ER S AH L AH S L IY
MERCILESSNESS	M ER S IY L AH S N AH S
MERCILESSNESSES	M ER S IY L AH S N AH S IH Z
MERETRICIOUS	M EH R AH T R IH SH AH S
MERETRICIOUSLY	M EH R AH T R IH SH AH S L IY
MERETRICIOUSNESS	M EH R AH T R IH SH AH S N AH S
MERETRICIOUSNESSES	M EH R AH T R IH SH AH S N AH S IH Z
MERITOCRACIES	M EH R AH T AA K R AH S IY Z
MESOTHORACIC	M AH S AA TH AH R AH S AH K
METAPHYSICIAN	M EH T AH F AH Z IH SH AH N
METAPHYSICIANS	M EH T AH F AH Z IH SH AH N Z
METATHORACIC	M AH T AE TH AH R AH S AH K
METEORITICIST	M IY T IY AH R IH T IH K IH S T
METEORITICISTS	M IY T IY AH R IH T IH K IH S T S
METHICILLIN	M EH TH AH S IH L AH N
METHICILLINS	M EH TH AH S IH L AH N Z
METRICIZE	M EH T R IH K AY Z
METRICIZED	M EH T R IH K AY Z D
METRICIZES	M EH T R IH K AY Z IH Z
METRICIZING	M EH T R IH K AY Z IH NG
MICROCIRCUIT	M AY K R OW S ER K AH T
MICROCIRCUITRIES	M AY K R OW S ER K AH T R IY Z
MICROCIRCUITRY	M AY K R OW S ER K AH T R IY
MICROCIRCUITS	M AY K R OW S ER K AH T S
MICROCIRCULATION	M AY K R OW S ER K Y AH L EY SH AH N
MICROCIRCULATIONS	M AY K R OW S ER K Y AH L EY SH AH N Z
MICROCIRCULATORY	M AY K R OW S ER K Y AH L AH T OW R IY
MICROCOCCI	M AY K R OW K AH K S IY
MICROSEISMICITIES	M AY K R OW S AY Z M IH K AH T IY Z
MICROSEISMICITY	M AY K R OW S AY Z M IH K AH T IY
MILITANCIES	M IH L AH T AH N S IY Z
MINACITIES	M AH N AE S AH T AY Z
MINACITY	M AH N AH S AH T IY
MINCIER	M IH N S IY ER
MINCIEST	M IH N S IY AH S T
MINCING	M IH N S IH NG
MINCINGLY	M IH N S IH NG L IY
MIRACIDIA	M IH R AH S IH D IY AH
MIRACIDIAL	M IH R AH S IH D IY AH L
MIRACIDIUM	M IH R AH S IH D IY AH M
MISBALANCING	M IH S B AE L AH N S IH NG
MISCIBILITIES	M IH S AH B IH L AH T AY Z
MISCIBILITY	M IH S IH B IH L IH T IY
MISCIBLE	M IH S AH B AH L
MISCIBLE(2)	M IH S IH B AH L
MISCITATION	M IH S AY T EY SH AH N
MISCITATIONS	M IH S AY T EY SH AH N Z
MISCITE	M IH S AY T
MISCITED	M IH S AY T IH D
MISCITES	M IH S AY T S
MISCITING	M IH S AY T IH NG
MISPLACING	M IH S P L EY S IH NG
MISPRICING	M IH S P R AY S IH NG
MISPRONOUNCING	M IH S P R AH N AW N S IH NG
MISPRONUNCIATION	M IH S P R AH Z N AH N S IY EY SH AH N
MISPRONUNCIATIONS	M IH S P R AH Z N AH N S IY EY SH AH N Z
MISSPACING	M IH S P EY S IH NG
MISTRACING	M IH S T R EY S IH NG
MITICIDAL	M AY T IH K S AH D AH L
MITICIDE	M IH T AH S AY D
MITICIDES	M IH T AH S AY D Z
MITOGENICITIES	M IH T AH JH AH N IH S AH T AY Z
MITOGENICITY	M AH T AA JH AH N IH S AH T IY
MITOMYCIN	M AH T AA M AH S AH N
MITOMYCINS	M AH T AA M AH S AH N Z
MOBOCRACIES	M AH B AA K R AH S IY Z
MOLLUSCICIDAL	M AA L AH S IH S AH D AH L
MOLLUSCICIDE	M AA L AH S AH S AY D
MOLLUSCICIDES	M AA L AH S AH S AY D Z
MONACID	M AA N AH S AH D
MONACIDS	M AA N AH S AH D Z
MONASTICISM	M AH N AE S T AH S IH Z AH M
MONASTICISMS	M AH N AE S T AH S IH Z AH M Z
MONECIAN	M AH N IY SH AH N
MONECIOUS	M AH N IY SH AH S
MONOACID	M AA N OW AE S AH D
MONOACIDIC	M AA N OW AE S AH D IH K
MONOACIDS	M AA N OW AE S AH D Z
MONOCHROMATICITIES	M AA N OW K R OW M AE T IH K AH T IY Z
MONOCHROMATICITY	M AA N OW K R OW M AE T IH K AH T IY
MONOCRACIES	M AH N AA K R AH S IY Z
MONOECIES	M AH N OW AH S AY Z
MONOECIOUS	M AH N OW AH SH AH S
MONOECISM	M AA N OW AH S IH Z AH M
MONOECISMS	M AH N OW AH S AH Z AH M Z
MONOSPECIFIC	M AA N OW S P IH S IH F IH K
MONOSPECIFICITIES	M AA N OW S P EH S AH F IH S AH T IY Z
MONOSPECIFICITY	M AA N OW S P EH S AH F IH S AH T IY
MONOSYLLABICITIES	M AA N OW S IH L AH B IH S AH T IY Z
MONOSYLLABICITY	M AA N OW S IH L AH B IH S AH T IY
MONOTONICITIES	M AA N OW T AA N IH K AH T IY Z
MONOTONICITY	M AA N OW T AA N IH K AH T IY
MORDANCIES	M AO R D AE N S AY Z
MORTICIAN	M AO R T IH SH AH N
MORTICIANS	M AO R T IH SH AH N Z
MORTICING	M AO R T IH K S IH NG
MOSAICISM	M OW Z EY IH K IH Z AH M
MOSAICISMS	M OW Z EY IH K IH Z AH M Z
MOSAICIST	M OW Z EY IH K IH S T
MOSAICISTS	M OW Z EY IH K IH S T S
MUCID	M Y UW S AH D
MUCIDITIES	M Y UW S IH D AH T AY Z
MUCIDITY	M Y UW S IH D AH T IY
MUCILAGE	M Y UW S AH L IH JH
MUCILAGES	M Y UW S AH L IH JH IH Z
MUCILAGINOUS	M Y UW S AH L AE JH AH N AH S
MUCILAGINOUSLY	M Y UW S AH L AH JH IH N OW AH S L IY
MUCIN	M Y UW S AH N
MUCINOID	M Y UW S AH N OY D
MUCINOUS	M Y UW S AH N AH S
MUCINS	M Y UW S AH N Z
MULTICITY	M AH L T AY S IH T IY
MULTIDISCIPLINARY	M AH L T AY D IH S AH P L AH N EH R IY
MULTIDISCIPLINE	M AH L T AY D IH S AH P L AH N
MULTIDISCIPLINES	M AH L T AY D IH S AH P L AH N Z
MULTIPLICITIES	M AH L T AH P L IH S AH T IY Z
MULTIPLICITY	M AH L T AH P L IH S IH T IY
MULTIRACIAL	M AH L T AY R EY SH AH L
MULTIRACIALISM	M AH L T AY R EY SH AH L IH Z AH M
MULTIRACIALISMS	M AH L T AY R EY SH AH L IH Z AH M Z
MULTISPECIES	M AH L T AY S P IY SH IY Z
MUNICIPAL	M Y UW N IH S AH P AH L
MUNICIPALITIES	M Y UW N IH S AH P AE L IH T IY Z
MUNICIPALITY	M Y UW N IH S AH P AE L AH T IY
MUNICIPALIZATION	M Y UH N IH S AH P AH L AH Z EY SH AH N
MUNICIPALIZATIONS	M Y UH N IH S AH P AH L AH Z EY SH AH N Z
MUNICIPALIZE	M Y UH N IH S AH P AH L AY Z
MUNICIPALIZED	M Y UH N IH S AH P AH L AY Z D
MUNICIPALIZES	M Y UH N IH S AH P AH L AY Z IH Z
MUNICIPALIZING	M Y UH N IH S AH P AH L AY Z IH NG
MUNICIPALLY	M Y UW N IH S IH P AH L IY
MUNICIPALLY(2)	M Y UW N IH S IH P L IY
MUNICIPALS	M Y UW N IH S IH P AH L Z
MUSCID	M AH S AH D
MUSCIDS	M AH S AH D Z
MUSICIAN	M Y UW Z IH SH AH N
MUSICIANLY	M Y UH Z IH SH AH N L IY
MUSICIANS	M Y UW Z IH SH AH N Z
MUSICIANSHIP	M Y UW Z IH SH AH N SH IH P
MUSICIANSHIPS	M Y UH Z IH SH AH N SH IH P S
MUTAGENICITIES	M Y UW T IH JH AH N IH K S AH T IY Z
MUTAGENICITY	M Y UW T IH JH AH N IH K S AH T IY
MYSTICISM	M IH S T IH S IH Z AH M
MYSTICISMS	M IH S T IH K S P IH Z AH M Z
MYTHICIZE	M IH TH IH K S AY Z
MYTHICIZED	M IH TH IH K S AY Z D
MYTHICIZER	M IH TH IH K S AY Z ER
MYTHICIZERS	M IH TH IH K S AY Z ER Z
MYTHICIZES	M IH TH IH K S AY Z IH Z
MYTHICIZING	M IH TH IH K S AY Z IH NG
NANCIES	N AE N S AY Z
NARCISM	N AA R S AH Z AH M
NARCISMS	N AA R S AH Z AH M Z
NARCISSI	N AA R S IH S IY
NARCISSISM	N AA R S IH S IH Z AH M
NARCISSISMS	N AA R S IH S AH Z AH M Z
NARCISSIST	N AA R S IH S IH S T
NARCISSISTIC	N AA R S IH S IH S T IH K
NARCISSISTS	N AA R S IH S AH S T S
NARCISSUS	N AA R S IH S AH S
NARCISSUSES	N AA R S AH S UW Z AH Z
NARCIST	N AA R S AH S T
NARCISTS	N AA R S AH S T S
NASCENCIES	N EY S AH N S IY Z
NECROMANCIES	N EH K R AH M AE N S AY Z
NEMATICIDAL	N EH M AH T IH S AH D AH L
NEMATICIDE	N AH M AE T AH S AY D
NEMATICIDES	N AH M AE T AH S AY D Z
NEMATOCIDAL	N EH M AH T AA S AH D AH L
NEMATOCIDE	N AH M AE T AH S AY D
NEMATOCIDES	N AH M AE T AH S AY D Z
NEOCLASSICISM	N IY OW K L AE S IH K S IH Z AH M
NEOCLASSICISMS	N IY OW K L AE S IH K S IH Z AH M Z
NEOCLASSICIST	N IY OW K L AE S AH S AH S T
NEOCLASSICISTS	N IY OW K L AE S AH S AH S T S
NEOMYCIN	N IY AH M IH S AH N
NEOMYCINS	N IY AH M IH S AH N Z
NEOPLASTICISM	N IY OW P L AE S T IH K IH Z AH M
NEOPLASTICISMS	N IY OW P L AE S T IH K IH Z AH M Z
NEOPLASTICIST	N IY OW P L AE S T IH K IH S T
NEOPLASTICISTS	N IY OW P L AE S T IH K IH S T S
NEPHROTOXICITIES	N EH F R AH T AA K S IH S AH T AY Z
NEPHROTOXICITY	N EH F R AH T AA K S IH S AH T IY
NESCIENCE	N EH SH AH N S
NESCIENCES	N AH SH AH N S AH Z
NESCIENT	N EH SH AH N T
NESCIENTS	N EH S IY N T S
NEUROSCIENCE	N Y UH R OW S AY AH N S
NEUROSCIENCES	N Y UH R AH SH AH N S AH Z
NEUROSCIENTIFIC	N Y AH R AA S IY N T IH F AH K
NEUROSCIENTIST	N Y UH R OW S AY AH N T IH S T
NEUROSCIENTIST(2)	N Y UH R OW S AY AH N IH S T
NEUROSCIENTISTS	N Y UH R AH S IY N T AH S T S
NEUROTICISM	N UH R AA T IH K IH Z AH M
NEUROTICISMS	N UH R AA T IH K IH Z AH M Z
NEUROTOXICITIES	N Y UH R AH T AA K S IH S AH T AY Z
NEUROTOXICITY	N Y UH R AH T AA K S IH S AH T IY
NIACIN	N AY AH S AH N
NIACIN(2)	N AY AH S IH N
NIACINAMIDE	N AY AH S IH N AH M AY D
NIACINAMIDES	N AY AH S IH N AH M AY D Z
NIACINS	N AY AH S AH N Z
NOCICEPTIVE	N OW S IY S EH P T IH V
NONACID	N AA N AE S AH D
NONACIDIC	N AA N AE S AH D IH K
NONACIDS	N AA N AE S AH D Z
NONASSOCIATED	N AA N AH S OW S IY EY T IH D
NONBELLIGERENCIES	N AA N B AH L IH JH ER AH N S IY Z
NONCANDIDACIES	N AA N K AE N D AH D AH S IY Z
NONCARCINOGEN	N AA N K AA R S IH N AH JH AH N
NONCARCINOGENIC	N AA N K AA R S IH N AH JH AH N AH K
NONCARCINOGENS	N AA N K AA R S IH N AH JH AH N Z
NONCIRCULAR	N AA N S ER K Y AH L ER
NONCIRCULATING	N AA N S ER K Y AH L EY T IH NG
NONCITIZEN	N AA N S IH T AH Z AH N
NONCITIZENS	N AA N S IH T AH Z AH N Z
NONCOERCIVE	N AA N K OW ER S IH V
NONCOINCIDENCE	N AA N K OW IH N S AH D AH N S
NONCOINCIDENCES	N AA N K OW IH N S AH D AH N S IH Z
NONCOMMERCIAL	N AA N K AH M ER SH AH L
NONCOMMERCIALS	N AA N K AH M ER SH AH L Z
NONCONSCIOUS	N AA N K AA N SH AH S
NONDECISION	N AA N D IH S IH ZH AH N
NONDECISIONS	N AA N D IH S IH ZH AH N Z
NONEMERGENCIES	N AA N IH M ER JH AH N S IY Z
NONFINANCIAL	N AA N F AH N AE N SH AH L
NONFINANCIAL(2)	N AA N F AY N AE N SH AH L
NONFLUENCIES	N AA N F L UW AH N S IY Z
NONINSECTICIDAL	N AA N IH N S EH K T AH S AY D AH L
NONJUDICIAL	N AA N JH UH D IH SH AH L
NONJUSTICIABLE	N AA N JH AH S T AH S IY AH B AH L
NONMATHEMATICIAN	N AA N M AE TH AH M AH T IH SH AH N
NONMATHEMATICIANS	N AA N M AE TH AH M AH T IH SH AH N Z
NONMUNICIPAL	N AA N M Y UH N IH S AH P AH L
NONMUSICIAN	N AA N M Y UH Z IH SH AH N
NONMUSICIANS	N AA N M Y UH Z IH SH AH N Z
NONOFFICIAL	N AA N AH F IH SH AH L
NONPARTICIPANT	N AA N P AA R T IH S AH P AH N T
NONPARTICIPANTS	N AA N P AA R T IH S AH P AH N T S
NONPARTICIPATING	N AA N P AA R T IH S AH P EY T IH NG
NONPARTICIPATION	N AA N P AA R T IH S AH P EY SH AH N
NONPARTICIPATIONS	N AA N P AA R T IH S AH P EY SH AH N Z
NONPARTICIPATORY	N AA N P AA R T IH S AH P AH T OW R IY
NONPHYSICIAN	N AA N F AH Z IH SH AH N
NONPHYSICIANS	N AA N F AH Z IH SH AH N Z
NONPOLITICIAN	N AA N P AA L AH T IH SH AH N
NONPOLITICIANS	N AA N P AA L AH T IH SH AH N Z
NONPRACTICING	N AA N P R AE K T AH S IH NG
NONPRODUCING	N AA N P R AH D UW S IH NG
NONRACIAL	N AA N R EY SH AH L
NONRACIALLY	N AA N R EY SH AH L IY
NONRECIPROCAL	N AA N R IH S IH P R AH K AH L
NONRECIPROCALS	N AA N R IH S IH P R AH K AH L Z
NONREDUCING	N AA N R IH D UW S IH NG
NONREPRODUCIBLE	N AA N R IY P R AH D UW S AH B AH L
NONRESIDENCIES	N AA N R IH Z AY D AH N S IY Z
NONSCIENCE	N AA N S AY AH N S
NONSCIENCES	N AA N S AY AH N S IH Z
NONSCIENTIFIC	N AA N S AY AH N T IH F IH K
NONSCIENTIST	N AA N S AY AH N T IH S T
NONSCIENTISTS	N AA N S AY AH N T IH S T S
NONSOCIAL	N AA N S OW SH AH L
NONSOCIALIST	N AA N S OW SH AH L IH S T
NONSOCIALISTS	N AA N S OW SH AH L IH S T S
NONSPECIALIST	N AA N S P EH SH AH L IH S T
NONSPECIALISTS	N AA N S P EH SH AH L IH S T S
NONSPECIFIC	N AA N S P AH S IH F IH K
NONSPECIFICALLY	N AA N S P IH S IH F IH K AH L IY
NORMALCIES	N AO R M AH L S IY Z
NOTICING	N OW T IH S IH NG
NOVEMDECILLION	N AH V EH M D AH S IH L IY AH N
NOVEMDECILLIONS	N AH V EH M D AH S IH L IY AH N Z
NOVOBIOCIN	N AA V AH B IY AH S AH N
NOVOBIOCINS	N AA V AH B IY AH S AH N Z
NUCLEOPHILICITIES	N AH K L IY AH F AH L IH S AH T AY Z
NUCLEOPHILICITY	N AH K L IY AH F AH L IH S AH T IY
NUMERACIES	N UW M ER AH S IY Z
NUNCIATURE	N AH N S AY EY T Y AH R
NUNCIATURES	N AH N S AY EY T Y AH R Z
NUNCIO	N AH N S IY OW
NUNCIOS	N AH N S IY AH Z
OBDURACIES	AA B D Y UH R AH S AY Z
OBSOLESCING	AA B S AH L EH S IH NG
OBSTETRICIAN	AA B S T AH T R IH SH AH N
OBSTETRICIANS	AA B S T AH T R IH SH AH N Z
OBSTINACIES	AA B S T AH N AH S IY Z
OCCIDENT	AA K S AH D EH N T
OCCIDENTAL	AA K S AH D EH N T AH L
OCCIDENTALIZE	AA K S AH D EH N T AH L AY Z
OCCIDENTALIZED	AA K S AH D EH N T AH L AY Z D
OCCIDENTALIZES	AA K S AH D EH N T AH L AY Z IH Z
OCCIDENTALIZING	AA K S AH D EH N T AH L AY Z IH NG
OCCIDENTALLY	AA K S AH D EH N T AH L IY
OCCIDENTS	AA K S AH D AH N T S
OCCIPITA	AA K S IH P AH T AH
OCCIPITAL	AA K S IH P AH T AH L
OCCIPITALLY	AA K S IH P AH T AH L IY
OCCIPITALS	AA K S IH P AH T AH L Z
OCCIPUT	AA K S AH P AH T
OCCIPUTS	AA K S AH P Y UW T S
OCCUPANCIES	AA K Y AH P AH N S IY Z
OCHLOCRACIES	AA K L AA K R AH S IY Z
OCTODECILLION	AA K T AA D AH S IH L IY AH N
OCTODECILLIONS	AA K T AH D AH S IH L IY AH N Z
OFFICIAL	AH F IH SH AH L
OFFICIALDOM	AH F IH SH AH L D AH M
OFFICIALDOMS	AH F IH SH AH L D AH M Z
OFFICIALESE	AA F IH S IY AH L IY Z
OFFICIALESES	AA F IH S IY AH L IY Z AH Z
OFFICIALISM	AH F IH SH AH L IH Z AH M
OFFICIALISMS	AH F IH SH AH L IH Z AH M Z
OFFICIALLY	AH F IH SH AH L IY
OFFICIALS	AH F IH SH AH L Z
OFFICIANT	AH F IH SH IY AH N T
OFFICIANTS	AH F IH SH IY AH N T S
OFFICIARIES	AH F IH SH IY EH R IY Z
OFFICIARY	AH F IH SH IY EH R IY
OFFICIATE	AH F IH SH IY EY T
OFFICIATED	AH F IH SH IY EY T AH D
OFFICIATES	AH F IH SH IY EY T S
OFFICIATING	AH F IH SH IY EY T IH NG
OFFICIATION	AH F IH SH IY EY SH AH N
OFFICIATIONS	AH F IH SH IY EY SH AH N Z
OFFICINAL	AO F IH K S N IH N AH L
OFFICIOUS	AH F IH SH AH S
OFFICIOUSLY	AH F IH SH AH S L IY
OFFICIOUSNESS	AH F IH SH AH S N AH S
OFFICIOUSNESSES	AH F IH SH AH S N AH S IH Z
OITICICA	OY T AH S IY K AH
OITICICAS	OY T AH S IY K AH Z
OLEANDOMYCIN	OW L IY N D AA M AH S AH N
OLEANDOMYCINS	OW L IY N D AA M AH S AH N Z
OMNISCIENCE	AA M N IH SH AH N S
OMNISCIENCES	AA M N IH SH AH N S IH Z
OMNISCIENT	AA M N IH SH AH N T
OMNISCIENTLY	AA M N IH SH AH N T L IY
ONCHOCERCIASES	AO NG K AH S AH R S IY EY Z AH Z
ONCHOCERCIASIS	AO NG K AH S AH R S IY AH S AH S
ONCIDIUM	AA N S IH D IY AH M
ONCIDIUMS	AA N S IH D IY AH M Z
ONCOGENICITIES	AO N K OW JH AH N IH K S AH T IY Z
ONCOGENICITY	AO N K OW JH AH N IH K S AH T IY
ONEIROMANCIES	OW N AH R AH M AE N S AY Z
ONOMASTICIAN	AA N AH M AE S T IH S IY AH N
ONOMASTICIANS	AA N AH M AH S T IH S IY AH N Z
OPACIFIED	AH P AE S AH F AY D
OPACIFIES	AH P AE S AH F AY Z
OPACIFY	OW P AH S AH F AY
OPACIFYING	AA P AH S IH F AY AH NG
OPACITIES	AH P AE S AH T AY Z
OPACITY	OW P AE S AH T IY
OPALESCING	AA P AH L EH S AH NG
OPTICIAN	AA P T IH SH AH N
OPTICIANS	AA P T IH SH AH N Z
OPTICIST	AA P T IH K IH S T
OPTICISTS	AA P T IH K IH S T S
OPULENCIES	AA P Y AH L AH N S IY Z
ORCIN	AO R S AH N
ORCINOL	AO R S AH N AH L
ORCINOLS	AO R S AH N AH L Z
ORCINS	AO R S AH N Z
ORGANICISM	AO R G AE N IH K IH Z AH M
ORGANICISMS	AO R G AE N IH K IH Z AH M Z
ORGANICIST	AO R G AE N IH K IH S T
ORGANICISTS	AO R G AE N IH K IH S T S
ORGANICITIES	AO R G AE N IH K AH T IY Z
ORGANICITY	AO R G AE N IH K AH T IY
ORIFICIAL	AO R AH F AH S IY AH L
OSCILLATE	AA S AH L EY T
OSCILLATED	AA S AH L EY T AH D
OSCILLATES	AA S AH L EY T S
OSCILLATING	AA S AH L EY T IH NG
OSCILLATION	AA S AH L EY SH AH N
OSCILLATIONAL	AA S AH L EY SH AH N AH L
OSCILLATIONS	AA S AH L EY SH AH N Z
OSCILLATOR	AA S AH L EY T ER
OSCILLATORS	AA S AH L EY T ER Z
OSCILLATORY	AA S AH L AH T AO R IY
OSCILLOGRAM	AA S AH L AA G R AH M
OSCILLOGRAMS	AA S AH L AA G R AH M Z
OSCILLOGRAPH	AA S AH L AA G R AH F
OSCILLOGRAPHIC	AA S AH L AA G R AH F AH K
OSCILLOGRAPHICALLY	AA S IH L AA G R AE F AH K AE L IY
OSCILLOGRAPHIES	AA S AH L AA G R AH F AY Z
OSCILLOGRAPHS	AA S AH L AA G R AH F S
OSCILLOGRAPHY	AA S AH L AA G R AH F IY
OSCILLOSCOPE	AO S IH L AH S K OW P
OSCILLOSCOPES	AO S IH L AH S K OW P S
OSCILLOSCOPIC	AA S AH L AA S AH P AH K
OSCINE	AA S AY N
OSCINES	AA S AY N Z
OSCININE	AA S AH N AY N
OSCITANT	AA S AY T AH N T
OSTEOMALACIA	AA S T IY AH M AH L EY SH IY AH
OSTEOMALACIAS	AA S T IY AH M AH L EY S IY AH Z
OSTRACISE	AA S T R AH S AY Z
OSTRACISED	AA S T R EY S IY Z D
OSTRACISES	AA S T R EY S IY Z IH Z
OSTRACISING	AA S T R EY S IY Z IH NG
OSTRACISM	AO S T R AH S IH Z AH M
OSTRACISMS	AA S T R AH S IH Z AH M Z
OSTRACIZE	AO S T R AH S AY Z
OSTRACIZED	AO S T R AH S AY Z D
OSTRACIZES	AA S T R AH S AY Z IH Z
OSTRACIZING	AA S T R AH S AY Z IH NG
OTOTOXICITIES	AA T AH T AA K S IH S AH T AY Z
OTOTOXICITY	AA T AH T AA K S IH S AH T IY
OUTBALANCING	AW T B AE L AH N S IH NG
OUTDANCING	AW T D AE N S IH NG
OUTDISTANCING	AW T D IH S T AH N S IH NG
OUTFACING	AW T F EY S IH NG
OUTPACING	AW T P EY S IH NG
OUTPRICING	AW T P R AY S IH NG
OUTPRODUCING	AW T P R AH D UW S IH NG
OUTRACING	AW T R EY S IH NG
OUTREPRODUCING	AW T R IY P R AH D UW S IH NG
OUTSOURCING	AW T S AO R S IH NG
OUTSOURCINGS	AW T S OW R S IH NG Z
OUTVOICING	AW T V OY S IH NG
OVERBALANCING	OW V ER B AE L AH N S IH NG
OVERCAPACITIES	OW V ER K AH P AE S AH T IY Z
OVERCAPACITY	OW V ER K AH P AE S AH T IY
OVERCIVILIZED	OW V ER S IH V AH L AY Z D
OVERCOMMERCIALIZATION	OW V ER K AH M ER SH AH L AH Z EY SH AH N
OVERCOMMERCIALIZATIONS	OW V ER K AH M ER SH AH L AH Z EY SH AH N Z
OVERCOMMERCIALIZE	OW V ER K AH M ER SH AH L AY Z
OVERCOMMERCIALIZED	OW V ER K AH M ER SH AH L AY Z D
OVERCOMMERCIALIZES	OW V ER K AH M ER SH AH L AY Z IH Z
OVERCOMMERCIALIZING	OW V ER K AH M ER SH AH L AY Z IH NG
OVERCONSCIENTIOUS	OW V ER K AA N CH IY EH N CH AH S
OVERCONSCIOUS	OW V ER K AA N SH AH S
OVEREXCITE	OW V ER EH K S AY T
OVEREXCITED	OW V ER EH K S AY T IH D
OVEREXCITES	OW V ER EH K S AY T S
OVEREXCITING	OW V ER EH K S AY T IH NG
OVEREXERCISE	OW V ER EH K S ER S AY Z
OVEREXERCISED	OW V ER EH K S ER S AY Z D
OVEREXERCISES	OW V ER EH K S ER S AY Z IH Z
OVEREXERCISING	OW V ER EH K S ER S AY Z IH NG
OVEREXPLICIT	OW V ER IH K S P L IH S AH T
OVERFACILE	OW V ER F AE S AH L
OVERPRECISE	OW V ER P R IH S AY S
OVERPRICING	OW V ER P R AY S IH NG
OVERPRODUCING	OW V ER P R AH D Y UW S IH NG
OVERSAUCING	OW V ER S AO S IH NG
OVERSERVICING	OW V ER S ER V AH S IH NG
OVERSOLICITOUS	OW V ER S AH L IH S AH T AH S
OVERSPECIALIZATION	OW V ER S P EH SH AH L AH Z EY SH AH N
OVERSPECIALIZATIONS	OW V ER S P EH SH AH L AH Z EY SH AH N Z
OVERSPECIALIZE	OW V ER S P EH SH AH L AY Z
OVERSPECIALIZED	OW V ER S P EH SH AH L AY Z D
OVERSPECIALIZES	OW V ER S P EH SH AH L AY Z IH Z
OVERSPECIALIZING	OW V ER S P EH SH AH L AY Z IH NG
OVERSUSPICIOUS	OW V ER S AH S P IH SH AH S
OVICIDAL	AH V IH S AH D AH L
OVICIDE	AA V AH S AY D
OVICIDES	AA V AH S AY D Z
OXACILLIN	AA K S AH S IH L AH N
OXACILLINS	AA K S AH S IH L AH N Z
OXYACID	AA K S IY AE S AH D
OXYACIDS	AA K S IY AE S AH D Z
OXYTOCIC	AA K S AH T AH S AH K
OXYTOCICS	AA K S IH T AH S AH S Z
OXYTOCIN	AA K S AH T OW S AH N
OXYTOCINS	AA K S IH T AH S AH N Z
PACIFIABLE	P AE S AH F AY AH B AH L
PACIFIC	P AH S IH F IH K
PACIFICALLY	P AH S IH F IH K AH L IY
PACIFICATION	P AE S AH F AH K EY SH AH N
PACIFICATIONS	P AE S AH F AH K EY SH AH N Z
PACIFICATOR	P AH S IH F IH K AH T ER
PACIFICATORS	P AH S IH F IH K AH T ER Z
PACIFICISM	P AH S IH F IH K IH Z AH M
PACIFICISMS	P AH S IH F IH K IH Z AH M Z
PACIFICIST	P AH S IH F IH K IH S T
PACIFICISTS	P AH S IH F IH K IH S T S
PACIFIED	P AE S AH F AY D
PACIFIER	P AE S AH F AY ER
PACIFIERS	P AE S AH F AY ER Z
PACIFIES	P AE S AH F AY Z
PACIFISM	P AE S IH F IH Z AH M
PACIFISMS	P AE S AH F AH Z AH M Z
PACIFIST	P AE S IH F IH S T
PACIFISTIC	P AE S AH F IH S T IH K
PACIFISTICALLY	P AE S AH F IH S T IH K AH L IY
PACIFISTS	P AE S IH F IH S T S
PACIFY	P AE S AH F AY
PACIFYING	P AE S AH F AY IH NG
PACING	P EY S IH NG
PAEDIATRICIAN	P IY D IY AE T R IH S IY AH N
PAEDIATRICIANS	P IY D IY AH T R IH S IY AH N Z
PANTISOCRACIES	P AE N T AH S AA K R AH S IY Z
PAPACIES	P AE P AH S IY Z
PARAMECIA	P AE R AH M IY SH IY AH
PARAMECIUM	P EH R AH M IY S IY AH M
PARAMECIUMS	P AE R AH M IY S IY AH M Z
PARAMOUNTCIES	P AE R AH M AW N T S AY Z
PARASITICIDAL	P AE R AH S IH T IH K AH D AH L
PARASITICIDE	P AH R AH S IH T AH S AY D
PARASITICIDES	P AH R AH S IH T AH S AY D Z
PARECISM	P AE R AH S IH Z AH M
PARECISMS	P AE R AH S AH Z AH M Z
PARRICIDAL	P AA R IH K S AH D AH L
PARRICIDE	P AE R AH S AY D
PARRICIDES	P AE R AH S AY D Z
PARTICIPANT	P AA R T IH S AH P AH N T
PARTICIPANTS	P AA R T IH S AH P AH N T S
PARTICIPATE	P AA R T IH S AH P EY T
PARTICIPATED	P AA R T IH S AH P EY T AH D
PARTICIPATED(2)	P AA R T IH S AH P EY T IH D
PARTICIPATES	P AA R T IH S AH P EY T S
PARTICIPATING	P AA R T IH S AH P EY T IH NG
PARTICIPATION	P AA R T IH S AH P EY SH AH N
PARTICIPATIONAL	P AA R T IH S AH P EY SH AH N AH L
PARTICIPATIONS	P AA R T IH S AH P EY SH AH N Z
PARTICIPATIVE	P AA R T IH S AH P AH T IH V
PARTICIPATOR	P AA R T IH S AH P AH T ER
PARTICIPATORS	P AA R T IH S AH P AH T ER Z
PARTICIPATORY	P AA R T IH S AH P AH T AO R IY
PARTICIPIAL	P AA R T IH S AH P IY AH L
PARTICIPIALLY	P AA R T IH S AH P IY AH L IY
PARTICIPLE	P AA R T IH S IH P AH L
PARTICIPLES	P AA R T IH S IH P AH L Z
PASTICCI	P AE S T IH K S IY
PASTICCIO	P AE S T IH K S IY OW
PASTICCIOS	P AE S T IH K S IY AH Z
PATENCIES	P EY T AH N S IY Z
PATHOGENICITIES	P AE TH AH JH EH N IH K AH T IY Z
PATHOGENICITY	P AE TH AH JH EH N IH K AH T IY
PATRICIAN	P AH T R IH SH AH N
PATRICIANS	P AH T R IH SH AH N Z
PATRICIATE	P AE T R AY S IY AH T
PATRICIATES	P AE T R AY S IY AH T S
PATRICIDAL	P AE T R AY S AH D AH L
PATRICIDE	P AE T R AH S AY D
PATRICIDES	P AE T R AH S AY D Z
PAUCITIES	P AO S AH T IY Z
PAUCITY	P AO S AH T IY
PEACING	P IY S IH NG
PECCANCIES	P EH K AH N S IY Z
PEDIATRICIAN	P IY D IY AH T R IH SH AH N
PEDIATRICIANS	P IY D IY AH T R IH SH AH N Z
PELLUCID	P EH L UW S AH D
PELLUCIDLY	P EH L AH S IH D L IY
PENANCING	P EH N AH N S IH NG
PENCIL	P EH N S AH L
PENCILED	P EH N S AH L D
PENCILER	P EH N S AH L ER
PENCILERS	P EH N S AH L ER Z
PENCILING	P EH N S AH L IH NG
PENCILINGS	P EH N S AH L IH NG Z
PENCILLED	P EH N S AH L D
PENCILLING	P EH N S AH L IH NG
PENCILLINGS	P EH N S AH L IH NG Z
PENCILS	P EH N S AH L Z
PENDENCIES	P EH N D EH N S AY Z
PENICIL	P EH N AH S AH L
PENICILLAMINE	P EH N IH K S IH L AH M AY N
PENICILLAMINES	P EH N IH K S IH L AH M AY N Z
PENICILLATE	P EH N IH K S IH L AH T
PENICILLIA	P EH N AH S IH L IY AH
PENICILLIN	P EH N AH S IH L AH N
PENICILLINASE	P AH N AH S IH L AH N EY Z
PENICILLINASES	P AH N AH S IH L AH N EY Z AH Z
PENICILLINS	P EH N AH S IH L AH N Z
PENICILLIUM	P EH N AH S IH L IY AH M
PENICILLIUMS	P EH N AH S IH L IY AH M Z
PENICILS	P IY N IH S AH L Z
PENTAZOCINE	P EH N T AE Z AH S AY N
PENTAZOCINES	P EH N T AE Z AH S AY N Z
PERACID	P ER AE S AH D
PERACIDS	P ER AE S AH D Z
PERCIPIENCE	P AH R S IH P IY AH N S
PERCIPIENCES	P AH R S IH P IY EH N S AH Z
PERCIPIENT	P ER S IH P IY AH N T
PERCIPIENT(2)	P ER S IH P Y AH N T
PERCIPIENTLY	P AH R S AH P IY N T L IY
PERCIPIENTS	P AH R S AH P IY N T S
PERIODICITIES	P IH R IY AH D IH S AH T IY Z
PERIODICITY	P IH R IY AH D IH S AH T IY
PERITHECIA	P AH R AH TH IY SH IY AH
PERITHECIAL	P AH R AH TH IY SH AH L
PERITHECIUM	P AH R AH TH IY S IY AH M
PERMANENCIES	P ER M AH N AH N S IY Z
PERNICIOUS	P ER N IH SH AH S
PERNICIOUSLY	P ER N IH SH AH S L IY
PERNICIOUSNESS	P ER N IH SH AH S N AH S
PERNICIOUSNESSES	P ER N IH SH AH S N AH S IH Z
PERSISTENCIES	P ER S IH S T AH N S IY Z
PERSPICACIOUS	P ER S P AH K EY SH AH S
PERSPICACIOUSLY	P ER S P AY S AH S IY AH S L IY
PERSPICACIOUSNESS	P ER S P AY S AH S IY AH S N AH S
PERSPICACIOUSNESSES	P ER S P AY S AH S IY AH S N AH S IH Z
PERSPICACITIES	P AH R S AH K AE S AH T AY Z
PERSPICACITY	P AH R S IH S AH S AH T IY
PERTINACIOUS	P ER T AH N AH S IY AH S
PERTINACIOUSLY	P ER T AH N AH S IY AH S L IY
PERTINACIOUSNESS	P ER T AH N AH S IY AH S N AH S
PERTINACIOUSNESSES	P ER T AH N AH S IY AH S N AH S IH Z
PERTINACITIES	P ER T IH N EY S AH T IY Z
PERTINACITY	P ER T IH N EY S AH T IY
PERTINENCIES	P ER T AH N AH N S IY Z
PESTICIDE	P EH S T AH S AY D
PESTICIDES	P EH S T AH S AY D Z
PETULANCIES	P EH CH AH L AH N S IY Z
PHALLICISM	F AE L AH S IH Z AH M
PHALLICISMS	F AE L AH S AH Z AH M Z
PHARMACIES	F AA R M AH S IY Z
PHARMACIST	F AA R M AH S IH S T
PHARMACISTS	F AA R M AH S IH S T S
PHENACITE	F EH N AH S AY T
PHENACITES	F EH N AH S AY T S
PHENETICIST	F EH N AH T IH S AH S T
PHENETICISTS	F AH N EH T AH S AH S T S
PHOCINE	F AH S AY N
PHONEMICIST	F OW N IY M IH K IH S T
PHONEMICISTS	F OW N IY M IH K IH S T S
PHONETICIAN	F AA N AH T IH S IY AH N
PHONETICIANS	F AA N AH T IH S IY AH N Z
PHOSPHORESCING	F AA S F AH R EH S IH NG
PHOTODISSOCIATE	F OW T OW D IH S OW SH AH T
PHOTODISSOCIATED	F OW T OW D IH S OW SH EY T IH D
PHOTODISSOCIATES	F OW T OW D IH S OW SH AH T S
PHOTODISSOCIATING	F OW T OW D IH S OW SH EY T IH NG
PHOTODISSOCIATION	F OW T OW D IH S OW SH EY SH AH N
PHOTODISSOCIATIONS	F OW T OW D IH S OW SH EY SH AH N Z
PHOTOEXCITATION	F OW T OW IH K S AY T EY SH AH N
PHOTOEXCITATIONS	F OW T OW IH K S AY T EY SH AH N Z
PHOTOEXCITED	F OW T OW IH K S AY T IH D
PHOTOREDUCING	F OW T OW R IH D UW S IH NG
PHOTOTOXICITIES	F OW T OW T AA K S IH K AH T IY Z
PHOTOTOXICITY	F OW T OW T AA K S IH K AH T IY
PHYSICIAN	F AH Z IH SH AH N
PHYSICIANS	F AH Z IH SH AH N Z
PHYSICIANS(2)	F IH Z IH SH AH N Z
PHYSICIST	F IH Z IH S IH S T
PHYSICISTS	F IH Z IH S IH S T S
PHYTOSOCIOLOGICAL	F IH T AH S AH S IY AA L AH JH IH S AH L
PHYTOSOCIOLOGIES	F AH T AH S AH S IY AA L AH JH AY Z
PHYTOSOCIOLOGY	F IH T AH S AH S IY AA L AH JH IY
PHYTOTOXICITIES	F IH T AH T AA K S IH S AH T AY Z
PHYTOTOXICITY	F IH T AH T AA K S IH S AH T IY
PICIFORM	P IH S AH F AH R M
PIECING	P IY S IH NG
PIECINGS	P IY S IH NG Z
PIERCING	P IH R S IH NG
PIERCINGLY	P IH ER S IH NG L IY
PIERCINGS	P IH ER S IH NG Z
PIEZOELECTRICITIES	P IY EY Z OW AH L EH K T R IH S AH T IY Z
PIEZOELECTRICITY	P IY EY Z OW AH L EH K T R IH S AH T IY
PIQUANCIES	P IY K AH N S IY Z
PIRACIES	P AY R AH S IY Z
PISCICULTURE	P IH S AH K AH L T Y AH R
PISCICULTURES	P IH S AH K AH L T Y AH R Z
PISCINA	P IH S AH N AH
PISCINAE	P IH S AH N IY
PISCINAL	P IH S AH N AH L
PISCINAS	P IH S AH N AH Z
PISCINE	P IH S AY N
PISCIVOROUS	P IH S IH V AH R AH S
PLACID	P L AE S AH D
PLACID(2)	P L AE S IH D
PLACIDITIES	P L AE S AH D AH T IY Z
PLACIDITY	P L AE S AH D AH T IY
PLACIDLY	P L AE S IH D L IY
PLACIDNESS	P L AE S AH D N AH S
PLACIDNESSES	P L AE S AH D N AH S IH Z
PLACING	P L EY S IH NG
PLANGENCIES	P L AE N JH EH N S AY Z
PLANTOCRACIES	P L AE N T AA K R AH S IY Z
PLASTICINE	P L AE S T IH S IY N
PLASTICINES	P L AE S T AH S AY N Z
PLASTICITIES	P L AE S T IH S AH T IY Z
PLASTICITY	P L AE S T IH S AH T IY
PLASTICIZATION	P L AE S T IH K AH Z EY SH AH N
PLASTICIZATIONS	P L AE S T IH K AH Z EY SH AH N Z
PLASTICIZE	P L AE S T IH K AY Z
PLASTICIZED	P L AE S T IH K AY Z D
PLASTICIZER	P L AE S T AH S AY Z ER
PLASTICIZERS	P L AE S T IH K AY Z ER Z
PLASTICIZES	P L AE S T IH K AY Z IH Z
PLASTICIZING	P L AE S T IH K AY Z IH NG
PLEBISCITARY	P L AH B IH S AH T EH R IY
PLEBISCITE	P L EH B AH S AY T
PLEBISCITE(2)	P L IY B IH S AY T
PLEBISCITES	P L EH B AH S AY T S
PLIANCIES	P L AY AH N S IY Z
PLUTOCRACIES	P L UW T AA K R AH S IY Z
PNEUMATICITIES	N Y UW M AH T IH S AH T AY Z
PNEUMATICITY	N Y UW M AH T IH S AH T IY
PNEUMOCOCCI	N Y UW M AH K AA K S IY
POETICISM	P OW EH T IH K IH Z AH M
POETICISMS	P OW EH T IH K IH Z AH M Z
POETICIZE	P OW EH T IH K AY Z
POETICIZED	P OW EH T IH K AY Z D
POETICIZES	P OW EH T IH K AY Z IH Z
POETICIZING	P OW EH T IH K AY Z IH NG
POIGNANCIES	P OY N Y AH N S IY Z
POINCIANA	P OY N S IY AH N AH
POINCIANAS	P OY N S IY AH N AH Z
POLEMICIST	P AH L EH M AH S AH S T
POLEMICISTS	P AH L EH M IH K IH S T S
POLEMICIZE	P AH L EH M IH K AY Z
POLEMICIZED	P AH L EH M IH K AY Z D
POLEMICIZES	P AH L EH M IH K AY Z IH Z
POLEMICIZING	P AH L EH M IH K AY Z IH NG
POLICIES	P AA L AH S IY Z
POLICING	P AH L IY S IH NG
POLITICIAN	P AA L AH T IH SH AH N
POLITICIANS	P AA L AH T IH SH AH N Z
POLITICISE	P AH L IH T AH S AY Z
POLITICISED	P AA L AH T IH K IY Z D
POLITICISES	P AA L AH T IH K IY Z IH Z
POLITICISING	P AA L AH T IH K IY Z IH NG
POLITICIZATION	P AH L IH T AH S AH Z EY SH AH N
POLITICIZATIONS	P AA L AH T IH K AH Z EY SH AH N Z
POLITICIZE	P AH L IH T IH S AY Z
POLITICIZED	P AH L IH T IH S AY Z D
POLITICIZES	P AA L AH T IH K AY Z IH Z
POLITICIZING	P AH L IH T IH S AY Z IH NG
POLYCISTRONIC	P AA L AH S IH S T R AH N AH K
PONCING	P AA N S AH NG
PORCINE	P AO R S AY N
PORCINI	P AO R S AH N IY
PORCINO	P AO R S AH N OW
POSTACCIDENT	P OW S T AE K S AH D AH N T
POSTEXERCISE	P OW S T EH K S ER S AY Z
POSTGLACIAL	P OW S T G L EY SH AH L
POSTSYNCING	P AA S T S IH N S AH NG
POSTULANCIES	P AA S CH AH L AH N S IY Z
POSTVACCINAL	P OW S T V AE K S IY N AH L
POSTVACCINATION	P OW S T V AE K S AH N EY SH AH N
POTENCIES	P OW T AH N S IY Z
POULTICING	P OW L T AH S IH NG
POUNCING	P AW N S IH NG
PRACTICING	P R AE K T IH S IH NG
PRAECIPE	P R IY S AY P
PRAECIPES	P R IY S AY P S
PRAGMATICISM	P R AE G M AE T IH K IH Z AH M
PRAGMATICISMS	P R AE G M AE T IH K IH Z AH M Z
PRAGMATICIST	P R AE G M AE T IH K IH S T
PRAGMATICISTS	P R AE G M AE T IH K IH S T S
PRANCING	P R AE N S IH NG
PREANNOUNCING	P R IY AH N AW N S IH NG
PRECEDENCIES	P R EH S AH D AH N S IY Z
PRECIEUSE	P R IY S Y UW Z
PRECIEUX	P R IY S Y UW K S
PRECINCT	P R IY S IH NG K T
PRECINCT(2)	P R IY S IH NG K
PRECINCTS	P R IY S IH NG K T S
PRECINCTS(2)	P R IY S IH NG K S
PRECIOSITIES	P R IY S AY AA S AH T AY Z
PRECIOSITY	P R IY S AY AA Z AH T IY
PRECIOUS	P R EH SH AH S
PRECIOUSES	P R EH SH AH S IH Z
PRECIOUSLY	P R EH SH AH S L IY
PRECIOUSNESS	P R EH SH AH S N AH S
PRECIOUSNESSES	P R EH SH AH S N AH S IH Z
PRECIPE	P R IY S AY P
PRECIPES	P R IY S AY P S
PRECIPICE	P R EH S IH P AH S
PRECIPICES	P R EH S AH P AH S IH Z
PRECIPITABLE	P R IY S AH P IH T AH B AH L
PRECIPITANCE	P R IY S IH P AH T AH N S
PRECIPITANCES	P R IY S IH P AH T AE N S AH Z
PRECIPITANCIES	P R IY S AH P AH T AE N S AY Z
PRECIPITANCY	P R IY S IH P AH T AE N S IY
PRECIPITANT	P R IY S IH P AH T AH N T
PRECIPITANTLY	P R IY S IH P AH T AE N T L IY
PRECIPITANTNESS	P R IY S IH P AH T AE N T N AH S
PRECIPITANTNESSES	P R IY S IH P AH T AE N T N EH S AH Z
PRECIPITANTS	P R IY S IH P AH T AH N T S
PRECIPITATE	P R IH S IH P IH T EY T
PRECIPITATED	P R IH S IH P IH T EY T IH D
PRECIPITATELY	P R IH S IH P AH T EY T L IY
PRECIPITATENESS	P R IH S IH P AH T EY T N AH S
PRECIPITATENESSES	P R IH S IH P AH T EY T N AH S IH Z
PRECIPITATES	P R IH S IH P AH T EY T S
PRECIPITATING	P R IH S IH P AH T EY T IH NG
PRECIPITATION	P R IH S IH P IH T EY SH AH N
PRECIPITATIONS	P R IH S IH P AH T EY SH AH N Z
PRECIPITATIVE	P R IH S IH P AH T EY T IH V
PRECIPITATOR	P R IH S IH P AH T EY T ER
PRECIPITATORS	P R IH S IH P AH T EY T ER Z
PRECIPITIN	P R IH S IH P AH T AH N
PRECIPITINOGEN	P R IY S AH P AH T IH N AH JH AH N
PRECIPITINOGENS	P R IY S IH P AH T IH N AH JH AH N Z
PRECIPITINS	P R IH S IH P AH T AH N Z
PRECIPITOUS	P R IH S IH P IH T AH S
PRECIPITOUSLY	P R IY S IH P IH T AH S L IY
PRECIPITOUSNESS	P R IY S IH P AH T AW Z N AH S
PRECIPITOUSNESSES	P R IY S IH P AH T AW Z N EH S AH Z
PRECIS	P R EY S IY
PRECISE	P R IH S AY S
PRECISE(2)	P R IY S AY S
PRECISED	P R IH S AY S T
PRECISELY	P R IH S AY S L IY
PRECISELY(2)	P R IY S AY S L IY
PRECISENESS	P R IH S AY S N AH S
PRECISENESSES	P R IH S AY S N AH S IH Z
PRECISER	P R IH S AY S ER
PRECISES	P R IH S AY S IH Z
PRECISEST	P R IH S AY S AH S T
PRECISIAN	P R IY S AH S IY AH N
PRECISIANS	P R IY S IH S IY AH N Z
PRECISING	P R IH S AY S IH NG
PRECISION	P R IY S IH ZH AH N
PRECISIONIST	P R IH S AY ZH AH N IH S T
PRECISIONISTS	P R IH S AY ZH AH N IH S T S
PRECISIONS	P R IH S AY ZH AH N Z
PRECITED	P R IY S AY T IH D
PRECOCIAL	P R IY K OW SH AH L
PRECOCIOUS	P R IH K OW SH AH S
PRECOCIOUS(2)	P R IY K OW SH AH S
PRECOCIOUSLY	P R IH K OW SH AH S L IY
PRECOCIOUSNESS	P R IH K OW SH AH S N AH S
PRECOCIOUSNESSES	P R IH K OW SH AH S N AH S IH Z
PRECOCITIES	P R IH K AA S AH T IY Z
PRECOCITY	P R IH K AA S AH T IY
PRECONSCIOUS	P R IY K AA N SH AH S
PRECONSCIOUSES	P R IY K AA N SH AH S IH Z
PRECONSCIOUSLY	P R IY K AA N SH AH S L IY
PREDACIOUS	P R IY D AH S IY AH S
PREDACITIES	P R IY D AE S AH T AY Z
PREDACITY	P R IY D AH S AH T IY
PREDOMINANCIES	P R IY D AA M AH N AH N S IY Z
PREFACING	P R EH F AH S IH NG
PREFASCIST	P R IY F AE SH AH S T
PREFASCISTS	P R IY F AE SH AH S T S
PREFINANCING	P R IY F AH N AE N S IH NG
PREGNANCIES	P R EH G N AH N S IY Z
PREJUDICIAL	P R EH JH AH D IH SH AH L
PREJUDICIALLY	P R EH JH AH D IH SH AH L IY
PREJUDICIALNESS	P R EH JH AH D IH SH AH L N AH S
PREJUDICIALNESSES	P R EH JH AH D IH SH AH L N AH S IH Z
PREJUDICING	P R EH JH AH D IH S IH NG
PRELACIES	P R IY L EY S IY Z
PRENTICING	P R EH N T AH S IH NG
PREOCCUPANCIES	P R IY AA K Y AH P AH N S IY Z
PREPLACING	P R IY P L EY S IH NG
PREPONDERANCIES	P R IY P AA N D ER AH N S IY Z
PREPOTENCIES	P R IY P OW T AH N S IY Z
PREPRICING	P R IY P R AY S IH NG
PRESCIENCE	P R IY SH IY AH N S
PRESCIENCES	P R IY S AY AH N S IH Z
PRESCIENT	P R EH S IY AH N T
PRESCIENTIFIC	P R IY S AY AH N T IH F IH K
PRESCIENTLY	P R IY S AY AH N T L IY
PRESCIND	P R IY S AY N D
PRESCINDED	P R IY S AY N D AH D
PRESCINDING	P R IY S AY N D AH NG
PRESCINDS	P R IY S AY N D Z
PRESENTENCING	P R IY S EH N T AH N S IH NG
PRESENTENCINGS	P R IY S EH N T AH N S IH NG Z
PRESIDENCIES	P R EH Z IH D AH N S IY Z
PRESLICING	P R IY S L AY S IH NG
PRESPECIFIED	P R IY S P EH K AH F AY D
PRESPECIFIES	P R IY S P EH K AH F AY Z
PRESPECIFY	P R IY S P EH K AH F AY
PRESPECIFYING	P R IY S P EH K AH F AY IH NG
PRICIER	P R AY S IY ER
PRICIEST	P R AY S IY IH S T
PRICING	P R AY S IH NG
PRIMACIES	P R AY M AH S IY Z
PRINCIPAL	P R IH N S AH P AH L
PRINCIPALITIES	P R IH N S IH P AE L IH T IY Z
PRINCIPALITY	P R IH N S IH P AE L IH T IY
PRINCIPALLY	P R IH N S IH P L IY
PRINCIPALS	P R IH N S AH P AH L Z
PRINCIPALSHIP	P R IH N S AH P AH L SH IH P
PRINCIPALSHIPS	P R IH N S AH P AH L SH IH P S
PRINCIPE	P R IY N CH IY P IY
PRINCIPI	P R IH N S AH P IY
PRINCIPIA	P R IH N S IH P IY AH
PRINCIPIUM	P R IH N S IH P IY AH M
PRINCIPLE	P R IH N S AH P AH L
PRINCIPLED	P R IH N S AH P AH L D
PRINCIPLES	P R IH N S AH P AH L Z
PRIVACIES	P R AY V AH S IY Z
PROBENECID	P R AA B EH N AH S IH D
PROBENECIDS	P R OW B AH N EH S AH D Z
PROBOSCIDEAN	P R OW B AA S AY D IY AH N
PROBOSCIDEANS	P R OW B AA S AH D IY N Z
PROBOSCIDES	P R OW B AA S AY D Z
PROBOSCIDIAN	P R OW B AA S IH D IY AH N
PROBOSCIDIANS	P R OW B AA S IH D IY AH N Z
PROBOSCIS	P R OW B AA S AH S
PROBOSCISES	P R OW B AA S AY Z AH Z
PRODUCIBLE	P R AH D UW S AH B AH L
PRODUCING	P R AH D UW S IH NG
PROFICIENCIES	P R AH F IH SH AH N S IY Z
PROFICIENCY	P R AH F IH SH AH N S IY
PROFICIENT	P R AA F IH SH AH N T
PROFICIENTLY	P R AH F IH SH AH N T L IY
PROFICIENTS	P R AH F IH SH AH N T S
PROFLIGACIES	P R OW F L IH G AH S AY Z
PROLIFICACIES	P R AH L IH F IH K AH S IY Z
PROLIFICITIES	P R AH L IH F IH K AH T IY Z
PROLIFICITY	P R AH L IH F IH K AH T IY
PRONOUNCING	P R AH N AW N S IH NG
PRONUNCIAMENTO	P R OW N AH N S IY AH M EH N T OW
PRONUNCIAMENTOES	P R OW N AH N S IY AH M EH N T OW Z
PRONUNCIAMENTOS	P R OW N AH N S IY AH M EH N T AH Z
PRONUNCIATION	P R OW N AH N S IY EY SH AH N
PRONUNCIATION(2)	P R AH N AH N S IY EY SH AH N
PRONUNCIATIONAL	P R AH Z N AH N S IY EY SH AH N AH L
PRONUNCIATIONS	P R OW N AH N S IY EY SH AH N Z
PRONUNCIATIONS(2)	P R AH N AH N S IY EY SH AH N Z
PROPHECIES	P R AA F AH S IY Z
PROSCIUTTI	P R OW S AY AH T IY
PROSCIUTTO	P R OW S AY AH T OW
PROSCIUTTOS	P R OW S AY AH T AH Z
PROTHORACIC	P R OW TH AO R AH S AH K
PROVINCIAL	P R AH V IH N SH AH L
PROVINCIALISM	P R AH V IH N SH AH L IH Z AH M
PROVINCIALISMS	P R AH V IH N CH AH L IH Z AH M Z
PROVINCIALIST	P R AH V IH N CH AH L IH S T
PROVINCIALISTS	P R AH V IH N CH AH L IH S T S
PROVINCIALITIES	P R AH V IH N CH AH L AH T IY Z
PROVINCIALITY	P R AH V IH N CH AH L AH T IY
PROVINCIALIZATION	P R AH V IH N CH AH L AH Z EY SH AH N
PROVINCIALIZATIONS	P R AH V IH N CH AH L AH Z EY SH AH N Z
PROVINCIALIZE	P R AH V IH N CH AH L AY Z
PROVINCIALIZED	P R AH V IH N CH AH L AY Z D
PROVINCIALIZES	P R AH V IH N CH AH L AY Z IH Z
PROVINCIALIZING	P R AH V IH N CH AH L AY Z IH NG
PROVINCIALLY	P R AH V IH N SH AH L IY
PROVINCIALS	P R AH V IH N CH AH L Z
PRURIENCIES	P R UH R IY AH N S IY Z
PSEUDOCLASSICISM	S UW D OW K L AE S IH K S IH Z AH M
PSEUDOCLASSICISMS	S UW D OW K L AE S IH K S IH Z AH M Z
PSEUDOPREGNANCIES	S UW D OW P R EH G N AH N S IY Z
PSEUDOSCIENCE	S UW D OW S AY AH N S
PSEUDOSCIENCES	S UW D OW S AY AH N S IH Z
PSEUDOSCIENTIFIC	S UW D OW S AY AH N T IH F IH K
PSEUDOSCIENTIST	S UW D OW S AY AH N T IH S T
PSEUDOSCIENTISTS	S UW D OW S AY AH N T IH S T S
PSILOCIN	S IH L AH S AH N
PSILOCINS	S IH L AH S AH N Z
PSITTACINE	S IH T AH S AY N
PSITTACINES	S IH T AH S AY N Z
PSOCID	S AA S AH D
PSOCIDS	S AA S AH D Z
PSYCHOMETRICIAN	S AY K AH M EH T R IH S IY AH N
PSYCHOMETRICIANS	S AY K AH M EH T R IH S IY AH N Z
PSYCHOPHYSICIST	S AY K OW F IH Z AH S AH S T
PSYCHOPHYSICISTS	S AY K OW F IH Z AH S AH S T S
PSYCHOSOCIAL	S AY K OW S OW SH AH L
PSYCHOSOCIALLY	S AY K OW S OW SH AH L IY
PUBLICISE	P AH B L AH S AY Z
PUBLICISED	P AH B L IH K IY Z D
PUBLICISES	P AH B L IH K IY Z IH Z
PUBLICISING	P AH B L IH K IY Z IH NG
PUBLICIST	P AH B L IH S IH S T
PUBLICISTS	P AH B L IH S IH S T S
PUBLICITIES	P AH B L IH S AH T IY Z
PUBLICITY	P AH B L IH S AH T IY
PUBLICITY(2)	P AH B L IH S IH T IY
PUBLICIZE	P AH B L IH S AY Z
PUBLICIZED	P AH B L IH S AY Z D
PUBLICIZES	P AH B L AH S AY Z IH Z
PUBLICIZING	P AH B L AH S AY Z IH NG
PUDENCIES	P Y UW D EH N S AY Z
PUGNACIOUS	P AH G N AE SH IH S
PUGNACIOUSLY	P AH G N AH S IY OW AH S L IY
PUGNACIOUSNESS	P AH G N EY S IY AW Z N AH S
PUGNACIOUSNESSES	P AH G N EY S IY AW Z N EH S AH Z
PUGNACITIES	P AH G N AE S AH T AY Z
PUGNACITY	P AH G N AH S AH T IY
PULICIDE	P Y UW L AH S AY D
PULICIDES	P Y UW L AH S AY D Z
PUMICING	P Y UW M IH S AH NG
PUMICITE	P Y UW M AH S AY T
PUMICITES	P Y UW M AH S AY T S
PUNGENCIES	P AH N JH AH N S IY Z
PUROMYCIN	P Y AH R AA M AH S AH N
PUROMYCINS	P Y AH R AA M AH S AH N Z
PUTRESCIBLE	P AH T R EH S AH B AH L
PUTRESCINE	P AH T R AH S AY N
PUTRESCINES	P AH T R AH S AY N Z
PYROELECTRICITIES	P AH R OW AH L EH K T R IH S AH T AY Z
PYROELECTRICITY	P AH R OW AH L EH K T R IH S AH T IY
PYROGENICITIES	P IH R AH JH AH N IH S AH T AY Z
PYROGENICITY	P AH R AA JH AH N IH S AH T IY
PYROMANCIES	P IH R AH M AE N S AY Z
QUADRUPLICITIES	K W AA D R UW P AH L IH K S AH T IY Z
QUADRUPLICITY	K W AA D R UW P AH L IH K S AH T IY
QUASIPERIODICITIES	K W AH S AH P IY R IY AH D IH S AH T AY Z
QUASIPERIODICITY	K W AA S AH P AH R IY AH D IH S AH T IY
QUATTUORDECILLION	K W AA T Y UW AO R D AH S IH L IY AH N
QUATTUORDECILLIONS	K W AA T Y UW AO R D AH S IH L IY AH N Z
QUERCINE	K W AH R S AY N
QUERCITRON	K W AH R S IH T R AH N
JAUK	JH AO K
KUCHEN	K AH CH AH N
OBOIST	OW B OW AH S T
JIAO	JH AY AH OW
CEANOTHUS	S IY N AH TH AH S
LO	L OW
LO	L OW
