CK	S IY K
ABACK	AH B AE K
ACKEE	AE K IY IY
ACKEES	AE K IY Z
ACKNOWLEDGE	AE K N AA L IH JH
ACKNOWLEDGED	AE K N AA L IH JH D
ACKNOWLEDGEDLY	AE K N AA L IH JH AH D L IY
ACKNOWLEDGEMENT	AE K N AA L IH JH M AH N T
ACKNOWLEDGEMENTS	AE K N AA L IH JH M AH N T S
ACKNOWLEDGES	AE K N AA L IH JH IH Z
ACKNOWLEDGING	AE K N AA L IH JH IH NG
ACKNOWLEDGMENT	AE K N AA L IH JH M AH N T
ACKNOWLEDGMENTS	AE K N AA L IH JH M AH N T S
ACOCK	AH K AA K
AFTERDECK	AE F T ER D EH K
AFTERDECKS	AE F T ER D EH K S
AFTERSHOCK	AE F T ER SH AA K
AFTERSHOCKS	AE F T ER SH AA K S
AIRCHECK	AH IH R CH EH K
AIRCHECKS	AH IH R CH EH K S
AIRSICK	AH IH R S IH K
AIRSICKNESS	AH IH R S IH K N AH S
AIRSICKNESSES	AH IH R S IH K N AH S IH Z
ALACK	AH L AE K
ALPENSTOCK	AE L P AH N S T AA K
ALPENSTOCKS	AE L P AH N S T AA K S
AMBERJACK	AE M B ER JH AE K
AMBERJACKS	AE M B ER JH AE K S
AMTRACK	AE M T R AE K
AMTRACKS	AE M T R AH K S
AMUCK	AH M AH K
AMUCKS	AH M AH K S
ANTIBACKLASH	AE N T AY B AE K L AE SH
ANTIBLACK	AE N T AY B L AE K
ANTIBLACKISM	AE N T AY B L AE K IH Z AH M
ANTIBLACKISMS	AE N T AY B L AE K IH Z AH M Z
ANTICK	AE N T AH K
ANTICKED	AE N T IH K T
ANTICKING	AE N T IH K IH NG
ANTICKS	AE N T AH K S
ANTICLOCKWISE	AE N T AY K L AA K W AY Z
ANTICRACK	AE N T AY K R AE K
ANTIHIJACK	AE N T AY HH AY JH AE K
ANTIKICKBACK	AE N T AY K IH K B AE K
ANTIKNOCK	AE N T IY N AA K
ANTIKNOCKS	AE N T AY N AA K S
ANTILOCK	AE N T IY L AA K
ANTILOCK(2)	AE N T AY L AA K
ANTIRACKETEERING	AE N T AY R AE K AH T IH R IH NG
ANTIROCK	AE N T AY R AA K
ANTISHOCK	AE N T AY SH AA K
ANTISTICK	AE N T AY S T IH K
APPLEJACK	AE P AH L JH AE K
APPLEJACKS	AE P AH L JH AE K S
ARCKED	AA R K T
ARCKING	AA R K IH NG
ARMLOCK	AA R M L AA K
ARMLOCKS	AA R M L AA K S
ARRACK	AH R AE K
ARRACKS	AH R AE K S
ATTACK	AH T AE K
ATTACKED	AH T AE K T
ATTACKER	AH T AE K ER
ATTACKERS	AH T AE K ER Z
ATTACKING	AH T AE K IH NG
ATTACKMAN	AH T AE K M AE N
ATTACKMEN	AH T AE K M EH N
ATTACKS	AH T AE K S
AWESTRICKEN	AO S T R IH K AH N
AWESTRUCK	AA S T R AH K
BACK	B AE K
BACKACHE	B AE K EY K
BACKACHES	B AE K EY K S
BACKBEAT	B AE K B IY T
BACKBEATS	B AE K B IY T S
BACKBENCH	B AE K B EH N CH
BACKBENCHER	B AE K B EH N CH ER
BACKBENCHERS	B AE K B EH N CH ER Z
BACKBENCHES	B AE K B EH N CH IH Z
BACKBEND	B AE K B EH N D
BACKBENDS	B AE K B EH N D Z
BACKBIT	B AE K B IH T
BACKBITE	B AE K B AY T
BACKBITER	B AE K B AY T ER
BACKBITERS	B AE K B AY T ER Z
BACKBITES	B AE K B AY T S
BACKBITING	B AE K B AY T IH NG
BACKBITINGS	B AE K B AY T IH NG Z
BACKBITTEN	B AE K B IH T AH N
BACKBLOCK	B AE K B L AA K
BACKBLOCKS	B AE K B L AA K S
BACKBOARD	B AE K B AO R D
BACKBOARDS	B AE K B AO R D Z
BACKBONE	B AE K B OW N
BACKBONES	B AE K B OW N Z
BACKBREAKER	B AE K B R EY K ER
BACKBREAKERS	B AE K B R EY K ER Z
BACKBREAKING	B AE K B R EY K IH NG
BACKCAST	B AE K AE S T
BACKCASTS	B AE K AE S T S
BACKCHAT	B AE K CH AE T
BACKCHATS	B AE K CH AE T S
BACKCLOTH	B AE K L AO TH
BACKCLOTHS	B AE K L AO TH S
BACKCOUNTRIES	B AE K AH N T R IY Z
BACKCOUNTRY	B AE K AH N T R IY
BACKCOURT	B AE K OW R T
BACKCOURTMAN	B AE K OW R T M AE N
BACKCOURTMEN	B AE K OW R T M EH N
BACKCOURTS	B AE K OW R T S
BACKCROSS	B AE K R AO S
BACKCROSSED	B AE K R AO S T
BACKCROSSES	B AE K R AO S IH Z
BACKCROSSING	B AE K R AO S IH NG
BACKDATE	B AE K D EY T
BACKDATED	B AE K D EY T IH D
BACKDATES	B AE K D EY T S
BACKDATING	B AE K D EY T IH NG
BACKDOOR	B AE K D AO R
BACKDROP	B AE K D R AA P
BACKDROPPED	B AE K D R AA P T
BACKDROPPING	B AE K D R AA P IH NG
BACKDROPS	B AE K D R AA P S
BACKDROPT	B AE K D R AH P T
BACKED	B AE K T
BACKER	B AE K ER
BACKERS	B AE K ER Z
BACKFIELD	B AE K F IY L D
BACKFIELDS	B AE K F IY L D Z
BACKFILL	B AE K F IH L
BACKFILLED	B AE K F IH L D
BACKFILLING	B AE K F IH L IH NG
BACKFILLS	B AE K F IH L Z
BACKFIRE	B AE K F AY R
BACKFIRED	B AE K F AY ER D
BACKFIRES	B AE K F AY ER Z
BACKFIRING	B AE K F AY ER IH NG
BACKFIT	B AE K F IH T
BACKFITS	B AE K F IH T S
BACKFITTED	B AE K F IH T IH D
BACKFITTING	B AE K F IH T IH NG
BACKFLOW	B AE K F L OW
BACKFLOWS	B AE K F L OW Z
BACKGAMMON	B AE K G AE M AH N
BACKGAMMONS	B AE K G AE M AH N Z
BACKGROUND	B AE K G R AW N D
BACKGROUNDED	B AE K G R AW N D IH D
BACKGROUNDER	B AE K G R AW N D ER
BACKGROUNDERS	B AE K G R AW N D ER Z
BACKGROUNDING	B AE K G R AW N D IH NG
BACKGROUNDS	B AE K G R AW N D Z
BACKHAND	B AE K HH AE N D
BACKHANDED	B AE K HH AE N D IH D
BACKHANDEDLY	B AE K HH AE N D AH D L IY
BACKHANDER	B AE K HH AE N D ER
BACKHANDERS	B AE K HH AE N D ER Z
BACKHANDING	B AE K HH AE N D IH NG
BACKHANDS	B AE K HH AE N D Z
BACKHAUL	B AE K HH AO L
BACKHAULED	B AE K HH AO L D
BACKHAULING	B AE K HH AO L IH NG
BACKHAULS	B AE K HH AO L Z
BACKHOE	B AE K HH OW
BACKHOES	B AE K HH OW Z
BACKHOUSE	B AE K HH AW S
BACKHOUSES	B AE K HH AW S IH Z
BACKING	B AE K IH NG
BACKINGS	B AE K IH NG Z
BACKLAND	B AE K L AE N D
BACKLANDS	B AE K L AE N D Z
BACKLASH	B AE K L AE SH
BACKLASHED	B AE K L AE SH T
BACKLASHER	B AE K L AE SH ER
BACKLASHERS	B AE K L AE SH ER Z
BACKLASHES	B AE K L AE SH AH Z
BACKLASHING	B AE K L AE SH IH NG
BACKLESS	B AE K L AH S
BACKLIGHT	B AE K L AY T
BACKLIGHTED	B AE K L AY T IH D
BACKLIGHTING	B AE K L AY T IH NG
BACKLIGHTS	B AE K L AY T S
BACKLIST	B AE K L IH S T
BACKLISTED	B AE K L IH S T AH D
BACKLISTING	B AE K L IH S T IH NG
BACKLISTS	B AE K L IH S T S
BACKLIT	B AE K L IH T
BACKLOG	B AE K L AA G
BACKLOG(2)	B AE K L AO G
BACKLOGGED	B AE K L AA G D
BACKLOGGING	B AE K L AA G IH NG
BACKLOGS	B AE K L AO G Z
BACKMOST	B AE K M OW S T
BACKOUT	B AE K AW T
BACKOUTS	B AE K AW T S
BACKPACK	B AE K P AE K
BACKPACKED	B AE K P AE K T
BACKPACKER	B AE K P AE K ER
BACKPACKERS	B AE K P AE S ER Z
BACKPACKING	B AE K P AE K IH NG
BACKPACKS	B AE K P AE K S
BACKPEDAL	B AE K P EH D AH L
BACKPEDALED	B AE K P EH D AH L D
BACKPEDALING	B AE K P EH D AH L IH NG
BACKPEDALING(2)	B AE K P EH D L IH NG
BACKPEDALLED	B AE K P EH D AH L D
BACKPEDALLING	B AE K P EH D AH L IH NG
BACKPEDALS	B AE K P EH D AH L Z
BACKREST	B AE K R EH S T
BACKRESTS	B AE K R EH S T S
BACKROOM	B AE K R UW M
BACKROOMS	B AE K R UW M Z
BACKRUSH	B AE K R AH SH
BACKRUSHES	B AE K R AH SH IH Z
BACKS	B AE K S
BACKSAW	B AE K S AA
BACKSAW(2)	B AE K S AO
BACKSAWS	B AE K S AA Z
BACKSAWS(2)	B AE K S AO Z
BACKSCATTER	B AE K S K AE T ER
BACKSCATTERED	B AE K S K AE T ER D
BACKSCATTERING	B AE K S K AE T ER IH NG
BACKSCATTERINGS	B AE K S K AE T ER IH NG Z
BACKSCATTERS	B AE K S K AE T ER Z
BACKSEAT	B AE K S IY T
BACKSEATS	B AE K S IY T S
BACKSET	B AE K S EH T
BACKSETS	B AE K S EH T S
BACKSIDE	B AE K S AY D
BACKSIDES	B AE K S AY D Z
BACKSLAP	B AE K S L AE P
BACKSLAPPED	B AE K S L AE P T
BACKSLAPPER	B AE K S L AE P ER
BACKSLAPPERS	B AE K S L AE P ER Z
BACKSLAPPING	B AE K S L AE P IH NG
BACKSLAPS	B AE K S L AE P S
BACKSLASH	B AE K S L AE SH
BACKSLASHES	B AE K S L AE SH AH Z
BACKSLID	B AE K S L IH D
BACKSLIDDEN	B AE K S L IH D AH N
BACKSLIDE	B AE K S L AY D
BACKSLIDER	B AE K S L AY D ER
BACKSLIDERS	B AE K S L AY D ER Z
BACKSLIDES	B AE K S L AY D Z
BACKSLIDING	B AE K S L AY D IH NG
BACKSPACE	B AE K S P EY S
BACKSPACED	B AE K S P EY S T
BACKSPACES	B AE K S P EY S IH Z
BACKSPACING	B AE K S P EY S IH NG
BACKSPIN	B AE K S P IH N
BACKSPINS	B AE K S P IH N Z
BACKSPLASH	B AE K S P L AE SH
BACKSPLASHES	B AE K S P L AE SH IH Z
BACKSTAB	B AE K S T AE B
BACKSTABBED	B AE K S T AE B D
BACKSTABBER	B AE K S T AE B ER
BACKSTABBERS	B AE K S T AE B ER Z
BACKSTABBING	B AE K S T AE B IH NG
BACKSTABBINGS	B AE K S T AE B IH NG Z
BACKSTABS	B AE K S T AE B Z
BACKSTAGE	B AE K S T EY JH
BACKSTAIRS	B AE K S T EH R Z
BACKSTAY	B AE K S T EY
BACKSTAYS	B AE K S T EY Z
BACKSTITCH	B AE K S T IH CH
BACKSTITCHED	B AE K S T IH CH T
BACKSTITCHES	B AE K S T IH CH AH Z
BACKSTITCHING	B AE K S T IH CH IH NG
BACKSTOP	B AE K S T AA P
BACKSTOPPED	B AE K S T AA P T
BACKSTOPPING	B AE K S T AA P IH NG
BACKSTOPS	B AE K S T AA P S
BACKSTREET	B AE K S T R IY T
BACKSTREETS	B AE K S T R IY T S
BACKSTRETCH	B AE K S T R EH CH
BACKSTRETCHES	B AE K S T R EH CH IH Z
BACKSTROKE	B AE K S T R OW K
BACKSTROKES	B AE K S T R OW K S
BACKSWEPT	B AE K S W EH P T
BACKSWING	B AE K S W IH NG
BACKSWINGS	B AE K S W IH NG Z
BACKSWORD	B AE K S OW R D
BACKSWORDS	B AE K S OW R D Z
BACKTALK	B AE K T AO K
BACKTALKS	B AE K T AO K S
BACKTRACK	B AE K T R AE K
BACKTRACKED	B AE K T R AE K T
BACKTRACKING	B AE K T R AE K IH NG
BACKTRACKS	B AE K T R AE K S
BACKUP	B AE K AH P
BACKUPS	B AE K AH P S
BACKWARD	B AE K W ER D
BACKWARDLY	B AE K W ER D L IY
BACKWARDNESS	B AE K W ER D N AH S
BACKWARDNESSES	B AE K W ER D N AH S IH Z
BACKWARDS	B AE K W ER D Z
BACKWASH	B AE K W AA SH
BACKWASHED	B AE K W AA SH T
BACKWASHES	B AE K W AA SH IH Z
BACKWASHING	B AE K W AA SH IH NG
BACKWATER	B AE K W AO T ER
BACKWATERS	B AE K W AO T ER Z
BACKWOOD	B AE K W UH D
BACKWOODS	B AE K W UH D Z
BACKWOODSMAN	B AE K W UH D Z M AH N
BACKWOODSMEN	B AE K W UH D Z M EH N
BACKWOODSY	B AE K W UH D Z IY
BACKWRAP	B AE K R AE P
BACKWRAPS	B AE K R AE P S
BACKYARD	B AE K Y AA R D
BACKYARDS	B AE K Y AA R D Z
BAILIWICK	B EY L IH W IH K
BAILIWICKS	B EY L AH W AH K S
BALDRICK	B AE L D R AH K
BALDRICKS	B AE L D R AH K S
BANNOCK	B AE N AH K
BANNOCKS	B AE N AH K S
BAREBACK	B EH R B AE K
BAREBACKED	B EH R B AE K T
BARRACK	B AE R AH K
BARRACK(2)	B EH R AH K
BARRACKED	B AE R AH K T
BARRACKER	B AE R AH K ER
BARRACKERS	B AE R AH K ER Z
BARRACKING	B AE R AH K IH NG
BARRACKS	B AE R AH K S
BARRACKS(2)	B EH R AH K S
BAWCOCK	B AO K AH K
BAWCOCKS	B AO K AH K S
BECK	B EH K
BECKED	B EH K T
BECKET	B EH K AH T
BECKETS	B EH K AH T S
BECKING	B EH K IH NG
BECKON	B EH K AH N
BECKONED	B EH K AH N D
BECKONER	B EH K AH N ER
BECKONERS	B EH K AH N ER Z
BECKONING	B EH K AH N IH NG
BECKONS	B EH K AH N Z
BECKS	B EH K S
BEDECK	B IH D EH K
BEDECKED	B IH D EH K T
BEDECKING	B IH D EH K IH NG
BEDECKS	B IH D EH K S
BEDROCK	B EH D R AA K
BEDROCKS	B EH D R AA K S
BEDTICK	B EH D T IH K
BEDTICKS	B EH D T IH K S
BEFLECK	B IH F L EH K
BEFLECKED	B IH F L EH K T
BEFLECKING	B IH F L EH K IH NG
BEFLECKS	B IH F L EH K S
BELOWDECKS	B IH L OW D EH K S
BEMOCK	B IH M AA K
BEMOCKED	B IH M AA K T
BEMOCKING	B IH M AA K IH NG
BEMOCKS	B IH M AA K S
BENEDICK	B EH N AH D IH K
BENEDICKS	B AH N EH D AH K S
BIBCOCK	B IH B K AA K
BIBCOCKS	B IH B K AA K S
BICKER	B IH K ER
BICKERED	B IH K ER D
BICKERER	B IH K ER ER
BICKERERS	B IH K ER ER Z
BICKERING	B IH K ER IH NG
BICKERS	B IH K ER Z
BILLYCOCK	B IH L IY K AA K
BILLYCOCKS	B IH L IY K AA K S
BIOFEEDBACK	B AY OW F IY D B AE K
BIOFEEDBACKS	B AY AH F IY D AH K S
BIPACK	B AY P AE K
BIPACKS	B AY P AE K S
BITSTOCK	B IH T S T AA K
BITSTOCKS	B IH T S T AA K S
BITTOCK	B AY T AA K
BITTOCKS	B AY T AA K S
BIVOUACKED	B IH V AH W AE K T
BIVOUACKING	B IH V AH W AE K IH NG
BIVOUACKS	B AY V AW AH K S
BLACK	B L AE K
BLACKAMOOR	B L AE K AH M UH R
BLACKAMOORS	B L AE K AH M UH R Z
BLACKBALL	B L AE K B AO L
BLACKBALLED	B L AE K B AO L D
BLACKBALLING	B L AE K B AO L IH NG
BLACKBALLS	B L AE K B AO L Z
BLACKBERRIES	B L AE K B EH R IY Z
BLACKBERRY	B L AE K B EH R IY
BLACKBIRD	B L AE K B ER D
BLACKBIRDED	B L AE K B ER D IH D
BLACKBIRDER	B L AE K B ER D ER
BLACKBIRDERS	B L AE K B ER D ER Z
BLACKBIRDING	B L AE K B ER D IH NG
BLACKBIRDS	B L AE K B ER D Z
BLACKBOARD	B L AE K B AO R D
BLACKBOARDS	B L AE K B AO R D Z
BLACKBODIES	B L AE K B AA D IY Z
BLACKBODY	B L AE K B AA D IY
BLACKBOY	B L AE K B OY
BLACKBOYS	B L AE K B OY Z
BLACKCAP	B L AE K AE P
BLACKCAPS	B L AE K AE P S
BLACKCOCK	B L AE K AA K
BLACKCOCKS	B L AE K AA K S
BLACKED	B L AE K T
BLACKEN	B L AE K AH N
BLACKENED	B L AE K AH N D
BLACKENER	B L AE K AH N ER
BLACKENERS	B L AE K AH N ER Z
BLACKENING	B L AE K AH N IH NG
BLACKENING(2)	B L AE K N IH NG
BLACKENINGS	B L AE K AH N IH NG Z
BLACKENS	B L AE K AH N Z
BLACKER	B L AE K ER
BLACKEST	B L AE K AH S T
BLACKFACE	B L AE K F EY S
BLACKFACES	B L AE K F EY S IH Z
BLACKFIN	B L AE K F IH N
BLACKFINS	B L AE K F IH N Z
BLACKFISH	B L AE K F IH SH
BLACKFISHES	B L AE K F IH SH IH Z
BLACKFLIES	B L AE K F L AY Z
BLACKFLY	B L AE K F L AY
BLACKGUARD	B L AE K G AA R D
BLACKGUARDED	B L AE K G AA R D IH D
BLACKGUARDING	B L AE K G AA R D IH NG
BLACKGUARDISM	B L AE K G AA R D IH Z AH M
BLACKGUARDISMS	B L AE K G AA R D IH Z AH M Z
BLACKGUARDLY	B L AE K G AA R D L IY
BLACKGUARDS	B L AE K G AA R D Z
BLACKGUM	B L AE K G AH M
BLACKGUMS	B L AE K G AH M Z
BLACKHANDER	B L AE K HH AE N D ER
BLACKHANDERS	B L AE K HH AE N D ER Z
BLACKHEAD	B L AE K HH EH D
BLACKHEADS	B L AE K HH EH D Z
BLACKHEART	B L AE K HH AA R T
BLACKHEARTS	B L AE K HH AA R T S
BLACKING	B L AE K IH NG
BLACKINGS	B L AE K IH NG Z
BLACKISH	B L AE K IH SH
BLACKJACK	B L AE K JH AE K
BLACKJACKED	B L AE K JH AE K T
BLACKJACKING	B L AE K JH AE K IH NG
BLACKJACKS	B L AE K JH AE K S
BLACKLAND	B L AE K L AE N D
BLACKLANDS	B L AE K L AE N D Z
BLACKLEAD	B L AE K L IY D
BLACKLEADS	B L AE K L IY D Z
BLACKLEG	B L AE K L EH G
BLACKLEGS	B L AE K L EH G Z
BLACKLIST	B L AE K L IH S T
BLACKLISTED	B L AE K L IH S T IH D
BLACKLISTER	B L AE K L IY S T ER
BLACKLISTERS	B L AE K L IY S T ER Z
BLACKLISTING	B L AE K L IH S T IH NG
BLACKLISTS	B L AE K L IH S T S
BLACKLY	B L AE K L IY
BLACKMAIL	B L AE K M EY L
BLACKMAILED	B L AE K M EY L D
BLACKMAILER	B L AE K M EY L ER
BLACKMAILERS	B L AE K M EY L ER Z
BLACKMAILING	B L AE K M EY L IH NG
BLACKMAILS	B L AE K M EY L Z
BLACKNESS	B L AE K N AH S
BLACKNESSES	B L AE K N AH S IH Z
BLACKOUT	B L AE K AW T
BLACKOUTS	B L AE K AW T S
BLACKPOLL	B L AE K P OW L
BLACKPOLLS	B L AE K P OW L Z
BLACKS	B L AE K S
BLACKSMITH	B L AE K S M IH TH
BLACKSMITHING	B L AE K S M IH TH IH NG
BLACKSMITHINGS	B L AE K S M IH TH IH NG Z
BLACKSMITHS	B L AE K S M IH TH S
BLACKSNAKE	B L AE K S N EY K
BLACKSNAKES	B L AE K S N EY K S
BLACKTAIL	B L AE K T EY L
BLACKTAILS	B L AE K T EY L Z
BLACKTHORN	B L AE K TH AO R N
BLACKTHORNS	B L AE K TH AO R N Z
BLACKTOP	B L AE K T AA P
BLACKTOPPED	B L AE K T AA P T
BLACKTOPPING	B L AE K T AA P IH NG
BLACKTOPS	B L AE K T AA P S
BLACKWATER	B L AE K W AO T ER
BLACKWATERS	B L AE K W AO T ER Z
BLACKWOOD	B L AE K W UH D
BLACKWOODS	B L AE K W UH D Z
BLESBUCK	B L EH Z AH K
BLESBUCKS	B L EH Z AH K S
BLOCK	B L AA K
BLOCKADE	B L AA K EY D
BLOCKADED	B L AA K EY D IH D
BLOCKADER	B L AA K EY D ER
BLOCKADERS	B L AA K EY D ER Z
BLOCKADES	B L AA K EY D Z
BLOCKADING	B L AA K EY D IH NG
BLOCKAGE	B L AA K IH JH
BLOCKAGES	B L AA K IH JH IH Z
BLOCKBUSTER	B L AA K B AH S T ER
BLOCKBUSTERS	B L AA K B AH S T ER Z
BLOCKBUSTING	B L AA K B AH S T IH NG
BLOCKBUSTINGS	B L AA K B AH S T IH NG Z
BLOCKED	B L AA K T
BLOCKER	B L AA K ER
BLOCKERS	B L AA K ER Z
BLOCKHEAD	B L AA K HH EH D
BLOCKHEADS	B L AA K HH EH D Z
BLOCKHOUSE	B L AA K HH AW S
BLOCKHOUSES	B L AA K HH AW S AH Z
BLOCKIER	B L AA K IY ER
BLOCKIEST	B L AA K IY AH S T
BLOCKING	B L AA K IH NG
BLOCKISH	B L AA K IH SH
BLOCKS	B L AA K S
BLOCKY	B L AA K IY
BLOODSTOCK	B L AH D S T AA K
BLOODSTOCKS	B L AH D S T AA K S
BLOODSUCKER	B L AH D S AH K ER
BLOODSUCKERS	B L AH D S AH K ER Z
BLOODSUCKING	B L AH D S AH K IH NG
BLOWBACK	B L OW B AE K
BLOWBACKS	B L OW B AE K S
BLUEJACK	B L UW JH AE K
BLUEJACKET	B L UW JH AE K AH T
BLUEJACKETS	B L UW JH AE K AH T S
BLUEJACKS	B L UW JH AE K S
BLUESTOCKING	B L UW S T AA K IH NG
BLUESTOCKINGS	B L UW S T AA K IH NG Z
BLUETICK	B L UW T IH K
BLUETICKS	B L UW T IH K S
BOCK	B AA K
BOCKS	B AA K S
BODYCHECK	B AA D IY CH EH K
BODYCHECKED	B AA D IY CH EH K T
BODYCHECKING	B AA D IY CH EH K IH NG
BODYCHECKS	B AA D IY CH EH K S
BOLLOCKS	B AA L AH K S
BONNOCK	B AA N AH K
BONNOCKS	B AA N AH K S
BOOKRACK	B UH K R AE K
BOOKRACKS	B UH K R AE K S
BOONDOCK	B UW N D AA K
BOONDOCKS	B UW N D AA K S
BOOTBLACK	B UW T B L AE K
BOOTBLACKS	B UW T B L AE K S
BOOTJACK	B UW T JH AE K
BOOTJACKS	B UW T JH AE K S
BOOTLICK	B UW T L IH K
BOOTLICKED	B UW T L IH K T
BOOTLICKER	B UW T L IH K ER
BOOTLICKERS	B UW T L IH K ER Z
BOOTLICKING	B UW T L IH K IH NG
BOOTLICKS	B UW T L IH K S
BOTTLENECK	B AA T AH L N EH K
BOTTLENECKED	B AA T AH L N EH K T
BOTTLENECKING	B AA T AH L N EH K IH NG
BOTTLENECKS	B AA T AH L N EH K S
BOYCHICK	B OY CH IH K
BOYCHICKS	B OY CH IH K S
BRACKEN	B R AE K AH N
BRACKENS	B R AE K AH N Z
BRACKET	B R AE K IH T
BRACKETED	B R AE K AH T IH D
BRACKETING	B R AE K AH T IH NG
BRACKETS	B R AE K AH T S
BRACKETS(2)	B R AE K IH T S
BRACKISH	B R AE K IH SH
BRACKISHNESS	B R AE K IH SH N AH S
BRACKISHNESSES	B R AE K IH SH N AH S IH Z
BRAINSICK	B R EY N S IH K
BRAINSICKLY	B R EY N S IH K L IY
BREADSTICK	B R EH D S T IH K
BREADSTICKS	B R EH D S T IH K S
BREAKNECK	B R EY K N EH K
BREECHBLOCK	B R IY CH B L AA K
BREECHBLOCKS	B R IY CH B L AA K S
BRICK	B R IH K
BRICKBAT	B R IH K B AE T
BRICKBATS	B R IH K B AE T S
BRICKED	B R IH K T
BRICKFIELD	B R IH K F IY L D
BRICKFIELDS	B R IH K F IY L D Z
BRICKIER	B R IH K IY ER
BRICKIEST	B R IH K IY AH S T
BRICKING	B R IH K IH NG
BRICKLAYER	B R IH K L EY ER
BRICKLAYERS	B R IH K L EY ER Z
BRICKLAYING	B R IH K L EY IH NG
BRICKLAYINGS	B R IH K L EY IH NG Z
BRICKLE	B R IH K AH L
BRICKLES	B R IH K AH L Z
BRICKS	B R IH K S
BRICKWORK	B R IH K W ER K
BRICKWORKS	B R IH K W ER K S
BRICKY	B R IH K IY
BRICKYARD	B R IH K Y AA R D
BRICKYARDS	B R IH K Y AA R D Z
BROCK	B R AA K
BROCKAGE	B R AA K AH JH
BROCKAGES	B R AA K AH JH AH Z
BROCKET	B R AA K AH T
BROCKETS	B R AA K AH T S
BROCKS	B R AA K S
BROOMSTICK	B R UW M S T IH K
BROOMSTICKS	B R UW M S T IH K S
BRUSHBACK	B R AH SH B AE K
BRUSHBACKS	B R AH SH B AE K S
BUCK	B AH K
BUCKAROO	B AH K AH R UW
BUCKAROOS	B AH K AH R UW Z
BUCKAYRO	B AH K EY R OW
BUCKAYROS	B AH K EY R AH Z
BUCKBEAN	B AH K B IY N
BUCKBEANS	B AH K B IY N Z
BUCKBOARD	B AH K B OW R D
BUCKBOARDS	B AH K B OW R D Z
BUCKED	B AH K T
BUCKEEN	B AH K IY AH N
BUCKEENS	B AH K IY N Z
BUCKER	B AH K ER
BUCKEROO	B AH K AH R UW
BUCKEROOS	B AH K AH R UW Z
BUCKERS	B AH K ER Z
BUCKET	B AH K IH T
BUCKETED	B AH K AH T IH D
BUCKETFUL	B AH K AH T F AH L
BUCKETFULS	B AH K AH T F AH L Z
BUCKETING	B AH K AH T IH NG
BUCKETS	B AH K AH T S
BUCKETSFUL	B AH K AH T S F AH L
BUCKEYE	B AH K AY
BUCKEYES	B AH K AY Z
BUCKING	B AH K IH NG
BUCKISH	B AH K IH SH
BUCKLE	B AH K AH L
BUCKLED	B AH K AH L D
BUCKLER	B AH K AH L ER
BUCKLER(2)	B AH K L ER
BUCKLERED	B AH K AH L ER D
BUCKLERING	B AH K AH L ER IH NG
BUCKLERS	B AH K AH L ER Z
BUCKLES	B AH K AH L Z
BUCKLING	B AH K L IH NG
BUCKMINSTERFULLERENE	B AH K M AH N S T AH R F UH L AH R IY N
BUCKMINSTERFULLERENES	B AH K M AH N S T AH R F UH L AH R IY N Z
BUCKO	B AH K OW
BUCKOES	B AH K OW Z
BUCKOS	B AH K AA S
BUCKRA	B AH K R AH
BUCKRAM	B AH K R AE M
BUCKRAMED	B AH K R AE M D
BUCKRAMING	B AH K R AE M IH NG
BUCKRAMS	B AH K R AE M Z
BUCKRAS	B AH K R AH Z
BUCKS	B AH K S
BUCKSAW	B AH K S AO
BUCKSAWS	B AH K S AO Z
BUCKSHEE	B AH K IY IY
BUCKSHEES	B AH K IY Z
BUCKSHOT	B AH K SH AA T
BUCKSHOTS	B AH K SH AA T S
BUCKSKIN	B AH K S K IH N
BUCKSKINNED	B AH K S K IH N D
BUCKSKINS	B AH K S K IH N Z
BUCKTAIL	B AH K T EY L
BUCKTAILS	B AH K T EY L Z
BUCKTEETH	B AH K T IY TH
BUCKTHORN	B AH K TH AO R N
BUCKTHORNS	B AH K TH AO R N Z
BUCKTOOTH	B AH K T UW TH
BUCKTOOTHED	B AH K T UW TH T
BUCKWHEAT	B AH K W IY T
BUCKWHEATS	B AH K W IY T S
BUCKYBALL	B AH K IY B AO L
BUCKYBALLS	B AH K IY B AO L Z
BULLNECK	B UH L N EH K
BULLNECKED	B UH L N EH K T
BULLNECKS	B UH L N EH K S
BULLOCK	B UH L AH K
BULLOCKS	B UH L AH K S
BULLOCKY	B UH L AA K IY
BURDOCK	B AH R D AH K
BURDOCKS	B AH R D AH K S
BUSHBUCK	B UH SH B AH K
BUSHBUCKS	B UH SH B AH K S
BUSHWHACK	B UH SH W AE K
BUSHWHACKED	B UH SH W AE K T
BUSHWHACKER	B UH SH W AE K ER
BUSHWHACKERS	B UH SH W AE K ER Z
BUSHWHACKING	B UH SH W AE K IH NG
BUSHWHACKS	B UH SH W AE K S
BUTTOCK	B AH T AH K
BUTTOCKS	B AH T AH K S
BUTTSTOCK	B AH T S T AA K
BUTTSTOCKS	B AH T S T AA K S
BUYBACK	B AY B AE K
BUYBACKS	B AY B AE K S
CACKLE	K AE K AH L
CACKLED	K AE K AH L D
CACKLER	K AE K AH L ER
CACKLERS	K AE K AH L ER Z
CACKLES	K AE K AH L Z
CACKLING	K AE K AH L IH NG
CACKLING(2)	K AE K L IH NG
CALLBACK	K AO L B AE K
CALLBACKS	K AO L B AE K S
CALPACK	K AE L P AH K
CALPACKS	K AE L P AH K S
CAMELBACK	K AE M AH L B AE K
CAMELBACKS	K AE M AH L B AE K S
CANDLESTICK	K AE N D AH L S T IH K
CANDLESTICKS	K AE N D AH L S T IH K S
CANDLEWICK	K AE N D AH L W IH K
CANDLEWICKS	K AE N D AH L W IH K S
CANVASBACK	K AE N V AH S B AE K
CANVASBACKS	K AE N V AH S B AE K S
CAPROCK	K AE P R AA K
CAPROCKS	K AE P R AA K S
CARACK	K AE R AH K
CARACKS	K AE R AH K S
CARJACKER	K AA R JH AE K ER
CARJACKERS	K AA R JH AE K ER Z
CARJACKING	K AA R JH AE K IH NG
CARJACKINGS	K AA R JH AE K IH NG Z
CARRACK	K AA R AE K
CARRACKS	K AA R AE K S
CARRYBACK	K AE R IY B AE K
CARRYBACKS	K AE R IY B AE K S
CARSICK	K AA R S IH K
CARSICKNESS	K AA R S IH K N AH S
CARSICKNESSES	K AA R S IH K N AH S IH Z
CASSOCK	K AE S AH K
CASSOCKS	K AE S AH K S
CELLBLOCK	S EH L B L AA K
CELLBLOCKS	S EH L B L AA K S
CHARLOCK	CH AA R L AA K
CHARLOCKS	CH AA R L AA K S
CHEAPJACK	CH IY P JH AE K
CHEAPJACKS	CH IY P JH AE K S
CHECK	CH EH K
CHECKABLE	CH EH K AH B AH L
CHECKBOOK	CH EH K B UH K
CHECKBOOKS	CH EH K B UH K S
CHECKED	CH EH K T
CHECKER	CH EH K ER
CHECKERBERRIES	CH EH K ER B EH R IY Z
CHECKERBERRY	CH EH K ER B EH R IY
CHECKERBOARD	CH EH K ER B AO R D
CHECKERBOARDS	CH EH K ER B AO R D Z
CHECKERED	CH EH K ER D
CHECKERING	CH EH K ER IH NG
CHECKERS	CH EH K ER Z
CHECKING	CH EH K IH NG
CHECKLESS	CH EH K L AH S
CHECKLIST	CH EH K L IH S T
CHECKLISTS	CH EH K L IH S T S
CHECKMARK	CH EH K M AA R K
CHECKMARKED	CH EH K M AA R K T
CHECKMARKING	CH EH K M AA R K IH NG
CHECKMARKS	CH EH K M AA R K S
CHECKMATE	CH EH K M EY T
CHECKMATED	CH EH K M EY T IH D
CHECKMATES	CH EH K M EY T S
CHECKMATING	CH EH K M EY T IH NG
CHECKOFF	CH EH K AO F
CHECKOFFS	CH EH K AO F S
CHECKOUT	CH EH K AW T
CHECKOUTS	CH EH K AW T S
CHECKPOINT	CH EH K P OY N T
CHECKPOINTS	CH EH K P OY N T S
CHECKREIN	CH EH K R EY N
CHECKREINS	CH EH K R EY N Z
CHECKROOM	CH EH K R UW M
CHECKROOMS	CH EH K R UW M Z
CHECKROW	CH EH K R OW
CHECKROWED	CH EH K R OW D
CHECKROWING	CH EH K R OW IH NG
CHECKROWS	CH EH K R OW Z
CHECKS	CH EH K S
CHECKUP	CH EH K AH P
CHECKUPS	CH EH K AH P S
CHICK	CH IH K
CHICKADEE	CH IH K EY D IY
CHICKADEES	CH IH K EY D IY Z
CHICKAREE	CH IH K ER IY
CHICKAREES	CH IH K ER IY Z
CHICKEE	CH IH K IY
CHICKEES	CH IH K IY Z
CHICKEN	CH IH K AH N
CHICKENED	CH IH K AH N D
CHICKENHEARTED	CH IH K AH N HH AA R T IH D
CHICKENING	CH IH K AH N IH NG
CHICKENPOX	CH IH K AH N P AA K S
CHICKENPOXES	CH IH K AH N P AA K S IH Z
CHICKENS	CH IH K AH N Z
CHICKENSHIT	CH IH K AH N SH IH T
CHICKENSHITS	CH IH K AH N SH IH T S
CHICKORIES	CH IH K ER IY Z
CHICKORY	CH IH K ER IY
CHICKPEA	CH IH K P IY
CHICKPEAS	CH IH K P IY Z
CHICKS	CH IH K S
CHICKWEED	CH IH K W IY D
CHICKWEEDS	CH IH K W IY D Z
CHIPMUCK	CH IH P M AH K
CHIPMUCKS	CH IH P M AH K S
CHOCK	CH AA K
CHOCKABLOCK	CH AA K AH B L AA K
CHOCKED	CH AA K T
CHOCKFUL	CH AA K F AH L
CHOCKING	CH AA K IH NG
CHOCKS	CH AA K S
CHOPSTICK	CH AA P S T IH K
CHOPSTICKS	CH AA P S T IH K S
CHUCK	CH AH K
CHUCKAWALLA	CH AH K AH AE L AH
CHUCKAWALLAS	CH AH K AH AE L AH Z
CHUCKED	CH AH K T
CHUCKHOLE	CH AH K HH OW L
CHUCKHOLES	CH AH K HH OW L Z
CHUCKIES	CH AH K IY Z
CHUCKING	CH AH K IH NG
CHUCKLE	CH AH K AH L
CHUCKLED	CH AH K AH L D
CHUCKLEHEAD	CH AH K AH L HH EH D
CHUCKLEHEADED	CH AH K AH L HH EH D IH D
CHUCKLEHEADS	CH AH K AH L HH EH D Z
CHUCKLER	CH AH K AH L ER
CHUCKLERS	CH AH K AH L ER Z
CHUCKLES	CH AH K AH L Z
CHUCKLESOME	CH AH K AH L S AH M
CHUCKLING	CH AH K L IH NG
CHUCKLINGLY	CH AH K AH L IH NG L IY
CHUCKS	CH AH K S
CHUCKWALLA	CH AH K W AA L AH
CHUCKWALLAS	CH AH K W AA L AH Z
CHUCKY	CH AH K IY
CINDERBLOCK	S IH N D ER B L AA K
CINDERBLOCKS	S IH N D ER B L AA K S
CLACK	K L AE K
CLACKED	K L AE K T
CLACKER	K L AE K AH R
CLACKERS	K L AE K AH R Z
CLACKING	K L AE K AH NG
CLACKS	K L AE K S
CLICK	K L IH K
CLICKED	K L IH K T
CLICKER	K L IH K ER
CLICKERS	K L IH K ER Z
CLICKING	K L IH K IH NG
CLICKS	K L IH K S
CLOCK	K L AA K
CLOCKED	K L AA K T
CLOCKER	K L AA K ER
CLOCKERS	K L AA K ER Z
CLOCKING	K L AA K IH NG
CLOCKLIKE	K L AA K L AY K
CLOCKS	K L AA K S
CLOCKWISE	K L AA K W AY Z
CLOCKWORK	K L AA K W ER K
CLOCKWORKS	K L AA K W ER K S
CLUCK	K L AH K
CLUCKED	K L AH K T
CLUCKING	K L AH K IH NG
CLUCKS	K L AH K S
COALSACK	K OW L S AE K
COALSACKS	K OW L S AE K S
COATRACK	K OW AH T R AE K
COATRACKS	K OW AH T R AE K S
COCK	K AA K
COCKADE	K AA K EY D
COCKADED	K AA K EY D IH D
COCKADES	K AA K EY D Z
COCKALORUM	K AA K AE L AH R AH M
COCKALORUMS	K AA K AE L AH R AH M Z
COCKAMAMIE	K AO K AH M EY M IY
COCKAMAMY	K AA K AE M AH M IY
COCKAPOO	K AA K AE P UW
COCKAPOOS	K AA K AH P UW Z
COCKATIEL	K AA K AH T IY L
COCKATIELS	K AA K AH T IY L Z
COCKATOO	K AA K AH T UW
COCKATOOS	K AA K AH T UW Z
COCKATRICE	K AA K AE T R AH S
COCKATRICES	K AA K AE T R AH S
COCKBILL	K AA K B IH L
COCKBILLED	K AA K B IH L D
COCKBILLING	K AA K B IH L IH NG
COCKBILLS	K AA K B IH L Z
COCKBOAT	K AA K B OW T
COCKBOATS	K AA K B OW T S
COCKCHAFER	K AA K CH EY F ER
COCKCHAFERS	K AA K CH EY F ER Z
COCKCROW	K AA K R OW
COCKCROWS	K AA K R OW Z
COCKED	K AA K T
COCKED(2)	K AO K T
COCKER	K AA K ER
COCKERED	K AA K ER D
COCKEREL	K AA K EH R AH L
COCKERELS	K AA K EH R AH L Z
COCKERING	K AA K ER IH NG
COCKERS	K AA K ER Z
COCKEYE	K AA K AY
COCKEYED	K AA K AY D
COCKEYEDLY	K AA K AY AH D L IY
COCKEYEDNESS	K AA K AY AH D N AH S
COCKEYEDNESSES	K AA K AY AH D N AH S IH Z
COCKEYES	K AA K AY Z
COCKFIGHT	K AA K F AY T
COCKFIGHTING	K AA K F AY T IH NG
COCKFIGHTINGS	K AA K F AY T IH NG Z
COCKFIGHTS	K AA K F AY T S
COCKHORSE	K AA K HH AO R S
COCKHORSES	K AA K HH AO R S IH Z
COCKIER	K AA K IY ER
COCKIEST	K AA K IY AH S T
COCKILY	K AA K IY L IY
COCKINESS	K AA K IY N AH S
COCKINESSES	K AA K IY N AH S IH Z
COCKING	K AA K IH NG
COCKISH	K AA K IH SH
COCKLE	K AA K AH L
COCKLEBUR	K AA K L EH B AH R
COCKLEBURS	K AA K L EH B Y AH R Z
COCKLED	K AA K L EH D
COCKLES	K AA K AH L Z
COCKLESHELL	K AA K L EH SH AH L
COCKLESHELLS	K AA K L EH SH AH L Z
COCKLIKE	K AA K L AY K
COCKLING	K AA K L IH NG
COCKLOFT	K AA K L AO F T
COCKLOFTS	K AA K L AO F T S
COCKNEY	K AA K N IY
COCKNEYFIED	K AA K N AH F AY D
COCKNEYFIES	K AA K N AH F AY Z
COCKNEYFY	K AA K N EY F IY
COCKNEYFYING	K AA K N EY F AY AH NG
COCKNEYISH	K AA K N EY AH SH
COCKNEYISM	K AA K N EY AH Z AH M
COCKNEYISMS	K AA K N EY AH Z AH M Z
COCKNEYS	K AA K N EY Z
COCKPIT	K AA K P IH T
COCKPITS	K AA K P IH T S
COCKROACH	K AA K R OW CH
COCKROACHES	K AA K R OW CH IH Z
COCKS	K AA K S
COCKSCOMB	K AA K S K OW M
COCKSCOMBS	K AA K S K OW M Z
COCKSFOOT	K AA K S F UH T
COCKSFOOTS	K AA K S F UH T S
COCKSHIES	K AA K SH AY Z
COCKSHUT	K AA K SH AH T
COCKSHUTS	K AA K SH AH T S
COCKSHY	K AA K SH AY
COCKSPUR	K AA K S P ER
COCKSPURS	K AA K S P ER Z
COCKSUCKER	K AA K S AH K ER
COCKSUCKER(2)	K AA K S AH K ER Z
COCKSUCKERS	K AA K S AH K ER Z
COCKSURE	K AA K SH UH R
COCKSURELY	K AA K SH UH R L IY
COCKSURENESS	K AA K SH UH R N AH S
COCKSURENESSES	K AA K SH UH R N AH S IH Z
COCKTAIL	K AA K T EY L
COCKTAILED	K AA K T EY L D
COCKTAILING	K AA K T EY L IH NG
COCKTAILS	K AA K T EY L Z
COCKUP	K AA K AH P
COCKUPS	K AA K AH P S
COCKY	K AA K IY
COLDCOCK	K OW L D K AA K
COLDCOCKED	K OW L D K AA K T
COLDCOCKING	K OW L D K AA K IH NG
COLDCOCKS	K OW L D K AA K S
COLICKY	K AA L AH K IY
COMEBACK	K AH M B AE K
COMEBACKS	K AH M B AE K S
COOKSHACK	K UH K SH AE K
COOKSHACKS	K UH K SH AE K S
COPECK	K OW P EH K
COPECKS	K OW P EH K S
CORNERBACK	K AO R N ER B AE K
CORNERBACKS	K AO R N ER B AE K S
COSSACK	K AO S AH K
COSSACKS	K AA S AE K S
COUNTERATTACK	K AW N T ER AH T AE K
COUNTERATTACK(2)	K AW N ER AH T AE K
COUNTERATTACKED	K AW N T ER AH T AE K T
COUNTERATTACKED(2)	K AW N ER AH T AE K T
COUNTERATTACKER	K AW N T ER AH T AE K ER
COUNTERATTACKERS	K AW N T ER AH T AE K ER Z
COUNTERATTACKING	K AW N T ER AH T AE K IH NG
COUNTERATTACKING(2)	K AW N ER AH T AE K IH NG
COUNTERATTACKS	K AW N T ER AH T AE K S
COUNTERATTACKS(2)	K AW N ER AH T AE K S
COUNTERBLOCKADE	K AW N T ER B L AA K EY D
COUNTERBLOCKADED	K AW N T ER B L AA K EY D IH D
COUNTERBLOCKADES	K AW N T ER B L AA K EY D Z
COUNTERBLOCKADING	K AW N T ER B L AA K EY D IH NG
COUNTERCHECK	K AW N T ER CH EH K
COUNTERCHECKED	K AW N T ER CH EH K T
COUNTERCHECKING	K AW N T ER CH EH K IH NG
COUNTERCHECKS	K AW N T ER CH EH K S
COUNTERCLOCKWISE	K AW N T ER K L AO K W AY Z
COUNTERCLOCKWISE(2)	K AW N ER K L AO K W AY Z
COUNTERPICKET	K AW N T ER P IH K AH T
COUNTERPICKETED	K AW N T ER P IH K AH T IH D
COUNTERPICKETING	K AW N T ER P IH K AH T IH NG
COUNTERPICKETS	K AW N T ER P IH K AH T S
COWLICK	K AW L IH K
COWLICKS	K AW L IH K S
CRABSTICK	K R AE B S T IH K
CRABSTICKS	K R AE B S T IH K S
CRACK	K R AE K
CRACKAJACK	K R AE K AH JH AE K
CRACKAJACKS	K R AE K AH JH AE K S
CRACKBACK	K R AE K B AE K
CRACKBACKS	K R AE K B AE K S
CRACKBRAIN	K R AE K B R EY N
CRACKBRAINED	K R AE K B R EY N D
CRACKBRAINS	K R AE K B R EY N Z
CRACKDOWN	K R AE K D AW N
CRACKDOWNS	K R AE K D AW N Z
CRACKED	K R AE K T
CRACKER	K R AE K ER
CRACKERJACK	K R AE K ER JH AE K
CRACKERJACKS	K R AE K ER JH AE K S
CRACKERS	K R AE K ER Z
CRACKING	K R AE K IH NG
CRACKINGS	K R AE K IH NG Z
CRACKLE	K R AE K AH L
CRACKLED	K R AE K AH L D
CRACKLES	K R AE K AH L Z
CRACKLEWARE	K R AE K AH L W EH R
CRACKLEWARES	K R AE K AH L W EH R Z
CRACKLIER	K R AE K L IY ER
CRACKLIEST	K R AE K L IY AH S T
CRACKLING	K R AE K L IH NG
CRACKLINGS	K R AE K L IH NG Z
CRACKLY	K R AE K L IY
CRACKNEL	K R AE K N AH L
CRACKNELS	K R AE K N AH L Z
CRACKPOT	K R AE K P AA T
CRACKPOTS	K R AE K P AA T S
CRACKS	K R AE K S
CRACKSMAN	K R AE K S M AE N
CRACKSMEN	K R AE K S M EH N
CRACKUP	K R AE K AH P
CRACKUPS	K R AE K AH P S
CRACKY	K R AE K IY
CREWNECK	K R UW N EH K
CREWNECKS	K R UW N EH K S
CRICK	K R IH K
CRICKED	K R IH K T
CRICKET	K R IH K IH T
CRICKETED	K R IH K AH T IH D
CRICKETER	K R IH K AH T ER
CRICKETERS	K R IH K AH T ER Z
CRICKETING	K R IH K AH T IH NG
CRICKETS	K R IH K IH T S
CRICKEY	K R IH K IY
CRICKING	K R IH K AH NG
CRICKS	K R IH K S
CROCK	K R AA K
CROCKED	K R AA K T
CROCKERIES	K R AA K AH R IY Z
CROCKERY	K R AA K ER IY
CROCKET	K R AA K AH T
CROCKETED	K R AA K AH T IH D
CROCKETS	K R AA K AH T S
CROCKING	K R AA K IH NG
CROCKS	K R AA K S
CROOKBACK	K R UH K B AE K
CROOKBACKED	K R UH K B AE K T
CROOKBACKS	K R UH K B AE K S
CROOKNECK	K R UH K N EH K
CROOKNECKS	K R UH K N EH K S
CROSSCHECK	K R AO S CH EH K
CROSSCHECKED	K R AO S CH EH K T
CROSSCHECKING	K R AO S CH EH K IH NG
CROSSCHECKS	K R AO S CH EH K S
CRUCK	K R AH K
CRUCKS	K R AH K S
CUCKOLD	K AH K OW L D
CUCKOLDED	K AH K OW L D AH D
CUCKOLDING	K AH K OW L D AH NG
CUCKOLDRIES	K AH K OW L D R AY Z
CUCKOLDRY	K AH K OW L D R IY
CUCKOLDS	K AH K OW L D Z
CUCKOO	K AH K UW
CUCKOO(2)	K UW K UW
CUCKOOED	K AH K UW D
CUCKOOFLOWER	K AH K UW F L OW AH R
CUCKOOFLOWERS	K AH K UW F L OW AH R Z
CUCKOOING	K AH K UW AH NG
CUCKOOPINT	K AH K UW P AH N T
CUCKOOPINTS	K AH K UW P AH N T S
CUCKOOS	K UW K UW Z
CUPRONICKEL	K AH P R AH N IH K AH L
CUPRONICKELS	K AH P R AH N IH K AH L Z
CUTBACK	K AH T B AE K
CUTBACKS	K AH T B AE K S
DABCHICK	D AE B CH IH K
DABCHICKS	D AE B CH IH K S
DACKER	D AE K AH R
DACKERED	D AE K IY R D
DACKERING	D AE K IY R AH NG
DACKERS	D AE K AH R Z
DAGLOCK	D AE G L AA K
DAGLOCKS	D AE G L AA K S
DEADLOCK	D EH D L AA K
DEADLOCKED	D EH D L AA K T
DEADLOCKING	D EH D L AA K IH NG
DEADLOCKS	D EH D L AA K S
DECK	D EH K
DECKED	D EH K T
DECKEL	D IH K EH L
DECKELS	D IH K EH L Z
DECKER	D EH K ER
DECKERS	D IY S ER Z
DECKHAND	D EH K HH AE N D
DECKHANDS	D EH K HH AE N D Z
DECKHOUSE	D EH K HH AW S
DECKHOUSES	D EH K HH AW S IH Z
DECKING	D EH K IH NG
DECKINGS	D EH K IH NG Z
DECKLE	D IH K AH L
DECKLES	D EH K AH L Z
DECKS	D EH K S
DEFROCK	D IY F R AA K
DEFROCKED	D IY F R AA K T
DEFROCKING	D IY F R AA K IH NG
DEFROCKS	D IY F R AA K S
DERRICK	D EH R IH K
DERRICKS	D EH R IH K S
DETICK	D IY T IH K
DETICKED	D IY T IH K T
DETICKER	D IY T IH K ER
DETICKERS	D IY T IH K ER Z
DETICKING	D IY T IH K IH NG
DETICKS	D IY T IH K S
DEZINCKED	D IY Z IH NG K T
DEZINCKING	D IY Z IH NG K IH NG
DIAMONDBACK	D AY M AH N D B AE K
DIAMONDBACKS	D AY M AH N D B AE K S
DICK	D IH K
DICKCISSEL	D IH K S IH S AH L
DICKCISSELS	D IH K S IH S AH L Z
DICKED	D IH K T
DICKENS	D IH K AH N Z
DICKENSES	D IH K AH N Z IH Z
DICKER	D IH K ER
DICKERED	D IH K ER D
DICKERING	D IH K ER IH NG
DICKERS	D IH K ER Z
DICKEY	D IH K IY
DICKEYS	D IH K IY Z
DICKIE	D IH K IY
DICKIER	D IH K IY ER
DICKIES	D IH K IY Z
DICKIEST	D IH K IY AH S T
DICKING	D IH K IH NG
DICKS	D IH K S
DICKY	D IH K IY
DICKYS	D IH K IY Z
DIEBACK	D AY B AE K
DIEBACKS	D AY B AE K S
DIESTOCK	D AY S T AA K
DIESTOCKS	D AY S T AA K S
DIPSTICK	D IH P S T IH K
DIPSTICKS	D IH P S T IH K S
DISFROCK	D IH S F R AA K
DISFROCKED	D IH S F R AA K T
DISFROCKING	D IH S F R AA K IH NG
DISFROCKS	D IH S F R AA K S
DOCK	D AA K
DOCKAGE	D AA K IH JH
DOCKAGES	D AA K IH JH IH Z
DOCKED	D AA K T
DOCKER	D AA K ER
DOCKERS	D AA K ER Z
DOCKET	D AA K AH T
DOCKETED	D AA K AH T IH D
DOCKETING	D AA K AH T IH NG
DOCKETS	D AA K AH T S
DOCKHAND	D AA K HH AE N D
DOCKHANDS	D AA K HH AE N D Z
DOCKING	D AA K IH NG
DOCKLAND	D AA K L AH N D
DOCKLANDS	D AA K L AH N D Z
DOCKMASTER	D AA K M AE S T ER
DOCKMASTERS	D AA K M AE S T ER Z
DOCKS	D AA K S
DOCKSIDE	D AA K S AY D
DOCKSIDES	D AA K S AY D Z
DOCKWORKER	D AA K W ER K ER
DOCKWORKERS	D AA K W ER K ER Z
DOCKYARD	D AA K Y AA R D
DOCKYARDS	D AA K Y AA R D Z
DOMINICK	D AA M AH N IH K
DOMINICKER	D AA M AH N IH K S D ER
DOMINICKERS	D AA M AH N IH K S ER Z
DOMINICKS	D AA M AH N AH K S
DONNICKER	D AA N IH K S ER
DONNICKERS	D AA N IH K S ER Z
DOOHICKEY	D UW HH IH K IY
DOOHICKEYS	D UW HH IH K EY Z
DOOHICKIES	D UW HH IH K AY Z
DORNECK	D AO R N AH K
DORNECKS	D AO R N AH K S
DORNICK	D AO R N AH K
DORNICKS	D AO R N AH K S
DORNOCK	D AO R N AH K
DORNOCKS	D AO R N AH K S
DOWNTICK	D AW N T IH K
DOWNTICKS	D AW N T IH K S
DRAMMOCK	D R AE M AA K
DRAMMOCKS	D R AE M AA K S
DRAWBACK	D R AO B AE K
DRAWBACKS	D R AO B AE K S
DREADLOCK	D R EH D L AA K
DREADLOCKS	D R EH D L AA K S
DRECK	D R EH K
DRECKS	D R EH K S
DRECKY	D R EH K IY
DROPKICK	D R AA P K IH K
DROPKICKER	D R AA P K IH K ER
DROPKICKERS	D R AA P K IH K ER Z
DROPKICKS	D R AA P K IH K S
DRUMSTICK	D R AH M S T IH K
DRUMSTICKS	D R AH M S T IH K S
DUCK	D AH K
DUCKBILL	D AH K B IH L
DUCKBILLS	D AH K B IH L Z
DUCKBOARD	D AH K B OW R D
DUCKBOARDS	D AH K B OW R D Z
DUCKED	D AH K T
DUCKER	D AH K ER
DUCKERS	D AH K ER Z
DUCKIE	D AH K IY
DUCKIER	D AH K IY ER
DUCKIES	D AH K IH Z
DUCKIEST	D AH K IY AH S T
DUCKING	D AH K IH NG
DUCKLING	D AH K L IH NG
DUCKLINGS	D AH K L IH NG Z
DUCKPIN	D AH K P IH N
DUCKPINS	D AH K P IH N Z
DUCKS	D AH K S
DUCKTAIL	D AH K T EY L
DUCKTAILS	D AH K T EY L Z
DUCKWALK	D AH K W AO K
DUCKWALKED	D AH K W AO K T
DUCKWALKING	D AH K W AO K IH NG
DUCKWALKS	D AH K W AO K S
DUCKWEED	D AH K W IY D
DUCKWEEDS	D AH K W IY D Z
DUCKY	D AH K IY
DUMBSTRUCK	D AH M S T R AH K
EARLOCK	IH ER L AA K
EARLOCKS	IH ER L AA K S
ELECTROSHOCK	IH L EH K T R OW SH AA K
ELECTROSHOCKS	AH L EH K T R AH SH AH K S
ELFLOCK	EH L F L AH K
ELFLOCKS	EH L F L AH K S
FALLBACK	F AO L B AE K
FALLBACKS	F AO L B AE K S
FASTBACK	F AE S T B AE K
FASTBACKS	F AE S T B AE K S
FATBACK	F AE T B AE K
FATBACKS	F AE T B AE K S
FATSTOCK	F AE T S T AA K
FATSTOCKS	F AE T S T AA K S
FECK	F EH K
FECKLESS	F EH K L IH S
FECKLESSLY	F EH K L EH S L IY
FECKLESSNESS	F EH K L EH S N AH S
FECKLESSNESSES	F EH K L EH S N EH S AH Z
FECKLY	F EH K L IY
FECKS	F EH K S
FEEDBACK	F IY D B AE K
FEEDBACKS	F IY D B AE K S
FEEDSTOCK	F IY D S T AA K
FEEDSTOCKS	F IY D S T AA K S
FETLOCK	F EH T L AH K
FETLOCKS	F EH T L AH K S
FICKLE	F IH K AH L
FICKLENESS	F IH K AH L N AH S
FICKLENESSES	F IH K AH L N AH S IH Z
FICKLER	F IH K AH L ER
FICKLEST	F IH K AH L AH S T
FICKLY	F IH K AH L IY
FIDDLEBACK	F IH D AH L B AE K
FIDDLEBACKS	F IH D AH L B AE K S
FIDDLESTICK	F IH D AH L S T IH K
FIDDLESTICKS	F IH D AH L S T IH K S
FINBACK	F IH N B AE K
FINBACKS	F IH N B AE K S
FINGERPICK	F IH NG G ER P IH K
FINGERPICKED	F IH NG G ER P IH K T
FINGERPICKING	F IH NG G ER P IH K IH NG
FINGERPICKINGS	F IH NG G ER P IH K IH NG Z
FINGERPICKS	F IH NG G ER P IH K S
FINICKIER	F IH N IH K IY ER
FINICKIEST	F IH N IH K IY AH S T
FINICKIN	F AY N IH K IH N
FINICKINESS	F IH N IH K IY N AH S
FINICKINESSES	F IH N IH K IY N AH S IH Z
FINICKING	F AY N IH K S IH NG
FINICKY	F IH N AH K IY
FINNICKIER	F IH N IH K S IY ER
FINNICKIEST	F IH N IH K S IY AH S T
FINNICKY	F IH N IH K S IY
FIREBACK	F AY ER B AE K
FIREBACKS	F AY ER B AE K S
FIREBRICK	F AY ER B R IH K
FIREBRICKS	F AY ER B R IH K S
FIRECRACKER	F AY ER K R AE K ER
FIRECRACKERS	F AY ER K R AE K ER Z
FIRELOCK	F AY ER L AA K
FIRELOCKS	F AY ER L AA K S
FLACK	F L AE K
FLACKED	F L AE K T
FLACKERIES	F L AE K AH R AY Z
FLACKERY	F L AE K AH R IY
FLACKING	F L AE K AH NG
FLACKS	F L AE K S
FLAGSTICK	F L AE G S T IH K
FLAGSTICKS	F L AE G S T IH K S
FLAPJACK	F L AE P JH AE K
FLAPJACKS	F L AE P JH AE K S
FLASHBACK	F L AE SH B AE K
FLASHBACKS	F L AE SH B AE K S
FLECK	F L EH K
FLECKED	F L EH K T
FLECKING	F L EH K IH NG
FLECKS	F L EH K S
FLECKY	F L EH K IY
FLICK	F L IH K
FLICKED	F L IH K T
FLICKER	F L IH K ER
FLICKERED	F L IH K ER D
FLICKERING	F L IH K ER IH NG
FLICKERINGLY	F L IH K ER IH NG L IY
FLICKERS	F L IH K ER Z
FLICKERY	F L IH K AH R IY
FLICKING	F L IH K IH NG
FLICKS	F L IH K S
FLINTLOCK	F L IH N T L AA K
FLINTLOCKS	F L IH N T L AA K S
FLOCK	F L AA K
FLOCKED	F L AA K T
FLOCKIER	F L AA K IY ER
FLOCKIEST	F L AA K IY AH S T
FLOCKING	F L AA K IH NG
FLOCKINGS	F L AA K IH NG Z
FLOCKS	F L AA K S
FLOCKY	F L AA K IY
FLYSPECK	F L AY S P EH K
FLYSPECKED	F L AY S P EH K T
FLYSPECKING	F L AY S P EH K IH NG
FLYSPECKS	F L AY S P EH K S
FOOTLOCKER	F UH T L OW K ER
FOOTLOCKERS	F UH T L OW K ER Z
FORECHECK	F OW R CH EH K
FORECHECKED	F OW R CH EH K T
FORECHECKER	F OW R CH EH K ER
FORECHECKERS	F OW R CH EH K ER Z
FORECHECKING	F OW R CH EH K IH NG
FORECHECKS	F OW R CH EH K S
FOREDECK	F OW R D EH K
FOREDECKS	F OW R D EH K S
FORELOCK	F OW R L AA K
FORELOCKED	F OW R L AA K T
FORELOCKING	F OW R L AA K IH NG
FORELOCKS	F OW R L AA K S
FORESHOCK	F OW R SH AA K
FORESHOCKS	F OW R SH AA K S
FOSSICK	F AA S AH K
FOSSICKED	F AA S AH K T
FOSSICKER	F AA S IH K AH R
FOSSICKERS	F AA S IH K AH R Z
FOSSICKING	F AA S IH K AH NG
FOSSICKS	F AA S AH K S
FRECKLE	F R EH K AH L
FRECKLED	F R EH K AH L D
FRECKLES	F R EH K AH L Z
FRECKLIER	F R EH K AH L IY ER
FRECKLIEST	F R EH K AH L IY AH S T
FRECKLING	F R EH K AH L IH NG
FRECKLY	F R EH K AH L IY
FROCK	F R AA K
FROCKED	F R AA K T
FROCKING	F R AA K IH NG
FROCKS	F R AA K S
FROLICKED	F R AA L IH K T
FROLICKING	F R AA L IH K IH NG
FROLICKY	F R AA L IH K IY
FUCK	F AH K
FUCKED	F AH K T
FUCKER	F AH K ER
FUCKERS	F AH K ER Z
FUCKING	F AH K IH NG
FUCKS	F AH K S
FUCKUP	F AH K AH P
FUCKUPS	F AH K AH P S
FULLBACK	F UH L B AE K
FULLBACKS	F UH L B AE K S
FUTTOCK	F AH T AH K
FUTTOCKS	F AH T AH K S
GAMECOCK	G EY M K AO K
GAMECOCKS	G EY M K AO K S
GARLICKED	G AA R L IH K T
GARLICKY	G AA R L IH K IY
GAVELOCK	G EY V L AA K
GAVELOCKS	G EY V L AA K S
GECK	JH EH K
GECKED	JH EH K T
GECKING	JH EH K AH NG
GECKO	G EH K OW
GECKOES	JH EH K OW Z
GECKOS	G EH K OW Z
GECKS	JH EH K S
GEMSBUCK	JH EH M Z B AH K
GEMSBUCKS	JH EH M Z B AH K S
GEODUCK	JH IY AH D AH K
GEODUCKS	JH IY AH D AH K S
GIMCRACK	JH IH M K R AH K
GIMCRACKERIES	JH IH M K R AE K AH R AY Z
GIMCRACKERY	JH IH M K R AH K EH R IY
GIMCRACKS	JH IH M K R AH K S
GIMMICK	G IH M IH K
GIMMICKED	JH IH M AH K T
GIMMICKING	JH IH M IH K AH NG
GIMMICKRIES	JH IH M IH K R AY Z
GIMMICKRY	G IH M IH K R IY
GIMMICKS	G IH M IH K S
GIMMICKY	G IH M IH K IY
GIVEBACK	G IH V B AE K
GIVEBACKS	G IH V B AE K S
GLOCKENSPIEL	G L AA K AH N S P IY L
GLOCKENSPIELS	G L AA K AH N S IY L Z
GOATSUCKER	G OW T S AH K ER
GOATSUCKERS	G OW T S AH K ER Z
GOLDBRICK	G OW L D B R IH K
GOLDBRICKED	G OW L D B R IH K T
GOLDBRICKING	G OW L D B R IH K IH NG
GOLDBRICKS	G OW L D B R IH K S
GOOSENECK	G UW S N EH K
GOOSENECKED	G UW S N EH K T
GOOSENECKS	G UW S N EH K S
GORCOCK	G AO R K AH K
GORCOCKS	G AO R K AH K S
GRACKLE	G R AE K AH L
GRACKLES	G R AE K AH L Z
GRAYBACK	G R EY B AE K
GRAYBACKS	G R EY B AE K S
GRAYWACKE	G R EY W AH K
GRAYWACKES	G R EY W AH K S
GREENBACK	G R IY N B AE K
GREENBACKER	G R IY N B AE K ER
GREENBACKERS	G R IY N B AE K ER Z
GREENBACKISM	G R IY N B AE K IH Z AH M
GREENBACKISMS	G R IY N B AE K IH Z AH M Z
GREENBACKS	G R IY N B AE K S
GREENOCKITE	G R IY N AH K AY T
GREENOCKITES	G R IY N AH K AY T S
GREENSICK	G R IY N S IH K
GREENSICKNESS	G R IY N S IH K N AH S
GREENSICKNESSES	G R IY N S IH K N AH S IH Z
GRIDLOCK	G R IH D L AA K
GRIDLOCKED	G R IH D L AA K T
GRIDLOCKING	G R IH D L AA K AH NG
GRIDLOCKS	G R IH D L AA K S
GRIPSACK	G R IH P S AE K
GRIPSACKS	G R IH P S AE K S
GUCK	G AH K
GUCKS	G AH K S
GUNLOCK	G AH N L AA K
GUNLOCKS	G AH N L AA K S
GUNNYSACK	G AH N IY S AE K
GUNNYSACKS	G AH N IY S AE K S
GUNSTOCK	G AH N S T AA K
GUNSTOCKS	G AH N S T AA K S
GUTBUCKET	G AH T B AH K AH T
GUTBUCKETS	G AH T B AH K AH T S
GWEDUCK	G W EH D AH K
GWEDUCKS	G W EH D AH K S
HACK	HH AE K
HACKAMORE	HH AE K AH M AH R
HACKAMORES	HH AE K AH M AO R EY Z
HACKBERRIES	HH AE K B EH R IY Z
HACKBERRY	HH AE K B EH R IY
HACKBUT	HH AE K B AH T
HACKBUTS	HH AE K B Y UW T S
HACKED	HH AE K T
HACKEE	HH AE K IY
HACKEES	HH AE K IY Z
HACKER	HH AE K ER
HACKERS	HH AE K ER Z
HACKIE	HH AE K IY
HACKIES	HH AE K IY Z
HACKING	HH AE K IH NG
HACKLE	HH AE K AH L
HACKLED	HH AE K AH L D
HACKLER	HH AE K AH L ER
HACKLER(2)	HH AE K L ER
HACKLERS	HH AE K AH L ER Z
HACKLES	HH AE K AH L Z
HACKLIER	HH AE K L IY ER
HACKLIEST	HH AE K L IY AH S T
HACKLING	HH AE K L IH NG
HACKLY	HH AE K L IY
HACKMAN	HH AE K M AE N
HACKMAN(2)	HH AE K M AH N
HACKMATACK	HH AE K M AH T AE K
HACKMATACKS	HH AE K M AH T AH K S
HACKMEN	HH AE K M EH N
HACKNEY	HH AE K N IY
HACKNEYED	HH AE K N IY D
HACKNEYING	HH AE K N IY IH NG
HACKNEYS	HH AE K N IY Z
HACKS	HH AE K S
HACKSAW	HH AE K S AO
HACKSAWS	HH AE K S AO Z
HACKWORK	HH AE K W ER K
HACKWORKS	HH AE K W ER K S
HADDOCK	HH AE D AH K
HADDOCKS	HH AE D AH K S
HAIRLOCK	HH EH R L AA K
HAIRLOCKS	HH EH R L AA K S
HALFBACK	HH AE F B AE K
HALFBACKS	HH AE F B AE K S
HAMMERLOCK	HH AE M ER L AA K
HAMMERLOCKS	HH AE M ER L AA K S
HAMMOCK	HH AE M AH K
HAMMOCKS	HH AE M AH K S
HANDPICK	HH AE N D P IH K
HANDPICKED	HH AE N D P IH K T
HANDPICKING	HH AE N D P IH K IH NG
HANDPICKS	HH AE N D P IH K S
HARDBACK	HH AA R D B AE K
HARDBACKS	HH AA R D B AE K S
HARDHACK	HH AA R D HH AE K
HARDHACKS	HH AA R D HH AE K S
HARDTACK	HH AA R D T AE K
HARDTACKS	HH AA R D T AE K S
HASSOCK	HH AA Z S AA K
HASSOCKS	HH AA Z S AA K S
HATCHBACK	HH AE CH B AE K
HATCHBACKS	HH AE CH B AE K S
HATCHECK	HH AE T CH EH K
HATRACK	HH AE T R AE K
HATRACKS	HH AE T R AE K S
HAVELOCK	HH AE V L AA K
HAVELOCKS	HH AE V AH L AH K S
HAVERSACK	HH AH V AH R S AH K
HAVERSACKS	HH AH V AH R S AH K S
HAVOCKED	HH AE V AH K T
HAVOCKER	HH AE V AH K ER
HAVOCKERS	HH AE V AH K ER Z
HAVOCKING	HH AE V AH K IH NG
HAYCOCK	HH EY K AA K
HAYCOCKS	HH EY K AA K S
HAYRACK	HH EY R AE K
HAYRACKS	HH EY R AE K S
HAYRICK	HH EY R AH K
HAYRICKS	HH EY R AH K S
HAYSTACK	HH EY S T AE K
HAYSTACKS	HH EY S T AE K S
HEADLOCK	HH EH D L AA K
HEADLOCKS	HH EH D L AA K S
HEADSTOCK	HH EH D S T AA K
HEADSTOCKS	HH EH D S T AA K S
HEARTSICK	HH AA R T S IH K
HEARTSICKNESS	HH AA R T S IH K N AH S
HEARTSICKNESSES	HH AA R T S IH K N AH S IH Z
HECK	HH EH K
HECKLE	HH EH K AH L
HECKLED	HH EH K AH L D
HECKLER	HH EH K L ER
HECKLERS	HH EH K L ER Z
HECKLES	HH EH K AH L Z
HECKLING	HH EH K L IH NG
HECKS	HH EH K S
HEMLOCK	HH EH M L AA K
HEMLOCKS	HH EH M L AA K S
HENPECK	HH EH N P EH K
HENPECKED	HH EH N P EH K T
HENPECKING	HH EH N P EH K IH NG
HENPECKS	HH EH N P EH K S
HICK	HH IH K
HICKEY	HH IH K IY
HICKEYS	HH IH K EY Z
HICKIES	HH IH K IY Z
HICKISH	HH IH K IH SH
HICKORIES	HH IH K ER IY Z
HICKORY	HH IH K ER IY
HICKORY(2)	HH IH K R IY
HICKS	HH IH K S
HIGHJACK	HH AY JH AE K
HIGHJACKED	HH AY JH AE K T
HIGHJACKING	HH AY JH AE K IH NG
HIGHJACKS	HH AY JH AE K S
HIJACK	HH AY JH AE K
HIJACKED	HH AY JH AE K T
HIJACKER	HH AY JH AE K ER
HIJACKERS	HH AY JH AE K ER Z
HIJACKING	HH AY JH AE K IH NG
HIJACKINGS	HH AY JH AE K IH NG Z
HIJACKS	HH AY JH AE K S
HILLOCK	HH IH L AH K
HILLOCKS	HH IH L AH K S
HILLOCKY	HH IH L AA K IY
HOCK	HH AA K
HOCKED	HH AA K T
HOCKER	HH AA K ER
HOCKERS	HH AA K ER Z
HOCKEY	HH AA K IY
HOCKEYS	HH AA K IY Z
HOCKING	HH AA K IH NG
HOCKS	HH AA K S
HOCKSHOP	HH AA K SH AA P
HOCKSHOPS	HH AA K SH AA P S
HOGBACK	HH AA G B AE K
HOGBACKS	HH AA G B AE K S
HOICK	HH OY K
HOICKED	HH OW IH K S T
HOICKING	HH OW IH K S IH NG
HOICKS	HH OY K S
HOLDBACK	HH OW L D B AE K
HOLDBACKS	HH OW L D B AE K S
HOLLYHOCK	HH AA L IY HH AA K
HOLLYHOCKS	HH AA L IY HH AA K S
HOMESICK	HH OW M S IH K
HOMESICKNESS	HH OW M S IH K N AH S
HOMESICKNESSES	HH OW M S IH K N AH S IH Z
HOMMOCK	HH AA M AH K
HOMMOCKS	HH AA M AH K S
HONEYSUCKLE	HH AH N IY S AH K AH L
HONEYSUCKLES	HH AH N IY S AH K AH L Z
HOPSACK	HH AA P S AE K
HOPSACKING	HH AA P S AE K IH NG
HOPSACKINGS	HH AA P S AE K IH NG Z
HOPSACKS	HH AA P S AE K S
HORSEBACK	HH AO R S B AE K
HORSEBACKS	HH AO R S B AE K S
HUCK	HH AH K
HUCKABACK	HH AH K AH B AH K
HUCKABACKS	HH AH K AH B AH K S
HUCKLE	HH AH K AH L
HUCKLEBERRIES	HH AH K L AH B EH R AY Z
HUCKLEBERRY	HH AH K AH L B EH R IY
HUCKLES	HH AH K AH L Z
HUCKS	HH AH K S
HUCKSTER	HH AH K S T ER
HUCKSTERED	HH AH K S T ER D
HUCKSTERING	HH AH K S T ER IH NG
HUCKSTERISM	HH AH K S T ER IH Z AH M
HUCKSTERISMS	HH AH K S T ER IH Z AH M Z
HUCKSTERS	HH AH K S T ER Z
HUMMOCK	HH AH M AH K
HUMMOCKED	HH AH M AH K T
HUMMOCKING	HH AH M AH K IH NG
HUMMOCKS	HH AH M AH K S
HUMMOCKY	HH AH M AH K IY
HUMPBACK	HH AH M P B AE K
HUMPBACKED	HH AH M P B AE K T
HUMPBACKS	HH AH M P B AE K S
HUNCHBACK	HH AH N CH B AE K
HUNCHBACKED	HH AH N CH B AE K T
HUNCHBACKS	HH AH N CH B AE K S
HYDROCRACK	HH IH D R AA K R AH K
HYDROCRACKED	HH IH D R AA K R AH K T
HYDROCRACKER	HH IH D R AA K R AE K AH R
HYDROCRACKERS	HH IH D R AH K R AE K AH R Z
HYDROCRACKING	HH IH D R AA K R AE K AH NG
HYDROCRACKINGS	HH IH D R AH K R AE K AH NG Z
HYDROCRACKS	HH IH D R AA K R AH K S
ICK	IH K
ICKER	IH K AH R
ICKERS	IH K AH R Z
ICKIER	IH K AY AH R
ICKIEST	IH K AY AH S T
ICKILY	IH K AH L IY
ICKINESS	IH K AH N AH S
ICKINESSES	IH K AH N EH S AH Z
ICKY	IH K IY
INTERLOCK	IH N T ER L AA K
INTERLOCKED	IH N T ER L AA K D
INTERLOCKING	IH N T ER L AA K IH NG
INTERLOCKS	IH N T ER L AA K S
JABBERWOCKIES	JH AE B AH R W AA K AY Z
JABBERWOCKY	JH AE B AH R W AA K IY
JACK	JH AE K
JACKAL	JH AE K AH L
JACKALS	JH AE K AH L Z
JACKANAPES	JH AE K AH N EY P S
JACKANAPESES	JH AE K AE N AH P IY Z AH Z
JACKAROO	JH AE K AH R UW
JACKAROOS	JH AE K AH R UW Z
JACKASS	JH AE K AE S
JACKASSERIES	JH AE K AE S AH R IY Z
JACKASSERY	JH AE K AE S AH R IY
JACKASSES	JH AE K AE S IH Z
JACKBOOT	JH AE K B UW T
JACKBOOTED	JH AE K B UW T IH D
JACKBOOTS	JH AE K B UW T S
JACKDAW	JH AE K D AO
JACKDAWS	JH AE K D AO Z
JACKED	JH AE K T
JACKER	JH AE K ER
JACKEROO	JH AE K AH R UW
JACKEROOS	JH AE K AH R UW Z
JACKERS	JH AE K ER Z
JACKET	JH AE K AH T
JACKET(2)	JH AE K IH T
JACKETED	JH AE K AH T IH D
JACKETING	JH AE K AH T IH NG
JACKETLESS	JH AE K AH T L AH S
JACKETS	JH AE K IH T S
JACKFISH	JH AE K F IH SH
JACKFISHES	JH AE K F IH SH IH Z
JACKFRUIT	JH AE K F R UW T
JACKFRUITS	JH AE K F R UW T S
JACKHAMMER	JH AE K HH AE M ER
JACKHAMMERED	JH AE K HH AE M ER D
JACKHAMMERING	JH AE K HH AE M ER IH NG
JACKHAMMERS	JH AE K HH AE M ER Z
JACKIES	JH AE K IY Z
JACKING	JH AE K IH NG
JACKKNIFE	JH AE K N AY F
JACKKNIFED	JH AE K N AY F T
JACKKNIFES	JH AE K N AY F S
JACKKNIFING	JH AE K N AY F IH NG
JACKKNIVES	JH AE K N AY V Z
JACKLEG	JH AE K L EH G
JACKLEGS	JH AE K L EH G Z
JACKLIGHT	JH AE K L AY T
JACKLIGHTS	JH AE K L AY T S
JACKPOT	JH AE K P AA T
JACKPOTS	JH AE K P AA T S
JACKRABBIT	JH AE K R AE B AH T
JACKRABBITS	JH AE K R AE B AH T S
JACKROLL	JH AE K R OW L
JACKROLLED	JH AE K R OW L D
JACKROLLING	JH AE K R OW L IH NG
JACKROLLS	JH AE K R OW L Z
JACKS	JH AE K S
JACKSCREW	JH AE K S K R UW
JACKSCREWS	JH AE K S K R UW Z
JACKSMELT	JH AE K S M EH L T
JACKSMELTS	JH AE K S M EH L T S
JACKSTAY	JH AE K S T EY
JACKSTAYS	JH AE K S T EY Z
JACKSTRAW	JH AE K S T R AO
JACKSTRAWS	JH AE K S T R AO Z
JACKY	JH AE K IY
JINRICKSHA	JH IH N R IH K AH
JINRICKSHAS	JH IH N R IH K AH Z
JOCK	JH AA K
JOCKETTE	JH AA K EH T
JOCKETTES	JH AA K EH T S
JOCKEY	JH AA K IY
JOCKEYED	JH AA K IY D
JOCKEYING	JH AA K IY IH NG
JOCKEYS	JH AA K IY Z
JOCKO	JH AA K OW
JOCKOS	JH AA K AA S
JOCKS	JH AA K S
JOCKSTRAP	JH AA K S T R AE P
JOCKSTRAPS	JH AA K S T R AE P S
JOYSTICK	JH OY S T IH K
JOYSTICKS	JH OY S T IH K S
JUMBUCK	JH AH M B AH K
JUMBUCKS	JH AH M B AH K S
KEBBOCK	K EH B AH K
KEBBOCKS	K EH B AH K S
KEBBUCK	K EH B AH K
KEBBUCKS	K EH B AH K S
KECK	K EH K
KECKED	K EH K T
KECKING	K EH K AH NG
KECKLE	K EH K AH L
KECKLED	K EH K AH L D
KECKLES	K EH K AH L Z
KECKLING	K EH K L AH NG
KECKS	K EH K S
KENSPECKLE	K EH N S P EH K AH L
KICK	K IH K
KICKABLE	K IH K AH B AH L
KICKBACK	K IH K B AE K
KICKBACKS	K IH K B AE K S
KICKBALL	K IH K B AO L
KICKBALLS	K IH K B AO L Z
KICKBOARD	K IH K B OW R D
KICKBOARDS	K IH K B OW R D Z
KICKBOXER	K IH K B AA K S ER
KICKBOXERS	K IH K B AA K S ER Z
KICKBOXING	K IH K B AA K S IH NG
KICKBOXINGS	K IH K B AA K S IH NG Z
KICKED	K IH K T
KICKER	K IH K ER
KICKERS	K IH K ER Z
KICKIER	K IH K IY ER
KICKIEST	K IH K IY AH S T
KICKING	K IH K IH NG
KICKOFF	K IH K AO F
KICKOFFS	K IH K AO F S
KICKS	K IH K S
KICKSHAW	K IH K SH AO
KICKSHAWS	K IH K SH AO Z
KICKSTAND	K IH K S T AE N D
KICKSTANDS	K IH K S T AE N D Z
KICKSTART	K IH K S T AA R T
KICKSTARTED	K IH K S T AA R T IH D
KICKSTARTING	K IH K S T AA R T IH NG
KICKSTARTS	K IH K S T AA R T S
KICKUP	K IH K AH P
KICKUPS	K IH K AH P S
KICKY	K IH K IY
KILLICK	K IH L AH K
KILLICKS	K IH L AH K S
KILLOCK	K IH L AH K
KILLOCKS	K IH L AH K S
KINNIKINNICK	K IH N AH K IH N AH K
KINNIKINNICKS	K IH N AH K IH N AH K S
KNACK	N AE K
KNACKED	N AE K T
KNACKER	N AE K ER
KNACKERED	N AE K ER D
KNACKERIES	N AE K AH R IY Z
KNACKERS	N AE K ER Z
KNACKERY	N AE K AH R IY
KNACKING	N AE K IH NG
KNACKS	N AE K S
KNACKWURST	N AE K W AH R S T
KNACKWURSTS	N AE K W AH R S T S
KNAPSACK	N AE P S AE K
KNAPSACKED	N AE P S AH K T
KNAPSACKS	N AE P S AH K S
KNEESOCK	N IY S AA K
KNEESOCKS	N IY S AA K S
KNICKERBOCKER	N IH K ER B AA K ER
KNICKERBOCKERS	N IH K ER B AA K ER Z
KNICKERS	N IH K ER Z
KNICKKNACK	N IH K N AE K
KNICKKNACKS	N IH K N AE K S
KNOCK	N AA K
KNOCKABOUT	N AA K AH B AW T
KNOCKABOUTS	N AA K AH B AW T S
KNOCKDOWN	N AA K D AW N
KNOCKDOWNS	N AA K D AW N Z
KNOCKED	N AA K T
KNOCKER	N AA K ER
KNOCKERS	N AA K ER Z
KNOCKING	N AA K IH NG
KNOCKOFF	N AA K AO F
KNOCKOFFS	N AA K AO F S
KNOCKOUT	N AA K AW T
KNOCKOUTS	N AA K AW T S
KNOCKS	N AA K S
KNOCKWURST	N AA K W AH R S T
KNOCKWURSTS	N AA K W AH R S T S
KNUCKLE	N AH K AH L
KNUCKLEBALL	N AH K AH L B AO L
KNUCKLEBALLER	N AH K AH L B AO L ER
KNUCKLEBALLERS	N AH K AH L B AO L ER Z
KNUCKLEBALLS	N AH K AH L B AO L Z
KNUCKLEBONE	N AH K AH L B OW N
KNUCKLEBONES	N AH K AH L B OW N Z
KNUCKLED	N AH K AH L D
KNUCKLEHEAD	N AH K AH L HH EH D
KNUCKLEHEADED	N AH K AH L HH EH D IH D
KNUCKLEHEADS	N AH K AH L HH EH D Z
KNUCKLER	N AH K AH L ER
KNUCKLERS	N AH K AH L ER Z
KNUCKLES	N AH K AH L Z
KNUCKLIER	N AH K AH L IY ER
KNUCKLIEST	N AH K AH L IY AH S T
KNUCKLING	N AH K AH L IH NG
KNUCKLY	N AH K AH L IY
KOLACKY	K AH L AE K IY
KOMONDOROCK	K AH M AA N D AH R AH K
KOPECK	K AA P AH K
KOPECKS	K AA P AH K S
KYACK	K AY AH K
KYACKS	K AY AH K S
LACK	L AE K
LACKADAISICAL	L AE K AH D EY Z IH K AH L
LACKADAISICALLY	L AE K AH D EY Z IH K AH L IY
LACKADAY	L AE K AH D EY
LACKED	L AE K T
LACKER	L AE K ER
LACKERED	L AE K ER D
LACKERING	L AE K ER IH NG
LACKERS	L AE K ER Z
LACKEY	L AE K IY
LACKEYED	L AE K IY D
LACKEYING	L AE K IY IH NG
LACKEYS	L AE K IY Z
LACKING	L AE K IH NG
LACKLUSTER	L AE K L AH S T ER
LACKLUSTERS	L AE K L AH S T ER Z
LACKS	L AE K S
LAMPBLACK	L AE M P B L AE K
LAMPBLACKS	L AE M P B L AE K S
LANDLOCKED	L AE N D L AA K T
LAUGHINGSTOCK	L AE F IH NG S T AA K
LAUGHINGSTOCKS	L AE F IH NG S T AA K S
LAVEROCK	L AE V AH R AH K
LAVEROCKS	L AE V AH R AH K S
LAVROCK	L AE V R AH K
LAVROCKS	L AE V R AH K S
LEASEBACK	L IY S B AE K
LEASEBACKS	L IY S B AE K S
LEATHERBACK	L EH DH ER B AE K
LEATHERBACKS	L EH DH ER B AE K S
LEATHERNECK	L EH DH ER N EH K
LEATHERNECKS	L EH DH ER N EH K S
LICK	L IH K
LICKED	L IH K T
LICKER	L IH K ER
LICKERISH	L IH K ER IH SH
LICKERISHLY	L IH K ER IH SH L IY
LICKERISHNESS	L IH K ER IH SH N AH S
LICKERISHNESSES	L IH K ER IH SH N AH S IH Z
LICKERS	L IH K ER Z
LICKING	L IH K IH NG
LICKINGS	L IH K IH NG Z
LICKS	L IH K S
LICKSPIT	L IH K S P IH T
LICKSPITS	L IH K S P IH T S
LICKSPITTLE	L IH K S P IH T AH L
LICKSPITTLES	L IH K S P IH T AH L Z
LIMBECK	L IH M B AH K
LIMBECKS	L IH M B AH K S
LIMERICK	L IH M ER IH K
LIMERICKS	L IH M ER IH K S
LINEBACKER	L AY N B AE K ER
LINEBACKERS	L AY N B AE K ER Z
LINEBACKING	L AY N B AE K IH NG
LINEBACKINGS	L AY N B AE K IH NG Z
LINSTOCK	L IH N S T AH K
LINSTOCKS	L IH N S T AH K S
LIPSTICK	L IH P S T IH K
LIPSTICKED	L IH P S T IH K T
LIPSTICKS	L IH P S T IH K S
LITTLENECK	L IH T AH L N EH K
LITTLENECKS	L IH T AH L N EH K S
LIVESTOCK	L AY V S T AA K
LIVESTOCKS	L IH V S T AA K S
LOBSTICK	L AA B S T IH K
LOBSTICKS	L AA B S T IH K S
LOCK	L AA K
LOCKABLE	L OW K AH B AH L
LOCKAGE	L OW K IH JH
LOCKAGES	L OW K IH JH IH Z
LOCKBOX	L AA K B AA K S
LOCKBOXES	L AA K B AA K S IH Z
LOCKDOWN	L AA K D AW N
LOCKDOWNS	L AA K D AW N Z
LOCKED	L AA K T
LOCKER	L AA K ER
LOCKERS	L AA K ER Z
LOCKET	L AA K IH T
LOCKETS	L AA K IH T S
LOCKING	L AA K IH NG
LOCKJAW	L AA K JH AO
LOCKJAWS	L AA K JH AO Z
LOCKKEEPER	L AA K IY P ER
LOCKKEEPERS	L AA K IY P ER Z
LOCKNUT	L AA K N AH T
LOCKNUTS	L AA K N AH T S
LOCKOUT	L AA K AW T
LOCKOUTS	L AA K AW T S
LOCKRAM	L AA K R AE M
LOCKRAMS	L AA K R AE M Z
LOCKS	L AA K S
LOCKSMITH	L AA K S M IH TH
LOCKSMITHING	L AA K S M IH TH IH NG
LOCKSMITHINGS	L AA K S M IH TH IH NG Z
LOCKSMITHS	L AA K S M IH TH S
LOCKSTEP	L AA K S T EH P
LOCKSTEPS	L AA K S T EH P S
LOCKSTITCH	L AA K S T IH CH
LOCKSTITCHED	L AA K S T IH CH T
LOCKSTITCHES	L AA K S T IH CH IH Z
LOCKSTITCHING	L AA K S T IH CH IH NG
LOCKUP	L AA K AH P
LOCKUPS	L AA K AH P S
LOPSTICK	L AA P S T IH K
LOPSTICKS	L AA P S T IH K S
LOVELOCK	L AH V L AA K
LOVELOCKS	L AH V L AA K S
LOVESICK	L AH V S IH K
LOVESICKNESS	L AH V S IH K N AH S
LOVESICKNESSES	L AH V S IH K N AH S IH Z
LUCK	L AH K
LUCKED	L AH K T
LUCKIE	L AH K IY
LUCKIER	L AH K IY ER
LUCKIES	L UW S IY Z
LUCKIEST	L AH K IY AH S T
LUCKILY	L AH K AH L IY
LUCKINESS	L UW S IY N AH S
LUCKINESSES	L UW S IY N AH S IH Z
LUCKING	L AH K IH NG
LUCKLESS	L AH K L AH S
LUCKS	L AH K S
LUCKY	L AH K IY
LUMBERJACK	L AH M B ER JH AE K
LUMBERJACKS	L AH M B ER JH AE K S
MACK	M AE K
MACKEREL	M AE K ER AH L
MACKERELS	M AE K AH R AH L Z
MACKINAW	M AE K AH N AO
MACKINAWS	M AE K AH N AO Z
MACKINTOSH	M AE K AH N T AA SH
MACKINTOSHES	M AE K AH N T AA SH IH Z
MACKLE	M AE K AH L
MACKLED	M AE K AH L D
MACKLES	M AE K AH L Z
MACKLING	M AE K L AH NG
MACKS	M AE K S
MAFFICK	M AE F AH K
MAFFICKED	M AE F AH K T
MAFFICKING	M AE F IH K AH NG
MAFFICKS	M AE F AH K S
MAGICKED	M AE JH IH K T
MAGICKING	M AE JH IH K IH NG
MAHLSTICK	M AE L S T AH K
MAHLSTICKS	M AE L S T AH K S
MAMMOCK	M AE M AH K
MAMMOCKED	M AE M AH K T
MAMMOCKING	M AE M AA K AH NG
MAMMOCKS	M AE M AH K S
MANPACK	M AE N P AE K
MATCHLOCK	M AE CH L AA K
MATCHLOCKS	M AE CH L AA K S
MATCHSTICK	M AE CH S T IH K
MATCHSTICKS	M AE CH S T IH K S
MATTOCK	M AE T AH K
MATTOCKS	M AE T AH K S
MAULSTICK	M AO L S T IH K
MAULSTICKS	M AO L S T IH K S
MAVERICK	M AE V ER IH K
MAVERICK(2)	M AE V R IH K
MAVERICKS	M AE V ER IH K S
MAVERICKS(2)	M AE V R IH K S
MEATPACKING	M IY T P AE K IH NG
MEATPACKINGS	M IY T P AE K IH NG Z
MEDEVACKED	M EH D AH V AH K T
MEDEVACKING	M EH D AH V AE K AH NG
MEDICK	M EH D AH K
MEDICKS	M EH D AH K S
MEGABUCK	M EH G AH B AH K
MEGABUCKS	M EH G AH B AH K S
METERSTICK	M IY T ER S T IH K
METERSTICKS	M IY T ER S T IH K S
MICK	M IH K
MICKEY	M IH K IY
MICKEYS	M IH K EY Z
MICKLE	M IH K AH L
MICKLER	M IH K L ER
MICKLES	M IH K AH L Z
MICKLEST	M IH K AH L AH S T
MICKS	M IH K S
MIMICKED	M IH M IH K T
MIMICKER	M AH M IH K AH R
MIMICKERS	M AH M IH K AH R Z
MIMICKING	M IH M IH K IH NG
MISKICK	M IH S K IH K
MISKICKED	M IH S K IH K T
MISKICKING	M IH S K IH K IH NG
MISKICKS	M IH S K IH K S
MISPACKAGE	M IH S P AE S IH JH
MISPACKAGED	M IH S P AE S IH JH D
MISPACKAGES	M IH S P AE S IH JH IH Z
MISPACKAGING	M IH S P AE S IH JH IH NG
MISRECKON	M IH S R EH K AH N
MISRECKONED	M IH S R EH K AH N D
MISRECKONING	M IH S R EH K AH N IH NG
MISRECKONS	M IH S R EH K AH N Z
MISSTRICKEN	M IH S T R IH K AH N
MISSTRUCK	M IH S T R AH K
MOCK	M AA K
MOCKABLE	M AA K AH B AH L
MOCKED	M AA K T
MOCKER	M AA K ER
MOCKERIES	M AA K AH R IY Z
MOCKERS	M AA K ER Z
MOCKERY	M AA K ER IY
MOCKING	M AA K IH NG
MOCKINGBIRD	M AA K IH NG B ER D
MOCKINGBIRDS	M AA K IH NG B ER D Z
MOCKINGLY	M AA K IH NG L IY
MOCKS	M AA K S
MOCKUP	M AA K AH P
MOCKUPS	M AA K AH P S
MONADNOCK	M AA N AE D N AA K
MONADNOCKS	M AH N AE D N AH K S
MONICKER	M AH N IH K AH R
MONICKERS	M AH N IH K AH R Z
MOONSTRUCK	M UW N S T R AH K
MOORCOCK	M UH R K AA K
MOORCOCKS	M UH R K AA K S
MOSAICKED	M OW Z EY IH K T
MOSAICKING	M OW Z EY IH K IH NG
MOSSBACK	M AO S B AE K
MOSSBACKED	M AO S B AE K T
MOSSBACKS	M AO S B AE K S
MOTHERFUCKER	M AH DH ER F AH K ER
MOTHERFUCKERS	M AH DH ER F AH K ER Z
MOTHERFUCKING	M AH DH ER F AH K IH NG
MOTORTRUCK	M OW T ER T R AH K
MOTORTRUCKS	M OW T ER T R AH K S
MUCK	M AH K
MUCKAMUCK	M AH K AH M AH K
MUCKAMUCKS	M AH K AH M AH K S
MUCKED	M AH K T
MUCKER	M AH K ER
MUCKERS	M AH K ER Z
MUCKIER	M AH K IY ER
MUCKIEST	M AH K IY AH S T
MUCKILY	M AH K IY L IY
MUCKING	M AH K IH NG
MUCKLE	M AH K AH L
MUCKLES	M AH K AH L Z
MUCKLUCK	M AH K L AH K
MUCKLUCKS	M AH K L AH K S
MUCKRAKE	M AH K R EY K
MUCKRAKED	M AH K R EY K T
MUCKRAKER	M AH K R EY K ER
MUCKRAKERS	M AH K R EY K ER Z
MUCKRAKES	M AH K R EY K S
MUCKRAKING	M AH K R EY K IH NG
MUCKS	M AH K S
MUCKWORM	M AH K W ER M
MUCKWORMS	M AH K W ER M Z
MUCKY	M AH K IY
MUDPACK	M AH D P AE K
MUDPACKS	M AH D P AE K S
MUDROCK	M AH D R AA K
MUDROCKS	M AH D R AA K S
MULLOCK	M UH L AH K
MULLOCKS	M UH L AH K S
MULLOCKY	M UH L AA K IY
MULTITRACK	M AH L T AY T R AE K
MULTITRACKED	M AH L T AY T R AE K T
MULTITRACKING	M AH L T AY T R AE K IH NG
MULTITRACKS	M AH L T AY T R AE K S
NECK	N EH K
NECKBAND	N EH K B AE N D
NECKBANDS	N EH K B AE N D Z
NECKED	N EH K T
NECKER	N EH K ER
NECKERCHIEF	N EH K ER CH IY F
NECKERCHIEFS	N EH K ER CH IY F S
NECKERCHIEVES	N EH K AH R CH IY V Z
NECKERS	N EH K ER Z
NECKING	N EH K IH NG
NECKINGS	N EH K IH NG Z
NECKLACE	N EH K L AH S
NECKLACES	N EH K L AH S IH Z
NECKLESS	N EH K L AH S
NECKLIKE	N EH K L AY K
NECKLINE	N EH K L AY N
NECKLINES	N EH K L AY N Z
NECKS	N EH K S
NECKTIE	N EH K T AY
NECKTIES	N EH K T AY Z
NECKWEAR	N EH K W EH R
NIBLICK	N IH B L IH K
NIBLICKS	N IH B L IH K S
NICK	N IH K
NICKED	N IH K T
NICKEL	N IH K AH L
NICKELED	N IH K AH L D
NICKELIC	N IH K AH L IH K
NICKELIFEROUS	N IH K AH L IH F AH R AH S
NICKELING	N IH K AH L IH NG
NICKELLED	N IH K AH L D
NICKELLING	N IH K AH L IH NG
NICKELODEON	N IH K IH L OW D IY AH N
NICKELODEONS	N IH K AH L OW D IY AH N Z
NICKELS	N IH K AH L Z
NICKER	N IH K ER
NICKERED	N IH K ER D
NICKERING	N IH K ER IH NG
NICKERS	N IH K ER Z
NICKING	N IH K IH NG
NICKLE	N IH K AH L
NICKLED	N IH K L EH D
NICKLES	N IH K AH L Z
NICKLING	N IH K L IH NG
NICKNACK	N IH K N AH K
NICKNACKS	N IH K N AH K S
NICKNAME	N IH K N EY M
NICKNAMED	N IH K N EY M D
NICKNAMER	N IH K N EY M ER
NICKNAMERS	N IH K N EY M ER Z
NICKNAMES	N IH K N EY M Z
NICKNAMING	N IH K N EY M IH NG
NICKS	N IH K S
NIGHTSTICK	N AY T S T IH K
NIGHTSTICKS	N AY T S T IH K S
NITPICK	N IH T P IH K
NITPICKED	N IH T AH K T
NITPICKER	N IH T IH K AH R
NITPICKERS	N IH T IH K AH R Z
NITPICKIER	N IH T IH K AY AH R
NITPICKIEST	N IH T IH K AY AH S T
NITPICKING	N IH T P IH K IH NG
NITPICKS	N IH T AH K S
NITPICKY	N IH T P IH K IY
NOCK	N AA K
NOCKED	N AA K T
NOCKING	N AA K AH NG
NOCKS	N AA K S
NONBLACK	N AA N B L AE K
NONBLACKS	N AA N B L AE K S
NONSTICK	N AA N S T IH K
NOTCHBACK	N AA CH B AE K
NOTCHBACKS	N AA CH B AE K S
NUDNICK	N AH D N AH K
NUDNICKS	N AH D N AH K S
NUTCRACKER	N AH T K R AE K ER
NUTCRACKERS	N AH T K R AE K ER Z
NUTPICK	N AH T P IH K
NUTPICKS	N AH T P IH K S
OARLOCK	AO R L AA K
OARLOCKS	OW R L AH K S
OCKER	AA K ER
OCKERS	AA K AH R Z
OFFTRACK	AO F T R AE K
OOMIACK	UW M IY AH K
OOMIACKS	UW M IY AH K S
OUTBACK	AW T B AE K
OUTBACKS	AW T B AE K S
OUTKICK	AW T K IH K
OUTKICKED	AW T K IH K T
OUTKICKING	AW T K IH K IH NG
OUTKICKS	AW T K IH K S
OUTPOLITICK	AW T P AA L AH T IH K
OUTPOLITICKED	AW T P AA L AH T IH K T
OUTPOLITICKING	AW T P AA L AH T IH K IH NG
OUTPOLITICKS	AW T P AA L AH T IH K S
OUTROCK	AW T R AA K
OUTROCKED	AW T R AA K T
OUTROCKING	AW T R AA K IH NG
OUTROCKS	AW T R AA K S
OUTSLICK	AW T S L IH K
OUTSLICKED	AW T S L IH K T
OUTSLICKING	AW T S L IH K IH NG
OUTSLICKS	AW T S L IH K S
OUTTRICK	AW T R IH K
OUTTRICKED	AW T R IH K T
OUTTRICKING	AW T R IH K IH NG
OUTTRICKS	AW T R IH K S
OVERDECK	OW V ER D EH K
OVERDECKED	OW V ER D EH K T
OVERDECKING	OW V ER D EH K IH NG
OVERDECKS	OW V ER D EH K S
OVERPACKAGE	OW V ER P AE S IH JH
OVERPACKAGED	OW V ER P AE S IH JH D
OVERPACKAGES	OW V ER P AE S IH JH IH Z
OVERPACKAGING	OW V ER P AE S IH JH IH NG
OVERSICK	OW V ER S IH K
OVERSTOCK	OW V ER S T AA K
OVERSTOCKED	OW V ER S T AA K T
OVERSTOCKING	OW V ER S T AA K IH NG
OVERSTOCKS	OW V ER S T AA K S
OVERSTRUCK	OW V ER S T R AH K
OVERTRICK	OW V ER T R IH K
OVERTRICKS	OW V ER T R IH K S
OXPECKER	AA K S P EH K ER
OXPECKERS	AA K S P EH K ER Z
PACK	P AE K
PACKABILITIES	P AE S AH B IH L AH T EH Z
PACKABILITY	P AE S AH B IH L AH T EH
PACKABLE	P AE S AH B AH L
PACKAGE	P AE K AH JH
PACKAGE(2)	P AE K IH JH
PACKAGED	P AE K IH JH D
PACKAGER	P AE K IH JH ER
PACKAGERS	P AE K IH JH ER Z
PACKAGES	P AE K AH JH AH Z
PACKAGES(2)	P AE K IH JH IH Z
PACKAGING	P AE K IH JH IH NG
PACKBOARD	P AE K B OW R D
PACKBOARDS	P AE K B OW R D Z
PACKED	P AE K T
PACKER	P AE K ER
PACKERS	P AE K ER Z
PACKET	P AE K AH T
PACKET(2)	P AE K IH T
PACKETED	P AE K AH T IH D
PACKETING	P AE K AH T IH NG
PACKETS	P AE K IH T S
PACKHORSE	P AE K HH AO R S
PACKHORSES	P AE K HH AO R S IH Z
PACKING	P AE K IH NG
PACKINGHOUSE	P AE K IH NG HH AW S
PACKINGHOUSES	P AE K IH NG HH AW S IH Z
PACKINGS	P AE K IH NG Z
PACKLY	P AE K L IY
PACKMAN	P AE K M AH N
PACKMEN	P AE K M EH N
PACKNESS	P AE K N AH S
PACKNESSES	P AE K N AH S IH Z
PACKS	P AE K S
PACKSACK	P AE K S AE K
PACKSACKS	P AE K S AE K S
PACKSADDLE	P AE K S AE D AH L
PACKSADDLES	P AE K S AE D AH L Z
PACKTHREAD	P AE K TH R EH D
PACKTHREADS	P AE K TH R EH D Z
PACKWAX	P AE K W AE K S
PACKWAXES	P AE K W AE K S IH Z
PADDOCK	P AE D AH K
PADDOCKED	P AE D AH K T
PADDOCKING	P AE D AH K IH NG
PADDOCKS	P AE D AH K S
PADLOCK	P AE D L AA K
PADLOCKED	P AE D L AA K T
PADLOCKING	P AE D L AA K IH NG
PADLOCKS	P AE D L AA K S
PANICKED	P AE N IH K T
PANICKIER	P AE N IH K IY ER
PANICKIEST	P AE N IH K IY AH S T
PANICKING	P AE N IH K IH NG
PANICKY	P AE N IH K IY
PAPERBACK	P EY P ER B AE K
PAPERBACKED	P EY P ER B AE K T
PAPERBACKS	P EY P ER B AE K S
PARBUCKLE	P AA R B AH K AH L
PARBUCKLED	P AA R B AH K AH L D
PARBUCKLES	P AA R B AH K AH L Z
PARBUCKLING	P AA R B AH K L IH NG
PAYBACK	P EY B AE K
PAYBACKS	P EY B AE K S
PAYCHECK	P EY CH EH K
PAYCHECKS	P EY CH EH K S
PEACOCK	P IY K AA K
PEACOCKED	P IY K AA K T
PEACOCKIER	P IY K AA K IY ER
PEACOCKIEST	P IY K AA K IY AH S T
PEACOCKING	P IY K AA K IH NG
PEACOCKISH	P IY K AA K IH SH
PEACOCKS	P IY K AA K S
PEACOCKY	P IY K AA K IY
PECK	P EH K
PECKED	P EH K T
PECKER	P EH K ER
PECKERS	P EH K ER Z
PECKERWOOD	P EH K ER W UH D
PECKERWOODS	P EH K ER W UH D Z
PECKIER	P EH K IY ER
PECKIEST	P EH K IY AH S T
PECKING	P EH K IH NG
PECKISH	P EH K IH SH
PECKS	P EH K S
PECKY	P EH K IY
PENSTOCK	P EH N S T AA K
PENSTOCKS	P EH N S T AA K S
PENUCKLE	P EH N AH K AH L
PENUCKLES	P EH N AH K AH L Z
PERNICKETY	P AH R N IH K AH T IY
PERSNICKETINESS	P AH R S N IH K EH T AH N AH S
PERSNICKETINESSES	P AH R S N IH K EH T AH N EH S AH Z
PERSNICKETY	P AH R S N IH K AH T IY
PETCOCK	P EH T K AA K
PETCOCKS	P EH T K AA K S
PHYSICKED	F IH S AH K T
PHYSICKING	F AH S IH K AH NG
PICK	P IH K
PICKABACK	P IH K AH B AE K
PICKABACKED	P IH K AH B AE K T
PICKABACKING	P IH K AH B AE K IH NG
PICKABACKS	P IH K AH B AE K S
PICKADIL	P IH K AH D AH L
PICKADILS	P IH K AH D AH L Z
PICKANINNIES	P IH K AH N IH N AY Z
PICKANINNY	P IH K AH N IH N IY
PICKAROON	P IH K AH R UW N
PICKAROONS	P IH K AH R UW N Z
PICKAX	P IH K AE K S
PICKAXE	P IH K AE K S
PICKAXED	P IH K AE K S T
PICKAXES	P IH K AE K S IH Z
PICKAXING	P IH K AE K S IH NG
PICKED	P IH K T
PICKEER	P IH K IH R
PICKEERED	P IH K IH R D
PICKEERING	P IH K IH R IH NG
PICKEERS	P IH K IH R Z
PICKER	P IH K ER
PICKEREL	P IH K ER AH L
PICKERELS	P IH K AH R AH L Z
PICKERELWEED	P IH K AH R EH L W IY D
PICKERELWEEDS	P IH K EH R AH L W IY D Z
PICKERS	P IH K ER Z
PICKET	P IH K IH T
PICKETBOAT	P IH K AH T B OW T
PICKETBOATS	P IH K AH T B OW T S
PICKETED	P IH K AH T IH D
PICKETER	P IH K AH T ER
PICKETERS	P IH K AH T ER Z
PICKETING	P IH K AH T IH NG
PICKETS	P IH K AH T S
PICKIER	P IH K IY ER
PICKIEST	P IH K IY AH S T
PICKING	P IH K IH NG
PICKINGS	P IH K IH NG Z
PICKLE	P IH K AH L
PICKLED	P IH K AH L D
PICKLES	P IH K AH L Z
PICKLING	P IH K L IH NG
PICKLOCK	P IH K L AA K
PICKLOCKS	P IH K L AA K S
PICKOFF	P IH K AO F
PICKOFFS	P IH K AO F S
PICKPOCKET	P IH K P AA K AH T
PICKPOCKETS	P IH K P AA K AH T S
PICKPROOF	P IH K P R UW F
PICKS	P IH K S
PICKTHANK	P IH K TH AE NG K
PICKTHANKS	P IH K TH AE NG K S
PICKUP	P IH K AH P
PICKUPS	P IH K AH P S
PICKWICK	P IH K W IH K
PICKWICKS	P IH K W IH K S
PICKY	P IH K IY
PICNICKED	P IH K N IH K T
PICNICKER	P IH K N IH K ER
PICNICKERS	P IH K N IH K ER Z
PICNICKING	P IH K N IH K IH NG
PICNICKY	P IH K N IH K IY
PIDDOCK	P IH D AH K
PIDDOCKS	P IH D AH K S
PIGGYBACK	P IH G IY B AE K
PIGGYBACKED	P IH G IY B AE K T
PIGGYBACKING	P IH G IY B AE K IH NG
PIGGYBACKS	P IH G IY B AE K S
PIGSTICK	P IH G S T IH K
PIGSTICKED	P IH G S T IH K T
PIGSTICKER	P IH G S T IH K ER
PIGSTICKERS	P IH G S T IH K ER Z
PIGSTICKING	P IH G S T IH K IH NG
PIGSTICKS	P IH G S T IH K S
PINCHBECK	P IH N CH B EH K
PINCHBECKS	P IH N CH B EH K S
PINCHECK	P IH N CH EH K
PINCHECKS	P IH N CH EH K S
PINPRICK	P IH N P R IH K
PINPRICKED	P IH N P R IH K T
PINPRICKING	P IH N P R IH K IH NG
PINPRICKS	P IH N P R IH K S
PLACEKICK	P L EY S K IH K
PLACEKICKED	P L EY S K IH K T
PLACEKICKER	P L EY S K IH K ER
PLACEKICKERS	P L EY S K IH K ER Z
PLACEKICKING	P L EY S K IH K IH NG
PLACEKICKS	P L EY S K IH K S
PLACK	P L AE K
PLACKET	P L AE K AH T
PLACKETS	P L AE K AH T S
PLACKS	P L AE K S
PLASTICKY	P L AE S T IH K IY
PLAYBACK	P L EY B AE K
PLAYBACKS	P L EY B AE K S
PLOWBACK	P L AW B AE K
PLOWBACKS	P L AW B AE K S
PLUCK	P L AH K
PLUCKED	P L AH K T
PLUCKER	P L AH K ER
PLUCKERS	P L AH K ER Z
PLUCKIER	P L AH K IY ER
PLUCKIEST	P L AH K IY AH S T
PLUCKILY	P L AH K IY L IY
PLUCKINESS	P L AH K IY N AH S
PLUCKINESSES	P L AH K IY N AH S IH Z
PLUCKING	P L AH K IH NG
PLUCKS	P L AH K S
PLUCKY	P L AH K IY
POCK	P AA K
POCKED	P AA K T
POCKET	P AA K AH T
POCKETABLE	P AA K AH T AH B AH L
POCKETBOOK	P AA K AH T B UH K
POCKETBOOKS	P AA K AH T B UH K S
POCKETED	P AA K AH T IH D
POCKETER	P AA K AH T ER
POCKETERS	P AA K AH T ER Z
POCKETFUL	P AA K AH T F UH L
POCKETFULS	P AA K AH T F UH L Z
POCKETING	P AA K AH T IH NG
POCKETKNIFE	P AA K AH T N AY F
POCKETKNIVES	P AA K AH T N AY V Z
POCKETS	P AA K AH T S
POCKETSFUL	P AA K AH T S F AH L
POCKIER	P AA K AY AH R
POCKIEST	P AA K AY AH S T
POCKILY	P AA K AH L IY
POCKING	P AA K AH NG
POCKMARK	P AA K M AA R K
POCKMARKED	P AA K M AA R K T
POCKMARKING	P AA K M AA R K AH NG
POCKMARKS	P AA K M AH R K S
POCKS	P AA K S
POCKY	P AA K IY
POLITICK	P AA L AH T IH K
POLITICKED	P AA L AH T IH K T
POLITICKER	P AA L AH T IH K ER
POLITICKERS	P AA L AH T IH K ER Z
POLITICKING	P AA L AH T IH K IH NG
POLITICKS	P AA L AH T IH K S
POLLACK	P AA L AH K
POLLACKS	P AA L AH K S
POLLOCK	P AA L AH K
POLLOCKS	P AA L AH K S
POPPYCOCK	P AA P IY K AO K
POPPYCOCKS	P AA P IY K AA K S
PORTAPACK	P OW R T AH P AE K
PORTAPACKS	P OW R T AH P AE K S
POSTATTACK	P OW S T AH T AE K
POTLUCK	P AA T L AH K
POTLUCKS	P AA T L AH K S
PRECHECK	P R IY CH EH K
PRECHECKED	P R IY CH EH K T
PRECHECKING	P R IY CH EH K IH NG
PRECHECKS	P R IY CH EH K S
PREPACK	P R IY P AE K
PREPACKAGE	P R IY P AE K AH JH
PREPACKAGED	P R IY P AE K AH JH D
PREPACKAGES	P R IY P AE S IH JH IH Z
PREPACKAGING	P R IY P AE S IH JH IH NG
PREPACKED	P R IY P AE K T
PREPACKING	P R IY P AE K IH NG
PREPACKS	P R IY P AE K S
PREROCK	P R IY R AA K
PRICK	P R IH K
PRICKED	P R IH K T
PRICKER	P R IH K ER
PRICKERS	P R IH K ER Z
PRICKET	P R IH K AH T
PRICKETS	P R IH K AH T S
PRICKIER	P R IH K IY ER
PRICKIEST	P R IH K IY AH S T
PRICKING	P R IH K IH NG
PRICKINGS	P R IH K IH NG Z
PRICKLE	P R IH K AH L
PRICKLED	P R IH K L EH D
PRICKLES	P R IH K AH L Z
PRICKLIER	P R IH K L IY ER
PRICKLIEST	P R IH K L IY AH S T
PRICKLINESS	P R IH K L IY N AH S
PRICKLINESSES	P R IH K L IY N AH S IH Z
PRICKLING	P R IH K L IH NG
PRICKLY	P R IH K L IY
PRICKS	P R IH K S
PRICKY	P R IH K IY
PRINCOCK	P R IH NG K AH K
PRINCOCKS	P R IH NG K AH K S
PUCK	P AH K
PUCKA	P AH K AH
PUCKER	P AH K ER
PUCKERED	P AH K ER D
PUCKERER	P AH K ER ER
PUCKERERS	P AH K ER ER Z
PUCKERIER	P AH K AH R IY ER
PUCKERIEST	P AH K AH R IY AH S T
PUCKERING	P AH K ER IH NG
PUCKERS	P AH K ER Z
PUCKERY	P AH K AH R IY
PUCKISH	P AH K IH SH
PUCKISHLY	P AH K IH SH L IY
PUCKISHNESS	P AH K IH SH N AH S
PUCKISHNESSES	P AH K IH SH N AH S IH Z
PUCKS	P AH K S
PULLBACK	P UH L B AE K
PULLBACKS	P UH L B AE K S
PUMPERNICKEL	P AH M P ER N IH K AH L
PUMPERNICKELS	P AH M P ER N IH K AH L Z
QUACK	K W AE K
QUACKED	K W AE K T
QUACKERIES	K W AE K AH R IY Z
QUACKERY	K W AE K ER IY
QUACKING	K W AE K IH NG
QUACKISH	K W AE K IH SH
QUACKISM	K W AE K IH Z AH M
QUACKISMS	K W AE K IH Z AH M Z
QUACKS	K W AE K S
QUACKSALVER	K W AE K S AA V ER
QUACKSALVERS	K W AE K S AA V ER Z
QUARTERBACK	K W AO R T ER B AE K
QUARTERBACKED	K W AO R T ER B AE K T
QUARTERBACKING	K W AO R T ER B AE K IH NG
QUARTERBACKS	K W AO R T ER B AE K S
QUARTERDECK	K W AO R T ER D EH K
QUARTERDECKS	K W AO R T ER D EH K S
QUICK	K W IH K
QUICKEN	K W IH K AH N
QUICKENED	K W IH K AH N D
QUICKENER	K W IH K AH N ER
QUICKENERS	K W IH K AH N ER Z
QUICKENING	K W IH K AH N IH NG
QUICKENS	K W IH K AH N Z
QUICKER	K W IH K ER
QUICKEST	K W IH K IH S T
QUICKIE	K W IH K IY
QUICKIES	K W IH K IY Z
QUICKLIME	K W IH K L AY M
QUICKLIMES	K W IH K L AY M Z
QUICKLY	K W IH K L IY
QUICKNESS	K W IH K N AH S
QUICKNESSES	K W IH K N AH S IH Z
QUICKS	K W IH K S
QUICKSAND	K W IH K S AE N D
QUICKSANDS	K W IH K S AE N D Z
QUICKSET	K W IH K S EH T
QUICKSETS	K W IH K S EH T S
QUICKSILVER	K W IH K S IH L V ER
QUICKSILVERS	K W IH K S IH L V ER Z
QUICKSTEP	K W IH K S T EH P
QUICKSTEPS	K W IH K S T EH P S
QUILLBACK	K W IH L B AE K
QUILLBACKS	K W IH L B AE K S
RACETRACK	R EY S T R AE K
RACETRACKER	R EY S T R AE K ER
RACETRACKERS	R EY S T R AE K ER Z
RACETRACKS	R EY S T R AE K S
RACK	R AE K
RACKED	R AE K T
RACKER	R AE K ER
RACKERS	R AE K ER Z
RACKET	R AE K IH T
RACKETED	R AE K AH T IH D
RACKETEER	R AE K IH T IH R
RACKETEERED	R AE K AH T IH R D
RACKETEERING	R AE K IH T IH R IH NG
RACKETEERS	R AE K AH T IH R Z
RACKETIER	R AE K AH T IY ER
RACKETIEST	R AE K AH T IY AH S T
RACKETING	R AE K AH T IH NG
RACKETS	R AE K AH T S
RACKETY	R AE K AH T IY
RACKFUL	R AE K F AH L
RACKFULS	R AE K F AH L Z
RACKING	R AE K IH NG
RACKINGLY	R AE K IH NG L IY
RACKLE	R AE K AH L
RACKS	R AE K S
RACKWORK	R AE K W ER K
RACKWORKS	R AE K W ER K S
RAGPICKER	R AE G P IH K ER
RAGPICKERS	R AE G P IH K ER Z
RAINCHECK	R EY N CH EH K
RAINCHECKS	R EY N CH EH K S
RAMSHACKLE	R AE M SH AE K AH L
RANSACK	R AE N S AE K
RANSACKED	R AE N S AE K T
RANSACKER	R AE N S AE K ER
RANSACKERS	R AE N S AE K ER Z
RANSACKING	R AE N S AE K IH NG
RANSACKS	R AE N S AE K S
RAZORBACK	R EY Z ER B AE K
RAZORBACKS	R EY Z ER B AE K S
REATTACK	R IY AH T AE K
REATTACKED	R IY AH T AE K T
REATTACKING	R IY AH T AE K IH NG
REATTACKS	R IY AH T AE K S
REBECK	R IY B EH K
REBECKS	R IY B EH K S
RECHECK	R IY CH EH K
RECHECKED	R IY CH EH K T
RECHECKING	R IY CH EH K IH NG
RECHECKS	R IY CH EH K S
RECK	R EH K
RECKED	R EH K T
RECKING	R EH K IH NG
RECKLESS	R EH K L AH S
RECKLESSLY	R EH K L AH S L IY
RECKLESSNESS	R EH K L AH S N AH S
RECKLESSNESSES	R EH K L AH S N AH S IH Z
RECKON	R EH K AH N
RECKONED	R EH K AH N D
RECKONER	R EH K AH N ER
RECKONERS	R EH K AH N ER Z
RECKONING	R EH K AH N IH NG
RECKONING(2)	R EH K N IH NG
RECKONINGS	R EH K AH N IH NG Z
RECKONS	R EH K AH N Z
RECKS	R EH K S
RECOCK	R IY K AA K
RECOCKED	R IY K AA K T
RECOCKING	R IY K AA K IH NG
RECOCKS	R IY K AA K S
REDBRICK	R EH D B R IH K
REDBRICKS	R EH D B R IH K S
REDNECK	R EH D N EH K
REDNECKED	R EH D N EH K T
REDNECKS	R EH D N EH K S
REDOCK	R IY D AA K
REDOCKED	R IY D AA K T
REDOCKING	R IY D AA K IH NG
REDOCKS	R IY D AA K S
REEDBUCK	R IY D B AH K
REEDBUCKS	R IY D B AH K S
REJACKET	R IY JH AE K AH T
REJACKETED	R IY JH AE K AH T IH D
REJACKETING	R IY JH AE K AH T IH NG
REJACKETS	R IY JH AE K AH T S
RELOCK	R IY L AA K
RELOCKED	R IY L AA K T
RELOCKING	R IY L AA K IH NG
RELOCKS	R IY L AA K S
REPACK	R IY P AE K
REPACKAGE	R IY P AE K IH JH
REPACKAGED	R IY P AE K IH JH D
REPACKAGER	R IY P AE S IH JH ER
REPACKAGERS	R IY P AE S IH JH ER Z
REPACKAGES	R IY P AE K IH JH IH Z
REPACKAGING	R IY P AE K IH JH IH NG
REPACKED	R IY P AE K T
REPACKING	R IY P AE K IH NG
REPACKS	R IY P AE K S
RERACK	R IY R AE K
RERACKED	R IY R AE K T
RERACKING	R IY R AE K IH NG
RERACKS	R IY R AE K S
RESTACK	R IY S T AE K
RESTACKED	R IY S T AE K T
RESTACKING	R IY S T AE K IH NG
RESTACKS	R IY S T AE K S
RESTOCK	R IY S T AA K
RESTOCKED	R IY S T AA K T
RESTOCKING	R IY S T AA K IH NG
RESTOCKS	R IY S T AA K S
RESTRICKEN	R IY S T R IH K AH N
RESTRUCK	R IY S T R AH K
RETACK	R IY T AE K
RETACKED	R IY T AE K T
RETACKING	R IY T AE K IH NG
RETACKLE	R IY T AE K AH L
RETACKLED	R IY T AE K AH L D
RETACKLES	R IY T AE K AH L Z
RETACKLING	R IY T AE K L IH NG
RETACKS	R IY T AE K S
RETRACK	R IY T R AE K
RETRACKED	R IY T R AE K T
RETRACKING	R IY T R AE K IH NG
RETRACKS	R IY T R AE K S
RETROPACK	R IH T R AA P AH K
RETROPACKS	R IH T R AA P AH K S
RETROROCKET	R IH T R AH R AA K AH T
RETROROCKETS	R IH T R AH R AA K AH T S
RICK	R IH K
RICKED	R IH K T
RICKETIER	R IH K AH T IY ER
RICKETIEST	R IH K AH T IY AH S T
RICKETS	R IH K IH T S
RICKETTSIA	R IH K EH T S IY AH
RICKETTSIAE	R IH K EH T S IY IY
RICKETTSIAL	R IH K EH T S IY AH L
RICKETTSIAS	R IH K EH T S IY AH Z
RICKETY	R IH K AH T IY
RICKEY	R IH K IY
RICKEYS	R IH K IY Z
RICKING	R IH K AH NG
RICKRACK	R IH K R AH K
RICKRACKS	R IH K R AH K S
RICKS	R IH K S
RICKSHA	R IH K AH
RICKSHAS	R IH K AH Z
RICKSHAW	R IH K SH AO
RICKSHAWS	R IH K SH AO Z
RIMROCK	R IH M R AA K
RIMROCKS	R IH M R AA K S
RINGNECK	R IH NG N EH K
RINGNECKS	R IH NG N EH K S
ROADBLOCK	R OW D B L AA K
ROADBLOCKED	R OW D B L AA K T
ROADBLOCKING	R OW D B L AA K IH NG
ROADBLOCKS	R OW D B L AA K S
ROCK	R AA K
ROCKABIES	R AA K AH B AY Z
ROCKABILLIES	R AA K AH B IH L IY Z
ROCKABILLY	R AA K AH B IH L IY
ROCKABY	R AA K AH B AY
ROCKABYE	R AA K AH B AY
ROCKABYES	R AA K AH B AY Z
ROCKAWAY	R AA K AH W EY
ROCKAWAYS	R AA K AH W EY Z
ROCKBOUND	R AA K B AW N D
ROCKED	R AA K T
ROCKER	R AA K ER
ROCKERIES	R AA K AH R IY Z
ROCKERS	R AA K ER Z
ROCKERY	R AA K AH R IY
ROCKET	R AA K AH T
ROCKETED	R AA K AH T IH D
ROCKETEER	R AA K AH T IH R
ROCKETEERS	R AA K AH T IH R Z
ROCKETER	R AA K AH T ER
ROCKETERS	R AA K AH T ER Z
ROCKETING	R AA K AH T IH NG
ROCKETRIES	R AA K AH T R IY Z
ROCKETRY	R AA K AH T R IY
ROCKETS	R AA K AH T S
ROCKFALL	R AA K F AO L
ROCKFALLS	R AA K F AO L Z
ROCKFISH	R AA K F IH SH
ROCKFISHES	R AA K F IH SH IH Z
ROCKHOPPER	R AA K HH AA P ER
ROCKHOPPERS	R AA K HH AA P ER Z
ROCKHOUND	R AA K HH AW N D
ROCKHOUNDING	R AA K HH AW N D IH NG
ROCKHOUNDINGS	R AA K HH AW N D IH NG Z
ROCKHOUNDS	R AA K HH AW N D Z
ROCKIER	R AA K IY ER
ROCKIEST	R AA K IY AH S T
ROCKINESS	R AA K IY N AH S
ROCKINESSES	R AA K IY N AH S IH Z
ROCKING	R AA K IH NG
ROCKLESS	R AA K L AH S
ROCKLIKE	R AA K L AY K
ROCKLING	R AA K L IH NG
ROCKLINGS	R AA K L IH NG Z
ROCKOON	R AA K UW N
ROCKOONS	R AA K UW N Z
ROCKROSE	R AA K R OW Z
ROCKROSES	R AA K R OW Z IH Z
ROCKS	R AA K S
ROCKSHAFT	R AA K SH AE F T
ROCKSHAFTS	R AA K SH AE F T S
ROCKSLIDE	R AA K S L AY D
ROCKSLIDES	R AA K S L AY D Z
ROCKWEED	R AA K W IY D
ROCKWEEDS	R AA K W IY D Z
ROCKWORK	R AA K W ER K
ROCKWORKS	R AA K W ER K S
ROCKY	R AA K IY
ROEBUCK	R OW B AH K
ROEBUCKS	R OW B AH K S
ROLLBACK	R OW L B AE K
ROLLBACKS	R OW L B AE K S
ROLLICK	R AA L IH K
ROLLICKED	R AA L IH K T
ROLLICKING	R AA L IH K IH NG
ROLLICKS	R AA L IH K S
ROLLICKY	R AA L IH K IY
ROORBACK	R OW ER B AE K
ROORBACKS	R OW ER B AE K S
ROOTSTOCK	R UW T S T AA K
ROOTSTOCKS	R UW T S T AA K S
ROUGHNECK	R AH F N EH K
ROUGHNECKS	R AH F N EH K S
ROWLOCK	R OW L AA K
ROWLOCKS	R OW L AA K S
RUBBERNECK	R AH B ER N EH K
RUBBERNECKED	R AH B ER N EH K T
RUBBERNECKER	R AH B ER N EH K ER
RUBBERNECKERS	R AH B ER N EH K ER Z
RUBBERNECKING	R AH B ER N EH K IH NG
RUBBERNECKS	R AH B ER N EH K S
RUCK	R AH K
RUCKED	R AH K T
RUCKING	R AH K AH NG
RUCKLE	R AH K AH L
RUCKLED	R AH K AH L D
RUCKLES	R AH K AH L Z
RUCKLING	R AH K L AH NG
RUCKS	R AH K S
RUCKSACK	R AH K S AE K
RUCKSACKS	R AH K S AH K S
RUCKUS	R AH K AH S
RUCKUSES	R AH K AH S IH Z
RUDBECKIA	R AH D EH K IY AH
RUDBECKIAS	R AH D EH K IY AH Z
RUDDOCK	R AH D AH K
RUDDOCKS	R AH D AH K S
RUNBACK	R AH N B AE K
RUNBACKS	R AH N B AE K S
SACK	S AE K
SACKBUT	S AE K B AH T
SACKBUTS	S AE K B Y UW T S
SACKCLOTH	S AE K L AO TH
SACKCLOTHS	S AE K L AO TH S
SACKED	S AE K T
SACKER	S AE K ER
SACKERS	S AE K ER Z
SACKFUL	S AE K F AH L
SACKFULS	S AE K F AH L Z
SACKING	S AE K IH NG
SACKINGS	S AE K IH NG Z
SACKLIKE	S AE K L AY K
SACKS	S AE K S
SACKSFUL	S AE K S F AH L
SAFECRACKER	S EY F K R AE K ER
SAFECRACKERS	S EY F K R AE K ER Z
SAFECRACKING	S EY F K R AE K IH NG
SAFECRACKINGS	S EY F K R AE K IH NG Z
SAPSUCKER	S AE P S AH K ER
SAPSUCKERS	S AE P S AH K ER Z
SAWBUCK	S AO B AH K
SAWBUCKS	S AO B AH K S
SCATBACK	S K AE T B AH K
SCATBACKS	S K AE T B AH K S
SCHLOCK	SH L AA K
SCHLOCKMEISTER	S K L AA K M IY S T AH R
SCHLOCKMEISTERS	S K L AA K M IY S T AH R Z
SCHLOCKS	S K L AA K S
SCHLOCKY	S K L AA K IY
SCHMUCK	SH M AH K
SCHMUCKS	S K M AH K S
SCHNECKE	S K N EH K
SCHNECKEN	S K N EH K AH N
SCHTICK	SH T IH K
SCHTICKS	S K T IH K S
SEACOCK	S IY K AA K
SEACOCKS	S IY K AA K S
SEASICK	S IY S IH K
SEASICKNESS	S IY S IH K N AH S
SEASICKNESSES	S IY S IH K N AH S IH Z
SEERSUCKER	S IH ER S AH K ER
SEERSUCKERS	S IH ER S AH K ER Z
SETBACK	S EH T B AE K
SETBACKS	S EH T B AE K S
SHACK	SH AE K
SHACKLE	SH AE K AH L
SHACKLEBONE	SH AE K AH L B OW N
SHACKLEBONES	SH AE K AH L B OW N Z
SHACKLED	SH AE K AH L D
SHACKLER	SH AE K AH L ER
SHACKLERS	SH AE K AH L ER Z
SHACKLES	SH AE K AH L Z
SHACKLING	SH AE K L IH NG
SHACKO	SH AE K OW
SHACKOES	SH AE K OW Z
SHACKOS	SH AE K AA S
SHACKS	SH AE K S
SHADDOCK	SH AE D AH K
SHADDOCKS	SH AE D AH K S
SHAMROCK	SH AE M R AA K
SHAMROCKS	SH AE M R AA K S
SHASHLICK	SH AE SH L AH K
SHASHLICKS	SH AE SH L AH K S
SHELDUCK	SH EH L D AH K
SHELDUCKS	SH EH L D AH K S
SHELLACK	SH EH L AE K
SHELLACKED	SH EH L AE K D
SHELLACKING	SH EH L AE K IH NG
SHELLACKINGS	SH EH L AE K AH NG Z
SHELLACKS	SH EH L AH K S
SHELLBACK	SH EH L B AE K
SHELLBACKS	SH EH L B AE K S
SHELLCRACKER	SH EH L K R AE K ER
SHELLCRACKERS	SH EH L K R AE K ER Z
SHELLSHOCKED	SH EH L SH AA K T
SHERLOCK	SH ER L AA K
SHERLOCKS	SH ER L AA K S
SHICKER	SH IH K AH R
SHICKERS	SH IH K AH R Z
SHICKSA	SH IH K S AH
SHICKSAS	SH IH K S AH Z
SHIPWRECK	SH IH P R EH K
SHIPWRECKED	SH IH P R EH K T
SHIPWRECKING	SH IH P R EH K IH NG
SHIPWRECKS	SH IH P R EH K S
SHLOCK	SH L AA K
SHLOCKS	SH L AA K S
SHMUCK	SH M AH K
SHMUCKS	SH M AH K S
SHOCK	SH AA K
SHOCKABLE	SH AA K AH B AH L
SHOCKED	SH AA K T
SHOCKER	SH AA K ER
SHOCKERS	SH AA K ER Z
SHOCKING	SH AA K IH NG
SHOCKINGLY	SH AA K IH NG L IY
SHOCKPROOF	SH AA K P R UW F
SHOCKS	SH AA K S
SHOEBLACK	SH UW B L AE K
SHOEBLACKS	SH UW B L AE K S
SHOEPACK	SH UW P AE K
SHOEPACKS	SH UW P AE K S
SHTICK	SH T IH K
SHTICKS	SH T IH K S
SHUCK	SH AH K
SHUCKED	SH AH K T
SHUCKER	SH AH K ER
SHUCKERS	SH AH K ER Z
SHUCKING	SH AH K IH NG
SHUCKINGS	SH AH K IH NG Z
SHUCKS	SH AH K S
SHUTTLECOCK	SH AH T AH L K AA K
SHUTTLECOCKED	SH AH T AH L K AA K T
SHUTTLECOCKING	SH AH T AH L K AA K IH NG
SHUTTLECOCKS	SH AH T AH L K AA K S
SHYLOCK	SH AY L AA K
SHYLOCKED	SH AY L AA K T
SHYLOCKING	SH AY L AA K IH NG
SHYLOCKS	SH AY L AA K S
SICK	S IH K
SICKBAY	S IH K B EY
SICKBAYS	S IH K B EY Z
SICKBED	S IH K B EH D
SICKBEDS	S IH K B EH D Z
SICKED	S IH K T
SICKEE	S IH K IY
SICKEES	S IH K IY Z
SICKEN	S IH K AH N
SICKENED	S IH K AH N D
SICKENER	S IH K AH N ER
SICKENERS	S IH K AH N ER Z
SICKENING	S IH K AH N IH NG
SICKENING(2)	S IH K N IH NG
SICKENINGLY	S IH K AH N IH NG L IY
SICKENS	S IH K AH N Z
SICKER	S IH K ER
SICKERLY	S IH K ER L IY
SICKEST	S IH K AH S T
SICKIE	S IH K IY
SICKIES	S IH K IY Z
SICKING	S IH K IH NG
SICKISH	S IH K IH SH
SICKISHLY	S IH K IH SH L IY
SICKISHNESS	S IH K IH SH N AH S
SICKISHNESSES	S IH K IH SH N AH S IH Z
SICKLE	S IH K AH L
SICKLED	S IH K L EH D
SICKLEMIA	S IH K L IY M IY AH
SICKLEMIAS	S IH K L IY M IY AH Z
SICKLES	S IH K AH L Z
SICKLIED	S IH K L IY D
SICKLIER	S IH K L IY ER
SICKLIES	S IH K L IY Z
SICKLIEST	S IH K L IY AH S T
SICKLILY	S IH K L IY L IY
SICKLINESS	S IH K L IY N AH S
SICKLINESSES	S IH K L IY N AH S IH Z
SICKLING	S IH K L IH NG
SICKLY	S IH K L IY
SICKLYING	S IH K L IY IH NG
SICKNESS	S IH K N AH S
SICKNESSES	S IH K N AH S IH Z
SICKO	S IH K OW
SICKOS	S IH K AA S
SICKOUT	S IH K AW T
SICKOUTS	S IH K AW T S
SICKROOM	S IH K R UW M
SICKROOMS	S IH K R UW M Z
SICKS	S IH K S
SIDEKICK	S AY D K IH K
SIDEKICKS	S AY D K IH K S
SIDETRACK	S AY D T R AE K
SIDETRACKED	S AY D T R AE K T
SIDETRACKING	S AY D T R AE K IH NG
SIDETRACKS	S AY D T R AE K S
SILVERBACK	S IH L V ER B AE K
SILVERBACKS	S IH L V ER B AE K S
SINGLESTICK	S IH NG G AH L S T IH K
SINGLESTICKS	S IH NG G AH L S T IH K S
SKEWBACK	S K Y UW B AH K
SKEWBACKS	S K Y UW B AH K S
SKIPJACK	S K IH P JH AE K
SKIPJACKS	S K IH P JH AE K S
SKYJACK	S K AY JH AE K
SKYJACKED	S K AY JH AE K T
SKYJACKER	S K AY JH AE K ER
SKYJACKERS	S K AY JH AE K ER Z
SKYJACKING	S K AY JH AE K IH NG
SKYJACKINGS	S K AY JH AE K IH NG Z
SKYJACKS	S K AY JH AE K S
SKYROCKET	S K AY R AA K AH T
SKYROCKETED	S K AY R AA K AH T IH D
SKYROCKETING	S K AY R AA K AH T IH NG
SKYROCKETS	S K AY R AA K AH T S
SLACK	S L AE K
SLACKED	S L AE K T
SLACKEN	S L AE K AH N
SLACKENED	S L AE K AH N D
SLACKENING	S L AE K AH N IH NG
SLACKENS	S L AE K AH N Z
SLACKER	S L AE K ER
SLACKERS	S L AE K ER Z
SLACKEST	S L AE K AH S T
SLACKING	S L AE K IH NG
SLACKLY	S L AE K L IY
SLACKNESS	S L AE K N AH S
SLACKNESSES	S L AE K N AH S IH Z
SLACKS	S L AE K S
SLAPJACK	S L AE P JH AE K
SLAPJACKS	S L AE P JH AE K S
SLAPSTICK	S L AE P S T IH K
SLAPSTICKS	S L AE P S T IH K S
SLICK	S L IH K
SLICKED	S L IH K T
SLICKENSIDE	S L IH K AH N S AY D
SLICKENSIDES	S L IH K AH N S AY D Z
SLICKER	S L IH K ER
SLICKERS	S L IH K ER Z
SLICKEST	S L IH K AH S T
SLICKING	S L IH K IH NG
SLICKLY	S L IH K L IY
SLICKNESS	S L IH K N AH S
SLICKNESSES	S L IH K N AH S IH Z
SLICKROCK	S L IH K R AA K
SLICKROCKS	S L IH K R AA K S
SLICKS	S L IH K S
SLOTBACK	S L AA T B AE K
SLOTBACKS	S L AA T B AE K S
SMACK	S M AE K
SMACKED	S M AE K T
SMACKER	S M AE K ER
SMACKERS	S M AE K ER Z
SMACKING	S M AE K IH NG
SMACKS	S M AE K S
SMOCK	S M AA K
SMOCKED	S M AA K T
SMOCKING	S M AA K AH NG
SMOCKINGS	S M AA K AH NG Z
SMOCKS	S M AA K S
SMOKEJACK	S M OW K JH AE K
SMOKEJACKS	S M OW K JH AE K S
SMOKESTACK	S M OW K S T AE K
SMOKESTACKS	S M OW K S T AE K S
SNACK	S N AE K
SNACKED	S N AE K T
SNACKING	S N AE K IH NG
SNACKS	S N AE K S
SNAPBACK	S N AE P B AE K
SNAPBACKS	S N AE P B AE K S
SNECK	S N EH K
SNECKS	S N EH K S
SNICK	S N IH K
SNICKED	S N IH K T
SNICKER	S N IH K ER
SNICKERED	S N IH K ER D
SNICKERER	S N IH K ER ER
SNICKERERS	S N IH K ER ER Z
SNICKERING	S N IH K ER IH NG
SNICKERS	S N IH K ER Z
SNICKERSNEE	S N IH K AH R S N IY IY
SNICKERSNEES	S N IH K AH R S N IY Z
SNICKERY	S N IH K AH R IY
SNICKING	S N IH K IH NG
SNICKS	S N IH K S
SNOWPACK	S N OW P AE K
SNOWPACKS	S N OW P AE K S
SNUCK	S N AH K
SOCK	S AA K
SOCKDOLAGER	S AA K D OW L IH JH ER
SOCKDOLAGERS	S AA K D OW L IH JH ER Z
SOCKDOLOGER	S AA K D UW L AA G ER
SOCKDOLOGERS	S AA K D UW L AA G ER Z
SOCKED	S AA K T
SOCKET	S AA K AH T
SOCKETED	S AA K AH T IH D
SOCKETING	S AA K AH T IH NG
SOCKETS	S AA K AH T S
SOCKEYE	S AA K AY
SOCKEYES	S AA K AY Z
SOCKING	S AA K IH NG
SOCKLESS	S AA K L AH S
SOCKMAN	S AA K M AE N
SOCKMEN	S AA K M EH N
SOCKO	S AA K OW
SOCKS	S AA K S
SOFTBACK	S AO F T B AE K
SOFTBACKS	S AO F T B AE K S
SOUNDTRACK	S AW N D T R AE K
SOUNDTRACK(2)	S AW N T R AE K
SOUNDTRACKS	S AW N D T R AE K S
SOUNDTRACKS(2)	S AW N T R AE K S
SPACKLE	S P AE K AH L
SPACKLED	S P AE K AH L D
SPACKLES	S P AE K AH L Z
SPACKLING	S P AE K L AH NG
SPATTERDOCK	S P AE T ER D AA K
SPATTERDOCKS	S P AE T ER D AA K S
SPECK	S P EH K
SPECKED	S P EH K T
SPECKING	S P EH K IH NG
SPECKLE	S P EH K AH L
SPECKLED	S P EH K AH L D
SPECKLES	S P EH K AH L Z
SPECKLING	S P EH K L IH NG
SPECKS	S P EH K S
SPICK	S P IH K
SPICKS	S P IH K S
SPROCKET	S P R AA K AH T
SPROCKETS	S P R AA K AH T S
STACK	S T AE K
STACKABLE	S T AE K AH B AH L
STACKED	S T AE K T
STACKER	S T AE K ER
STACKERS	S T AE K ER Z
STACKING	S T AE K IH NG
STACKS	S T AE K S
STACKUP	S T AE K AH P
STACKUPS	S T AE K AH P S
STAGESTRUCK	S T EY JH S T R AH K
STARSTRUCK	S T AA R S T R AH K
STATICKY	S T AE T IH K IY
STEEPLEJACK	S T IY P AH L JH AE K
STEEPLEJACKS	S T IY P AH L JH AE K S
STICK	S T IH K
STICKBALL	S T IH K B AO L
STICKBALLS	S T IH K B AO L Z
STICKED	S T IH K T
STICKER	S T IH K ER
STICKERS	S T IH K ER Z
STICKFUL	S T IH K F AH L
STICKFULS	S T IH K F AH L Z
STICKHANDLE	S T IH K HH AE N D AH L
STICKHANDLED	S T IH K HH AE N D AH L D
STICKHANDLER	S T IH K HH AE N D AH L ER
STICKHANDLERS	S T IH K HH AE N D AH L ER Z
STICKHANDLES	S T IH K HH AE N D AH L Z
STICKHANDLING	S T IH K HH AE N D L IH NG
STICKIER	S T IH K IY ER
STICKIEST	S T IH K IY AH S T
STICKILY	S T IH K IY L IY
STICKINESS	S T IH K IY N AH S
STICKINESSES	S T IH K IY N AH S IH Z
STICKING	S T IH K IH NG
STICKIT	S T IH K AH T
STICKLE	S T IH K AH L
STICKLEBACK	S T IH K AH L B AE K
STICKLEBACKS	S T IH K AH L B AE K S
STICKLED	S T IH K AH L D
STICKLER	S T IH K AH L ER
STICKLER(2)	S T IH K L ER
STICKLERS	S T IH K AH L ER Z
STICKLES	S T IH K AH L Z
STICKLIKE	S T IH K L AY K
STICKLING	S T IH K L IH NG
STICKMAN	S T IH K M AE N
STICKMEN	S T IH K M EH N
STICKOUT	S T IH K AW T
STICKOUTS	S T IH K AW T S
STICKPIN	S T IH K P IH N
STICKPINS	S T IH K P IH N Z
STICKS	S T IH K S
STICKSEED	S T IH K S IY D
STICKSEEDS	S T IH K S IY D Z
STICKTIGHT	S T IH K T AY T
STICKTIGHTS	S T IH K T AY T S
STICKUM	S T IH K AH M
STICKUMS	S T IH K AH M Z
STICKUP	S T IH K AH P
STICKUPS	S T IH K AH P S
STICKWEED	S T IH K W IY D
STICKWEEDS	S T IH K W IY D Z
STICKWORK	S T IH K W ER K
STICKWORKS	S T IH K W ER K S
STICKY	S T IH K IY
STOCK	S T AA K
STOCKADE	S T AA K EY D
STOCKADED	S T AA K EY D IH D
STOCKADES	S T AA K EY D Z
STOCKADING	S T AA K EY D IH NG
STOCKBREEDER	S T AA K B R IY D ER
STOCKBREEDERS	S T AA K B R IY D ER Z
STOCKBROKER	S T AA K B R OW K ER
STOCKBROKERAGE	S T AA K B R OW K ER IH JH
STOCKBROKERAGES	S T AA K B R OW K ER IH JH IH Z
STOCKBROKERS	S T AA K B R OW K ER Z
STOCKBROKING	S T AA K B R OW K IH NG
STOCKBROKINGS	S T AA K B R OW K IH NG Z
STOCKCAR	S T AA K AA R
STOCKCARS	S T AA K AA R Z
STOCKED	S T AA K T
STOCKER	S T AA K ER
STOCKERS	S T AA K ER Z
STOCKFISH	S T AA K F IH SH
STOCKFISHES	S T AA K F IH SH IH Z
STOCKHOLDER	S T AA K HH OW L D ER
STOCKHOLDERS	S T AA K HH OW L D ER Z
STOCKIER	S T AA K IY ER
STOCKIEST	S T AA K IY AH S T
STOCKILY	S T AA K IY L IY
STOCKINESS	S T AA K IY N AH S
STOCKINESSES	S T AA K IY N AH S IH Z
STOCKINET	S T AA K AH N AH T
STOCKINETS	S T AA K AH N AH T S
STOCKINETTE	S T AA K IH N EH T
STOCKINETTES	S T AA K IH N EH T S
STOCKING	S T AA K IH NG
STOCKINGED	S T AA K IH NG D
STOCKINGS	S T AA K IH NG Z
STOCKISH	S T AA K IH SH
STOCKIST	S T AA K IH S T
STOCKISTS	S T AA K IH S T S
STOCKJOBBER	S T AA K JH AA B ER
STOCKJOBBERS	S T AA K JH AA B ER Z
STOCKJOBBING	S T AA K JH AA B IH NG
STOCKJOBBINGS	S T AA K JH AA B IH NG Z
STOCKKEEPER	S T AA K IY P ER
STOCKKEEPERS	S T AA K IY P ER Z
STOCKMAN	S T AA K M AH N
STOCKMEN	S T AA K M EH N
STOCKPILE	S T AA K P AY L
STOCKPILED	S T AA K P AY L D
STOCKPILER	S T AA K P AY L ER
STOCKPILERS	S T AA K P AY L ER Z
STOCKPILES	S T AA K P AY L Z
STOCKPILING	S T AA K P AY L IH NG
STOCKPOT	S T AA K P AA T
STOCKPOTS	S T AA K P AA T S
STOCKROOM	S T AA K R UW M
STOCKROOMS	S T AA K R UW M Z
STOCKS	S T AA K S
STOCKTAKING	S T AA K T EY K IH NG
STOCKTAKINGS	S T AA K T EY K IH NG Z
STOCKY	S T AA K IY
STOCKYARD	S T AA K Y AA R D
STOCKYARDS	S T AA K Y AA R D Z
STOPCOCK	S T AA P K AA K
STOPCOCKS	S T AA P K AA K S
STRAIGHTJACKET	S T R EY T JH AE K AH T
STRAIGHTJACKETED	S T R EY T JH AE K AH T IH D
STRAIGHTJACKETING	S T R EY T JH AE K AH T IH NG
STRAIGHTJACKETS	S T R EY T JH AE K AH T S
STRAITJACKET	S T R EY T JH AE K AH T
STRAITJACKETED	S T R EY T JH AE K AH T IH D
STRAITJACKETING	S T R EY T JH AE K AH T IH NG
STRAITJACKETS	S T R EY T JH AE K AH T S
STRICK	S T R IH K
STRICKEN	S T R IH K AH N
STRICKLE	S T R IH K AH L
STRICKLED	S T R IH K AH L D
STRICKLES	S T R IH K AH L Z
STRICKLING	S T R IH K L IH NG
STRICKS	S T R IH K S
STRUCK	S T R AH K
STRUCKEN	S T R AH K AH N
STUCK	S T AH K
SUBBLOCK	S AH B L AA K
SUBBLOCKS	S AH B L AA K S
SUCK	S AH K
SUCKED	S AH K T
SUCKER	S AH K ER
SUCKERED	S AH K ER D
SUCKERING	S AH K ER IH NG
SUCKERS	S AH K ER Z
SUCKFISH	S AH K F IH SH
SUCKFISHES	S AH K F IH SH IH Z
SUCKING	S AH K IH NG
SUCKLE	S AH K AH L
SUCKLED	S AH K L EH D
SUCKLER	S AH K L AH R
SUCKLERS	S AH K L AH R Z
SUCKLES	S AH K AH L Z
SUCKLESS	S AH K L AH S
SUCKLING	S AH K L IH NG
SUCKLINGS	S AH K L IH NG Z
SUCKS	S AH K S
SUNBACK	S AH N B AE K
SUNBLOCK	S AH N B L AA K
SUNBLOCKS	S AH N B L AA K S
SUNDECK	S AH N D EH K
SUNDECKS	S AH N D EH K S
SUNSTRUCK	S AH N S T R AH K
SUPERBLOCK	S UW P ER B L AA K
SUPERBLOCKS	S UW P ER B L AA K S
SUPERFLACK	S UW P AH R F L AE K
SUPERFLACKS	S UW P AH R F L AE K S
SUPERJOCK	S UW P ER JH AA K
SUPERJOCKS	S UW P ER JH AA K S
SUPERSLICK	S UW P ER S L IH K
SUPERSTOCK	S UW P ER S T AA K
SUPERSTOCKS	S UW P ER S T AA K S
SUPERTHICK	S UW P ER TH IH K
SUPPLEJACK	S AH P AH L JH AE K
SUPPLEJACKS	S AH P AH L JH AE K S
SWACKED	S W AE K T
SWASHBUCKLE	S W AA SH B AH K AH L
SWASHBUCKLED	S W AA SH B AH K AH L D
SWASHBUCKLER	S W AA SH B AH K L AH R
SWASHBUCKLERS	S W AA SH B AH K L AH R Z
SWASHBUCKLES	S W AA SH B AH K AH L Z
SWASHBUCKLING	S W AA SH B AH K L IH NG
SWAYBACK	S W EY B AE K
SWAYBACKED	S W EY B AE K T
SWAYBACKS	S W EY B AE K S
SWEEPBACK	S W IY P B AE K
SWEEPBACKS	S W IY P B AE K S
SWITCHBACK	S W IH CH B AE K
SWITCHBACKED	S W IH CH B AE K T
SWITCHBACKING	S W IH CH B AE K IH NG
SWITCHBACKS	S W IH CH B AE K S
TACK	T AE K
TACKBOARD	T AE K B OW R D
TACKBOARDS	T AE K B OW R D Z
TACKED	T AE K T
TACKER	T AE K ER
TACKERS	T AE K ER Z
TACKET	T AE K AH T
TACKETS	T AE K AH T S
TACKEY	T AE K IY
TACKIER	T AE K IY ER
TACKIEST	T AE K IY AH S T
TACKIFIED	T AE K AH F AY D
TACKIFIER	T AE K AH F AY ER
TACKIFIERS	T AE K AH F AY ER Z
TACKIFIES	T AE K AH F AY Z
TACKIFY	T AE K AH F AY
TACKIFYING	T AE K AH F AY IH NG
TACKILY	T AE K IY L IY
TACKINESS	T AE K IY N AH S
TACKINESSES	T AE K IY N AH S IH Z
TACKING	T AE K IH NG
TACKLE	T AE K AH L
TACKLED	T AE K AH L D
TACKLER	T AE K AH L ER
TACKLERS	T AE K AH L ER Z
TACKLES	T AE K AH L Z
TACKLESS	T AE K L AH S
TACKLING	T AE K L IH NG
TACKLING(2)	T AE K AH L IH NG
TACKLINGS	T AE K L IH NG Z
TACKS	T AE K S
TACKY	T AE K IY
TAILBACK	T EY L B AE K
TAILBACKS	T EY L B AE K S
TALCKED	T AE L K T
TALCKING	T AE L K AH NG
TALCKY	T AE L K IY
TAMARACK	T AE M AH R AH K
TAMARACKS	T AE M AH R AH K S
TAPERSTICK	T EY P ER S T IH K
TAPERSTICKS	T EY P ER S T IH K S
THACK	TH AE K
THACKED	TH AE K T
THACKING	TH AE K AH NG
THACKS	TH AE K S
THICK	TH IH K
THICKEN	TH IH K AH N
THICKENED	TH IH K AH N D
THICKENER	TH IH K AH N ER
THICKENERS	TH IH K AH N ER Z
THICKENING	TH IH K AH N IH NG
THICKENING(2)	TH IH K N IH NG
THICKENINGS	TH IH K AH N IH NG Z
THICKENS	TH IH K AH N Z
THICKER	TH IH K ER
THICKEST	TH IH K IH S T
THICKET	TH IH K IH T
THICKETED	TH IH K AH T IH D
THICKETS	TH IH K AH T S
THICKETY	TH IH K AH T IY
THICKHEAD	TH IH K HH EH D
THICKHEADED	TH IH K HH EH D IH D
THICKHEADS	TH IH K HH EH D Z
THICKISH	TH IH K IH SH
THICKLY	TH IH K L IY
THICKNESS	TH IH K N AH S
THICKNESSES	TH IH K N AH S IH Z
THICKS	TH IH K S
THICKSET	TH IH K S EH T
THICKSETS	TH IH K S EH T S
THORNBACK	TH AO R N B AE K
THORNBACKS	TH AO R N B AE K S
THROWBACK	TH R OW B AE K
THROWBACKS	TH R OW B AE K S
THUMBSUCKER	TH AH M S AH K ER
THUMBSUCKERS	TH AH M S AH K ER Z
THUMBTACK	TH AH M T AE K
THUMBTACKED	TH AH M T AE K T
THUMBTACKING	TH AH M T AE K IH NG
THUMBTACKS	TH AH M T AE K S
THUNDERSTRICKEN	TH AH N D ER S T R IH K AH N
THUNDERSTRUCK	TH AH N D ER S T R AH K
THWACK	TH W AE K
THWACKED	TH W AE K T
THWACKER	TH W AE K ER
THWACKERS	TH W AE K ER Z
THWACKING	TH W AE K IH NG
THWACKS	TH W AE K S
TICK	T IH K
TICKED	T IH K T
TICKER	T IH K ER
TICKERS	T IH K ER Z
TICKET	T IH K AH T
TICKET(2)	T IH K IH T
TICKETED	T IH K AH T IH D
TICKETING	T IH K AH T IH NG
TICKETLESS	T IH K AH T L AH S
TICKETS	T IH K AH T S
TICKETS(2)	T IH K IH T S
TICKING	T IH K IH NG
TICKINGS	T IH K IH NG Z
TICKLE	T IH K AH L
TICKLED	T IH K AH L D
TICKLER	T IH K AH L ER
TICKLERS	T IH K AH L ER Z
TICKLES	T IH K AH L Z
TICKLING	T IH K L IH NG
TICKLISH	T IH K AH L IH SH
TICKLISHLY	T IH K AH L IH SH L IY
TICKLISHNESS	T IH K AH L IH SH N AH S
TICKLISHNESSES	T IH K AH L IH SH N AH S IH Z
TICKS	T IH K S
TICKSEED	T IH K S IY D
TICKSEEDS	T IH K S IY D Z
TICKTACK	T IH K T AE K
TICKTACKED	T IH K T AE K T
TICKTACKING	T IH K T AE K IH NG
TICKTACKS	T IH K T AE K S
TICKTACKTOE	T IH K T AE K T OW
TICKTACKTOES	T IH K T AE K T OW Z
TICKTOCK	T IH K T AH K
TICKTOCKED	T IH K T AH K T
TICKTOCKING	T IH K T AA K AH NG
TICKTOCKS	T IH K T AH K S
TICTACKED	T IH K T AH K T
TICTACKING	T IH K T AE K AH NG
TICTOCKED	T IH K T AH K T
TICTOCKING	T IH K T AA K AH NG
TIEBACK	T AY B AE K
TIEBACKS	T AY B AE K S
TIPSTOCK	T IH P S T AA K
TIPSTOCKS	T IH P S T AA K S
TOMBACK	T AA M B AE K
TOMBACKS	T AA M B AE K S
TOOTHPICK	T UW TH P IH K
TOOTHPICKS	T UW TH P IH K S
TOPKICK	T AA P K IH K
TOPKICKS	T AA P K IH K S
TOUCHBACK	T AH CH B AE K
TOUCHBACKS	T AH CH B AE K S
TRACK	T R AE K
TRACKAGE	T R AE K IH JH
TRACKAGES	T R AE K IH JH IH Z
TRACKBALL	T R AE K B AO L
TRACKBALLS	T R AE K B AO L Z
TRACKED	T R AE K T
TRACKER	T R AE K ER
TRACKERS	T R AE K ER Z
TRACKING	T R AE K IH NG
TRACKINGS	T R AE K IH NG Z
TRACKLAYER	T R AE K L EY ER
TRACKLAYERS	T R AE K L EY ER Z
TRACKLAYING	T R AE K L EY IH NG
TRACKLAYINGS	T R AE K L EY IH NG Z
TRACKLESS	T R AE K L AH S
TRACKMAN	T R AE K M AE N
TRACKMEN	T R AE K M EH N
TRACKS	T R AE K S
TRACKSIDE	T R AE K S AY D
TRACKSIDES	T R AE K S AY D Z
TRACKSUIT	T R AE K S UW T
TRACKSUITS	T R AE K S UW T S
TRACKWALKER	T R AE K W AO K ER
TRACKWALKERS	T R AE K W AO K ER Z
TRACKWAY	T R AE K W EY
TRACKWAYS	T R AE K W EY Z
TRAFFICKED	T R AE F IH K T
TRAFFICKER	T R AE F IH K ER
TRAFFICKERS	T R AE F IH K ER Z
TRAFFICKING	T R AE F IH K IH NG
TRAPROCK	T R AE P R AA K
TRAPROCKS	T R AE P R AA K S
TREBUCKET	T R AH B AH K AH T
TREBUCKETS	T R AH B AH K AH T S
TRICK	T R IH K
TRICKED	T R IH K T
TRICKER	T R IH K ER
TRICKERIES	T R IH K AH R IY Z
TRICKERS	T R IH K ER Z
TRICKERY	T R IH K ER IY
TRICKIE	T R IH K IY
TRICKIER	T R IH K IY ER
TRICKIEST	T R IH K IY AH S T
TRICKILY	T R IH K IY L IY
TRICKINESS	T R IH K IY N AH S
TRICKINESSES	T R IH K IY N AH S IH Z
TRICKING	T R IH K IH NG
TRICKISH	T R IH K IH SH
TRICKISHLY	T R IH K IH SH L IY
TRICKISHNESS	T R IH K IH SH N AH S
TRICKISHNESSES	T R IH K IH SH N AH S IH Z
TRICKLE	T R IH K AH L
TRICKLED	T R IH K AH L D
TRICKLEDOWN	T R IH K AH L D AW N
TRICKLES	T R IH K AH L Z
TRICKLIER	T R IH K L IY ER
TRICKLIEST	T R IH K L IY AH S T
TRICKLING	T R IH K L IH NG
TRICKLY	T R IH K L IY
TRICKS	T R IH K S
TRICKSIER	T R IH K S IY ER
TRICKSIEST	T R IH K S IY AH S T
TRICKSINESS	T R IH K S AY N AH S
TRICKSINESSES	T R IH K S AY N AH S IH Z
TRICKSTER	T R IH K S T ER
TRICKSTERS	T R IH K S T ER Z
TRICKSY	T R IH K S IY
TRICKY	T R IH K IY
TRIPACK	T R IH P AH K
TRIPACKS	T R IH P AH K S
TROCK	T R AA K
TROCKED	T R AA K T
TROCKING	T R AA K AH NG
TROCKS	T R AA K S
TRUCK	T R AH K
TRUCKAGE	T R AH K IH JH
TRUCKAGES	T R AH K IH JH IH Z
TRUCKED	T R AH K T
TRUCKER	T R AH K ER
TRUCKERS	T R AH K ER Z
TRUCKFUL	T R AH K F AH L
TRUCKFULS	T R AH K F AH L Z
TRUCKING	T R AH K IH NG
TRUCKINGS	T R AH K IH NG Z
TRUCKLE	T R AH K AH L
TRUCKLED	T R AH K L EH D
TRUCKLER	T R AH K L AH R
TRUCKLERS	T R AH K L AH R Z
TRUCKLES	T R AH K AH L Z
TRUCKLINE	T R AH K L AY N
TRUCKLINES	T R AH K L AY N Z
TRUCKLING	T R AH K L IH NG
TRUCKLOAD	T R AH K L OW D
TRUCKLOADS	T R AH K L OW D Z
TRUCKMAN	T R AH K M AE N
TRUCKMASTER	T R AH K M AE S T ER
TRUCKMASTERS	T R AH K M AE S T ER Z
TRUCKMEN	T R AH K M EH N
TRUCKS	T R AH K S
TUCK	T AH K
TUCKAHOE	T AH K AH HH OW
TUCKAHOES	T AH K AH HH OW Z
TUCKED	T AH K T
TUCKER	T AH K ER
TUCKERED	T AH K ER D
TUCKERING	T AH K ER IH NG
TUCKERS	T AH K ER Z
TUCKET	T AH K AH T
TUCKETS	T AH K AH T S
TUCKING	T AH K IH NG
TUCKS	T AH K S
TUCKSHOP	T AH K SH AA P
TUCKSHOPS	T AH K SH AA P S
TURNBUCKLE	T ER N B AH K AH L
TURNBUCKLES	T ER N B AH K AH L Z
TURTLEBACK	T ER T AH L B AE K
TURTLEBACKS	T ER T AH L B AE K S
TURTLENECK	T ER T AH L N EH K
TURTLENECKED	T ER T AH L N EH K T
TURTLENECKS	T ER T AH L N EH K S
TUSSOCK	T AH S AH K
TUSSOCKS	T AH S AH K S
TUSSOCKY	T AH S AA K IY
TUSSUCK	T AH S AH K
TUSSUCKS	T AH S AH K S
ULTRASLICK	AH L T R AH S L IH K
UMIACK	Y UW M AY AH K
UMIACKS	Y UW M AY AH K S
UNACKNOWLEDGED	AH N AE K N AA L IH JH D
UNBACKED	AH N B AE K T
UNBLOCK	AH N B L AA K
UNBLOCKED	AH N B L AA K T
UNBLOCKING	AH N B L AA K IH NG
UNBLOCKS	AH N B L AA K S
UNBRACKETED	AH N B R AE K AH T IH D
UNBUCKLE	AH N B AH K AH L
UNBUCKLED	AH N B AH K AH L D
UNBUCKLES	AH N B AH K AH L Z
UNBUCKLING	AH N B AH K L IH NG
UNCHECKABLE	AH N CH EH K AH B AH L
UNCHECKED	AH N CH EH K T
UNCOCK	AH N K AA K
UNCOCKED	AH N K AA K T
UNCOCKING	AH N K AA K IH NG
UNCOCKS	AH N K AA K S
UNCRACKED	AH N K R AE K T
UNDECKED	AH N D EH K T
UNDERTRICK	AH N D ER T R IH K
UNDERTRICKS	AH N D ER T R IH K S
UNDOCK	AH N D AA K
UNDOCKED	AH N D AA K T
UNDOCKING	AH N D AA K IH NG
UNDOCKS	AH N D AA K S
UNFROCK	AH N F R AA K
UNFROCKED	AH N F R AA K T
UNFROCKING	AH N F R AA K IH NG
UNFROCKS	AH N F R AA K S
UNGIMMICKY	AH N JH IH M IH K IY
UNHACKNEYED	AH N HH AE K N IY D
UNLICKED	AH N L IH K T
UNLOCK	AH N L AA K
UNLOCKED	AH N L AA K T
UNLOCKING	AH N L AA K IH NG
UNLOCKS	AH N L AA K S
UNLUCKIER	AH N L UW S IY ER
UNLUCKIEST	AH N L UW S IY AH S T
UNLUCKILY	AH N L UW S IY L IY
UNLUCKINESS	AH N L UW S IY N AH S
UNLUCKINESSES	AH N L UW S IY N AH S IH Z
UNLUCKY	AH N L AH K IY
UNPACK	AH N P AE K
UNPACKED	AH N P AE K T
UNPACKER	AH N P AE S ER
UNPACKERS	AH N P AE S ER Z
UNPACKING	AH N P AE K IH NG
UNPACKS	AH N P AE K S
UNPICK	AH N P IH K
UNPICKED	AH N P IH K T
UNPICKING	AH N P IH K IH NG
UNPICKS	AH N P IH K S
UNPUCKER	AH N P AH K ER
UNPUCKERED	AH N P AH K ER D
UNPUCKERING	AH N P AH K ER IH NG
UNPUCKERS	AH N P AH K ER Z
UNSHACKLE	AH N SH AE K AH L
UNSHACKLED	AH N SH AE K AH L D
UNSHACKLES	AH N SH AE K AH L Z
UNSHACKLING	AH N SH AE K L IH NG
UNSHOCKABLE	AH N SH AA K AH B AH L
UNSICKER	AH N S IH K ER
UNSTACK	AH N S T AE K
UNSTACKED	AH N S T AE K T
UNSTACKING	AH N S T AE K IH NG
UNSTACKS	AH N S T AE K S
UNSTICK	AH N S T IH K
UNSTICKING	AH N S T IH K IH NG
UNSTICKS	AH N S T IH K S
UNSTUCK	AH N S T AH K
UNTACK	AH N T AE K
UNTACKED	AH N T AE K T
UNTACKING	AH N T AE K IH NG
UNTACKS	AH N T AE K S
UNTUCK	AH N T AH K
UNTUCKED	AH N T AH K T
UNTUCKING	AH N T AH K IH NG
UNTUCKS	AH N T AH K S
UPCHUCK	AH P CH AH K
UPCHUCKED	AH P CH AH K T
UPCHUCKING	AH P CH AH K IH NG
UPCHUCKS	AH P CH AH K S
UPTICK	AH P T IH K
UPTICKS	AH P T IH K S
WACK	W AE K
WACKE	W AE K
WACKES	W AE K S
WACKIER	W AE K IY ER
WACKIEST	W AE K IY AH S T
WACKILY	W AE K IY L IY
WACKINESS	W AE K IY N AH S
WACKINESSES	W AE K IY N AH S IH Z
WACKO	W AE K OW
WACKOES	W AE K OW Z
WACKOS	W AE K OW Z
WACKS	W AE K S
WACKY	W AE K IY
WAESUCK	W IY S AH K
WAESUCKS	W IY S AH K S
WALKINGSTICK	W AO K IH NG S T IH K
WALKINGSTICKS	W AO K IH NG S T IH K S
WARLOCK	W AO R L AO K
WARLOCKS	W AO R L AO K S
WATERBUCK	W AO T ER B AH K
WATERBUCKS	W AO T ER B AH K S
WEATHERCOCK	W EH DH ER K AA K
WEATHERCOCKS	W EH DH ER K AA K S
WEDLOCK	W EH D L AA K
WEDLOCKS	W EH D L AA K S
WETBACK	W EH T B AE K
WETBACKS	W EH T B AE K S
WHACK	W AE K
WHACK(2)	HH W AE K
WHACKED	W AE K T
WHACKED(2)	HH W AE K T
WHACKER	W AE K ER
WHACKER(2)	HH W AE K ER
WHACKERS	W AE K ER Z
WHACKIER	W AE K IY ER
WHACKIEST	W AE K IY AH S T
WHACKING	W AE K IH NG
WHACKING(2)	HH W AE K IH NG
WHACKO	W AE K OW
WHACKOS	W AE K OW Z
WHACKS	W AE K S
WHACKS(2)	HH W AE K S
WHACKY	W AE K IY
WHALEBACK	W EY L B AE K
WHALEBACKS	W EY L B AE K S
WHICKER	W IH K ER
WHICKER(2)	HH W IH K ER
WHICKERED	W IH K IY R D
WHICKERING	W IH K IY R AH NG
WHICKERS	W IH K AH R Z
WHIPSTOCK	W IH P S T AA K
WHIPSTOCKS	W IH P S T AA K S
WHITRACK	W IH T R AE K
WHITRACKS	W IH T R AE K S
WICK	W IH K
WICKAPE	W IH K EY P
WICKAPES	W IH K EY P S
WICKED	W IH K AH D
WICKEDER	W IH K AH D ER
WICKEDEST	W IH K AH D AH S T
WICKEDLY	W IH K IH D L IY
WICKEDNESS	W IH K AH D N AH S
WICKEDNESSES	W IH K AH D N AH S IH Z
WICKER	W IH K ER
WICKERS	W IH K ER Z
WICKERWORK	W IH K ER W ER K
WICKERWORKS	W IH K ER W ER K S
WICKET	W IH K AH T
WICKET(2)	HH W IH K AH T
WICKETS	W IH K AH T S
WICKETS(2)	HH W IH K AH T S
WICKING	W IH K IH NG
WICKINGS	W IH K IH NG Z
WICKIUP	W IH K IY AH P
WICKIUPS	W IH K IY AH P S
WICKS	W IH K S
WICKYUP	W IH K IY AH P
WICKYUPS	W IH K IY AH P S
WINDSOCK	W IH N D S AA K
WINDSOCKS	W IH N D S AA K S
WINGBACK	W IH NG B AE K
WINGBACKS	W IH NG B AE K S
WINNOCK	W IH N AH K
WINNOCKS	W IH N AH K S
WISECRACK	W AY Z K R AE K
WISECRACKED	W AY Z K R AE K T
WISECRACKER	W AY Z K R AE K ER
WISECRACKERS	W AY Z K R AE K ER Z
WISECRACKING	W AY Z K R AE K IH NG
WISECRACKS	W AY Z K R AE K S
WOODBLOCK	W UH D B L AA K
WOODBLOCKS	W UH D B L AA K S
WOODCHUCK	W UH D CH AH K
WOODCHUCKS	W UH D CH AH K S
WOODCOCK	W UH D K AA K
WOODCOCKS	W UH D K AA K S
WOODPECKER	W UH D P EH K ER
WOODPECKERS	W UH D P EH K ER Z
WOOLPACK	W UH L P AE K
WOOLPACKS	W UH L P AE K S
WOOLSACK	W UH L S AE K
WOOLSACKS	W UH L S AE K S
WRACK	R AE K
WRACKED	R AE K T
WRACKFUL	R AE K F AH L
WRACKING	R AE K IH NG
WRACKS	R AE K S
WRECK	R EH K
WRECKAGE	R EH K AH JH
WRECKAGE(2)	R EH K IH JH
WRECKAGES	R EH K IH JH IH Z
WRECKED	R EH K T
WRECKER	R EH K ER
WRECKERS	R EH K ER Z
WRECKFUL	R EH K F AH L
WRECKING	R EH K IH NG
WRECKINGS	R EH K IH NG Z
WRECKS	R EH K S
WRICK	R IH K
WRICKED	R IH K T
WRICKING	R IH K AH NG
WRICKS	R IH K S
WRISTLOCK	R IH S T L AA K
WRISTLOCKS	R IH S T L AA K S
WRYNECK	R AY N EH K
WRYNECKS	R AY N EH K S
YACK	Y AE K
YACKED	Y AE K T
YACKING	Y AE K AH NG
YACKS	Y AE K S
YAPOCK	Y AE P AH K
YAPOCKS	Y AE P AH K S
YARDSTICK	Y AA R D S T IH K
YARDSTICKS	Y AA R D S T IH K S
YOCK	Y AA K
YOCKED	Y AA K T
YOCKING	Y AA K AH NG
YOCKS	Y AA K S
YOICKS	Y OY K S
YUCK	Y AH K
YUCKED	Y AH K T
YUCKIER	Y AH K AY AH R
YUCKIEST	Y AH K AY AH S T
YUCKING	Y AH K AH NG
YUCKS	Y AH K S
YUCKY	Y AH K IY
ZADDICK	Z AE D AH K
ZEBECK	Z EH B AH K
ZEBECKS	Z EH B AH K S
ZINCKED	Z IH NG K T
ZINCKING	Z IH NG K IH NG
ZINCKY	Z IH NG K IY
ZWIEBACK	Z W IY B AH K
ZWIEBACKS	Z W IY B AH K S
WO	W OW
WO(2)	HH W OW
EX	EH K S
JNANA	JH N AE N AH
AGROCHEMICAL	AE G R OW K EH M IH K AH L
ICE	AY S
IFS	IH F S
MU	M UW
