CO	K OW
ABSCOND	AE B S K AA N D
ABSCONDED	AE B S K AA N D AH D
ABSCONDER	AE B S K AA N D AH R
ABSCONDERS	AE B S K AA N D AH R Z
ABSCONDING	AE B S K AA N D IH NG
ABSCONDS	AE B S K AA N D Z
ACCOLADE	AE K AH L EY D
ACCOLADES	AE K AH L EY D Z
ACCOMMODATE	AH K AA M AH D EY T
ACCOMMODATED	AH K AA M AH D EY T AH D
ACCOMMODATES	AH K AA M AH D EY T S
ACCOMMODATING	AH K AA M AH D EY T IH NG
ACCOMMODATINGLY	AH K AA M AH D EY T IH NG L IY
ACCOMMODATION	AH K AA M AH D EY SH AH N
ACCOMMODATIONAL	AH K AA M AH D EY SH AH N AH L
ACCOMMODATIONIST	AH K AA M AH D EY SH AH N IH S T
ACCOMMODATIONISTS	AH K AA M AH D EY SH AH N IH S T S
ACCOMMODATIONS	AH K AA M AH D EY SH AH N Z
ACCOMMODATIVE	AH K AA M AH D EY T IH V
ACCOMMODATIVENESS	AH K AA M AH D EY T IH V N AH S
ACCOMMODATIVENESSES	AH K AA M AH D EY T IH V N AH S IH Z
ACCOMMODATOR	AH K AA M AH D EY T ER
ACCOMMODATORS	AH K AA M AH D EY T ER Z
ACCOMPANIED	AH K AH M P AH N IY D
ACCOMPANIES	AH K AH M P AH N IY Z
ACCOMPANIMENT	AH K AH M P N IH M AH N T
ACCOMPANIMENT(2)	AH K AH M P N IY M AH N T
ACCOMPANIMENTS	AH K AH M P N IH M AH N T S
ACCOMPANIMENTS(2)	AH K AH M P N IY M AH N T S
ACCOMPANIST	AH K AH M P AH N AH S T
ACCOMPANISTS	AE K AA M P AH N AH S T S
ACCOMPANY	AH K AH M P AH N IY
ACCOMPANYING	AH K AH M P AH N IY IH NG
ACCOMPLICE	AH K AA M P L AH S
ACCOMPLICES	AH K AA M P L AH S AH Z
ACCOMPLISH	AH K AA M P L IH SH
ACCOMPLISHABLE	AH K AA M P L IH SH AH B AH L
ACCOMPLISHED	AH K AA M P L IH SH T
ACCOMPLISHER	AH K AA M P L IH SH ER
ACCOMPLISHERS	AH K AA M P L IH SH ER Z
ACCOMPLISHES	AH K AA M P L IH SH IH Z
ACCOMPLISHING	AH K AA M P L IH SH IH NG
ACCOMPLISHMENT	AH K AA M P L IH SH M AH N T
ACCOMPLISHMENTS	AH K AA M P L IH SH M AH N T S
ACCORD	AH K AO R D
ACCORDANCE	AH K AO R D AH N S
ACCORDANCES	AH K AO R D AH N S IH Z
ACCORDANT	AH K AO R D AH N T
ACCORDANTLY	AH K AO R D AH N T L IY
ACCORDED	AH K AO R D IH D
ACCORDER	AH K AO R D ER
ACCORDERS	AH K AO R D ER Z
ACCORDING	AH K AO R D IH NG
ACCORDINGLY	AH K AO R D IH NG L IY
ACCORDION	AH K AO R D IY AH N
ACCORDIONIST	AH K AO R D IY AH N IH S T
ACCORDIONISTS	AH K AO R D IY AH N IH S T S
ACCORDIONS	AH K AO R D IY AH N Z
ACCORDS	AH K AO R D Z
ACCOST	AH K AO S T
ACCOSTED	AH K AA S T AH D
ACCOSTING	AH K AA S T IH NG
ACCOSTS	AH K AO S T S
ACCOUCHEMENT	AE K AW CH M AH N T
ACCOUCHEMENTS	AE K AW K AH M AH N T S
ACCOUCHEUR	AE K AW CH AH R
ACCOUCHEURS	AE K AW CH IY Y AH R Z
ACCOUNT	AH K AW N T
ACCOUNTABILITIES	AH K AW N T AH B IH L AH T EH Z
ACCOUNTABILITY	AH K AW N T AH B IH L IH T IY
ACCOUNTABLE	AH K AW N T AH B AH L
ACCOUNTABLENESS	AH K AW N T AH B AH L N AH S
ACCOUNTABLENESSES	AH K AW N T AH B AH L N AH S IH Z
ACCOUNTABLY	AH K AW N T AH B L IY
ACCOUNTANCIES	AH K AW N T AH N S IY Z
ACCOUNTANCY	AH K AW N T AH N T S IY
ACCOUNTANT	AH K AW N T AH N T
ACCOUNTANTS	AH K AW N T AH N T S
ACCOUNTANTSHIP	AH K AW N T AH N T SH IH P
ACCOUNTANTSHIPS	AH K AW N T AH N T SH IH P S
ACCOUNTED	AH K AW N T IH D
ACCOUNTING	AH K AW N T IH NG
ACCOUNTING(2)	AH K AW N IH NG
ACCOUNTINGS	AH K AW N T IH NG Z
ACCOUNTS	AH K AW N T S
ACCOUTER	AH K UW T ER
ACCOUTERED	AH K UW T ER D
ACCOUTERING	AH K UW T ER IH NG
ACCOUTERMENT	AH K UW T ER M AH N T
ACCOUTERMENTS	AH K UW T ER M AH N T S
ACCOUTERS	AH K UW T ER Z
ACCOUTRE	AE K AW T AH R
ACCOUTRED	AE K AW T AH R D
ACCOUTREMENT	AH K UW T ER M AH N T
ACCOUTREMENTS	AH K UW T ER M AH N T S
ACCOUTRES	AE K AW T AH R Z
ACCOUTRING	AE K AW T R AH NG
ACOCK	AH K AA K
ACOELOMATE	AH K OW EH L AH M EY T
ACOELOMATES	AH K OW EH L AH M EY T S
ACOLD	AH K OW L D
ACOLYTE	AE K AH L AY T
ACOLYTES	AE K AH L AY T S
ACONITE	AE K AH N AY T
ACONITES	AE K AH N AY T S
ACONITIC	AE K AH N AH T AH K
ACONITUM	AH K AA N AH T AH M
ACONITUMS	AH K AA N AH T AH M Z
ACORN	EY K AO R N
ACORNS	EY K AO R N Z
ACOUSTIC	AH K UW S T IH K
ACOUSTICAL	AH K UW S T IH K AH L
ACOUSTICALLY	AH K UW S T IH K L IY
ACOUSTICIAN	AH K AW S T IH S IY AH N
ACOUSTICIANS	AE K AW S T IH S IY AH N Z
ACOUSTICS	AH K UW S T IH K S
ACTINOMYCOSES	AE K T AH N AA M AH K OW Z AH Z
ACTINOMYCOSIS	AE K T IH N OW M AY K OW S IH S
ACTINOMYCOTIC	AE K T AH N AA M AH K AH T AH K
ADRENOCORTICAL	AE D R EH N AH K AO R T IH S AH L
ADRENOCORTICOSTEROID	AE D R AH N AH K AO R T AH K AA S T AH R OY D
ADRENOCORTICOSTEROIDS	AE D R AH N AH K AH R T AH K AA S T AH R OY D Z
ADRENOCORTICOTROPHIC	AE D R AH N AH K AO R T AH K AA T R AH F AH K
ADRENOCORTICOTROPHIN	AE D R AH N AH K AO R T AH K AA T R AH F AH N
ADRENOCORTICOTROPHINS	AE D R AH N AH K AO R T AH K AA T R AH F AH N Z
ADRENOCORTICOTROPIC	AE D R AH N AH K AO R T AH K AA T R AH P AH K
ADRENOCORTICOTROPIN	AE D R AH N AH K AO R T AH K AA T R AH P AH N
ADRENOCORTICOTROPINS	AE D R AH N AH K AO R T AH K AA T R AH P AH N Z
ADUNCOUS	AH D AH NG K AH S
AGLYCON	EY JH L IY K AA N
AGLYCONE	EY JH L IY K OW N
AGLYCONES	EY JH L IY K OW N Z
AGLYCONS	EY JH L IY K AA N Z
AIRCOACH	AH IH R K OW CH
AIRCOACHES	AH IH R K OW CH IH Z
ALBACORE	AE L B AH K AO R
ALBACORES	AE L B AH K OW R Z
ALBICORE	AE L B AH K AH R
ALBICORES	AE L B AH K AH R Z
ALCOHOL	AE L K AH HH AA L
ALCOHOLIC	AE L K AH HH AA L IH K
ALCOHOLICALLY	AE L K AH HH AO L IH K AH L IY
ALCOHOLICS	AE L K AH HH AA L IH K S
ALCOHOLISM	AE L K AH HH AO L IH Z AH M
ALCOHOLISMS	AE L K AH HH AO L IH Z AH M Z
ALCOHOLS	AE L K AH HH AO L Z
ALCOVE	AE L K OW V
ALCOVED	AE L K OW V D
ALCOVES	AE L K OW V Z
ALENCON	EY L AH N K AA N
ALENCONS	EY L AH N K AA N Z
ALFRESCO	AE L F R EH S K OW
ALNICO	AE L N AH K OW
ALNICOES	AE L N AH K OW Z
ALNICOS	AE L N AH K AH Z
AMELCORN	AH M EH L K AH R N
AMELCORNS	AH M EH L K AH R N Z
ANACOLUTHA	AE N AH K AA L AH TH AH
ANACOLUTHIC	AH N AE K AH L AH TH AH K
ANACOLUTHICALLY	AE N AH K AH L AH TH AH K AE L IY
ANACOLUTHON	AE N AH K AA L AH TH AH N
ANACOLUTHONS	AE N AH K AA L AH TH AH N Z
ANACONDA	AE N AH K AA N D AH
ANACONDAS	AE N AH K AA N D AH Z
ANASARCOUS	AE N AH S AA R K AH S
ANCON	AE NG K AH N
ANCONAL	AE NG K AH N AH L
ANCONE	AE NG K OW N
ANCONEAL	AE NG K OW N IY AH L
ANCONES	AE NG K OW N Z
ANCONOID	AE NG K AH N OY D
ANTIALCOHOL	AE N T AY AE L K AH HH AO L
ANTIALCOHOLISM	AE N T AY AE L K AH HH AO L IH Z AH M
ANTIALCOHOLISMS	AE N T AY AE L K AH HH AO L IH Z AH M Z
ANTIBOYCOTT	AE N T AY B OY K AA T
ANTIBOYCOTTS	AE N T AY B OY K AA T S
ANTICOAGULANT	AE N T AY K OW AE G Y AH L AH N T
ANTICOAGULANTS	AE N T AY K OW AE G Y AH L AH N T S
ANTICODON	AE N T AY K OW D AA N
ANTICODONS	AE N T AY K OW D AA N Z
ANTICOLD	AE N T AY K OW L D
ANTICOLLISION	AE N T AY K AH L IH ZH AH N
ANTICOLONIAL	AE N T AY K AH L OW N IY AH L
ANTICOLONIALISM	AE N T AY K AH L OW N IY AH L IH Z AH M
ANTICOLONIALISMS	AE N T AY K AH L OW N IY AH L IH Z AH M Z
ANTICOLONIALIST	AE N T AY K AH L OW N IY AH L IH S T
ANTICOLONIALISTS	AE N T AY K AH L OW N IY AH L IH S T S
ANTICOLONIALS	AE N T AY K AH L OW N IY AH L Z
ANTICOMMERCIAL	AE N T AY K AH M ER SH AH L
ANTICOMMERCIALISM	AE N T AY K AH M ER SH AH L IH Z AH M
ANTICOMMERCIALISMS	AE N T AY K AH M ER SH AH L IH Z AH M Z
ANTICOMMUNISM	AE N T AY K AH M Y UW N IH Z AH M
ANTICOMMUNISMS	AE N T AY K AH M Y UW N IH Z AH M Z
ANTICOMMUNIST	AE N T IY K AA M Y AH N IH S T
ANTICOMMUNISTS	AE N T AY K AH M Y UW N IH S T S
ANTICOMPETITIVE	AE N T IH K AH M P EH T IH T IH V
ANTICONGLOMERATE	AE N T AY K AH N G L AA M ER AH T
ANTICONSERVATION	AE N T AY K AH N S ER V EY SH AH N
ANTICONSERVATIONIST	AE N T AY K AH N S ER V EY SH AH N IH S T
ANTICONSERVATIONISTS	AE N T AY K AH N S ER V EY SH AH N IH S T S
ANTICONSERVATIONS	AE N T AY K AH N S ER V EY SH AH N Z
ANTICONSUMER	AE N T AY K AH N S UW M ER
ANTICONSUMERS	AE N T AY K AH N S UW M ER Z
ANTICONVENTIONAL	AE N T AY K AA N V AH N CH AH N AH L
ANTICONVULSANT	AE N T AY K AH N V AH L S AH N T
ANTICONVULSANTS	AE N T AY K AH N V AH L S AH N T S
ANTICONVULSIVE	AE N T AY K AH N V AH L S IH V
ANTICONVULSIVES	AE N T AY K AH N V AH L S IH V Z
ANTICORPORATE	AE N T AY K AO R P ER AH T
ANTICORROSION	AE N T AY K AH R OW ZH AH N
ANTICORROSIVE	AE N T AY K AH R OW S IH V
ANTICORROSIVES	AE N T AY K AH R OW S IH V Z
ANTICORRUPTION	AE N T AY K ER AH P SH AH N
ANTICORRUPTION(2)	AE N T IY K ER AH P SH AH N
ANTICORRUPTIONS	AE N T AY K AH R AH P SH AH N Z
ANTICOUNTERFEITING	AE N T AY K AW N T ER F IH T IH NG
ANTIECONOMIC	AE N T AY EH K AH N AA M IH K
ANTISCORBUTIC	AE N T AY S AO R B Y UW T AH K
ANTISCORBUTICS	AE N T AY S AO R B Y UW T AH S Z
ANTITOBACCO	AE N T AY T AH B AE K OW
APOCOPE	AE P AH K OW P
APOCOPES	AE P AH K OW P S
APOCOPIC	AE P AH K AH P AH K
APRICOT	EY P R AH K AA T
APRICOTS	AE P R AH K AA T S
ARCCOSINE	AA R K OW S AY N
ARCCOSINES	AA R K OW S AY N Z
ARCHCONSERVATIVE	AA R CH K AH N S ER V AH T IH V
ARCHCONSERVATIVES	AA R CH K AH N S ER V AH T IH V Z
ARCHDEACON	AA R CH D IY K AH N
ARCHDEACONRIES	AA R CH D IY K AH N R IY Z
ARCHDEACONRY	AA R CH D IY K AH N R IY
ARCHDEACONS	AA R CH D IY K AH N Z
ARCHIDIACONAL	AA R K AH D IY AE K AH N AH L
ARCHIEPISCOPAL	AA R K AH P IH S AH P AH L
ARCHIEPISCOPALLY	AA R K AH P IH S AH P AE L IY
ARCHIEPISCOPATE	AA R K AH P IH S AH P EY T
ARCHIEPISCOPATES	AA R K AH P IH S AH P EY T S
ARCO	AA R K OW
ARECOLINE	AH R IY K OW L AY N
ARECOLINES	AH R IY K OW L AY N Z
ARENICOLOUS	AE R AH N IH K AH L AH S
ARTHROSCOPE	AA R TH R AH S OW P
ARTHROSCOPES	AA R TH R AH S OW P S
ARTHROSCOPIC	AA R TH R AA S AH P AH K
ARTHROSCOPIES	AA R TH R AA S AH P AY Z
ARTHROSCOPY	AA R TH R AA S AH P IY
ASCOCARP	AH Z K OW K AA R P
ASCOCARPIC	AH Z K OW K AA R P IH K
ASCOCARPS	AH Z K OW K AA R P S
ASCOGONIA	AE S AH G OW N Y AH
ASCOGONIUM	AE S AH G OW N IY AH M
ASCOMYCETE	AE S AA M AH S IY T
ASCOMYCETES	AE S AA M AH S IY T S
ASCOMYCETOUS	AE S AH M IH S AH T AH S
ASCORBATE	AE S AH R B EY T
ASCORBATES	AE S AH R B EY T S
ASCORBIC	AH S K AO R B IH K
ASCOSPORE	AH Z K OW S P OW R
ASCOSPORES	AH Z K OW S P OW R Z
ASCOSPORIC	AH Z K OW S P OW R IH K
ASCOT	AE S K AA T
ASCOTS	AH S K AA T S
ATAMASCO	AE T AH M AE S OW
ATAMASCOS	AE T AH M AE S AH Z
AUTACOID	EY Y UW T AH S OY D
AUTACOIDS	AO T AH K OY D Z
AUTECOLOGICAL	AO T AH K AA L AH JH IH S AH L
AUTECOLOGIES	AO T AH K AA L AH JH AY Z
AUTECOLOGY	AO T AH K AA L AH JH IY
AUTOCOID	AO T AH K OY D
AUTOCOIDS	AO T AH K OY D Z
AUTOCORRELATION	AO T OW K AO R AH L EY SH AH N
AUTOCORRELATIONS	AO T OW K AO R AH L EY SH AH N Z
BACKCOUNTRIES	B AE K AH N T R IY Z
BACKCOUNTRY	B AE K AH N T R IY
BACKCOURT	B AE K OW R T
BACKCOURTMAN	B AE K OW R T M AE N
BACKCOURTMEN	B AE K OW R T M EH N
BACKCOURTS	B AE K OW R T S
BACON	B EY K AH N
BACONS	B EY K AH N Z
BALCONIED	B AE L K AH N IY D
BALCONIES	B AE L K AH N IY Z
BALCONY	B AE L K AH N IY
BANCO	B AE NG K OW
BANCOS	B AE NG K AH Z
BANDICOOT	B AE N D IH K UW T
BANDICOOT(2)	B AE N D IY K UW T
BANDICOOTS	B AE N D IH K UW T S
BANDICOOTS(2)	B AE N D IY K UW T S
BARBASCO	B AA R B AE S OW
BARBASCOES	B AA R B AE S OW Z
BARBASCOS	B AA R B AE S AH Z
BARLEYCORN	B AA R L IY K AO R N
BARLEYCORNS	B AA R L IY K AO R N Z
BARRACOON	B AE R AH S UW N
BARRACOONS	B AE R AH K UW N Z
BARRACOUTA	B AE R AH K AW T AH
BARRACOUTAS	B AE R AH K AW T AH Z
BARRANCO	B AA R AA N K OW
BARRANCOS	B AE R AE NG K AH Z
BAWCOCK	B AO K AH K
BAWCOCKS	B AO K AH K S
BEACHCOMB	B IY CH K OW M
BEACHCOMBED	B IY CH K OW M D
BEACHCOMBER	B IY CH K OW M ER
BEACHCOMBERS	B IY CH K OW M ER Z
BEACHCOMBING	B IY CH K OW M IH NG
BEACHCOMBS	B IY CH K OW M Z
BEACON	B IY K AH N
BEACONED	B IY K AH N D
BEACONING	B IY K AH N IH NG
BEACONS	B IY K AH N Z
BEAUCOUP	B OW K UW
BECOME	B IH K AH M
BECOMES	B IH K AH M Z
BECOMING	B IH K AH M IH NG
BECOMINGLY	B IH K AH M IH NG L IY
BECOMINGS	B IH K AH M IH NG Z
BECOWARD	B IH K AW ER D
BECOWARDED	B IH K AW ER D IH D
BECOWARDING	B IH K AW ER D IH NG
BECOWARDS	B IH K AW ER D Z
BEDCOVER	B EH D K AH V ER
BEDCOVERING	B EH D K AH V ER IH NG
BEDCOVERINGS	B EH D K AH V ER IH NG Z
BEDCOVERS	B EH D K AH V ER Z
BELLICOSE	B EH L AH K OW S
BELLICOSELY	B IH L AH K OW Z L IY
BELLICOSITIES	B EH L IH K AA S AH T IY Z
BELLICOSITY	B EH L IH K AA S AH T IY
BESCORCH	B IH S K AO R CH
BESCORCHED	B IH S K AO R CH T
BESCORCHES	B IH S K AO R CH IH Z
BESCORCHING	B IH S K AO R CH IH NG
BESCOUR	B IH S K AW ER
BESCOURED	B IH S K AW ER D
BESCOURING	B IH S K AW ER IH NG
BESCOURS	B IH S K AW ER Z
BIBCOCK	B IH B K AA K
BIBCOCKS	B IH B K AA K S
BICOASTAL	B IH K OW S T AH L
BICOLOR	B AY K AH L ER
BICOLORED	B AY K AH L ER D
BICOLORS	B AY K AH L ER Z
BICOLOUR	B AY K AH L ER
BICOLOURS	B AY K AH L ER Z
BICOMPONENT	B AY K AH M P OW N AH N T
BICONCAVE	B AY K AA N K EY V
BICONCAVITIES	B AY K AH N K AE V AH T IY Z
BICONCAVITY	B AY K AH N K AE V AH T IY
BICONDITIONAL	B AY K AH N D IH SH AH N AH L
BICONDITIONALS	B AY K AH N D IH SH AH N AH L Z
BICONVEX	B AY K AA N V EH K S
BICONVEXITIES	B AY K AA N V EH K S AH T IY Z
BICONVEXITY	B AY K AA N V EH K S AH T IY
BICORN	B AY K AO R N
BICORNE	B AY K AH R N IY
BICORNES	B AY K AO R N Z
BILLYCOCK	B IH L IY K AA K
BILLYCOCKS	B IH L IY K AA K S
BIOACOUSTICS	B AY AH K AW S T AH S Z
BIOCOENOSES	B AY AA K OW AH N OW Z AH Z
BIOCOENOSIS	B AY AA K OW AH N OW S AH S
BIOCOMPATIBILITIES	B AY AH K AA M P AH T AH B IH L AH T AY Z
BIOCOMPATIBILITY	B AY AA K AH M P EY T AH B IH L AH T IY
BIOCOMPATIBLE	B AY AA K AH M P EY T AH B AH L
BIOCONTROL	B AY AH K AA N T R AA L
BIOCONTROLS	B AY AH K AA N T R AH L Z
BIOCONVERSION	B AY AH K AA N V EH R Z IY AH N
BIOCONVERSIONS	B AY AA K AH N V AH R S IY AH N Z
BIOSCOPE	B AY AA S K OW P
BIOSCOPES	B AY AA S K OW P S
BIOSCOPIES	B AY AA S K AA P IY Z
BIOSCOPY	B AY AA S K AA P IY
BLACKCOCK	B L AE K AA K
BLACKCOCKS	B L AE K AA K S
BLASTOCOEL	B L AE S T AA K OW AH L
BLASTOCOELE	B L AE S T AA K OW AH L
BLASTOCOELES	B L AE S T AA K OW AH L Z
BLASTOCOELIC	B L AE S T AA K OW AH L AH K
BLASTOCOELS	B L AE S T AA K OW AH L Z
BLASTOMYCOSES	B L AE S T AA M AH K OW Z AH Z
BLASTOMYCOSIS	B L AE S T AH M AH K OW S AH S
BLUECOAT	B L UW K OW T
BLUECOATS	B L UW K OW T S
BORECOLE	B AO R K OW L
BORECOLES	B AO R K OW L Z
BORESCOPE	B AO R S K OW P
BORESCOPES	B AO R S K OW P S
BOYCOTT	B OY K AA T
BOYCOTTED	B OY K AA T IH D
BOYCOTTER	B OY K AA T ER
BOYCOTTERS	B OY K AA T ER Z
BOYCOTTING	B OY K AA T IH NG
BOYCOTTS	B OY K AA T S
BRACONID	B R AE K AH N AH D
BRACONIDS	B R AE K AH N AH D Z
BRICOLAGE	B R IH K AH L AH JH
BRICOLAGES	B R AH K AA L AH JH AH Z
BRICOLE	B R AH K OW L
BRICOLES	B R AH K OW L Z
BROCCOLI	B R AA K AH L IY
BROCCOLI(2)	B R AA K L IY
BROCCOLIS	B R AA K L IY Z
BROCOLI	B R AA K AH L IY
BROCOLIS	B R AA K AH L AH S
BRONCHOSCOPE	B R AA N K AH S K OW P
BRONCHOSCOPES	B R AO NG K AH S OW P S
BRONCHOSCOPIC	B R AO NG K AA S AH P AH K
BRONCHOSCOPIES	B R AO NG K AA S AH P AY Z
BRONCHOSCOPIST	B R AO NG K AA S AH P AH S T
BRONCHOSCOPISTS	B R AO NG K AA S AH P AH S T S
BRONCHOSCOPY	B R AO NG K AA S AH P IY
BRONCO	B R AA NG K OW
BRONCOBUSTER	B R AA NG K OW B AH S T ER
BRONCOBUSTERS	B R AA NG K OW B AH S T ER Z
BRONCOS	B R AA NG K OW Z
BROOMCORN	B R UW M K AO R N
BROOMCORNS	B R UW M K AO R N Z
BUCOLIC	B Y UW K AA L IH K
BUCOLICALLY	B Y UW K AA L IH K AH L IY
BUCOLICS	B Y UW K AA L IH K S
BUNCO	B AH NG K OW
BUNCOED	B AH NG K OW D
BUNCOES	B AH NG K OW Z
BUNCOING	B AH NG K OW AH NG
BUNCOMBE	B AH N K OW M
BUNCOMBES	B AH N K OW M Z
BUNCOS	B AH NG K AH Z
BUTTERSCOTCH	B AH T ER S K AA CH
BUTTERSCOTCHES	B AH T ER S K AA CH IH Z
CACODEMON	K AH K AA D AH M AH N
CACODEMONIC	K AH K AA D AH M AH N AH K
CACODEMONS	K AH K AA D AH M AH N Z
CACODYL	K AE K AH D AH L
CACODYLS	K AE K AH D AH L Z
CACOETHES	K AE K OW AH DH Z
CACOGRAPHICAL	K AH K AA G R AH F IH S AH L
CACOGRAPHIES	K AH K AA G R AH F AY Z
CACOGRAPHY	K AH K AA G R AH F IY
CACOMISTLE	K AE K AH M AH S AH L
CACOMISTLES	K AE K AH M AH S T AH L Z
CACOMIXL	K AE K AH M AH K S L
CACOMIXLS	K AE K AH M AH K S L Z
CACOPHONIES	K AE K AA F AH N IY Z
CACOPHONOUS	K AE K AA F AH N AH S
CACOPHONOUSLY	K AE K AA F AH N AH S L IY
CACOPHONY	K AE K AA F AH N IY
CADUCOUS	K AE D Y UW K AH S
CALCICOLE	K AE L S AH K OW L
CALCICOLES	K AE L S AH K OW L Z
CALCICOLOUS	K AE L S IH K AH L AH S
CALICO	K AE L AH K OW
CALICOES	K AE L IH K OW Z
CALICOS	K AE L IH K OW Z
CAMCORDER	K AE M K AO R D ER
CAMCORDERS	K AE M K AO R D ER Z
CARACOL	K AE R AH K AH L
CARACOLE	K AA R AH K OW L
CARACOLED	K AA R AH K OW L D
CARACOLES	K AA R AH K OW L Z
CARACOLING	K AA R AH K OW L IH NG
CARACOLLED	K AE R AH K AH L D
CARACOLLING	K AE R AH K AA L AH NG
CARACOLS	K AE R AH K AH L Z
CARCINOSARCOMA	K AA R S AH N AH S AA R K AH M AH
CARCINOSARCOMAS	K AA R S AH N AH S AA R K AH M AH Z
CARCINOSARCOMATA	K AA R S IH N AH S AH R K AA M AH T AH
CATACOMB	K AE T AH K OW M
CATACOMBS	K AE T AH K OW M Z
CATERCORNER	K EY T ER K AO R N ER
CATERCORNERED	K EY T ER K AO R N ER D
CATHOLICOI	K AH TH AA L AH K OY
CATHOLICON	K AE TH L IH K AO N
CATHOLICONS	K AE TH L IH K AO N Z
CATHOLICOS	K AE TH L IH K AA S
CATHOLICOSES	K AE TH L IH K AA S IH Z
CAVERNICOLOUS	K AH V AH R N IH K AH L AH S
CAVICORN	K AE V AH K AH R N
CHACONNE	CH AE K AH N
CHACONNES	CH AE K AH N Z
CHALCOCITE	CH AE L K AH S AY T
CHALCOCITES	CH AE L K AH S AY T S
CHALCOGEN	CH AE L K AH JH AH N
CHALCOGENIDE	CH AE L K AA JH AH N AY D
CHALCOGENIDES	CH AE L K AA JH AH N AY D Z
CHALCOGENS	CH AE L K AH JH AH N Z
CHALCOPYRITE	CH AE L K AA P AH R AY T
CHALCOPYRITES	CH AE L K AA P AH R AY T S
CHARCOAL	CH AA R K OW L
CHARCOALED	CH AA R K OW L D
CHARCOALING	CH AA R K OW L IH NG
CHARCOALS	CH AA R K OW L Z
CHAWBACON	CH AO B EY K AH N
CHAWBACONS	CH AO B EY K AH N Z
CHICCORIES	SH IY K ER IY Z
CHICCORY	SH IY K ER IY
CHICO	CH IY K OW
CHICORIES	CH IY K OW R IY Z
CHICORY	CH IY K OW R IY
CHICOS	CH IY K OW Z
CHLORAMPHENICOL	K L AO R AH M F EH N AH K AH L
CHLORAMPHENICOLS	K L AO R AH M F EH N AH K AH L Z
CHOCOHOLIC	CH AA K AH HH AH L AH K
CHOCOHOLICS	CH AH K AA HH AH L AH S Z
CHOCOLATE	CH AO K L AH T
CHOCOLATES	CH AO K L AH T S
CHOCOLATEY	CH AA K L AH T IY
CHOCOLATIER	CH AA K L AH T IY ER
CHOCOLATIERS	CH AA K L AH T IY ER Z
CHOCOLATY	CH AA K L AH T IY
CHUBASCO	CH UW B AE S OW
CHUBASCOS	CH UW B AE S AH Z
CICOREE	S IH K AH R IY IY
CICOREES	S IH K AH R IY Z
CISCO	S IH S K OW
CISCOES	S IH S OW Z
CISCOS	S IH S AH Z
CLASSICO	K L AE S AH K OW
CLINICOPATHOLOGIC	K L IH N AH K AH P AE TH AH L AH JH AH K
CLINICOPATHOLOGICAL	K L AH N IH K AH P AH TH AA L AH JH IH S AH L
CLINICOPATHOLOGICALLY	K L AH N AH K AA P AH TH AH L AA JH AH K AE L IY
COACERVATE	K OW AE S AH R V EY T
COACERVATES	K OW AE S AH R V EY T S
COACERVATION	K OW AE S AH R V EY SH AH N
COACERVATIONS	K OW AE S AH R V EY T IY AH N Z
COACH	K OW CH
COACHABLE	K OW CH AH B AH L
COACHED	K OW CH T
COACHER	K OW CH ER
COACHERS	K OW CH ER Z
COACHES	K OW CH IH Z
COACHING	K OW CH IH NG
COACHMAN	K OW CH M AH N
COACHMEN	K OW CH M EH N
COACHWORK	K OW CH W ER K
COACHWORKS	K OW CH W ER K S
COACT	K OW AE K T
COACTED	K OW AE K T IH D
COACTING	K OW AE K T IH NG
COACTION	K OW AE K SH AH N
COACTIONS	K OW AE K SH AH N Z
COACTIVE	K OW AE K T IH V
COACTOR	K OW AE K T ER
COACTORS	K OW AE K T ER Z
COACTS	K OW AE K T S
COADAPTATION	K OW AE D AE P T EY SH AH N
COADAPTATIONS	K OW AE D AE P T EY SH AH N Z
COADAPTED	K OW AH D AE P T IH D
COADJUTOR	K OW AE JH Y UW T AH R
COADJUTORS	K OW AE JH UW T AH R Z
COADJUTRICES	K OW AE JH AH T R AH S
COADJUTRIX	K OW AE JH AH T R AH K S
COADMINISTRATION	K OW AH D M IH N AH S T R EY SH AH N
COADMINISTRATIONS	K OW AH D M IH N AH S T R EY SH AH N Z
COADMIRE	K OW AH D M AY ER
COADMIRED	K OW AH D M AY ER D
COADMIRES	K OW AH D M AY ER Z
COADMIRING	K OW AH D M AY ER IH NG
COADMIT	K OW AH D M IH T
COADMITS	K OW AH D M IH T S
COADMITTED	K OW AH D M IH T IH D
COADMITTING	K OW AH D M IH T IH NG
COAEVAL	K OW AH IY V AH L
COAEVALS	K OW AH IY V AH L Z
COAGENCIES	K OW EY JH AH N S IY Z
COAGENCY	K OW EY JH AH N S IY
COAGENT	K OW EY JH AH N T
COAGENTS	K OW EY JH AH N T S
COAGULA	K OW AE G Y UW L AH
COAGULABILITIES	K OW AE G Y AH L AH B IH L AH T EH Z
COAGULABILITY	K OW AE G Y AH L AH B IH L AH T EH
COAGULABLE	K OW AE G Y AH L AH B AH L
COAGULANT	K OW AE G Y AH L AH N T
COAGULANTS	K OW AE G Y AH L AH N T S
COAGULASE	K OW AE G Y AH L EY Z
COAGULASES	K OW AE G Y AH L EY Z AH Z
COAGULATE	K OW AE G Y AH L EY T
COAGULATED	K OW AE G Y AH L EY T IH D
COAGULATES	K OW AE G Y AH L AH T S
COAGULATING	K OW AE G Y AH L EY T IH NG
COAGULATION	K OW AE G Y AH L EY SH AH N
COAGULATIONS	K OW AE G Y AH L EY SH AH N Z
COAGULUM	K OW AE G Y UW L AH M
COAGULUMS	K OW AE G Y UW L AH M Z
COAL	K OW L
COALA	K OW AE L AH
COALAS	K OW AE L AH Z
COALBIN	K OW L B IH N
COALBINS	K OW L B IH N Z
COALBOX	K OW L B AA K S
COALBOXES	K OW L B AA K S IH Z
COALED	K OW L D
COALER	K OW L ER
COALERS	K OW L ER Z
COALESCE	K OW AH L EH S
COALESCED	K OW AH L EH S T
COALESCENCE	K OW AH L EH S AH N S
COALESCENCES	K OW AH L EH S AH N S IH Z
COALESCENT	K OW AH L EH S AH N T
COALESCES	K OW AH L EH S IH Z
COALESCING	K OW AH L EH S IH NG
COALFIELD	K OW L F IY L D
COALFIELDS	K OW L F IY L D Z
COALFISH	K OW L F IH SH
COALFISHES	K OW L F IH SH IH Z
COALHOLE	K OW L HH OW L
COALHOLES	K OW L HH OW L Z
COALIER	K OW L IY ER
COALIEST	K OW L IY AH S T
COALIFICATION	K OW L AH F AH K EY SH AH N
COALIFICATIONS	K OW L AH F AH K EY SH AH N Z
COALIFIED	K OW L AH F AY D
COALIFIES	K OW L AH F AY Z
COALIFY	K OW L AH F AY
COALIFYING	K OW L AH F AY IH NG
COALING	K OW L IH NG
COALITION	K OW AH L IH SH AH N
COALITIONIST	K OW AH L IH SH AH N IH S T
COALITIONISTS	K OW AH L IH SH AH N IH S T S
COALITIONS	K OW AH L IH SH AH N Z
COALLESS	K OW L AH S
COALPIT	K OW L P IH T
COALPITS	K OW L P IH T S
COALS	K OW L Z
COALSACK	K OW L S AE K
COALSACKS	K OW L S AE K S
COALSHED	K OW L SH EH D
COALSHEDS	K OW L SH EH D Z
COALY	K OW L IY
COALYARD	K OW L Y AA R D
COALYARDS	K OW L Y AA R D Z
COAMING	K OW EY M AH NG
COAMINGS	K OW AE M AH NG Z
COANCHOR	K OW AE NG K ER
COANCHORED	K OW AE NG K ER D
COANCHORING	K OW AE NG K ER IH NG
COANCHORS	K OW AE NG K ER Z
COANNEX	K OW AH N EH K S
COANNEXED	K OW AH N EH K S T
COANNEXES	K OW AH N EH K S IH Z
COANNEXING	K OW AH N EH K S IH NG
COAPPEAR	K OW AH P IH ER
COAPPEARED	K OW AH P IH ER D
COAPPEARING	K OW AH P IH ER IH NG
COAPPEARS	K OW AH P IH ER Z
COAPT	K OW AE P T
COAPTATION	K OW AE P T EY SH AH N
COAPTATIONS	K OW AE P T EY SH AH N Z
COAPTED	K OW AE P T IH D
COAPTING	K OW AE P T IH NG
COAPTS	K OW AE P T S
COARCTATION	K OW AA R K T AE SH AH N
COARCTATIONS	K OW AA R K T AE SH AH N Z
COARSE	K AO R S
COARSELY	K OW R S L IY
COARSEN	K OW R S AH N
COARSENED	K OW R S AH N D
COARSENESS	K OW R S N AH S
COARSENESSES	K OW R S N AH S IH Z
COARSENING	K AO R S IH N IH NG
COARSENS	K OW R S AH N Z
COARSER	K AO R S ER
COARSEST	K OW R S AH S T
COASSIST	K OW AH S IH S T
COASSISTED	K OW AH S IH S T IH D
COASSISTING	K OW AH S IH S T IH NG
COASSISTS	K OW AH S IH S T S
COASSUME	K OW AH S UW M
COASSUMED	K OW AH S UW M D
COASSUMES	K OW AH S UW M Z
COASSUMING	K OW AH S UW M IH NG
COAST	K OW S T
COASTAL	K OW S T AH L
COASTED	K OW S T IH D
COASTER	K OW S T ER
COASTERS	K OW S T ER Z
COASTGUARD	K OW S T G AA R D
COASTGUARDMAN	K OW S T G AA R D M AE N
COASTGUARDMEN	K OW S T G AA R D M EH N
COASTGUARDS	K OW S T G AA R D Z
COASTGUARDSMAN	K OW S T G AA R D Z M AE N
COASTGUARDSMEN	K OW S T G AA R D Z M EH N
COASTING	K OW S T IH NG
COASTINGS	K OW S T IH NG Z
COASTLAND	K OW S T L AE N D
COASTLANDS	K OW S T L AE N D Z
COASTLINE	K OW S T L AY N
COASTLINES	K OW S T L AY N Z
COASTS	K OW S T S
COASTWARD	K OW S T W ER D
COASTWARDS	K OW S T W ER D Z
COASTWISE	K OW S T W AY Z
COAT	K OW T
COATDRESS	K OW T D R EH S
COATDRESSES	K OW T D R EH S IH Z
COATED	K OW T AH D
COATED(2)	K OW T IH D
COATEE	K OW T IY
COATEES	K OW T IY Z
COATER	K OW T ER
COATERS	K OW T ER Z
COATI	K OW AE T IY
COATIMUNDI	K OW AE T AH M AH N D IY
COATIMUNDIS	K OW AE T AH M AH N D AH S
COATING	K OW T IH NG
COATINGS	K OW T IH NG Z
COATIS	K OW T IY Z
COATLESS	K OW T L AH S
COATRACK	K OW AH T R AE K
COATRACKS	K OW AH T R AE K S
COATROOM	K OW T R UW M
COATROOMS	K OW T R UW M Z
COATS	K OW T S
COATTAIL	K OW T T EY L
COATTAILS	K OW T T EY L Z
COATTEND	K OW AH T EH N D
COATTENDED	K OW AH T EH N D IH D
COATTENDING	K OW AH T EH N D IH NG
COATTENDS	K OW AH T EH N D Z
COATTEST	K OW AH T EH S T
COATTESTED	K OW AH T EH S T IH D
COATTESTING	K OW AH T EH S T IH NG
COATTESTS	K OW AH T EH S T S
COAUTHOR	K OW AA TH ER
COAUTHORED	K OW AA TH ER D
COAUTHORING	K OW AA TH ER IH NG
COAUTHORS	K OW AA TH ER Z
COAUTHORSHIP	K OW AO TH ER SH IH P
COAUTHORSHIPS	K OW AO TH ER SH IH P S
COAX	K OW K S
COAXAL	K OW K S AH L
COAXED	K OW K S T
COAXER	K OW K S ER
COAXERS	K OW K S ER Z
COAXES	K OW K S IH Z
COAXIAL	K OW AE K S IY AH L
COAXIALLY	K OW AE K S IY AH L IY
COAXING	K OW K S IH NG
COB	K AA B
COBALAMIN	K OW B AE L AH M AH N
COBALAMINS	K OW B AE L AH M AH N Z
COBALT	K OW B AO L T
COBALTIC	K OW B AO L T IH K
COBALTINE	K OW B IY AH L T AY N
COBALTINES	K OW B IY AH L T AY N Z
COBALTITE	K OW B AE L T AY T
COBALTITES	K OW B AE L T AY T S
COBALTOUS	K OW B AO L T AH S
COBALTS	K OW B AO L T S
COBB	K AA B
COBBER	K AA B AH R
COBBERS	K AA B EH R Z
COBBIER	K AA B AY AH R
COBBIEST	K AA B AY AH S T
COBBLE	K AA B AH L
COBBLED	K AA B AH L D
COBBLER	K AA B L ER
COBBLERS	K AA B L ER Z
COBBLES	K AA B AH L Z
COBBLESTONE	K AA B AH L S T OW N
COBBLESTONED	K AA B AH L S T OW N D
COBBLESTONES	K AA B AH L S T OW N Z
COBBLING	K AA B AH L IH NG
COBBS	K AA B Z
COBBY	K AA B IY
COBELLIGERENT	K OW B AH L IH JH ER AH N T
COBELLIGERENTS	K OW B AH L IH JH ER AH N T S
COBIA	K OW B IY AH
COBIAS	K OW B AY AH S
COBLE	K OW B AH L
COBLES	K OW B AH L Z
COBNUT	K AA B N AH T
COBNUTS	K AA B N Y UW T S
COBRA	K OW B R AH
COBRAS	K OW B R AH Z
COBS	K AA B Z
COBWEB	K AA B W EH B
COBWEBBED	K AA B W EH B D
COBWEBBIER	K AA B W EH B IY ER
COBWEBBIEST	K AA B W EH B IY AH S T
COBWEBBING	K AA B W EH B IH NG
COBWEBBY	K AA B W EH B IY
COBWEBS	K AA B W EH B Z
COCA	K OW K AH
COCAIN	K OW K EY N
COCAINE	K OW K EY N
COCAINES	K OW K EY N Z
COCAINIZATION	K OW K EY N AH Z EY SH AH N
COCAINIZATIONS	K OW K EY N AH Z EY SH AH N Z
COCAINIZE	K OW K EY N AY Z
COCAINIZED	K OW K EY N AY Z D
COCAINIZES	K OW K EY N AY Z IH Z
COCAINIZING	K OW K EY N AY Z IH NG
COCAINS	K OW K EY N Z
COCAPTAIN	K OW K AE P T AH N
COCAPTAINED	K OW K AE P T AH N D
COCAPTAINING	K OW K AE P T AH N IH NG
COCAPTAINS	K OW K AE P T AH N Z
COCARBOXYLASE	K OW K AH R B AA K S AH L EY Z
COCARBOXYLASES	K OW K AH R B AA K S AH L EY Z AH Z
COCARCINOGEN	K OW K AA R S IH N AH JH AH N
COCARCINOGENIC	K OW K AA R S IH N AH JH AH N AH K
COCARCINOGENS	K OW K AA R S IH N AH JH AH N Z
COCAS	K OW K AE Z
COCATALYST	K OW K AE T AH L AH S T
COCATALYSTS	K OW K AE T AH L AH S T S
COCCAL	K AA K AH L
COCCI	K AA K S IY
COCCIC	K AA K S AH K
COCCID	K AA K S IH D
COCCIDIA	K AA K S IH D IY AH
COCCIDIOIDOMYCOSES	K AA K S AH D IY OY D AA M AH K OW Z AH Z
COCCIDIOIDOMYCOSIS	K AA K S IH D IY OY D OW M AY K OW S AH S
COCCIDIOSES	K AA K S IH D IY OW Z AH Z
COCCIDIOSIS	K AA K S IH D IY OW S AH S
COCCIDIUM	K AA K S IH D IY AH M
COCCIDS	K AA K S IH D Z
COCCOID	K AA K OY D
COCCOIDS	K AA K OY D Z
COCCOUS	K AA K AH S
COCCUS	K AA K AH S
COCCYGEAL	K AA K S AY JH IY AH L
COCCYGES	K AA K S AY JH AH Z
COCCYX	K AA K S IH K S
COCCYXES	K AA K S IH K S
COCHAIR	K OW CH EH ER
COCHAIRED	K OW CH EH ER D
COCHAIRING	K OW CH EH ER IH NG
COCHAIRMAN	K OW CH EH R M AH N
COCHAIRMEN	K OW CH EH ER M EH N
COCHAIRPERSON	K OW CH EH ER P ER S AH N
COCHAIRPERSONS	K OW CH EH ER P ER S AH N Z
COCHAIRS	K OW CH EH ER Z
COCHAIRWOMAN	K OW CH EH ER W UH M AH N
COCHAIRWOMEN	K OW CH EH ER W IH M AH N
COCHAMPION	K OW CH AE M P IY AH N
COCHAMPIONS	K OW CH AE M P IY AH N Z
COCHIN	K OW CH IH N
COCHINEAL	K OW CH AY N AH L
COCHINEALS	K OW CH AY N AH L Z
COCHINS	K OW CH IH N Z
COCHLEA	K AA K L IY AH
COCHLEAE	K OW K L IY
COCHLEAR	K AA K L IY ER
COCHLEAS	K OW K L IY Z
COCINERA	K OW S IH N AH R AH
COCINERAS	K OW S IH N AH R AH Z
COCK	K AA K
COCKADE	K AA K EY D
COCKADED	K AA K EY D IH D
COCKADES	K AA K EY D Z
COCKALORUM	K AA K AE L AH R AH M
COCKALORUMS	K AA K AE L AH R AH M Z
COCKAMAMIE	K AO K AH M EY M IY
COCKAMAMY	K AA K AE M AH M IY
COCKAPOO	K AA K AE P UW
COCKAPOOS	K AA K AH P UW Z
COCKATIEL	K AA K AH T IY L
COCKATIELS	K AA K AH T IY L Z
COCKATOO	K AA K AH T UW
COCKATOOS	K AA K AH T UW Z
COCKATRICE	K AA K AE T R AH S
COCKATRICES	K AA K AE T R AH S
COCKBILL	K AA K B IH L
COCKBILLED	K AA K B IH L D
COCKBILLING	K AA K B IH L IH NG
COCKBILLS	K AA K B IH L Z
COCKBOAT	K AA K B OW T
COCKBOATS	K AA K B OW T S
COCKCHAFER	K AA K CH EY F ER
COCKCHAFERS	K AA K CH EY F ER Z
COCKCROW	K AA K R OW
COCKCROWS	K AA K R OW Z
COCKED	K AA K T
COCKED(2)	K AO K T
COCKER	K AA K ER
COCKERED	K AA K ER D
COCKEREL	K AA K EH R AH L
COCKERELS	K AA K EH R AH L Z
COCKERING	K AA K ER IH NG
COCKERS	K AA K ER Z
COCKEYE	K AA K AY
COCKEYED	K AA K AY D
COCKEYEDLY	K AA K AY AH D L IY
COCKEYEDNESS	K AA K AY AH D N AH S
COCKEYEDNESSES	K AA K AY AH D N AH S IH Z
COCKEYES	K AA K AY Z
COCKFIGHT	K AA K F AY T
COCKFIGHTING	K AA K F AY T IH NG
COCKFIGHTINGS	K AA K F AY T IH NG Z
COCKFIGHTS	K AA K F AY T S
COCKHORSE	K AA K HH AO R S
COCKHORSES	K AA K HH AO R S IH Z
COCKIER	K AA K IY ER
COCKIEST	K AA K IY AH S T
COCKILY	K AA K IY L IY
COCKINESS	K AA K IY N AH S
COCKINESSES	K AA K IY N AH S IH Z
COCKING	K AA K IH NG
COCKISH	K AA K IH SH
COCKLE	K AA K AH L
COCKLEBUR	K AA K L EH B AH R
COCKLEBURS	K AA K L EH B Y AH R Z
COCKLED	K AA K L EH D
COCKLES	K AA K AH L Z
COCKLESHELL	K AA K L EH SH AH L
COCKLESHELLS	K AA K L EH SH AH L Z
COCKLIKE	K AA K L AY K
COCKLING	K AA K L IH NG
COCKLOFT	K AA K L AO F T
COCKLOFTS	K AA K L AO F T S
COCKNEY	K AA K N IY
COCKNEYFIED	K AA K N AH F AY D
COCKNEYFIES	K AA K N AH F AY Z
COCKNEYFY	K AA K N EY F IY
COCKNEYFYING	K AA K N EY F AY AH NG
COCKNEYISH	K AA K N EY AH SH
COCKNEYISM	K AA K N EY AH Z AH M
COCKNEYISMS	K AA K N EY AH Z AH M Z
COCKNEYS	K AA K N EY Z
COCKPIT	K AA K P IH T
COCKPITS	K AA K P IH T S
COCKROACH	K AA K R OW CH
COCKROACHES	K AA K R OW CH IH Z
COCKS	K AA K S
COCKSCOMB	K AA K S K OW M
COCKSCOMBS	K AA K S K OW M Z
COCKSFOOT	K AA K S F UH T
COCKSFOOTS	K AA K S F UH T S
COCKSHIES	K AA K SH AY Z
COCKSHUT	K AA K SH AH T
COCKSHUTS	K AA K SH AH T S
COCKSHY	K AA K SH AY
COCKSPUR	K AA K S P ER
COCKSPURS	K AA K S P ER Z
COCKSUCKER	K AA K S AH K ER
COCKSUCKER(2)	K AA K S AH K ER Z
COCKSUCKERS	K AA K S AH K ER Z
COCKSURE	K AA K SH UH R
COCKSURELY	K AA K SH UH R L IY
COCKSURENESS	K AA K SH UH R N AH S
COCKSURENESSES	K AA K SH UH R N AH S IH Z
COCKTAIL	K AA K T EY L
COCKTAILED	K AA K T EY L D
COCKTAILING	K AA K T EY L IH NG
COCKTAILS	K AA K T EY L Z
COCKUP	K AA K AH P
COCKUPS	K AA K AH P S
COCKY	K AA K IY
COCO	K OW K OW
COCOA	K OW K OW
COCOANUT	K OW K OW AH N AH T
COCOANUTS	K OW K OW N AH T S
COCOAS	K OW K OW Z
COCOBOLA	K OW K AH B OW L AH
COCOBOLAS	K OW K AH B AA L AH Z
COCOBOLO	K OW K OW B OW L OW
COCOBOLOS	K OW K OW B OW L OW Z
COCOMAT	K OW K OW M AE T
COCOMATS	K OW K OW M AE T S
COCOMPOSER	K OW K AH M P OW Z ER
COCOMPOSERS	K OW K AH M P OW Z ER Z
COCONSPIRATOR	K OW K AH N S P IH R AH T ER
COCONSPIRATORS	K OW K AH N S P IH R AH T ER Z
COCONUT	K OW K AH N AH T
COCONUTS	K OW K AH N AH T S
COCOON	K AH K UW N
COCOONED	K AH K UW N D
COCOONING	K AH K UW N IH NG
COCOONINGS	K AH K UW N IH NG Z
COCOONS	K AH K UW N Z
COCOS	K OW K OW Z
COCOTTE	K OW K AH T IY
COCOTTES	K OW K AA T S
COCOUNSEL	K OW K AW N S AH L
COCOUNSELED	K OW K AW N S AH L D
COCOUNSELING	K OW K AW N S AH L IH NG
COCOUNSELLED	K OW K AW N S AH L D
COCOUNSELLING	K OW K AW N S AH L IH NG
COCOUNSELS	K OW K AW N S AH L Z
COCOYAM	K OW K AH Y AE M
COCOYAMS	K OW K AH Y AE M Z
COCREATE	K OW K R IY EY T
COCREATED	K OW K R IY EY T IH D
COCREATES	K OW K R IY EY T S
COCREATING	K OW K R IY EY T IH NG
COCREATOR	K OW K R IY EY T ER
COCREATORS	K OW K R IY EY T ER Z
COCULTIVATE	K OW K AH L T IH V AH T
COCULTIVATED	K OW K AH L T IH V EY T IH D
COCULTIVATES	K OW K AH L T IH V AH T S
COCULTIVATING	K OW K AH L T IH V EY T IH NG
COCULTIVATION	K OW K AH L T IH V EY SH AH N
COCULTIVATIONS	K OW K AH L T IH V EY SH AH N Z
COCULTURE	K OW K AH L CH ER
COCULTURED	K OW K AH L CH ER D
COCULTURES	K OW K AH L CH ER Z
COCULTURING	K OW K AH L CH ER IH NG
COCURATOR	K OW K Y UH R AH T ER
COCURATORS	K OW K Y UH R AH T ER Z
COCURRICULAR	K OW K AH R IH K Y AH L ER
COD	K AA D
COD(2)	S IY OW D IY
CODA	K OW D AH
CODABLE	K OW D AH B AH L
CODAS	K OW D AE Z
CODDED	K AA D IH D
CODDER	K AA D ER
CODDERS	K AA D ER Z
CODDING	K AA D IH NG
CODDLE	K AA D AH L
CODDLED	K AA D AH L D
CODDLER	K AA D AH L ER
CODDLERS	K AA D AH L ER Z
CODDLES	K AA D AH L Z
CODDLING	K AA D AH L IH NG
CODDLING(2)	K AA D L IH NG
CODE	K OW D
CODEBOOK	K OW D IY B UH K
CODEBOOKS	K OW D IY B UH K S
CODEBTOR	K OW D EH T ER
CODEBTORS	K OW D EH T ER Z
CODEC	K OW D EH K
CODECS	K OW D EH K S
CODED	K OW D IH D
CODEFENDANT	K OW D IY F EH N D AH N T
CODEFENDANTS	K OW D IY F EH N D AH N T S
CODEIA	K OW D IY IY AH
CODEIAS	K OW D IY AY AH Z
CODEIN	K OW D IY IH N
CODEINA	K OW D IY AH N AA
CODEINAS	K OW D IY AH N AE Z
CODEINE	K OW D IY IH N
CODEINES	K OW D IY AY N Z
CODEINS	K OW D IY IH N Z
CODELESS	K OW D L AH S
CODEN	K OW D EH N
CODENS	K OW D EH N Z
CODEPENDENCE	K OW D IH P EH N D AH N S
CODEPENDENCES	K OW D IH P EH N D AH N S IH Z
CODEPENDENCIES	K OW D IH P EH N D AH N S IY Z
CODEPENDENCY	K OW D IH P EH N D AH N S IY
CODEPENDENT	K OW D IY P EH N D EH N T
CODEPENDENTS	K OW D IY P EH N D EH N T S
CODER	K OW D ER
CODERIVE	K OW D IH R AY V
CODERIVED	K OW D IH R AY V D
CODERIVES	K OW D IH R AY V Z
CODERIVING	K OW D IH R AY V IH NG
CODERS	K OW D ER Z
CODES	K OW D Z
CODESIGN	K OW D IH Z AY N
CODESIGNED	K OW D IH Z AY N D
CODESIGNING	K OW D IH Z AY N IH NG
CODESIGNS	K OW D IH Z AY N Z
CODETERMINATION	K OW D IY T ER M AH N EY SH AH N
CODETERMINATIONS	K OW D IY T ER M AH N EY SH AH N Z
CODEVELOP	K OW D IH V EH L AH P
CODEVELOPED	K OW D IH V EH L AH P T
CODEVELOPER	K OW D IH V EH L AH P ER
CODEVELOPERS	K OW D IH V EH L AH P ER Z
CODEVELOPING	K OW D IH V EH L AH P IH NG
CODEVELOPS	K OW D IH V EH L AH P S
CODEX	K OW D EH K S
CODFISH	K AA D F IH SH
CODFISHES	K AA D F IH SH IH Z
CODGER	K AA JH AH R
CODGERS	K AA JH EH R Z
CODICES	K OW D AY S IH Z
CODICIL	K OW D IH S AH L
CODICILLARY	K OW D IH K S IH L EH R IY
CODICILS	K AH D IH S AH L Z
CODICOLOGICAL	K OW D AH K AA L AH JH IH S AH L
CODICOLOGIES	K OW D AY S AA L AH JH IY Z
CODICOLOGY	K OW D AY S AA L AH JH IY
CODIFIABILITIES	K OW D AH F AY AH B IH L AH T EH Z
CODIFIABILITY	K OW D AH F AY AH B IH L AH T EH
CODIFICATION	K AA D AH F AH K EY SH AH N
CODIFICATIONS	K OW D AH F AH K EY SH AH N Z
CODIFIED	K AA D AH F AY D
CODIFIER	K OW D AH F AY ER
CODIFIERS	K OW D AH F AY ER Z
CODIFIES	K OW D AH F AY Z
CODIFY	K OW D AH F AY
CODIFYING	K OW D AH F AY IH NG
CODING	K OW D IH NG
CODIRECT	K OW D AH R EH K T
CODIRECTED	K OW D AH R EH K T IH D
CODIRECTING	K OW D AH R EH K T IH NG
CODIRECTION	K OW D AH R EH K SH AH N
CODIRECTIONS	K OW D AH R EH K SH AH N Z
CODIRECTOR	K OW D AH R EH K T ER
CODIRECTORS	K OW D AH R EH K T ER Z
CODIRECTS	K OW D AH R EH K T S
CODISCOVER	K OW D IH S K AH V ER
CODISCOVERED	K OW D IH S K AH V ER D
CODISCOVERER	K OW D IH S K OW V EH R ER
CODISCOVERERS	K OW D IH S K OW V EH R ER Z
CODISCOVERING	K OW D IH S K AH V ER IH NG
CODISCOVERS	K OW D IH S K AH V ER Z
CODLIN	K AA D L IH N
CODLING	K AA D L IH NG
CODLINGS	K AA D L IH NG Z
CODLINS	K AA D L IH N Z
CODOMINANT	K OW D AA M AH N AH N T
CODOMINANTS	K OW D AA M AH N AH N T S
CODON	K OW D AA N
CODONS	K OW D AA N Z
CODPIECE	K AA D P IY S
CODPIECES	K AA D P IY S IH Z
CODRIVE	K OW D R AY V
CODRIVEN	K OW D R AY V AH N
CODRIVER	K OW D R AY V ER
CODRIVERS	K OW D R AY V ER Z
CODRIVES	K OW D R AY V Z
CODRIVING	K OW D R AY V IH NG
CODROVE	K OW D R OW V
CODS	K AA D Z
CODSWALLOP	K AA D Z W AA L IH P
CODSWALLOPS	K AA D Z W AA L IH P S
COED	K OW EH D
COED(2)	K OW D
COEDIT	K OW EH D AH T
COEDITED	K OW EH D AH T IH D
COEDITING	K OW EH D AH T IH NG
COEDITOR	K OW EH D AH T ER
COEDITORS	K OW EH D AH T ER Z
COEDITS	K OW EH D AH T S
COEDS	K OW EH D Z
COEDUCATION	K OW EH JH AH K EY SH AH N
COEDUCATIONAL	K OW EH JH AH K EY SH AH N AH L
COEDUCATIONALLY	K OW EH JH AH K EY SH AH N AH L IY
COEDUCATIONS	K OW EH JH AH K EY SH AH N Z
COEFFECT	K OW IH F EH K T
COEFFECTS	K OW IH F EH K T S
COEFFICIENT	K OW AH F IH SH AH N T
COEFFICIENTS	K OW AH F IH SH AH N T S
COELACANTH	S IY L AH K AE N TH
COELACANTHS	K OW EH L AH K AH N TH S
COELENTERA	K OW AH L EH N T AH R AH
COELENTERATE	K OW AH L EH N T AH R EY T
COELENTERATES	K OW AH L EH N T AH R EY T S
COELENTERON	K OW AH L EH N T AH R AH N
COELIAC	K OW IY L IY AH K
COELOM	K OW EH L AH M
COELOMATA	K OW AH L AA M AH T AH
COELOMATE	K OW EH L AH M EY T
COELOMATES	K OW EH L AH M EY T S
COELOME	K OW AH L OW M
COELOMES	K OW AH L OW M Z
COELOMIC	K OW EH L AH M AH K
COELOMS	K OW EH L AH M Z
COEMBODIED	K OW IH M B AA D IY D
COEMBODIES	K OW IH M B AA D IY Z
COEMBODY	K OW IH M B AA D IY
COEMBODYING	K OW IH M B AA D IY IH NG
COEMPLOY	K OW IH M P L OY
COEMPLOYED	K OW IH M P L OY IY D
COEMPLOYING	K OW IH M P L OY IY IH NG
COEMPLOYS	K OW IH M P L OY Z
COEMPT	K OW EH M P T
COEMPTED	K OW EH M P T AH D
COEMPTING	K OW EH M P T AH NG
COEMPTS	K OW EH M P T S
COENACT	K OW EH N AE K T
COENACTED	K OW EH N AE K T IH D
COENACTING	K OW EH N AE K T IH NG
COENACTS	K OW EH N AE K T S
COENAMOR	K OW AH N EY M AH R
COENAMORED	K OW AH N AE M AH R D
COENAMORING	K OW AH N AE M AH R AH NG
COENAMORS	K OW AH N AE M AH R Z
COENDURE	K OW EH N D Y UH R
COENDURED	K OW EH N D Y UH R D
COENDURES	K OW EH N D Y UH R Z
COENDURING	K OW EH N D Y UH R IH NG
COENOBITE	K OW AH N AH B AY T
COENOBITES	K OW AH N AH B AY T S
COENOCYTE	K OW AH N AH S AY T
COENOCYTES	K OW AH N AH S AY T S
COENOCYTIC	K OW AH N AA S AH T AH K
COENURE	K OW EH N Y AH R
COENURES	K OW EH N Y AH R Z
COENURI	K OW AH N Y UH R IY
COENURUS	K OW EH N Y AH R AH S
COENZYMATIC	K OW EH N Z AH M AE T IH K
COENZYMATICALLY	K OW EH N Z AH M AE T IH K AH L IY
COENZYME	K OW EH N Z AY M
COENZYMES	K OW EH N Z AY M Z
COEQUAL	K OW IY K W AH L
COEQUALITIES	K OW IH K W AA L AH T IY Z
COEQUALITY	K OW IH K W AA L AH T IY
COEQUALLY	K OW IY K W AH L IY
COEQUALS	K OW IY K W AH L Z
COEQUATE	K OW IH K W EY T
COEQUATED	K OW IH K W EY T IH D
COEQUATES	K OW IH K W EY T S
COEQUATING	K OW IH K W EY T IH NG
COERCE	K OW ER S
COERCED	K OW ER S T
COERCER	K OW ER S ER
COERCERS	K OW ER S ER Z
COERCES	K OW ER S IH Z
COERCIBLE	K OW ER S AH B AH L
COERCING	K OW ER S IH NG
COERCION	K OW ER SH AH N
COERCIONS	K OW ER SH AH N Z
COERCIVE	K OW ER S IH V
COERCIVELY	K OW ER S IH V L IY
COERCIVENESS	K OW ER S IH V N AH S
COERCIVENESSES	K OW ER S IH V N AH S IH Z
COERCIVITIES	K OW ER S IH V AH T IY Z
COERCIVITY	K OW ER S IH V AH T IY
COERECT	K OW IH R EH K T
COERECTED	K OW IH R EH K T IH D
COERECTING	K OW IH R EH K T IH NG
COERECTS	K OW IH R EH K T S
COESITE	K OW AH S AY T
COESITES	K OW AH S AY T S
COETANEOUS	K OW AH T EY N IY AH S
COETERNAL	K OW IH T ER N AH L
COEVAL	K OW IY V AH L
COEVALITIES	K OW IY V AH L AH T IY Z
COEVALITY	K OW IY V AH L AH T IY
COEVALLY	K OW IY V AH L IY
COEVALS	K OW IY V AH L Z
COEVOLUTION	K OW EH V AH L UW SH AH N
COEVOLUTIONARY	K OW EH V AH L UW SH AH N EH R IY
COEVOLUTIONS	K OW EH V AH L UW SH AH N Z
COEVOLVE	K OW IH V AA L V
COEVOLVED	K OW IH V AA L V D
COEVOLVES	K OW IH V AA L V Z
COEVOLVING	K OW IH V AA L V IH NG
COEXECUTOR	K OW IH G Z EH K Y AH T ER
COEXECUTORS	K OW IH G Z EH K Y AH T ER Z
COEXERT	K OW IH G Z ER T
COEXERTED	K OW IH G Z ER T IH D
COEXERTING	K OW IH G Z ER T IH NG
COEXERTS	K OW IH G Z ER T S
COEXIST	K OW AH G Z IH S T
COEXISTED	K OW AH G Z IH S T AH D
COEXISTENCE	K OW IH G Z IH S T AH N S
COEXISTENCES	K OW EH G Z IH S T AH N S IH Z
COEXISTENT	K OW EH G Z IH S T AH N T
COEXISTING	K OW IH G Z IH S T IH NG
COEXISTS	K OW EH G Z IH S T S
COEXTEND	K OW IH K S T EH N D
COEXTENDED	K OW IH K S T EH N D IH D
COEXTENDING	K OW IH K S T EH N D IH NG
COEXTENDS	K OW IH K S T EH N D Z
COEXTENSIVE	K OW IH K S T EH N S IH V
COEXTENSIVELY	K OW IH K S T EH N S IH V L IY
COFACTOR	K OW F AE K T ER
COFACTORS	K OW F AE K T ER Z
COFAVORITE	K OW F EY V AH R AH T
COFAVORITES	K OW F EY V AH R AH T S
COFEATURE	K OW F IY CH ER
COFEATURED	K OW F IY CH ER D
COFEATURES	K OW F IY CH ER Z
COFEATURING	K OW F IY CH ER IH NG
COFF	K AA F
COFFEE	K AA F IY
COFFEE(2)	K AO F IY
COFFEECAKE	K AO F IY K EY K
COFFEECAKES	K AO F IY K EY K S
COFFEEHOUSE	K AO F IY HH AW S
COFFEEHOUSES	K AO F IY HH AW S IH Z
COFFEEMAKER	K AO F IY M EY K ER
COFFEEMAKERS	K AO F IY M EY K ER Z
COFFEEPOT	K AO F IY P AA T
COFFEEPOTS	K AO F IY P AA T S
COFFEES	K AO F IY Z
COFFER	K AO F ER
COFFERDAM	K AO F ER D AE M
COFFERDAMS	K AO F ER D AE M Z
COFFERED	K AO F ER D
COFFERING	K AO F ER IH NG
COFFERS	K AA F ER Z
COFFERS(2)	K AO F ER Z
COFFIN	K AO F IH N
COFFINED	K AO F AH N D
COFFING	K AO F IH NG
COFFINING	K AO F AH N IH NG
COFFINS	K AO F IH N Z
COFFLE	K AA F AH L
COFFLED	K AA F AH L D
COFFLES	K AA F AH L Z
COFFLING	K AA F L AH NG
COFFRET	K AA F R EH T
COFFRETS	K AA F R EH T S
COFFS	K AA F S
COFINANCE	K OW F AH N AE N S
COFINANCED	K OW F AH N AE N S T
COFINANCES	K OW F AH N AE N S IH Z
COFINANCING	K OW F AH N AE N S IH NG
COFOUND	K OW F AW N D
COFOUNDED	K OW F AW N D IH D
COFOUNDER	K OW F AW N D ER
COFOUNDERS	K OW F AW N D ER Z
COFOUNDING	K OW F AW N D IH NG
COFOUNDS	K OW F AW N D Z
COFT	K AA F T
COFUNCTION	K OW F AH NG K SH AH N
COFUNCTIONS	K OW F AH NG K SH AH N Z
COG	K AO G
COGENCIES	K OW JH AH N S IY Z
COGENCY	K OW JH AH N S IY
COGENERATION	K OW JH EH N ER EY SH AH N
COGENERATIONS	K OW JH EH N ER EY SH AH N Z
COGENERATOR	K OW JH EH N ER EY T ER
COGENERATORS	K OW JH EH N ER EY T ER Z
COGENT	K OW JH AH N T
COGENTLY	K OW JH AH N T L IY
COGGED	K AA G D
COGGING	K AA G IH NG
COGITABLE	K OW JH AY T AH B AH L
COGITATE	K AA JH IH T EY T
COGITATED	K OW JH AH T EY T AH D
COGITATES	K OW JH AH T EY T S
COGITATING	K OW JH AH T EY T AH NG
COGITATION	K AA JH IH T EY SH AH N
COGITATIONS	K OW JH AH T EY T IY AH N Z
COGITATIVE	K OW JH AH T EY T AH V
COGITO	K OW JH IH T OW
COGITOS	K OW JH IH T AH Z
COGNAC	K OW N Y AE K
COGNAC(2)	K AA N Y AE K
COGNACS	K OW N Y AE K S
COGNATE	K AA G N EY T
COGNATELY	K AA G N EY T L IY
COGNATES	K AA G N EY T S
COGNATION	K AA G N EY SH AH N
COGNATIONS	K AA G N EY SH AH N Z
COGNISE	K AH N AY Z
COGNISED	K AA G N AH S T
COGNISES	K AH N AY Z AH Z
COGNISING	K AH N AY Z AH NG
COGNITION	K AA G N IH SH AH N
COGNITIONAL	K AH N AH T IY AH N AH L
COGNITIONS	K AH N IH T IY AH N Z
COGNITIVE	K AA G N IH T IH V
COGNITIVELY	K AA G N AH T IH V L IY
COGNIZABLE	K AA G N AY Z AH B AH L
COGNIZABLY	K AA G N AH Z AH B L IY
COGNIZANCE	K AA G N AH Z AH N S
COGNIZANCES	K AA G N AH Z AH N S IH Z
COGNIZANT	K AA G N AH Z AH N T
COGNIZE	K AA G N AY Z
COGNIZED	K AA G N AY Z D
COGNIZER	K AA G N AY Z AH R
COGNIZERS	K AH N IH Z AH R Z
COGNIZES	K AA G N AY Z AH Z
COGNIZING	K AA G N AY Z AH NG
COGNOMEN	K OW N OW M AH N
COGNOMENS	K OW N OW M AH N Z
COGNOMINA	K AH N AA M AH N AH
COGNOMINAL	K AA G N AA M AH N AH L
COGNOSCENTE	K AH N AA S AH N T
COGNOSCENTI	K AA G N AO SH EH N T IY
COGNOSCIBLE	K AH N AA S AH B AH L
COGNOVIT	K AH N AA V AH T
COGNOVITS	K AH N AA V AH T S
COGON	K AA G AO N
COGONS	K AA G AO N Z
COGS	K AA G Z
COGWAY	K AA G W EY
COGWAYS	K AA G W EY Z
COGWHEEL	K AA G W IY L
COGWHEELS	K AA G W IY L Z
COHABIT	K OW HH AE B IH T
COHABITANT	K OW HH AE B AH T AH N T
COHABITANTS	K OW HH AE B AH T AH N T S
COHABITATION	K OW HH AE B AH T EY SH AH N
COHABITATIONS	K OW HH AE B AH T EY SH AH N Z
COHABITED	K OW HH AE B AH T IH D
COHABITING	K OW HH AE B IH T IH NG
COHABITS	K OW HH AE B AH T S
COHEAD	K OW HH EH D
COHEADED	K OW HH EH D IH D
COHEADING	K OW HH EH D IH NG
COHEADS	K OW HH EH D Z
COHEIR	K OW EH R
COHEIRESS	K OW EH R AH S
COHEIRESSES	K OW EH R AH S IH Z
COHEIRS	K OW EH R Z
COHERE	K OW HH IH R
COHERED	K OW HH IH R D
COHERENCE	K OW HH IH R AH N S
COHERENCES	K OW HH IH ER AH N S IH Z
COHERENCIES	K OW HH IH ER AH N S IY Z
COHERENCY	K OW HH IH ER AH N S IY
COHERENT	K OW HH IH R AH N T
COHERENTLY	K OW HH IY R AH N T L IY
COHERER	K OW HH IH ER ER
COHERERS	K OW HH IH ER ER Z
COHERES	K OW HH IH R Z
COHERING	K OW HH IH ER IH NG
COHESION	K OW HH IY ZH AH N
COHESIONLESS	K OW HH IY ZH AH N L AH S
COHESIONS	K OW HH IY ZH AH N Z
COHESIVE	K OW HH IY S IH V
COHESIVELY	K OW HH IY S IH V L IY
COHESIVENESS	K OW HH IY S IH V N AH S
COHESIVENESSES	K OW HH IY S IH V N AH S IH Z
COHO	K OW HH OW
COHOBATE	K OW HH AA B AH T
COHOBATED	K OW HH AA B EY T IH D
COHOBATES	K OW HH AA B AH T S
COHOBATING	K OW HH AA B EY T IH NG
COHOG	K OW HH AA G
COHOGS	K OW HH AA G Z
COHOLDER	K OW HH OW L D ER
COHOLDERS	K OW HH OW L D ER Z
COHOMOLOGICAL	K OW HH OW M OW L AA JH IH K AH L
COHOMOLOGIES	K OW HH OW M AA L AH JH IY Z
COHOMOLOGY	K OW HH OW M AA L AH JH IY
COHORT	K OW HH AO R T
COHORTS	K OW HH AO R T S
COHOS	K OW HH AA Z
COHOSH	K OW HH AA SH
COHOSHES	K OW HH AA SH AH Z
COHOST	K OW HH OW S T
COHOSTED	K OW HH OW S T IH D
COHOSTESS	K OW HH OW S T AH S
COHOSTESSED	K OW HH OW S T AH S T
COHOSTESSES	K OW HH OW S T AH S IH Z
COHOSTESSING	K OW HH OW S T AH S IH NG
COHOSTING	K OW HH OW S T IH NG
COHOSTS	K OW HH OW S T S
COHUNE	K OW HH Y UW N
COHUNES	K OW HH Y UW N Z
COIF	K W AA F
COIFED	K OW AY F T
COIFFE	K W AA F EY
COIFFED	K W AA F T
COIFFES	K OW IH F S
COIFFEUR	K OW IH F AH R
COIFFEURS	K OW IH F IY Y AH R Z
COIFFEUSE	K OW IH F Y UW Z
COIFFEUSES	K OW IH F IY AH Z AH Z
COIFFING	K OW IH F AH NG
COIFFURE	K W AA F Y UH R
COIFFURED	K W AA F Y UH R D
COIFFURES	K W AA F Y UH R Z
COIFFURING	K W AA F Y UH R IH NG
COIFING	K OW AY F AH NG
COIFS	K OW IH F S
COIGN	K OW IH N
COIGNE	K OW IH N
COIGNED	K OW IH N D
COIGNES	K OW IH N Z
COIGNING	K OW IH N AH NG
COIGNS	K OW IH N Z
COIL	K OY L
COILABILITIES	K OY L AH B IH L AH T EH Z
COILABILITY	K OY L AH B IH L AH T EH
COILED	K OY L D
COILER	K OY L ER
COILERS	K OY L ER Z
COILING	K OY L IH NG
COILS	K OY L Z
COIN	K OY N
COINABLE	K OY N AH B AH L
COINAGE	K OY N IH JH
COINAGES	K OY N IH JH IH Z
COINCIDE	K OW IH N S AY D
COINCIDED	K OW AH N S AY D AH D
COINCIDENCE	K OW IH N S IH D AH N S
COINCIDENCES	K OW IH N S AH D AH N S IH Z
COINCIDENT	K OW IH N S AH D AH N T
COINCIDENTAL	K OW IH N S AH D EH N T AH L
COINCIDENTALLY	K OW IH N S IH D EH N T AH L IY
COINCIDENTLY	K OW IH N S AH D AH N T L IY
COINCIDES	K OW IH N S AY D Z
COINCIDING	K OW AH N S AY D IH NG
COINED	K OY N D
COINER	K OY N ER
COINERS	K OY N ER Z
COINFER	K OW IH N F ER
COINFERRED	K OW IH N F ER D
COINFERRING	K OW IH N F ER IH NG
COINFERS	K OW IH N F ER Z
COINHERE	K OW IH N HH IH ER
COINHERED	K OW IH N HH IH ER D
COINHERES	K OW IH N HH IH ER Z
COINHERING	K OW IH N HH IH ER IH NG
COINING	K OY N IH NG
COINMATE	K OW IH N M EY T
COINMATES	K OW IH N M EY T S
COINS	K OY N Z
COINSURANCE	K OW IH N SH ER AH N S
COINSURANCES	K OW IH N SH UH R AH N S IH Z
COINSURE	K OW IH N SH UH R
COINSURED	K OW IH N SH UH R D
COINSURER	K OW IH N SH UH R ER
COINSURERS	K OW IH N SH UH R ER Z
COINSURES	K OW IH N SH UH R Z
COINSURING	K OW IH N SH UH R IH NG
COINTER	K OW IH N T ER
COINTERRED	K OW IH N T ER R EH D
COINTERRING	K OW IH N T ER R IH NG
COINTERS	K OW IH N T ER Z
COINVENT	K OW IH N V EH N T
COINVENTED	K OW IH N V EH N T IH D
COINVENTING	K OW IH N V EH N T IH NG
COINVENTOR	K OW IH N V EH N T ER
COINVENTORS	K OW IH N V EH N T ER Z
COINVENTS	K OW IH N V EH N T S
COINVESTIGATOR	K OW IH N V EH S T AH G AH T ER
COINVESTIGATORS	K OW IH N V EH S T AH G AH T ER Z
COINVESTOR	K OW IH N V EH S T ER
COINVESTORS	K OW IH N V EH S T ER Z
COIR	K OW IH R
COIRS	K OW IH R Z
COISTREL	K OW IH S T R AH L
COISTRELS	K OW IH S T R AH L Z
COISTRIL	K OW IH S T R AH L
COISTRILS	K OW IH S T R AH L Z
COITAL	K OW AY T AH L
COITALLY	K OW AH T AE L IY
COITION	K OW IH SH AH N
COITIONAL	K OW AH T IY AH N AH L
COITIONS	K OW IH T IY AH N Z
COITUS	K OY T AH S
COITUSES	K OW IH T Y UW Z AH Z
COJOIN	K OW JH OY N
COJOINED	K OW JH OY N D
COJOINING	K OW JH OY N IH NG
COJOINS	K OW JH OY N Z
COJONES	K OW JH OW N Z
COKE	K OW K
COKED	K OW K T
COKEHEAD	K OW K HH EH D
COKEHEADS	K OW K HH EH D Z
COKES	K OW K S
COKING	K OW K IH NG
COL	K AA L
COLA	K OW L AH
COLANDER	K AA L AH N D ER
COLANDERS	K AA L AH N D ER Z
COLAS	K OW L AH S
COLATITUDE	K OW L AE T AH T UW D
COLATITUDES	K OW L AE T AH T UW D Z
COLCANNON	K AA L K AE N AH N
COLCANNONS	K AA L K AE N AH N Z
COLCHICINE	K AO L CH AH S IY N
COLCHICINES	K AA L CH AH S AY N Z
COLCHICUM	K AA L CH IH K AH M
COLCHICUMS	K AA L CH IH K AH M Z
COLD	K OW L D
COLDBLOOD	K OW L D B L AH D
COLDBLOODED	K OW L D B L AH D IH D
COLDCOCK	K OW L D K AA K
COLDCOCKED	K OW L D K AA K T
COLDCOCKING	K OW L D K AA K IH NG
COLDCOCKS	K OW L D K AA K S
COLDER	K OW L D ER
COLDEST	K OW L D AH S T
COLDHEARTED	K OW L D HH AA R T IH D
COLDHEARTEDLY	K OW L D HH AA R T AH D L IY
COLDHEARTEDNESS	K OW L D HH AA R T AH D N AH S
COLDHEARTEDNESSES	K OW L D HH AA R T AH D N AH S IH Z
COLDISH	K OW L D IH SH
COLDLY	K OW L D L IY
COLDNESS	K OW L D N AH S
COLDNESSES	K OW L D N AH S IH Z
COLDS	K OW L D Z
COLE	K OW L
COLEAD	K OW L IY D
COLEADER	K OW L IY D ER
COLEADERS	K OW L IY D ER Z
COLEADING	K OW L IY D IH NG
COLEADS	K OW L IY D Z
COLED	K OW L D
COLEMANITE	K OW L EH M AH N AY T
COLEMANITES	K OW L EH M AH N AY T S
COLEOPTERA	K OW L AA P T IH R AH
COLEOPTERAN	K OW L IY AA P T AH R AH N
COLEOPTERANS	K OW L IY AA P T AH R AH N Z
COLEOPTERIST	K OW L AA P T ER IH S T
COLEOPTERISTS	K OW L AA P T ER IH S T S
COLEOPTEROUS	K OW L AA P T ER AH S
COLEOPTILE	K OW L IY AA P T AH L
COLEOPTILES	K OW L IY AA P T AH L Z
COLEORHIZA	K OW L IY AO R AH Z AH
COLEORHIZAE	K OW L IY AO R AH Z IY
COLES	K OW L Z
COLESEED	K OW L S IY D
COLESEEDS	K OW L S IY D Z
COLESLAW	K OW L S L AA
COLESLAWS	K OW L Z L AO Z
COLESSEE	K OW L EH S IY
COLESSEES	K OW L EH S IY Z
COLESSOR	K OW L EH S ER
COLESSORS	K OW L EH S ER Z
COLEUS	K OW L IY AH S
COLEUSES	K OW L Y UW S IH Z
COLEWORT	K OW L UW AH R T
COLEWORTS	K OW L UW AH R T S
COLIC	K OW L IH K
COLICIN	K OW L IH K S IH N
COLICINE	K OW L AH S AY N
COLICINES	K OW L AH S AY N Z
COLICINS	K OW L IH K S IH N Z
COLICKY	K AA L AH K IY
COLICROOT	K OW L IH K R UW T
COLICROOTS	K OW L IH K R UW T S
COLICS	K OW L IH K S
COLIES	K OW L AY Z
COLIFORM	K OW L AH F AO R M
COLIFORM(2)	K AO L AH F AO R M
COLIFORMS	K OW L AH F AO R M Z
COLIFORMS(2)	K AO L AH F AO R M Z
COLIN	K OW L IH N
COLINEAR	K OW L IH N IY ER
COLINEARITIES	K OW L IH N IY ER AH T IY Z
COLINEARITY	K OW L IH N IY ER AH T IY
COLINS	K OW L IH N Z
COLIPHAGE	K OW L IH F AH JH
COLIPHAGES	K OW L IH F AH JH AH Z
COLISEUM	K AA L AH S IY AH M
COLISEUMS	K AA L AH S IY AH M Z
COLISTIN	K OW L IH S T IH N
COLISTINS	K OW L IH S T IH N Z
COLITIC	K OW L IH T IH K
COLITIS	K OW L AH T IY Z
COLITISES	K OW L AH T IY Z IH Z
COLLABORATE	K AH L AE B ER EY T
COLLABORATED	K AH L AE B ER EY T AH D
COLLABORATED(2)	K AH L AE B ER EY T IH D
COLLABORATES	K AH L AE B AH R EY T S
COLLABORATING	K AH L AE B ER EY T IH NG
COLLABORATION	K AH L AE B ER EY SH AH N
COLLABORATIONISM	K AH L AE B AH R EY SH AH N IH Z AH M
COLLABORATIONISMS	K AH L AE B AH R EY SH AH N IH Z AH M Z
COLLABORATIONIST	K AH L AE B ER EY SH AH N IH S T
COLLABORATIONISTS	K AH L AE B AH R EY SH AH N IH S T S
COLLABORATIONS	K AA L AH B ER EY SH AH N Z
COLLABORATIVE	K AH L AE B ER EY T IH V
COLLABORATIVE(2)	K AH L AE B R AH T IH V
COLLABORATIVELY	K AH L AE B AH R EY T IH V L IY
COLLABORATIVES	K AH L AE B AH R EY T IH V Z
COLLABORATOR	K AH L AE B ER EY T ER
COLLABORATORS	K AH L AE B ER EY T ER Z
COLLAGE	K AH L AA ZH
COLLAGED	K AH L AA ZH D
COLLAGEN	K AA L AH G AH N
COLLAGENASE	K AA L AE JH AH N EY Z
COLLAGENASES	K AA L AE JH AH N EY Z AH Z
COLLAGENOUS	K AA L AH JH EH N AH S
COLLAGENS	K AA L AH JH EH N Z
COLLAGES	K AH L AA ZH IH Z
COLLAGING	K AH L AA ZH IH NG
COLLAGIST	K AH L AA ZH IH S T
COLLAGISTS	K AH L AA ZH IH S T S
COLLAPSE	K AH L AE P S
COLLAPSED	K AH L AE P S T
COLLAPSES	K AH L AE P S IH Z
COLLAPSIBILITIES	K AH L AE P S AH B IH L AH T IY Z
COLLAPSIBILITY	K AH L AE P S AH B IH L AH T IY
COLLAPSIBLE	K AH L AE P S AH B AH L
COLLAPSING	K AH L AE P S IH NG
COLLAR	K AA L ER
COLLARBONE	K AA L ER B OW N
COLLARBONES	K AA L ER B OW N Z
COLLARD	K AA L ER D
COLLARDS	K AA L ER D Z
COLLARED	K AA L ER D
COLLARET	K AA L AE R AH T
COLLARETS	K AA L AE R AH T S
COLLARING	K AA L ER IH NG
COLLARLESS	K AA L ER L AH S
COLLARS	K AA L ER Z
COLLATE	K AH L EY T
COLLATED	K AH L EY T IH D
COLLATERAL	K AH L AE T ER AH L
COLLATERALITIES	K AH L EY T ER AH L AH T IY Z
COLLATERALITY	K AH L EY T ER AH L AH T IY
COLLATERALIZE	K AH L AE T ER AH L AY Z
COLLATERALIZED	K AH L AE T ER AH L AY Z D
COLLATERALIZES	K AH L EY T ER AH L AY Z IH Z
COLLATERALIZING	K AH L EY T ER AH L AY Z IH NG
COLLATERALLY	K AH L EY T ER AH L IY
COLLATERALS	K AH L EY T ER AH L Z
COLLATES	K AH L EY T S
COLLATING	K AH L EY T IH NG
COLLATION	K AH L EY SH AH N
COLLATIONS	K AH L EY SH AH N Z
COLLATOR	K AH L EY T ER
COLLATORS	K AH L EY T ER Z
COLLEAGUE	K AA L IY G
COLLEAGUES	K AA L IY G Z
COLLEAGUESHIP	K AA L IY G SH IH P
COLLEAGUESHIPS	K AA L IY G SH IH P S
COLLECT	K AH L EH K T
COLLECTABLE	K AA L IH K T AH B AH L
COLLECTABLES	K AA L IH K T AH B AH L Z
COLLECTANEA	K AA L EH K T EY N IY AH
COLLECTED	K AH L EH K T AH D
COLLECTEDLY	K AA L IH K T AH D L IY
COLLECTEDNESS	K AA L IH K T AH D N AH S
COLLECTEDNESSES	K AA L IH K T AH D N AH S IH Z
COLLECTIBLE	K AH L EH K T AH B AH L
COLLECTIBLES	K AH L EH K T AH B AH L Z
COLLECTING	K AH L EH K T IH NG
COLLECTION	K AH L EH K SH AH N
COLLECTIONS	K AH L EH K SH AH N Z
COLLECTIVE	K AH L EH K T IH V
COLLECTIVELY	K AH L EH K T IH V L IY
COLLECTIVES	K AH L EH K T IH V Z
COLLECTIVISE	K AA L EH K T AH V AY Z
COLLECTIVISED	K AA L IH K T IH V IY Z D
COLLECTIVISES	K AA L IH K T IH V IY Z IH Z
COLLECTIVISING	K AA L IH K T IH V IY Z IH NG
COLLECTIVISM	K AH L EH K T IH V IH Z AH M
COLLECTIVISMS	K AA L IH K T IH V IH Z AH M Z
COLLECTIVIST	K AH L EH K T IH V IH S T
COLLECTIVISTIC	K AA L IH K T IH V IH S T IH K
COLLECTIVISTICALLY	K AA L IH K T IH V IH S T IH K AH L IY
COLLECTIVISTS	K AA L IH K T IH V IH S T S
COLLECTIVITIES	K AA L IH K T IH V AH T IY Z
COLLECTIVITY	K AA L IH K T IH V AH T IY
COLLECTIVIZATION	K AH L EH K T IH V IH Z EY SH AH N
COLLECTIVIZATIONS	K AA L IH K T IH V AH Z EY SH AH N Z
COLLECTIVIZE	K AH L EH K T IH V AY Z
COLLECTIVIZED	K AH L EH K T IH V AY Z D
COLLECTIVIZES	K AA L IH K T IH V AY Z IH Z
COLLECTIVIZING	K AA L IH K T IH V AY Z IH NG
COLLECTOR	K AH L EH K T ER
COLLECTORS	K AH L EH K T ER Z
COLLECTORSHIP	K AA L IH K T ER SH IH P
COLLECTORSHIPS	K AA L IH K T ER SH IH P S
COLLECTS	K AH L EH K T S
COLLEEN	K AA L IY N
COLLEENS	K AA L IY N Z
COLLEGE	K AA L IH JH
COLLEGER	K AA L IH JH ER
COLLEGERS	K AA L IH JH ER Z
COLLEGES	K AA L IH JH IH Z
COLLEGIA	K AA L IY JH IY AH
COLLEGIAL	K AH L IY JH IY AH L
COLLEGIALITIES	K AA L IH JH IY AH L AH T IY Z
COLLEGIALITY	K AH L IY JH IY AE L IH T IY
COLLEGIALLY	K AA L IH JH IY AH L IY
COLLEGIAN	K AH L IY JH AH N
COLLEGIANS	K AH L IY JH AH N Z
COLLEGIATE	K AH L IY JH IH T
COLLEGIATELY	K AH L IY JH AH T L IY
COLLEGIUM	K AA L IY JH IY AH M
COLLEGIUMS	K AA L IY JH IY AH M Z
COLLEMBOLAN	K AA L EH M B AH L AH N
COLLEMBOLANS	K AA L EH M B AH L AH N Z
COLLEMBOLOUS	K AA L EH M B AH L AH S
COLLENCHYMA	K AA L EH NG K AH M AH
COLLENCHYMAS	K AA L EH NG K AH M AH Z
COLLENCHYMATA	K AA L EH NG K IH M AH T AH
COLLENCHYMATOUS	K AA L EH NG K IH M AH T AH S
COLLET	K AA L IH T
COLLETED	K AA L IY T AH D
COLLETING	K AA L IY T AH NG
COLLETS	K AA L EH T S
COLLIDE	K AH L AY D
COLLIDED	K AH L AY D IH D
COLLIDER	K AH L AY D ER
COLLIDERS	K AH L AY D ER Z
COLLIDES	K AH L AY D Z
COLLIDING	K AH L AY D IH NG
COLLIE	K AA L IY
COLLIED	K AA L IY D
COLLIER	K AA L Y ER
COLLIERIES	K AA L IY AH R IY Z
COLLIERS	K AA L Y ER Z
COLLIERY	K AA L IY AH R IY
COLLIES	K AA L IY Z
COLLIESHANGIE	K AA L IY Z HH AE NG IY
COLLIESHANGIES	K AA L IY Z HH AE NG IY Z
COLLIGATE	K AA L AH G EY T
COLLIGATED	K AA L AH G EY T AH D
COLLIGATES	K AA L AH G EY T S
COLLIGATING	K AA L AH G EY T AH NG
COLLIGATION	K AA L AH G EY SH AH N
COLLIGATIONS	K AA L AH G EY T IY AH N Z
COLLIGATIVE	K AA L AH G EY T AH V
COLLIMATE	K AA L AH M EY T
COLLIMATED	K AA L AH M EY T IH D
COLLIMATES	K AA L AH M EY T S
COLLIMATING	K AA L AH M EY T IH NG
COLLIMATION	K AA L AH M EY SH AH N
COLLIMATIONS	K AA L AH M EY SH AH N Z
COLLIMATOR	K AA L AH M EY T ER
COLLIMATORS	K AA L AH M EY T ER Z
COLLINEAR	K AA L AY N IY AH R
COLLINEARITIES	K AA L AH N IY R AH T AY Z
COLLINEARITY	K AA L AH N IY R AH T IY
COLLINS	K AA L IH N Z
COLLINSES	K AA L IH N S AH Z
COLLISION	K AH L IH ZH AH N
COLLISIONAL	K AH L IH ZH AH N AH L
COLLISIONALLY	K AH L IH ZH AH N AH L IY
COLLISIONS	K AH L IH ZH AH N Z
COLLOCATE	K AA L AH K EY T
COLLOCATED	K AA L AH K EY T AH D
COLLOCATES	K AA L AH K EY T S
COLLOCATING	K AA L AH K EY T AH NG
COLLOCATION	K AA L AH K EY SH AH N
COLLOCATIONAL	K AA L AH K AH T IY AH N AH L
COLLOCATIONS	K AA L AH K EY T IY AH N Z
COLLODION	K AH L OW D IY AH N
COLLODIONS	K AA L OW D IY AH N Z
COLLOGUE	K AA L AA G
COLLOGUED	K AA L AA G D
COLLOGUES	K AA L AA G Z
COLLOGUING	K AA L AA G AH NG
COLLOID	K AA L OY D
COLLOIDAL	K AH L OY D AH L
COLLOIDALLY	K AH L OY D AH L IY
COLLOIDS	K AA L OY D Z
COLLOP	K AA L AA P
COLLOPS	K AA L AA P S
COLLOQUIA	K AA L AA K W IY AH
COLLOQUIAL	K AH L OW K W IY AH L
COLLOQUIALISM	K AH L OW K W IY AH L IH Z AH M
COLLOQUIALISMS	K AH L OW K W IY AH L IH Z AH M Z
COLLOQUIALITIES	K AH L OW K W IY AH L AH T IY Z
COLLOQUIALITY	K AH L OW K W IY AH L AH T IY
COLLOQUIALLY	K AH L OW K W IY AH L IY
COLLOQUIALS	K AH L OW K W IY AH L Z
COLLOQUIES	K AA L AH K W IY Z
COLLOQUIST	K AA L AA K W AH S T
COLLOQUISTS	K AA L AA K W AH S T S
COLLOQUIUM	K AH L OW K W IY AH M
COLLOQUIUMS	K AH L OW K W IY AH M Z
COLLOQUY	K AA L AH K W IY
COLLOTYPE	K AA L AH T AY P
COLLOTYPES	K AA L AH T AY P S
COLLUDE	K AH L UW D
COLLUDED	K AH L UW D IH D
COLLUDER	K AA L UW D AH R
COLLUDERS	K AA L UW D AH R Z
COLLUDES	K AA L UW D Z
COLLUDING	K AH L UW D IH NG
COLLUSION	K AH L UW ZH AH N
COLLUSIONS	K AH L UW ZH AH N Z
COLLUSIVE	K AH L UW S IH V
COLLUSIVELY	K AH L UW S IH V L IY
COLLUVIA	K AA L UW V IY AH
COLLUVIAL	K AA L UW V IY AH L
COLLUVIUM	K AA L UW V IY AH M
COLLUVIUMS	K AA L UW V IY AH M Z
COLLY	K AA L IY
COLLYING	K AA L AY AH NG
COLLYRIA	K AA L IH R IY AH
COLLYRIUM	K AA L IH R IY AH M
COLLYRIUMS	K AA L IH R IY AH M Z
COLLYWOBBLES	K AA L IH W AH B AH L Z
COLOBI	K OW L OW B IY
COLOBOMA	K OW L AA B AH M AH
COLOBOMATA	K OW L AH B AA M AH T AH
COLOBUS	K OW L OW B AH S
COLOBUSES	K OW L AA B Y UW S IH Z
COLOCATE	K OW L OW K AH T
COLOCATED	K OW L OW K EY T IH D
COLOCATES	K OW L OW K AH T S
COLOCATING	K OW L OW K EY T IH NG
COLOCYNTH	K OW L AA S AH N TH
COLOCYNTHS	K OW L AA S AH N TH S
COLOG	K OW L AA G
COLOGARITHM	K OW L AA G AH R IH DH AH M
COLOGARITHMS	K OW L AA G AH R IH DH AH M Z
COLOGNE	K AH L OW N
COLOGNED	K AH L OW N D
COLOGNES	K AH L OW N Z
COLOGS	K OW L AA G Z
COLON	K OW L AH N
COLONE	K OW L OW N
COLONEL	K ER N AH L
COLONELCIES	K OW L AH N EH L S AY Z
COLONELCY	K OW L AH N EH L S IY
COLONELS	K ER N AH L Z
COLONES	K OW L OW N Z
COLONI	K OW L OW N IY
COLONIAL	K AH L OW N IY AH L
COLONIALISM	K AH L OW N IY AH L IH Z AH M
COLONIALISMS	K AH L OW N IY AH L IH Z AH M Z
COLONIALIST	K AH L OW N IY AH L IH S T
COLONIALISTIC	K AH L OW N IY AH L IH S T IH K
COLONIALISTS	K AH L OW N IY AH L IH S T S
COLONIALIZE	K AH L OW N IY AH L AY Z
COLONIALIZED	K AH L OW N IY AH L AY Z D
COLONIALIZES	K AH L OW N IY AH L AY Z IH Z
COLONIALIZING	K AH L OW N IY AH L AY Z IH NG
COLONIALLY	K AH L OW N IY AH L IY
COLONIALNESS	K AH L OW N IY AH L N AH S
COLONIALNESSES	K AH L OW N IY AH L N AH S IH Z
COLONIALS	K AH L OW N IY AH L Z
COLONIC	K OW L AH N IH K
COLONICS	K OW L AH N IH K S
COLONIES	K AA L AH N IY Z
COLONISATION	K AA L AH N IY Z EY SH AH N
COLONISATIONS	K AA L AH N IY Z EY SH AH N Z
COLONISE	K OW L AH N AY Z
COLONISED	K AA L AH N IY Z D
COLONISES	K AA L AH N IY Z IH Z
COLONISING	K AA L AH N IY Z IH NG
COLONIST	K AA L AH N IH S T
COLONISTS	K AA L AH N IH S T S
COLONIZATION	K AA L AH N IH Z EY SH AH N
COLONIZATIONIST	K OW L AH N AH Z EY SH AH N IH S T
COLONIZATIONISTS	K OW L AH N AH Z EY SH AH N IH S T S
COLONIZATIONS	K OW L AH N AH Z EY SH AH N Z
COLONIZE	K AA L AH N AY Z
COLONIZED	K AA L AH N AY Z D
COLONIZER	K AA L AH N AY Z ER
COLONIZERS	K AA L AH N AY Z ER Z
COLONIZES	K AA L AH N AY Z IH Z
COLONIZING	K AA L AH N AY Z IH NG
COLONNADE	K AA L AH N EY D
COLONNADED	K AA L AH N EY D IH D
COLONNADES	K AA L AH N EY D Z
COLONS	K OW L AH N Z
COLONUS	K AH L OW N AH S
COLONY	K AA L AH N IY
COLOPHON	K OW L AA F AH N
COLOPHONIES	K OW L AA P HH OW N IY Z
COLOPHONS	K OW L AA F AH N Z
COLOPHONY	K OW L AA P HH OW N IY
COLOR	K AH L ER
COLOR(2)	K AO L ER
COLORABLE	K AH L ER AH B AH L
COLORABLY	K AH L ER AH B L IY
COLORADO	K AA L ER AA D OW
COLORADO(2)	K AA L ER AE D OW
COLORANT	K AH L ER AH N T
COLORANTS	K AH L ER AH N T S
COLORATION	K AH L ER EY SH AH N
COLORATIONS	K AH L ER EY SH AH N Z
COLORATURA	K AH L ER AH T UH R AH
COLORATURAS	K AH L AH R AH T UH R AH Z
COLORBLIND	K AH L ER B L AY N D
COLORBLINDNESS	K AH L ER B L AY N D N AH S
COLORBLINDNESSES	K AH L ER B L AY N D N AH S IH Z
COLORBRED	K AH L ER B R EH D
COLORECTAL	K OW L OW R EH K T AH L
COLORED	K AH L ER D
COLOREDS	K AA L ER AH D Z
COLORER	K AH L ER ER
COLORERS	K AH L ER ER Z
COLORFAST	K AH L ER F AE S T
COLORFASTNESS	K AH L ER F AE S T N AH S
COLORFASTNESSES	K AH L ER F AE S T N AH S IH Z
COLORFUL	K AH L ER F AH L
COLORFULLY	K AH L ER F L IY
COLORFULNESS	K AH L ER F AH L N AH S
COLORFULNESSES	K AH L ER F AH L N AH S IH Z
COLORIFIC	K OW L AH R IH F AH K
COLORIMETER	K OW L AH R IH M AH T AH R
COLORIMETERS	K OW L AH R IH M AH T AH R Z
COLORIMETRIC	K OW L AO R AH M AH T R AH K
COLORIMETRICALLY	K OW L AO R AH M EH T R AH K AE L IY
COLORIMETRIES	K OW L AH R AH M EH T R AY Z
COLORIMETRY	K OW L AO R AH M EH T R IY
COLORING	K AH L ER IH NG
COLORINGS	K AH L ER IH NG Z
COLORISM	K AH L ER IH Z AH M
COLORISMS	K AH L ER IH Z AH M Z
COLORIST	K AH L ER IH S T
COLORISTIC	K AH L ER IH S T IH K
COLORISTICALLY	K AH L ER IH S T IH K AH L IY
COLORISTS	K AH L ER IH S T S
COLORIZATION	K AH L ER AH Z EY SH AH N
COLORIZATIONS	K AH L ER AH Z EY SH AH N Z
COLORIZE	K AH L ER AY Z
COLORIZED	K AH L ER AY Z D
COLORIZES	K AH L ER AY Z IH Z
COLORIZING	K AH L ER AY Z IH NG
COLORLESS	K AH L ER L AH S
COLORLESSLY	K AH L ER L AH S L IY
COLORLESSNESS	K AH L ER L AH S N AH S
COLORLESSNESSES	K AH L ER L AH S N AH S IH Z
COLORMAN	K AH L ER M AE N
COLORMEN	K AH L ER M EH N
COLORPOINT	K AH L ER P OY N T
COLORPOINTS	K AH L ER P OY N T S
COLORS	K AH L ER Z
COLOSSAL	K AH L AA S AH L
COLOSSALLY	K AH L AA S AH L IY
COLOSSEUM	K AA L AH S IY AH M
COLOSSEUMS	K AA L AH S IY AH M Z
COLOSSI	K OW L AA S IY
COLOSSUS	K AH L AA S AH S
COLOSSUSES	K AH L AA S AH S IH Z
COLOSTOMIES	K OW L AA S T AH M AY Z
COLOSTOMY	K OW L AA S T AH M IY
COLOSTRAL	K OW L AA S T R AH L
COLOSTRUM	K OW L AO S T R AH M
COLOSTRUMS	K OW L AO S T R AH M Z
COLOTOMIES	K OW L AA T AH M AY Z
COLOTOMY	K OW L AA T AH M IY
COLOUR	K AH L ER
COLOURED	K AH L ER D
COLOURER	K AH L ER ER
COLOURERS	K AH L ER ER Z
COLOURING	K AH L ER R IH NG
COLOURS	K AH L ER Z
COLPITIS	K OW L P AY T AH S
COLPITISES	K AA L P AH T AY Z AH Z
COLPORTAGE	K AA L P AO R T AH JH
COLPORTAGES	K AA L P AO R T AH JH AH Z
COLPORTEUR	K AA L P AO R T AH R
COLPORTEURS	K AA L P AO R T IY Y AH R Z
COLS	K AA L Z
COLT	K OW L T
COLTER	K OW L T ER
COLTERS	K OW L T ER Z
COLTISH	K OW L T IH SH
COLTISHLY	K OW L T IH SH L IY
COLTISHNESS	K OW L T IH SH N AH S
COLTISHNESSES	K OW L T IH SH N AH S IH Z
COLTS	K OW L T S
COLTSFOOT	K OW L T S F UH T
COLTSFOOTS	K OW L T S F UH T S
COLUBRID	K OW L AH B R AH D
COLUBRIDS	K OW L AH B R AH D Z
COLUBRINE	K OW L AH B R AY N
COLUGO	K OW L UW G OW
COLUGOS	K OW L AH G AA S
COLUMBARIA	K OW L AH M B AE R IY AH
COLUMBARIUM	K OW L AH M B AE R IY AH M
COLUMBIC	K OW L AH M B AH K
COLUMBINE	K AA L AH M B AY N
COLUMBINES	K AA L AH M B AY N Z
COLUMBITE	K OW L AH M B AY T
COLUMBITES	K OW L AH M B AY T S
COLUMBIUM	K OW L AH M B IY AH M
COLUMBIUMS	K OW L AH M B IY AH M Z
COLUMEL	K OW L UW M AH L
COLUMELLA	K OW L AH M EH L AH
COLUMELLAE	K OW L AH M EH L IY
COLUMELLAR	K OW L AH M EH L AH R
COLUMELS	K OW L UW M AH L Z
COLUMN	K AA L AH M
COLUMNAL	K AA L AH M AH L
COLUMNAR	K AA L AH M ER
COLUMNED	K AA L AH M D
COLUMNIATION	K AA L AH M IY EY SH AH N
COLUMNIATIONS	K AA L AH M IY EY SH AH N Z
COLUMNIST	K AA L AH M N AH S T
COLUMNISTIC	K AA L AH M IH S T IH K
COLUMNISTS	K AA L AH M N AH S T S
COLUMNS	K AA L AH M Z
COLURE	K OW L UH R
COLURES	K OW L UH R Z
COLY	K OW L IY
COLZA	K AA L Z AA
COLZAS	K AA L Z AE Z
COMA	K OW M AH
COMADE	K AH M EY D
COMAE	K AH M EH
COMAKE	K OW M EY K
COMAKER	K OW M EY K ER
COMAKERS	K OW M EY K ER Z
COMAKES	K OW M EY K S
COMAKING	K AH M AH K IH NG
COMAL	K AH M AH L
COMANAGE	K OW M AE N IH JH
COMANAGED	K OW M AE N IH JH D
COMANAGEMENT	K OW M AE N IH JH M AH N T
COMANAGEMENTS	K OW M AE N IH JH M AH N T S
COMANAGER	K OW M AE N IH JH ER
COMANAGERS	K OW M AE N IH JH ER Z
COMANAGES	K OW M AE N IH JH IH Z
COMANAGING	K OW M AE N IH JH IH NG
COMAS	K OW M AH Z
COMATE	K OW M EY T
COMATES	K OW M EY T S
COMATIC	K OW M EY T IH K
COMATIK	K AH M AE T AH K
COMATIKS	K AH M AE T AH K S
COMATOSE	K OW M AH T OW S
COMATULA	K AH M AE T Y UW L AH
COMATULAE	K AH M AE T Y AH L IY
COMB	K OW M
COMBAT	K AA M B AE T
COMBAT(2)	K AH M B AE T
COMBATANT	K AH M B AE T AH N T
COMBATANTS	K AH M B AE T AH N T S
COMBATED	K AH M B AE T IH D
COMBATER	K AH M B AE T ER
COMBATERS	K AH M B AE T ER Z
COMBATING	K AH M B AE T IH NG
COMBATIVE	K AH M B AE T IH V
COMBATIVE(2)	K AA M B AE T IH V
COMBATIVELY	K AH M B AE T IH V L IY
COMBATIVENESS	K AH M B AE T IH V N AH S
COMBATIVENESSES	K AH M B AE T IH V N AH S IH Z
COMBATS	K AH M B AE T S
COMBATTED	K AH M B AE T IH D
COMBATTING	K AH M B AE T IH NG
COMBE	K OW M
COMBED	K OW M D
COMBER	K OW M ER
COMBERS	K OW M ER Z
COMBES	K OW M Z
COMBINABLE	K AH M B AY N AH B AH L
COMBINATION	K AA M B AH N EY SH AH N
COMBINATIONAL	K AA M B AH N EY SH AH N AH L
COMBINATIONS	K AA M B AH N EY SH AH N Z
COMBINATIVE	K AH M B AY N EY T IH V
COMBINATORIAL	K AH M B AY N AH T OW R IY AH L
COMBINATORIALLY	K AH M B AY N AH T OW R IY AH L IY
COMBINATORICS	K AH M B AY N EY T ER IH K S
COMBINATORY	K AH M B AY N AH T OW R IY
COMBINE	K AA M B AY N
COMBINE(2)	K AH M B AY N
COMBINED	K AH M B AY N D
COMBINER	K AH M B AY N ER
COMBINERS	K AH M B AY N ER Z
COMBINES	K AH M B AY N Z
COMBING	K OW M IH NG
COMBINGS	K OW M IH NG Z
COMBINING	K AH M B AY N IH NG
COMBLIKE	K OW M L AY K
COMBO	K AA M B OW
COMBOS	K AA M B OW Z
COMBS	K OW M Z
COMBUST	K AH M B AH S T
COMBUSTED	K AH M B AH S T IH D
COMBUSTIBILITIES	K AH M B AH S T AH B IH L AH T IY Z
COMBUSTIBILITY	K AH M B AH S T AH B IH L AH T IY
COMBUSTIBLE	K AH M B AH S T AH B AH L
COMBUSTIBLES	K AH M B AH S T AH B AH L Z
COMBUSTIBLY	K AH M B AH S T AH B L IY
COMBUSTING	K AH M B AH S T IH NG
COMBUSTION	K AH M B AH S CH AH N
COMBUSTIONS	K AH M B AH S SH AH N Z
COMBUSTIVE	K AH M B AH S T IH V
COMBUSTOR	K AH M B AH S T ER
COMBUSTORS	K AH M B AH S T ER Z
COMBUSTS	K AH M B AH S T S
COME	K AH M
COMEBACK	K AH M B AE K
COMEBACKS	K AH M B AE K S
COMEDIAN	K AH M IY D IY AH N
COMEDIANS	K AH M IY D IY AH N Z
COMEDIC	K AH M IY D IH K
COMEDICALLY	K OW M EH D IH K AH L IY
COMEDIENNE	K AH M IY D IY EH N
COMEDIENNES	K AA M AH D IY N Z
COMEDIES	K AA M AH D IY Z
COMEDO	K AH M D UW
COMEDONES	K AH M D AH N Z
COMEDOS	K AH M D UW Z
COMEDOWN	K AH M D AW N
COMEDOWNS	K AH M D AW N Z
COMEDY	K AA M AH D IY
COMELIER	K AH M L IY ER
COMELIEST	K AH M L IY AH S T
COMELILY	K AH M L IY L IY
COMELINESS	K AH M L IY N AH S
COMELINESSES	K AH M L IY N AH S IH Z
COMELY	K AH M L IY
COMEMBER	K OW M EH M B ER
COMEMBERS	K OW M EH M B ER Z
COMER	K AH M ER
COMERS	K AH M ER Z
COMES	K AH M Z
COMESTIBLE	K AH M AH S T AH B AH L
COMESTIBLES	K AH M AH S T AH B AH L Z
COMET	K AA M AH T
COMETARY	K AA M AH T EH R IY
COMETH	K AH M IH TH
COMETHER	K AH M IY TH ER
COMETHERS	K AH M IY TH ER Z
COMETIC	K AA M AH T IH K
COMETS	K AA M AH T S
COMEUPPANCE	K AH M AH P AH N S
COMEUPPANCES	K AH M AH P AH N S IH Z
COMFIER	K AA M F AY AH R
COMFIEST	K AA M F AY AH S T
COMFIT	K AH M F IH T
COMFITS	K AH M F IH T S
COMFORT	K AH M F ER T
COMFORTABLE	K AH M F ER T AH B AH L
COMFORTABLENESS	K AH M F ER T AH B AH L N AH S
COMFORTABLENESSES	K AH M F ER T AH B AH L N AH S IH Z
COMFORTABLY	K AH M F ER T AH B L IY
COMFORTED	K AH M F ER T IH D
COMFORTER	K AH M F ER T ER
COMFORTERS	K AH M F ER T ER Z
COMFORTING	K AH M F ER T IH NG
COMFORTINGLY	K AH M F ER T IH NG L IY
COMFORTLESS	K AH M F ER T L AH S
COMFORTS	K AH M F ER T S
COMFREY	K AH M F R IY
COMFREYS	K AA M F R EY Z
COMFY	K AH M F IY
COMIC	K AA M IH K
COMICAL	K AA M IH K AH L
COMICALITIES	K AA M IH K AH L AH T IY Z
COMICALITY	K AA M IH K AH L AH T IY
COMICALLY	K AA M IH K AH L IY
COMICALLY(2)	K AA M IH K L IY
COMICS	K AA M IH K S
COMING	K AH M IH NG
COMINGLE	K OW M IH NG G AH L
COMINGLED	K OW M IH NG G AH L D
COMINGLES	K OW M IH NG G AH L Z
COMINGLING	K OW M IH NG G AH L IH NG
COMINGS	K AH M IH NG Z
COMITIA	K AH M IH SH IY AH
COMITIAL	K AH M AH T IY AH L
COMITIES	K AH M AH T IY Z
COMITY	K OW M IH T IY
COMIX	K OW M IH K S
COMMA	K AA M AH
COMMAND	K AH M AE N D
COMMANDABLE	K AH M AE N D AH B AH L
COMMANDANT	K AA M AH N D AA N T
COMMANDANTS	K AA M AH N D AA N T S
COMMANDED	K AH M AE N D IH D
COMMANDEER	K AA M AH N D IH R
COMMANDEERED	K AA M AH N D IH R D
COMMANDEERING	K AA M AH N D IH ER IH NG
COMMANDEERS	K AA M AH N D IH ER Z
COMMANDER	K AH M AE N D ER
COMMANDERIES	K AH M AE N D AH R IY Z
COMMANDERS	K AH M AE N D ER Z
COMMANDERSHIP	K AH M AE N D ER SH IH P
COMMANDERSHIPS	K AH M AE N D ER SH IH P S
COMMANDERY	K AH M AE N D AH R IY
COMMANDING	K AH M AE N D IH NG
COMMANDINGLY	K AH M AE N D IH NG L IY
COMMANDMENT	K AH M AE N D M AH N T
COMMANDMENTS	K AH M AE N D M AH N T S
COMMANDO	K AH M AE N D OW
COMMANDOES	K AH M AE N D OW Z
COMMANDOS	K AH M AE N D OW Z
COMMANDS	K AH M AE N D Z
COMMAS	K AA M AH Z
COMMATA	K AA M AE T AH
COMMEMORATE	K AH M EH M ER EY T
COMMEMORATED	K AH M EH M ER EY T IH D
COMMEMORATES	K AH M EH M ER EY T S
COMMEMORATING	K AH M EH M ER EY T IH NG
COMMEMORATION	K AH M EH M ER EY SH AH N
COMMEMORATIONS	K AH M EH M ER EY SH AH N Z
COMMEMORATIVE	K AH M EH M R AH T IH V
COMMEMORATIVE(2)	K AH M EH M ER EY T IH V
COMMEMORATIVELY	K AH M EH M ER AH T IH V L IY
COMMEMORATIVES	K AH M EH M ER AH T IH V Z
COMMEMORATOR	K AH M EH M ER AH T ER
COMMEMORATORS	K AH M EH M ER AH T ER Z
COMMENCE	K AH M EH N S
COMMENCED	K AH M EH N S T
COMMENCEMENT	K AH M EH N S M AH N T
COMMENCEMENTS	K AH M EH N S M AH N T S
COMMENCER	K AH M EH N S ER
COMMENCERS	K AH M EH N S ER Z
COMMENCES	K AH M EH N S AH Z
COMMENCING	K AH M EH N S IH NG
COMMEND	K AH M EH N D
COMMENDABLE	K AH M EH N D AH B AH L
COMMENDABLY	K AH M EH N D AH B L IY
COMMENDATION	K AA M AH N D EY SH AH N
COMMENDATIONS	K AA M AH N D EY SH AH N Z
COMMENDATORY	K AH M EH N D AH T OW R IY
COMMENDED	K AH M EH N D IH D
COMMENDER	K AH M EH N D ER
COMMENDERS	K AH M EH N D ER Z
COMMENDING	K AH M EH N D IH NG
COMMENDS	K AH M EH N D Z
COMMENSAL	K AH M EH N Z AH L
COMMENSALISM	K AH M EH N Z AH L IH Z AH M
COMMENSALISMS	K AH M EH N Z AH L IH Z AH M Z
COMMENSALLY	K AH M EH N S AE L IY
COMMENSALS	K AH M EH N Z AH L Z
COMMENSURABILITIES	K AH M EH N Z Y ER AH B IH L AH T EH Z
COMMENSURABILITY	K AH M EH N Z Y ER AH B IH L AH T EH
COMMENSURABLE	K AH M EH N Z Y ER AH B AH L
COMMENSURABLY	K AH M EH N Z Y ER AH B L IY
COMMENSURATE	K AH M EH N S ER AH T
COMMENSURATE(2)	K AH M EH N S ER IH T
COMMENSURATELY	K AH M EH N S ER AH T L IY
COMMENSURATELY(2)	K AH M EH N SH ER AH T L IY
COMMENSURATION	K AH M EH N S AH R AH SH AH N
COMMENSURATIONS	K AH M EH N S AH R AH SH AH N Z
COMMENT	K AA M EH N T
COMMENTARIES	K AA M AH N T EH R IY Z
COMMENTARY	K AA M AH N T EH R IY
COMMENTATE	K AH M EH N T AH T
COMMENTATED	K AH M EH N T EY T IH D
COMMENTATES	K AH M EH N T AH T S
COMMENTATING	K AH M EH N T EY T IH NG
COMMENTATOR	K AA M AH N T EY T ER
COMMENTATORS	K AA M AH N T EY T ER Z
COMMENTED	K AA M EH N T AH D
COMMENTING	K AA M EH N T IH NG
COMMENTS	K AA M EH N T S
COMMERCE	K AA M ER S
COMMERCED	K AA M ER S T
COMMERCES	K AA M ER S IH Z
COMMERCIAL	K AH M ER SH AH L
COMMERCIALISE	K AA M AH R S IY AH L AY Z
COMMERCIALISED	K AH M ER SH AH L IY Z D
COMMERCIALISES	K AH M ER SH AH L IY Z IH Z
COMMERCIALISING	K AH M ER SH AH L IY Z IH NG
COMMERCIALISM	K AH M ER SH AH L IH Z AH M
COMMERCIALISMS	K AH M ER SH AH L IH Z AH M Z
COMMERCIALIST	K AH M ER SH AH L IH S T
COMMERCIALISTIC	K AH M ER SH AH L IH S T IH K
COMMERCIALISTS	K AH M ER SH AH L IH S T S
COMMERCIALITIES	K AH M ER SH AH L AH T IY Z
COMMERCIALITY	K AH M ER SH AH L AH T IY
COMMERCIALIZATION	K AH M ER SH AH L IH Z EY SH AH N
COMMERCIALIZATIONS	K AH M ER SH AH L AH Z EY SH AH N Z
COMMERCIALIZE	K AH M ER SH AH L AY Z
COMMERCIALIZED	K AH M ER SH AH L AY Z D
COMMERCIALIZES	K AH M ER SH AH L AY Z IH Z
COMMERCIALIZING	K AH M ER SH AH L AY Z IH NG
COMMERCIALLY	K AH M ER SH AH L IY
COMMERCIALS	K AH M ER SH AH L Z
COMMERCING	K AA M ER S IH NG
COMMIE	K AA M IY
COMMIES	K AA M IY Z
COMMINATION	K AH M AY N EY SH AH N
COMMINATIONS	K AH M AY N EY SH AH N Z
COMMINATORY	K AH M AY N AH T OW R IY
COMMINGLE	K AH M IH NG G AH L
COMMINGLE(2)	K OW M IH NG G AH L
COMMINGLED	K AA M IH NG G AH L D
COMMINGLED(2)	K OW M IH NG G AH L D
COMMINGLES	K AH M IH NG G AH L Z
COMMINGLING	K AA M IH NG G AH L IH NG
COMMINGLING(2)	K OW M IH NG G L IH NG
COMMINUTE	K AH M IH N AH T
COMMINUTED	K AH M IH N AH T IH D
COMMINUTES	K AH M IH N AH T S
COMMINUTING	K AH M IH N AH T IH NG
COMMINUTION	K AH M IH N AH SH AH N
COMMINUTIONS	K AH M IH N AH SH AH N Z
COMMISERATE	K AH M IH S ER EY T
COMMISERATED	K AH M IH Z ER EY T IH D
COMMISERATES	K AH M IH Z ER AH T S
COMMISERATING	K AH M IH Z ER EY T IH NG
COMMISERATINGLY	K AH M IH Z ER AH T IH NG L IY
COMMISERATION	K AH M IH Z ER EY SH AH N
COMMISERATIONS	K AH M IH Z ER EY SH AH N Z
COMMISERATIVE	K AH M IH Z ER AH T IH V
COMMISSAR	K AA M AH S AA R
COMMISSARIAL	K AA M AH S EH R IY AH L
COMMISSARIAT	K AA M AH S AE R IY AH T
COMMISSARIATS	K AA M AH S AE R AY EY T S
COMMISSARIES	K AA M AH S EH R IY Z
COMMISSARS	K AA M IH S AA Z
COMMISSARY	K AA M AH S EH R IY
COMMISSION	K AH M IH SH AH N
COMMISSIONAIRE	K AH M IH SH AH N AH AY ER
COMMISSIONAIRES	K AH M IH SH AH N AH AY ER Z
COMMISSIONED	K AH M IH SH AH N D
COMMISSIONER	K AH M IH SH AH N ER
COMMISSIONERS	K AH M IH SH AH N ER Z
COMMISSIONERSHIP	K AH M IH SH AH N ER SH IH P
COMMISSIONERSHIPS	K AH M IH SH AH N ER SH IH P S
COMMISSIONING	K AH M IH SH AH N IH NG
COMMISSIONS	K AH M IH SH AH N Z
COMMISSURAL	K AH M IH SH ER AH L
COMMISSURE	K AH M IH SH ER
COMMISSURES	K AH M IH SH ER Z
COMMIT	K AH M IH T
COMMITMENT	K AH M IH T M AH N T
COMMITMENTS	K AH M IH T M AH N T S
COMMITS	K AH M IH T S
COMMITTABLE	K AH M IH T AH B AH L
COMMITTAL	K AH M IH T AH L
COMMITTALS	K AH M IH T AH L Z
COMMITTED	K AH M IH T IH D
COMMITTEE	K AH M IH T IY
COMMITTEEMAN	K AH M IH T IY M AH N
COMMITTEEMEN	K AH M IH T IY M EH N
COMMITTEES	K AH M IH T IY Z
COMMITTEEWOMAN	K AH M IH T IY W UH M AH N
COMMITTEEWOMEN	K AH M IH T IY W IH M AH N
COMMITTING	K AH M IH T IH NG
COMMIX	K AH M IH K S
COMMIXED	K AH M IH K S T
COMMIXES	K AH M IH K S IH Z
COMMIXING	K AH M IH K S IH NG
COMMIXT	K AA M IH K S T
COMMIXTURE	K AH M IH K S CH ER
COMMIXTURES	K AH M IH K S CH ER Z
COMMODE	K AH M OW D
COMMODES	K AH M OW D Z
COMMODIFICATION	K AH M AA D AH F AH K EY SH AH N
COMMODIFICATIONS	K AH M AA D AH F AH K EY SH AH N Z
COMMODIFIED	K AH M AA D AH F AY D
COMMODIFIES	K AH M AA D AH F AY Z
COMMODIFY	K AH M AA D AH F AY
COMMODIFYING	K AH M AA D AH F AY IH NG
COMMODIOUS	K AH M OW D IY AH S
COMMODIOUSLY	K AH M OW D IY AH S L IY
COMMODIOUSNESS	K AH M OW D IY AH S N AH S
COMMODIOUSNESSES	K AH M OW D IY AH S N AH S IH Z
COMMODITIES	K AH M AA D AH T IY Z
COMMODITY	K AH M AA D AH T IY
COMMODORE	K AA M AH D AO R
COMMODORES	K AA M AH D OW R Z
COMMON	K AA M AH N
COMMONAGE	K AA M AH N IH JH
COMMONAGES	K AA M AH N IH JH IH Z
COMMONALITIES	K AA M AH N AE L AH T IY Z
COMMONALITY	K AA M AH N AE L AH T IY
COMMONALTIES	K AA M AH N AH L T AY Z
COMMONALTY	K AA M AH N AE L T IY
COMMONER	K AA M AH N ER
COMMONERS	K AA M AH N ER Z
COMMONEST	K AA M AH N AH S T
COMMONLY	K AA M AH N L IY
COMMONNESS	K AA M AH N AH S
COMMONNESSES	K AA M AH N AH S IH Z
COMMONPLACE	K AA M AH N P L EY S
COMMONPLACENESS	K AA M AH N P L EY S N AH S
COMMONPLACENESSES	K AA M AH N P L EY S N AH S IH Z
COMMONPLACES	K AA M AH N P L EY S IH Z
COMMONS	K AA M AH N Z
COMMONSENSE	K AA M AH N S EH N S
COMMONSENSIBLE	K AA M AH N S EH N S AH B AH L
COMMONSENSICAL	K AA M AH N S EH N S IH K AH L
COMMONSENSICALLY	K AA M AH N S EH N S IH K AH L IY
COMMONWEAL	K AA M AH N W IY L
COMMONWEALS	K AA M AH N W IY L Z
COMMONWEALTH	K AA M AH N W EH L TH
COMMONWEALTHS	K AA M AH N W EH L TH S
COMMOTION	K AH M OW SH AH N
COMMOTIONS	K AH M OW SH AH N Z
COMMOVE	K AH M UW V
COMMOVED	K AH M UW V D
COMMOVES	K AH M UW V Z
COMMOVING	K AH M UW V IH NG
COMMUNAL	K AH M Y UW N AH L
COMMUNALISM	K AH M Y UW N AH L IH Z AH M
COMMUNALISMS	K AH M Y UW N AH L IH Z AH M Z
COMMUNALIST	K AH M Y UW N AH L IH S T
COMMUNALISTS	K AH M Y UW N AH L IH S T S
COMMUNALITIES	K AH M Y UW N AH L AH T IY Z
COMMUNALITY	K AH M Y UW N AH L AH T IY
COMMUNALIZE	K AH M Y UW N AH L AY Z
COMMUNALIZED	K AH M Y UW N AH L AY Z D
COMMUNALIZES	K AH M Y UW N AH L AY Z IH Z
COMMUNALIZING	K AH M Y UW N AH L AY Z IH NG
COMMUNALLY	K AH M Y UW N AH L IY
COMMUNARD	K AA M Y UW N AH R D
COMMUNARDS	K AA M Y UW N AH R D Z
COMMUNE	K AA M Y UW N
COMMUNE(2)	K AH M Y UW N
COMMUNED	K AH M Y UW N D
COMMUNES	K AA M Y UW N Z
COMMUNES(2)	K AH M Y UW N Z
COMMUNICABILITIES	K AH M Y UW N AH K AH B IH L AH T EH Z
COMMUNICABILITY	K AH M Y UW N AH K AH B IH L AH T EH
COMMUNICABLE	K AH M Y UW N AH K AH B AH L
COMMUNICABLENESS	K AH M Y UW N AH K AH B AH L N AH S
COMMUNICABLENESSES	K AH M Y UW N AH K AH B AH L N AH S IH Z
COMMUNICABLY	K AH M Y UW N AH K AH B L IY
COMMUNICANT	K AH M Y UW N AH K AH N T
COMMUNICANTS	K AH M Y UW N AH K AH N T S
COMMUNICATE	K AH M Y UW N AH K EY T
COMMUNICATED	K AH M Y UW N AH K EY T IH D
COMMUNICATEE	K AH M Y UW N AH K AH T IY
COMMUNICATEES	K AH M Y UW N AH K AH T IY Z
COMMUNICATES	K AH M Y UW N IH K EY T S
COMMUNICATING	K AH M Y UW N AH K EY T IH NG
COMMUNICATION	K AH M Y UW N AH K EY SH AH N
COMMUNICATIONAL	K AH M Y UW N AH K EY SH AH N AH L
COMMUNICATIONS	K AH M Y UW N AH K EY SH AH N Z
COMMUNICATIVE	K AH M Y UW N AH K AH T IH V
COMMUNICATIVELY	K AH M Y UW N AH K AH T IH V L IY
COMMUNICATIVENESS	K AH M Y UW N AH K AH T IH V N AH S
COMMUNICATIVENESSES	K AH M Y UW N AH K AH T IH V N AH S IH Z
COMMUNICATOR	K AH M Y UW N AH K EY T ER
COMMUNICATORS	K AH M Y UW N AH K EY T ER Z
COMMUNICATORY	K AH M Y UW N AH K AH T OW R IY
COMMUNING	K AH M Y UW N IH NG
COMMUNION	K AH M Y UW N Y AH N
COMMUNIONS	K AH M Y UW N Y AH N Z
COMMUNIQUE	K AH M Y UW N AH K EY
COMMUNIQUES	K AH M Y UW N IH K EY Z
COMMUNISE	K AA M Y AH N AY Z
COMMUNISED	K AH M Y UW N IY Z D
COMMUNISES	K AH M Y UW N IY Z IH Z
COMMUNISING	K AH M Y UW N IY Z IH NG
COMMUNISM	K AA M Y AH N IH Z AH M
COMMUNISMS	K AH M Y UW N IH Z AH M Z
COMMUNIST	K AA M Y AH N AH S T
COMMUNISTIC	K AA M Y AH N IH S T IH K
COMMUNISTICALLY	K AA M Y AH N IH S T IH K AH L IY
COMMUNISTS	K AA M Y AH N AH S T S
COMMUNITARIAN	K AA M Y UW N AH T EH R IY AH N
COMMUNITARIANISM	K AA M Y UW N AH T AE R IY AH N IH Z AH M
COMMUNITARIANISMS	K AA M Y UW N AH T AH R IY AH N AH Z AH M Z
COMMUNITARIANS	K AA M Y UW N AH T AE R IY AH N Z
COMMUNITIES	K AH M Y UW N AH T IY Z
COMMUNITIES(2)	K AH M Y UW N IH T IY Z
COMMUNITY	K AH M Y UW N AH T IY
COMMUNITY(2)	K AH M Y UW N IH T IY
COMMUNIZATION	K AA M Y AH N AH Z EY SH AH N
COMMUNIZATIONS	K AH M Y UW N AH Z EY SH AH N Z
COMMUNIZE	K AA M Y AH N AY Z
COMMUNIZED	K AH M Y UW N AY Z D
COMMUNIZES	K AH M Y UW N AY Z IH Z
COMMUNIZING	K AH M Y UW N AY Z IH NG
COMMUTABLE	K AH M Y UW T AH B AH L
COMMUTATE	K AA M Y AH T EY T
COMMUTATED	K AH M Y UW T EY T IH D
COMMUTATES	K AH M Y UW T AH T S
COMMUTATING	K AH M Y UW T EY T IH NG
COMMUTATION	K AA M Y AH T EY SH AH N
COMMUTATIONS	K AA M Y AH T EY SH AH N Z
COMMUTATIVE	K AH M Y UW T AH T IH V
COMMUTATIVITIES	K AH M Y UW T AH T IH V AH T IY Z
COMMUTATIVITY	K AH M Y UW T AH T IH V AH T IY
COMMUTATOR	K AH M Y UW T AH T ER
COMMUTATORS	K AH M Y UW T AH T ER Z
COMMUTE	K AH M Y UW T
COMMUTED	K AH M Y UW T IH D
COMMUTER	K AH M Y UW T ER
COMMUTERS	K AH M Y UW T ER Z
COMMUTES	K AH M Y UW T S
COMMUTING	K AH M Y UW T IH NG
COMMY	K AA M IY
COMONOMER	K OW M AA N AH M ER
COMONOMERS	K OW M AA N AH M ER Z
COMOSE	K AH M OW Z
COMOUS	K AH M AH S
COMP	K AA M P
COMPACT	K AA M P AE K T
COMPACT(2)	K AH M P AE K T
COMPACTED	K AH M P AE K T IH D
COMPACTER	K AH M P AE K T ER
COMPACTERS	K AH M P AE K T ER Z
COMPACTEST	K AH M P AE K T AH S T
COMPACTIBLE	K AH M P AE K T AH B AH L
COMPACTING	K AH M P AE K T IH NG
COMPACTION	K AH M P AE K SH AH N
COMPACTIONS	K AH M P AE K SH AH N Z
COMPACTLY	K AH M P AE K T L IY
COMPACTNESS	K AH M P AE K T N AH S
COMPACTNESSES	K AH M P AE K T N AH S IH Z
COMPACTOR	K AH M P AE K T ER
COMPACTORS	K AH M P AE K T ER Z
COMPACTS	K AH M P AE K T S
COMPACTS(2)	K AA M P AE K T S
COMPADRE	K AA M P EY D AH R
COMPADRES	K AA M P EY D AH R Z
COMPANIED	K AH M P AH N IY D
COMPANIES	K AH M P AH N IY Z
COMPANION	K AH M P AE N Y AH N
COMPANIONABILITIES	K AH M P AE N Y AH N AH B IH L AH T EH Z
COMPANIONABILITY	K AH M P AE N Y AH N AH B IH L AH T EH
COMPANIONABLE	K AH M P AE N Y AH N AH B AH L
COMPANIONABLENESS	K AH M P AE N Y AH N AH B AH L N AH S
COMPANIONABLENESSES	K AH M P AE N Y AH N AH B AH L N AH S IH Z
COMPANIONABLY	K AH M P AE N Y AH N AH B L IY
COMPANIONATE	K AH M P AE N Y AH N AH T
COMPANIONED	K AH M P AE N Y AH N D
COMPANIONING	K AH M P AE N Y AH N IH NG
COMPANIONS	K AH M P AE N Y AH N Z
COMPANIONSHIP	K AH M P AE N Y AH N SH IH P
COMPANIONSHIPS	K AH M P AE N Y AH N SH IH P S
COMPANIONWAY	K AH M P AE N Y AH N W EY
COMPANIONWAYS	K AH M P AE N Y AH N W EY Z
COMPANY	K AH M P AH N IY
COMPANYING	K AH M P AH N IY IH NG
COMPARABILITIES	K AH M P EH R AH B IH L AH T EH Z
COMPARABILITY	K AA M P ER AH B IH L IH T IY
COMPARABLE	K AA M P R AH B AH L
COMPARABLE(2)	K AH M P AE R AH B AH L
COMPARABLENESS	K AA M P AH R AH B AH L N AH S
COMPARABLENESSES	K AA M P AH R AH B AH L N AH S IH Z
COMPARABLY	K AA M P R AH B L IY
COMPARABLY(2)	K AA M P AE R AH B L IY
COMPARATIST	K AH M P EH R AH T IH S T
COMPARATISTS	K AH M P EH R AH T IH S T S
COMPARATIVE	K AH M P AE R AH T IH V
COMPARATIVELY	K AH M P AE R AH T IH V L IY
COMPARATIVENESS	K AH M P AE R AH T IH V N AH S
COMPARATIVENESSES	K AH M P AE R AH T IH V N AH S IH Z
COMPARATIVES	K AH M P AE R AH T IH V Z
COMPARATIVIST	K AH M P AE R AH T IH V IH S T
COMPARATIVISTS	K AH M P AE R AH T IH V IH S T S
COMPARATOR	K AH M P AE R AH T ER
COMPARATORS	K AH M P EH R AH T ER Z
COMPARE	K AH M P EH R
COMPARED	K AH M P EH R D
COMPARER	K AH M P EH R ER
COMPARERS	K AH M P EH R ER Z
COMPARES	K AH M P EH R Z
COMPARING	K AH M P EH R IH NG
COMPARISON	K AH M P EH R AH S AH N
COMPARISONS	K AH M P EH R AH S AH N Z
COMPART	K AH M P AA R T
COMPARTED	K AH M P AA R T IH D
COMPARTING	K AH M P AA R T IH NG
COMPARTMENT	K AH M P AA R T M AH N T
COMPARTMENTAL	K AH M P AA R T M EH N T AH L
COMPARTMENTALISE	K AA M P AH R T M EH N T AH L AY Z
COMPARTMENTALISED	K AH M P AA R T M AH N T AH L IY Z D
COMPARTMENTALISES	K AH M P AA R T M AH N T AH L IY Z IH Z
COMPARTMENTALISING	K AH M P AA R T M AH N T AH L IY Z IH NG
COMPARTMENTALIZATION	K AH M P AA R T M AH N T AH L AH Z EY SH AH N
COMPARTMENTALIZATIONS	K AH M P AA R T M AH N T AH L AH Z EY SH AH N Z
COMPARTMENTALIZE	K AH M P AA R T M EH N T AH L AY Z
COMPARTMENTALIZED	K AA M P AA R T M EH N T AH L AY Z D
COMPARTMENTALIZES	K AH M P AA R T M AH N T AH L AY Z IH Z
COMPARTMENTALIZING	K AH M P AA R T M AH N T AH L AY Z IH NG
COMPARTMENTATION	K AH M P AA R T M AH N T EY SH AH N
COMPARTMENTATIONS	K AH M P AA R T M AH N T EY SH AH N Z
COMPARTMENTED	K AH M P AA R T M AH N T IH D
COMPARTMENTING	K AH M P AA R T M AH N T IH NG
COMPARTMENTS	K AH M P AA R T M AH N T S
COMPARTS	K AH M P AA R T S
COMPASS	K AH M P AH S
COMPASSABLE	K AH M P AE S AH B AH L
COMPASSED	K AH M P AH S T
COMPASSES	K AH M P AH S IH Z
COMPASSING	K AH M P AH S IH NG
COMPASSION	K AH M P AE SH AH N
COMPASSIONATE	K AH M P AE SH AH N AH T
COMPASSIONATED	K AH M P AE SH AH N EY T IH D
COMPASSIONATELY	K AH M P AE SH AH N AH T L IY
COMPASSIONATENESS	K AH M P AE SH AH N AH T N AH S
COMPASSIONATENESSES	K AH M P AE SH AH N AH T N AH S IH Z
COMPASSIONATES	K AH M P AE SH AH N AH T S
COMPASSIONATING	K AH M P AE SH AH N EY T IH NG
COMPASSIONLESS	K AH M P AE SH AH N L AH S
COMPASSIONS	K AH M P AE SH AH N Z
COMPATIBILITIES	K AH M P AE T AH B IH L AH T IY Z
COMPATIBILITY	K AH M P AE T AH B IH L AH T IY
COMPATIBLE	K AH M P AE T AH B AH L
COMPATIBLENESS	K AH M P AE T AH B AH L N AH S
COMPATIBLENESSES	K AH M P AE T AH B AH L N AH S IH Z
COMPATIBLES	K AH M P AE T IH B AH L Z
COMPATIBLY	K AH M P AE T AH B L IY
COMPATRIOT	K AH M P EY T R IY AH T
COMPATRIOTIC	K AH M P EY T R IY AA T IH K
COMPATRIOTS	K AH M P EY T R IY AH T S
COMPED	K AH M P EH D
COMPEER	K AH M P IH ER
COMPEERED	K AH M P IH ER D
COMPEERING	K AH M P IH ER IH NG
COMPEERS	K AH M P IH ER Z
COMPEL	K AH M P EH L
COMPELLABLE	K AH M P EH L AH B AH L
COMPELLATION	K AH M P EH L EY SH AH N
COMPELLATIONS	K AH M P EH L EY SH AH N Z
COMPELLED	K AH M P EH L D
COMPELLING	K AH M P EH L IH NG
COMPELLINGLY	K AH M P EH L IH NG L IY
COMPELS	K AH M P EH L Z
COMPEND	K AH M P EH N D
COMPENDIA	K AA M P EH N D IY AH
COMPENDIOUS	K AH M P EH N D AY AH S
COMPENDIOUSLY	K AH M P EH N D AY AH S L IY
COMPENDIOUSNESS	K AH M P EH N D AY AH S N AH S
COMPENDIOUSNESSES	K AH M P EH N D AY AH S N AH S IH Z
COMPENDIUM	K AH M P EH N D IY AH M
COMPENDIUMS	K AH M P EH N D IY AH M Z
COMPENDS	K AH M P EH N D Z
COMPENSABILITIES	K AH M P EH N S AH B IH L AH T EH Z
COMPENSABILITY	K AH M P EH N S AH B IH L AH T EH
COMPENSABLE	K AH M P EH N S AH B AH L
COMPENSATE	K AA M P AH N S EY T
COMPENSATED	K AA M P AH N S EY T AH D
COMPENSATES	K AA M P AH N S EY T S
COMPENSATING	K AA M P AH N S EY T IH NG
COMPENSATION	K AA M P AH N S EY SH AH N
COMPENSATIONAL	K AH M P EH N S EY SH AH N AH L
COMPENSATIONS	K AA M P AH N S EY SH AH N Z
COMPENSATIVE	K AA M P AH N S EY T IH V
COMPENSATOR	K AA M P AH N S EY T ER
COMPENSATORS	K AA M P AH N S EY T ER Z
COMPENSATORY	K AH M P EH N S AH T AO R IY
COMPERE	K AA M P AH R
COMPERED	K AA M P IY R D
COMPERES	K AA M P IY R Z
COMPERING	K AA M P IY R AH NG
COMPETE	K AH M P IY T
COMPETED	K AH M P IY T IH D
COMPETENCE	K AA M P AH T IH N S
COMPETENCES	K AA M P AH T AH N S IH Z
COMPETENCIES	K AA M P AH T IH N S IY Z
COMPETENCY	K AA M P AH T IH N S IY
COMPETENT	K AA M P AH T IH N T
COMPETENTLY	K AA M P AH T IH N T L IY
COMPETES	K AH M P IY T S
COMPETING	K AH M P IY T IH NG
COMPETITION	K AA M P AH T IH SH AH N
COMPETITIONS	K AA M P AH T IH SH AH N Z
COMPETITIVE	K AH M P EH T AH T IH V
COMPETITIVE(2)	K AH M P EH T IH T IH V
COMPETITIVELY	K AH M P EH T IH T IH V L IY
COMPETITIVENESS	K AH M P EH T IH T IH V N IH S
COMPETITIVENESSES	K AH M P EH T AH T IH V N AH S IH Z
COMPETITOR	K AH M P EH T AH T ER
COMPETITOR(2)	K AH M P EH T IH T ER
COMPETITORS	K AH M P EH T AH T ER Z
COMPETITORS(2)	K AH M P EH T IH T ER Z
COMPILATION	K AA M P AH L EY SH AH N
COMPILATIONS	K AA M P AH L EY SH AH N Z
COMPILE	K AH M P AY L
COMPILED	K AH M P AY L D
COMPILER	K AH M P AY L ER
COMPILERS	K AH M P AY L ER Z
COMPILES	K AH M P AY L Z
COMPILING	K AH M P AY L IH NG
COMPING	K AH M P IH NG
COMPLACENCE	K AH M P L EY S AH N S
COMPLACENCES	K AH M P L EY S AH N S IH Z
COMPLACENCIES	K AH M P L EY S AH N S IY Z
COMPLACENCY	K AH M P L EY S AH N S IY
COMPLACENT	K AH M P L EY S AH N T
COMPLACENTLY	K AH M P L EY S AH N T L IY
COMPLAIN	K AH M P L EY N
COMPLAINANT	K AH M P L EY N AH N T
COMPLAINANTS	K AH M P L EY N AH N T S
COMPLAINED	K AH M P L EY N D
COMPLAINER	K AH M P L EY N ER
COMPLAINERS	K AA M P L EY N ER Z
COMPLAINING	K AH M P L EY N IH NG
COMPLAININGLY	K AH M P L EY N IH NG L IY
COMPLAINS	K AH M P L EY N Z
COMPLAINT	K AH M P L EY N T
COMPLAINTS	K AH M P L EY N T S
COMPLAISANCE	K AH M P L EY S AH N S
COMPLAISANCES	K AH M P L EY S AH N S IH Z
COMPLAISANT	K AH M P L EY S AH N T
COMPLAISANTLY	K AH M P L EY S AH N T L IY
COMPLEAT	K AH M P L IY T
COMPLECT	K AA M P L EH K T
COMPLECTED	K AA M P L EH K T AH D
COMPLECTING	K AA M P L EH K T AH NG
COMPLECTS	K AA M P L EH K T S
COMPLEMENT	K AA M P L AH M AH N T
COMPLEMENTAL	K AA M P L AH M AH N T AH L
COMPLEMENTARIES	K AA M P L AH M EH N T AH R IY Z
COMPLEMENTARILY	K AA M P L AH M EH N T AH R IY L IY
COMPLEMENTARINESS	K AA M P L AH M EH N T AH R IY N AH S
COMPLEMENTARINESSES	K AA M P L AH M EH N T AH R IY N AH S IH Z
COMPLEMENTARITIES	K AA M P L AH M AH N T ER AH T IY Z
COMPLEMENTARITY	K AA M P L AH M AH N T ER AH T IY
COMPLEMENTARY	K AA M P L AH M EH N T R IY
COMPLEMENTARY(2)	K AA M P L AH M EH N CH IY
COMPLEMENTATION	K AA M P L AH M AH N T EY SH AH N
COMPLEMENTATIONS	K AA M P L AH M AH N T EY SH AH N Z
COMPLEMENTED	K AA M P L AH M EH N T IH D
COMPLEMENTING	K AA M P L AH M EH N T IH NG
COMPLEMENTIZER	K AA M P L AH M AH N T AY Z ER
COMPLEMENTIZERS	K AA M P L AH M AH N T AY Z ER Z
COMPLEMENTS	K AA M P L AH M AH N T S
COMPLETE	K AH M P L IY T
COMPLETED	K AH M P L IY T AH D
COMPLETED(2)	K AH M P L IY T IH D
COMPLETELY	K AH M P L IY T L IY
COMPLETENESS	K AH M P L IY T N AH S
COMPLETENESSES	K AH M P L IY T N AH S IH Z
COMPLETER	K AH M P L IY T ER
COMPLETES	K AH M P L IY T S
COMPLETEST	K AH M P L IY T AH S T
COMPLETING	K AH M P L IY T IH NG
COMPLETION	K AH M P L IY SH AH N
COMPLETIONS	K AH M P L IY SH AH N Z
COMPLETIST	K AH M P L IY T IH S T
COMPLETISTS	K AH M P L IY T IH S T S
COMPLETIVE	K AH M P L IY T IH V
COMPLEX	K AA M P L EH K S
COMPLEX(2)	K AH M P L EH K S
COMPLEXATION	K AH M P L EH K S EY SH AH N
COMPLEXATIONS	K AH M P L EH K S EY SH AH N Z
COMPLEXED	K AH M P L EH K S T
COMPLEXER	K AH M P L EH K S ER
COMPLEXES	K AA M P L EH K S AH Z
COMPLEXEST	K AH M P L EH K S AH S T
COMPLEXIFIED	K AH M P L EH K S AH F AY D
COMPLEXIFIES	K AH M P L EH K S AH F AY Z
COMPLEXIFY	K AH M P L EH K S AH F AY
COMPLEXIFYING	K AH M P L EH K S AH F AY IH NG
COMPLEXING	K AH M P L EH K S IH NG
COMPLEXION	K AH M P L EH K SH AH N
COMPLEXIONAL	K AH M P L EH K SH AH N AH L
COMPLEXIONED	K AH M P L EH K SH AH N D
COMPLEXIONS	K AH M P L EH K SH AH N Z
COMPLEXITIES	K AH M P L EH K S IH T IY Z
COMPLEXITY	K AH M P L EH K S AH T IY
COMPLEXITY(2)	K AH M P L EH K S IH T IY
COMPLEXLY	K AH M P L EH K S L IY
COMPLEXNESS	K AH M P L EH K S N AH S
COMPLEXNESSES	K AH M P L EH K S N AH S IH Z
COMPLIANCE	K AH M P L AY AH N S
COMPLIANCES	K AH M P L AY AH N S IH Z
COMPLIANCIES	K AH M P L AY AH N S IY Z
COMPLIANCY	K AH M P L AY AH N S IY
COMPLIANT	K AH M P L AY AH N T
COMPLIANTLY	K AH M P L AY AH N T L IY
COMPLICACIES	K AA M P L AH K AH S IY Z
COMPLICACY	K AA M P L AH K AH S IY
COMPLICATE	K AA M P L AH K EY T
COMPLICATED	K AA M P L AH K EY T AH D
COMPLICATEDLY	K AA M P L AH K AH T AH D L IY
COMPLICATEDNESS	K AA M P L AH K AH T AH D N AH S
COMPLICATEDNESSES	K AA M P L AH K AH T AH D N AH S IH Z
COMPLICATES	K AA M P L IH K EY T S
COMPLICATING	K AA M P L AH K EY T IH NG
COMPLICATION	K AA M P L AH K EY SH AH N
COMPLICATIONS	K AA M P L AH K EY SH AH N Z
COMPLICE	K AA M P L AH S
COMPLICES	K AA M P L AH S
COMPLICIT	K AH M P L IH S AH T
COMPLICITIES	K AH M P L IH S IH T IY Z
COMPLICITOUS	K AA M P L IH S AH T AH S
COMPLICITY	K AH M P L IH S AH T IY
COMPLICITY(2)	K AH M P L IH S IH T IY
COMPLIED	K AH M P L AY D
COMPLIER	K AH M P L AY ER
COMPLIERS	K AH M P L AY ER Z
COMPLIES	K AH M P L AY Z
COMPLIMENT	K AA M P L AH M EH N T
COMPLIMENTARILY	K AA M P L AH M EH N T AH R IY L IY
COMPLIMENTARY	K AA M P L AH M EH N T ER IY
COMPLIMENTED	K AA M P L AH M EH N T IH D
COMPLIMENTING	K AA M P L AH M EH N T IH NG
COMPLIMENTS	K AA M P L AH M EH N T S
COMPLIN	K AA M P L IH N
COMPLINE	K AA M P L AY N
COMPLINES	K AA M P L AY N Z
COMPLINS	K AA M P L IH N Z
COMPLOT	K AH M P L AA T
COMPLOTS	K AH M P L AA T S
COMPLOTTED	K AH M P L AA T IH D
COMPLOTTING	K AH M P L AA T IH NG
COMPLY	K AH M P L AY
COMPLYING	K AH M P L AY IH NG
COMPO	K AA M P OW
COMPONE	K AA M P OW N
COMPONENT	K AH M P OW N AH N T
COMPONENTIAL	K AH M P OW N AH N T IY AH L
COMPONENTS	K AH M P OW N AH N T S
COMPONY	K AH M P OW N IY
COMPORT	K AH M P AO R T
COMPORTED	K AH M P AO R T AH D
COMPORTING	K AH M P OW R T IH NG
COMPORTMENT	K AH M P AO R T M AH N T
COMPORTMENTS	K AH M P OW R T M AH N T S
COMPORTS	K AH M P OW R T S
COMPOS	K AA M P AA Z
COMPOSE	K AH M P OW Z
COMPOSED	K AH M P OW Z D
COMPOSEDLY	K AH M P OW Z AH D L IY
COMPOSEDNESS	K AH M P OW Z AH D N AH S
COMPOSEDNESSES	K AH M P OW Z AH D N AH S IH Z
COMPOSER	K AH M P OW Z ER
COMPOSERS	K AH M P OW Z ER Z
COMPOSES	K AH M P OW Z IH Z
COMPOSING	K AH M P OW Z IH NG
COMPOSITE	K AH M P AA Z AH T
COMPOSITE(2)	K AA M P AA Z AH T
COMPOSITED	K AH M P AA Z AH T IH D
COMPOSITELY	K AH M P AA Z AH T L IY
COMPOSITES	K AH M P AA Z AH T S
COMPOSITES(2)	K AA M P AA Z AH T S
COMPOSITING	K AH M P AA Z AH T IH NG
COMPOSITION	K AA M P AH Z IH SH AH N
COMPOSITIONAL	K AA M P AH Z IH SH AH N AH L
COMPOSITIONALLY	K AA M P AH Z IH SH AH N AH L IY
COMPOSITIONS	K AA M P AH Z IH SH AH N Z
COMPOSITOR	K AH M P AA Z AH T ER
COMPOSITORS	K AH M P AA Z AH T ER Z
COMPOST	K AA M P OW S T
COMPOSTED	K AA M P OW S T IH D
COMPOSTING	K AA M P OW S T IH NG
COMPOSTS	K AA M P OW S T S
COMPOSURE	K AH M P OW ZH ER
COMPOSURES	K AH M P OW ZH ER Z
COMPOTE	K AA M P OW T
COMPOTES	K AA M P OW T S
COMPOUND	K AA M P AW N D
COMPOUND(2)	K AH M P AW N D
COMPOUNDABLE	K AH M P AW N D AH B AH L
COMPOUNDED	K AH M P AW N D AH D
COMPOUNDED(2)	K AH M P AW N D IH D
COMPOUNDER	K AH M P AW N D ER
COMPOUNDERS	K AH M P AW N D ER Z
COMPOUNDING	K AH M P AW N D IH NG
COMPOUNDS	K AA M P AW N D Z
COMPOUNDS(2)	K AH M P AW N D Z
COMPRADOR	K AA M P R EY D AH R
COMPRADORE	K AA M P R AE D AH R
COMPRADORES	K AA M P R AE D AH R Z
COMPRADORS	K AA M P R AE D AH R Z
COMPREHEND	K AA M P R IY HH EH N D
COMPREHENDED	K AA M P R IH HH EH N D IH D
COMPREHENDIBLE	K AA M P R IH HH EH N D AH B AH L
COMPREHENDING	K AA M P R IH HH EH N D IH NG
COMPREHENDS	K AA M P R IY HH EH N D Z
COMPREHENSIBILITIES	K AA M P R IH HH EH N S AH B IH L AH T IY Z
COMPREHENSIBILITY	K AA M P R IY HH EH N S AH B IH L AH T IY
COMPREHENSIBLE	K AA M P R IY HH EH N S AH B AH L
COMPREHENSIBLENESS	K AA M P R IH HH EH N S AH B AH L N AH S
COMPREHENSIBLENESSES	K AA M P R IH HH EH N S AH B AH L N AH S IH Z
COMPREHENSIBLY	K AA M P R IH HH EH N S AH B L IY
COMPREHENSION	K AA M P R IY HH EH N SH AH N
COMPREHENSIONS	K AA M P R IH HH EH N CH AH N Z
COMPREHENSIVE	K AA M P R IY HH EH N S IH V
COMPREHENSIVELY	K AA M P R IH HH EH N S IH V L IY
COMPREHENSIVENESS	K AA M P R IH HH EH N S IH V N AH S
COMPREHENSIVENESSES	K AA M P R IH HH EH N S IH V N AH S IH Z
COMPRESS	K AA M P R EH S
COMPRESS(2)	K AH M P R EH S
COMPRESSED	K AH M P R EH S T
COMPRESSEDLY	K AH M P R EH S AH D L IY
COMPRESSES	K AA M P R EH S AH Z
COMPRESSES(2)	K AH M P R EH S AH Z
COMPRESSES(3)	K AH M P R EH S IH Z
COMPRESSIBILITIES	K AH M P R EH S AH B IH L AH T IY Z
COMPRESSIBILITY	K AH M P R EH S AH B IH L AH T IY
COMPRESSIBLE	K AH M P R EH S AH B AH L
COMPRESSING	K AH M P R EH S IH NG
COMPRESSION	K AH M P R EH SH AH N
COMPRESSIONAL	K AH M P R EH SH AH N AH L
COMPRESSIONS	K AH M P R EH SH AH N Z
COMPRESSIVE	K AH M P R EH S IH V
COMPRESSIVELY	K AH M P R EH S IH V L IY
COMPRESSOR	K AH M P R EH S ER
COMPRESSORS	K AH M P R EH S ER Z
COMPRISE	K AH M P R AY Z
COMPRISED	K AH M P R AY Z D
COMPRISES	K AH M P R AY Z AH Z
COMPRISES(2)	K AH M P R AY Z IH Z
COMPRISING	K AH M P R AY Z IH NG
COMPRIZE	K AH M P R AY Z
COMPRIZED	K AH M P R AY Z D
COMPRIZES	K AH M P R AY Z IH Z
COMPRIZING	K AH M P R AY Z IH NG
COMPROMISE	K AA M P R AH M AY Z
COMPROMISED	K AA M P R AH M AY Z D
COMPROMISER	K AA M P R AH M AY Z ER
COMPROMISERS	K AA M P R AH M AY Z ER Z
COMPROMISES	K AA M P R AH M AY Z IH Z
COMPROMISING	K AA M P R AH M AY Z IH NG
COMPS	K AA M P S
COMPT	K AA M P T
COMPTED	K AA M P T AH D
COMPTING	K AA M P T AH NG
COMPTROLLER	K AH M T R OW L ER
COMPTROLLER(2)	K AA M T R OW L ER
COMPTROLLERS	K AA M P T R OW L ER Z
COMPTROLLERSHIP	K AA M P T R OW L ER SH IH P
COMPTROLLERSHIPS	K AA M P T R OW L ER SH IH P S
COMPTS	K AA M P T S
COMPULSION	K AH M P AH L SH AH N
COMPULSIONS	K AH M P UH L SH AH N Z
COMPULSIVE	K AH M P AH L S IH V
COMPULSIVELY	K AH M P AH L S IH V L IY
COMPULSIVENESS	K AH M P AH L S IH V N AH S
COMPULSIVENESSES	K AH M P AH L S IH V N AH S IH Z
COMPULSIVES	K AH M P AH L S IH V Z
COMPULSIVITIES	K AH M P AH L S IH V AH T IY Z
COMPULSIVITY	K AH M P AH L S IH V AH T IY
COMPULSORILY	K AH M P AH L S ER IY L IY
COMPULSORY	K AH M P AH L S ER IY
COMPUNCTION	K AH M P AH NG K SH AH N
COMPUNCTIONS	K AA M P AH NG K T IY AH N Z
COMPUNCTIOUS	K AA M P AH NG K AH S
COMPURGATION	K AH M P ER G EY SH AH N
COMPURGATIONS	K AH M P ER G EY SH AH N Z
COMPURGATOR	K AH M P ER JH AH T ER
COMPURGATORS	K AH M P ER JH AH T ER Z
COMPUTABILITIES	K AH M P Y UW T AH B IH L AH T EH Z
COMPUTABILITY	K AH M P Y UW T AH B IH L AH T EH
COMPUTABLE	K AH M P Y UW T AH B AH L
COMPUTATION	K AA M P Y AH T EY SH AH N
COMPUTATIONAL	K AA M P Y UW T EY SH AH N AH L
COMPUTATIONALLY	K AA M P Y UH T EY SH AH N AH L IY
COMPUTATIONS	K AA M P Y UW T EY SH AH N Z
COMPUTE	K AH M P Y UW T
COMPUTED	K AH M P Y UW T AH D
COMPUTED(2)	K AH M P Y UW T IH D
COMPUTER	K AH M P Y UW T ER
COMPUTERDOM	K AH M P Y UW T ER D AH M
COMPUTERDOMS	K AH M P Y UW T ER D AH M Z
COMPUTERESE	K AA M P Y UW T AH R IY Z
COMPUTERESES	K AA M P Y UW T AH R IY Z AH Z
COMPUTERISE	K AH M P Y UW T R AY Z
COMPUTERISED	K AH M P Y UW T AH R IY Z D
COMPUTERISES	K AH M P Y UW T AH R IY Z IH Z
COMPUTERISING	K AH M P Y UW T AH R IY Z IH NG
COMPUTERIST	K AH M P Y UW T ER IH S T
COMPUTERISTS	K AH M P Y UW T ER IH S T S
COMPUTERIZABLE	K AH M P Y UW T ER AY Z AH B AH L
COMPUTERIZATION	K AH M P Y UW T ER IH Z EY SH AH N
COMPUTERIZATIONS	K AH M P Y UW T ER AH Z EY SH AH N Z
COMPUTERIZE	K AH M P Y UW T ER AY Z
COMPUTERIZED	K AH M P Y UW T ER AY Z D
COMPUTERIZES	K AH M P Y UW T ER AY Z IH Z
COMPUTERIZING	K AH M P Y UW T ER AY Z IH NG
COMPUTERLESS	K AH M P Y UW T ER L AH S
COMPUTERLIKE	K AH M P Y UW T ER L AY K
COMPUTERNIK	K AA M P Y AH T AH R N AH K
COMPUTERNIKS	K AA M P Y AH T AH R N AH K S
COMPUTERPHOBE	K AA M P Y UW T AH R F OW B
COMPUTERPHOBES	K AA M P Y UW T AH R F OW B Z
COMPUTERPHOBIA	K AA M P Y UW T AH R F OW B IY AH
COMPUTERPHOBIAS	K AA M P Y UW T AH R F OW B IY AH Z
COMPUTERPHOBIC	K AA M P Y AH T AH R F AH B AH K
COMPUTERS	K AH M P Y UW T ER Z
COMPUTES	K AH M P Y UW T S
COMPUTING	K AH M P Y UW T IH NG
COMRADE	K AA M R AE D
COMRADELINESS	K AA M R AE D L IY N AH S
COMRADELINESSES	K AA M R AE D L IY N AH S IH Z
COMRADELY	K AA M R AE D L IY
COMRADERIES	K AA M R AE D AH R IY Z
COMRADERY	K AA M R AE D AH R IY
COMRADES	K AA M R AE D Z
COMRADESHIP	K AA M R AE D SH IH P
COMRADESHIPS	K AA M R AE D SH IH P S
COMSYMP	K AA M S IH M P
COMSYMPS	K AA M S IH M P S
COMTE	K AA M T IY
COMTES	K AA M T S
CON	K AA N
CONATION	K OW N EY SH AH N
CONATIONS	K OW N EY SH AH N Z
CONATIVE	K OW N EY T IH V
CONATUS	K OW N EY T AH S
CONCANAVALIN	K AA N K AH N AE V AH L AH N
CONCANAVALINS	K AA N K AH N AE V AH L AH N Z
CONCATENATE	K AH N K AE T AH N EY T
CONCATENATED	K AH N K AE T AH N EY T AH D
CONCATENATES	K AH N K AE T AH N EY T S
CONCATENATING	K AH N K AE T AH N EY T IH NG
CONCATENATION	K AH N K AE T AH N EY SH AH N
CONCATENATIONS	K AH N K EY T AH N EY SH AH N Z
CONCAVE	K AA N K EY V
CONCAVED	K AA N K EY V D
CONCAVES	K AA N K EY V Z
CONCAVING	K AA N K EY V IH NG
CONCAVITIES	K AH N K AE V AH T IY Z
CONCAVITY	K AH N K AE V AH T IY
CONCEAL	K AH N S IY L
CONCEALABLE	K AH N S IY L AH B AH L
CONCEALED	K AH N S IY L D
CONCEALER	K AH N S IY L ER
CONCEALERS	K AH N S IY L ER Z
CONCEALING	K AH N S IY L IH NG
CONCEALINGLY	K AH N S IY L IH NG L IY
CONCEALMENT	K AH N S IY L M AH N T
CONCEALMENTS	K AH N S IY L M AH N T S
CONCEALS	K AH N S IY L Z
CONCEDE	K AH N S IY D
CONCEDED	K AH N S IY D IH D
CONCEDEDLY	K AH N S IY D AH D L IY
CONCEDER	K AH N S IY D ER
CONCEDERS	K AH N S IY D ER Z
CONCEDES	K AH N S IY D Z
CONCEDING	K AH N S IY D IH NG
CONCEIT	K AH N S IY T
CONCEITED	K AH N S IY T AH D
CONCEITEDLY	K AH N S IY T AH D L IY
CONCEITEDNESS	K AH N S IY T AH D N AH S
CONCEITEDNESSES	K AH N S IY T AH D N AH S IH Z
CONCEITING	K AH N S IY T IH NG
CONCEITS	K AH N S IY T S
CONCEIVABILITIES	K AH N S IY V AH B IH L AH T EH Z
CONCEIVABILITY	K AH N S IY V AH B IH L AH T EH
CONCEIVABLE	K AH N S IY V AH B AH L
CONCEIVABLENESS	K AH N S IY V AH B AH L N AH S
CONCEIVABLENESSES	K AH N S IY V AH B AH L N AH S IH Z
CONCEIVABLY	K AH N S IY V AH B L IY
CONCEIVE	K AH N S IY V
CONCEIVED	K AH N S IY V D
CONCEIVER	K AH N S IY V ER
CONCEIVERS	K AH N S IY V ER Z
CONCEIVES	K AH N S IY V Z
CONCEIVING	K AH N S IY V IH NG
CONCELEBRANT	K AH N S EH L AH B R AH N T
CONCELEBRANTS	K AH N S EH L AH B R AH N T S
CONCELEBRATE	K AH N S EH L AH B R AH T
CONCELEBRATED	K AH N S EH L AH B R EY T IH D
CONCELEBRATES	K AH N S EH L AH B R AH T S
CONCELEBRATING	K AH N S EH L AH B R EY T IH NG
CONCELEBRATION	K AH N S EH L AH B R EY SH AH N
CONCELEBRATIONS	K AH N S EH L AH B R EY SH AH N Z
CONCENT	K AH N S EH N T
CONCENTER	K AH N S EH N T ER
CONCENTERED	K AH N S EH N T ER D
CONCENTERING	K AH N S EH N T ER IH NG
CONCENTERS	K AH N S EH N T ER Z
CONCENTRATE	K AA N S AH N T R EY T
CONCENTRATED	K AA N S AH N T R EY T AH D
CONCENTRATED(2)	K AO N S AH N T R EY T IH D
CONCENTRATEDLY	K AA N S AH N T R EY T AH D L IY
CONCENTRATES	K AA N S AH N T R EY T S
CONCENTRATING	K AA N S AH N T R EY T IH NG
CONCENTRATION	K AA N S AH N T R EY SH AH N
CONCENTRATIONS	K AA N S AH N T R EY SH AH N Z
CONCENTRATIVE	K AA N S AH N T R EY T IH V
CONCENTRATOR	K AA N S AH N T R EY T ER
CONCENTRATORS	K AA N S AH N T R EY T ER Z
CONCENTRIC	K AH N S EH N T R IH K
CONCENTRICALLY	K AH N S EH N T R IH K AH L IY
CONCENTRICITIES	K AH N S EH N T R IH K AH T IY Z
CONCENTRICITY	K AH N S EH N T R IH K AH T IY
CONCENTS	K AH N S EH N T S
CONCEPT	K AA N S EH P T
CONCEPTACLE	K AA N S EH P T AH K AH L
CONCEPTACLES	K AA N S EH P T AH K AH L Z
CONCEPTION	K AH N S EH P SH AH N
CONCEPTIONAL	K AA N S EH P SH AH N AH L
CONCEPTIONS	K AH N S EH P SH AH N Z
CONCEPTIVE	K AA N S EH P T IH V
CONCEPTS	K AA N S EH P T S
CONCEPTS(2)	K AA N S EH P S
CONCEPTUAL	K AH N S EH P CH UW AH L
CONCEPTUALISE	K AA N S EH P T Y UW AH L AY Z
CONCEPTUALISED	K AH N S EH P CH AH W AH L IY Z D
CONCEPTUALISES	K AH N S EH P CH AH W AH L IY Z IH Z
CONCEPTUALISING	K AH N S EH P CH AH W AH L IY Z IH NG
CONCEPTUALISM	K AH N S EH P CH AH W AH L IH Z AH M
CONCEPTUALISMS	K AH N S EH P CH AH W AH L IH Z AH M Z
CONCEPTUALIST	K AH N S EH P CH AH W AH L IH S T
CONCEPTUALISTIC	K AH N S EH P CH AH W AH L IH S T IH K
CONCEPTUALISTICALLY	K AH N S EH P CH AH W AH L IH S T IH K AH L IY
CONCEPTUALISTS	K AH N S EH P CH AH W AH L IH S T S
CONCEPTUALITIES	K AH N S EH P CH AH W AH L AH T IY Z
CONCEPTUALITY	K AH N S EH P CH AH W AH L AH T IY
CONCEPTUALIZATION	K AH N S EH P CH W AH L IH Z EY SH AH N
CONCEPTUALIZATIONS	K AH N S EH P CH AH W AH L AH Z EY SH AH N Z
CONCEPTUALIZE	K AH N S EH P CH AH W AH L AY Z
CONCEPTUALIZED	K AH N S EH P CH AH W AH L AY Z D
CONCEPTUALIZER	K AH N S EH P CH AH W AH L AY Z ER
CONCEPTUALIZERS	K AH N S EH P CH AH W AH L AY Z ER Z
CONCEPTUALIZES	K AH N S EH P CH AH W AH L AY Z IH Z
CONCEPTUALIZING	K AH N S EH P CH AH W AH L AY Z IH NG
CONCEPTUALLY	K AH N S EH P CH UW AH L IY
CONCEPTUS	K AA N S EH P T AH S
CONCEPTUSES	K AA N S EH P T Y UW S IH Z
CONCERN	K AH N S ER N
CONCERNED	K AH N S ER N D
CONCERNING	K AH N S ER N IH NG
CONCERNMENT	K AH N S ER N M AH N T
CONCERNMENTS	K AH N S ER N M AH N T S
CONCERNS	K AH N S ER N Z
CONCERT	K AA N S ER T
CONCERT(2)	K AH N S ER T
CONCERTED	K AH N S ER T AH D
CONCERTED(2)	K AH N S ER T IH D
CONCERTEDLY	K AH N S ER T AH D L IY
CONCERTEDNESS	K AH N S ER T AH D N AH S
CONCERTEDNESSES	K AH N S ER T AH D N AH S IH Z
CONCERTGOER	K AH N S ER T G OW ER
CONCERTGOERS	K AH N S ER T G OW ER Z
CONCERTGOING	K AH N S ER T G OW IH NG
CONCERTGOINGS	K AH N S ER T G OW IH NG Z
CONCERTI	K AH N CH EH R T IY
CONCERTINA	K AA N S ER T IY N AH
CONCERTINAS	K AA N S ER T IY N AH Z
CONCERTING	K AH N S ER T IH NG
CONCERTINI	K AA N S AH R T AH N IY
CONCERTINO	K AA N S AH R T AH N OW
CONCERTINOS	K AH N S ER T IH N AA S
CONCERTIZE	K AH N S ER T AY Z
CONCERTIZED	K AH N S ER T AY Z D
CONCERTIZES	K AH N S ER T AY Z IH Z
CONCERTIZING	K AH N S ER T AY Z IH NG
CONCERTMASTER	K AA N S ER T M AE S T ER
CONCERTMASTERS	K AH N S ER T M AE S T ER Z
CONCERTMEISTER	K AA N S AH R T M IY S T AH R
CONCERTMEISTERS	K AA N S AH R T M IY S T AH R Z
CONCERTO	K AH N CH EH R T OW
CONCERTOS	K AH N CH EH R T OW Z
CONCERTS	K AA N S ER T S
CONCERTS(2)	K AH N S ER T S
CONCESSION	K AH N S EH SH AH N
CONCESSIONAIRE	K AH N S EH SH AH N EH R
CONCESSIONAIRES	K AH N S EH SH AH N EH R Z
CONCESSIONAL	K AH N S EH SH AH N AH L
CONCESSIONARY	K AH N S EH SH AH N EH R IY
CONCESSIONER	K AH N S EH SH AH N ER
CONCESSIONERS	K AH N S EH SH AH N ER Z
CONCESSIONS	K AH N S EH SH AH N Z
CONCESSIVE	K AH N S EH S IH V
CONCESSIVELY	K AH N S EH S IH V L IY
CONCH	K AA N CH
CONCH(2)	K AA NG K
CONCHA	K AA N CH AH
CONCHAE	K AA N CH IY
CONCHAL	K AA N CH AH L
CONCHES	K AA N CH AH Z
CONCHIE	K AA N CH AY
CONCHIES	K AA N CH AY Z
CONCHOID	K AA N CH OY D
CONCHOIDAL	K AA N CH OY D AH L
CONCHOIDALLY	K AA N CH OY D AE L IY
CONCHOIDS	K AA N CH OY D Z
CONCHOLOGIES	K AA N CH AA L AH JH AY Z
CONCHOLOGIST	K AA N CH AA L AH JH AH S T
CONCHOLOGISTS	K AA N CH AA L AH JH AH S T S
CONCHOLOGY	K AA N CH AA L AH JH IY
CONCHS	K AA N CH S
CONCHY	K AA N CH IY
CONCIERGE	K AA N S IY EH R ZH
CONCIERGES	K OW N S Y EH R ZH IH Z
CONCILIAR	K AH N S IH L IY ER
CONCILIARLY	K AH N S IH L IY ER L IY
CONCILIATE	K AH N S IH L IY EY T
CONCILIATED	K AH N S IH L IY EY T IH D
CONCILIATES	K AH N S IH L IY EY T S
CONCILIATING	K AH N S IH L IY EY T IH NG
CONCILIATION	K AH N S IH L IY EY SH AH N
CONCILIATIONS	K AH N S IH L IY EY SH AH N Z
CONCILIATIVE	K AH N S IH L IY EY T IH V
CONCILIATOR	K AH N S IH L IY EY T ER
CONCILIATORS	K AH N S IH L IY EY T ER Z
CONCILIATORY	K AH N S IH L IY AH T AO R IY
CONCILIATORY(2)	K AH N S IH L Y AH T AO R IY
CONCINNITIES	K AA N S IH N AH T AY Z
CONCINNITY	K AA N S IH N AH T IY
CONCISE	K AH N S AY S
CONCISELY	K AH N S AY S L IY
CONCISENESS	K AH N S AY S N AH S
CONCISENESSES	K AH N S AY S N AH S IH Z
CONCISER	K AH N S AY S ER
CONCISEST	K AH N S AY S AH S T
CONCISION	K AH N S AY ZH AH N
CONCISIONS	K AH N S AY ZH AH N Z
CONCLAVE	K AA N K L EY V
CONCLAVES	K AA N K L EY V Z
CONCLUDE	K AH N K L UW D
CONCLUDED	K AH N K L UW D AH D
CONCLUDED(2)	K AH N K L UW D IH D
CONCLUDER	K AH N K L UW D ER
CONCLUDERS	K AH N K L UW D ER Z
CONCLUDES	K AH N K L UW D Z
CONCLUDING	K AH N K L UW D IH NG
CONCLUSION	K AH N K L UW ZH AH N
CONCLUSIONARY	K AH N K L UW ZH AH N EH R IY
CONCLUSIONS	K AH N K L UW ZH AH N Z
CONCLUSIVE	K AH N K L UW S IH V
CONCLUSIVELY	K AH N K L UW S IH V L IY
CONCLUSIVENESS	K AH N K L UW S IH V N AH S
CONCLUSIVENESSES	K AH N K L UW S IH V N AH S IH Z
CONCLUSORY	K AO NG K L AH S AO R IY
CONCOCT	K AH N K AA K T
CONCOCTED	K AH N K AA K T AH D
CONCOCTER	K AH N K AA K T ER
CONCOCTERS	K AH N K AA K T ER Z
CONCOCTING	K AH N K AA K T IH NG
CONCOCTION	K AH N K AA K SH AH N
CONCOCTIONS	K AH N K AA K SH AH N Z
CONCOCTIVE	K AH N K AA K T IH V
CONCOCTS	K AH N K AA K T S
CONCOMITANCE	K AH N K OW M AY T AH N S
CONCOMITANCES	K AH N K OW M AY T AH N S IH Z
CONCOMITANT	K AA N K AA M AH T AH N T
CONCOMITANT(2)	K AA N K AH M IH T AH N T
CONCOMITANTLY	K AA N K AA M AH T AH N T L IY
CONCOMITANTLY(2)	K AA N K AH M IH T AH N T L IY
CONCOMITANTS	K AH N K OW M AY T AH N T S
CONCORD	K AA N K AO R D
CONCORD(2)	K AA N K ER D
CONCORDANCE	K AH N K AO R D AH N S
CONCORDANCES	K AH N K AO R D AH N S IH Z
CONCORDANT	K AH N K AO R D AH N T
CONCORDANTLY	K AH N K AO R D AH N T L IY
CONCORDAT	K AA N K AH R D AE T
CONCORDATS	K AA N K AO R D EY T S
CONCORDS	K AA N K AO R D Z
CONCOURSE	K AA N K AO R S
CONCOURSES	K AA N K AO R S IH Z
CONCRESCENCE	K AH N K R EH S AH N S
CONCRESCENCES	K AH N K R EH S AH N S IH Z
CONCRESCENT	K AH N K R EH S AH N T
CONCRETE	K AH N K R IY T
CONCRETE(2)	K AA N K R IY T
CONCRETED	K AA N K R IY T IH D
CONCRETELY	K AA N K R IY T L IY
CONCRETENESS	K AA N K R IY T N AH S
CONCRETENESSES	K AA N K R IY T N AH S IH Z
CONCRETES	K AA N K R IY T S
CONCRETING	K AA N K R IY T IH NG
CONCRETION	K AA N K R IY SH AH N
CONCRETIONARY	K AA N K R IY SH AH N EH R IY
CONCRETIONS	K AA N K R IY SH AH N Z
CONCRETISM	K AA N K R IY T IH Z AH M
CONCRETISMS	K AA N K R IY T IH Z AH M Z
CONCRETIST	K AA N K R IY T IH S T
CONCRETISTS	K AA N K R IY T IH S T S
CONCRETIZATION	K AA N K R IY T AH Z EY SH AH N
CONCRETIZATIONS	K AA N K R IY T AH Z EY SH AH N Z
CONCRETIZE	K AA N K R IY T AY Z
CONCRETIZED	K AA N K R IY T AY Z D
CONCRETIZES	K AA N K R IY T AY Z IH Z
CONCRETIZING	K AA N K R IY T AY Z IH NG
CONCUBINAGE	K AA N K Y UW B AH N AH JH
CONCUBINAGES	K AH N K AH B IH N IH JH IH Z
CONCUBINE	K AA N K Y AH B AY N
CONCUBINES	K AA N K Y AH B AY N Z
CONCUPISCENCE	K AA N K Y AH P IH S AH N S
CONCUPISCENCES	K AA N K Y AH P IH S EH N S AH Z
CONCUPISCENT	K AH N K AH P IY Z S EH N T
CONCUPISCIBLE	K AA N K Y AH P IH S AH B AH L
CONCUR	K AH N K ER
CONCURRED	K AH N K ER D
CONCURRENCE	K AH N K ER AH N S
CONCURRENCES	K AH N K ER AH N S IH Z
CONCURRENCIES	K AH N K ER AH N S IY Z
CONCURRENCY	K AH N K ER AH N S IY
CONCURRENT	K AH N K ER AH N T
CONCURRENTLY	K AH N K ER AH N T L IY
CONCURRENTS	K AH N K ER AH N T S
CONCURRING	K AH N K ER IH NG
CONCURS	K AH N K ER Z
CONCUSS	K AH N K AH S
CONCUSSED	K AH N K AH S T
CONCUSSES	K AH N K AH S IH Z
CONCUSSING	K AH N K AH S IH NG
CONCUSSION	K AH N K AH SH AH N
CONCUSSIONS	K AH N K AH SH AH N Z
CONCUSSIVE	K AH N K AH S IH V
CONDEMN	K AH N D EH M
CONDEMNABLE	K AH N D EH M AH B AH L
CONDEMNATION	K AA N D AH M N EY SH AH N
CONDEMNATIONS	K AA N D AH M N EY SH AH N Z
CONDEMNATORY	K AH N D EH M N AH T OW R IY
CONDEMNED	K AH N D EH M D
CONDEMNER	K AH N D EH M ER
CONDEMNERS	K AH N D EH M ER Z
CONDEMNING	K AH N D EH M IH NG
CONDEMNOR	K AH N D EH M ER
CONDEMNORS	K AH N D EH M ER Z
CONDEMNS	K AH N D EH M Z
CONDENSABLE	K AH N D EH N S AH B AH L
CONDENSATE	K AA N D AH N S EY T
CONDENSATES	K AA N D AH N S EY T S
CONDENSATION	K AA N D AH N S EY SH AH N
CONDENSATIONAL	K AA N D EH N S EY SH AH N AH L
CONDENSATIONS	K AA N D EH N S EY SH AH N Z
CONDENSE	K AH N D EH N S
CONDENSED	K AH N D EH N S T
CONDENSER	K AH N D EH N S ER
CONDENSERS	K AH N D EH N S ER Z
CONDENSES	K AH N D EH N S IH Z
CONDENSIBLE	K AH N D EH N S AH B AH L
CONDENSING	K AH N D EH N S IH NG
CONDESCEND	K AA N D IH S EH N D
CONDESCENDED	K AA N D IH S EH N D IH D
CONDESCENDENCE	K AA N D IH S EH N D AH N S
CONDESCENDENCES	K AA N D IH S EH N D AH N S IH Z
CONDESCENDING	K AA N D IH S EH N D IH NG
CONDESCENDINGLY	K AA N D IH S EH N D IH NG L IY
CONDESCENDS	K AA N D IH S EH N D Z
CONDESCENSION	K AA N D AH S EH N SH AH N
CONDESCENSIONS	K AA N D IH S EH N CH AH N Z
CONDIGN	K AA N D IH N
CONDIGNLY	K AA N D IH N L IY
CONDIMENT	K AA N D AH M AH N T
CONDIMENTAL	K AA N D AH M AH N T AH L
CONDIMENTS	K AA N D AH M AH N T S
CONDITION	K AH N D IH SH AH N
CONDITIONABLE	K AH N D IH SH AH N AH B AH L
CONDITIONAL	K AH N D IH SH AH N AH L
CONDITIONALITIES	K AH N D IH SH AH N AH L AH T IY Z
CONDITIONALITY	K AH N D IH SH AH N AE L IH T IY
CONDITIONALLY	K AH N D IH SH AH N AH L IY
CONDITIONALLY(2)	K AH N D IH SH N AH L IY
CONDITIONALS	K AH N D IH SH AH N AH L Z
CONDITIONED	K AH N D IH SH AH N D
CONDITIONER	K AH N D IH SH AH N ER
CONDITIONERS	K AH N D IH SH AH N ER Z
CONDITIONING	K AH N D IH SH AH N IH NG
CONDITIONS	K AH N D IH SH AH N Z
CONDO	K AA N D OW
CONDOES	K AH N D OW Z
CONDOLATORY	K AH N D OW L AH T OW R IY
CONDOLE	K AH N D OW L
CONDOLED	K AH N D OW L D
CONDOLENCE	K AH N D OW L AH N S
CONDOLENCES	K AH N D OW L AH N S AH Z
CONDOLER	K AH N D OW L ER
CONDOLERS	K AH N D OW L ER Z
CONDOLES	K AH N D OW L Z
CONDOLING	K AH N D UW L IH NG
CONDOM	K AA N D AH M
CONDOMINIUM	K AA N D AH M IH N IY AH M
CONDOMINIUMS	K AA N D AH M IH N IY AH M Z
CONDOMS	K AA N D AH M Z
CONDONABLE	K AH N D OW N AH B AH L
CONDONATION	K AH N D OW N EY SH AH N
CONDONATIONS	K AH N D OW N EY SH AH N Z
CONDONE	K AH N D OW N
CONDONED	K AH N D OW N D
CONDONER	K AH N D OW N ER
CONDONERS	K AH N D OW N ER Z
CONDONES	K AH N D OW N Z
CONDONING	K AH N D OW N IH NG
CONDOR	K AA N D ER
CONDORES	K AA N D AO R Z
CONDORS	K AA N D ER Z
CONDOS	K AA N D OW Z
CONDOTTIERE	K AA N D AA T IY R
CONDOTTIERI	K AA N D AA T AH R IY
CONDUCE	K AH N D UW S
CONDUCED	K AH N D UW S T
CONDUCER	K AH N D UW S ER
CONDUCERS	K AH N D UW S ER Z
CONDUCES	K AH N D UW S IH Z
CONDUCING	K AH N D UW S IH NG
CONDUCIVE	K AH N D UW S IH V
CONDUCIVENESS	K AH N D UW S IH V N AH S
CONDUCIVENESSES	K AH N D UW S IH V N AH S IH Z
CONDUCT	K AA N D AH K T
CONDUCTANCE	K AA N D AH K T AH N S
CONDUCTANCES	K AA N D AH K T AH N S IH Z
CONDUCTED	K AH N D AH K T AH D
CONDUCTIBILITIES	K AA N D AH K T AH B IH L AH T IY Z
CONDUCTIBILITY	K AA N D AH K T AH B IH L AH T IY
CONDUCTIBLE	K AA N D AH K T AH B AH L
CONDUCTIMETRIC	K AA N D AH K T AH M AH T R AH K
CONDUCTING	K AH N D AH K T IH NG
CONDUCTION	K AH N D AH K SH AH N
CONDUCTIONS	K AA N D AH K SH AH N Z
CONDUCTIVE	K AH N D AH K T IH V
CONDUCTIVITIES	K AA N D AH K T IH V AH T IY Z
CONDUCTIVITY	K AA N D AH K T IH V AH T IY
CONDUCTOMETRIC	K AA N D AH K T AH M AH T R AH K
CONDUCTOR	K AH N D AH K T ER
CONDUCTORIAL	K AA N D AH K T ER IY AH L
CONDUCTORS	K AH N D AH K T ER Z
CONDUCTRESS	K AA N D AH K T R AH S
CONDUCTRESSES	K AA N D AH K T R EH S AH Z
CONDUCTS	K AH N D AH K T S
CONDUIT	K AA N D UW IH T
CONDUIT(2)	K AA N JH UW IH T
CONDUIT(3)	K AA N D W IH T
CONDUITS	K AA N D UW AH T S
CONDUITS(2)	K AA N D W AH T S
CONDUPLICATE	K AH N D UW P L IH K AH T
CONDYLAR	K AA N D AY L AH R
CONDYLE	K AA N D AY L
CONDYLES	K AA N D AY L Z
CONDYLOID	K AA N D AH L OY D
CONDYLOMA	K AA N D IH L AH M AH
CONDYLOMAS	K AA N D IH L AH M AH Z
CONDYLOMATA	K AA N D AH L AA M AH T AH
CONDYLOMATOUS	K AA N D AH L AA M AH T AH S
CONE	K OW N
CONED	K OW N D
CONEFLOWER	K OW N F L AW ER
CONEFLOWERS	K OW N F L AW ER Z
CONELRAD	K AH N EH L R AH D
CONELRADS	K AH N EH L R AH D Z
CONENOSE	K OW N OW Z
CONENOSES	K AH N EH N AA S IH Z
CONEPATE	K OW N P EY T
CONEPATES	K OW N P EY T S
CONEPATL	K AH N EH P AH T L
CONEPATLS	K AH N EH P AH T L Z
CONES	K OW N Z
CONEY	K OW N IY
CONEYS	K OW N IY Z
CONFAB	K AA N F AE B
CONFABBED	K AA N F AE B D
CONFABBING	K AA N F AE B AH NG
CONFABS	K AA N F AE B Z
CONFABULATE	K AH N F AE B Y AH L AH T
CONFABULATED	K AH N F AE B Y AH L EY T IH D
CONFABULATES	K AH N F AE B Y AH L AH T S
CONFABULATING	K AH N F AE B Y AH L EY T IH NG
CONFABULATION	K AH N F AE B Y AH L EY SH AH N
CONFABULATIONS	K AH N F AE B Y AH L EY SH AH N Z
CONFABULATOR	K AH N F AE B Y AH L AH T ER
CONFABULATORS	K AH N F AE B Y AH L AH T ER Z
CONFABULATORY	K AH N F AE B Y AH L AH T OW R IY
CONFECT	K AH N F EH K T
CONFECTED	K AA N F EH K T AH D
CONFECTING	K AA N F EH K T AH NG
CONFECTION	K AH N F EH K SH AH N
CONFECTIONARIES	K AH N F EH K SH AH N EH R IY Z
CONFECTIONARY	K AH N F EH K SH AH N EH R IY
CONFECTIONER	K AH N F EH K SH AH N ER
CONFECTIONERIES	K AH N F EH K SH AH N AH R IY Z
CONFECTIONERS	K AH N F EH K SH AH N ER Z
CONFECTIONERY	K AH N F EH K SH AH N EH R IY
CONFECTIONS	K AH N F EH K SH AH N Z
CONFECTS	K AA N F EH K T S
CONFEDERACIES	K AH N F EH D ER AH S IY Z
CONFEDERACY	K AH N F EH D ER AH S IY
CONFEDERACY(2)	K AH N F EH D R AH S IY
CONFEDERAL	K AH N F EH D ER AH L
CONFEDERATE	K AH N F EH D ER AH T
CONFEDERATE(2)	K AH N F EH D ER EY T
CONFEDERATED	K AH N F EH D ER EY T IH D
CONFEDERATES	K AH N F EH D ER AH T S
CONFEDERATING	K AH N F EH D ER EY T IH NG
CONFEDERATION	K AH N F EH D ER EY SH AH N
CONFEDERATIONS	K AH N F EH D ER EY SH AH N Z
CONFEDERATIVE	K AH N F EH D ER AH T IH V
CONFER	K AH N F ER
CONFEREE	K AA N F ER IY
CONFEREES	K AA N F ER IY Z
CONFERENCE	K AA N F ER AH N S
CONFERENCE(2)	K AA N F R AH N S
CONFERENCES	K AA N F ER AH N S AH Z
CONFERENCES(2)	K AA N F R AH N S AH Z
CONFERENCING	K AA N F R AH N S IH NG
CONFERENCINGS	K AA N F AH R AH N S IH NG Z
CONFERENTIAL	K AH N F ER AH N T IY AH L
CONFERMENT	K AH N F ER M EH N T
CONFERMENTS	K AH N F ER M EH N T S
CONFERRABLE	K AH N F ER AH B AH L
CONFERRAL	K AH N F ER AH L
CONFERRALS	K AH N F ER AH L Z
CONFERRED	K AH N F ER D
CONFERRENCE	K AH N F ER AH N S
CONFERRENCES	K AH N F ER AH N S IH Z
CONFERRER	K AH N F ER ER
CONFERRERS	K AH N F ER ER Z
CONFERRING	K AH N F ER IH NG
CONFERS	K AH N F ER Z
CONFERVA	K AA N F AH R V AH
CONFERVAE	K AA N F AH R V IY
CONFERVAS	K AA N F AH R V AH Z
CONFESS	K AH N F EH S
CONFESSABLE	K AH N F EH S AH B AH L
CONFESSED	K AH N F EH S T
CONFESSEDLY	K AH N F EH S AH D L IY
CONFESSES	K AH N F EH S IH Z
CONFESSING	K AH N F EH S IH NG
CONFESSION	K AH N F EH SH AH N
CONFESSIONAL	K AH N F EH SH AH N AH L
CONFESSIONALISM	K AH N F EH SH AH N AH L IH Z AH M
CONFESSIONALISMS	K AH N F EH SH AH N AH L IH Z AH M Z
CONFESSIONALIST	K AH N F EH SH AH N AH L IH S T
CONFESSIONALISTS	K AH N F EH SH AH N AH L IH S T S
CONFESSIONALLY	K AH N F EH SH AH N AH L IY
CONFESSIONALS	K AH N F EH SH AH N AH L Z
CONFESSIONS	K AH N F EH SH AH N Z
CONFESSOR	K AH N F EH S ER
CONFESSORS	K AH N F EH S ER Z
CONFETTI	K AH N F EH T IY
CONFETTO	K AA N F EH T OW
CONFIDANT	K AA N F AH D AA N T
CONFIDANTE	K AA N F AH D AE N T
CONFIDANTES	K AA N F AH D AE N T S
CONFIDANTS	K AA N F AH D AE N T S
CONFIDE	K AH N F AY D
CONFIDED	K AH N F AY D IH D
CONFIDENCE	K AA N F AH D EH N S
CONFIDENCES	K AA N F AH D EH N S IH Z
CONFIDENT	K AA N F AH D AH N T
CONFIDENTIAL	K AA N F AH D EH N SH AH L
CONFIDENTIALITIES	K AA N F AH D EH N CH IY AE L AH T IY Z
CONFIDENTIALITY	K AA N F AH D EH N SH IY AE L AH T IY
CONFIDENTIALLY	K AA N F AH D EH N SH AH L IY
CONFIDENTLY	K AA N F AH D AH N T L IY
CONFIDER	K AH N F AY D ER
CONFIDERS	K AH N F AY D ER Z
CONFIDES	K AH N F AY D Z
CONFIDING	K AH N F AY D IH NG
CONFIDINGLY	K AH N F AY D IH NG L IY
CONFIDINGNESS	K AH N F AY D IH NG N AH S
CONFIDINGNESSES	K AH N F AY D IH NG N AH S IH Z
CONFIGURATION	K AH N F IH G Y ER EY SH AH N
CONFIGURATIONAL	K AH N F IH G Y ER EY SH AH N AH L
CONFIGURATIONALLY	K AH N F IH G Y ER EY SH AH N AH L IY
CONFIGURATIONS	K AH N F IH G Y ER EY SH AH N Z
CONFIGURATIVE	K AH N F IH G Y AH R AH T IH V
CONFIGURE	K AH N F IH G Y ER
CONFIGURED	K AH N F IH G Y ER D
CONFIGURES	K AH N F IH G Y ER Z
CONFIGURING	K AH N F IH G Y ER IH NG
CONFINE	K AH N F AY N
CONFINED	K AH N F AY N D
CONFINEMENT	K AH N F AY N M AH N T
CONFINEMENTS	K AH N F AY N M AH N T S
CONFINER	K AH N F AY N ER
CONFINERS	K AH N F AY N ER Z
CONFINES	K AA N F AY N Z
CONFINES(2)	K AH N F AY N Z
CONFINING	K AH N F AY N IH NG
CONFIRM	K AH N F ER M
CONFIRMABILITIES	K AH N F ER M AH B IH L AH T EH Z
CONFIRMABILITY	K AH N F ER M AH B IH L AH T EH
CONFIRMABLE	K AH N F ER M AH B AH L
CONFIRMAND	K AA N F AH R M AH N D
CONFIRMANDS	K AA N F AH R M AH N D Z
CONFIRMATION	K AA N F ER M EY SH AH N
CONFIRMATIONAL	K AA N F ER M EY SH AH N AH L
CONFIRMATIONS	K AA N F ER M EY SH AH N Z
CONFIRMATORY	K AH N F ER M AH T AO R IY
CONFIRMED	K AH N F ER M D
CONFIRMEDLY	K AH N F ER M AH D L IY
CONFIRMEDNESS	K AH N F ER M AH D N AH S
CONFIRMEDNESSES	K AH N F ER M AH D N AH S IH Z
CONFIRMING	K AH N F ER M IH NG
CONFIRMS	K AH N F ER M Z
CONFISCABLE	K AH N F IH S K AH B AH L
CONFISCATABLE	K AA N F AH S K EY T AH B AH L
CONFISCATE	K AA N F AH S K EY T
CONFISCATED	K AA N F AH S K EY T AH D
CONFISCATES	K AA N F AH S K EY T S
CONFISCATING	K AA N F AH S K EY T IH NG
CONFISCATION	K AA N F AH S K EY SH AH N
CONFISCATIONS	K AA N F AH S K EY SH AH N Z
CONFISCATOR	K AA N F AH S K EY T ER
CONFISCATORS	K AA N F AH S K EY T ER Z
CONFISCATORY	K AH N F IH S K AH T AO R IY
CONFIT	K AH N F IH T
CONFITEOR	K AA N F AY T IY AH R
CONFITEORS	K AA N F IH T IY AH R Z
CONFITS	K AH N F IH T S
CONFITURE	K AH N F IH CH ER
CONFITURES	K AH N F IH CH ER Z
CONFLAGRANT	K AH N F L EY G R AH N T
CONFLAGRATION	K AA N F L AH G R EY SH AH N
CONFLAGRATIONS	K AA N F L AH G R EY SH AH N Z
CONFLATE	K AH N F L EY T
CONFLATED	K AH N F L AE T IH D
CONFLATES	K AH N F L EY T S
CONFLATING	K AH N F L AE T IH NG
CONFLATION	K AH N F L EY SH AH N
CONFLATIONS	K AH N F L AE SH AH N Z
CONFLICT	K AA N F L IH K T
CONFLICT(2)	K AH N F L IH K T
CONFLICTED	K AH N F L IH K T IH D
CONFLICTFUL	K AA N F L IH K T F AH L
CONFLICTING	K AH N F L IH K T IH NG
CONFLICTINGLY	K AA N F L IH K T IH NG L IY
CONFLICTION	K AA N F L IH K SH AH N
CONFLICTIONS	K AA N F L IH K SH AH N Z
CONFLICTIVE	K AA N F L IH K T IH V
CONFLICTS	K AH N F L IH K T S
CONFLICTS(2)	K AA N F L IH K T S
CONFLICTS(3)	K AH N F L IH K S
CONFLICTS(4)	K AA N F L IH K S
CONFLICTUAL	K AA N F L IH K T Y AH W AH
CONFLUENCE	K AA N F L UW AH N S
CONFLUENCES	K AH N F L UW AH N S IH Z
CONFLUENT	K AA N F L UW AH N T
CONFLUENTS	K AH N F L UW AH N T S
CONFLUX	K AH N F L AH K S
CONFLUXES	K AH N F L AH K S IH Z
CONFOCAL	K AH N F OW K AH L
CONFOCALLY	K AH N F OW K AH L IY
CONFORM	K AH N F AO R M
CONFORMABLE	K AH N F AO R M AH B AH L
CONFORMABLY	K AH N F AO R M AH B L IY
CONFORMAL	K AH N F AO R M AH L
CONFORMANCE	K AH N F AO R M AH N S
CONFORMANCES	K AH N F AO R M AH N S IH Z
CONFORMATION	K AA N F AO R M EY SH AH N
CONFORMATIONAL	K AA N F ER M EY SH AH N AH L
CONFORMATIONS	K AA N F AO R M EY SH AH N Z
CONFORMED	K AH N F AO R M D
CONFORMER	K AH N F AO R M ER
CONFORMERS	K AH N F AO R M ER Z
CONFORMING	K AH N F AO R M IH NG
CONFORMISM	K AH N F AO R M IH Z AH M
CONFORMISMS	K AH N F AO R M IH Z AH M Z
CONFORMIST	K AH N F AO R M IH S T
CONFORMISTS	K AH N F AO R M AH S T S
CONFORMITIES	K AH N F AO R M AH T IY Z
CONFORMITY	K AH N F AO R M AH T IY
CONFORMS	K AH N F AO R M Z
CONFOUND	K AA N F AW N D
CONFOUND(2)	K AH N F AW N D
CONFOUNDED	K AH N F AW N D IH D
CONFOUNDEDLY	K AH N F AW N D AH D L IY
CONFOUNDER	K AH N F AW N D ER
CONFOUNDERS	K AH N F AW N D ER Z
CONFOUNDING	K AH N F AW N D IH NG
CONFOUNDINGLY	K AH N F AW N D IH NG L IY
CONFOUNDS	K AH N F AW N D Z
CONFRATERNITIES	K AH N F R AH T ER N AH T IY Z
CONFRATERNITY	K AH N F R AH T ER N AH T IY
CONFRERE	K AA N F R EH R
CONFRERES	K AA N F R EH R Z
CONFRONT	K AH N F R AH N T
CONFRONTAL	K AH N F R AH N T AH L
CONFRONTALS	K AH N F R AH N T AH L Z
CONFRONTATION	K AA N F R AH N T EY SH AH N
CONFRONTATIONAL	K AA N F R AH N T EY SH AH N AH L
CONFRONTATIONIST	K AA N F R AH N T EY SH AH N IH S T
CONFRONTATIONISTS	K AA N F R AH N T EY SH AH N IH S T S
CONFRONTATIONS	K AA N F R AH N T EY SH AH N Z
CONFRONTED	K AH N F R AH N T AH D
CONFRONTED(2)	K AH N F R AH N T IH D
CONFRONTER	K AH N F R AH N T ER
CONFRONTERS	K AH N F R AH N T ER Z
CONFRONTING	K AH N F R AH N T IH NG
CONFRONTS	K AH N F R AH N T S
CONFUSE	K AH N F Y UW Z
CONFUSED	K AH N F Y UW Z D
CONFUSEDLY	K AH N F Y UW Z AH D L IY
CONFUSEDNESS	K AH N F Y UW Z AH D N AH S
CONFUSEDNESSES	K AH N F Y UW Z AH D N AH S IH Z
CONFUSES	K AH N F Y UW Z IH Z
CONFUSING	K AH N F Y UW Z IH NG
CONFUSINGLY	K AH N F Y UW Z IH NG L IY
CONFUSION	K AH N F Y UW ZH AH N
CONFUSIONAL	K AH N F Y UW ZH AH N AH L
CONFUSIONS	K AH N F Y UW ZH AH N Z
CONFUTATION	K AH N F Y UW T EY SH AH N
CONFUTATIONS	K AH N F Y UW T EY SH AH N Z
CONFUTATIVE	K AH N F Y UW T AH T IH V
CONFUTE	K AH N F Y UW T
CONFUTED	K AH N F Y UW T IH D
CONFUTER	K AH N F Y UW T ER
CONFUTERS	K AH N F Y UW T ER Z
CONFUTES	K AH N F Y UW T S
CONFUTING	K AH N F Y UW T IH NG
CONGA	K AO NG G AH
CONGAED	K AA N G EY D
CONGAING	K AA N G EY AH NG
CONGAS	K AH N G AE S
CONGE	K AA N JH IY
CONGEAL	K AH N JH IY L
CONGEALED	K AH N JH IY L D
CONGEALING	K AH N JH IY L IH NG
CONGEALMENT	K AH N JH IY L M AH N T
CONGEALMENTS	K AH N JH IY L M AH N T S
CONGEALS	K AH N JH IY L Z
CONGEE	K AA N JH IY IY
CONGEED	K AA N JH IY D
CONGEEING	K AA N JH IY AH NG
CONGEES	K AA N JH IY Z
CONGELATION	K AH N JH EH L EY SH AH N
CONGELATIONS	K AH N JH EH L EY SH AH N Z
CONGENER	K AH N JH IY N ER
CONGENERIC	K AH N JH EH N ER IH K
CONGENEROUS	K AH N JH EH N ER AH S
CONGENERS	K AH N JH IY N ER Z
CONGENIAL	K AH N JH IY N Y AH L
CONGENIALITIES	K AH N JH IY N IY AE L AH T IY Z
CONGENIALITY	K AH N JH IY N IY AE L AH T IY
CONGENIALLY	K AH N JH IY N Y AH L IY
CONGENITAL	K AH N JH EH N AH T AH L
CONGENITALLY	K AH N JH EH N AH T AH L IY
CONGER	K AO NG ER
CONGERIES	K AA N JH AH R AY Z
CONGERS	K AA N JH EH R Z
CONGES	K AA N JH AH Z
CONGEST	K AH N JH EH S T
CONGESTED	K AH N JH EH S T AH D
CONGESTED(2)	K AH N JH EH S T IH D
CONGESTING	K AH N JH EH S T IH NG
CONGESTION	K AH N JH EH S CH AH N
CONGESTIONS	K AH N JH EH S SH AH N Z
CONGESTIVE	K AH N JH EH S T IH V
CONGESTS	K AH N JH EH S T S
CONGII	K AA N JH IY
CONGIUS	K AA N JH AY AH S
CONGLOBATE	K AH N G L OW B AH T
CONGLOBATED	K AH N G L OW B EY T IH D
CONGLOBATES	K AH N G L OW B AH T S
CONGLOBATING	K AH N G L OW B EY T IH NG
CONGLOBATION	K AH N G L OW B EY SH AH N
CONGLOBATIONS	K AH N G L OW B EY SH AH N Z
CONGLOBE	K AH N G L OW B
CONGLOBED	K AH N G L OW B D
CONGLOBES	K AH N G L OW B Z
CONGLOBING	K AH N G L OW B IH NG
CONGLOMERATE	K AH N G L AA M ER AH T
CONGLOMERATED	K AH N G L AA M ER EY T IH D
CONGLOMERATES	K AH N G L AA M ER AH T S
CONGLOMERATEUR	K AA N G L AA M AH R EY T AH R
CONGLOMERATEURS	K AA N G L AA M AH R AH T IY Y AH R Z
CONGLOMERATIC	K AH N G L AA M ER AH T IH K
CONGLOMERATING	K AH N G L AA M ER EY T IH NG
CONGLOMERATION	K AH N G L AA M ER EY SH AH N
CONGLOMERATIONS	K AH N G L AA M ER EY SH AH N Z
CONGLOMERATIVE	K AH N G L AA M ER AH T IH V
CONGLOMERATOR	K AH N G L AA M ER AH T ER
CONGLOMERATORS	K AH N G L AA M ER AH T ER Z
CONGLUTINATE	K AH N G L AH T IH N AH T
CONGLUTINATED	K AH N G L AH T IH N EY T IH D
CONGLUTINATES	K AH N G L AH T IH N AH T S
CONGLUTINATING	K AH N G L AH T IH N EY T IH NG
CONGLUTINATION	K AH N G L AH T IH N EY SH AH N
CONGLUTINATIONS	K AH N G L AH T IH N EY SH AH N Z
CONGO	K AA NG G OW
CONGOES	K AA NG G OW Z
CONGOS	K AA NG G OW Z
CONGOU	K AA N G UW
CONGOUS	K AA N G AH S
CONGRATS	K AH N G R AE T S
CONGRATULATE	K AH N G R AE CH AH L EY T
CONGRATULATED	K AH N G R AE CH AH L EY T IH D
CONGRATULATES	K AH N G R AE CH AH L AH T S
CONGRATULATING	K AH N G R AE CH AH L EY T IH NG
CONGRATULATION	K AH N G R AE CH AH L EY SH AH N
CONGRATULATIONS	K AH N G R AE CH AH L EY SH AH N Z
CONGRATULATOR	K AH N G R AE CH AH L AH T ER
CONGRATULATORS	K AH N G R AE CH AH L AH T ER Z
CONGRATULATORY	K AH N G R AE CH AH L AH T AO R IY
CONGREGANT	K AA NG G R AH G AH N T
CONGREGANTS	K AA NG G R AH G AH N T S
CONGREGATE	K AA NG G R AH G EY T
CONGREGATED	K AA NG G R IH G EY T IH D
CONGREGATES	K AA NG G R IH G EY T S
CONGREGATING	K AA NG G R IH G EY T IH NG
CONGREGATION	K AA NG G R AH G EY SH AH N
CONGREGATIONAL	K AA NG G R AH G EY SH AH N AH L
CONGREGATIONALISM	K AA NG G R IH G EY SH AH N AH L IH Z AH M
CONGREGATIONALISMS	K AA NG G R IH G EY SH AH N AH L IH Z AH M Z
CONGREGATIONALIST	K AA NG G R IH G EY SH AH N AH L IH S T
CONGREGATIONALISTS	K AA NG G R IH G EY SH AH N AH L IH S T S
CONGREGATIONS	K AA NG G R AH G EY SH AH N Z
CONGREGATOR	K AA NG G R IH G EY T ER
CONGREGATORS	K AA NG G R IH G EY T ER Z
CONGRESS	K AA NG G R AH S
CONGRESSED	K AA NG G R AH S T
CONGRESSES	K AA NG G R AH S IH Z
CONGRESSING	K AA NG G R AH S IH NG
CONGRESSIONAL	K AH N G R EH SH AH N AH L
CONGRESSIONALLY	K AH N G R EH SH AH N AH L IY
CONGRESSIONALLY(2)	K AH N G R EH SH N AH L IY
CONGRESSMAN	K AA NG G R AH S M AH N
CONGRESSMEN	K AA NG G R AH S M IH N
CONGRESSPEOPLE	K AA NG G R AH S P IY P AH L
CONGRESSPERSON	K AA NG G R AH S P ER S AH N
CONGRESSPERSONS	K AA NG G R AH S P ER S AH N Z
CONGRESSWOMAN	K AA NG G R AH S W UH M AH N
CONGRESSWOMEN	K AA NG G R AH S W IH M IH N
CONGRUENCE	K AO N G R UW AH N S
CONGRUENCES	K AH N G R UW AH N S IH Z
CONGRUENCIES	K AH N G R UW AH N S IY Z
CONGRUENCY	K AH N G R UW AH N S IY
CONGRUENT	K AH N G R UW AH N T
CONGRUENTLY	K AH N G R UW AH N T L IY
CONGRUITIES	K AH N G R UW AH T IY Z
CONGRUITY	K AH N G R UW AH T IY
CONGRUOUS	K AA NG G R AH W AH S
CONGRUOUSLY	K AA NG G R AH W AH S L IY
CONGRUOUSNESS	K AA NG G R AH W AH S N AH S
CONGRUOUSNESSES	K AA NG G R AH W AH S N AH S IH Z
CONI	K AH N IY
CONIC	K AA N IH K
CONIC(2)	K OW N IH K
CONICAL	K AA N IH K AH L
CONICAL(2)	K OW N IH K AH L
CONICALLY	K AA N IH K AH L IY
CONICITIES	K AA N IH K AH T IY Z
CONICITY	K AA N IH K AH T IY
CONICS	K AA N IH K S
CONICS(2)	K OW N IH K S
CONIDIA	K AH N IH D IY AH
CONIDIAL	K OW N AH D IY AH L
CONIDIAN	K AH N IH D IY AH N
CONIDIOPHORE	K AH N AH D IY AH F AH R
CONIDIOPHORES	K AH N AH D IY AH F AH R Z
CONIDIUM	K AH N IH D IY AH M
CONIES	K OW N IY Z
CONIFER	K AA N AH F ER
CONIFEROUS	K AH N IH F ER AH S
CONIFERS	K AA N AH F ER Z
CONIINE	K AH N IY N
CONIINES	K AH N IY N Z
CONIN	K AH N IH N
CONINE	K OW N AY N
CONINES	K OW N AY N Z
CONING	K OW N IH NG
CONINS	K AH N IH N Z
CONIOSES	K AH N AY OW Z AH Z
CONIOSIS	K AA N Y OW S AH S
CONIUM	K AH N IY AH M
CONIUMS	K AH N AY AH M Z
CONJECTURAL	K AH N JH EH K CH ER AH L
CONJECTURALLY	K AH N JH EH K CH ER AH L IY
CONJECTURE	K AH N JH EH K CH ER
CONJECTURE(2)	K AH N JH EH K SH ER
CONJECTURED	K AH N JH EH K CH ER D
CONJECTURER	K AH N JH EH K CH ER ER
CONJECTURERS	K AH N JH EH K CH ER ER Z
CONJECTURES	K AH N JH EH K CH ER Z
CONJECTURES(2)	K AH N JH EH K SH ER Z
CONJECTURING	K AH N JH EH K CH ER IH NG
CONJOIN	K AA N JH OY N
CONJOINED	K AA N JH OY N D
CONJOINING	K AH N JH OY N IH NG
CONJOINS	K AH N JH OY N Z
CONJOINT	K AH N JH OY N T
CONJOINTLY	K AH N JH OY N T L IY
CONJUGAL	K AA N JH AH G AH L
CONJUGALITIES	K AA N JH IH G AH L AH T IY Z
CONJUGALITY	K AA N JH IH G AH L AH T IY
CONJUGALLY	K AA N JH IH G AH L IY
CONJUGANT	K AA N JH IH G AH N T
CONJUGANTS	K AA N JH IH G AH N T S
CONJUGATE	K AA N JH AH G EY T
CONJUGATED	K AA N JH AH G EY T IH D
CONJUGATELY	K AA N JH IH G AH T L IY
CONJUGATENESS	K AA N JH IH G AH T N AH S
CONJUGATENESSES	K AA N JH IH G AH T N AH S IH Z
CONJUGATES	K AA N JH AH G EY T S
CONJUGATING	K AA N JH IH G EY T IH NG
CONJUGATION	K AA N JH AH G EY SH AH N
CONJUGATIONAL	K AA N JH IH G EY SH AH N AH L
CONJUGATIONALLY	K AA N JH IH G EY SH AH N AH L IY
CONJUGATIONS	K AA N JH AH G EY SH AH N Z
CONJUNCT	K AA N JH AH NG K T
CONJUNCTION	K AH N JH AH NG K SH AH N
CONJUNCTIONAL	K AH N JH AH NG K SH AH N AH L
CONJUNCTIONALLY	K AH N JH AH NG K SH AH N AH L IY
CONJUNCTIONS	K AH N JH AH NG K SH AH N Z
CONJUNCTIVA	K AA N JH AH NG K T AY V AH
CONJUNCTIVAE	K AA N JH AH NG K T AH V IY
CONJUNCTIVAL	K AH N JH AH NG K T IH V AH L
CONJUNCTIVAS	K AA N JH AH NG K T AH V AH Z
CONJUNCTIVE	K AH N JH AH NG K T IH V
CONJUNCTIVELY	K AH N JH AH NG K T IH V L IY
CONJUNCTIVES	K AH N JH AH NG K T IH V Z
CONJUNCTIVITIS	K AH N JH AH NG K T IH V AH T IY Z
CONJUNCTIVITISES	K AH N JH AH NG K T IH V AH T IY Z IH Z
CONJUNCTS	K AA N JH AH NG K T S
CONJUNCTURE	K AH N JH AH NG K CH ER
CONJUNCTURES	K AH N JH AH NG K CH ER Z
CONJURATION	K AH N JH UH R EY SH AH N
CONJURATIONS	K AH N JH UH R EY SH AH N Z
CONJURE	K AA N JH ER
CONJURED	K AA N JH ER D
CONJURER	K AH N JH UH R ER
CONJURERS	K AH N JH UH R ER Z
CONJURES	K AA N JH ER Z
CONJURING	K AA N JH ER IH NG
CONJUROR	K AA N JH ER ER
CONJURORS	K AH N JH UH R ER Z
CONK	K AA NG K
CONKED	K AO NG K T
CONKER	K AO NG K AH R
CONKERS	K AA N K EH R Z
CONKING	K AH N K IH NG
CONKS	K AO NG K S
CONKY	K AO NG K IY
CONN	K AA N
CONNATE	K AA N AH T
CONNATELY	K AA N AH T L IY
CONNATURAL	K AH N AE CH AH R AH L
CONNATURALITIES	K AH N AE CH AH R AH L AH T IY Z
CONNATURALITY	K AH N AE CH AH R AH L AH T IY
CONNATURALLY	K AH N AE CH AH R AH L IY
CONNECT	K AH N EH K T
CONNECTABLE	K AH N EH K T AH B AH L
CONNECTED	K AH N EH K T IH D
CONNECTEDLY	K AH N EH K T AH D L IY
CONNECTEDNESS	K AH N EH K T AH D N AH S
CONNECTEDNESSES	K AH N EH K T AH D N AH S IH Z
CONNECTER	K AH N EH K T ER
CONNECTERS	K AH N EH K T ER Z
CONNECTIBLE	K AH N EH K T AH B AH L
CONNECTING	K AH N EH K T IH NG
CONNECTION	K AH N EH K SH AH N
CONNECTIONAL	K AH N EH K SH AH N AH L
CONNECTIONS	K AH N EH K SH AH N Z
CONNECTIVE	K AH N EH K T IH V
CONNECTIVELY	K AH N EH K T IH V L IY
CONNECTIVES	K AH N EH K T IH V Z
CONNECTIVITIES	K AH N EH K T IH V AH T IY Z
CONNECTIVITY	K AH N EH K T IH V IH T IY
CONNECTOR	K AH N EH K T ER
CONNECTORS	K AH N EH K T ER Z
CONNECTS	K AH N EH K T S
CONNED	K AA N D
CONNER	K AA N ER
CONNERS	K AA N ER Z
CONNEXION	K AH N EH K SH AH N
CONNEXIONS	K AH N EH K SH AH N Z
CONNING	K AA N IH NG
CONNIPTION	K AH N IH P SH AH N
CONNIPTIONS	K AA N IH P T IY AH N Z
CONNIVANCE	K AH N AY V AH N S
CONNIVANCES	K AH N AY V AH N S IH Z
CONNIVE	K AH N AY V
CONNIVED	K AH N AY V D
CONNIVENT	K AH N AY V AH N T
CONNIVER	K AH N AY V ER
CONNIVERS	K AH N AY V ER Z
CONNIVES	K AH N AY V Z
CONNIVING	K AH N AY V IH NG
CONNOISSEUR	K AA N AH S ER
CONNOISSEURS	K AA N AH S ER Z
CONNOISSEURSHIP	K AA N AH S ER SH IH P
CONNOISSEURSHIPS	K AA N AH S ER SH IH P S
CONNOTATION	K AA N AH T EY SH AH N
CONNOTATIONAL	K AA N AH T EY SH AH N AH L
CONNOTATIONS	K AA N AH T EY SH AH N Z
CONNOTATIVE	K AH N OW T AH T IH V
CONNOTATIVELY	K AH N OW T AH T IH V L IY
CONNOTE	K AH N OW T
CONNOTED	K AH N OW T IH D
CONNOTES	K AH N OW T S
CONNOTING	K AH N OW T IH NG
CONNS	K AA N Z
CONNUBIAL	K AA N Y UW B IY AH L
CONNUBIALISM	K AA N Y UW B IY AH L IH Z AH M
CONNUBIALISMS	K AA N Y AH B IY AH L AH Z AH M Z
CONNUBIALITIES	K AA N Y AH B IY AE L AH T AY Z
CONNUBIALITY	K AA N Y UW B IY AE L AH T IY
CONNUBIALLY	K AA N Y UW B IY AE L IY
CONODONT	K AH N AA D AH N T
CONODONTS	K AH N AA D AH N T S
CONOID	K OW N OY D
CONOIDAL	K AH N OY D AH L
CONOIDS	K AH N OY D Z
CONOMINEE	K OW N AA M AH N IY
CONOMINEES	K OW N AA M AH N IY Z
CONQUER	K AA NG K ER
CONQUERED	K AA NG K ER D
CONQUERING	K AA NG K ER IH NG
CONQUEROR	K AA NG K ER ER
CONQUERORS	K AA NG K ER ER Z
CONQUERS	K AA NG K ER Z
CONQUEST	K AA NG K W EH S T
CONQUESTS	K AA N K W EH S T S
CONQUIAN	K AA N K W IY AH N
CONQUIANS	K AA N K W AY AH N Z
CONQUISTADOR	K AA N K W IH S T AH D AH R
CONQUISTADORES	K AA N K W IH S T AH D AH R Z
CONQUISTADORS	K AA N K W IH S T AH D AH R Z
CONS	K AA N Z
CONSANGUINE	K AA N S AE N G W AY N
CONSANGUINEOUS	K AA N S AE N G W IH N IY AH S
CONSANGUINEOUSLY	K AA N S AE N G W IH N IY AH S L IY
CONSANGUINITIES	K AA N S AE N G W IH N AH T IY Z
CONSANGUINITY	K AA N S AE N G W IH N AH T IY
CONSCIENCE	K AA N SH AH N S
CONSCIENCELESS	K AA N CH AH N S L AH S
CONSCIENCES	K AA N CH IH N S IH Z
CONSCIENTIOUS	K AA N SH IY EH N SH AH S
CONSCIENTIOUSLY	K AA N CH IY EH N CH AH S L IY
CONSCIENTIOUSNESS	K AA N CH IY EH N CH AH S N AH S
CONSCIENTIOUSNESSES	K AA N CH IY EH N CH AH S N AH S IH Z
CONSCIONABLE	K AA N CH AH N AH B AH L
CONSCIOUS	K AA N SH AH S
CONSCIOUSES	K AA N SH AH S IH Z
CONSCIOUSLY	K AA N SH AH S L IY
CONSCIOUSNESS	K AA N SH AH S N AH S
CONSCIOUSNESSES	K AA N SH AH S N AH S IH Z
CONSCRIBE	K AH N S K R AY B
CONSCRIBED	K AH N S K R AY B D
CONSCRIBES	K AH N S K R AY B Z
CONSCRIBING	K AH N S K R AY B IH NG
CONSCRIPT	K AA N S K R IH P T
CONSCRIPT(2)	K AH N S K R IH P T
CONSCRIPTED	K AH N S K R IH P T IH D
CONSCRIPTING	K AH N S K R IH P T IH NG
CONSCRIPTION	K AH N S K R IH P SH AH N
CONSCRIPTIONS	K AH N S K R IH P SH AH N Z
CONSCRIPTS	K AA N S K R IH P T S
CONSECRATE	K AA N S AH K R EY T
CONSECRATED	K AA N S AH K R EY T AH D
CONSECRATED(2)	K AA N S AH K R EY T IH D
CONSECRATES	K AA N S AH K R EY T S
CONSECRATING	K AA N S AH K R EY T IH NG
CONSECRATION	K AA N S AH K R EY SH AH N
CONSECRATIONS	K AA N S AH K R EY SH AH N Z
CONSECRATIVE	K AA N S AH K R EY T IH V
CONSECRATOR	K AA N S AH K R EY T ER
CONSECRATORS	K AA N S AH K R EY T ER Z
CONSECRATORY	K AA N S AH K R EY T ER IY
CONSECUTION	K AA N S IY K Y UW SH AH N
CONSECUTIONS	K AA N S EH K Y UW T IY AH N Z
CONSECUTIVE	K AH N S EH K Y AH T IH V
CONSECUTIVELY	K AH N S EH K Y AH T IH V L IY
CONSECUTIVENESS	K AH N S EH K Y AH T IH V N AH S
CONSECUTIVENESSES	K AH N S EH K Y AH T IH V N AH S IH Z
CONSENSUAL	K AH N S EH N S UW AH L
CONSENSUAL(2)	K AH N S EH N SH UW AH L
CONSENSUALLY	K AH N S EH N CH AH W AH L IY
CONSENSUS	K AH N S EH N S AH S
CONSENSUSES	K AH N S EH N S AH S IH Z
CONSENT	K AH N S EH N T
CONSENTANEOUS	K AA N S EH N T EY N IY AH S
CONSENTANEOUSLY	K AA N S EH N T AH N IY OW AH S L IY
CONSENTED	K AH N S EH N T IH D
CONSENTED(2)	K AH N S EH N IH D
CONSENTER	K AH N S EH N T ER
CONSENTERS	K AH N S EH N T ER Z
CONSENTING	K AH N S EH N T IH NG
CONSENTING(2)	K AH N S EH N IH NG
CONSENTINGLY	K AH N S EH N T IH NG L IY
CONSENTS	K AH N S EH N T S
CONSEQUENCE	K AA N S AH K W AH N S
CONSEQUENCES	K AA N S AH K W EH N S AH Z
CONSEQUENT	K AA N S AH K W AH N T
CONSEQUENTIAL	K AA N S AH K W EH N SH AH L
HUARACHE	HH Y UW ER EY K
EBON	EH B AH N
IHRAM	IH R AH M
MUJAHEDEEN	M UW JH AH HH EH D IY N
WOTS	W AA T S
MRIDANGA	M R AH D AE N G AH
EJECT	IH JH EH K T
