CR	S IY R
ACCREDIT	AH K R EH D IH T
ACCREDITABLE	AH K R EH D AH T AH B AH L
ACCREDITATION	AH K R EH D AH T EY SH AH N
ACCREDITATIONS	AH K R EH D AH T EY SH AH N Z
ACCREDITED	AH K R EH D IH T IH D
ACCREDITING	AH K R EH D AH T IH NG
ACCREDITS	AH K R EH D AH T S
ACCRETE	AH K R IY T
ACCRETED	AH K R IY T IH D
ACCRETES	AH K R IY T S
ACCRETING	AH K R IY T IH NG
ACCRETION	AH K R IY SH AH N
ACCRETIONARY	AH K R IY SH AH N EH R IY
ACCRETIONS	AH K R IY SH AH N Z
ACCRETIVE	AH K R IY T IH V
ACCRUABLE	AH K R UW AH B AH L
ACCRUAL	AH K R UW AH L
ACCRUALS	AH K R UW AH L Z
ACCRUE	AH K R UW
ACCRUED	AH K R UW D
ACCRUEMENT	AH K R UW M AH N T
ACCRUEMENTS	AH K R UW M AH N T S
ACCRUES	AH K R UW Z
ACCRUING	AH K R UW IH NG
ACRASIA	AE K R EY ZH IY AH
ACRASIAS	AE K R EY S IY AH Z
ACRASIN	AE K R AH S AH N
ACRASINS	AE K R AH S AH N Z
ACRE	EY K ER
ACREAGE	EY K AH R IH JH
ACREAGE(2)	EY K R IH JH
ACREAGES	EY K ER IH JH IH Z
ACRED	EY K ER D
ACRES	EY K ER Z
ACRID	AE K R IH D
ACRIDER	AE K R AH D ER
ACRIDEST	AE K R AH D AH S T
ACRIDINE	AE K R AH D AY N
ACRIDINES	AE K R AH D AY N Z
ACRIDITIES	AE K R AH D AH T IY Z
ACRIDITY	AE K R AH D AH T IY
ACRIDLY	AE K R AH D L IY
ACRIDNESS	AE K R AH D N AH S
ACRIDNESSES	AE K R AH D N AH S IH Z
ACRIFLAVINE	AE K R IH F L AH V AY N
ACRIFLAVINES	AE K R IH F L AH V AY N Z
ACRIMONIES	AE K R IH M AH N AY Z
ACRIMONIOUS	AE K R AH M OW N IY AH S
ACRIMONIOUSLY	AE K R AH M AH N IY OW AH S L IY
ACRIMONIOUSNESS	AE K R AH M OW N IY AW Z N AH S
ACRIMONIOUSNESSES	AE K R AH M OW N IY AW Z N EH S AH Z
ACRIMONY	AE K R IH M OW N IY
ACRITARCH	AE K R AH T AH R K
ACRITARCHS	AE K R AH T AH R K S
ACROBAT	AE K R AH B AE T
ACROBATIC	AE K R AH B AE T IH K
ACROBATICALLY	AE K R AH B AE T IH K AH L IY
ACROBATICS	AE K R AH B AE T IH K S
ACROBATS	AE K R AH B AE T S
ACROCENTRIC	AE K R AH S AH N T R AH K
ACROCENTRICS	AE K R AH S EH N T R AH S Z
ACRODONT	AE K R AH D AH N T
ACRODONTS	AE K R AH D AH N T S
ACROGEN	AE K R AH JH AH N
ACROGENS	AE K R AH JH AH N Z
ACROLECT	AE K R AH L AH K T
ACROLECTS	AE K R AH L AH K T S
ACROLEIN	AE K R OW L IY N
ACROLEINS	AE K R AH L IY N Z
ACROLITH	AE K R AH L AH TH
ACROLITHS	AE K R AH L AH TH S
ACROMEGALIC	AE K R AA M AH G AH L AH K
ACROMEGALICS	AE K R AH M EH G AH L AH S Z
ACROMEGALIES	AE K R AH M EH G AH L AY Z
ACROMEGALY	AE K R AH M EH G AH L IY
ACROMIA	AE K R OW M IY AH
ACROMIAL	AE K R OW M IY AH L
ACROMION	AE K R OW M IY AH N
ACROMIONS	AE K R OW M IY AH N Z
ACRONIC	AH K R OW N IH K
ACRONYM	AE K R AH N IH M
ACRONYMIC	AE K R AH N AH M AH K
ACRONYMICALLY	AH K R OW N IY M AY S AH L IY
ACRONYMS	AE K R AH N IH M Z
ACROPETAL	AE K R AA P AH T AH L
ACROPETALLY	AE K R AA P AH T AE L IY
ACROPHOBE	AE K R AH F OW B
ACROPHOBES	AE K R AH F OW B Z
ACROPHOBIA	AE K R AH F OW B IY AH
ACROPHOBIAS	AE K R AH F OW B IY AH Z
ACROPOLIS	AH K R AA P AH L AH S
ACROPOLISES	AH K R AA P AH L AH S IH Z
ACROSOMAL	AE K R AA S AH M AH L
ACROSOME	AE K R AH S AH M
ACROSOMES	AE K R AH S AH M Z
ACROSS	AH K R AO S
ACROSTIC	AE K R AH S T AH K
ACROSTICAL	AE K R AA S T IH S AH L
ACROSTICALLY	AE K R AA S T AH K AE L IY
ACROSTICS	AE K R AA S T AH S Z
ACROTIC	AE K R AH T AH K
ACROTISM	AE K R AH T IH Z AH M
ACROTISMS	AE K R AH T AH Z AH M Z
ACRYLAMIDE	AE K R IH L AH M AY D
ACRYLAMIDES	AE K R IH L AH M AY D Z
ACRYLATE	AH K R AY L EY T
ACRYLATES	AH K R AY L EY T S
ACRYLIC	AH K R IH L IH K
ACRYLICS	AH K R IH L IH K S
ACRYLONITRILE	AE K R IH L AH N IH T R AH L
ACRYLONITRILES	AE K R IH L AH N IH T R AH L Z
ADSCRIPT	AE D S K R AH P T
ADSCRIPTS	AE D S K R AH P T S
AIRCRAFT	EH R K R AE F T
AIRCREW	EH R K R UW
AIRCREWS	AH IH R K R UW Z
AIRSCREW	AH IH R S K R UW
AIRSCREWS	AH IH R S K R UW Z
ALACRITIES	AH L AE K R AH T IY Z
ALACRITOUS	AH L AE K R AH T AH S
ALACRITY	AH L AE K R AH T IY
AMBULACRA	AE M B Y AH L AE K R AH
AMBULACRAL	AE M B Y AH L AE K R AH L
AMBULACRUM	AE M B Y AH L AE K R AH M
ANACREONTIC	AH N AE K R IY AH N T AH K
ANACREONTICS	AH N AE K R IY AA N T AH S Z
ANACRUSES	AE N AH K R UW Z AH Z
ANACRUSIS	AH N AE K R UW S AH S
ANCRESS	AE NG K R AH S
ANCRESSES	AE NG K R EH S AH Z
ANTIAIRCRAFT	AE N T AY EH R K R AE F T
ANTIAIRCRAFTS	AE N T AY AH IH R K R AE F T S
ANTIARISTOCRATIC	AE N T AY AH R IH S T AH K R AE T IH K
ANTIBUREAUCRATIC	AE N T AY B Y UH R AH K R AE T IH K
ANTICRACK	AE N T AY K R AE K
ANTICREATIVE	AE N T AY K R IY EY T IH V
ANTICRIME	AE N T IY K R AY M
ANTICRIME(2)	AE N T AY K R AY M
ANTICRUELTY	AE N T AY K R UW AH L T IY
ANTIDEMOCRATIC	AE N T AY D EH M AH K R AE T IH K
ANTIDISCRIMINATION	AE N T IY D IH S K R IH M AH N EY SH AH N
ANTIDISCRIMINATION(2)	AE N T AY D IH S K R IH M AH N EY SH AH N
ANTIMICROBIAL	AE N T AY M AY K R OW B IY AH L
ANTIMICROBIALS	AE N T AY M AY K R OW B IY AH L Z
ANTISECRECY	AE N T AY S IY K R AH S IY
APOCRINE	AE P AH K R AY N
APOCRYPHA	AH P AA K R AH F AH
APOCRYPHAL	AH P AA K R AH F AH L
APOCRYPHALLY	AH P AA K R AH F AH L IY
APOCRYPHALNESS	AH P AA K R AH F AH L N AH S
APOCRYPHALNESSES	AH P AA K R AH F AH L N AH S IH Z
ARISTOCRACIES	AE R AH S T AA K R AH S IY Z
ARISTOCRACY	EH R AH S T AA K R AH S IY
ARISTOCRAT	ER IH S T AH K R AE T
ARISTOCRATIC	ER IH S T AH K R AE T IH K
ARISTOCRATICALLY	AH R IH S T AH K R AE T IH K AH L IY
ARISTOCRATS	ER IH S T AH K R AE T S
ASCRIBABLE	AH S K R AY B AH B AH L
ASCRIBE	AH S K R AY B
ASCRIBED	AH S K R AY B D
ASCRIBES	AH S K R AY B Z
ASCRIBING	AH S K R AY B IH NG
ASCRIPTION	AH S K R IH P SH AH N
ASCRIPTIONS	AH S K R IH P SH AH N Z
ASCRIPTIVE	AH S K R IH P T IH V
AUTOCRACIES	AO T AA K R AH S IY Z
AUTOCRACY	AO T AA K R AH S IY
AUTOCRAT	AO T AH K R AE T
AUTOCRATIC	AO T AH K R AE T IH K
AUTOCRATICAL	AO T AH K R AE T IH K AH L
AUTOCRATICALLY	AO T AH K R AE T IH K AH L IY
AUTOCRATS	AO T AH K R AE T S
AUTOCROSS	AO T OW K R AO S
AUTOCROSSES	AO T OW K R AO S IH Z
BACKCROSS	B AE K R AO S
BACKCROSSED	B AE K R AO S T
BACKCROSSES	B AE K R AO S IH Z
BACKCROSSING	B AE K R AO S IH NG
BECRAWL	B IH K R AO L
BECRAWLED	B IH K R AO L D
BECRAWLING	B IH K R AO L IH NG
BECRAWLS	B IH K R AO L Z
BECRIME	B IH K R AY M
BECRIMED	B IH K R AY M D
BECRIMES	B IH K R AY M Z
BECRIMING	B IH K R AY M IH NG
BECROWD	B IH K R AW D
BECROWDED	B IH K R AW D IH D
BECROWDING	B IH K R AW D IH NG
BECROWDS	B IH K R AW D Z
BECRUST	B IH K R AH S T
BECRUSTED	B IH K R AH S T IH D
BECRUSTING	B IH K R AH S T IH NG
BECRUSTS	B IH K R AH S T S
BESCREEN	B IH S K R IY N
BESCREENED	B IH S K R IY N D
BESCREENING	B IH S K R IY N IH NG
BESCREENS	B IH S K R IY N Z
BICRON	B AY K R AA N
BICRONS	B AY K R AA N Z
BREADCRUMB	B R EH D K R AH M
BREADCRUMBS	B R EH D K R AH M Z
BROMOCRIPTINE	B R AH M AA K R AH P T AY N
BROMOCRIPTINES	B R AH M AA K R AH P T AY N Z
BUREAUCRACIES	B Y UH R AA K R AH S IY Z
BUREAUCRACY	B Y UH R AA K R AH S IY
BUREAUCRAT	B Y UH R AH K R AE T
BUREAUCRAT(2)	B Y UH R OW K R AE T
BUREAUCRATESE	B Y UH R AH K R AE T IY Z
BUREAUCRATESES	B Y UH R OW K R EY T S IH Z
BUREAUCRATIC	B Y UH R AH K R AE T IH K
BUREAUCRATICALLY	B Y UH R AH K R AE T IH K AH L IY
BUREAUCRATISE	B Y AH R IY AH K R AH T AY Z
BUREAUCRATISED	B Y UH R AH K R AE T IY Z D
BUREAUCRATISES	B Y UH R AH K R AE T IY Z IH Z
BUREAUCRATISING	B Y UH R AH K R AE T IY Z IH NG
BUREAUCRATISM	B Y UH R AH K R AE T IH Z AH M
BUREAUCRATISMS	B Y UH R AH K R AE T IH Z AH M Z
BUREAUCRATIZATION	B Y UH R AH K R AE T AH Z EY SH AH N
BUREAUCRATIZATIONS	B Y UH R AH K R AE T AH Z EY SH AH N Z
BUREAUCRATIZE	B Y UH R AH K R AE T AY Z
BUREAUCRATIZED	B Y UH R AH K R AE T AY Z D
BUREAUCRATIZES	B Y UH R AH K R AE T AY Z IH Z
BUREAUCRATIZING	B Y UH R AH K R AE T AY Z IH NG
BUREAUCRATS	B Y UH R AH K R AE T S
BUREAUCRATS(2)	B Y UH R OW K R AE T S
CAMPCRAFT	K AE M P K R AE F T
CAMPCRAFTS	K AE M P K R AE F T S
CANCROID	K AE NG K R OY D
CANCROIDS	K AE NG K R OY D Z
CARVACROL	K AA R V AE K R AH L
CARVACROLS	K AA R V AE K R AH L Z
CHANCRE	CH AE NG K AH R
CHANCRES	CH AE NG K AH R Z
CHANCROID	CH AE NG K R OY D
CHANCROIDAL	CH AE NG K R OY D AH L
CHANCROIDS	CH AE NG K R OY D Z
CHANCROUS	CH AE NG K R AH S
CHLOROPICRIN	K L AO R AH P IH K R AH N
CHLOROPICRINS	K L AO R AH P IH K R AH N Z
CHONDROCRANIA	CH AA N D R AH K R EY N Y AH
CHONDROCRANIUM	CH AA N D R AH K R EY N IY AH M
CHONDROCRANIUMS	CH AA N D R AH K R EY N IY AH M Z
CHYLOMICRON	CH IH L AH M IH K R AH N
CHYLOMICRONS	CH IH L AH M IH K R AH N Z
CIRCUMSCRIBE	S ER K AH M S K R AY B
CIRCUMSCRIBED	S ER K AH M S K R AY B D
CIRCUMSCRIBES	S ER K AH M S K R AY B Z
CIRCUMSCRIBING	S ER K AH M S K R AY B IH NG
CIRCUMSCRIPTION	S ER K AH M S K R IH P SH AH N
CIRCUMSCRIPTIONS	S ER K AH M S K R IH P SH AH N Z
COCKCROW	K AA K R OW
COCKCROWS	K AA K R OW Z
COCREATE	K OW K R IY EY T
COCREATED	K OW K R IY EY T IH D
COCREATES	K OW K R IY EY T S
COCREATING	K OW K R IY EY T IH NG
COCREATOR	K OW K R IY EY T ER
COCREATORS	K OW K R IY EY T ER Z
COLICROOT	K OW L IH K R UW T
COLICROOTS	K OW L IH K R UW T S
CONCRESCENCE	K AH N K R EH S AH N S
CONCRESCENCES	K AH N K R EH S AH N S IH Z
CONCRESCENT	K AH N K R EH S AH N T
CONCRETE	K AH N K R IY T
CONCRETE(2)	K AA N K R IY T
CONCRETED	K AA N K R IY T IH D
CONCRETELY	K AA N K R IY T L IY
CONCRETENESS	K AA N K R IY T N AH S
CONCRETENESSES	K AA N K R IY T N AH S IH Z
CONCRETES	K AA N K R IY T S
CONCRETING	K AA N K R IY T IH NG
CONCRETION	K AA N K R IY SH AH N
CONCRETIONARY	K AA N K R IY SH AH N EH R IY
CONCRETIONS	K AA N K R IY SH AH N Z
CONCRETISM	K AA N K R IY T IH Z AH M
CONCRETISMS	K AA N K R IY T IH Z AH M Z
CONCRETIST	K AA N K R IY T IH S T
CONCRETISTS	K AA N K R IY T IH S T S
CONCRETIZATION	K AA N K R IY T AH Z EY SH AH N
CONCRETIZATIONS	K AA N K R IY T AH Z EY SH AH N Z
CONCRETIZE	K AA N K R IY T AY Z
CONCRETIZED	K AA N K R IY T AY Z D
CONCRETIZES	K AA N K R IY T AY Z IH Z
CONCRETIZING	K AA N K R IY T AY Z IH NG
CONSCRIBE	K AH N S K R AY B
CONSCRIBED	K AH N S K R AY B D
CONSCRIBES	K AH N S K R AY B Z
CONSCRIBING	K AH N S K R AY B IH NG
CONSCRIPT	K AA N S K R IH P T
CONSCRIPT(2)	K AH N S K R IH P T
CONSCRIPTED	K AH N S K R IH P T IH D
CONSCRIPTING	K AH N S K R IH P T IH NG
CONSCRIPTION	K AH N S K R IH P SH AH N
CONSCRIPTIONS	K AH N S K R IH P SH AH N Z
CONSCRIPTS	K AA N S K R IH P T S
CONSECRATE	K AA N S AH K R EY T
CONSECRATED	K AA N S AH K R EY T AH D
CONSECRATED(2)	K AA N S AH K R EY T IH D
CONSECRATES	K AA N S AH K R EY T S
CONSECRATING	K AA N S AH K R EY T IH NG
CONSECRATION	K AA N S AH K R EY SH AH N
CONSECRATIONS	K AA N S AH K R EY SH AH N Z
CONSECRATIVE	K AA N S AH K R EY T IH V
CONSECRATOR	K AA N S AH K R EY T ER
CONSECRATORS	K AA N S AH K R EY T ER Z
CONSECRATORY	K AA N S AH K R EY T ER IY
CORKSCREW	K AO R K S K R UW
CORKSCREWED	K AO R K S K R UW D
CORKSCREWING	K AO R K S K R UW IH NG
CORKSCREWS	K AO R K S K R UW Z
CORNCRAKE	K AA R NG K R EY K
CORNCRAKES	K AA R NG K R EY K S
CORNCRIB	K AO R N K R IH B
CORNCRIBS	K AO R N K R IH B Z
COSCRIPT	K OW S K R IH P T
COSCRIPTED	K OW S K R IH P T IH D
COSCRIPTING	K OW S K R IH P T IH NG
COSCRIPTS	K OW S K R IH P T S
COUNTERCRIES	K AW N T ER K R AY Z
COUNTERCRITICISM	K AW N T ER K R IH T AH S IH Z AH M
COUNTERCRITICISMS	K AW N T ER K R IH T AH S IH Z AH M Z
COUNTERCRY	K AW N T ER K R AY
CRAAL	K R EY AH L
CRAALED	K R AA L D
CRAALING	K R AA L AH NG
CRAALS	K R AA L Z
CRAB	K R AE B
CRABBED	K R AE B D
CRABBEDNESS	K R AE B AH D N AH S
CRABBEDNESSES	K R AE B AH D N AH S IH Z
CRABBER	K R AE B ER
CRABBERS	K R AE B ER Z
CRABBIER	K R AE B IY ER
CRABBIEST	K R AE B IY AH S T
CRABBILY	K R AE B IY L IY
CRABBING	K R AE B IH NG
CRABBY	K R AE B IY
CRABGRASS	K R AE B G R AE S
CRABGRASSES	K R AE B G R AE S IH Z
CRABMEAT	K R AE B M IY T
CRABMEATS	K R AE B M IY T S
CRABS	K R AE B Z
CRABSTICK	K R AE B S T IH K
CRABSTICKS	K R AE B S T IH K S
CRABWISE	K R AE B W AY Z
CRACK	K R AE K
CRACKAJACK	K R AE K AH JH AE K
CRACKAJACKS	K R AE K AH JH AE K S
CRACKBACK	K R AE K B AE K
CRACKBACKS	K R AE K B AE K S
CRACKBRAIN	K R AE K B R EY N
CRACKBRAINED	K R AE K B R EY N D
CRACKBRAINS	K R AE K B R EY N Z
CRACKDOWN	K R AE K D AW N
CRACKDOWNS	K R AE K D AW N Z
CRACKED	K R AE K T
CRACKER	K R AE K ER
CRACKERJACK	K R AE K ER JH AE K
CRACKERJACKS	K R AE K ER JH AE K S
CRACKERS	K R AE K ER Z
CRACKING	K R AE K IH NG
CRACKINGS	K R AE K IH NG Z
CRACKLE	K R AE K AH L
CRACKLED	K R AE K AH L D
CRACKLES	K R AE K AH L Z
CRACKLEWARE	K R AE K AH L W EH R
CRACKLEWARES	K R AE K AH L W EH R Z
CRACKLIER	K R AE K L IY ER
CRACKLIEST	K R AE K L IY AH S T
CRACKLING	K R AE K L IH NG
CRACKLINGS	K R AE K L IH NG Z
CRACKLY	K R AE K L IY
CRACKNEL	K R AE K N AH L
CRACKNELS	K R AE K N AH L Z
CRACKPOT	K R AE K P AA T
CRACKPOTS	K R AE K P AA T S
CRACKS	K R AE K S
CRACKSMAN	K R AE K S M AE N
CRACKSMEN	K R AE K S M EH N
CRACKUP	K R AE K AH P
CRACKUPS	K R AE K AH P S
CRACKY	K R AE K IY
CRADLE	K R EY D AH L
CRADLED	K R EY D AH L D
CRADLER	K R EY D AH L ER
CRADLERS	K R EY D AH L ER Z
CRADLES	K R EY D AH L Z
CRADLESONG	K R EY D AH L S AO NG
CRADLESONGS	K R EY D AH L S AO NG Z
CRADLING	K R EY D AH L IH NG
CRADLING(2)	K R EY D L IH NG
CRAFT	K R AE F T
CRAFTED	K R AE F T IH D
CRAFTIER	K R AE F T IY ER
CRAFTIEST	K R AE F T IY AH S T
CRAFTILY	K R AE F T IY L IY
CRAFTINESS	K R AE F T IY N AH S
CRAFTINESSES	K R AE F T IY N AH S IH Z
CRAFTING	K R AE F T IH NG
CRAFTS	K R AE F T S
CRAFTS(2)	K R AE F S
CRAFTSMAN	K R AE F T S M AH N
CRAFTSMAN(2)	K R AE F S M AH N
CRAFTSMANLIKE	K R AE F T S M AE N L AY K
CRAFTSMANLY	K R AE F T S M AE N L IY
CRAFTSMANSHIP	K R AE F T S M AH N SH IH P
CRAFTSMANSHIP(2)	K R AE F S M AH N SH IH P
CRAFTSMANSHIPS	K R AE F T S M AE N SH IH P S
CRAFTSMEN	K R AE F T S M EH N
CRAFTSMEN(2)	K R AE F S M EH N
CRAFTSPEOPLE	K R AE F T S P IY P AH L
CRAFTSPEOPLE(2)	K R AE F S P IY P AH L
CRAFTSPERSON	K R AE F T S P ER S AH N
CRAFTSPERSONS	K R AE F T S P ER S AH N Z
CRAFTSWOMAN	K R AE F T S W UH M AH N
CRAFTSWOMEN	K R AE F T S W IH M AH N
CRAFTY	K R AE F T IY
CRAG	K R AE G
CRAGGED	K R AE G D
CRAGGIER	K R AE G IY ER
CRAGGIEST	K R AE G IY AH S T
CRAGGILY	K R AE G IY L IY
CRAGGINESS	K R AE G IY N AH S
CRAGGINESSES	K R AE G IY N AH S IH Z
CRAGGY	K R AE G IY
CRAGS	K R AE G Z
CRAGSMAN	K R AE G Z M AE N
CRAGSMEN	K R AE G Z M EH N
CRAKE	K R EY K
CRAKES	K R EY K S
CRAM	K R AE M
CRAMBE	K R AE M B IY
CRAMBES	K R AE M B IY Z
CRAMBO	K R AE M B OW
CRAMBOES	K R AE M B OW Z
CRAMBOS	K R AE M B AH Z
CRAMMED	K R AE M D
CRAMMER	K R AE M ER
CRAMMERS	K R AE M ER Z
CRAMMING	K R AE M IH NG
CRAMOISIE	K R AH M OY S AY
CRAMOISIES	K R AE M OY S AY Z
CRAMOISY	K R AH M OW AH S IY
CRAMP	K R AE M P
CRAMPED	K R AE M P T
CRAMPING	K R AE M P IH NG
CRAMPIT	K R AE M P IH T
CRAMPITS	K R AE M P IH T S
CRAMPON	K R AE M P AO N
CRAMPONS	K R AE M P AO N Z
CRAMPOON	K R AE M P UW N
CRAMPOONS	K R AE M P UW N Z
CRAMPS	K R AE M P S
CRAMS	K R AE M Z
CRANBERRIES	K R AE N B EH R IY Z
CRANBERRY	K R AE N B EH R IY
CRANCH	K R AE N CH
CRANCHED	K R AE N CH T
CRANCHES	K R AE N CH AH Z
CRANCHING	K R AE N CH AH NG
CRANE	K R EY N
CRANED	K R EY N D
CRANES	K R EY N Z
CRANESBILL	K R EY N Z B IH L
CRANESBILLS	K R EY N Z B IH L Z
CRANIA	K R EY N Y AH
CRANIAL	K R EY N IY AH L
CRANIALLY	K R EY N IY AH L IY
CRANIATE	K R EY N IY AH T
CRANIATES	K R EY N IY AH T S
CRANING	K R EY N IH NG
CRANIOCEREBRAL	K R EY N IY AA S AH R EH B R AH L
CRANIOFACIAL	K R EY N IY AH F AH S IY AH L
CRANIOLOGIES	K R EY N IY AA L AH JH IY Z
CRANIOLOGY	K R EY N IY AA L AH JH IY
CRANIOMETRIES	K R EY N IY AH M EH T R AY Z
CRANIOMETRY	K R EY N IY AH M EH T R IY
CRANIOSACRAL	K R EY N IY AH S AE K R AH L
CRANIOTOMIES	K R EY N IY AA T AH M AY Z
CRANIOTOMY	K R EY N IY AA T AH M IY
CRANIUM	K R EY N IY AH M
CRANIUMS	K R EY N IY AH M Z
CRANK	K R AE NG K
CRANKCASE	K R AE NG K EY S
CRANKCASES	K R AE NG K EY S IH Z
CRANKED	K R AE NG K T
CRANKER	K R AE NG K ER
CRANKEST	K R AE NG K AH S T
CRANKIER	K R AE NG K IY ER
CRANKIEST	K R AE NG K IY AH S T
CRANKILY	K R AE NG K IY L IY
CRANKINESS	K R AE NG K IY N AH S
CRANKINESSES	K R AE NG K IY N AH S IH Z
CRANKING	K R AE NG K IH NG
CRANKISH	K R AE NG K IH SH
CRANKLE	K R AE NG K AH L
CRANKLED	K R AE NG K L EH D
CRANKLES	K R AE NG K AH L Z
CRANKLING	K R AE NG K L IH NG
CRANKLY	K R AE NG K L IY
CRANKOUS	K R AE NG K AH S
CRANKPIN	K R AE NG K P IH N
CRANKPINS	K R AE NG K P IH N Z
CRANKS	K R AE NG K S
CRANKSHAFT	K R AE NG K SH AE F T
CRANKSHAFTS	K R AE NG K SH AE F T S
CRANKY	K R AE NG K IY
CRANNIED	K R AE N IY D
CRANNIES	K R AE N IY Z
CRANNOG	K R AE N AH G
CRANNOGE	K R AE N OW JH
CRANNOGES	K R AE N OW JH AH Z
CRANNOGS	K R AE N AH G Z
CRANNY	K R AE N IY
CRANREUCH	K R AE N R UW CH
CRANREUCHS	K R AE N R UW CH S
CRAP	K R AE P
CRAPE	K R EY P
CRAPED	K R AE P T
CRAPES	K R EY P S
CRAPING	K R AE P IH NG
CRAPPED	K R AE P T
CRAPPER	K R AE P ER
CRAPPERS	K R AE P ER Z
CRAPPIE	K R AE P IY
CRAPPIER	K R AE P IY ER
CRAPPIES	K R AE P IY Z
CRAPPIEST	K R AE P IY AH S T
CRAPPING	K R AE P IH NG
CRAPPY	K R AE P IY
CRAPS	K R AE P S
CRAPSHOOT	K R AE P SH UW T
CRAPSHOOTER	K R AE P SH UW T ER
CRAPSHOOTERS	K R AE P SH UW T ER Z
CRAPSHOOTS	K R AE P SH UW T S
CRAPULOUS	K R AE P Y AH L AH S
CRASES	K R EY Z AH Z
CRASH	K R AE SH
CRASHED	K R AE SH T
CRASHER	K R AE SH ER
CRASHERS	K R AE SH ER Z
CRASHES	K R AE SH IH Z
CRASHING	K R AE SH IH NG
CRASHINGLY	K R AE SH IH NG L IY
CRASHWORTHINESS	K R AE SH W ER DH IY N AH S
CRASHWORTHINESSES	K R AE SH W ER DH IY N AH S IH Z
CRASHWORTHY	K R AE SH W ER DH IY
CRASIS	K R AE S AH S
CRASS	K R AE S
CRASSER	K R AE S ER
CRASSEST	K R AE S AH S T
CRASSITUDE	K R AE S AH T UW D
CRASSITUDES	K R AE S AH T UW D Z
CRASSLY	K R AE S L IY
CRASSNESS	K R AE S N AH S
CRASSNESSES	K R AE S N AH S IH Z
CRATCH	K R AE CH
CRATCHES	K R AE CH AH Z
CRATE	K R EY T
CRATED	K R EY T IH D
CRATER	K R EY T ER
CRATERED	K R EY T ER D
CRATERING	K R EY T ER IH NG
CRATERLET	K R EY T ER L AH T
CRATERLETS	K R EY T ER L AH T S
CRATERLIKE	K R EY T ER L AY K
CRATERS	K R EY T ER Z
CRATES	K R EY T S
CRATING	K R EY T IH NG
CRATON	K R AE T AH N
CRATONIC	K R AE T AH N AH K
CRATONS	K R AE T AH N Z
CRAUNCH	K R AO N CH
CRAUNCHED	K R AO N CH T
CRAUNCHES	K R AO N CH AH Z
CRAUNCHING	K R AO N CH AH NG
CRAVAT	K R AE V AH T
CRAVATS	K R EY V EY T S
CRAVE	K R EY V
CRAVED	K R EY V D
CRAVEN	K R EY V AH N
CRAVENED	K R EY V AH N D
CRAVENING	K R EY V AH N IH NG
CRAVENLY	K R EY V AH N L IY
CRAVENNESS	K R EY V AH N AH S
CRAVENNESSES	K R EY V AH N AH S IH Z
CRAVENS	K R EY V AH N Z
CRAVER	K R EY V ER
CRAVERS	K R EY V ER Z
CRAVES	K R EY V Z
CRAVING	K R EY V IH NG
CRAVINGS	K R EY V IH NG Z
CRAW	K R AO
CRAWDAD	K R AO D AH D
CRAWDADS	K R AO D AH D Z
CRAWFISH	K R AO F IH SH
CRAWFISHED	K R AO F AH SH T
CRAWFISHES	K R AO F AH SH AH Z
CRAWFISHING	K R AO F AH SH AH NG
CRAWL	K R AO L
CRAWLED	K R AO L D
CRAWLER	K R AO L ER
CRAWLERS	K R AO L ER Z
CRAWLIER	K R AO L IY ER
CRAWLIEST	K R AO L IY AH S T
CRAWLING	K R AO L IH NG
CRAWLS	K R AO L Z
CRAWLSPACE	K R AO L S P EY S
CRAWLSPACES	K R AO L S P EY S IH Z
CRAWLWAY	K R AO L W EY
CRAWLWAYS	K R AO L W EY Z
CRAWLY	K R AO L IY
CRAWS	K R AO Z
CRAYFISH	K R EY F IH SH
CRAYFISHES	K R EY F AH SH AH Z
CRAYOLA	K R EY AH L AH
CRAYOLAS	K R EY AH L AH Z
CRAYON	K R EY AA N
CRAYONED	K R EY AA N D
CRAYONING	K R EY AA N IH NG
CRAYONIST	K R EY AA N IH S T
CRAYONISTS	K R EY AA N IH S T S
CRAYONS	K R EY AA N Z
CRAZE	K R EY Z
CRAZED	K R EY Z D
CRAZES	K R EY Z IH Z
CRAZIER	K R EY Z IY ER
CRAZIES	K R EY Z IY Z
CRAZIEST	K R EY Z IY AH S T
CRAZILY	K R EY Z AH L IY
CRAZINESS	K R EY Z IY N AH S
CRAZINESSES	K R EY Z IY N AH S IH Z
CRAZING	K R EY Z IH NG
CRAZY	K R EY Z IY
CRAZYWEED	K R EY Z IY W IY D
CRAZYWEEDS	K R EY Z IY W IY D Z
CREAK	K R IY K
CREAKED	K R IY K T
CREAKIER	K R IY K IY ER
CREAKIEST	K R IY K IY AH S T
CREAKILY	K R IY K IY L IY
CREAKINESS	K R IY K IY N AH S
CREAKINESSES	K R IY K IY N AH S IH Z
CREAKING	K R IY K IH NG
CREAKS	K R IY K S
CREAKY	K R IY K IY
CREAM	K R IY M
CREAMCUPS	K R IY M K AH P S
CREAMED	K R IY M D
CREAMER	K R IY M ER
CREAMERIES	K R IY M AH R IY Z
CREAMERS	K R IY M ER Z
CREAMERY	K R IY M ER IY
CREAMIER	K R IY M IY ER
CREAMIEST	K R IY M IY IH S T
CREAMILY	K R IY M IY L IY
CREAMINESS	K R IY M IY N AH S
CREAMINESSES	K R IY M IY N AH S IH Z
CREAMING	K R IY M IH NG
CREAMPUFF	K R IY M P AH F
CREAMPUFFS	K R IY M P AH F S
CREAMS	K R IY M Z
CREAMWARE	K R IY M W EH R
CREAMWARES	K R IY M W EH R Z
CREAMY	K R IY M IY
CREASE	K R IY S
CREASED	K R IY S T
CREASELESS	K R IY S L AH S
CREASER	K R IY S ER
CREASERS	K R IY S ER Z
CREASES	K R IY S IH Z
CREASIER	K R IY S IY ER
CREASIEST	K R IY S IY AH S T
CREASING	K R IY S IH NG
CREASY	K R IY S IY
CREATE	K R IY EY T
CREATED	K R IY EY T AH D
CREATED(2)	K R IY EY T IH D
CREATES	K R IY EY T S
CREATIN	K R IY T AH N
CREATINE	K R IY T AY N
CREATINES	K R IY T AY N Z
CREATING	K R IY EY T IH NG
CREATININE	K R IY T AH N AY N
CREATININES	K R IY T AH N AY N Z
CREATINS	K R IY T AH N Z
CREATION	K R IY EY SH AH N
CREATIONISM	K R IY EY SH AH N IH Z AH M
CREATIONISMS	K R IY EY SH AH N IH Z AH M Z
CREATIONIST	K R IY EY SH AH N IH S T
CREATIONISTS	K R IY EY SH AH N IH S T S
CREATIONS	K R IY EY SH AH N Z
CREATIVE	K R IY EY T IH V
CREATIVELY	K R IY EY T IH V L IY
CREATIVENESS	K R IY EY T IH V N AH S
CREATIVENESSES	K R IY EY T IH V N AH S IH Z
CREATIVITIES	K R IY EY T IH V AH T IY Z
CREATIVITY	K R IY EY T IH V AH T IY
CREATOR	K R IY EY T ER
CREATORS	K R IY EY T ER Z
CREATURAL	K R IY CH ER AH L
CREATURE	K R IY CH ER
CREATUREHOOD	K R IY CH ER HH UH D
CREATUREHOODS	K R IY CH ER HH UH D Z
CREATURELINESS	K R IY CH ER L IY N AH S
CREATURELINESSES	K R IY CH ER L IY N AH S IH Z
CREATURELY	K R IY CH ER L IY
CREATURES	K R IY CH ER Z
CRECHE	K R EH SH
CRECHES	K R EH SH AH Z
CREDAL	K R EH D AH L
CREDENCE	K R IY D AH N S
CREDENCES	K R EH D AH N S IH Z
CREDENDA	K R AH D EH N D AH
CREDENDUM	K R AH D EH N D AH M
CREDENT	K R EH D AH N T
CREDENTIAL	K R IH D EH N SH AH L
CREDENTIAL(2)	K R AH D EH N SH AH L
CREDENTIALED	K R AH D EH N SH AH L D
CREDENTIALING	K R IH D EH N CH AH L IH NG
CREDENTIALISM	K R IH D EH N CH AH L IH Z AH M
CREDENTIALISMS	K R IH D EH N CH AH L IH Z AH M Z
CREDENTIALLED	K R IH D EH N CH AH L D
CREDENTIALLING	K R IH D EH N CH AH L IH NG
CREDENTIALS	K R AH D EH N SH AH L Z
CREDENZA	K R AH D EH N Z AH
CREDENZAS	K R AH D EH N Z AH Z
CREDIBILITIES	K R EH D AH B IH L AH T IY Z
CREDIBILITY	K R EH D AH B IH L IH T IY
CREDIBLE	K R EH D AH B AH L
CREDIBLY	K R EH D AH B L IY
CREDIT	K R EH D AH T
CREDIT(2)	K R EH D IH T
CREDITABILITIES	K R EH D AH T AH B IH L AH T EH Z
CREDITABILITY	K R EH D AH T AH B IH L AH T EH
CREDITABLE	K R EH D AH T AH B AH L
CREDITABLENESS	K R EH D AH T AH B AH L N AH S
CREDITABLENESSES	K R EH D AH T AH B AH L N AH S IH Z
CREDITABLY	K R EH D AH T AH B L IY
CREDITED	K R EH D AH T AH D
CREDITED(2)	K R EH D IH T IH D
CREDITING	K R EH D AH T IH NG
CREDITOR	K R EH D AH T ER
CREDITOR(2)	K R EH D IH T ER
CREDITORS	K R EH D IH T ER Z
CREDITS	K R EH D IH T S
CREDITWORTHINESS	K R EH D IH T W ER DH IY N AH S
CREDITWORTHINESSES	K R EH D AH T W ER DH IY N AH S IH Z
CREDITWORTHY	K R EH D IH T W ER DH IY
CREDO	K R EY D OW
CREDO(2)	K R IY D OW
CREDOS	K R EY D OW Z
CREDULITIES	K R IH D UW L AH T IY Z
CREDULITY	K R IH D UW L AH T IY
CREDULOUS	K R EH JH AH L AH S
CREDULOUSLY	K R EH JH AH L AH S L IY
CREDULOUSNESS	K R EH JH AH L AH S N AH S
CREDULOUSNESSES	K R EH JH AH L AH S N AH S IH Z
CREED	K R IY D
CREEDAL	K R IY D AH L
CREEDS	K R IY D Z
CREEK	K R IY K
CREEKS	K R IY K S
CREEL	K R IY L
CREELED	K R IY L D
CREELING	K R IY L AH NG
CREELS	K R IY L Z
CREEP	K R IY P
CREEPAGE	K R IY P IH JH
CREEPAGES	K R IY P IH JH IH Z
CREEPER	K R IY P ER
CREEPERS	K R IY P ER Z
CREEPIE	K R IY P IY
CREEPIER	K R IY P IY ER
CREEPIES	K R IY P IY Z
CREEPIEST	K R IY P IY AH S T
CREEPILY	K R IY P IY L IY
CREEPINESS	K R IY P IY N IH S
CREEPINESSES	K R IY P IY N AH S IH Z
CREEPING	K R IY P IH NG
CREEPS	K R IY P S
CREEPY	K R IY P IY
CREESE	K R IY Z
CREESES	K R IY Z AH Z
CREESH	K R IY SH
CREESHED	K R IY SH T
CREESHES	K R IY SH AH Z
CREESHING	K R IY SH AH NG
CREMAINS	K R AH M EY N Z
CREMATE	K R IY M EY T
CREMATED	K R IY M EY T IH D
CREMATES	K R IY M EY T S
CREMATING	K R IY M EY T IH NG
CREMATION	K R IY M EY SH AH N
CREMATIONS	K R IY M EY SH AH N Z
CREMATOR	K R IY M EY T ER
CREMATORIA	K R IY M AH T AO R IY AH
CREMATORIES	K R IY M EY T ER IY Z
CREMATORIUM	K R IY M AH T AO R IY AH M
CREMATORIUMS	K R EH M AH T AO R IY AH M Z
CREMATORS	K R IY M EY T ER Z
CREMATORY	K R IY M EY T ER IY
CREME	K R IY M
CREMES	K R IY M Z
CRENATE	K R IY N EY T
CRENATED	K R IY N EY T AH D
CRENATION	K R IY N EY SH AH N
CRENATIONS	K R AH N EY T IY AH N Z
CRENEL	K R EH N AH L
CRENELATED	K R EH N AH L EY T AH D
CRENELATION	K R EH N AH L EY SH AH N
CRENELATIONS	K R EH N AH L EY T IY AH N Z
CRENELED	K R AH N IY L D
CRENELING	K R AH N IY L AH NG
CRENELLATED	K R EH N AH L EY T AH D
CRENELLATION	K R EH N AH L EY SH AH N
CRENELLATIONS	K R EH N AH L EY T IY AH N Z
CRENELLE	K R EH N AH L
CRENELLED	K R EH N AH L D
CRENELLES	K R EH N AH L Z
CRENELLING	K R AH N EH L AH NG
CRENELS	K R EH N AH L Z
CRENULATE	K R IY N Y AH L EY T
CRENULATED	K R IY N Y AH L EY T AH D
CRENULATION	K R IY N Y AH L EY SH AH N
CRENULATIONS	K R EH N Y AH L EY T IY AH N Z
CREODONT	K R IY AH D AH N T
CREODONTA	K R IY AH D AA N T AH
CREODONTS	K R IY AH D AH N T S
CREOLE	K R IY OW L
CREOLES	K R IY OW L Z
CREOLISE	K R IY AH L AY Z
CREOLISED	K R IY OW L IY Z D
CREOLISES	K R IY OW L IY Z IH Z
CREOLISING	K R IY OW L IY Z IH NG
CREOLIZATION	K R IY OW L AH Z EY SH AH N
CREOLIZATIONS	K R IY OW L AH Z EY SH AH N Z
CREOLIZE	K R IY OW L AY Z
CREOLIZED	K R IY OW L AY Z D
CREOLIZES	K R IY OW L AY Z IH Z
CREOLIZING	K R IY OW L AY Z IH NG
CREOSOL	K R IY AH S AH L
CREOSOLS	K R IY AH S AH L Z
CREOSOTE	K R IY AH S OW T
CREOSOTED	K R IY AH S OW T AH D
CREOSOTES	K R IY AH S OW T S
CREOSOTING	K R IY AH S OW T AH NG
CREPE	K R EY P
CREPED	K R EY P T
CREPES	K R EY P S
CREPEY	K R EY P IY
CREPIER	K R EY P IY ER
CREPIEST	K R EY P IY AH S T
CREPING	K R EY P IH NG
CREPITANT	K R EH P AH T AH N T
CREPITATE	K R EH P AH T EY T
CREPITATED	K R EH P AH T EY T AH D
CREPITATES	K R EH P AH T EY T S
CREPITATING	K R EH P AH T EY T AH NG
CREPITATION	K R EH P AH T EY SH AH N
CREPITATIONS	K R EH P AH T EY T IY AH N Z
CREPON	K R EH P AH N
CREPONS	K R EH P AH N Z
CREPT	K R EH P T
CREPUSCLE	K R EH P AH S AH L
CREPUSCLES	K R EH P AH S AH L Z
CREPUSCULAR	K R AH P AH S Y AH L AH R
CREPUSCULE	K R EH P AH S Y UW L
CREPUSCULES	K R EH P AH S Y UW L Z
CREPY	K R EY P IY
CRESCENDI	K R EH S EH N D IY
CRESCENDO	K R IH SH EH N D OW
CRESCENDOED	K R IH SH EH N D OW D
CRESCENDOES	K R IH SH EH N D OW Z
CRESCENDOING	K R IH SH EH N D OW IH NG
CRESCENDOS	K R IH SH EH N D OW Z
CRESCENT	K R EH S AH N T
CRESCENTIC	K R EH S AH N T IH K
CRESCENTS	K R EH S AH N T S
CRESCIVE	K R EH S IH V
CRESCIVELY	K R EH S IH V L IY
CRESOL	K R EH S AH L
CRESOLS	K R EH S AH L Z
CRESS	K R EH S
CRESSES	K R EH S AH Z
CRESSES(2)	K R EH S IH Z
CRESSET	K R EH S AH T
CRESSETS	K R EH S AH T S
CREST	K R EH S T
CRESTAL	K R EH S T AH L
CRESTED	K R EH S T IH D
CRESTFALLEN	K R EH S T F AO L AH N
CRESTFALLENLY	K R EH S T F AE L AH N L IY
CRESTFALLENNESS	K R EH S T F AE L AH N AH S
CRESTFALLENNESSES	K R EH S T F AE L AH N AH S IH Z
CRESTING	K R EH S T IH NG
CRESTINGS	K R EH S T IH NG Z
CRESTLESS	K R EH S T L AH S
CRESTS	K R EH S T S
CRESYL	K R EH S AH L
CRESYLIC	K R EH S AH L AH K
CRESYLS	K R EH S AH L Z
CRETIC	K R IY T AH K
CRETICS	K R IY T AH S Z
CRETIN	K R IY T AH N
CRETINISM	K R EH T AH N IH Z AH M
CRETINISMS	K R EH T AH N AH Z AH M Z
CRETINOUS	K R EH T AH N AH S
CRETINS	K R EH T AH N Z
CRETONNE	K R EH T AH N
CRETONNES	K R EH T AH N Z
CREVALLE	K R EH V AH L
CREVALLES	K R EH V AH L Z
CREVASSE	K R AH V AE S
CREVASSED	K R EH V AH S T
CREVASSES	K R AH V AE S AH Z
CREVASSING	K R AH V AE S AH NG
CREVICE	K R EH V AH S
CREVICED	K R EH V AH S T
CREVICES	K R EH V AH S IH Z
CREW	K R UW
CREWCUT	K R UW K AH T
CREWCUTS	K R UW K AH T S
CREWED	K R UW D
CREWEL	K R UW AH L
CREWELS	K R UW AH L Z
CREWELWORK	K R UW AH L W ER K
CREWELWORKS	K R UW AH L W ER K S
CREWING	K R UW IH NG
CREWLESS	K R UW L AH S
CREWMAN	K R UW M AH N
CREWMATE	K R UW M EY T
CREWMATES	K R UW M EY T S
CREWMEN	K R UW M IH N
CREWNECK	K R UW N EH K
CREWNECKS	K R UW N EH K S
CREWS	K R UW Z
CRIB	K R IH B
CRIBBAGE	K R IH B AH JH
CRIBBAGES	K R IH B IH JH IH Z
CRIBBED	K R IH B D
CRIBBER	K R IH B ER
CRIBBERS	K R IH B ER Z
CRIBBING	K R IH B IH NG
CRIBBINGS	K R IH B IH NG Z
CRIBBLED	K R IH B L EH D
CRIBRIFORM	K R IH B R AH F AH R M
CRIBROUS	K R IH B R AH S
CRIBS	K R IH B Z
CRIBWORK	K R IH B W ER K
CRIBWORKS	K R IH B W ER K S
CRICETID	K R IH S AH T AH D
CRICETIDS	K R IH S AH T AH D Z
CRICK	K R IH K
CRICKED	K R IH K T
CRICKET	K R IH K IH T
CRICKETED	K R IH K AH T IH D
CRICKETER	K R IH K AH T ER
CRICKETERS	K R IH K AH T ER Z
CRICKETING	K R IH K AH T IH NG
CRICKETS	K R IH K IH T S
CRICKEY	K R IH K IY
CRICKING	K R IH K AH NG
CRICKS	K R IH K S
CRICOID	K R AY K OY D
CRICOIDS	K R AH K OY D Z
CRIED	K R AY D
CRIER	K R AY ER
CRIERS	K R AY ER Z
CRIES	K R AY Z
CRIKEY	K R IH K IY
CRIME	K R AY M
CRIMELESS	K R AY M L AH S
CRIMES	K R AY M Z
CRIMINAL	K R IH M AH N AH L
CRIMINALISTICS	K R IH M AH N AH L IH S T IH K S
CRIMINALITIES	K R IH M AH N AE L AH T IY Z
CRIMINALITY	K R IH M AH N AE L IH T IY
CRIMINALIZATION	K R IH M AH N AH L AH Z EY SH AH N
CRIMINALIZATIONS	K R IH M AH N AH L AH Z EY SH AH N Z
CRIMINALIZE	K R IH M AH N AH L AY Z
CRIMINALIZED	K R IH M AH N AH L AY Z D
CRIMINALIZES	K R IH M AH N AH L AY Z IH Z
CRIMINALIZING	K R IH M AH N AH L AY Z IH NG
CRIMINALLY	K R IH M AH N AH L IY
CRIMINALS	K R IH M AH N AH L Z
CRIMINATE	K R IH M AH N AH T
CRIMINATED	K R IH M AH N EY T IH D
CRIMINATES	K R IH M AH N AH T S
CRIMINATING	K R IH M AH N EY T IH NG
CRIMINATION	K R IH M AH N EY SH AH N
CRIMINATIONS	K R IH M AH N EY SH AH N Z
CRIMINOLOGICAL	K R IH M AH N AA L AH JH IH S AH L
CRIMINOLOGICALLY	K R IH M AH N AH L AA JH AH K AE L IY
CRIMINOLOGIES	K R IH M AH N AA L AH JH IY Z
CRIMINOLOGIST	K R IH M IH N AA L AH JH IH S T
CRIMINOLOGISTS	K R IH M IH N AA L AH JH IH S T S
CRIMINOLOGY	K R IH M IH N AA L AH JH IY
CRIMINOUS	K R IH M AH N AH S
CRIMMER	K R IH M AH R
CRIMMERS	K R IH M AH R Z
CRIMP	K R IH M P
CRIMPED	K R IH M P T
CRIMPER	K R IH M P AH R
CRIMPERS	K R IH M P AH R Z
CRIMPIER	K R IH M P AY AH R
CRIMPIEST	K R IH M P AY AH S T
CRIMPING	K R IH M P IH NG
CRIMPLE	K R IH M P AH L
CRIMPLED	K R IH M P AH L D
CRIMPLES	K R IH M P AH L Z
CRIMPLING	K R IH M P L AH NG
CRIMPS	K R IH M P S
CRIMPY	K R IH M P IY
CRIMSON	K R IH M Z AH N
CRIMSONED	K R IH M Z AH N D
CRIMSONING	K R IH M Z AH N IH NG
CRIMSONS	K R IH M Z AH N Z
CRINGE	K R IH N JH
CRINGED	K R IH N JH D
CRINGER	K R IH N JH ER
CRINGERS	K R IH N JH ER Z
CRINGES	K R IH N JH IH Z
CRINGING	K R IH N JH IH NG
CRINGLE	K R IH N G AH L
CRINGLES	K R IH N G AH L Z
CRINITE	K R AH N AY T
CRINITES	K R AH N AY T S
CRINKLE	K R IH NG K AH L
CRINKLED	K R IH NG K AH L D
CRINKLES	K R IH NG K AH L Z
CRINKLIER	K R IH NG K AH L IY ER
CRINKLIEST	K R IH NG K AH L IY AH S T
CRINKLING	K R IH NG K AH L IH NG
CRINKLY	K R IH NG K AH L IY
CRINOID	K R AY N OY D
CRINOIDS	K R AH N OY D Z
CRINOLINE	K R IH N AH L AY N
CRINOLINED	K R IH N AH L AY N D
CRINOLINES	K R IH N AH L AY N Z
CRINUM	K R IH N AH M
CRINUMS	K R IH N AH M Z
CRIOLLO	K R AY AA L OW
CRIOLLOS	K R AY AA L AH Z
CRIPE	K R AY P
CRIPES	K R AY P S
CRIPPLE	K R IH P AH L
CRIPPLED	K R IH P AH L D
CRIPPLER	K R IH P AH L ER
CRIPPLERS	K R IH P AH L ER Z
CRIPPLES	K R IH P AH L Z
CRIPPLING	K R IH P AH L IH NG
CRIPPLING(2)	K R IH P L IH NG
CRIPPLINGLY	K R IH P AH L IH NG L IY
CRIS	K R IH S
CRISES	K R AY S IY Z
CRISIC	K R AY Z IH K
CRISIS	K R AY S AH S
CRISP	K R IH S P
CRISPATE	K R IH S P AH T
CRISPBREAD	K R IH S P B R EH D
CRISPBREADS	K R IH S P B R EH D Z
CRISPED	K R IH S P T
CRISPEN	K R IH S P AH N
CRISPENED	K R IH S P AH N D
CRISPENING	K R IH S P AH N IH NG
CRISPENS	K R IH S P AH N Z
CRISPER	K R IH S P ER
CRISPERS	K R IH S P ER Z
CRISPEST	K R IH S P AH S T
CRISPIER	K R IH S P IY ER
CRISPIEST	K R IH S P IY AH S T
CRISPILY	K R IH S P IY L IY
CRISPINESS	K R IH S P IY N AH S
CRISPINESSES	K R IH S P IY N AH S IH Z
CRISPING	K R IH S P IH NG
CRISPLY	K R IH S P L IY
CRISPNESS	K R IH S P N AH S
CRISPNESSES	K R IH S P N AH S IH Z
CRISPS	K R IH S P S
CRISPY	K R IH S P IY
CRISSA	K R IH S AH
CRISSAL	K R AY Z AH L
CRISSCROSS	K R IH S K R AO S
CRISSCROSSED	K R IH S K R AO S T
CRISSCROSSES	K R IH S K R AO S IH Z
CRISSCROSSING	K R IH S K R AO S IH NG
CRISSUM	K R AY Z S AH M
CRISTA	K R IH S T AH
CRISTAE	K R IH S T IY
CRISTATE	K R IH S T EY T
CRITERIA	K R AY T IH R IY AH
CRITERION	K R AY T IH R IY AH N
CRITERIONS	K R AY T IH R IY AH N Z
CRITERIUM	K R AH T IY R IY AH M
CRITERIUMS	K R AH T IY R IY AH M Z
CRITIC	K R IH T IH K
CRITICAL	K R IH T IH K AH L
CRITICALITIES	K R IH T AH K AE L AH T IY Z
CRITICALITY	K R IH T AH K AE L AH T IY
CRITICALLY	K R IH T IH K AH L IY
CRITICALLY(2)	K R IH T IH K L IY
CRITICALNESS	K R IH T IH K AH L N AH S
CRITICALNESSES	K R IH T IH K AH L N AH S IH Z
CRITICASTER	K R IH T IH K AE S T ER
CRITICASTERS	K R IH T IH K AE S T ER Z
CRITICISE	K R IH T AH S AY Z
CRITICISED	K R IH T IH K IY Z D
CRITICISES	K R IH T IH K IY Z IH Z
CRITICISING	K R IH T IH K IY Z IH NG
CRITICISM	K R IH T IH S IH Z AH M
CRITICISMS	K R IH T IH S IH Z AH M Z
CRITICIZABLE	K R IH T AH S AY Z AH B AH L
CRITICIZE	K R IH T IH S AY Z
CRITICIZED	K R IH T AH S AY Z D
CRITICIZER	K R IH T AH S AY Z ER
CRITICIZERS	K R IH T AH S AY Z ER Z
CRITICIZES	K R IH T IH S AY Z IH Z
CRITICIZING	K R IH T IH S AY Z IH NG
CRITICS	K R IH T IH K S
CRITIQUE	K R AH T IY K
CRITIQUE(2)	K R IH T IY K
CRITIQUED	K R IH T IY K T
CRITIQUES	K R IH T IY K S
CRITIQUING	K R IH T IY K IH NG
CRITTER	K R IH T ER
CRITTERS	K R IH T ER Z
CRITTUR	K R IH T AH R
CRITTURS	K R IH T Y AH R Z
CROAK	K R OW K
CROAKED	K R OW K T
CROAKER	K R OW K ER
CROAKERS	K R OW K ER Z
CROAKIER	K R OW K IY ER
CROAKIEST	K R OW K IY AH S T
CROAKILY	K R OW K IY L IY
CROAKING	K R OW K IH NG
CROAKS	K R OW K S
CROAKY	K R OW K IY
CROC	K R AA K
CROCEIN	K R OW S IY N
CROCEINE	K R OW S IY N
CROCEINES	K R OW S IY N Z
CROCEINS	K R OW S IY N Z
CROCHET	K R OW SH EY
CROCHETED	K R OW SH EY D
CROCHETER	K R OW SH EY ER
CROCHETERS	K R OW SH EY ER Z
CROCHETING	K R OW SH EY IH NG
CROCHETS	K R OW SH EY Z
CROCI	K R AA S IY
CROCIDOLITE	K R AH S IH D AH L AY T
CROCIDOLITES	K R AH S IH D AH L AY T S
CROCINE	K R AH S AY N
CROCK	K R AA K
CROCKED	K R AA K T
CROCKERIES	K R AA K AH R IY Z
CROCKERY	K R AA K ER IY
CROCKET	K R AA K AH T
CROCKETED	K R AA K AH T IH D
CROCKETS	K R AA K AH T S
CROCKING	K R AA K IH NG
CROCKS	K R AA K S
CROCODILE	K R AA K AH D AY L
CROCODILES	K R AA K AH D AY L Z
CROCODILIAN	K R AA K AH D IH L Y AH N
CROCODILIANS	K R AA K AH D IH L IY AH N Z
CROCOITE	K R AH K OY T
CROCOITES	K R AH K OY T S
CROCS	K R AA K S
CROCUS	K R OW K AH S
CROCUSES	K R OW K Y UW S IH Z
CROFT	K R AO F T
CROFTER	K R AO F T ER
CROFTERS	K R AO F T ER Z
CROFTS	K R AO F T S
CROISSANT	K W AA S AA N T
CROISSANT(2)	K R AH S AA N T
CROISSANTS	K W AA S AA N T S
CROISSANTS(2)	K R AH S AA N T S
CROJIK	K R AA JH AH K
CROJIKS	K R AA JH AH K S
CROMLECH	K R AA M L AH CH
CROMLECHS	K R AA M L AH CH S
CRONE	K R OW N
CRONES	K R OW N Z
CRONIES	K R OW N IY Z
CRONY	K R OW N IY
CRONYISM	K R OW N IY IH Z AH M
CRONYISMS	K R OW N IY IH Z AH M Z
CROOK	K R UH K
CROOKBACK	K R UH K B AE K
CROOKBACKED	K R UH K B AE K T
CROOKBACKS	K R UH K B AE K S
CROOKED	K R UH K AH D
CROOKEDER	K R UH K AH D ER
CROOKEDEST	K R UH K AH D AH S T
CROOKEDLY	K R UH K AH D L IY
CROOKEDNESS	K R UH K AH D N AH S
CROOKEDNESSES	K R UH K AH D N AH S IH Z
CROOKERIES	K R UH K AH R IY Z
CROOKERY	K R UH K AH R IY
CROOKING	K R UH K IH NG
CROOKNECK	K R UH K N EH K
CROOKNECKS	K R UH K N EH K S
CROOKS	K R UH K S
CROON	K R UW N
CROONED	K R UW N D
CROONER	K R UW N ER
CROONERS	K R UW N ER Z
CROONING	K R UW N IH NG
CROONS	K R UW N Z
CROP	K R AA P
CROPLAND	K R AA P L AE N D
CROPLANDS	K R AA P L AE N D Z
CROPLESS	K R AA P L AH S
CROPPED	K R AA P T
CROPPER	K R AA P ER
CROPPERS	K R AA P ER Z
CROPPIE	K R AA P IY
CROPPIES	K R AA P IY Z
CROPPING	K R AA P IH NG
CROPS	K R AA P S
CROQUET	K R OW K EY
CROQUETED	K R AH K IY T AH D
CROQUETING	K R AH K IY T AH NG
CROQUETS	K R AA K AH T S
CROQUETTE	K R AA K W EH T
CROQUETTES	K R AA K W EH T S
CROQUIGNOLE	K R AA K W AH G N OW L
CROQUIGNOLES	K R AA K W AH G N OW L Z
CROQUIS	K R AA K W AH S
CRORE	K R AO R
CRORES	K R AO R Z
CROSIER	K R AA S AY AH R
CROSIERS	K R OW S IY R Z
CROSS	K R AO S
CROSSABILITIES	K R AO S AH B IH L AH T EH Z
CROSSABILITY	K R AO S AH B IH L AH T EH
CROSSABLE	K R AO S AH B AH L
CROSSARM	K R AO S AA R M
CROSSARMS	K R AO S AA R M Z
CROSSBANDED	K R AO S B AE N D IH D
CROSSBANDING	K R AO S B AE N D IH NG
CROSSBANDINGS	K R AO S B AE N D IH NG Z
CROSSBAR	K R AO S B AA R
CROSSBARRED	K R AO S B AA R D
CROSSBARRING	K R AO S B AA R IH NG
CROSSBARS	K R AO S B AA R Z
CROSSBEAM	K R AO S B IY M
CROSSBEAMS	K R AO S B IY M Z
CROSSBEARER	K R AO S B AE ER ER
CROSSBEARERS	K R AO S B AE ER ER Z
CROSSBILL	K R AO S B IH L
CROSSBILLS	K R AO S B IH L Z
CROSSBONES	K R AO S B OW N Z
CROSSBOW	K R AO S B OW
CROSSBOWMAN	K R AO S B OW M AH N
CROSSBOWMEN	K R AO S B AW M EH N
CROSSBOWS	K R AO S B OW Z
CROSSBRED	K R AO S B R EH D
CROSSBREDS	K R AO S B R EH D Z
CROSSBREED	K R AO S B R IY D
CROSSBREEDING	K R AO S B R IY D IH NG
CROSSBREEDS	K R AO S B R IY D Z
CROSSCHECK	K R AO S CH EH K
CROSSCHECKED	K R AO S CH EH K T
CROSSCHECKING	K R AO S CH EH K IH NG
CROSSCHECKS	K R AO S CH EH K S
CROSSCOURT	K R AO S K OW R T
CROSSCURRENT	K R AO S K ER AH N T
CROSSCURRENTS	K R AO S K ER AH N T S
CROSSCUT	K R AO S K AH T
CROSSCUTS	K R AO S K AH T S
CROSSCUTTING	K R AO S K AH T IH NG
CROSSCUTTINGS	K R AO S K AH T IH NG Z
CROSSE	K R AA S
CROSSED	K R AO S T
CROSSER	K R AO S ER
CROSSERS	K R AO S ER Z
CROSSES	K R AO S IH Z
CROSSEST	K R AO S AH S T
CROSSFIRE	K R AO S F AY R
CROSSFIRES	K R AO S F AY ER Z
CROSSHAIR	K R AO S HH EH R
CROSSHAIRS	K R AO S HH EH R Z
CROSSHATCH	K R AO S HH AE CH
CROSSHATCHED	K R AO S HH AE CH T
CROSSHATCHES	K R AO S HH AE CH IH Z
CROSSHATCHING	K R AO S HH AE CH IH NG
CROSSHEAD	K R AO S HH EH D
CROSSHEADS	K R AO S HH EH D Z
CROSSING	K R AO S IH NG
CROSSINGS	K R AO S IH NG Z
CROSSLET	K R AO S L AH T
CROSSLETS	K R AO S L AH T S
CROSSLINGUISTIC	K R AO S L IH NG G W IH S T IH K
CROSSLINGUISTICALLY	K R AO S L IH NG G W IH S T IH K AH L IY
CROSSLY	K R AO S L IY
CROSSNESS	K R AO S N AH S
CROSSNESSES	K R AO S N AH S IH Z
CROSSOPTERYGIAN	K R AA S AA P T EH R AH JH AH N
CROSSOPTERYGIANS	K R AA S AA P T AH R IH JH IY AH N Z
CROSSOVER	K R AO S OW V ER
CROSSOVERS	K R AO S OW V ER Z
CROSSPATCH	K R AO S P AE CH
CROSSPATCHES	K R AO S P AE CH IH Z
CROSSPIECE	K R AO S P IY S
CROSSPIECES	K R AO S P IY S AH Z
CROSSPIECES(2)	K R AO S P IY S IH Z
CROSSROAD	K R AO S R OW D
CROSSROADS	K R AO S R OW D Z
CROSSRUFF	K R AA S R AH F
CROSSRUFFED	K R AA S R AH F T
CROSSRUFFING	K R AA S R AH F AH NG
CROSSRUFFS	K R AA S R AH F S
CROSSTALK	K R AO S T AO K
CROSSTALKS	K R AO S T AO K S
CROSSTIE	K R AO S T AY
CROSSTIES	K R AO S T AY Z
CROSSTOWN	K R AO S T AW N
CROSSTREES	K R AO S T R IY Z
CROSSWALK	K R AA S W AA K
CROSSWALKS	K R AA S W AA K S
CROSSWAY	K R AO S W EY
CROSSWAYS	K R AO S W EY Z
CROSSWIND	K R AO S W IH N D
CROSSWINDS	K R AO S W IH N D Z
CROSSWISE	K R AO S W AY Z
CROSSWORD	K R AO S W ER D
CROSSWORDS	K R AO S W ER D Z
CROTCH	K R AA CH
CROTCHED	K R AA CH T
CROTCHES	K R AA CH AH Z
CROTCHET	K R AA CH AH T
CROTCHETINESS	K R AA CH AH T IY N AH S
CROTCHETINESSES	K R AA CH AH T IY N AH S IH Z
CROTCHETS	K R AA CH AH T S
CROTCHETY	K R AA CH AH T IY
CROTON	K R AA T AH N
CROTONS	K R AA T AH N Z
CROUCH	K R AW CH
CROUCHED	K R AW CH T
CROUCHES	K R AW CH IH Z
CROUCHING	K R AW CH IH NG
CROUP	K R UW P
CROUPE	K R UW P
CROUPES	K R UW P S
CROUPIER	K R UW P IY EY
CROUPIERS	K R UW P IY EY Z
CROUPIEST	K R UW P AY AH S T
CROUPILY	K R UW P AH L IY
CROUPOUS	K R UW P AH S
CROUPS	K R UW P S
CROUPY	K R UW P IY
CROUSE	K R AW S
CROUSELY	K R AW Z L IY
CROUSTADE	K R AW S T EY D
CROUSTADES	K R AW S T EY D Z
CROUTON	K R AW T AH N
CROUTONS	K R AW T AH N Z
CROW	K R OW
CROWBAR	K R OW B AA R
CROWBARRED	K R OW B AA R D
CROWBARRING	K R OW B AA R IH NG
CROWBARS	K R OW B AA R Z
CROWBERRIES	K R OW B EH R IY Z
CROWBERRY	K R OW B EH R IY
CROWD	K R AW D
CROWDED	K R AW D AH D
CROWDED(2)	K R AW D IH D
CROWDEDNESS	K R AW D AH D N AH S
CROWDEDNESSES	K R AW D AH D N AH S IH Z
CROWDER	K R AW D ER
CROWDERS	K R AW D ER Z
CROWDIE	K R AW D IY
CROWDIES	K R AW D IY Z
CROWDING	K R AW D IH NG
CROWDS	K R AW D Z
CROWDY	K R AW D IY
CROWED	K R OW D
CROWER	K R OW ER
CROWERS	K R OW ER Z
CROWFEET	K R OW F IY T
CROWFOOT	K R OW F UH T
CROWFOOTS	K R OW F UH T S
CROWING	K R OW IH NG
CROWKEEPER	K R OW K IY P ER
CROWKEEPERS	K R OW K IY P ER Z
CROWN	K R AW N
CROWNED	K R AW N D
CROWNER	K R AW N ER
CROWNERS	K R AW N ER Z
CROWNET	K R OW N EH T
CROWNETS	K R OW N EH T S
CROWNING	K R AW N IH NG
CROWNLESS	K R AW N L AH S
CROWNS	K R AW N Z
CROWS	K R OW Z
CROWSTEP	K R OW S T EH P
CROWSTEPPED	K R OW S T EH P T
CROWSTEPS	K R OW S T EH P S
CROZE	K R OW Z
CROZER	K R OW Z AH R
CROZERS	K R AA Z AH R Z
CROZES	K R OW Z AH Z
CROZIER	K R OW ZH ER
CROZIERS	K R OW ZH ER Z
CRUCES	K R UW S IY Z
CRUCIAL	K R UW SH AH L
CRUCIALLY	K R UW SH AH L IY
CRUCIAN	K R UW SH AH N
CRUCIANS	K R UW S IY AH N Z
CRUCIATE	K R UW S AY EY T
CRUCIBLE	K R UW S AH B AH L
CRUCIBLES	K R UW S AH B AH L Z
CRUCIFER	K R UW S AY F AH R
CRUCIFEROUS	K R UW S IH F AH R AH S
CRUCIFERS	K R UW S AH F AH R Z
CRUCIFIED	K R UW S AH F AY D
CRUCIFIES	K R UW S AH F AY Z
CRUCIFIX	K R UW S AH F IH K S
CRUCIFIXES	K R UW S AH F IH K S IH Z
CRUCIFIXION	K R UW S IH F IH K SH AH N
CRUCIFIXIONS	K R UW S AH F IH K SH AH N Z
CRUCIFORM	K R UW S AH F AH R M
CRUCIFORMS	K R UW S AH F AH R M Z
CRUCIFY	K R UW S AH F AY
CRUCIFYING	K R UW S AH F AY IH NG
CRUCIVERBALIST	K R UW S AH V AH R B AH L AH S T
CRUCIVERBALISTS	K R UW S AH V AH R B AH L AH S T S
CRUCK	K R AH K
CRUCKS	K R AH K S
CRUD	K R AH D
CRUDDED	K R AH D AH D
CRUDDIER	K R AH D AY AH R
CRUDDIEST	K R AH D AY AH S T
CRUDDING	K R AH D AH NG
CRUDDY	K R AH D IY
CRUDE	K R UW D
CRUDELY	K R UW D L IY
CRUDENESS	K R UW D N AH S
CRUDENESSES	K R UW D N AH S IH Z
CRUDER	K R UW D ER
CRUDES	K R UW D Z
CRUDEST	K R UW D AH S T
CRUDITES	K R UW D AY T S
CRUDITIES	K R UW D AH T IY Z
CRUDITY	K R UW D AH T IY
CRUDS	K R AH D Z
CRUEL	K R UW AH L
CRUEL(2)	K R UW L
CRUELER	K R UW AH L ER
CRUELEST	K R UW L AH S T
CRUELLER	K R UW AH L ER
CRUELLEST	K R UW AH L AH S T
CRUELLY	K R UW L IY
CRUELNESS	K R UW AH L N AH S
CRUELNESSES	K R UW AH L N AH S IH Z
CRUELTIES	K R UW L T IY Z
CRUELTIES(2)	K R UW AH L T IY Z
CRUELTY	K R UW L T IY
CRUELTY(2)	K R UW AH L T IY
CRUET	K R UW AH T
CRUETS	K R UW AH T S
CRUISE	K R UW Z
CRUISED	K R UW Z D
CRUISER	K R UW Z ER
CRUISERS	K R UW Z ER Z
CRUISERWEIGHT	K R UW Z ER W EY T
CRUISERWEIGHTS	K R UW Z ER W EY T S
CRUISES	K R UW Z IH Z
CRUISING	K R UW Z IH NG
CRUISINGS	K R UW Z IH NG Z
CRULLER	K R AH L AH R
CRULLERS	K R AH L AH R Z
CRUMB	K R AH M
CRUMBED	K R AH M D
CRUMBER	K R AH M ER
CRUMBERS	K R AH M ER Z
CRUMBIER	K R AH M IY ER
CRUMBIEST	K R AH M IY AH S T
CRUMBING	K R AH M IH NG
CRUMBLE	K R AH M B AH L
CRUMBLED	K R AH M B AH L D
CRUMBLES	K R AH M B AH L Z
CRUMBLIER	K R AH M B L IY ER
CRUMBLIEST	K R AH M B L IY AH S T
CRUMBLINESS	K R AH M B L IY N AH S
CRUMBLINESSES	K R AH M B L IY N AH S IH Z
CRUMBLING	K R AH M B AH L IH NG
CRUMBLING(2)	K R AH M B L IH NG
CRUMBLINGS	K R AH M B L IH NG Z
CRUMBLY	K R AH M B L IY
CRUMBS	K R AH M Z
CRUMBUM	K R AH M B AH M
CRUMBUMS	K R AH M B AH M Z
CRUMBY	K R AH M B IY
CRUMHORN	K R AH M HH AH R N
CRUMHORNS	K R AH M HH AH R N Z
CRUMMIE	K R AH M AY
CRUMMIER	K R AH M IY ER
CRUMMIES	K R AH M IY Z
CRUMMIEST	K R AH M IY AH S T
CRUMMINESS	K R AH M IY N AH S
CRUMMINESSES	K R AH M IY N AH S IH Z
CRUMMY	K R AH M IY
CRUMP	K R AH M P
CRUMPED	K R AH M P T
CRUMPET	K R AH M P AH T
CRUMPETS	K R AH M P AH T S
CRUMPING	K R AH M P IH NG
CRUMPLE	K R AH M P AH L
CRUMPLED	K R AH M P AH L D
CRUMPLES	K R AH M P AH L Z
CRUMPLIER	K R AH M P L IY ER
CRUMPLIEST	K R AH M P L IY AH S T
CRUMPLING	K R AH M P L IH NG
CRUMPLY	K R AH M P L IY
CRUMPS	K R AH M P S
CRUNCH	K R AH N CH
CRUNCHABLE	K R AH N CH AH B AH L
CRUNCHED	K R AH N CH T
CRUNCHER	K R AH N CH ER
CRUNCHERS	K R AH N CH ER Z
CRUNCHES	K R AH N CH IH Z
CRUNCHIER	K R AH N CH IY ER
CRUNCHIEST	K R AH N CH IY AH S T
CRUNCHILY	K R AH N CH IY L IY
CRUNCHINESS	K R AH N CH IY N AH S
CRUNCHINESSES	K R AH N CH IY N AH S IH Z
CRUNCHING	K R AH N CH IH NG
CRUNCHY	K R AH N CH IY
CRUNODAL	K R UW N AH D AH L
CRUNODE	K R UW N OW D
CRUNODES	K R UW N OW D Z
CRUOR	K R UW W AH R
CRUORS	K R UW W AH R Z
CRUPPER	K R AH P ER
CRUPPERS	K R AH P ER Z
CRURA	K R UH R AH
CRURAL	K R UH R AH L
CRUS	K R AH Z
CRUSADE	K R UW S EY D
CRUSADED	K R UW S EY D IH D
CRUSADER	K R UW S EY D ER
CRUSADERS	K R UW S EY D ER Z
CRUSADES	K R UW S EY D Z
CRUSADING	K R UW S EY D IH NG
CRUSADO	K R UW S AH D OW
CRUSADOES	K R UW S AH D OW Z
CRUSADOS	K R UW S AH D AH Z
CRUSE	K R UW Z
CRUSES	K R UW Z AH Z
CRUSET	K R UW S AH T
CRUSETS	K R UW S AH T S
CRUSH	K R AH SH
CRUSHABLE	K R AH SH AH B AH L
CRUSHED	K R AH SH T
CRUSHER	K R AH SH ER
CRUSHERS	K R AH SH ER Z
CRUSHES	K R AH SH IH Z
CRUSHING	K R AH SH IH NG
CRUSHINGLY	K R AH SH IH NG L IY
CRUSHPROOF	K R AH SH P R UW F
CRUSILY	K R UW S AH L IY
CRUST	K R AH S T
CRUSTACEA	K R AH S T EY S IY AH
CRUSTACEAN	K R AH S T EY SH AH N
CRUSTACEANS	K R AH S T EY SH AH N Z
CRUSTACEOUS	K R AH S T EY SH AH S
CRUSTAL	K R AH S T AH L
CRUSTED	K R AH S T IH D
CRUSTIER	K R AH S T IY ER
CRUSTIEST	K R AH S T IY AH S T
CRUSTILY	K R AH S T IY L IY
CRUSTINESS	K R AH S T IY N AH S
CRUSTINESSES	K R AH S T IY N AH S IH Z
CRUSTING	K R AH S T IH NG
CRUSTLESS	K R AH S T L AH S
CRUSTOSE	K R AH S T OW Z
CRUSTS	K R AH S T S
CRUSTY	K R AH S T IY
CRUTCH	K R AH CH
CRUTCHED	K R AH CH T
CRUTCHES	K R AH CH IH Z
CRUTCHING	K R AH CH IH NG
CRUX	K R AH K S
CRUXES	K R AH K S IH Z
CRUZADO	K R UW Z AA D OW
CRUZADOES	K R UW Z AH D OW Z
CRUZADOS	K R UW Z AA D OW S
CRUZEIRO	K R UW Z IY R OW
CRUZEIROS	K R UW Z IY R AH Z
CRWTH	S IY AA R D AH B AH L Y UW T IY
CRWTHS	S IY AA R D AH B AH L Y UW T IY EY CH S
CRY	K R AY
CRYBABIES	K R AY B EY B IY Z
CRYBABY	K R AY B EY B IY
CRYING	K R AY IH NG
CRYINGLY	K R AY IH NG L IY
CRYOBIOLOGICAL	K R AY AH B IY AA L AH JH IH S AH L
CRYOBIOLOGIES	K R AY AH B IY AA L AH JH AY Z
CRYOBIOLOGIST	K R AY AH B IY AA L AH JH AH S T
CRYOBIOLOGISTS	K R AY OW B IY AA L AH JH AH S T S
CRYOBIOLOGY	K R AY AH B IY AA L AH JH IY
CRYOGEN	K R AY AH JH AH N
CRYOGENIC	K R AY AH JH EH N IH K
CRYOGENICALLY	K R AY AH JH EH N AH K AE L IY
CRYOGENICS	K R AY AH JH EH N IH K S
CRYOGENIES	K R AY AA JH AH N AY Z
CRYOGENS	K R AY AH JH AH N Z
CRYOGENY	K R AY AA JH AH N IY
CRYOLITE	K R AY AH L AY T
CRYOLITES	K R AY AH L AY T S
CRYONIC	K R AY AO N IH K
CRYONICS	K R AY AO N IH K S
CRYOPHILIC	K R AY AH F AY L AH K
CRYOPRESERVATION	K R AY AA P R EH S AH R V EY SH AH N
CRYOPRESERVATIONS	K R AY AA P R AH S AH R V EY T IY AH N Z
CRYOPRESERVE	K R AY AA P R AH S AH R V
CRYOPRESERVED	K R AY AA P R AH S AH R V D
CRYOPRESERVES	K R AY AA P R AH S AH R V Z
CRYOPRESERVING	K R AY AA P R AH S AH R V AH NG
CRYOPROBE	K R AY AH P R OW B
CRYOPROBES	K R AY AH P R OW B Z
CRYOPROTECTANT	K R AY AA P R AH T EH K T AH N T
CRYOPROTECTANTS	K R AY AA P R AH T EH K T AH N T S
CRYOPROTECTIVE	K R AY AA P R AH T EH K T AH V
CRYOSCOPE	K R AY AA S K OW P
CRYOSCOPES	K R AY AA S K OW P S
CRYOSCOPIC	K R AY AA S K OW P IH K
CRYOSCOPIES	K R AY AA S K AA P IY Z
CRYOSCOPY	K R AY AA S K AA P IY
CRYOSTAT	K R AY AH S T AE T
CRYOSTATIC	K R AY AH S T AE T IH K
CRYOSTATS	K R AY AH S T AE T S
CRYOSURGEON	K R AY AA S ER JH AO N
CRYOSURGEONS	K R AY AA S ER JH AO N Z
CRYOSURGERIES	K R AY AA S ER JH AH R IY Z
CRYOSURGERY	K R AY AA S ER JH AH R IY
CRYOSURGICAL	K R AY AA S ER JH IH K AH L
CRYOTHERAPIES	K R AY AH DH ER EY P IY Z
CRYOTHERAPY	K R AY AH DH ER EY P IY
CRYOTRON	K R AY AA T R AH N
CRYOTRONS	K R AY AA T R AH N Z
CRYPT	K R IH P T
CRYPTAL	K R IH P T AH L
CRYPTANALYSES	K R IH P T AH N AE L AH S IY Z
CRYPTANALYSIS	K R IH P T AH N AE L AH S AH S
CRYPTANALYST	K R IH P T AE N AH L AH S T
CRYPTANALYSTS	K R IH P T AE N AH L AH S T S
CRYPTANALYTIC	K R IH P T AE N AH L IH T IH K
CRYPTANALYTICAL	K R IH P T AE N AH L IH T IH K AH L
CRYPTARITHM	K R IH P T AH R AH DH AH M
CRYPTARITHMS	K R IH P T AH R AH DH AH M Z
CRYPTIC	K R IH P T IH K
CRYPTICALLY	K R IH P T IH K AH L IY
CRYPTO	K R IH P T OW
CRYPTOCOCCAL	K R IH P T AH K AA K AH L
CRYPTOCOCCI	K R IH P T AH K AA K S IY
CRYPTOCOCCOSES	K R IH P T AA K AH K OW Z AH Z
CRYPTOCOCCOSIS	K R IH P T AH K AH K OW S AH S
CRYPTOCOCCUS	K R IH P T AH K AA K AH S
CRYPTOCRYSTALLINE	K R IH P T AH K R IH S T AH L AY N
CRYPTOGAM	K R IH P T AH G AH M
CRYPTOGAMIC	K R IH P T AH G AH M AH K
CRYPTOGAMOUS	K R IH P T AA G AH M AH S
CRYPTOGAMS	K R IH P T AH G AH M Z
CRYPTOGENIC	K R IH P T AH JH AH N AH K
CRYPTOGRAM	K R IH P T AA G R AH M
CRYPTOGRAMS	K R IH P T AA G R AH M Z
CRYPTOGRAPH	K R IH P T AA G R AH F
CRYPTOGRAPHER	K R IH P T AA G R AH F AH R
CRYPTOGRAPHERS	K R IH P T AA G R AH F AH R Z
CRYPTOGRAPHIC	K R IH P T AH G R AE F IH K
CRYPTOGRAPHICALLY	K R IH P T AH G R AE F IH K AH L IY
CRYPTOGRAPHIES	K R IH P T AA G R AH F AY Z
CRYPTOGRAPHS	K R IH P T AA G R AH F S
CRYPTOGRAPHY	K R IH P T AA G R AH F IY
CRYPTOLOGIC	K R IH P T AH L AH JH AH K
CRYPTOLOGICAL	K R IH P T AA L AH JH IH S AH L
CRYPTOLOGIES	K R IH P T AA L AH JH IY Z
CRYPTOLOGIST	K R IH P T AA L AH JH AH S T
CRYPTOLOGISTS	K R IH P T AA L AH JH AH S T S
CRYPTOLOGY	K R IH P T AA L AH JH IY
CRYPTOMERIA	K R IH P T AH M IY R IY AH
CRYPTOMERIAS	K R IH P T AH M IY R IY AH Z
CRYPTONYM	K R IH P T AH N AH M
CRYPTONYMS	K R IH P T AH N AH M Z
CRYPTORCHID	K R IH P T AO R K AH D
CRYPTORCHIDISM	K R IH P T AO R K AH D IH Z AH M
CRYPTORCHIDISMS	K R IH P T AO R K AH D IH Z AH M Z
CRYPTORCHIDS	K R IH P T AO R K AH D Z
CRYPTORCHISM	K R IH P T AH R CH IH Z AH M
CRYPTORCHISMS	K R IH P T AO R CH AH Z AH M Z
CRYPTOS	K R IH P T AA S
CRYPTOZOOLOGIES	K R IH P T AH Z UW L AH JH AY Z
CRYPTOZOOLOGIST	K R IH P T AH Z UW L AH JH AH S T
CRYPTOZOOLOGISTS	K R IH P T AH Z UW L AH JH AH S T S
CRYPTOZOOLOGY	K R IH P T AH Z UW L AH JH IY
CRYPTS	K R IH P T S
CRYSTAL	K R IH S T AH L
CRYSTALIZE	K R IH S T AH L AY Z
CRYSTALIZED	K R IH S T AH L AY Z D
CRYSTALIZES	K R IH S T AH L AY Z IH Z
CRYSTALIZING	K R IH S T AH L AY Z IH NG
CRYSTALLINE	K R IH S T AH L AY N
CRYSTALLINITIES	K R IH S T AH L AH N AH T IY Z
CRYSTALLINITY	K R IH S T AH L AH N AH T IY
CRYSTALLISE	K R IH S T AH L AY Z
CRYSTALLISED	K R IH S T AH L IY Z D
CRYSTALLISES	K R IH S T AH L IY Z IH Z
CRYSTALLISING	K R IH S T AH L IY Z IH NG
CRYSTALLITE	K R IH S T AH L AY T
CRYSTALLITES	K R IH S T AH L AY T S
CRYSTALLIZABLE	K R IH S T AH L AY Z AH B AH L
CRYSTALLIZATION	K R IH S T AH L AH Z EY SH AH N
CRYSTALLIZATIONS	K R IH S T AH L AH Z EY SH AH N Z
CRYSTALLIZE	K R IH S T AH L AY Z
CRYSTALLIZED	K R IH S T AH L AY Z D
CRYSTALLIZER	K R IH S T AH L AY Z ER
CRYSTALLIZERS	K R IH S T AH L AY Z ER Z
CRYSTALLIZES	K R IH S T AH L AY Z IH Z
CRYSTALLIZING	K R IH S T AH L AY Z IH NG
CRYSTALLOGRAPHER	K R IH S T AH L AA G R AH F ER
CRYSTALLOGRAPHERS	K R IH S T AH L AA G R AH F ER Z
CRYSTALLOGRAPHIC	K R IH S T AH L OW G R AE F IH K
CRYSTALLOGRAPHICALLY	K R IH S T AH L OW G R AE F IH K AH L IY
CRYSTALLOGRAPHIES	K R IH S T AH L AA G R AH F IY Z
CRYSTALLOGRAPHY	K R IH S T AH L AA G R AH F IY
CRYSTALLOID	K R IH S T AH L OY D
CRYSTALLOIDAL	K R IH S T AH L OY D AH L
CRYSTALLOIDS	K R IH S T AH L OY D Z
CRYSTALS	K R IH S T AH L Z
CYANOACRYLATE	S AY AH N OW K R AH L EY T
CYANOACRYLATES	S AY AH N OW K R AH L EY T S
DECONSECRATE	D IY K AA N S AH K R EY T
DECONSECRATED	D IY K AA N S AH K R EY T IH D
DECONSECRATES	D IY K AA N S AH K R EY T S
DECONSECRATING	D IY K AA N S AH K R EY T IH NG
DECONSECRATION	D IY K AA N S AH K R EY SH AH N
DECONSECRATIONS	D IY K AA N S AH K R EY SH AH N Z
DECREASE	D IH K R IY S
DECREASE(2)	D IY K R IY S
DECREASED	D IH K R IY S T
DECREASED(2)	D IY K R IY S T
DECREASES	D IH K R IY S AH Z
DECREASES(2)	D IH K R IY S IH Z
DECREASES(3)	D IY K R IY S IH Z
DECREASING	D IH K R IY S IH NG
DECREASING(2)	D IY K R IY S IH NG
DECREASINGLY	D IH K R IY S IH NG L IY
DECREE	D IH K R IY
DECREED	D IH K R IY D
DECREEING	D IH K R IY IH NG
DECREER	D EH K R IH R
DECREERS	D IH K R IH R Z
DECREES	D IH K R IY Z
DECREMENT	D EH K R AH M AH N T
DECREMENTAL	D EH K R AH M AH N T AH L
DECREMENTED	D EH K R AH M AH N T IH D
DECREMENTING	D EH K R AH M AH N T IH NG
DECREMENTS	D EH K R AH M AH N T S
DECREPIT	D AH K R EH P IH T
DECREPITATE	D IH K R EH P AH T EY T
DECREPITATED	D IH K R EH P AH T EY T AH D
DECREPITATES	D IH K R EH P AH T EY T S
DECREPITATING	D IH K R EH P AH T EY T AH NG
DECREPITATION	D IH K R EH P AH T EY SH AH N
DECREPITATIONS	D IH K R EH P AH T EY T IY AH N Z
DECREPITLY	D AH K R EH P IH T L IY
DECREPITUDE	D IY K R EY P AH T UW D
DECREPITUDES	D IY K R EY P AH T UW D Z
DECRESCENDO	D IY K R IH SH EH N D OW
DECRESCENDOS	D IY K R IH SH EH N D OW Z
DECRESCENT	D IY K R EH S AH N T
DECRETAL	D IH K R IY T AH L
DECRETALS	D IH K R EH T AH L Z
DECRETIVE	D IH K R IY T AH V
DECRETORY	D IH K R AH T AO R IY
DECRIAL	D IY S R IY AH L
DECRIALS	D IY S R IY AH L Z
DECRIED	D IH K R AY D
DECRIER	D IY S R IY ER
DECRIERS	D IY S R IY ER Z
DECRIES	D IH K R AY Z
DECRIMINALIZATION	D IY K R IH M AH N AH L AH Z EY SH AH N
DECRIMINALIZATIONS	D IY K R IH M AH N AH L AH Z EY SH AH N Z
DECRIMINALIZE	D IY K R IH M AH N AH L AY Z
DECRIMINALIZED	D IY K R IH M AH N AH L AY Z D
DECRIMINALIZES	D IY K R IH M AH N AH L AY Z IH Z
DECRIMINALIZING	D IY K R IH M AH N AH L AY Z IH NG
DECROWN	D IY K R AW N
DECROWNED	D IY K R AW N D
DECROWNING	D IY K R AW N IH NG
DECROWNS	D IY K R AW N Z
DECRY	D IH K R AY
DECRYING	D IH K R AY IH NG
DECRYPT	D IY K R IH P T
DECRYPTED	D IY K R IH P T IH D
DECRYPTING	D IY K R IH P T IH NG
DECRYPTION	D IY K R IH P SH AH N
DECRYPTIONS	D IY K R IH P SH AH N Z
DECRYPTS	D IY K R IH P T S
DEMOCRACIES	D IH M AA K R AH S IY Z
DEMOCRACY	D IH M AA K R AH S IY
DEMOCRAT	D EH M AH K R AE T
DEMOCRATIC	D EH M AH K R AE T IH K
DEMOCRATICALLY	D EH M AH K R AE T IH K L IY
DEMOCRATIZATION	D IH M AA K R AH T AH Z EY SH AH N
DEMOCRATIZATIONS	D IH M AA K R AH T AH Z EY SH AH N Z
DEMOCRATIZE	D IH M AA K R AH T AY Z
DEMOCRATIZED	D IH M AA K R AH T AY Z D
DEMOCRATIZER	D IH M AA K R AH T AY Z ER
DEMOCRATIZERS	D IH M AA K R AH T AY Z ER Z
DEMOCRATIZES	D IH M AA K R AH T AY Z IH Z
DEMOCRATIZING	D IH M AA K R AH T AY Z IH NG
DEMOCRATS	D EH M AH K R AE T S
DESACRALIZATION	D IY S EY K R AH L AH Z EY SH AH N
DESACRALIZATIONS	D IY S EY K R AH L AH Z EY SH AH N Z
DESACRALIZE	D IY S EY K R AH L AY Z
DESACRALIZED	D IY S EY K R AH L AY Z D
DESACRALIZES	D IY S EY K R AH L AY Z IH Z
DESACRALIZING	D IY S EY K R AH L AY Z IH NG
DESCRAMBLE	D IY S K R AE M B AH L
DESCRAMBLED	D IY S K R AE M B AH L D
DESCRAMBLER	D IY S K R AE M B AH L ER
DESCRAMBLERS	D IY S K R AE M B AH L ER Z
DESCRAMBLES	D IY S K R AE M B AH L Z
DESCRAMBLING	D IY S K R AE M B AH L IH NG
DESCRIBABLE	D IH S K R AY B AH B AH L
DESCRIBE	D IH S K R AY B
DESCRIBED	D IH S K R AY B D
DESCRIBER	D IY S K R AY B ER
DESCRIBERS	D IY S K R AY B ER Z
DESCRIBES	D IH S K R AY B Z
DESCRIBING	D IH S K R AY B IH NG
DESCRIED	D IH S R AY D
DESCRIER	D IH S R AY AH R
DESCRIERS	D IH S R IY R Z
DESCRIES	D IH S R AY Z
DESCRIPTION	D IH S K R IH P SH AH N
DESCRIPTIONS	D IH S K R IH P SH AH N Z
DESCRIPTIVE	D IH S K R IH P T IH V
DESCRIPTIVELY	D IY S K R IH P T IH V L IY
DESCRIPTIVENESS	D IY S K R IH P T IH V N AH S
DESCRIPTIVENESSES	D IY S K R IH P T IH V N AH S IH Z
DESCRIPTOR	D IY S K R IH P T ER
DESCRIPTORS	D IY S K R IH P T ER Z
DESCRY	D EH S R IY
DESCRYING	D IH S R AY AH NG
DESECRATE	D EH Z AH K R EY T
DESECRATE(2)	D EH S AH K R EY T
DESECRATED	D EH Z AH K R EY T IH D
DESECRATED(2)	D EH S AH K R EY T IH D
DESECRATER	D EH S IH K R EY T ER
DESECRATERS	D EH S IH K R EY T ER Z
DESECRATES	D EH Z AH K R EY T S
DESECRATES(2)	D EH S AH K R EY T S
DESECRATING	D EH S IH K R EY T IH NG
DESECRATION	D EH S AH K R EY SH AH N
DESECRATION(2)	D EH Z AH K R EY SH AH N
DESECRATIONS	D EH S AH K R EY SH AH N Z
DESECRATIONS(2)	D EH Z AH K R EY SH AH N Z
DESECRATOR	D EH S IH K R EY T ER
DESECRATORS	D EH S IH K R EY T ER Z
DIACRITIC	D AY AH K R IH T AH K
DIACRITICAL	D AY AH K R IH T AH K AH L
DIACRITICS	D AY AH K R IH T AH K S
DICROTAL	D IH K R AH T AH L
DICROTIC	D IH K R AH T AH K
DICROTISM	D IH K R AH T IH Z AH M
DICROTISMS	D IH K R AH T AH Z AH M Z
DISCREDIT	D IH S K R EH D AH T
DISCREDITABLE	D IH S K R EH D AH T AH B AH L
DISCREDITABLY	D IH S K R EH D AH T AH B L IY
DISCREDITED	D IH S K R EH D IH T IH D
DISCREDITING	D IH S K R EH D AH T IH NG
DISCREDITS	D IH S K R EH D AH T S
DISCREET	D IH S K R IY T
DISCREETER	D IH S K R IY T ER
DISCREETEST	D IH S K R IY T AH S T
DISCREETLY	D IH S K R IY T L IY
DISCREETNESS	D IH S K R IY T N AH S
DISCREETNESSES	D IH S K R IY T N AH S IH Z
DISCREPANCIES	D IH S K R EH P AH N S IY Z
DISCREPANCY	D IH S K R EH P AH N S IY
DISCREPANT	D IH S K R EH P AH N T
DISCREPANTLY	D IH S K R EH P AH N T L IY
DISCRETE	D IH S K R IY T
DISCRETELY	D IH S K R IY T L IY
DISCRETENESS	D IH S K R IY T N AH S
DISCRETENESSES	D IH S K R IY T N AH S IH Z
DISCRETION	D IH S K R EH SH AH N
DISCRETIONARY	D IH S K R EH SH AH N EH R IY
DISCRETIONS	D IH S K R EH SH AH N Z
DISCRIMINABILITIES	D IH S K R IH M AH N AH B IH L AH T EH Z
DISCRIMINABILITY	D IH S K R IH M AH N AH B IH L AH T EH
DISCRIMINABLE	D IH S K R IH M AH N AH B AH L
DISCRIMINABLY	D IH S K R IH M AH N AH B L IY
DISCRIMINANT	D IH S K R IH M AH N AH N T
DISCRIMINANTS	D IH S K R IH M AH N AH N T S
DISCRIMINATE	D IH S K R IH M AH N EY T
DISCRIMINATED	D IH S K R IH M AH N EY T AH D
DISCRIMINATED(2)	D IH S K R IH M AH N EY T IH D
DISCRIMINATES	D IH S K R IH M AH N EY T S
DISCRIMINATING	D IH S K R IH M AH N EY T IH NG
DISCRIMINATINGLY	D IH S K R IH M AH N AH T IH NG L IY
DISCRIMINATION	D IH S K R IH M AH N EY SH AH N
DISCRIMINATIONAL	D IH S K R IH M AH N EY SH AH N AH L
DISCRIMINATIONS	D IH S K R IH M AH N EY SH AH N Z
DISCRIMINATIVE	D IH S K R IH M AH N AH T IH V
DISCRIMINATOR	D IH S K R IH M AH N AH T ER
DISCRIMINATORILY	D IH S K R IH M AH N AH T OW R IY L IY
DISCRIMINATORS	D IH S K R IH M AH N AH T ER Z
DISCRIMINATORY	D IH S K R IH M AH N AH T AO R IY
DISCROWN	D IH S K R AW N
DISCROWNED	D IH S K R AW N D
DISCROWNING	D IH S K R AW N IH NG
DISCROWNS	D IH S K R AW N Z
DYSCRASIA	D IH S R EY ZH IY AH
DYSCRASIAS	D IH S R EY S IY AH Z
ECCRINE	EH K R AY N
ECRASEUR	EH K R EY S AH R
ECRASEURS	EH K R AH Z IY Y AH R Z
ECRU	EH K R UW
ECRUS	EH K R AH S
ENCRIMSON	EH N K R IH M Z AH N
ENCRIMSONED	EH N K R IH M Z AH N D
ENCRIMSONING	EH N K R IH M Z AH N IH NG
ENCRIMSONS	EH N K R IH M Z AH N Z
ENCROACH	IH N K R OW CH
ENCROACHED	IH N K R OW CH T
ENCROACHER	IH N K R OW CH ER
ENCROACHERS	IH N K R OW CH ER Z
ENCROACHES	IH N K R OW CH IH Z
ENCROACHING	IH N K R OW CH IH NG
ENCROACHMENT	EH N K R OW CH M AH N T
ENCROACHMENTS	IH N K R OW CH M AH N T S
ENCRUST	EH N K R AH S T
ENCRUSTATION	EH N K R AH S T EY SH AH N
ENCRUSTATIONS	EH N K R AH S T EY SH AH N Z
ENCRUSTED	EH N K R AH S T IH D
ENCRUSTING	EH N K R AH S T IH NG
ENCRUSTS	EH N K R AH S T S
ENCRYPT	EH N K R IH P T
ENCRYPT(2)	IH N K R IH P T
ENCRYPTED	EH N K R IH P T IH D
ENCRYPTED(2)	IH N K R IH P T IH D
ENCRYPTING	EH N K R IH P T IH NG
ENCRYPTION	EH N K R IH P SH AH N
ENCRYPTIONS	EH N K R IH P SH AH N Z
ENCRYPTS	EH N K R IH P T S
ENDOCRINE	EH N D OW K R AY N
ENDOCRINES	IH N D AA K R AY N Z
ENDOCRINOLOGIC	IH N D AA K R IH N AH L AH JH AH K
ENDOCRINOLOGICAL	IH N D AA K R AH N AA L AH JH IH S AH L
ENDOCRINOLOGIES	IH N D AA K R AH N AA L AH JH AY Z
ENDOCRINOLOGIST	EH N D OW K R AH N AA L AH JH AH S T
ENDOCRINOLOGISTS	EH N D OW K R AH N AA L AH JH AH S T S
ENDOCRINOLOGY	EH N D OW K R AH N AA L AH JH IY
ENSCROLL	IH N S R AO L
ENSCROLLED	IH N S R AA L D
ENSCROLLING	IH N S R AA L AH NG
ENSCROLLS	IH N S R AA L Z
EPICRITIC	EH P IH K R AY T IH K
ESCRITOIRE	EH S K R AH T W AA R
ESCRITOIRES	EH S K R AH T W AA R Z
ESCROW	EH S K R OW
ESCROWED	EH S K R OW D
ESCROWING	EH S R OW AH NG
ESCROWS	EH S R OW Z
EUCRITE	Y UW K R AY T
EUCRITES	Y UW K R AY T S
EUCRITIC	Y UW K R AH T AH K
EXCREMENT	EH K S K R AH M AH N T
EXCREMENTAL	IH K S R AH M EH N T AH L
EXCREMENTITIOUS	IH K S R AH M EH N T AH SH AH S
EXCREMENTS	IH K S R EH M AH N T S
EXCRESCENCE	EH K S K R EH S AH N S
EXCRESCENCES	EH K S K R EH S AH N S IH Z
EXCRESCENCIES	EH K S K R EH S AH N S IY Z
EXCRESCENCY	EH K S K R EH S AH N S IY
EXCRESCENT	EH K S K R EH S AH N T
EXCRESCENTLY	EH K S K R EH S AH N T L IY
EXCRETA	IH K S R EH T AH
EXCRETAL	EH K S K R IY T AH L
EXCRETE	IH K S K R IY T
EXCRETED	EH K S K R IY T IH D
EXCRETER	EH K S K R IY T ER
EXCRETERS	EH K S K R IY T ER Z
EXCRETES	EH K S K R IY T S
EXCRETING	EH K S K R IY T IH NG
EXCRETION	IH K S K R IY SH AH N
EXCRETIONS	EH K S K R IY SH AH N Z
EXCRETORY	EH K S K R AH T AO R IY
EXCRUCIATE	IH K S K R UW SH IY EY T
EXCRUCIATED	IH K S K R UW SH IY EY T IH D
EXCRUCIATES	IH K S K R UW SH IY EY T S
EXCRUCIATING	IH K S K R UW SH IY EY T IH NG
EXCRUCIATINGLY	EH K S K R UW S IY EY T IH NG L IY
EXCRUCIATION	IH K S K R UW SH IY EY SH AH N
EXCRUCIATIONS	IH K S K R UW SH IY EY SH AH N Z
EXECRABLE	EH G Z EH K R AH B AH L
EXECRABLENESS	IH G Z EH K R AE B L N AH S
EXECRABLENESSES	IH G Z EH K R AE B L AH N EH S AH Z
EXECRABLY	IH G Z EH K R AH B L IY
EXECRATE	IH G Z EH K R EY T
EXECRATED	IH G Z EH K R EY T AH D
EXECRATES	IH G Z EH K R EY T S
EXECRATING	IH G Z EH K R EY T AH NG
EXECRATION	IH G Z EH K R EY SH AH N
EXECRATIONS	IH G Z EH K R EY T IY AH N Z
EXECRATIVE	IH G Z EH K R EY T AH V
EXECRATOR	IH G Z EH K R EY T AH R
EXECRATORS	IH G Z EH K R AH T AH R Z
EXOCRINE	IH G Z AA K R AY N
EXOCRINES	IH G Z AA K R AY N Z
EXTRACRANIAL	EH K S T R AH K R EY N IY AH L
FERROCONCRETE	F EH R OW K AA N K R IY T
FERROCONCRETES	F EH R OW K AA N K R IY T S
FIACRE	F AY AH K AH R
FIACRES	F AY AH K AH R Z
FIRECRACKER	F AY ER K R AE K ER
FIRECRACKERS	F AY ER K R AE K ER Z
FULCRA	F UH L K R AH
FULCRUM	F UH L K R AH M
FULCRUMS	F UH L K R AH M Z
FURCRAEA	F AH R K R IY AH
FURCRAEAS	F AH R K R IY AH Z
GERONTOCRACIES	JH AH R AA N T AA K R AH S IY Z
GERONTOCRACY	JH AH R AA N T AA K R AH S IY
GERONTOCRAT	JH EH R AH N T AA K R AH T
GERONTOCRATIC	JH AH R AA N T AA K R AH T AH K
GERONTOCRATS	JH AH R AA N T AH K R EY T S
GIMCRACK	JH IH M K R AH K
GIMCRACKERIES	JH IH M K R AE K AH R AY Z
GIMCRACKERY	JH IH M K R AH K EH R IY
GIMCRACKS	JH IH M K R AH K S
GYNECOCRACIES	JH IH N AH K AA K R AH S IY Z
GYNECOCRACY	JH IH N AH K AA K R AH S IY
GYNECOCRATIC	JH IH N AH K AA K R AH T AH K
HANDCRAFT	HH AE N D K R AE F T
HANDCRAFTED	HH AE N D K R AE F T IH D
HANDCRAFTING	HH AE N D K R AE F T IH NG
HANDCRAFTS	HH AE N D K R AE F T S
HANDCRAFTSMAN	HH AE N D K R AE F T S M AE N
HANDCRAFTSMANSHIP	HH AE N D K R AE F T S M AE N SH IH P
HANDCRAFTSMANSHIPS	HH AE N D K R AE F T S M AE N SH IH P S
HANDCRAFTSMEN	HH AE N D K R AE F T S M EH N
HANDICRAFT	HH AE N D IY K R AE F T
HANDICRAFTER	HH AE N D IH K R AE F T ER
HANDICRAFTERS	HH AE N D IH K R AE F T ER Z
HANDICRAFTS	HH AE N D IY K R AE F T S
HANDICRAFTSMAN	HH AE N D IH K R AE F T S M AE N
HANDICRAFTSMEN	HH AE N D IH K R AE F T S M EH N
HARDSCRABBLE	HH AA R D S K R AE B AH L
HEMATOCRIT	HH EH M AH T AA K R AH T
HEMATOCRITS	HH EH M AH T AA K R AH T S
HEPATOPANCREAS	HH EH P AH T AH P AE NG K R IY Z
HEPATOPANCREASES	HH AH P AH T AA P AH NG K R IY Z AH Z
HILLCREST	HH IH L K R EH S T
HILLCRESTS	HH IH L K R EH S T S
HIPPOCRAS	HH IH P AA K R AH Z
HIPPOCRASES	HH IH P AH K R EY Z AH Z
HOLOCRINE	HH AA L AH K R AY N
HONEYCREEPER	HH AH N IY K R IY P ER
HONEYCREEPERS	HH AH N IY K R IY P ER Z
HOVERCRAFT	HH AH V ER K R AE F T
HOVERCRAFTS	HH AH V ER K R AE F T S
HYDROCRACK	HH IH D R AA K R AH K
HYDROCRACKED	HH IH D R AA K R AH K T
HYDROCRACKER	HH IH D R AA K R AE K AH R
HYDROCRACKERS	HH IH D R AH K R AE K AH R Z
HYDROCRACKING	HH IH D R AA K R AE K AH NG
HYDROCRACKINGS	HH IH D R AH K R AE K AH NG Z
HYDROCRACKS	HH IH D R AA K R AH K S
HYPERCRITIC	HH AY P ER K R IH T IH K
HYPERCRITICAL	HH AY P ER K R IH T IH K AH L
HYPERCRITICALLY	HH AY P ER K R IH T IH K AH L IY
HYPERCRITICISM	HH AY P ER K R IH T AH S IH Z AH M
HYPERCRITICISMS	HH AY P ER K R IH T AH S IH Z AH M Z
HYPERCRITICS	HH AY P ER K R IH T IH K S
HYPEREXCRETION	HH AY P ER EH K S K R IY SH AH N
HYPEREXCRETIONS	HH AY P ER EH K S K R IY SH AH N Z
HYPERSECRETION	HH AY P ER S IH K R IY SH AH N
HYPERSECRETIONS	HH AY P ER S IH K R IY SH AH N Z
HYPOCRISIES	HH IH P AA K R AH S IY Z
HYPOCRISY	HH IH P AA K R AH S IY
HYPOCRITE	HH IH P AH K R IH T
HYPOCRITES	HH IH P AH K R IH T S
HYPOCRITICAL	HH IH P AH K R IH T IH K AH L
HYPOCRITICALLY	HH IH P AH K R IH T IH K AH L IY
IDIOSYNCRASIES	IH D IY OW S IH N K R AH S IY Z
IDIOSYNCRASY	IH D IY OW S IH N K R AH S IY
IDIOSYNCRATIC	IH D IY OW S IH N K R AE T IH K
IDIOSYNCRATICALLY	IH D IY OW S IH N K R AE T IH K AH L IY
IDOCRASE	IH D AH K R EY Z
IDOCRASES	IH D AH K R EY Z AH Z
INCREASABLE	IH N K R IY S AH B AH L
INCREASE	IH N K R IY S
INCREASED	IH N K R IY S T
INCREASER	IH N K R IY S ER
INCREASERS	IH N K R IY S ER Z
INCREASES	IH N K R IY S IH Z
INCREASING	IH N K R IY S IH NG
INCREASINGLY	IH N K R IY S IH NG G L IY
INCREATE	IH N K R IY EY T
INCREDIBILITIES	IH N K R EH D AH B IH L AH T IY Z
INCREDIBILITY	IH N K R EH D AH B IH L AH T IY
INCREDIBLE	IH N K R EH D AH B AH L
INCREDIBLENESS	IH N K R EH D AH B AH L N AH S
INCREDIBLENESSES	IH N K R EH D AH B AH L N AH S IH Z
INCREDIBLY	IH N K R EH D AH B L IY
INCREDULITIES	IH N K R IH D UW L AH T IY Z
INCREDULITY	IH N K R AH D UW L IH T IY
INCREDULOUS	IH N K R EH JH AH L AH S
INCREDULOUSLY	IH N K R EH JH AH L AH S L IY
INCREMENT	IH N K R AH M AH N T
INCREMENTAL	IH N K R AH M EH N T AH L
INCREMENTALISM	IH N K R AH M EH N T AH L IH Z M
INCREMENTALISMS	IH NG K R AH M EH N T AH L IH Z AH M Z
INCREMENTALIST	IH NG K R AH M EH N T AH L IH S T
INCREMENTALISTS	IH NG K R AH M EH N T AH L IH S T S
INCREMENTALLY	IH N K R AH M EH N T AH L IY
INCREMENTED	IH N K R AH M EH N T IH D
INCREMENTING	IH N K R AH M EH N T AH NG
INCREMENTS	IH NG K R AH M EH N T S
INCRESCENT	IH N K R EH S AH N T
INCRIMINATE	IH N K R IH M AH N EY T
INCRIMINATED	IH N K R IH M AH N EY T IH D
INCRIMINATES	IH N K R IH M AH N AH T S
INCRIMINATING	IH N K R IH M AH N EY T IH NG
INCRIMINATION	IH N K R IH M AH N EY SH AH N
INCRIMINATIONS	IH N K R IH M AH N EY SH AH N Z
INCRIMINATORY	IH N K R IH M AH N AH T OW R IY
INCROSS	IH N K R AO S
INCROSSED	IH N K R AO S T
INCROSSES	IH N K R AO S IH Z
INCROSSING	IH N K R AO S IH NG
INCRUST	IH N K R AH S T
INCRUSTATION	IH N K R AH S T EY SH AH N
INCRUSTATIONS	IH N K R AH S T EY SH AH N Z
INCRUSTED	IH N K R AH S T IH D
INCRUSTING	IH N K R AH S T IH NG
INCRUSTS	IH N K R AH S T S
INDESCRIBABLE	IH N D IH S K R AY B AH B AH L
INDESCRIBABLENESS	IH N D IY S K R AY B AH B AH L N AH S
INDESCRIBABLENESSES	IH N D IY S K R AY B AH B AH L N AH S IH Z
INDESCRIBABLY	IH N D IY S K R AY B AH B L IY
INDISCREET	IH N D IH S K R IY T
INDISCREETLY	IH N D IH S K R IY T L IY
INDISCREETNESS	IH N D IH S K R IY T N AH S
INDISCREETNESSES	IH N D IH S K R IY T N AH S IH Z
INDISCRETION	IH N D IH S K R EH SH AH N
INDISCRETIONS	IH N D IH S K R EH SH AH N Z
INDISCRIMINATE	IH N D IH S K R IH M AH N AH T
INDISCRIMINATELY	IH N D IH S K R IH M AH N AH T L IY
INDISCRIMINATENESS	IH N D IH S K R IH M AH N AH T N AH S
INDISCRIMINATENESSES	IH N D IH S K R IH M AH N AH T N AH S IH Z
INDISCRIMINATING	IH N D IH S K R IH M AH N EY T IH NG
INDISCRIMINATINGLY	IH N D IH S K R IH M AH N AH T IH NG L IY
INDISCRIMINATION	IH N D IH S K R IH M AH N EY SH AH N
INDISCRIMINATIONS	IH N D IH S K R IH M AH N EY SH AH N Z
INSCRIBE	IH N S K R AY B
INSCRIBED	IH N S K R AY B D
INSCRIBER	IH N S K R AY B ER
INSCRIBERS	IH N S K R AY B ER Z
INSCRIBES	IH N S K R AY B Z
INSCRIBING	IH N S K R AY B IH NG
INSCRIPTION	IH N S K R IH P SH AH N
INSCRIPTIONAL	IH N S K R IH P SH AH N AH L
INSCRIPTIONS	IH N S K R IH P SH AH N Z
INSCRIPTIVE	IH N S K R IH P T IH V
INSCRIPTIVELY	IH N S K R IH P T IH V L IY
INSCROLL	IH N S R AO L
INSCROLLED	IH N S R AA L D
INSCROLLING	IH N S R AA L AH NG
INSCROLLS	IH N S R AA L Z
INSCRUTABILITIES	IH N S K R UW T AH B IH L AH T EH Z
INSCRUTABILITY	IH N S K R UW T AH B IH L AH T EH
INSCRUTABLE	IH N S K R UW T AH B AH L
INSCRUTABLENESS	IH N S K R UW T AH B AH L N AH S
INSCRUTABLENESSES	IH N S K R UW T AH B AH L N AH S IH Z
INSCRUTABLY	IH N S K R UW T AH B L IY
INTERCRATER	IH N T ER K R EY T ER
INTERCROP	IH N T ER K R AA P
INTERCROPPED	IH N T ER K R AA P T
INTERCROPPING	IH N T ER K R AA P IH NG
INTERCROPS	IH N T ER K R AA P S
INTERCROSS	IH N T ER K R AO S
INTERCROSSED	IH N T ER K R AO S T
INTERCROSSES	IH N T ER K R AO S IH Z
INTERCROSSING	IH N T ER K R AO S IH NG
INTERCRYSTALLINE	IH N T ER K R IH S T AH L AH N
INTRACRANIAL	IH N T R AH K R EY N IY AH L
INTRACRANIALLY	IH N T R AH K R EY N IY AH L IY
INVOLUCRA	IH N V AH L AH K R AH
INVOLUCRAL	IH N V AH L AH K R AH L
INVOLUCRATE	IH N V AA L AH K R EY T
INVOLUCRE	IH N V AH L UW K AH R
INVOLUCRES	IH N V AA L AH K AH R Z
INVOLUCRUM	IH N V AH L AH K R AH M
ISOCRACIES	AH S AA K R AH S IY Z
ISOCRACY	AH S AA K R AH S IY
JACKSCREW	JH AE K S K R UW
JACKSCREWS	JH AE K S K R UW Z
KINGCRAFT	K IH NG K R AE F T
KINGCRAFTS	K IH NG K R AE F T S
LACRIMAL	L AE K R AH M AH L
LACRIMALS	L AE K R AH M AH L Z
LACRIMATION	L AE K R AH M EY SH AH N
LACRIMATIONS	L AE K R AH M EY T IY AH N Z
LACRIMATOR	L AE K R AH M EY T AH R
LACRIMATORS	L AE K R IH M AH T AH R Z
LACROSSE	L AH K R AO S
LACROSSES	L AE K R AA S AH Z
LEADSCREW	L IY D S K R UW
LEADSCREWS	L IY D S K R UW Z
LUCRATIVE	L UW K R AH T IH V
LUCRATIVELY	L UW K R AH T IH V L IY
LUCRATIVENESS	L UW K R AH T IH V N AH S
LUCRATIVENESSES	L UW K R AH T IH V N AH S IH Z
LUCRE	L UW K AH R
LUCRES	L AH K AH R Z
LUDICROUS	L UW D AH K R AH S
LUDICROUSLY	L UW D AH K R AH S L IY
LUDICROUSNESS	L UW D AH K R AH S N AH S
LUDICROUSNESSES	L UW D AH K R AH S N AH S IH Z
LUMBOSACRAL	L AH M B AH S AE K R AH L
MACRAME	M AE K R AH M EY
MACRAMES	M AE K R EY M Z
MACRO	M AE K R OW
MACROAGGREGATE	M AE K R OW G R AH G EY T
MACROAGGREGATED	M AE K R OW G R AH G EY T AH D
MACROAGGREGATES	M AE K R OW G R AH G EY T S
MACROBIOTIC	M AE K R OW B IY AH T AH K
MACROCOSM	M AE K R AH K AH Z AH M
MACROCOSMIC	M AE K R AH K AH Z M AH K
MACROCOSMICALLY	M AE K R AH K AA Z M AH K AE L IY
MACROCOSMS	M AE K R AH K AH Z AH M Z
MACROCYCLIC	M AE K R AH S AH K L AH K
MACROCYTE	M AE K R AH S AY T
MACROCYTES	M AE K R AH S AY T S
MACROCYTIC	M AE K R AH S AH T AH K
MACROCYTOSES	M AE K R AA S AH T OW Z AH Z
MACROCYTOSIS	M AE K R AH S AH T OW S AH S
MACROECONOMIC	M AE K R OW EH K AH N AA M IH K
MACROECONOMIC(2)	M AE K R OW IY K AH N AA M IH K
MACROECONOMICS	M AE K R OW EH K AH N AA M IH K S
MACROECONOMICS(2)	M AE K R OW IY K AH N AA M IH K S
MACROEVOLUTION	M AE K R OW EH V AH L Y UW T IY AH N
MACROEVOLUTIONARY	M AE K R OW AH V AH L UW T IY AH N EH R IY
MACROEVOLUTIONS	M AE K R OW AH V AH L UW T IY AH N Z
MACROFOSSIL	M AE K R AH F AA S AH L
MACROFOSSILS	M AE K R AH F AA S AH L Z
MACROGAMETE	M AE K R AA G AH M IY T
MACROGAMETES	M AE K R AA G AH M IY T S
MACROGLOBULIN	M AE K R AA G L AH B Y UW L AH N
MACROGLOBULINEMIA	M AE K R AH G L AH B Y UW L AH N IY M IY AH
MACROGLOBULINEMIAS	M AE K R AH G L AH B Y UW L AH N IY M IY AH Z
MACROGLOBULINEMIC	M AE K R AA G L AH B Y UW L AH N AH M AH K
MACROGLOBULINS	M AE K R AA G L AH B Y UW L AH N Z
MACROINSTRUCTION	M AE K R OY N S T R AH K AH N
MACROINSTRUCTIONS	M AE K R OY N S T R AH K T IY AH N Z
MACROLEPIDOPTERA	M AE K R AA L AH P AH D AA P T AH R AH
MACROMERE	M AE K R OW M AH R
MACROMERES	M AE K R AH M IY R Z
MACROMOLECULAR	M AE K R AA M AH L EH K Y AH L AH R
MACROMOLECULE	M AE K R AH M AA L AH K Y UW L
MACROMOLECULES	M AE K R AH M AA L AH K Y UW L Z
MACRON	M AE K R AH N
MACRONS	M AE K R AH N Z
MACRONUCLEAR	M AE K R AH N AH K L IY AH R
MACRONUCLEI	M AE K R AH N AH K L IY
MACRONUCLEUS	M AE K R AH N AH K L IY AH S
MACRONUCLEUSES	M AE K R AH N AH K L IY AH Z AH Z
MACRONUTRIENT	M AE K R AH N AH T R IY AH N T
MACRONUTRIENTS	M AE K R AA N AH T R IY N T S
MACROPHAGE	M AE K R OW F EY JH
MACROPHAGES	M AE K R OW F EY JH IH Z
MACROPHAGIC	M AE K R AH F EY JH IH K
MACROPHOTOGRAPH	M AE K R AH F AH T AA G R AH F
MACROPHOTOGRAPHIES	M AE K R AH F AH T AA G R AH F AY Z
MACROPHOTOGRAPHS	M AE K R AH F AH T AA G R AH F S
MACROPHOTOGRAPHY	M AE K R AH F AH T AA G R AH F IY
MACROPHYTE	M AE K R AH F AY T
MACROPHYTES	M AE K R AH F AY T S
MACROPHYTIC	M AE K R AH F AH T AH K
MACROPTEROUS	M AE K R AA P T AH R AH S
MACROS	M AE K R AH Z
MACROSCALE	M AE K R AH S EY L
MACROSCALES	M AE K R AH S EY L Z
MACROSCOPIC	M AE K R AH S K AA P IH K
MACROSCOPICALLY	M AE K R AH S K AA P IH K AH L IY
MACROSTRUCTURAL	M AE K R AA S T R AH K T Y AH R AH L
MACROSTRUCTURE	M AE K R AA S T R AH K T Y AH R
MACROSTRUCTURES	M AE K R AA S T R AH K T Y AH R Z
MACRURAL	M AE K R Y AH R AH L
MACRURAN	M AE K R Y AH R AH N
MACRURANS	M AE K R AH R AH N Z
MANUSCRIPT	M AE N Y AH S K R IH P T
MANUSCRIPTS	M AE N Y AH S K R IH P T S
MASSACRE	M AE S AH K ER
MASSACRED	M AE S AH K ER D
MASSACRER	M AE S IH K ER ER
MASSACRERS	M AE S IH K ER ER Z
MASSACRES	M AE S IH K ER Z
MASSACRING	M AE S AH K ER IH NG
MEDIOCRE	M IY D IY OW K ER
MEDIOCRITIES	M IY D IY AA K R AH T IY Z
MEDIOCRITY	M IY D IY AA K R AH T IY
MERITOCRACIES	M EH R AH T AA K R AH S IY Z
MERITOCRACY	M EH R IH T AO K R AH S IY
MERITOCRAT	M EH R AH T AA K R AH T
MERITOCRATIC	M EH R AH T AA K R AH T AH K
MERITOCRATS	M AH R IH T AH K R EY T S
MEROCRINE	M EH R AH K R AY N
METHACRYLATE	M AH TH AE K R AH L EY T
METHACRYLATES	M AH TH AE K R AH L EY T S
MICRA	M IH K R AH
MICRIFIED	M IH K R AH F AY D
MICRIFIES	M IH K R AH F AY Z
MICRIFY	M IH K R AH F AY
MICRIFYING	M IH K R IH F AY AH NG
MICRO	M AY K R OW
MICROAMPERE	M AY K R OW AE M P AH R
MICROAMPERES	M AY K R OW AE M P IY R Z
MICROANALYSES	M AY K R OW AH N AE L AH S IY Z
MICROANALYSIS	M AY K R OW AH N AE L AH S AH S
MICROANALYST	M AY K R OW AE N AH L AH S T
MICROANALYSTS	M AY K R OW AE N AH L AH S T S
MICROANALYTIC	M AY K R OW AE N AH L IH T IH K
MICROANALYTICAL	M AY K R OW AE N AH L IH T IH K AH L
MICROANATOMICAL	M AY K R OW AE N AH T AA M IH K AH L
MICROANATOMIES	M AY K R OW AH N AE T AH M IY Z
MICROANATOMY	M AY K R OW AH N AE T AH M IY
MICROBALANCE	M AY K R OW B AE L AH N S
MICROBALANCES	M AY K R OW B AE L AH N S IH Z
MICROBAR	M AY K R OW B AA R
MICROBAROGRAPH	M AY K R AH B AH R AA G R AH F
MICROBAROGRAPHS	M AY K R AH B AH R AA G R AH F S
MICROBARS	M AY K R OW B AA R Z
MICROBE	M AY K R OW B
MICROBEAM	M AY K R OW B IY M
MICROBEAMS	M AY K R OW B IY M Z
MICROBES	M AY K R OW B Z
MICROBIAL	M AY K R OW B IY AH L
MICROBIC	M AY K R OW B IY IH K
MICROBIOLOGIC	M AY K R OW B AY AH L AA JH IH K
MICROBIOLOGICAL	M AY K R OW B AY AH L AA JH IH K AH L
MICROBIOLOGICALLY	M AY K R OW B AY AH L AA JH IH K AH L IY
MICROBIOLOGIES	M AY K R OW B AY AA L AH JH IY Z
MICROBIOLOGIST	M AY K R OW B IY AA L AH JH IH S T
MICROBIOLOGISTS	M AY K R OW B IY AA L AH JH IH S T S
MICROBIOLOGISTS(2)	M AY K R OW B IY AA L AH JH IH S
MICROBIOLOGY	M AY K R OW B AY AA L AH JH IY
MICROBIOLOGY(2)	M AY K R AH B AY AA L AH JH IY
MICROBREW	M AY K R OW B R UW
MICROBREWER	M AY K R OW B R UW ER
MICROBREWERIES	M AY K R OW B R UW ER IY Z
MICROBREWERS	M AY K R OW B R UW ER Z
MICROBREWERY	M AY K R OW B R UW ER IY
MICROBREWING	M AY K R OW B R UW IH NG
MICROBREWINGS	M AY K R OW B R UW IH NG Z
MICROBREWS	M AY K R OW B R UW Z
MICROBURST	M AY K R OW B ER S T
MICROBURSTS	M AY K R OW B ER S T S
MICROBUS	M AY K R OW B AH S
MICROBUSES	M AY K R OW B AH S IH Z
MICROBUSSES	M AY K R OW B AH S IH Z
MICROCALORIMETER	M AY K R OW K AE L AH R IH M AH T ER
MICROCALORIMETERS	M AY K R OW K AE L AH R IH M AH T ER Z
MICROCALORIMETRIC	M AY K R OW K AH L AO R AH M EH T R IH K
MICROCALORIMETRIES	M AY K R AH K AH L AH R AH M EH T R AY Z
MICROCALORIMETRY	M AY K R AH K AE L AH R AH M EH T R IY
MICROCAPSULE	M AY K R OW K AE P S AH L
MICROCAPSULES	M AY K R OW K AE P S AH L Z
MICROCASSETTE	M AY K R AH K AE S EH T
MICROCASSETTES	M AY K R AH K AE S EH T S
MICROCEPHALIC	M AY K R AH S EH F AH L AH K
MICROCEPHALICS	M AY K R AH S EH F AH L AH S Z
MICROCEPHALIES	M AY K R AH S EH F AH L AY Z
MICROCEPHALY	M AY K R AH S EH F AH L IY
MICROCHIP	M AY K R OW CH IH P
MICROCHIPS	M AY K R OW CH IH P S
MICROCIRCUIT	M AY K R OW S ER K AH T
MICROCIRCUITRIES	M AY K R OW S ER K AH T R IY Z
MICROCIRCUITRY	M AY K R OW S ER K AH T R IY
MICROCIRCUITS	M AY K R OW S ER K AH T S
MICROCIRCULATION	M AY K R OW S ER K Y AH L EY SH AH N
MICROCIRCULATIONS	M AY K R OW S ER K Y AH L EY SH AH N Z
MICROCIRCULATORY	M AY K R OW S ER K Y AH L AH T OW R IY
MICROCLIMATE	M AY K R OW K L AY M AH T
MICROCLIMATES	M AY K R OW K L AY M AH T S
MICROCLIMATIC	M AY K R OW K L AY M AH T IH K
MICROCLINE	M AY K R OW K L AY N
MICROCLINES	M AY K R OW K L AY N Z
MICROCOCCAL	M AY K R AH K AA K AH L
MICROCOCCI	M AY K R OW K AH K S IY
MICROCOCCUS	M AY K R AH K AA K AH S
MICROCODE	M AY K R OW K OW D
MICROCODES	M AY K R OW K OW D Z
MICROCOMPUTER	M AY K R OW K AH M P Y UW T ER
MICROCOMPUTERS	M AY K R OW K AH M P Y UW T ER Z
MICROCOPIES	M AY K R OW K AA P IY Z
MICROCOPY	M AY K R OW K AA P IY
MICROCOSM	M AY K R AH K AA Z AH M
MICROCOSMIC	M AY K R OW K AA Z M IH K
MICROCOSMICALLY	M AY K R OW K AA Z M IH K AH L IY
MICROCOSMOS	M AY K R OW K AA Z M AH S
MICROCOSMOSES	M AY K R OW K AA Z M AH S IH Z
MICROCOSMS	M AY K R AH K AA Z AH M Z
MICROCRYSTAL	M AY K R OW K R IH S T AH L
MICROCRYSTALLINE	M AY K R OW K R IH S T AH L AH N
MICROCRYSTALLINITIES	M AY K R OW K R IH S T AH L AH N AH T IY Z
MICROCRYSTALLINITY	M AY K R OW K R IH S T AH L AH N AH T IY
MICROCRYSTALS	M AY K R OW K R IH S T AH L Z
MICROCULTURAL	M AY K R OW K AH L CH ER AH L
MICROCULTURE	M AY K R OW K AH L CH ER
MICROCULTURES	M AY K R OW K AH L CH ER Z
MICROCURIE	M AY K R OW K Y UH R IY
MICROCURIES	M AY K R OW K Y UH R IY Z
MICROCYTE	M AY K R AH S AY T
MICROCYTES	M AY K R AH S AY T S
MICROCYTIC	M AY K R AH S AY T AH K
MICRODENSITOMETER	M AY K R OW D AH N S AH T AA M AH T AH R
MICRODENSITOMETERS	M AY K R OW D AH N S AH T AA M AH T AH R Z
MICRODENSITOMETRIC	M AY K R OW D AH N S IH T AH M AH T R AH K
MICRODENSITOMETRIES	M AY K R OW D EH N S AH T AA M AH T R IY Z
MICRODENSITOMETRY	M AY K R OW D EH N S AH T AA M AH T R IY
MICRODISSECTION	M AY K R OW D IH S EH K SH AH N
MICRODISSECTIONS	M AY K R OW D IH S EH K SH AH N Z
MICRODOT	M AY K R OW D AA T
MICRODOTS	M AY K R OW D AA T S
MICROEARTHQUAKE	M AY K R OW ER TH K W EY K
MICROEARTHQUAKES	M AY K R OW ER TH K W EY K S
MICROECONOMIC	M AY K R OW EH K AH N AA M IH K
MICROECONOMICS	M AY K R OW EH K AH N AA M IH K S
MICROELECTRODE	M AY K R OW IH L EH K T R OW D
MICROELECTRODES	M AY K R OW IH L EH K T R OW D Z
MICROELECTRONIC	M AY K R OW IH L EH K T R AA N IH K
MICROELECTRONICALLY	M AY K R OW IH L EH K T R AA N IH K AH L IY
MICROELECTRONICS	M AY K R OW IH L EH K T R AA N IH K S
MICROELECTROPHORESES	M AY K R OW AH L EH K T R AA F AH R IY Z AH Z
MICROELECTROPHORESIS	M AY K R OW IH L EH K T R AH F AH R IY S AH S
MICROELECTROPHORETIC	M AY K R OW EH L AH K T R AA F AH R AH T AH K
MICROELECTROPHORETICALLY	M AY K R OW AH L EH K T R AH F AH R EH T AH K AE L IY
MICROELEMENT	M AY K R OW EH L AH M AH N T
MICROELEMENTS	M AY K R OW EH L AH M AH N T S
MICROENCAPSULATE	M AY K R OW EH N K AE P S AH L AH T
MICROENCAPSULATED	M AY K R OW EH N K AE P S AH L EY T IH D
MICROENCAPSULATES	M AY K R OW EH N K AE P S AH L AH T S
MICROENCAPSULATING	M AY K R OW EH N K AE P S AH L EY T IH NG
MICROENCAPSULATION	M AY K R OW EH N K AE P S AH L EY SH AH N
MICROENCAPSULATIONS	M AY K R OW EH N K AE P S AH L EY SH AH N Z
MICROENVIRONMENT	M AY K R OW IH N V AY R N M AH N T
MICROENVIRONMENTAL	M AY K R OW IH N V AY R AH N M EH N T AH L
MICROENVIRONMENTS	M AY K R OW IH N V AY R N M AH N T S
MICROEVOLUTION	M AY K R OW EH V AH L UW SH AH N
MICROEVOLUTIONARY	M AY K R OW EH V AH L UW SH AH N EH R IY
MICROEVOLUTIONS	M AY K R OW EH V AH L UW SH AH N Z
MICROFARAD	M AY K R AH F AE R AH D
MICROFARADS	M AY K R AH F AE R AH D Z
MICROFAUNA	M AY K R OW F AO N AH
MICROFAUNAE	M AY K R AH F AO N IY
MICROFAUNAL	M AY K R AH F AO N AH L
MICROFAUNAS	M AY K R OW F AO N AH Z
MICROFIBRIL	M AY K R AH F IH B R AH L
MICROFIBRILLAR	M AY K R AH F IH B R IH L AH R
MICROFIBRILS	M AY K R AH F IH B R AH L Z
MICROFICHE	M AY K R OW F IY CH
MICROFICHES	M AY K R AH F IH CH AH Z
MICROFILAMENT	M AY K R OW F IH L AH M AH N T
MICROFILAMENTS	M AY K R OW F IH L AH M AH N T S
MICROFILARIA	M AY K R AH F AH L AE R IY AH
MICROFILARIAE	M AY K R AH F AH L AE R IY IY
MICROFILARIAL	M AY K R OW F AY L EH R IY AH L
MICROFILM	M AY K R AH F IH L M
MICROFILMABLE	M AY K R OW F IH L M AH B AH L
MICROFILMED	M AY K R OW F IH L M D
MICROFILMER	M AY K R OW F IH L M ER
MICROFILMERS	M AY K R OW F IH L M ER Z
MICROFILMING	M AY K R OW F IH L M IH NG
MICROFILMS	M AY K R OW F IH L M Z
MICROFLORA	M AY K R OW F L OW R AH
MICROFLORAE	M AY K R OW F L AO R IY
MICROFLORAL	M AY K R OW F L OW R AH L
MICROFLORAS	M AY K R OW F L OW R AH Z
MICROFORM	M AY K R OW F AO R M
MICROFORMS	M AY K R OW F AO R M Z
MICROFOSSIL	M AY K R OW F AA S AH L
MICROFOSSILS	M AY K R OW F AA S AH L Z
MICROFUNGI	M AY K R AH F AH N JH IY
MICROFUNGUS	M AY K R OW F AH NG G AH S
MICROFUNGUSES	M AY K R OW F AH NG G AH S IH Z
MICROGAMETE	M AY K R AH G AH M IY T
MICROGAMETES	M AY K R AH G AH M IY T S
MICROGAMETOCYTE	M AY K R AH G AH M EH T AH S AY T
MICROGAMETOCYTES	M AY K R AH G AH M EH T AH S AY T S
MICROGRAM	M AY K R OW G R AE M
MICROGRAMS	M AY K R OW G R AE M Z
MICROGRAPH	M AY K R OW G R AE F
MICROGRAPHED	M AY K R OW G R AE F T
MICROGRAPHIC	M AY K R OW G R AE F IH K
MICROGRAPHICALLY	M AY K R OW G R AE F IH K AH L IY
MICROGRAPHICS	M AY K R OW G R AE F IH K S
MICROGRAPHING	M AY K R OW G R AE F IH NG
MICROGRAPHS	M AY K R OW G R AE F S
MICROGRAVITIES	M AY K R OW G R AE V AH T IY Z
MICROGRAVITY	M AY K R OW G R AE V AH T IY
MICROGROOVE	M AY K R OW G R UW V
MICROGROOVES	M AY K R OW G R UW V Z
MICROHABITAT	M AY K R OW HH AE B AH T AE T
MICROHABITATS	M AY K R OW HH AE B AH T AE T S
MICROHM	M IH K R AH M
MICROHMS	M IH K R AH M Z
MICROIMAGE	M AY K R OW IH M IH JH
MICROIMAGES	M AY K R OW IH M IH JH IH Z
MICROINCH	M AY K R OW IH N CH
MICROINCHES	M AY K R OW IH N CH IH Z
MICROINJECT	M AY K R OW IH N JH EH K T
MICROINJECTED	M AY K R OW IH N JH EH K T IH D
MICROINJECTING	M AY K R OW IH N JH EH K T IH NG
MICROINJECTION	M AY K R OW IH N JH EH K SH AH N
MICROINJECTIONS	M AY K R OW IH N JH EH K SH AH N Z
MICROINJECTS	M AY K R OW IH N JH EH K T S
MICROINSTRUCTION	M AY K R OW IH N S T R AH K SH AH N
MICROINSTRUCTIONS	M AY K R OW IH N S T R AH K SH AH N Z
MICROLEPIDOPTERA	M AY K R AH L EH P AH D AA P T AH R AH
MICROLEPIDOPTEROUS	M AY K R AH L EH P AH D AA P T AH R AH S
MICROLITER	M AY K R OW L IY T ER
MICROLITERS	M AY K R OW L IY T ER Z
MICROLITH	M AY K R AH L IH TH
MICROLITHIC	M AY K R OW L AY DH IH K
MICROLITHS	M AY K R AH L IH TH S
MICROLUCES	M AY K R AH L UW S AH Z
MICROLUX	M AY K R AH L AH K S
MICROLUXES	M AY K R AH L AH K S
MICROMANAGE	M AY K R OW M AE N IH JH
MICROMANAGED	M AY K R OW M AE N IH JH D
MICROMANAGEMENT	M AY K R OW M AE N IH JH M AH N T
MICROMANAGEMENTS	M AY K R OW M AE N IH JH M AH N T S
MICROMANAGER	M AY K R OW M AE N IH JH ER
MICROMANAGERS	M AY K R OW M AE N IH JH ER Z
MICROMANAGES	M AY K R OW M AE N IH JH AH Z
MICROMANAGING	M AY K R OW M AE N IH JH IH NG
MICROMANIPULATION	M AY K R OW M AH N IH P Y AH L EY SH AH N
MICROMANIPULATIONS	M AY K R OW M AH N IH P Y AH L EY SH AH N Z
MICROMANIPULATOR	M AY K R OW M AH N IH P Y AH L AH T ER
MICROMANIPULATORS	M AY K R OW M AH N IH P Y AH L AH T ER Z
MICROMERE	M AY K R OW M IH ER
MICROMERES	M AY K R OW M IH ER Z
MICROMETEORITE	M AY K R OW M IY T IY AH R AY T
MICROMETEORITES	M AY K R OW M IY T IY AH R AY T S
MICROMETEORITIC	M AY K R OW M IY T IY AH R IH T IH K
MICROMETEOROID	M AY K R AH M IY T IY AH R OY D
MICROMETEOROIDS	M AY K R AH M IY T IY AH R OY D Z
MICROMETEOROLOGICAL	M AY K R OW M IY T IY AO R AH L AA JH IH K AH L
MICROMETEOROLOGIES	M AY K R OW M IY T IY ER AA L AH JH IY Z
MICROMETEOROLOGIST	M AY K R OW M IY T IY ER AA L AH JH AH S T
MICROMETEOROLOGISTS	M AY K R OW M IY T IY ER AA L AH JH AH S T S
MICROMETEOROLOGY	M AY K R OW M IY T IY ER AA L AH JH IY
MICROMETER	M AY K R AA M AH T ER
MICROMETERS	M AY K R AA M AH T ER Z
MICROMETHOD	M AY K R OW M EH TH AH D
MICROMETHODS	M AY K R OW M EH TH AH D Z
MICROMHO	M AY K R OW M HH OW
MICROMHOS	M AY K R OW M HH AA Z
MICROMINI	M AY K R AH M IH N IY
MICROMINIATURE	M AY K R OW M IH N IY AH CH UH R
MICROMINIATURIZATION	M AY K R OW M IH N IY AH CH UH R AH Z EY SH AH N
MICROMINIATURIZATIONS	M AY K R OW M IH N IY AH CH UH R AH Z EY SH AH N Z
MICROMINIATURIZED	M AY K R OW M IH N IY AH CH UH R AY Z D
MICROMINIS	M AY K R OW M AY N IY Z
MICROMOLAR	M AY K R OW M OW L ER
MICROMOLE	M AY K R OW M OW L
MICROMOLES	M AY K R OW M OW L Z
MICROMORPHOLOGICAL	M AY K R OW M AO R F AH L AA JH IH K AH L
MICROMORPHOLOGIES	M AY K R OW M AO R F AA L AH JH IY Z
MICROMORPHOLOGY	M AY K R OW M AO R F AA L AH JH IY
MICRON	M AY K R AA N
MICRONIZE	M AY K R AA N AY Z
MICRONIZED	M AY K R AA N AY Z D
MICRONIZES	M AY K R AA N AY Z IH Z
MICRONIZING	M AY K R AA N AY Z IH NG
MICRONS	M AY K R AA N Z
MICRONUCLEI	M AY K R OW N UW K L IY AY
MICRONUCLEUS	M AY K R OW N UW K L IY AH S
MICRONUCLEUSES	M AY K R OW N UW K L IY AH S IH Z
MICRONUTRIENT	M AY K R OW N UW T R IY AH N T
MICRONUTRIENTS	M AY K R OW N UW T R IY AH N T S
MICROORGANISM	M AY K R OW AO R G AH N IH Z AH M
MICROORGANISMS	M AY K R OW AO R G AH N IH Z AH M Z
MICROPALEONTOLOGIC	M AY K R AH P EY L IY AA N T AH L AH JH AH K
MICROPALEONTOLOGICAL	M AY K R OW P EY L AA N T AH L AA JH IH K AH L
MICROPALEONTOLOGIES	M AY K R AH P EY L IY AA N T AA L AH JH AY Z
MICROPALEONTOLOGIST	M AY K R AH P EY L IY AA N T AA L AH JH AH S T
MICROPALEONTOLOGISTS	M AY K R AH P EY L IY AH N T AA L AH JH AH S T S
MICROPALEONTOLOGY	M AY K R OW P EY L IY AH N T AA L AH JH IY
MICROPARTICLE	M AY K R OW P AA R T IH K AH L
MICROPARTICLES	M AY K R OW P AA R T IH K AH L Z
MICROPHAGE	M IH K R AH F AH JH
MICROPHAGES	M IH K R AA F AH JH AH Z
MICROPHONE	M AY K R AH F OW N
MICROPHONES	M AY K R OW F OW N Z
MICROPHONIC	M AY K R OW F AA N IH K
MICROPHONICS	M AY K R OW F AA N IH K S
MICROPHOTOGRAPH	M AY K R OW F OW T AH G R AE F
MICROPHOTOGRAPHER	M AY K R OW F AH T AA G R AH F ER
MICROPHOTOGRAPHERS	M AY K R OW F AH T AA G R AH F ER Z
MICROPHOTOGRAPHIC	M AY K R OW F OW T AH G R AE F IH K
MICROPHOTOGRAPHIES	M AY K R OW F AH T AA G R AH F IY Z
MICROPHOTOGRAPHS	M AY K R OW F OW T AH G R AE F S
MICROPHOTOGRAPHY	M AY K R OW F AH T AA G R AH F IY
MICROPHOTOMETER	M AY K R OW F OW T OW M IY T ER
MICROPHOTOMETERS	M AY K R OW F OW T OW M IY T ER Z
MICROPHOTOMETRIC	M AY K R OW F OW T OW M EH T R IH K
MICROPHOTOMETRICALLY	M AY K R OW F OW T OW M EH T R IH K AH L IY
MICROPHOTOMETRIES	M AY K R OW F OW T OW M IY T ER IY Z
MICROPHOTOMETRY	M AY K R OW F OW T OW M IY T ER IY
MICROPHYLL	M AY K R AH F IH L
MICROPHYLLOUS	M AY K R AH F IH L AH S
MICROPHYLLS	M AY K R AH F IH L Z
MICROPHYSICAL	M AY K R OW F IH Z AH K AH L
MICROPHYSICALLY	M AY K R OW F IH Z AH K AH L IY
MICROPHYSICS	M AY K R OW F IH Z IH K S
MICROPIPET	M AY K R AH P IH P AH T
MICROPIPETS	M AY K R AH P IH P AH T S
MICROPIPETTE	M AY K R OW P AY P EH T
MICROPIPETTES	M AY K R OW P AY P EH T S
MICROPLANKTON	M AY K R OW P L AE NG K T AH N
MICROPLANKTONS	M AY K R OW P L AE NG K T AH N Z
MICROPORE	M AY K R OW P OW R
MICROPORES	M AY K R OW P OW R Z
MICROPOROSITIES	M AY K R OW P AH R AA S AH T IY Z
MICROPOROSITY	M AY K R OW P AH R AA S AH T IY
MICROPOROUS	M AY K R OW P OW R AH S
MICROPRISM	M IH K R AH P R IH Z AH M
MICROPRISMS	M AY K R OW P R IH Z AH M Z
MICROPROBE	M AY K R OW P R OW B
MICROPROBES	M AY K R OW P R OW B Z
MICROPROCESSOR	M AY K R OW P R AA S EH S ER
MICROPROCESSORS	M AY K R OW P R AA S EH S ER Z
MICROPROGRAM	M AY K R OW P R OW G R AE M
MICROPROGRAMMING	M AY K R OW P R OW G R AE M IH NG
MICROPROGRAMMINGS	M AY K R OW P R OW G R AE M IH NG Z
MICROPROGRAMS	M AY K R OW P R OW G R AE M Z
MICROPROJECTION	M AY K R OW P R AA JH EH K SH AH N
MICROPROJECTIONS	M AY K R OW P R AA JH EH K SH AH N Z
MICROPROJECTOR	M AY K R OW P R AA JH EH K T ER
MICROPROJECTORS	M AY K R OW P R AA JH EH K T ER Z
MICROPUBLISHER	M AY K R OW P AH B L IH SH ER
MICROPUBLISHERS	M AY K R OW P AH B L IH SH ER Z
MICROPUBLISHING	M AY K R OW P AH B L IH SH IH NG
MICROPUBLISHINGS	M AY K R OW P AH B L IH SH IH NG Z
MICROPULSATION	M AY K R OW P AH L S EY SH AH N
MICROPULSATIONS	M AY K R OW P AH L S EY SH AH N Z
MICROPUNCTURE	M AY K R OW P AH NG K CH ER
MICROPUNCTURES	M AY K R OW P AH NG K CH ER Z
MICROPYLAR	M AY K R AH P AY L AH R
MICROPYLE	M AY K R AH P AY L
MICROPYLES	M AY K R AH P AY L Z
MICROQUAKE	M AY K R OW K W EY K
MICROQUAKES	M AY K R OW K W EY K S
MICRORADIOGRAPH	M AY K R OW R EY D IY OW G R AE F
MICRORADIOGRAPHIC	M AY K R OW R EY D IY OW G R AE F IH K
MICRORADIOGRAPHIES	M AY K R OW R EY D IY AA G R AH F IY Z
MICRORADIOGRAPHS	M AY K R OW R EY D IY OW G R AE F S
MICRORADIOGRAPHY	M AY K R OW R EY D IY AA G R AH F IY
MICROREADER	M AY K R OW R IY D ER
MICROREADERS	M AY K R OW R IY D ER Z
MICROREPRODUCTION	M AY K R OW R IY P R AA D AH K SH AH N
MICROREPRODUCTIONS	M AY K R OW R IY P R AA D AH K SH AH N Z
MICROS	M AY K R OW Z
MICROSCALE	M AY K R OW S K EY L
MICROSCALES	M AY K R OW S K EY L Z
MICROSCOPE	M AY K R AH S K OW P
MICROSCOPES	M AY K R AH S K OW P S
MICROSCOPIC	M AY K R AH S K AA P IH K
MICROSCOPICAL	M AY K R AH S K AA P IH K AH L
MICROSCOPICALLY	M AY K R AH S K AA P IH K L IY
MICROSCOPIES	M AY K R AA S K AH P IY Z
MICROSCOPIST	M AY K R OW S K OW P IH S T
MICROSCOPISTS	M AY K R OW S K OW P IH S T S
MICROSCOPY	M AY K R AH S K AH P IY
MICROSECOND	M AY K R OW S EH K AH N D
MICROSECONDS	M AY K R OW S EH K AH N D Z
MICROSEISM	M AY K R AH S IY AH Z AH M
MICROSEISMIC	M AY K R OW S AY Z M IH K
MICROSEISMICITIES	M AY K R OW S AY Z M IH K AH T IY Z
MICROSEISMICITY	M AY K R OW S AY Z M IH K AH T IY
MICROSEISMS	M AY K R AH S AY Z AH M Z
MICROSOMAL	M IH K R AA S AH M AH L
MICROSOME	M IH K R AH S AH M
MICROSOMES	M IH K R AH S AH M Z
MICROSPECTROPHOTOMETER	M AY K R OW S P EH K T R OW F AH T AA M AH T ER
MICROSPECTROPHOTOMETERS	M AY K R OW S P EH K T R OW F AH T AA M AH T ER Z
MICROSPECTROPHOTOMETRIC	M AY K R OW S P EH K T R AH F OW T AH M EH T R IH K
MICROSPECTROPHOTOMETRIES	M AY K R OW S AH K T R AH F AH T AH M EH T R AY Z
MICROSPECTROPHOTOMETRY	M AY K R OW S EH K T R AA F AH T AH M EH T R IY
MICROSPHERE	M AY K R OW S F IH ER
MICROSPHERES	M AY K R OW S F IH ER Z
MICROSPHERICAL	M AY K R OW S F IH ER IH K AH L
MICROSPORANGIA	M AY K R OW S AH R AE N JH IY AH
MICROSPORANGIATE	M AY K R OW S AH R AE N JH AY EY T
MICROSPORANGIUM	M AY K R OW S AH R AE N JH IY AH M
MICROSPORE	M AY K R OW S P OW R
MICROSPORES	M AY K R OW S P OW R Z
MICROSPOROCYTE	M AY K R OW S AO R AH S AY T
MICROSPOROCYTES	M AY K R OW S AO R AH S AY T S
MICROSPOROGENESES	M AY K R OW S AH R AA JH AH N IY Z AH Z
MICROSPOROGENESIS	M AY K R OW S AO R AH JH IY N AH S AH S
MICROSPOROPHYLL	M AY K R OW S AO R AH F AH L
MICROSPOROPHYLLS	M AY K R OW S AO R AH F AH L Z
MICROSPOROUS	M AY K R OW S P OW R AH S
MICROSTATE	M AY K R OW S T EY T
MICROSTATES	M AY K R OW S T EY T S
MICROSTRUCTURAL	M AY K R OW S T R AH K CH ER AH L
MICROSTRUCTURE	M AY K R OW S T R AH K CH ER
MICROSTRUCTURES	M AY K R OW S T R AH K CH ER Z
MICROSURGERIES	M AY K R OW S ER JH AH R IY Z
MICROSURGERY	M AY K R OW S ER JH AH R IY
MICROSURGICAL	M AY K R OW S ER JH IH K AH L
MICROSWITCH	M AY K R OW S W IH CH
MICROSWITCHES	M AY K R OW S W IH CH IH Z
MICROTECHNIC	M AY K R OW T EH K N IH K
MICROTECHNICS	M AY K R OW T EH K N IH K S
MICROTECHNIQUE	M AY K R OW T EH K N IY K
MICROTECHNIQUES	M AY K R OW T EH K N IY K S
MICROTOME	M AY K R OW T OW M
MICROTOMES	M AY K R OW T OW M Z
MICROTONAL	M AY K R OW T OW N AH L
MICROTONALITIES	M AY K R OW T OW N AE L AH T IY Z
MICROTONALITY	M AY K R OW T OW N AE L AH T IY
MICROTONALLY	M AY K R OW T OW N AH L IY
MICROTONE	M AY K R OW T OW N
MICROTONES	M AY K R OW T OW N Z
MICROTUBULAR	M AY K R OW T UW B Y AH L ER
MICROTUBULE	M AY K R OW T UW B Y UW L
MICROTUBULES	M AY K R OW T UW B Y UW L Z
MICROVASCULAR	M AY K R OW V AE S K Y AH L ER
MICROVASCULATURE	M AY K R AH V AE S Y AH L EY T Y AH R
MICROVASCULATURES	M AY K R AH V AE S Y AH L EY T Y AH R Z
MICROVILLAR	M AY K R OW V IH L ER
MICROVILLI	M AY K R AH V IH L IY
MICROVILLOUS	M AY K R OW V IH L AH S
MICROVILLUS	M AY K R AH V IH L AH S
MICROVOLT	M AY K R OW V OW L T
MICROVOLTS	M AY K R OW V OW L T S
MICROWATT	M AY K R OW W AA T
MICROWATTS	M AY K R OW W AA T S
MICROWAVABLE	M AY K R OW W EY V AH B AH L
MICROWAVE	M AY K R AH W EY V
MICROWAVEABLE	M AY K R OW W EY V AH B AH L
MICROWAVED	M AY K R OW W EY V D
MICROWAVES	M AY K R OW W EY V Z
MICROWAVING	M AY K R AH W EY V IH NG
MICROWORLD	M AY K R OW W ER L D
MICROWORLDS	M AY K R OW W ER L D Z
MICRURGIES	M IH K R AH R JH AY Z
MICRURGY	M IH K R AH R JH IY
MILLIMICRON	M IH L AH M IH K R AH N
MILLIMICRONS	M IH L AH M IH K R AH N Z
MIMICRIES	M AH M IH K R AY Z
MIMICRY	M IH M IH K R IY
MISCREANT	M IH S K R IY AH N T
MISCREANTS	M IH S K R IY AH N T S
MISCREATE	M IH S K R IY EY T
MISCREATED	M IH S K R IY EY T IH D
MISCREATES	M IH S K R IY EY T S
MISCREATING	M IH S K R IY EY T IH NG
MISCREATION	M IH S K R IY EY SH AH N
MISCREATIONS	M IH S K R IY EY SH AH N Z
MISDESCRIBE	M IH S D IY S K R AY B
MISDESCRIBED	M IH S D IY S K R AY B D
MISDESCRIBES	M IH S D IY S K R AY B Z
MISDESCRIBING	M IH S D IY S K R AY B IH NG
MISDESCRIPTION	M IH S D IY S K R IH P SH AH N
MISDESCRIPTIONS	M IH S D IY S K R IH P SH AH N Z
MISTRANSCRIBE	M IH S T R AE N S K R AY B
MISTRANSCRIBED	M IH S T R AE N S K R AY B D
MISTRANSCRIBES	M IH S T R AE N S K R AY B Z
MISTRANSCRIBING	M IH S T R AE N S K R AY B IH NG
MISTRANSCRIPTION	M IH S T R AE N S K R IH P SH AH N
MISTRANSCRIPTIONS	M IH S T R AE N S K R IH P SH AH N Z
MOBOCRACIES	M AH B AA K R AH S IY Z
MOBOCRACY	M AH B AA K R AH S IY
MOBOCRAT	M AH B AA K R AH T
MOBOCRATIC	M AH B AA K R AH T AH K
MOBOCRATS	M AA B AH K R EY T S
MONOCRACIES	M AH N AA K R AH S IY Z
MONOCRACY	M AH N AA K R AH S IY
MONOCRAT	M AH N AA K R AH T
MONOCRATIC	M AA N OW K R EY T IH K
MONOCRATS	M AA N AH K R EY T S
MONOCRYSTAL	M AA N OW K R IH S T AH L
MONOCRYSTALLINE	M AA N OW K R IH S T AH L AH N
MONOCRYSTALS	M AA N OW K R IH S T AH L Z
MOTOCROSS	M AH T AA K R AH S
MOTOCROSSES	M AH T AA K R AA S AH Z
MUCRO	M AH K R OW
MUCRONATE	M AH K R AH N EY T
MUCRONES	M AH K R OW N Z
MUCROS	M AH K R AH Z
MULTISCREEN	M AH L T AY S K R IY N
NACRE	N EY K AH R
NACRED	N EY K AH R D
NACREOUS	N AE K R IY AH S
NACRES	N EY K AH R Z
NECROLOGICAL	N EH K R AA L AH JH IH S AH L
NECROLOGIES	N EH K R AA L AH JH AY Z
NECROLOGIST	N AH K R AO L AH JH IH S T
NECROLOGISTS	N AH K R AO L AH JH IH S T S
NECROLOGISTS(2)	N AH K R AO L AH JH IH S
NECROLOGY	N AH K R AO L AH JH IY
NECROMANCER	N EH K R AH M AE N S ER
NECROMANCERS	N EH K R AH M AE N S AH R Z
NECROMANCIES	N EH K R AH M AE N S AY Z
NECROMANCY	N EH K R AH M AE N S IY
NECROMANTIC	N EH K R AH M AE N T IH K
NECROMANTICALLY	N EH K R AH M AE N T IH K AH L IY
NECROPHAGOUS	N EH K R AH F EY JH AH S
NECROPHILIA	N EH K R AH F IH L Y AH
NECROPHILIAC	N EH K R AH F IH L IY AH K
NECROPHILIACS	N EH K R AH F IH L IY AH S
NECROPHILIAS	N EH K R AH F IH L Y AH Z
NECROPHILIC	N EH K R AH F AY L AH K
NECROPHILISM	N EH K R AH F AH L IH Z AH M
NECROPHILISMS	N EH K R AA F AH L AH Z AH M Z
NECROPOLEIS	N EH K R AH P OW L IY AH S
NECROPOLES	N EH K R AH P OW L Z
NECROPOLI	N EH K R AA P AH L IY
NECROPOLIS	N AH K R AA P AH L AH S
NECROPOLISES	N EH K R AA P AH L AY Z AH Z
NECROPSIED	N EH K R AA P S IY D
NECROPSIES	N EH K R AA P S IY Z
NECROPSY	N EH K R AA P S IY
NECROPSYING	N EH K R AA P S IY IH NG
NECROSE	N EH K R OW Z
NECROSED	N EH K R OW Z D
NECROSES	N EH K R OW Z AH Z
NECROSING	N EH K R OW Z AH NG
NECROSIS	N AH K R OW S AH S
NECROTIC	N AH K R AA T IH K
NECROTIZING	N EH K R AH T AY Z AH NG
NEUROENDOCRINE	N Y AH R OW EH N D AH K R AY N
NEUROENDOCRINOLOGICAL	N Y AH R OW EH N D AA K R AH N AA L AH JH IH S AH L
NEUROENDOCRINOLOGIES	N Y AH R OW AH N D AA K R AH N AA L AH JH AY Z
NEUROENDOCRINOLOGIST	N Y AH R OW EH N D AA K R AH N AA L AH JH AH S T
NEUROENDOCRINOLOGISTS	N Y AH R OW AH N D AA K R AH N AA L AH JH AH S T S
NEUROENDOCRINOLOGY	N Y AH R OW EH N D AA K R AH N AA L AH JH IY
NEUROSECRETION	N Y AH R AA S AH K R IY SH AH N
NEUROSECRETIONS	N Y UH R AH S AH K R IY T IY AH N Z
NEUROSECRETORY	N Y UH R AH S EH K R AH T AO R IY
NONACCREDITED	N AA N AH K R EH D AH T IH D
NONACCRUAL	N AA N AH K R UW AH L
NONARISTOCRATIC	N AA N AH R IH S T AH K R AE T IH K
NONCREATIVE	N AA N K R IY EY T IH V
NONCREATIVITIES	N AA N K R IY EY T IH V AH T IY Z
NONCREATIVITY	N AA N K R IY EY T IH V AH T IY
NONCREDENTIALED	N AA N K R IH D EH N CH AH L D
NONCREDIT	N AA N K R EH D AH T
NONCRIME	N AA N K R AY M
NONCRIMES	N AA N K R AY M Z
NONCRIMINAL	N AA N K R IH M IH N AH L
NONCRIMINALS	N AA N K R IH M AH N AH L Z
NONCRISES	N AA N K R AY S IY Z
NONCRISIS	N AA N K R AY S AH S
NONCRITICAL	N AA N K R IH T IH K AH L
NONCROSSOVER	N AA N K R AO S OW V ER
NONCRUSHABLE	N AA N K R AH SH AH B AH L
NONCRYSTALLINE	N AA N K R IH S T AH L AH N
NONDECREASING	N AA N D IH K R IY S IH NG
NONDEMOCRATIC	N AA N D EH M AH K R AE T IH K
NONDESCRIPT	N AA N D IH S K R IH P T
NONDESCRIPTIVE	N AA N D IH S K R IH P T IH V
NONDESCRIPTS	N AA N D IH S K R IH P T S
NONDISCRETIONARY	N AA N D IH S K R EH SH AH N EH R IY
NONDISCRIMINATION	N AA N D IH S K R IH M IH N EY SH AH N
NONDISCRIMINATIONS	N AA N D IH S K R IH M AH N EY SH AH N Z
NONDISCRIMINATORY	N AA N D IH S K R IH M AH N AH T AO R IY
NONINCREASING	N AA N IH N K R IY S IH NG
NONMICROBIAL	N AA N M AY K R OW B IY AH L
NONPRESCRIPTION	N AA N P R AH S K R IH P SH AH N
NONSECRETOR	N AA N S IH K R IY T ER
NONSECRETORIES	N AA N S IH K R IY T ER IY Z
NONSECRETORS	N AA N S IH K R IY T ER Z
NONSECRETORY	N AA N S IH K R IY T ER IY
NUTCRACKER	N AH T K R AE K ER
NUTCRACKERS	N AH T K R AE K ER Z
OCHLOCRACIES	AA K L AA K R AH S IY Z
OCHLOCRACY	AA K L AA K R AH S IY
OCHLOCRAT	AA K L AA K R AH T
OCHLOCRATIC	AA K L AA K R AH T AH K
OCHLOCRATICAL	AA K L AA K R AH T IH S AH L
OCHLOCRATS	AA K L AH K R EY T S
OCREA	AA K R IY AH
OCREAE	AA K R IY
OCREATE	AA K R IY EY T
OFFSCREEN	AO F S K R IY N
OLECRANON	AH L EH K R AH N AH N
OLECRANONS	AH L EH K R AH N AH N Z
OMICRON	AH M IH K R AH N
OMICRONS	AH M IH K R AH N Z
ONSCREEN	AA N S K R IY N
OUTCRAWL	AW T K R AO L
OUTCRAWLED	AW T K R AO L D
OUTCRAWLING	AW T K R AO L IH NG
OUTCRAWLS	AW T K R AO L Z
OUTCRIED	AW T K R AY D
OUTCRIES	AW T K R AY Z
OUTCROP	AW T K R AA P
OUTCROPPED	AW T K R AA P T
OUTCROPPING	AW T K R AA P IH NG
OUTCROPPINGS	AW T K R AA P IH NG Z
OUTCROPS	AW T K R AA P S
OUTCROSS	AW T K R AO S
OUTCROSSED	AW T K R AO S T
OUTCROSSES	AW T K R AO S IH Z
OUTCROSSING	AW T K R AO S IH NG
OUTCROW	AW T K R OW
OUTCROWED	AW T K R OW D
OUTCROWING	AW T K R OW IH NG
OUTCROWS	AW T K R OW Z
OUTCRY	AW T K R AY
OUTCRYING	AW T K R AY IH NG
OVERCRAM	OW V ER K R AE M
OVERCRAMMED	OW V ER K R AE M D
OVERCRAMMING	OW V ER K R AE M IH NG
OVERCRAMS	OW V ER K R AE M Z
OVERCREDULOUS	OW V ER K R EH JH AH L AH S
OVERCRITICAL	OW V ER K R IH T IH K AH L
OVERCROP	OW V ER K R AA P
OVERCROPPED	OW V ER K R AA P T
OVERCROPPING	OW V ER K R AA P IH NG
OVERCROPS	OW V ER K R AA P S
OVERCROWD	OW V ER K R AW D
OVERCROWDED	OW V ER K R AW D IH D
OVERCROWDING	OW V ER K R AW D IH NG
OVERCROWDS	OW V ER K R AW D Z
OVERPRESCRIBE	OW V ER P R IY S K R AY B
OVERPRESCRIBED	OW V ER P R IY S K R AY B D
OVERPRESCRIBES	OW V ER P R IY S K R AY B Z
OVERPRESCRIBING	OW V ER P R IY S K R AY B IH NG
OVERPRESCRIPTION	OW V ER P R IY S K R IH P SH AH N
OVERPRESCRIPTIONS	OW V ER P R IY S K R IH P SH AH N Z
OVERSCRUPULOUS	OW V ER S K R UW P Y AH L AH S
OVERSECRETION	OW V ER S IH K R IY SH AH N
OVERSECRETIONS	OW V ER S IH K R IY SH AH N Z
OVERSUBSCRIBE	OW V ER S AH B S K R AY B
OVERSUBSCRIBED	OW V ER S AH B S K R AY B D
OVERSUBSCRIBES	OW V ER S AH B S K R AY B Z
OVERSUBSCRIBING	OW V ER S AH B S K R AY B IH NG
OVERSUBSCRIPTION	OW V ER S AH B S K R IH P SH AH N
OVERSUBSCRIPTIONS	OW V ER S AH B S K R IH P SH AH N Z
PANCRATIA	P AE NG K R EY SH IY AH
PANCRATIUM	P AE NG K R EY T IY AH M
PANCRATIUMS	P AE NG K R EY T IY AH M Z
PANCREAS	P AE N K R IY AH S
PANCREASES	P AE N K R IY S IH Z
PANCREATECTOMIES	P AE NG K R AH T EH K T AH M AY Z
PANCREATECTOMIZED	P AE NG K R AH T EH K T AH M AY Z D
PANCREATECTOMY	P AE NG K R AH T EH K T AH M IY
PANCREATIC	P AE N K R IY AE T IH K
PANCREATIN	P AE NG K R IY T AH N
PANCREATINS	P AE NG K R IY T AH N Z
PANCREATITIDES	P AE NG K R IY T AH T AY D Z
PANCREATITIS	P AE N K R IY EY T AH T IY Z
PANCREOZYMIN	P AE NG K R IY AA Z AH M AH N
PANCREOZYMINS	P AE NG K R IY AA Z AH M AH N Z
PANTISOCRACIES	P AE N T AH S AA K R AH S IY Z
PANTISOCRACY	P AE N T AH S AA K R AH S IY
PANTISOCRATIC	P AE N T AH S AA K R AH T AH K
PANTISOCRATICAL	P AE N T AH S AA K R AH T IH S AH L
PANTISOCRATIST	P AE N T IH S AH K R EY T AH S T
PANTISOCRATISTS	P AE N T AH S AA K R AH T AH S T S
PENNYCRESS	P EH N IH K R AH S
PENNYCRESSES	P EH N IH K R EH S AH Z
PERICRANIA	P AH R IH K R EY N Y AH
PERICRANIAL	P AH R IH K R EY N IY AH L
PERICRANIUM	P AH R IH K R EY N IY AH M
PHENOCRYST	F AH N AA K R AH S T
PHENOCRYSTIC	F AH N AA K R AH S T AH K
PHENOCRYSTS	F AH N AA K R AH S T S
PHOSPHOCREATINE	F AA S AA K R AH T AY N
PHOSPHOCREATINES	F AA S AA K R AH T AY N Z
PHOTOMICROGRAPH	F OW T AH M AY K R AH G R AE F
PHOTOMICROGRAPHIC	F OW T AH M AY K R AH G R AE F IH K
PHOTOMICROGRAPHIES	F OW T AH M AY K R AA G R AH F IY Z
PHOTOMICROGRAPHS	F OW T AH M AY K R AH G R AE F S
PHOTOMICROGRAPHY	F OW T AH M AY K R AA G R AH F IY
PHYSIOCRATIC	F IH S IY AA K R AH T AH K
PICRATE	P IH K R EY T
PICRATED	P IH K R EY T AH D
PICRATES	P IH K R EY T S
PICRIC	P IH K R AH K
PICRITE	P IH K R AY T
PICRITES	P IH K R AY T S
PICRITIC	P IH K R AH T AH K
PICROTOXIN	P IH K R AH T AA K S AH N
PICROTOXINS	P IH K R AH T AA K S AH N Z
PIECRUST	P AY K R AH S T
PIECRUSTS	P AY K R AH S T S
PLANTOCRACIES	P L AE N T AA K R AH S IY Z
PLANTOCRACY	P L AE N T AA K R AH S IY
PLUTOCRACIES	P L UW T AA K R AH S IY Z
PLUTOCRACY	P L UW T AA K R AH S IY
PLUTOCRAT	P L UW T AH K R AE T
PLUTOCRATIC	P L UW T AA K R AH T AH K
PLUTOCRATICALLY	P L UW T AA K R AE T AH K AE L IY
PLUTOCRATS	P L UW T AH K R AE T S
POLYACRYLAMIDE	P AH L AY AE K R IH L AH M AY D
POLYACRYLAMIDES	P AH L AY AE K R IH L AH M AY D Z
POLYACRYLONITRILE	P AA L AY AE K R IH L AH N IH T R AH L
POLYACRYLONITRILES	P AA L AY AE K R IH L AH N IH T R AH L Z
POLYCRYSTAL	P OW L IY K R IH S T AH L
POLYCRYSTALLINE	P OW L IY K R IH S T AH L AH N
POLYCRYSTALS	P OW L IY K R IH S T AH L Z
POSTCRANIAL	P OW S T K R EY N IY AH L
POSTCRANIALLY	P OW S T K R EY N IY AH L IY
POSTCRASH	P OW S T K R AE SH
POSTCRISES	P OW S T K R AY S IY Z
POSTCRISIS	P OW S T K R AY S AH S
POSTSCRIPT	P OW S K R IH P T
POSTSCRIPT(2)	P OW S T S K R IH P T
POSTSCRIPTS	P OW S T S K R IH P T S
POSTTRANSCRIPTIONAL	P OW S T R AE N S K R IH P SH AH N AH L
PRECRASH	P R IY K R AE SH
PRECREASE	P R IY K R IY S
PRECREASED	P R IY K R IY S T
PRECREASES	P R IY K R IY S IH Z
PRECREASING	P R IY K R IY S IH NG
PRECRISIS	P R IY K R AY S AH S
PRECRITICAL	P R IY K R IH T IH K AH L
PRESCREEN	P R IY S K R IY N
PRESCREENED	P R IY S K R IY N D
PRESCREENING	P R IY S K R IY N IH NG
PRESCREENINGS	P R IY S K R IY N IH NG Z
PRESCREENS	P R IY S K R IY N Z
PRESCRIBE	P R AH S K R AY B
PRESCRIBE(2)	P R IY S K R AY B
PRESCRIBED	P R IY S K R AY B D
PRESCRIBER	P R IY S K R AY B ER
PRESCRIBERS	P R IY S K R AY B ER Z
PRESCRIBES	P R IY S K R AY B Z
PRESCRIBING	P R IY S K R AY B IH NG
PRESCRIPT	P R IY S K R IH P T
PRESCRIPTION	P R AH S K R IH P SH AH N
PRESCRIPTIONS	P R AH S K R IH P SH AH N Z
PRESCRIPTIVE	P R IY S K R IH P T IH V
PRESCRIPTIVELY	P R IY S K R IH P T IH V L IY
PRESCRIPTS	P R IY S K R IH P T S
PROCRASTINATE	P R AH K R AE S T AH N EY T
PROCRASTINATED	P R AH K R AE S T AH N EY T AH D
PROCRASTINATES	P R AH K R AE S T AH N EY T S
PROCRASTINATING	P R AH K R AE S T AH N EY T IH NG
PROCRASTINATION	P R AH K R AE S T AH N EY SH AH N
PROCRASTINATIONS	P R AH K R AE S T AH N EY SH AH N Z
PROCRASTINATOR	P R AH K R AE S T AH N EY T ER
PROCRASTINATORS	P R AH K R AE S T AH N EY T ER Z
PROCREANT	P R OW K R IY AH N T
PROCREATE	P R OW K R IY EY T
PROCREATED	P R OW K R IY EY T AH D
PROCREATES	P R OW K R IY EY T S
PROCREATING	P R OW K R IY EY T IH NG
PROCREATION	P R OW K R IY EY SH AH N
PROCREATIONS	P R OW K R IY EY SH AH N Z
PROCREATIVE	P R OW K R IY EY T IH V
PROCREATOR	P R OW K R IY EY T ER
PROCREATORS	P R OW K R IY EY T ER Z
PROCRUSTEAN	P R OW K R AH S T IY AH N
PROCRYPTIC	P R OW K R IH P T IH K
PROSCRIBE	P R OW S K R AY B
PROSCRIBED	P R OW S K R AY B D
PROSCRIBER	P R OW S K R AY B ER
PROSCRIBERS	P R OW S K R AY B ER Z
PROSCRIBES	P R OW S K R AY B Z
PROSCRIBING	P R OW S K R AY B IH NG
PROSCRIPTION	P R OW S K R IH P SH AH N
PROSCRIPTIONS	P R OW S K R IH P SH AH N Z
PROSCRIPTIVE	P R OW S K R IH P T IH V
PROSCRIPTIVELY	P R OW S K R IH P T IH V L IY
QUASICRYSTAL	K W AH S IH K R IH S T AH L
QUASICRYSTALLINE	K W AH S AH K R IH S T AH L AY N
QUASICRYSTALS	K W AA S AH K R IH S T AH L Z
QUINACRINE	K W IH N AH K R AY N
QUINACRINES	K W IH N AH K R AY N Z
REACCREDIT	R IY AH K R EH D AH T
REACCREDITATION	R IY AH K R EH D AH T EY SH AH N
REACCREDITATIONS	R IY AH K R EH D AH T EY SH AH N Z
REACCREDITED	R IY AH K R EH D AH T IH D
REACCREDITING	R IY AH K R EH D AH T IH NG
REACCREDITS	R IY AH K R EH D AH T S
RECONSECRATE	R IY K AA N S AH K R EY T
RECONSECRATED	R IY K AA N S AH K R EY T IH D
RECONSECRATES	R IY K AA N S AH K R EY T S
RECONSECRATING	R IY K AA N S AH K R EY T IH NG
RECONSECRATION	R IY K AA N S AH K R EY SH AH N
RECONSECRATIONS	R IY K AA N S AH K R EY SH AH N Z
RECRATE	R IY K R EY T
RECRATED	R IY K R EY T IH D
RECRATES	R IY K R EY T S
RECRATING	R IY K R EY T IH NG
RECREANT	R IH K R IY AH N T
RECREANTS	R IH K R IY N T S
RECREATE	R EH K R IY EY T
RECREATE(2)	R IY K R IY EY T
RECREATED	R EH K R IY EY T IH D
RECREATED(2)	R IY K R IY EY T IH D
RECREATES	R EH K R IY EY T S
RECREATES(2)	R IY K R IY EY T S
RECREATING	R EH K R IY EY T IH NG
RECREATING(2)	R IY K R IY EY T IH NG
RECREATION	R EH K R IY EY SH AH N
RECREATIONAL	R EH K R IY EY SH AH N AH L
RECREATIONIST	R EH K R IY EY SH AH N IH S T
RECREATIONISTS	R EH K R IY EY SH AH N IH S T S
RECREATIONS	R EH K R IY EY SH AH N Z
RECREATIVE	R EH K R IY EY T IH V
RECRIMINATE	R IH K R IH M IH N EY T
RECRIMINATED	R IY K R IH M AH N EY T IH D
RECRIMINATES	R IY K R IH M AH N AH T S
RECRIMINATING	R IY K R IH M AH N EY T IH NG
RECRIMINATION	R IH K R IH M IH N EY SH AH N
RECRIMINATIONS	R IH K R IH M IH N EY SH AH N Z
RECRIMINATIVE	R IY K R IH M AH N AH T IH V
RECRIMINATORY	R IY K R IH M AH N AH T OW R IY
RECROSS	R IY K R AO S
RECROSSED	R IY K R AO S T
RECROSSES	R IY K R AO S IH Z
RECROSSING	R IY K R AO S IH NG
RECROWN	R IY K R AW N
RECROWNED	R IY K R AW N D
RECROWNING	R IY K R AW N IH NG
RECROWNS	R IY K R AW N Z
RECRUDESCE	R IH K R AH D EH S
RECRUDESCED	R IH K R AH D EH S T
RECRUDESCENCE	R IH K R AH D EH S AH N S
RECRUDESCENCES	R IH K R AH D AH S EH N S AH Z
RECRUDESCENT	R IY K R UW D S EH N T
RECRUDESCES	R IH K R AH D EH S AH Z
RECRUDESCING	R IH K R AH D EH S AH NG
RECRUIT	R AH K R UW T
RECRUIT(2)	R IH K R UW T
RECRUIT(3)	R IY K R UW T
RECRUITED	R IH K R UW T IH D
RECRUITED(2)	R IY K R UW T IH D
RECRUITER	R IH K R UW T ER
RECRUITERS	R IH K R UW T ER Z
RECRUITING	R AH K R UW T IH NG
RECRUITING(2)	R IH K R UW T IH NG
RECRUITING(3)	R IY K R UW T IH NG
RECRUITMENT	R AH K R UW T M AH N T
RECRUITMENT(2)	R IH K R UW T M AH N T
RECRUITMENT(3)	R IY K R UW T M AH N T
RECRUITMENTS	R IH K R UW T M AH N T S
RECRUITS	R AH K R UW T S
RECRUITS(2)	R IH K R UW T S
RECRUITS(3)	R IY K R UW T S
RECRYSTALLIZATION	R IY K R IH S T AH L AH Z EY SH AH N
RECRYSTALLIZATIONS	R IY K R IH S T AH L AH Z EY SH AH N Z
RECRYSTALLIZE	R IY K R IH S T AH L AY Z
RECRYSTALLIZED	R IY K R IH S T AH L AY Z D
RECRYSTALLIZES	R IY K R IH S T AH L AY Z IH Z
RECRYSTALLIZING	R IY K R IH S T AH L AY Z IH NG
REDESCRIBE	R IY D IY S K R AY B
REDESCRIBED	R IY D IY S K R AY B D
REDESCRIBES	R IY D IY S K R AY B Z
REDESCRIBING	R IY D IY S K R AY B IH NG
REDESCRIPTION	R IY D IY S K R IH P SH AH N
REDESCRIPTIONS	R IY D IY S K R IH P SH AH N Z
RESCREEN	R IY S K R IY N
RESCREENED	R IY S K R IY N D
RESCREENING	R IY S K R IY N IH NG
RESCREENS	R IY S K R IY N Z
RESCRIPT	R IY S K R IH P T
RESCRIPTS	R IY S K R IH P T S
RICRAC	R IH K R AH K
RICRACS	R IH K R AH S
ROTORCRAFT	R OW T ER K R AE F T
SACRA	S AE K R AH
SACRAL	S EY K R AH L
SACRALS	S EY K R AH L Z
SACRAMENT	S AE K R AH M AH N T
SACRAMENTAL	S AE K R AH M AH N T AH L
SACRAMENTALISM	S AE K R AH M AH N T AH L IH Z AH M
SACRAMENTALISMS	S AE K R AH M AH N T AH L IH Z AH M Z
SACRAMENTALIST	S AE K R AH M AH N T AH L IH S T
SACRAMENTALISTS	S AE K R AH M AH N T AH L IH S T S
SACRAMENTALLY	S AE K R AH M AH N T AH L IY
SACRAMENTALS	S AE K R AH M AH N T AH L Z
SACRAMENTS	S AE K R AH M AH N T S
SACRARIA	S AE K R AE R IY AH
SACRARIUM	S AE K R AE R IY AH M
SACRED	S EY K R AH D
SACRED(2)	S EY K R IH D
SACREDLY	S EY K R AH D L IY
SACREDNESS	S EY K R IH D N IH S
SACREDNESSES	S EY K R AH D N AH S IH Z
SACRIFICE	S AE K R AH F AY S
SACRIFICED	S AE K R AH F AY S T
SACRIFICER	S AE K R AH F AY S ER
SACRIFICERS	S AE K R AH F AY S ER Z
SACRIFICES	S AE K R AH F AY S IH Z
SACRIFICIAL	S AE K R AH F IH SH AH L
SACRIFICIALLY	S AE K R AH F IH SH AH L IY
SACRIFICING	S AE K R AH F AY S IH NG
SACRILEGE	S AE K R AH L AH JH
SACRILEGES	S AE K R AH L IH JH IH Z
SACRILEGIOUS	S AE K R AH L EH JH IH S
SACRILEGIOUSLY	S AE K R AH L IH JH IY AH S L IY
SACRILEGIOUSNESS	S AE K R AH L IH JH IY AH S N AH S
SACRILEGIOUSNESSES	S AE K R AH L IH JH IY AH S N AH S IH Z
SACRING	S EY K R AH NG
SACRINGS	S AE K R AH NG Z
SACRIST	S AE K R AH S T
SACRISTAN	S AE K R IH S T AH N
SACRISTANS	S AE K R IH S T AH N Z
SACRISTIES	S AE K R IH S T AY Z
SACRISTS	S AE K R AH S T S
SACRISTY	S AE K R IH S T IY
SACROILIAC	S AE K R OY L IY AH K
SACROILIACS	S AE K R OY L IY AH S
SACROSANCT	S AE K R OW S AE NG K T
SACROSANCTITIES	S AE K R OW S AE NG K T AH T IY Z
SACROSANCTITY	S AE K R OW S AE NG K T AH T IY
SACRUM	S AE K R AH M
SACRUMS	S AE K R AH M Z
SAFECRACKER	S EY F K R AE K ER
SAFECRACKERS	S EY F K R AE K ER Z
SAFECRACKING	S EY F K R AE K IH NG
SAFECRACKINGS	S EY F K R AE K IH NG Z
SCARECROW	S K AE R K R OW
SCARECROWS	S K AE R K R OW Z
SCOUTCRAFT	S K AW T K R AE F T
SCOUTCRAFTS	S K AW T K R AE F T S
SCRABBLE	S K R AE B AH L
SCRABBLED	S K R AE B AH L D
SCRABBLER	S K R AE B L AH R
SCRABBLERS	S K R AE B L AH R Z
SCRABBLES	S K R AE B AH L Z
SCRABBLIER	S K R AE B L AY AH R
SCRABBLIEST	S K R AE B L AY AH S T
SCRABBLING	S K R AE B L AH NG
SCRABBLY	S K R AE B L IY
SCRAG	S K R AE G
SCRAGGED	S K R AE G D
SCRAGGIER	S K R AE JH AY AH R
SCRAGGIEST	S K R AE JH AY AH S T
SCRAGGING	S K R AE G AH NG
SCRAGGLIER	S K R AE G L IY ER
SCRAGGLIEST	S K R AE G L IY AH S T
SCRAGGLY	S K R AE G L IY
SCRAGGY	S K R AE G IY
SCRAGS	S K R AE G Z
SCRAICH	S K R EY CH
SCRAICHED	S K R EY CH T
SCRAICHING	S K R EY CH AH NG
SCRAICHS	S K R EY CH S
SCRAIGH	S K R EY
SCRAIGHED	S K R EY D
SCRAIGHING	S K R EY AH NG
SCRAIGHS	S K R EY Z
SCRAM	S K R AE M
SCRAMBLE	S K R AE M B AH L
SCRAMBLED	S K R AE M B AH L D
SCRAMBLER	S K R AE M B AH L ER
SCRAMBLERS	S K R AE M B AH L ER Z
SCRAMBLES	S K R AE M B AH L Z
SCRAMBLING	S K R AE M B AH L IH NG
SCRAMBLING(2)	S K R AE M B L IH NG
SCRAMJET	S K R AE M JH AH T
SCRAMJETS	S K R AE M JH AH T S
SCRAMMED	S K R AE M D
SCRAMMING	S K R AE M AH NG
SCRAMS	S K R AE M Z
SCRANNEL	S K R AE N AH L
SCRANNELS	S K R AE N AH L Z
SCRAP	S K R AE P
SCRAPBOOK	S K R AE P B UH K
SCRAPBOOKS	S K R AE P B UH K S
SCRAPE	S K R EY P
SCRAPED	S K R EY P T
SCRAPER	S K R EY P ER
SCRAPERS	S K R EY P ER Z
SCRAPES	S K R EY P S
SCRAPHEAP	S K R AE P HH IY P
SCRAPHEAPS	S K R AE P HH IY P S
SCRAPIE	S K R EY P IY
SCRAPIES	S K R EY P IY Z
SCRAPING	S K R EY P IH NG
SCRAPINGS	S K R EY P IH NG Z
SCRAPPAGE	S K R AE P IH JH
SCRAPPAGES	S K R AE P IH JH IH Z
SCRAPPED	S K R AE P T
SCRAPPER	S K R AE P ER
SCRAPPERS	S K R AE P ER Z
SCRAPPIER	S K R AE P IY ER
SCRAPPIEST	S K R AE P IY AH S T
SCRAPPILY	S K R AE P IY L IY
SCRAPPINESS	S K R AE P IY N AH S
SCRAPPINESSES	S K R AE P IY N AH S IH Z
SCRAPPING	S K R AE P IH NG
SCRAPPLE	S K R AE P AH L
SCRAPPLES	S K R AE P AH L Z
SCRAPPY	S K R AE P IY
SCRAPS	S K R AE P S
SCRATCH	S K R AE CH
SCRATCHBOARD	S K R AE CH B OW R D
SCRATCHBOARDS	S K R AE CH B OW R D Z
SCRATCHED	S K R AE CH T
SCRATCHER	S K R AE CH ER
SCRATCHERS	S K R AE CH ER Z
SCRATCHES	S K R AE CH AH Z
SCRATCHES(2)	S K R AE CH IH Z
SCRATCHIER	S K R AE CH IY ER
SCRATCHIEST	S K R AE CH IY AH S T
SCRATCHILY	S K R AE CH IY L IY
SCRATCHINESS	S K R AE CH IY N AH S
SCRATCHINESSES	S K R AE CH IY N AH S IH Z
SCRATCHING	S K R AE CH IH NG
SCRATCHY	S K R AE CH IY
SCRAWL	S K R AO L
SCRAWLED	S K R AO L D
SCRAWLER	S K R AO L ER
SCRAWLERS	S K R AO L ER Z
SCRAWLIER	S K R AO L IY ER
SCRAWLIEST	S K R AO L IY AH S T
SCRAWLING	S K R AO L IH NG
SCRAWLS	S K R AO L Z
SCRAWLY	S K R AO L IY
SCRAWNIER	S K R AO N IY ER
SCRAWNIEST	S K R AO N IY AH S T
SCRAWNINESS	S K R AO N IY N AH S
SCRAWNINESSES	S K R AO N IY N AH S IH Z
SCRAWNY	S K R AO N IY
SCREAK	S K R IY K
SCREAKED	S K R IY K T
SCREAKING	S K R IY K AH NG
SCREAKS	S K R IY K S
SCREAKY	S K R IY K IY
SCREAM	S K R IY M
SCREAMED	S K R IY M D
SCREAMER	S K R IY M ER
SCREAMERS	S K R IY M ER Z
SCREAMING	S K R IY M IH NG
SCREAMINGLY	S K R IY M IH NG L IY
SCREAMS	S K R IY M Z
SCREE	S K R IY
SCREECH	S K R IY CH
SCREECHED	S K R IY CH T
SCREECHER	S K R IY CH ER
SCREECHERS	S K R IY CH ER Z
SCREECHES	S K R IY CH IH Z
SCREECHIER	S K R IY CH IY ER
SCREECHIEST	S K R IY CH IY AH S T
SCREECHING	S K R IY CH IH NG
SCREECHY	S K R IY CH IY
SCREED	S K R IY D
SCREEDED	S K R IY D AH D
SCREEDING	S K R IY D AH NG
SCREEDS	S K R IY D Z
SCREEN	S K R IY N
SCREENABLE	S K R IY N AH B AH L
SCREENED	S K R IY N D
SCREENER	S K R IY N ER
SCREENERS	S K R IY N ER Z
SCREENING	S K R IY N IH NG
SCREENINGS	S K R IY N IH NG Z
SCREENLAND	S K R IY N L AE N D
SCREENLANDS	S K R IY N L AE N D Z
SCREENPLAY	S K R IY N P L EY
SCREENPLAYS	S K R IY N P L EY Z
SCREENS	S K R IY N Z
SCREENWRITER	S K R IY N R AY T ER
SCREENWRITERS	S K R IY N R AY T ER Z
SCREES	S K R IY Z
SCREW	S K R UW
SCREWBALL	S K R UW B AO L
SCREWBALLS	S K R UW B AO L Z
SCREWBEAN	S K R UW B IY N
SCREWBEANS	S K R UW B IY N Z
SCREWDRIVER	S K R UW D R AY V ER
SCREWDRIVERS	S K R UW D R AY V ER Z
SCREWED	S K R UW D
SCREWER	S K R UW ER
SCREWERS	S K R UW ER Z
SCREWIER	S K R UW IY ER
SCREWIEST	S K R UW IY AH S T
SCREWINESS	S K R UW IY N AH S
SCREWINESSES	S K R UW IY N AH S IH Z
SCREWING	S K R UW IH NG
SCREWLIKE	S K R UW L AY K
SCREWS	S K R UW Z
SCREWUP	S K R UW AH P
SCREWUPS	S K R UW AH P S
SCREWWORM	S K R UW W ER M
SCREWWORMS	S K R UW W ER M Z
SCREWY	S K R UW IY
SCRIBAL	S K R AY B AH L
SCRIBBLE	S K R IH B AH L
SCRIBBLED	S K R IH B AH L D
SCRIBBLER	S K R IH B L ER
SCRIBBLERS	S K R IH B L ER Z
SCRIBBLES	S K R IH B AH L Z
SCRIBBLING	S K R IH B AH L IH NG
SCRIBBLING(2)	S K R IH B L IH NG
SCRIBBLINGS	S K R IH B AH L IH NG Z
SCRIBE	S K R AY B
SCRIBED	S K R AY B D
SCRIBER	S K R AY B ER
SCRIBERS	S K R AY B ER Z
SCRIBES	S K R AY B Z
SCRIBING	S K R AY B IH NG
SCRIED	S K R AY D
SCRIES	S K R AY Z
SCRIEVE	S K R IY V
SCRIEVED	S K R IY V D
SCRIEVES	S K R IY V Z
SCRIEVING	S K R IY V AH NG
SCRIM	S K R IH M
SCRIMMAGE	S K R IH M IH JH
SCRIMMAGED	S K R IH M IH JH D
SCRIMMAGER	S K R IH M IH JH ER
SCRIMMAGERS	S K R IH M IH JH ER Z
SCRIMMAGES	S K R IH M IH JH IH Z
SCRIMMAGING	S K R IH M IH JH IH NG
SCRIMP	S K R IH M P
SCRIMPED	S K R IH M P EH D
SCRIMPER	S K R IH M P AH R
SCRIMPERS	S K R IH M P AH R Z
SCRIMPIER	S K R IH M P IH ER
SCRIMPIEST	S K R IH M P AY AH S T
SCRIMPING	S K R IH M P IH NG
SCRIMPIT	S K R IH M P IH T
SCRIMPS	S K R IH M P S
SCRIMPY	S K R IH M P IY
SCRIMS	S K R IH M Z
SCRIMSHANDER	S K R IH M Z HH AE N D ER
SCRIMSHANDERS	S K R IH M Z HH AE N D ER Z
SCRIMSHAW	S K R IH M SH AO
SCRIMSHAWED	S K R IH M SH AO D
SCRIMSHAWING	S K R IH M SH AO IH NG
SCRIMSHAWS	S K R IH M SH AO Z
SCRIP	S K R IH P
SCRIPS	S K R IH P S
SCRIPT	S K R IH P T
SCRIPTED	S K R IH P T IH D
SCRIPTER	S K R IH P T ER
SCRIPTERS	S K R IH P T ER Z
SCRIPTING	S K R IH P T IH NG
SCRIPTORIA	S K R IH P T AO R IY AH
SCRIPTORIUM	S K R IH P T AO R IY AH M
SCRIPTORIUMS	S K R IH P T AO R IY AH M Z
SCRIPTS	S K R IH P T S
SCRIPTS(2)	S K R IH P S
SCRIPTURAL	S K R IH P CH ER AH L
SCRIPTURALLY	S K R IH P CH ER AH L IY
SCRIPTURE	S K R IH P CH ER
SCRIPTURES	S K R IH P CH ER Z
SCRIPTWRITER	S K R IH P T R AY T ER
SCRIPTWRITERS	S K R IH P T R AY T ER Z
SCRIVE	S K R AY V
SCRIVED	S K R AY V D
SCRIVENER	S K R IH V N ER
SCRIVENERS	S K R IH V N ER Z
SCRIVES	S K R AY V Z
SCRIVING	S K R AY V AH NG
SCROD	S K R AA D
SCRODS	S K R AA D Z
SCROFULA	S K R AA F Y UW L AH
SCROFULAS	S K R AA F Y UW L AH Z
SCROFULOUS	S K R AA F Y AH L AH S
SCROGGIER	S K R AA JH AY AH R
SCROGGIEST	S K R AA JH AY AH S T
SCROGGY	S K R AA G IY
SCROLL	S K R OW L
SCROLLED	S K R AA L D
SCROLLING	S K R AA L AH NG
SCROLLS	S K R OW L Z
SCROLLWORK	S K R AA L W AH R K
SCROLLWORKS	S K R AA L W AH R K S
SCROOCH	S K R UW CH
SCROOCHED	S K R UW CH T
SCROOCHES	S K R UW CH AH Z
SCROOCHING	S K R UW CH AH NG
SCROOGE	S K R UW JH
SCROOGES	S K R UW JH AH Z
SCROOP	S K R UW P
SCROOPED	S K R UW P T
SCROOPING	S K R UW P AH NG
SCROOPS	S K R UW P S
SCROOTCH	S K R UW CH
SCROOTCHED	S K R UW CH T
SCROOTCHES	S K R UW CH AH Z
SCROOTCHING	S K R UW CH AH NG
SCROTA	S K R AA T AH
SCROTAL	S K R AA T AH L
SCROTUM	S K R AA T AH M
SCROTUMS	S K R AA T AH M Z
SCROUGE	S K R AW JH
SCROUGED	S K R AW JH D
SCROUGES	S K R AW JH AH Z
SCROUGING	S K R AW JH AH NG
SCROUNGE	S K R AW N JH
SCROUNGED	S K R AW N JH D
SCROUNGER	S K R AW N JH ER
SCROUNGERS	S K R AW N JH ER Z
SCROUNGES	S K R AW N JH IH Z
SCROUNGIER	S K R AW N JH IY ER
SCROUNGIEST	S K R AW N JH IY AH S T
SCROUNGING	S K R AW N JH IH NG
SCROUNGY	S K R AW N JH IY
SCRUB	S K R AH B
SCRUBBABLE	S K R AH B AH B AH L
SCRUBBED	S K R AH B D
SCRUBBER	S K R AH B ER
SCRUBBERS	S K R AH B ER Z
SCRUBBIER	S K R AH B IY ER
SCRUBBIEST	S K R AH B IY AH S T
SCRUBBING	S K R AH B IH NG
SCRUBBY	S K R AH B IY
SCRUBLAND	S K R AH B L AE N D
SCRUBLANDS	S K R AH B L AE N D Z
SCRUBS	S K R AH B Z
SCRUBWOMAN	S K R AH B W UH M AH N
SCRUBWOMEN	S K R AH B W IH M AH N
SCRUFF	S K R AH F
SCRUFFIER	S K R AH F AY AH R
SCRUFFIEST	S K R AH F AY AH S T
SCRUFFILY	S K R AH F AH L IY
SCRUFFINESS	S K R AH F AH N AH S
SCRUFFINESSES	S K R AH F AH N EH S AH Z
SCRUFFS	S K R AH F S
SCRUFFY	S K R AH F IY
SCRUM	S K R AH M
SCRUMMAGE	S K R AH M AH JH
SCRUMMAGED	S K R AH M AH JH D
SCRUMMAGES	S K R AH M AH JH AH Z
SCRUMMAGING	S K R AH M AH JH AH NG
SCRUMMED	S K R AH M D
SCRUMMING	S K R AH M AH NG
SCRUMPTIOUS	S K R AH M P SH AH S
SCRUMPTIOUSLY	S K R AH M P SH AH S L IY
SCRUMS	S K R AH M Z
SCRUNCH	S K R AH N CH
SCRUNCHED	S K R AH N CH T
SCRUNCHES	S K R AH N CH AH Z
SCRUNCHING	S K R AH N CH AH NG
SCRUPLE	S K R UW P AH L
SCRUPLED	S K R AH P AH L D
SCRUPLES	S K R UW P AH L Z
SCRUPLING	S K R AH P L AH NG
SCRUPULOSITIES	S K R UW P Y AH L AA S AH T IY Z
SCRUPULOSITY	S K R UW P Y AH L AA S AH T IY
SCRUPULOUS	S K R UW P Y AH L AH S
SCRUPULOUSLY	S K R UW P Y AH L AH S L IY
SCRUPULOUSNESS	S K R UW P Y AH L AH S N AH S
SCRUPULOUSNESSES	S K R UW P Y AH L AH S N AH S IH Z
SCRUTABLE	S K R UW T AH B AH L
SCRUTINEER	S K R UW T AH N IH R
SCRUTINEERS	S K R UW T AH N AH R Z
SCRUTINIES	S K R UW T AH N IY Z
SCRUTINISE	S K R UW T AH N AY Z
SCRUTINISED	S K R UW T AH N IY Z D
SCRUTINISES	S K R UW T AH N IY Z IH Z
SCRUTINISING	S K R UW T AH N IY Z IH NG
SCRUTINIZE	S K R UW T AH N AY Z
SCRUTINIZED	S K R UW T AH N AY Z D
SCRUTINIZER	S K R UW T AH N AY Z AH R
SCRUTINIZERS	S K R UW T IH N AH Z AH R Z
SCRUTINIZES	S K R UW T AH N AY Z IH Z
SCRUTINIZING	S K R UW T AH N AY Z IH NG
SCRUTINY	S K R UW T AH N IY
SCRY	S K R AY
SCRYING	S K R AY AH NG
SEACRAFT	S IY K R AE F T
SEACRAFTS	S IY K R AE F T S
SECRECIES	S IY K R AH S IY Z
SECRECY	S IY K R AH S IY
SECRET	S IY K R AH T
SECRET(2)	S IY K R IH T
SECRETAGOGUE	S EH K R EH T AH G AH G
SECRETAGOGUES	S EH K R EH T AH G AH G Z
SECRETARIAL	S EH K R AH T EH R IY AH L
SECRETARIAT	S EH K R IH T EH R IY AH T
SECRETARIATS	S EH K R AH T EH R IY AH T S
SECRETARIES	S EH K R AH T EH R IY Z
SECRETARY	S EH K R AH T EH R IY
SECRETARYSHIP	S EH K R AH T EH R IY SH IH P
SECRETARYSHIPS	S EH K R AH T EH R IY SH IH P S
SECRETE	S IH K R IY T
SECRETED	S AH K R IY T AH D
SECRETER	S IH K R IY T ER
SECRETES	S IH K R IY T S
SECRETEST	S IH K R IY T AH S T
SECRETIN	S IY K R AH T IH N
SECRETING	S IH K R IY T IH NG
SECRETINS	S IY K R AH T IH N Z
SECRETION	S AH K R IY SH AH N
SECRETIONARY	S IH K R IY SH AH N EH R IY
SECRETIONS	S AH K R IY SH AH N Z
SECRETIVE	S IY K R AH T IH V
SECRETIVELY	S IY K R AH T IH V L IY
SECRETIVENESS	S IY K R AH T IH V N AH S
SECRETIVENESSES	S IY K R AH T IH V N AH S IH Z
SECRETLY	S IY K R IH T L IY
SECRETOR	S IH K R IY T ER
SECRETORS	S IH K R IY T ER Z
SECRETORY	S IH K R IY T ER IY
SECRETS	S IY K R IH T S
SEMICRYSTALLINE	S EH M IY K R IH S T AH L AH N
SEMIMICRO	S AH M AH M IH K R OW
SEMISACRED	S EH M IY S EY K R AH D
SEMISECRET	S EH M IY S IY K R AH T
SETSCREW	S EH T S K R UW
SETSCREWS	S EH T S K R UW Z
SHARECROP	SH EH R K R AA P
SHARECROPPED	SH EH R K R AA P T
SHARECROPPER	SH EH R K R AA P ER
SHARECROPPERS	SH EH R K R AA P ER Z
SHARECROPPING	SH EH R K R AA P IH NG
SHARECROPS	SH EH R K R AA P S
SHELLCRACKER	SH EH L K R AE K ER
SHELLCRACKERS	SH EH L K R AE K ER Z
SILKSCREEN	S IH L K S K R IY N
SILKSCREENS	S IH L K S K R IY N Z
SIMULACRA	S IH M Y AH L AE K R AH
SIMULACRE	S IH M Y UW L AH K AH R
SIMULACRES	S IH M Y UW L AH K AH R Z
SIMULACRUM	S IH M Y AH L AE K R AH M
SIMULACRUMS	S IH M Y AH L AE K R AH M Z
SKYSCRAPER	S K AY S K R EY P ER
SKYSCRAPERS	S K AY S K R EY P ER Z
SLAVOCRACIES	S L AH V AA K R AH S IY Z
SLAVOCRACY	S L AH V AA K R AH S IY
SMOKESCREEN	S M OW K S K R IY N
SMOKESCREENS	S M OW K S K R IY N Z
SPACECRAFT	S P EY S K R AE F T
SPACECRAFTS	S P EY S K R AE F T S
STAGECRAFT	S T EY JH K R AE F T
STAGECRAFTS	S T EY JH K R AE F T S
STATECRAFT	S T EY T K R AE F T
STATECRAFTS	S T EY T K R AE F T S
STAVESACRE	S T EY V Z EY K ER
STAVESACRES	S T EY V Z EY K ER Z
STEREOMICROSCOPE	S T EH R IY OW M AY K R AH S K OW P
STEREOMICROSCOPES	S T EH R IY OW M AY K R OW S K OW P S
STEREOMICROSCOPIC	S T EH R IY OW M AY K R AH S K AA P IH K
STEREOMICROSCOPICALLY	S T EH R IY OW M AY K R AH S K AA P IH K AH L IY
STONECROP	S T OW N K R AA P
STONECROPS	S T OW N K R AA P S
STRATOCRACIES	S T R AH T AA K R AH S IY Z
STRATOCRACY	S T R AH T AA K R AH S IY
SUBACRID	S AH B AE K R AH D
SUBCRITICAL	S AH B K R IH T IH K AH L
SUBCRUSTAL	S AH B K R AH S T AH L
SUBMICROGRAM	S AH B M AY K R OW G R AE M
SUBMICRON	S AH B M AY K R AA N
SUBMICROSCOPIC	S AH B M AY K R AH S K AA P IH K
SUBMICROSCOPICALLY	S AH B M AY K R AH S K AA P IH K AH L IY
SUBSCRIBE	S AH B S K R AY B
SUBSCRIBED	S AH B S K R AY B D
SUBSCRIBER	S AH B S K R AY B ER
SUBSCRIBERS	S AH B S K R AY B ER Z
SUBSCRIBES	S AH B S K R AY B Z
SUBSCRIBING	S AH B S K R AY B IH NG
SUBSCRIPT	S AH B S K R IH P T
SUBSCRIPTION	S AH B S K R IH P SH AH N
SUBSCRIPTIONS	S AH B S K R IH P SH AH N Z
SUBSCRIPTS	S AH B S K R IH P T S
SUBSECRETARIES	S AH B S EH K R AH T EH R IY Z
SUBSECRETARY	S AH B S EH K R AH T EH R IY
SUCRASE	S AH K R EY Z
SUCRASES	S AH K R EY Z AH Z
SUCRE	S UW K ER
SUCRES	S AH K AH R Z
SUCROSE	S UW K R OW S
SUCROSES	S AH K R OW Z AH Z
SUNSCREEN	S AH N S K R IY N
SUNSCREENING	S AH N S K R IY N IH NG
SUNSCREENS	S AH N S K R IY N Z
SUPERBUREAUCRAT	S UW P ER B Y UH R AH K R AE T
SUPERBUREAUCRATS	S UW P ER B Y UH R AH K R AE T S
SUPERCRIMINAL	S UW P ER K R IH M AH N AH L
SUPERCRIMINALS	S UW P ER K R IH M AH N AH L Z
SUPERCRITICAL	S UW P ER K R IH T IH K AH L
SUPERMICRO	S UW P AH R M IH K R OW
SUPERMICROS	S UW P AH R M IH K R AH Z
SUPERSCRIBE	S UW P ER S K R AY B
SUPERSCRIBED	S UW P ER S K R AY B D
SUPERSCRIBES	S UW P ER S K R AY B Z
SUPERSCRIBING	S UW P ER S K R AY B IH NG
SUPERSCRIPT	S UW P ER S K R IH P T
SUPERSCRIPTION	S UW P ER S K R IH P SH AH N
SUPERSCRIPTIONS	S UW P ER S K R IH P SH AH N Z
SUPERSCRIPTS	S UW P ER S K R IH P T S
SUPERSECRECIES	S UW P ER S IY K R AH S IY Z
SUPERSECRECY	S UW P ER S IY K R AH S IY
SUPERSECRET	S UW P ER S IY K R IH T
SUPERSECRETS	S UW P ER S IY K R AH T S
SYNCRETIC	S IH NG K R AH T AH K
SYNCRETISE	S IH NG K R AH T AY Z
SYNCRETISED	S IH NG K R AH T AH S T
SYNCRETISES	S IH NG K R AH T AY Z AH Z
SYNCRETISING	S IH NG K R AH T AY Z AH NG
SYNCRETISM	S IH NG K R AH T IH Z AH M
SYNCRETISMS	S IH NG K R AH T AH Z AH M Z
SYNCRETIST	S IH NG K R AH T AH S T
SYNCRETISTIC	S IH NG K R AH T AH S T AH K
SYNCRETISTS	S IH NG K R AH T AH S T S
SYNCRETIZE	S IH NG K R AH T AY Z
SYNCRETIZED	S IH NG K R AH T AY Z D
SYNCRETIZES	S IH NG K R AH T AY Z AH Z
SYNCRETIZING	S IH NG K R AH T AY Z AH NG
TACRINE	T AE K R AY N
TACRINES	T AE K R AY N Z
TECHNOCRACIES	T EH K N AA K R AH S IY Z
TECHNOCRACY	T EH K N AA K R AH S IY
TECHNOCRAT	T EH K N AH K R AE T
TECHNOCRATIC	T EH K N AH K R AE T IH K
TECHNOCRATS	T EH K N AH K R AE T S
TESTCROSS	T EH S T K R AO S
TESTCROSSED	T EH S T K R AO S T
TESTCROSSES	T EH S T K R AO S IH Z
TESTCROSSING	T EH S T K R AO S IH NG
THALASSOCRACIES	TH AH L AE S AA K R AH S IY Z
THALASSOCRACY	TH AH L AE S AA K R AH S IY
THALASSOCRAT	TH AE L AH S AA K R AH T
THALASSOCRATS	TH AH L AE S AH K R EY T S
THEOCRACIES	TH IY AA K R AH S IY Z
THEOCRACY	TH IY AA K R AH S IY
THEOCRAT	TH IY AA K R AH T
THEOCRATIC	TH IY AH K R AE T IH K
THEOCRATICAL	TH IY AA K R AH T IH S AH L
THEOCRATICALLY	TH IY AA K R AE T AH K AE L IY
THEOCRATS	TH IY AH K R EY T S
THUMBSCREW	TH AH M S K R UW
THUMBSCREWS	TH AH M S K R UW Z
TIMOCRACIES	T AH M AA K R AH S IY Z
TIMOCRACY	T AH M AA K R AH S IY
TIMOCRATIC	T AH M AA K R AH T AH K
TIMOCRATICAL	T AH M AA K R AH T IH S AH L
TOPCROSS	T AA P K R AO S
TOPCROSSES	T AA P K R AO S IH Z
TRADECRAFT	T R EY D K R AE F T
TRADECRAFTS	T R EY D K R AE F T S
TRANSCRIBE	T R AE N S K R AY B
TRANSCRIBED	T R AE N S K R AY B D
TRANSCRIBER	T R AE N S K R AY B ER
TRANSCRIBERS	T R AE N S K R AY B ER Z
TRANSCRIBES	T R AE N S K R AY B Z
TRANSCRIBING	T R AE N S K R AY B IH NG
TRANSCRIPT	T R AE N S K R IH P T
TRANSCRIPTASE	T R AE N S R IH P T EY Z
TRANSCRIPTASES	T R AE N S R IH P T EY Z AH Z
TRANSCRIPTION	T R AE N S K R IH P SH AH N
TRANSCRIPTIONAL	T R AE N S K R IH P SH AH N AH L
TRANSCRIPTIONALLY	T R AE N S K R IH P SH AH N AH L IY
TRANSCRIPTIONIST	T R AE N S K R IH P SH AH N IH S T
TRANSCRIPTIONISTS	T R AE N S K R IH P SH AH N IH S T S
TRANSCRIPTIONS	T R AE N S K R IH P SH AH N Z
TRANSCRIPTS	T R AE N S K R IH P T S
TYPESCRIPT	T AY P S K R IH P T
TYPESCRIPTS	T AY P S K R IH P T S
ULTRACRITICAL	AH L T R AH K R IH T IH K AH L
ULTRADEMOCRATIC	AH L T R AH D EH M AH K R AE T IH K
ULTRAMICRO	AH L T R AH M IH K R OW
ULTRAMICROSCOPE	AH L T R AH M AY K R OW S K OW P
ULTRAMICROSCOPES	AH L T R AH M AY K R OW S K OW P S
ULTRAMICROSCOPIC	AH L T R AH M AY K R AH S K AA P IH K
ULTRAMICROSCOPICAL	AH L T R AH M AY K R AH S K AA P IH K AH L
ULTRAMICROSCOPICALLY	AH L T R AH M AY K R AH S K AA P IH K AH L IY
ULTRAMICROTOME	AH L T R AH M AY K R OW T OW M
ULTRAMICROTOMES	AH L T R AH M AY K R OW T OW M Z
ULTRAMICROTOMIES	AH L T R AH M AY K R OW T OW M IY Z
ULTRAMICROTOMY	AH L T R AH M AY K R OW T OW M IY
ULTRASECRET	AH L T R AH S IY K R AH T
UNACCREDITED	AH N AH K R EH D IH T IH D
UNBUREAUCRATIC	AH N B Y UH R AH K R AE T IH K
UNCONSECRATED	AH N K AA N S AH K R EY T IH D
UNCRACKED	AH N K R AE K T
UNCRATE	AH N K R EY T
UNCRATED	AH N K R EY T IH D
UNCRATES	AH N K R EY T S
UNCRATING	AH N K R EY T IH NG
UNCRAZY	AH N K R EY Z IY
UNCREATE	AH N K R IY EY T
UNCREATED	AH N K R IY EY T IH D
UNCREATES	AH N K R IY EY T S
UNCREATING	AH N K R IY EY T IH NG
UNCREATIVE	AH N K R IY EY T IH V
UNCREDENTIALED	AH N K R IH D EH N CH AH L D
UNCREDITED	AH N K R EH D AH T IH D
UNCRIPPLED	AH N K R IH P AH L D
UNCRITICAL	AH N K R IH T IH K AH L
UNCRITICALLY	AH N K R IH T IH K AH L IY
UNCRITICALLY(2)	AH N K R IH T IH K L IY
UNCROPPED	AH N K R AA P T
UNCROSS	AH N K R AO S
UNCROSSABLE	AH N K R AO S AH B AH L
UNCROSSED	AH N K R AO S T
UNCROSSES	AH N K R AO S IH Z
UNCROSSING	AH N K R AO S IH NG
UNCROWDED	AH N K R AW D IH D
UNCROWN	AH N K R AW N
UNCROWNED	AH N K R AW N D
UNCROWNING	AH N K R AW N IH NG
UNCROWNS	AH N K R AW N Z
UNCRUMPLE	AH N K R AH M P AH L
UNCRUMPLED	AH N K R AH M P AH L D
UNCRUMPLES	AH N K R AH M P AH L Z
UNCRUMPLING	AH N K R AH M P L IH NG
UNCRUSHABLE	AH N K R AH SH AH B AH L
UNCRYSTALLIZED	AH N K R IH S T AH L AY Z D
UNDEMOCRATIC	AH N D EH M AH K R AE T IH K
UNDEMOCRATICALLY	AH N D EH M AH K R AE T IH K AH L IY
UNDERCROFT	AH N D ER K R AO F T
UNDERCROFTS	AH N D ER K R AO F T S
UNDERSECRETARIES	AH N D ER S EH K R AH T EH R IY Z
UNDERSECRETARY	AH N D ER S EH K R IH T EH R IY
UNDESCRIBABLE	AH N D IY S K R AY B AH B AH L
UNDISCRIMINATING	AH N D IH S K R IH M AH N EY T IH NG
UNSCRAMBLE	AH N S K R AE M B AH L
UNSCRAMBLED	AH N S K R AE M B AH L D
UNSCRAMBLER	AH N S K R AE M B AH L ER
UNSCRAMBLERS	AH N S K R AE M B AH L ER Z
UNSCRAMBLES	AH N S K R AE M B AH L Z
UNSCRAMBLING	AH N S K R AE M B AH L IH NG
UNSCREENED	AH N S K R IY N D
UNSCREW	AH N S K R UW
UNSCREWED	AH N S K R UW D
UNSCREWING	AH N S K R UW IH NG
UNSCREWS	AH N S K R UW Z
UNSCRIPTED	AH N S K R IH P T IH D
UNSCRIPTURAL	AH N S K R IH P CH ER AH L
UNSCRUPULOUS	AH N S K R UW P Y AH L AH S
UNSCRUPULOUSLY	AH N S K R UW P Y AH L AH S L IY
UNSCRUPULOUSNESS	AH N S K R UW P Y AH L AH S N AH S
UNSCRUPULOUSNESSES	AH N S K R UW P Y AH L AH S N AH S IH Z
VINCRISTINE	V IH NG K R AH S T AY N
VINCRISTINES	V IH NG K R AH S T AY N Z
WARCRAFT	W AO R K R AE F T
WARCRAFTS	W AO R K R AE F T S
WATCHCRIES	W AA CH K R AY Z
WATCHCRY	W AA CH K R AY
WATERCRAFT	W AO T ER K R AE F T
WATERCRAFTS	W AO T ER K R AE F T S
WATERCRESS	W AO T ER K R EH S
WATERCRESSES	W AH T AH R K R EH S AH Z
WINDSCREEN	W IH N D S K R IY N
WINDSCREENS	W IH N D S K R IY N Z
WISEACRE	W AY Z EY K ER
WISEACRES	W AY Z EY K ER Z
WISECRACK	W AY Z K R AE K
WISECRACKED	W AY Z K R AE K T
WISECRACKER	W AY Z K R AE K ER
WISECRACKERS	W AY Z K R AE K ER Z
WISECRACKING	W AY Z K R AE K IH NG
WISECRACKS	W AY Z K R AE K S
WITCHCRAFT	W IH CH K R AE F T
WITCHCRAFTS	W IH CH K R AE F T S
WOODCRAFT	W UH D K R AE F T
WOODCRAFTS	W UH D K R AE F T S
WHODUNIT	HH UW D AH N IH T
VIA	V AY AH
VIA(2)	V IY AH
FOLACIN	F AA L AH S AH N
OOSPERM	UW S AH R M
CLABBER	K L AE B AH R
GEANTICLINE	JH IY N T AH K L AY N
KUNZITE	K AH N Z AY T
