DE	D IY
DE(2)	D EY
DE(3)	D AH
ABIDE	AH B AY D
ABIDED	AH B AY D IH D
ABIDER	AH B AY D ER
ABIDERS	AH B AY D ER Z
ABIDES	AH B AY D Z
ABODE	AH B OW D
ABODED	AH B OW D IH D
ABODES	AH B OW D Z
ABOIDEAU	AH B OY D IY UW
ABOIDEAUS	AH B OY D IY AH S
ABOIDEAUX	AH B OY D IY AH K S
ABOUNDED	AH B AW N D IH D
ABRADE	AE B R EY D
ABRADED	AH B R AE D IH D
ABRADER	AH B R AE D ER
ABRADERS	AH B R AE D ER Z
ABRADES	AE B R EY D Z
ABSCONDED	AE B S K AA N D AH D
ABSCONDER	AE B S K AA N D AH R
ABSCONDERS	AE B S K AA N D AH R Z
ABSENTMINDED	AE B S AH N T M AY N D IH D
ABSENTMINDEDLY	AE B S AH N T M AY N D AH D L IY
ABSENTMINDEDNESS	AE B S AH N T M AY N D AH D N AH S
ABSENTMINDEDNESSES	AE B S AH N T M AY N D AH D N AH S IH Z
ABSURDER	AH B S ER D ER
ABSURDEST	AH B S ER D AH S T
ACADEME	AE K AH D IY M
ACADEMES	AE K AH D IY M Z
ACADEMIA	AE K AH D IY M IY AH
ACADEMIAS	AE K AH D IY M IY AH Z
ACADEMIC	AE K AH D EH M IH K
ACADEMICAL	AE K AH D EH M IH K AH L
ACADEMICALLY	AE K AH D EH M IH K L IY
ACADEMICIAN	AE K AH D AH M IH SH AH N
ACADEMICIANS	AE K AH D AH M IH SH AH N Z
ACADEMICIANS(2)	AH K AE D AH M IH SH AH N Z
ACADEMICISM	AE K AH D EH M IH K IH Z AH M
ACADEMICISMS	AE K AH D EH M IH K IH Z AH M Z
ACADEMICS	AE K AH D EH M IH K S
ACADEMIES	AH K AE D AH M IY Z
ACADEMISM	AE K AH D AH M IH Z AH M
ACADEMISMS	AH K AE D AH M AH Z AH M Z
ACADEMY	AH K AE D AH M IY
ACARICIDE	AH K AE R AH S AY D
ACARICIDES	AH K AE R AH S AY D Z
ACCEDE	AE K S IY D
ACCEDED	AE K S IY D IH D
ACCEDER	AE K S IY D ER
ACCEDERS	AE K S IY D ER Z
ACCEDES	AE K S IY D Z
ACCIDENCE	AE K S AH D AH N S
ACCIDENCES	AE K S AH D AH N S IH Z
ACCIDENT	AE K S AH D AH N T
ACCIDENTAL	AE K S AH D EH N T AH L
ACCIDENTAL(2)	AE K S AH D EH N AH L
ACCIDENTALLY	AE K S AH D EH N T AH L IY
ACCIDENTALLY(2)	AE K S AH D EH N AH L IY
ACCIDENTALNESS	AE K S AH D EH N T AH L N AH S
ACCIDENTALNESSES	AE K S AH D EH N T AH L N AH S IH Z
ACCIDENTALS	AE K S AH D EH N T AH L Z
ACCIDENTLY	AE K S AH D AH N T L IY
ACCIDENTS	AE K S AH D AH N T S
ACCOLADE	AE K AH L EY D
ACCOLADES	AE K AH L EY D Z
ACCORDED	AH K AO R D IH D
ACCORDER	AH K AO R D ER
ACCORDERS	AH K AO R D ER Z
ACETALDEHYDE	AH S AH T AE L D AH HH AY D
ACETALDEHYDES	AH S AH T AE L D AH HH AY D Z
ACETAMIDE	AH S EH T AH M AY D
ACETAMIDES	AH S EH T AH M AY D Z
ACETANILIDE	AH S AH T AE N AH L AY D
ACETANILIDES	AH S AH T AE N AH L AY D Z
ACETAZOLAMIDE	AH S AH T AH Z AA L AH M AY D
ACETAZOLAMIDES	AH S AH T AH Z AA L AH M AY D Z
ACIDEMIA	AE S AH D IY M IY AH
ACIDEMIAS	AE S AH D IY M IY AH Z
ACNODE	AE K N OW D
ACNODES	AE K N OW D Z
ACRIDER	AE K R AH D ER
ACRIDEST	AE K R AH D AH S T
ACRYLAMIDE	AE K R IH L AH M AY D
ACRYLAMIDES	AE K R IH L AH M AY D Z
ACTINIDE	AE K T IH N AY D
ACTINIDES	AE K T AH N AY D Z
ADDED	AE D IH D
ADDEDLY	AE D AH D L IY
ADDEND	AE D EH N D
ADDENDA	AE D EH N D AH
ADDENDS	AE D EH N D Z
ADDENDUM	AH D EH N D AH M
ADDER	AE D ER
ADDERS	AE D ER Z
ADEEM	AH D IY M
ADEEMED	AH D IY M D
ADEEMING	AH D IY M IH NG
ADEEMS	AH D IY M Z
ADENINE	AE D AH N IY N
ADENINES	AH D IY N AY N Z
ADENITIS	AH D EH N AH T IY Z
ADENITISES	AH D EH N AH T IY Z IH Z
ADENOCARCINOMA	AH D EH N AH K AH R S IH N AH M AH
ADENOCARCINOMAS	AH D EH N AH K AH R S IH N AH M AH Z
ADENOCARCINOMATA	AH D AH N AH K AA R S AH N AA M AH T AH
ADENOCARCINOMATOUS	AH D EH N AH K AA R S AH N AA M AH T AH S
ADENOHYPOPHYSEAL	AE D AH N AH HH IH P AH F IH Z IY AH L
ADENOHYPOPHYSES	AH D AH N AH HH IH P AH F AY Z AH Z
ADENOHYPOPHYSIAL	AE D AH N AH HH IH P AH F IH Z IY AH L
ADENOHYPOPHYSIS	AH D EH N AH HH AH P AA F AH S AH S
ADENOID	AE D AH N OY D
ADENOIDAL	AE D AH N OY D AH L
ADENOIDS	AE D AH N OY D Z
ADENOMA	AE D AH N OW M AH
ADENOMAS	AE D AH N OW M AH Z
ADENOMATA	AE D AH N AA M AH T AH
ADENOMATOUS	AE D AH N AA M AH T AH S
ADENOSES	AH D IY N OW Z IH Z
ADENOSINE	AH D EH N AH S IY N
ADENOSINES	AH D EH N AH S AY N Z
ADENOSIS	AH D IY N OW Z IY Z
ADENOVIRAL	AE D AH N AA V AH R AH L
ADENOVIRUS	AH D EH N AH V AY R AH S
ADENOVIRUSES	AH D AH N AA V AH R UW Z AH Z
ADENYL	AE D AH N AH L
ADENYLS	AE D AH N AH L Z
ADEPT	AH D EH P T
ADEPTER	AE D EH P T ER
ADEPTEST	AE D EH P T AH S T
ADEPTLY	AE D EH P T L IY
ADEPTNESS	AE D EH P T N AH S
ADEPTNESSES	AE D EH P T N AH S IH Z
ADEPTS	AE D EH P T S
ADEQUACIES	AE D IH K W AH S IY Z
ADEQUACY	AE D AH K W AH S IY
ADEQUATE	AE D AH K W AH T
ADEQUATE(2)	AE D AH K W EY T
ADEQUATELY	AE D AH K W IH T L IY
ADEQUATENESS	AE D IH K W AH T N AH S
ADEQUATENESSES	AE D IH K W AH T N AH S IH Z
AEDES	EH D Z
AFFORDED	AH F AO R D AH D
AFTERDECK	AE F T ER D EH K
AFTERDECKS	AE F T ER D EH K S
AGGRADE	AE G R EY D
AGGRADED	AE G R EY D AH D
AGGRADES	AE G R EY D Z
AIDE	EY D
AIDED	EY D IH D
AIDER	EY D ER
AIDERS	EY D ER Z
AIDES	EY D Z
AIRHEADED	AH IH R HH EH D IH D
ALAMODE	AE L AH M OW D
ALAMODES	AE L AH M OW D Z
ALCADE	AE L K EY D
ALCADES	AE L K EY D Z
ALCAIDE	AE L K EY D
ALCAIDES	AE L K EY D Z
ALCALDE	AE L K AH L D
ALCALDES	AE L K AH L D Z
ALCAYDE	AE L K EY D
ALCAYDES	AE L K EY D Z
ALDEHYDE	AE L D AH HH AY D
ALDEHYDES	AE L D AH HH AY D Z
ALDEHYDIC	AE L D AH HH AH D AH K
ALDER	AO L D ER
ALDERFLIES	AE L D AH R F L AY Z
ALDERFLY	AE L D AH R F L IY
ALDERMAN	AO L D ER M AH N
ALDERMAN(2)	AE L D ER M AH N
ALDERMANIC	AO L D ER M AH N IH K
ALDERMEN	AO L D ER M IH N
ALDERS	AE L D AH R Z
ALDERWOMAN	AE L D AH R W AH M AH N
ALDERWOMEN	AE L D AH R W AH M AH N
ALEXANDER	AE L IH G Z AE N D ER
ALEXANDERS	AE L IH G Z AE N D ER Z
ALGAECIDE	AE L G AH S AY D
ALGAECIDES	AE L G AH S AY D Z
ALGICIDE	AE L JH AH S AY D
ALGICIDES	AE L JH AH S AY D Z
ALIDADE	AH L IH D EY D
ALIDADES	AH L IH D EY D Z
ALIUNDE	EY L IY AH N D
ALKOXIDE	AE L K AH K S AY D
ALKOXIDES	AE L K AH K S AY D Z
ALLANTOIDES	AE L AH N T OY D Z
ALLEMANDE	AE L AH M AH N D
ALLEMANDES	AE L AH M AH N D Z
ALLUDE	AH L UW D
ALLUDED	AH L UW D AH D
ALLUDES	AH L UW D Z
ALMUDE	AE L M Y UW D
ALMUDES	AE L M Y UW D Z
ALONGSIDE	AH L AO NG S AY D
ALTITUDE	AE L T AH T UW D
ALTITUDES	AE L T IH T UW D Z
ALUDEL	AH L UW D AH L
ALUDELS	AH L UW D AH L Z
AMBIDEXTERITIES	AE M B AH D EH K S T EH R AH T AY Z
AMBIDEXTERITY	AE M B AH D EH K S T EH R AH T IY
AMBIDEXTROUS	AE M B IH D EH K S T R AH S
AMBIDEXTROUSLY	AE M B IH D EH K S T R AH S L IY
AMBUSCADE	AE M B AH S K EY D
AMBUSCADED	AE M B AH S K EY D IH D
AMBUSCADER	AE M B AH S K EY D ER
AMBUSCADERS	AE M B AH S K EY D ER Z
AMBUSCADES	AE M B AH S K EY D Z
AMENDED	AH M EH N D IH D
AMENDER	AH M EH N D ER
AMENDERS	AH M EH N D ER Z
AMIDE	AE M AY D
AMIDES	AE M AY D Z
AMPLITUDE	AE M P L AH T UW D
AMPLITUDES	AE M P L AH T UW D Z
ANADEM	AE N AH D AH M
ANADEMS	AE N AH D AH M Z
ANDESITE	AE N D IH S AY T
ANDESITES	AE N D AH S AY T S
ANDESITIC	AE N D AH S AH T AH K
ANDESYTE	AE N D AH S AY T
ANDESYTES	AE N D AH S AY T S
ANHYDRIDE	AE N HH AY D R IH D
ANHYDRIDES	AE N HH AH D R AY D Z
ANODE	AE N OW D
ANODES	AE N OW D Z
ANTECEDE	AE N T AH S IY D
ANTECEDED	AE N T AH S IY D AH D
ANTECEDENCE	AE N T EH S AH D AH N S
ANTECEDENCES	AE N T EH S AH D EH N S AH Z
ANTECEDENT	AE N T EH S AH D AH N T
ANTECEDENT(2)	AE N T IH S IY D AH N T
ANTECEDENTLY	AE N T AH S IY D AH N T L IY
ANTECEDENTS	AE N T IH S IY D AH N T S
ANTECEDENTS(2)	AE N T EH S AH D AH N T S
ANTECEDES	AE N T AH S IY D Z
ANTIACADEMIC	AE N T AY AE K AH D EH M IH K
ANTIACADEMICS	AE N T AY AE K AH D EH M IH K S
ANTICATHODE	AE N T AY K AE TH OW D
ANTICATHODES	AE N T AY K AE TH OW D Z
ANTIDEFAMATION	AE N T AY D IY F EY M EY SH AH N
ANTIDEMOCRATIC	AE N T AY D EH M AH K R AE T IH K
ANTIDEPRESSANT	AE N T IY D IH P R EH S AH N T
ANTIDEPRESSANTS	AE N T AY D IH P R EH S AH N T S
ANTIDEPRESSANTS(2)	AE N T IY D IH P R EH S AH N T S
ANTIDEPRESSION	AE N T AY D IY P R EH SH AH N
ANTIDEPRESSIONS	AE N T AY D IY P R EH SH AH N Z
ANTIDERIVATIVE	AE N T AY D IH R IH V AH T IH V
ANTIDERIVATIVES	AE N T AY D IH R IH V AH T IH V Z
ANTIDESEGREGATION	AE N T AY D IY S EH G R IH G EY SH AH N
ANTIDESERTIFICATION	AE N T AY D EH Z ER T AH F AH K EY SH AH N
ANTIDESICCANT	AE N T AY D IY S IH K AH N T
ANTIDESICCANTS	AE N T AY D IY S IH K AH N T S
ANTIDEVELOPMENT	AE N T AY D IH V EH L AH P M AH N T
ANTIFEDERALIST	AE N T AY F EH D ER AH L IH S T
ANTIFEDERALISTS	AE N T AY F EH D ER AH L IH S T S
ANTIMODERN	AE N T AY M AA D ER N
ANTIMODERNIST	AE N T AY M AA D ER N IH S T
ANTIMODERNISTS	AE N T AY M AA D ER N IH S T S
ANTIMODERNS	AE N T AY M AA D ER N Z
ANTIMONIDE	AE N T AH M AH N AY D
ANTIMONIDES	AE N T AH M AH N AY D Z
ANTINODE	AE N T AY N OW D
ANTINODES	AE N T AY N OW D Z
ANTIPESTICIDE	AE N T AY P EH S T AH S AY D
ANTIPODE	AE N T AH P OW D
ANTIPODEAN	AE N T AH P OW D IY AH N
ANTIPODEANS	AE N T AH P AH D IY N Z
ANTIPODES	AE N T IH P AH D IY Z
ANTISTUDENT	AE N T AY S T UW D AH N T
ANTISUICIDE	AE N T AY S UW AH S AY D
ANTITRADES	AE N T AY T R EY D Z
APHIDES	AH F AY D Z
APOAPSIDES	AE P OW P S AY D Z
APODEICTIC	AE P AH D IY K T AH K
APPENDECTOMIES	AE P AH N D EH K T AH M IY Z
APPENDECTOMY	AE P IH N D EH K T AH M IY
APPENDED	AH P EH N D IH D
APPLAUDED	AH P L AO D IH D
APPLAUDER	AH P L AO D ER
APPLAUDERS	AH P L AO D ER Z
APPREHENDED	AE P R IH HH EH N D AH D
APSIDES	AE P S AY D Z
APTITUDE	AE P T AH T UW D
APTITUDES	AE P T AH T UW D Z
AQUACADE	AE K W AH K EY D
AQUACADES	AE K W AH K EY D Z
ARABINOSIDE	AH R AH B IH N AH S AY D
ARABINOSIDES	AH R AH B IH N AH S AY D Z
ARCADE	AA R K EY D
ARCADED	AA R K EY D IH D
ARCADES	AA R K EY D Z
ARCHDEACON	AA R CH D IY K AH N
ARCHDEACONRIES	AA R CH D IY K AH N R IY Z
ARCHDEACONRY	AA R CH D IY K AH N R IY
ARCHDEACONS	AA R CH D IY K AH N Z
ARDEB	AA R D AH B
ARDEBS	AA R D AH B Z
ARDENCIES	AA R D AH N S IY Z
ARDENCY	AA R D AH N S IY
ARDENT	AA R D AH N T
ARDENTLY	AA R D AH N T L IY
ARIDER	AE R AH D ER
ARIDEST	AE R AH D AH S T
ARILLODE	AE R AH L OW D
ARILLODES	AE R AH L OW D Z
ARSENIDE	AA R S AH N AY D
ARSENIDES	AA R S AH N AY D Z
ARTERITIDES	AA R T EH R AH T AY D Z
ARTHRITIDES	AA R TH R AH T AY D Z
ARTHRODESES	AA R TH R AH D IY Z AH Z
ARTHRODESIS	AA R TH R OW D AH S AH S
ASCARIDES	AE S AH R AY D Z
ASCENDED	AH S EH N D AH D
ASCENDENCE	AH S EH N D AH N S
ASCENDENCES	AH S EH N D AH N S IH Z
ASCENDENCIES	AH S EH N D AH N S IY Z
ASCENDENCY	AH S EH N D AH N S IY
ASCENDENT	AH S EH N D AH N T
ASCENDENTS	AH S EH N D AH N T S
ASCENDER	AH S EH N D ER
ASCENDERS	AH S EH N D ER Z
ASIDE	AH S AY D
ASIDES	AH S AY D Z
ASPHODEL	AE S AH D AH L
ASPHODELS	AE S AH D AH L Z
ASTOUNDED	AH S T AW N D IH D
ASTRIDE	AH S T R AY D
ASUNDER	AH S AH N D ER
ASYNDETA	AH S IH N D AH T AH
ASYNDETIC	AH S IH N D AH T AH K
ASYNDETICALLY	AH S IH N D EH T AH K AE L IY
ASYNDETON	AH S IH N D AH T AH N
ASYNDETONS	AH S IH N D AH T AH N Z
ATTAINDER	AH T EY N D ER
ATTAINDERS	AE T EY N D AH R Z
ATTENDED	AH T EH N D AH D
ATTENDEE	AH T EH N D IY
ATTENDEES	AH T EH N D IY Z
ATTENDER	AH T EH N D ER
ATTENDERS	AH T EH N D ER Z
ATTITUDE	AE T AH T UW D
ATTITUDES	AE T AH T UW D Z
AUBADE	AH B EY D
AUBADES	AH B EY D Z
AULDER	AO L D AH R
AULDEST	AO L D AH S T
AUSLANDER	AW S L AH N D ER
AUSLANDERS	AO Z L AE N D AH R Z
AUTOCADE	AO T AH K EY D
AUTOCADES	AO T AH K EY D Z
AUTOSTRADE	AO T OW Z T R EY D
AVOIDED	AH V OY D IH D
AVOIDER	AH V OY D ER
AVOIDERS	AH V OY D ER Z
AWARDED	AH W AO R D IH D
AWARDEE	AH W AO R D IY
AWARDEES	AH W AO R D IY Z
AWARDER	AH W AO R D ER
AWARDERS	AH W AO R D ER Z
AWKWARDER	AO K W ER D ER
AWKWARDEST	AO K W ER D AH S T
AZIDE	AH Z AY D
AZIDES	AE Z AY D Z
BACKGROUNDED	B AE K G R AW N D IH D
BACKGROUNDER	B AE K G R AW N D ER
BACKGROUNDERS	B AE K G R AW N D ER Z
BACKHANDED	B AE K HH AE N D IH D
BACKHANDEDLY	B AE K HH AE N D AH D L IY
BACKHANDER	B AE K HH AE N D ER
BACKHANDERS	B AE K HH AE N D ER Z
BACKSIDE	B AE K S AY D
BACKSIDES	B AE K S AY D Z
BACKSLIDDEN	B AE K S L IH D AH N
BACKSLIDE	B AE K S L AY D
BACKSLIDER	B AE K S L AY D ER
BACKSLIDERS	B AE K S L AY D ER Z
BACKSLIDES	B AE K S L AY D Z
BACTERICIDE	B AE K T EH R AH S AY D
BACTERICIDES	B AE K T EH R AH S AY D Z
BADDER	B AE D ER
BADDEST	B AE D AH S T
BADE	B EY D
BALDED	B AO L D IH D
BALDER	B AO L D ER
BALDERDASH	B AO L D ER D AE SH
BALDERDASHES	B AO L D ER D AE SH IH Z
BALDEST	B AO L D AH S T
BALDHEADED	B AO L D HH EH D IH D
BALLADE	B AH L AA D
BALLADEER	B AE L AH D IH R
BALLADEERS	B AE L AH D IH R Z
BALLADES	B AO L EY D Z
BALUSTRADE	B AE L AH S T R EY D
BALUSTRADED	B AE L AH S T R EY D IH D
BALUSTRADES	B AE L AH S T R EY D Z
BANDEAU	B AE N D IY UW
BANDEAUS	B AE N D IY AH S
BANDEAUX	B AE N D IY AH K S
BANDED	B AE N D IH D
BANDER	B AE N D ER
BANDERILLA	B AE N D AH R IH L AH
BANDERILLAS	B AE N D AH R IH L AH Z
BANDERILLERO	B AE N D AH R IH L AH R OW
BANDERILLEROS	B AE N D ER IH L ER AA S
BANDEROL	B AE N D AH R AH L
BANDEROLE	B AE N D IY R OW L
BANDEROLES	B AE N D IY R OW L Z
BANDEROLS	B AE N D AH R AH L Z
BANDERS	B AE N D ER Z
BANDLEADER	B AE N D L IY D ER
BANDLEADERS	B AE N D L IY D ER Z
BANKSIDE	B AE NG K S AY D
BANKSIDES	B AE NG K S AY D Z
BARDE	B AA R D
BARDED	B AA R D IH D
BARDES	B AA R D Z
BAREHANDED	B EH R HH AE N D IH D
BAREHEADED	B EH R HH EH D IH D
BARRICADE	B AE R AH K EY D
BARRICADE(2)	B EH R AH K EY D
BARRICADED	B AE R AH K EY D IH D
BARRICADED(2)	B EH R AH K EY D IH D
BARRICADES	B AE R AH K EY D Z
BARRICADES(2)	B EH R AH K EY D Z
BARTENDED	B AA R T EH N D IH D
BARTENDER	B AA R T EH N D ER
BARTENDERS	B AA R T EH N D ER Z
BASTINADE	B AE S T IH N EY D
BASTINADES	B AE S T IH N EY D Z
BAUDEKIN	B AO D AH K AH N
BAUDEKINS	B AO D AH K AH N Z
BAYADEER	B EY EY D IH R
BAYADEERS	B EY EY D IH R Z
BAYADERE	B EY EY D AH R
BAYADERES	B EY AH D IY R Z
BDELLIUM	B D EH L IY AH M
BDELLIUMS	B D EH L IY AH M Z
BEACHSIDE	B IY CH S AY D
BEADED	B IY D IH D
BEARDED	B IH R D AH D
BEARDEDNESS	B IH ER D AH D N AH S
BEARDEDNESSES	B IH ER D AH D N AH S IH Z
BEATITUDE	B IY AE T AH T UW D
BEATITUDES	B IY AE T AH T UW D Z
BEBLOODED	B IH B L AH D IH D
BECLOUDED	B IH K L AW D IH D
BECOWARDED	B IH K AW ER D IH D
BECROWDED	B IH K R AW D IH D
BEDDED	B EH D IH D
BEDDER	B EH D ER
BEDDERS	B EH D ER Z
BEDEAFEN	B IH D EH F AH N
BEDEAFENED	B IH D EH F AH N D
BEDEAFENING	B IH D EH F AH N IH NG
BEDEAFENS	B IH D EH F AH N Z
BEDECK	B IH D EH K
BEDECKED	B IH D EH K T
BEDECKING	B IH D EH K IH NG
BEDECKS	B IH D EH K S
BEDEL	B IH D EH L
BEDELL	B EH D AH L
BEDELLS	B IH D EH L Z
BEDELS	B AH D EH L Z
BEDEMAN	B IH D IY M AE N
BEDEMEN	B IH D IY M EH N
BEDESMAN	B AH D EH Z M AH N
BEDESMEN	B AH D EH Z M AH N
BEDEVIL	B IH D EH V AH L
BEDEVILED	B IH D EH V AH L D
BEDEVILING	B IH D IY V IY L IH NG
BEDEVILLED	B IH D EH V AH L D
BEDEVILLING	B IH D IY V IH L IH NG
BEDEVILMENT	B IH D IY V IH L M AH N T
BEDEVILMENTS	B IH D IY V IH L M AH N T S
BEDEVILS	B IH D EH V AH L Z
BEDEW	B IH D UW
BEDEWED	B IH D IY W EH D
BEDEWING	B IH D IY W IH NG
BEDEWS	B IH D UW Z
BEDRIDDEN	B EH D R IH D AH N
BEDSIDE	B EH D S AY D
BEDSIDES	B EH D S AY D Z
BEFRIENDED	B IH F R EH N D IH D
BEGIRDED	B IH G ER D IH D
BEGLADDED	B IH G L AE D IH D
BEHEADED	B IH HH EH D IH D
BEHOLDEN	B IH HH OW L D AH N
BEHOLDER	B IY HH OW L D ER
BEHOLDERS	B IH HH OW L D ER Z
BELAUDED	B IH L AO D IH D
BELOWDECKS	B IH L OW D EH K S
BELVEDERE	B EH L V AH D IH R
BELVEDERE(2)	B EH L V IH D IH R
BELVEDERES	B EH L V AH D IH ER Z
BEMADDEN	B IH M AE D AH N
BEMADDENED	B IH M AE D AH N D
BEMADDENING	B IH M AE D AH N IH NG
BEMADDENS	B IH M AE D AH N Z
BENDED	B EH N D IH D
BENDEE	B EH N D IY
BENDEES	B EH N D IY Z
BENDER	B EH N D ER
BENDERS	B EH N D ER Z
BENZALDEHYDE	B IH N Z AE L D AH HH AY D
BENZALDEHYDES	B IH N Z AE L D AH HH AY D Z
BESHROUDED	B IH SH R AW D IH D
BESIDE	B IH S AY D
BESIDE(2)	B IY S AY D
BESIDES	B IH S AY D Z
BESIDES(2)	B IY S AY D Z
BESTEADED	B IH S T EH D IH D
BESTRIDDEN	B EH S T R IH D AH N
BESTRIDE	B IH S T R AY D
BESTRIDES	B IH S T R AY D Z
BESTRODE	B IH S T R OW D
BESTUDDED	B IH S T AH D IH D
BETIDE	B IH T AY D
BETIDED	B IH T AY D IH D
BETIDES	B IH T AY D Z
BEWILDER	B IH W IH L D ER
BEWILDERED	B IH W IH L D ER D
BEWILDEREDLY	B IH W IH L D ER AH D L IY
BEWILDEREDNESS	B IH W IH L D ER AH D N AH S
BEWILDEREDNESSES	B IH W IH L D ER AH D N AH S IH Z
BEWILDERING	B IH W IH L D ER IH NG
BEWILDERINGLY	B IH W IH L D ER IH NG L IY
BEWILDERMENT	B IH W IH L D ER M AH N T
BEWILDERMENTS	B IH W IH L D ER M AH N T S
BEWILDERS	B IH W IH L D ER Z
BIDDEN	B IH D IH N
BIDDER	B IH D ER
BIDDERS	B IH D ER Z
BIDE	B AY D
BIDED	B AY D IH D
BIDENTAL	B AY D EH N T AH L
BIDER	B AY D ER
BIDERS	B AY D ER Z
BIDES	B AY D Z
BIDET	B AY D EH T
BIDETS	B AY D EH T S
BIELDED	B AY EH L D IH D
BIGARADE	B IH G ER EY D
BIGARADES	B IH G ER EY D Z
BIGHEADED	B IH G HH EH D IH D
BILANDER	B AY L AE N D ER
BILANDERS	B AY L AE N D ER Z
BILLBOARDED	B IH L B OW R D IH D
BINDER	B AY N D ER
BINDERIES	B AY N D AH R IY Z
BINDERS	B AY N D ER Z
BINDERY	B AY N D AH R IY
BIOCIDE	B AY AH S AY D
BIOCIDES	B AY AH S AY D Z
BIODEGRADABILITIES	B AY AH D EH G R AH D AH B IH L AH T AY Z
BIODEGRADABILITY	B AY AH D EH G R AH D AH B IH L AH T IY
BIODEGRADABLE	B AY OW D AH G R EY D AH B AH L
BIODEGRADATION	B AY AH D EH G R AH D EY SH AH N
BIODEGRADATIONS	B AY AH D EH G R AH D EY T IY AH N Z
BIODEGRADE	B AY AA D AH G R EY D
BIODEGRADED	B AY AA D AH G R EY D AH D
BIODEGRADES	B AY AA D AH G R EY D Z
BIODEGRADING	B AY AA D AH G R EY D AH NG
BIODETERIORATION	B AY AA D AH T IY R IY AH R EY SH AH N
BIODETERIORATIONS	B AY AH D AH T IY R IY AH R EY T IY AH N Z
BIRDED	B ER D IH D
BIRDER	B ER D ER
BIRDERS	B ER D ER Z
BISULFIDE	B AY S AH L F AY D
BISULFIDES	B AY S AH L F AY D Z
BLACKBIRDED	B L AE K B ER D IH D
BLACKBIRDER	B L AE K B ER D ER
BLACKBIRDERS	B L AE K B ER D ER Z
BLACKGUARDED	B L AE K G AA R D IH D
BLACKHANDER	B L AE K HH AE N D ER
BLACKHANDERS	B L AE K HH AE N D ER Z
BLADDER	B L AE D ER
BLADDERLIKE	B L AE D ER L AY K
BLADDERNUT	B L AE D ER N AH T
BLADDERNUTS	B L AE D ER N AH T S
BLADDERS	B L AE D ER Z
BLADDERWORT	B L AE D AH R W AH R T
BLADDERWORTS	B L AE D AH R W AH R T S
BLADDERY	B L AE D ER IY
BLADE	B L EY D
BLADED	B L EY D IH D
BLADELIKE	B L EY D L AY K
BLADES	B L EY D Z
BLANDER	B L AE N D ER
BLANDEST	B L AE N D AH S T
BLASTODERM	B L AE S T AH D ER M
BLASTODERMS	B L AE S T AH D AH R M Z
BLEEDER	B L IY D ER
BLEEDERS	B L IY D ER Z
BLENDE	B L EH N D
BLENDED	B L EH N D IH D
BLENDER	B L EH N D ER
BLENDERS	B L EH N D ER Z
BLENDES	B L EH N D Z
BLESSEDER	B L EH S T ER
BLESSEDEST	B L EH S T AH S T
BLINDED	B L AY N D IH D
BLINDER	B L AY N D ER
BLINDERS	B L AY N D ER Z
BLINDEST	B L AY N D AH S T
BLINDFOLDED	B L AY N D F OW L D IH D
BLINDSIDE	B L AY N D S AY D
BLINDSIDED	B L AY N D S AY D IH D
BLINDSIDES	B L AY N D S AY D Z
BLOCKADE	B L AA K EY D
BLOCKADED	B L AA K EY D IH D
BLOCKADER	B L AA K EY D ER
BLOCKADERS	B L AA K EY D ER Z
BLOCKADES	B L AA K EY D Z
BLONDE	B L AA N D
BLONDER	B L AA N D ER
BLONDES	B L AA N D Z
BLONDEST	B L AA N D AH S T
BLOODED	B L AH D IH D
BLUNDER	B L AH N D ER
BLUNDERBUSS	B L AH N D ER B AH S
BLUNDERBUSSES	B L AH N D ER B AH S IH Z
BLUNDERED	B L AH N D ER D
BLUNDERER	B L AH N D ER ER
BLUNDERERS	B L AH N D ER ER Z
BLUNDERING	B L AH N D ER IH NG
BLUNDERINGLY	B L AH N D ER IH NG L IY
BLUNDERS	B L AH N D ER Z
BOARDED	B AO R D AH D
BOARDED(2)	B AO R D IH D
BOARDER	B AO R D ER
BOARDERS	B AO R D ER Z
BOATBUILDER	B OW T B IH L D ER
BOATBUILDERS	B OW T B IH L D ER Z
BOBSLEDDED	B AA B S L EH D IH D
BOBSLEDDER	B AA B S L EH D ER
BOBSLEDDERS	B AA B S L EH D ER Z
BODE	B OW D
BODED	B OW D IH D
BODEGA	B OW D EY G AH
BODEGAS	B OW D EY G AH S
BODEMENT	B OW D M AH N T
BODEMENTS	B OW D M AH N T S
BODES	B OW D Z
BODYBUILDER	B AA D IY B IH L D ER
BODYBUILDERS	B AA D IY B IH L D ER Z
BOLDER	B OW L D ER
BOLDEST	B OW L D IH S T
BOLIDE	B AH L AY D
BOLIDES	B AH L AY D Z
BOMBARDED	B AA M B AA R D IH D
BONDED	B AA N D AH D
BONDED(2)	B AA N D IH D
BONDER	B AA N D ER
BONDERS	B AA N D ER Z
BONDHOLDER	B AA N D HH OW L D ER
BONDHOLDERS	B AA N D HH OW L D ER Z
BONEHEADED	B OW N HH EH D IH D
BONEHEADEDNESS	B OW N HH EH D AH D N AH S
BONEHEADEDNESSES	B OW N HH EH D AH D N AH S IH Z
BOOKBINDER	B UH K B AY N D ER
BOOKBINDERIES	B UH K B AY N D AH R IY Z
BOOKBINDERS	B UH K B AY N D ER Z
BOOKBINDERY	B UH K B AY N D AH R IY
BORDEAUX	B AO R D OW
BORDEL	B AO R D AH L
BORDELLO	B AO R D EH L OW
BORDELLOS	B IY ER D EH L AA S
BORDELS	B AO R D AH L Z
BORDER	B AO R D ER
BORDEREAU	B AO R D IY R IY UW
BORDEREAUX	B AO R D IY R IY AH K S
BORDERED	B AO R D ER D
BORDERER	B AO R D ER ER
BORDERERS	B AO R D ER ER Z
BORDERING	B AO R D ER IH NG
BORDERLAND	B AO R D ER L AE N D
BORDERLANDS	B AO R D ER L AE N D Z
BORDERLINE	B AO R D ER L AY N
BORDERLINES	B AO R D ER L AY N Z
BORDERS	B AO R D ER Z
BORIDE	B AH R AY D
BORIDES	B AH R AY D Z
BOROHYDRIDE	B AH R AA HH AH D R AY D
BOROHYDRIDES	B AH R AA HH AH D R AY D Z
BOULDER	B OW L D ER
BOULDERED	B OW L D ER D
BOULDERS	B OW L D ER Z
BOULDERY	B OW L D ER IY
BOUNDED	B AW N D AH D
BOUNDED(2)	B AW N D IH D
BOUNDEDNESS	B AW N D AH D N AH S
BOUNDEDNESSES	B AW N D AH D N AH S IH Z
BOUNDEN	B AW N D AH N
BOUNDER	B AW N D ER
BOUNDERISH	B AW N D ER IH SH
BOUNDERS	B AW N D ER Z
BOURRIDE	B AH R AY D
BOURRIDES	B AH R AY D Z
BOWLDER	B OW L D AH R
BOWLDERS	B OW L D AH R Z
BRADDED	B R AE D IH D
BRAIDED	B R EY D IH D
BRAIDER	B R EY D ER
BRAIDERS	B R EY D ER Z
BRANDED	B R AE N D IH D
BRANDER	B R AE N D ER
BRANDERS	B R AE N D ER Z
BREADBOARDED	B R EH D B OW R D IH D
BREADED	B R EH D IH D
BREDE	B R IY D
BREDES	B R IY D Z
BREECHLOADER	B R IY CH L OW D ER
BREECHLOADERS	B R IY CH L OW D ER Z
BREEDER	B R IY D ER
BREEDERS	B R IY D ER Z
BRIDE	B R AY D
BRIDEGROOM	B R AY D G R UW M
BRIDEGROOMS	B R AY D G R UW M Z
BRIDES	B R AY D Z
BRIDESMAID	B R AY D Z M EY D
BRIDESMAIDS	B R AY D Z M EY D Z
BRIDEWELL	B R AY D W EH L
BRIDEWELLS	B R AY D W EH L Z
BRIGADE	B R AH G EY D
BRIGADE(2)	B R IH G EY D
BRIGADED	B R IH G EY D IH D
BRIGADES	B R IH G EY D Z
BRINDED	B R AY N D AH D
BROADEN	B R AO D AH N
BROADENED	B R AO D AH N D
BROADENING	B R AO D AH N IH NG
BROADENING(2)	B R AO D N IH NG
BROADENS	B R AO D AH N Z
BROADER	B R AO D ER
BROADEST	B R AO D IH S T
BROADSIDE	B R AO D S AY D
BROADSIDED	B R AO D S AY D IH D
BROADSIDES	B R AO D S AY D Z
BROCADE	B R OW K EY D
BROCADED	B R OW K EY D IH D
BROCADES	B R OW K EY D Z
BROIDER	B R OY D AH R
BROIDERED	B R OY D IY R D
BROIDERIES	B R OY D AH R AY Z
BROIDERING	B R OY D IY R AH NG
BROIDERS	B R OY D AH R Z
BROIDERY	B R OY D AH R IY
BROMIDE	B R OW M AY D
BROMIDES	B R OW M AY D Z
BROODED	B R UW D IH D
BROODER	B R UW D ER
BROODERS	B R UW D ER Z
BUBBLEHEADED	B AH B AH L HH EH D IH D
BUDDED	B AH D IH D
BUDDER	B AH D ER
BUDDERS	B AH D ER Z
BUILDED	B IH L D IH D
BUILDER	B IH L D ER
BUILDERS	B IH L D ER Z
BULLHEADED	B UH L HH EH D IH D
BULLHEADEDLY	B UH L HH EH D AH D L IY
BULLHEADEDNESS	B UH L HH EH D AH D N AH S
BULLHEADEDNESSES	B UH L HH EH D AH D N AH S IH Z
BURDEN	B ER D AH N
BURDENED	B ER D AH N D
BURDENER	B ER D AH N ER
BURDENERS	B ER D AH N ER Z
BURDENING	B ER D AH N IH NG
BURDENS	B ER D AH N Z
BURDENSOME	B ER D AH N S AH M
BURLADERO	B AH R L AE D AH R OW
BURLADEROS	B ER L EY D ER AA S
BURNSIDES	B ER N S AY D Z
BUTYRALDEHYDE	B Y UW T AH R AE L D AH HH AY D
BUTYRALDEHYDES	B Y UW T AH R AE L D AH HH AY D Z
BYSTANDER	B AY S T AE N D ER
BYSTANDERS	B AY S T AE N D ER Z
CACODEMON	K AH K AA D AH M AH N
CACODEMONIC	K AH K AA D AH M AH N AH K
CACODEMONS	K AH K AA D AH M AH N Z
CADE	K EY D
CADELLE	K AE D AH L
CADELLES	K AE D AH L Z
CADENCE	K EY D AH N S
CADENCED	K EY D AH N S T
CADENCES	K EY D AH N S IH Z
CADENCIES	K EY D AH N S IY Z
CADENCING	K EY D AH N S IH NG
CADENCY	K EY D AH N S IY
CADENT	K EY D AH N T
CADENTIAL	K EY D AH N T IY AH L
CADENZA	K AH D EH N Z AH
CADENZAS	K AH D EH N Z AH Z
CADES	K EY D Z
CADET	K AH D EH T
CADETS	K AH D EH T S
CADETSHIP	K AH D EH T SH IH P
CADETSHIPS	K AH D EH T SH IH P S
CALAMANDER	K AE L AH M AE N D ER
CALAMANDERS	K AE L AH M AE N D AH R Z
CALDERA	K AE L D EH R AH
CALDERA(2)	K AO L D EH R AH
CALDERAS	K AE L D AH R AH Z
CALENDER	K AH L EH N D AH R
CALENDERED	K AE L AH N D IY R D
CALENDERER	K AE L AH N D IY R AH R
CALENDERERS	K AH L EH N D AH R AH R Z
CALENDERING	K AE L AH N D IY R AH NG
CALENDERS	K AH L EH N D AH R Z
CAMARADERIE	K AA M ER AA D ER IY
CAMARADERIES	K AA M AH R AA D AH R IY Z
CAMCORDER	K AE M K AO R D ER
CAMCORDERS	K AE M K AO R D ER Z
CAMISADE	K AE M IY Z EY D
CAMISADES	K AE M IY Z EY D Z
CANDELA	K AE N D EH L AH
CANDELABRA	K AE N D AH L AA B R AH
CANDELABRAS	K AE N D AH L AE B R AH Z
CANDELABRUM	K AE N D IY L AE B R AH M
CANDELABRUMS	K AE N D IY L AE B R AH M Z
CANDELAS	K AE N D AH L AH Z
CANDENT	K AE N D AH N T
CANDESCENCE	K AE N D EH S AH N S
CANDESCENCES	K AE N D AH S EH N S AH Z
CANDESCENT	K AE N D IH S EH N T
CANDIDER	K AE N D AH D ER
CANDIDEST	K AE N D AH D AH S T
CANDLEHOLDER	K AE N D AH L HH OW L D ER
CANDLEHOLDERS	K AE N D AH L HH OW L D ER Z
CANNONADE	K AE N AH N EY D
CANNONADED	K AE N AH N EY D IH D
CANNONADES	K AE N AH N EY D Z
CANTHARIDES	K AE N TH AH R AY D Z
CARBAMIDE	K AA R B AH M AY D
CARBAMIDES	K AA R B AH M AY D Z
CARBIDE	K AA R B AY D
CARBIDES	K AA R B AY D Z
CARBONADE	K AA R B AH N EY D
CARBONADES	K AA R B AH N EY D Z
CARBONNADE	K AA R B AH N EY D
CARBONNADES	K AA R B AH N EY D Z
CARDED	K AA R D IH D
CARDER	K AA R D ER
CARDERS	K AA R D ER Z
CARDHOLDER	K AA R D HH OW L D ER
CARDHOLDERS	K AA R D HH OW L D ER Z
CARDITIDES	K AA R D AH T AY D Z
CARRONADE	K AE R AH N EY D
CARRONADES	K AE R AH N EY D Z
CARYATIDES	K AE R IY AE T AH D IY Z
CARYOPSIDES	K AE R AY AH P S AY D Z
CASCADE	K AE S K EY D
CASCADED	K AE S K EY D IH D
CASCADES	K AE S K EY D Z
CATHODE	K AE TH OW D
CATHODES	K AE TH OW D Z
CAUDEX	K AO D AH K S
CAUDEXES	K AO D AH K S
CAVALCADE	K AE V AH L K EY D
CAVALCADES	K AE V AH L K EY D Z
CEDE	S IY D
CEDED	S IY D AH D
CEDED(2)	S IY D IH D
CEDER	S IY D ER
CEDERS	S EH D AH R Z
CEDES	S IY D Z
CENTIGRADE	S EH N T AH G R EY D
CENTIPEDE	S EH N T IH P IY D
CENTIPEDES	S EH N T AH P IY D Z
CEREBROSIDE	S AH R EH B R AH S AY D
CEREBROSIDES	S AH R EH B R AH S AY D Z
CERTITUDE	S ER T AH T UW D
CERTITUDES	S ER T AH T UW D Z
CESTODE	S EH S T OW D
CESTODES	S EH S T OW D Z
CHALCOGENIDE	CH AE L K AA JH AH N AY D
CHALCOGENIDES	CH AE L K AA JH AH N AY D Z
CHAMADE	CH AH M EY D
CHAMADES	CH AH M EY D Z
CHANDELIER	SH AE N D AH L IH R
CHANDELIERED	SH AE N D AH L IH ER D
CHANDELIERS	SH AE N D AH L IH Z
CHANDELLE	SH AE N D EH L
CHANDELLED	SH AE N D EH L D
CHANDELLES	SH AE N D EH L Z
CHANDELLING	SH AE N D EH L IH NG
CHARADE	SH ER EY D
CHARADES	SH ER EY D Z
CHEDER	CH IY D AH R
CHEDERS	CH EH D AH R Z
CHEERLEADER	CH IH R L IY D ER
CHEERLEADERS	CH IH R L IY D ER Z
CHICKADEE	CH IH K EY D IY
CHICKADEES	CH IH K EY D IY Z
CHIDDEN	CH IH D AH N
CHIDE	CH AY D
CHIDED	CH AY D IH D
CHIDER	CH AY D ER
CHIDERS	CH AY D ER Z
CHIDES	CH AY D Z
CHIFFONADE	CH IH F AH N EY D
CHIFFONADES	CH IH F AH N EY D Z
CHILDE	CH IH L D
CHILDES	CH IH L D Z
CHLAMYDES	K L AH M AY D Z
CHLORDIAZEPOXIDE	K L AO R D IY AH Z EH P AH K S AY D
CHLORDIAZEPOXIDES	K L AO R D IY AH Z EH P AH K S AY D Z
CHLORIDE	K L AO R AY D
CHLORIDES	K L OW R AY D Z
CHLOROTHIAZIDE	K L AH R AA TH IY AH Z AY D
CHLOROTHIAZIDES	K L AH R AA TH IY AH Z AY D Z
CHLORPROPAMIDE	K L AO R P R AA P AH M AY D
CHLORPROPAMIDES	K L AO R P R AA P AH M AY D Z
CHOLECYSTITIDES	CH AH L AH S IH S T AH T AY D Z
CHORDAMESODERM	CH AO R D AH M EH S AH D AH R M
CHORDAMESODERMAL	CH AO R D AH M EH S AH D AH R M AH L
CHORDAMESODERMS	CH AO R D AH M EH S AH D AH R M Z
CHORDED	K AO R D IH D
CHORIOALLANTOIDES	CH AH R IY OW L AH N T OY D Z
CHOWDER	CH AW D ER
CHOWDERED	CH AW D ER D
CHOWDERHEAD	CH AW D ER HH EH D
CHOWDERHEADED	CH AW D ER HH EH D IH D
CHOWDERHEADS	CH AW D ER HH EH D Z
CHOWDERING	CH AW D ER IH NG
CHOWDERS	CH AW D ER Z
CHROMIDE	K R AH M AY D
CHROMIDES	K R AH M AY D Z
CHRYSALIDES	K R IH S AH L AY D Z
CHUCKLEHEADED	CH AH K AH L HH EH D IH D
CHUDDER	CH AH D AH R
CHUDDERS	CH AH D AH R Z
CHURCHWARDEN	CH ER CH W ER D AH N
CHURCHWARDENS	CH ER CH W ER D AH N Z
CIDER	S AY D ER
CIDERS	S AY D ER Z
CINDER	S IH N D ER
CINDERBLOCK	S IH N D ER B L AA K
CINDERBLOCKS	S IH N D ER B L AA K S
CINDERED	S IH N D ER D
CINDERING	S IH N D ER IH NG
CINDERS	S IH N D ER Z
CINDERY	S IH N D ER IY
CITADEL	S IH T AH D EH L
CITADELS	S IH T AH D AH L Z
CITYWIDE	S IH T IY W AY D
CLADE	K L EY D
CLADES	K L EY D Z
CLADODE	K L AH D OW D
CLADODES	K L AH D OW D Z
CLANDESTINE	K L AE N D EH S T IH N
CLANDESTINELY	K L AE N D EH S T AH N L IY
CLANDESTINENESS	K L AE N D EH S T AH N AH S
CLANDESTINENESSES	K L AE N D EH S T AH N AH S IH Z
CLANDESTINITIES	K L AE N D EH S T AH N AH T IY Z
CLANDESTINITY	K L AE N D EH S T AH N AH T IY
CLAPBOARDED	K L AE P B OW R D IH D
CLEANHANDED	K L IY N HH AE N D IH D
CLEARHEADED	K L IH ER HH EH D IH D
CLEARHEADEDLY	K L IH ER HH EH D AH D L IY
CLEARHEADEDNESS	K L IH ER HH EH D AH D N AH S
CLEARHEADEDNESSES	K L IH ER HH EH D AH D N AH S IH Z
CLITORIDECTOMIES	K L IH T AH R AH D EH K T AH M AY Z
CLITORIDECTOMY	K L IH T AH R AH D EH K T AH M IY
CLITORIDES	K L IH T AH R AY D Z
CLOUDED	K L AW D IH D
CLOWDER	K L OW D AH R
CLOWDERS	K L OW D AH R Z
COATTENDED	K OW AH T EH N D IH D
COCKADE	K AA K EY D
COCKADED	K AA K EY D IH D
COCKADES	K AA K EY D Z
CODDED	K AA D IH D
CODDER	K AA D ER
CODDERS	K AA D ER Z
CODE	K OW D
CODEBOOK	K OW D IY B UH K
CODEBOOKS	K OW D IY B UH K S
CODEBTOR	K OW D EH T ER
CODEBTORS	K OW D EH T ER Z
CODEC	K OW D EH K
CODECS	K OW D EH K S
CODED	K OW D IH D
CODEFENDANT	K OW D IY F EH N D AH N T
CODEFENDANTS	K OW D IY F EH N D AH N T S
CODEIA	K OW D IY IY AH
CODEIAS	K OW D IY AY AH Z
CODEIN	K OW D IY IH N
CODEINA	K OW D IY AH N AA
CODEINAS	K OW D IY AH N AE Z
CODEINE	K OW D IY IH N
CODEINES	K OW D IY AY N Z
CODEINS	K OW D IY IH N Z
CODELESS	K OW D L AH S
CODEN	K OW D EH N
CODENS	K OW D EH N Z
CODEPENDENCE	K OW D IH P EH N D AH N S
CODEPENDENCES	K OW D IH P EH N D AH N S IH Z
CODEPENDENCIES	K OW D IH P EH N D AH N S IY Z
CODEPENDENCY	K OW D IH P EH N D AH N S IY
CODEPENDENT	K OW D IY P EH N D EH N T
CODEPENDENTS	K OW D IY P EH N D EH N T S
CODER	K OW D ER
CODERIVE	K OW D IH R AY V
CODERIVED	K OW D IH R AY V D
CODERIVES	K OW D IH R AY V Z
CODERIVING	K OW D IH R AY V IH NG
CODERS	K OW D ER Z
CODES	K OW D Z
CODESIGN	K OW D IH Z AY N
CODESIGNED	K OW D IH Z AY N D
CODESIGNING	K OW D IH Z AY N IH NG
CODESIGNS	K OW D IH Z AY N Z
CODETERMINATION	K OW D IY T ER M AH N EY SH AH N
CODETERMINATIONS	K OW D IY T ER M AH N EY SH AH N Z
CODEVELOP	K OW D IH V EH L AH P
CODEVELOPED	K OW D IH V EH L AH P T
CODEVELOPER	K OW D IH V EH L AH P ER
CODEVELOPERS	K OW D IH V EH L AH P ER Z
CODEVELOPING	K OW D IH V EH L AH P IH NG
CODEVELOPS	K OW D IH V EH L AH P S
CODEX	K OW D EH K S
COEXTENDED	K OW IH K S T EH N D IH D
COFOUNDED	K OW F AW N D IH D
COFOUNDER	K OW F AW N D ER
COFOUNDERS	K OW F AW N D ER Z
COHEADED	K OW HH EH D IH D
COHOLDER	K OW HH OW L D ER
COHOLDERS	K OW HH OW L D ER Z
COINCIDE	K OW IH N S AY D
COINCIDED	K OW AH N S AY D AH D
COINCIDENCE	K OW IH N S IH D AH N S
COINCIDENCES	K OW IH N S AH D AH N S IH Z
COINCIDENT	K OW IH N S AH D AH N T
COINCIDENTAL	K OW IH N S AH D EH N T AH L
COINCIDENTALLY	K OW IH N S IH D EH N T AH L IY
COINCIDENTLY	K OW IH N S AH D AH N T L IY
COINCIDES	K OW IH N S AY D Z
COLANDER	K AA L AH N D ER
COLANDERS	K AA L AH N D ER Z
COLATITUDE	K OW L AE T AH T UW D
COLATITUDES	K OW L AE T AH T UW D Z
COLDBLOODED	K OW L D B L AH D IH D
COLDER	K OW L D ER
COLDEST	K OW L D AH S T
COLEADER	K OW L IY D ER
COLEADERS	K OW L IY D ER Z
COLLIDE	K AH L AY D
COLLIDED	K AH L AY D IH D
COLLIDER	K AH L AY D ER
COLLIDERS	K AH L AY D ER Z
COLLIDES	K AH L AY D Z
COLLUDE	K AH L UW D
COLLUDED	K AH L UW D IH D
COLLUDER	K AA L UW D AH R
COLLUDERS	K AA L UW D AH R Z
COLLUDES	K AA L UW D Z
COLONNADE	K AA L AH N EY D
COLONNADED	K AA L AH N EY D IH D
COLONNADES	K AA L AH N EY D Z
COMADE	K AH M EY D
COMMANDED	K AH M AE N D IH D
COMMANDEER	K AA M AH N D IH R
COMMANDEERED	K AA M AH N D IH R D
COMMANDEERING	K AA M AH N D IH ER IH NG
COMMANDEERS	K AA M AH N D IH ER Z
COMMANDER	K AH M AE N D ER
COMMANDERIES	K AH M AE N D AH R IY Z
COMMANDERS	K AH M AE N D ER Z
COMMANDERSHIP	K AH M AE N D ER SH IH P
COMMANDERSHIPS	K AH M AE N D ER SH IH P S
COMMANDERY	K AH M AE N D AH R IY
COMMENDED	K AH M EH N D IH D
COMMENDER	K AH M EH N D ER
COMMENDERS	K AH M EH N D ER Z
COMMODE	K AH M OW D
COMMODES	K AH M OW D Z
COMPOUNDED	K AH M P AW N D AH D
COMPOUNDED(2)	K AH M P AW N D IH D
COMPOUNDER	K AH M P AW N D ER
COMPOUNDERS	K AH M P AW N D ER Z
COMPREHENDED	K AA M P R IH HH EH N D IH D
COMRADE	K AA M R AE D
COMRADELINESS	K AA M R AE D L IY N AH S
COMRADELINESSES	K AA M R AE D L IY N AH S IH Z
COMRADELY	K AA M R AE D L IY
COMRADERIES	K AA M R AE D AH R IY Z
COMRADERY	K AA M R AE D AH R IY
COMRADES	K AA M R AE D Z
COMRADESHIP	K AA M R AE D SH IH P
COMRADESHIPS	K AA M R AE D SH IH P S
CONCEDE	K AH N S IY D
CONCEDED	K AH N S IY D IH D
CONCEDEDLY	K AH N S IY D AH D L IY
CONCEDER	K AH N S IY D ER
CONCEDERS	K AH N S IY D ER Z
CONCEDES	K AH N S IY D Z
CONCLUDE	K AH N K L UW D
CONCLUDED	K AH N K L UW D AH D
CONCLUDED(2)	K AH N K L UW D IH D
CONCLUDER	K AH N K L UW D ER
CONCLUDERS	K AH N K L UW D ER Z
CONCLUDES	K AH N K L UW D Z
CONDEMN	K AH N D EH M
CONDEMNABLE	K AH N D EH M AH B AH L
CONDEMNATION	K AA N D AH M N EY SH AH N
CONDEMNATIONS	K AA N D AH M N EY SH AH N Z
CONDEMNATORY	K AH N D EH M N AH T OW R IY
CONDEMNED	K AH N D EH M D
CONDEMNER	K AH N D EH M ER
CONDEMNERS	K AH N D EH M ER Z
CONDEMNING	K AH N D EH M IH NG
CONDEMNOR	K AH N D EH M ER
CONDEMNORS	K AH N D EH M ER Z
CONDEMNS	K AH N D EH M Z
CONDENSABLE	K AH N D EH N S AH B AH L
CONDENSATE	K AA N D AH N S EY T
CONDENSATES	K AA N D AH N S EY T S
CONDENSATION	K AA N D AH N S EY SH AH N
CONDENSATIONAL	K AA N D EH N S EY SH AH N AH L
CONDENSATIONS	K AA N D EH N S EY SH AH N Z
CONDENSE	K AH N D EH N S
CONDENSED	K AH N D EH N S T
CONDENSER	K AH N D EH N S ER
CONDENSERS	K AH N D EH N S ER Z
CONDENSES	K AH N D EH N S IH Z
CONDENSIBLE	K AH N D EH N S AH B AH L
CONDENSING	K AH N D EH N S IH NG
CONDESCEND	K AA N D IH S EH N D
CONDESCENDED	K AA N D IH S EH N D IH D
CONDESCENDENCE	K AA N D IH S EH N D AH N S
CONDESCENDENCES	K AA N D IH S EH N D AH N S IH Z
CONDESCENDING	K AA N D IH S EH N D IH NG
CONDESCENDINGLY	K AA N D IH S EH N D IH NG L IY
CONDESCENDS	K AA N D IH S EH N D Z
CONDESCENSION	K AA N D AH S EH N SH AH N
CONDESCENSIONS	K AA N D IH S EH N CH AH N Z
CONFEDERACIES	K AH N F EH D ER AH S IY Z
CONFEDERACY	K AH N F EH D ER AH S IY
CONFEDERACY(2)	K AH N F EH D R AH S IY
CONFEDERAL	K AH N F EH D ER AH L
CONFEDERATE	K AH N F EH D ER AH T
CONFEDERATE(2)	K AH N F EH D ER EY T
CONFEDERATED	K AH N F EH D ER EY T IH D
CONFEDERATES	K AH N F EH D ER AH T S
CONFEDERATING	K AH N F EH D ER EY T IH NG
CONFEDERATION	K AH N F EH D ER EY SH AH N
CONFEDERATIONS	K AH N F EH D ER EY SH AH N Z
CONFEDERATIVE	K AH N F EH D ER AH T IH V
CONFIDE	K AH N F AY D
CONFIDED	K AH N F AY D IH D
CONFIDENCE	K AA N F AH D EH N S
CONFIDENCES	K AA N F AH D EH N S IH Z
CONFIDENT	K AA N F AH D AH N T
CONFIDENTIAL	K AA N F AH D EH N SH AH L
CONFIDENTIALITIES	K AA N F AH D EH N CH IY AE L AH T IY Z
CONFIDENTIALITY	K AA N F AH D EH N SH IY AE L AH T IY
CONFIDENTIALLY	K AA N F AH D EH N SH AH L IY
CONFIDENTLY	K AA N F AH D AH N T L IY
CONFIDER	K AH N F AY D ER
CONFIDERS	K AH N F AY D ER Z
CONFIDES	K AH N F AY D Z
CONFOUNDED	K AH N F AW N D IH D
CONFOUNDEDLY	K AH N F AW N D AH D L IY
CONFOUNDER	K AH N F AW N D ER
CONFOUNDERS	K AH N F AW N D ER Z
CONSIDER	K AH N S IH D ER
CONSIDERABLE	K AH N S IH D ER AH B AH L
CONSIDERABLES	K AH N S IH D ER AH B AH L Z
CONSIDERABLY	K AH N S IH D ER AH B L IY
CONSIDERATE	K AH N S IH D ER AH T
CONSIDERATELY	K AH N S IH D ER AH T L IY
CONSIDERATENESS	K AH N S IH D ER AH T N AH S
CONSIDERATENESSES	K AH N S IH D ER AH T N AH S IH Z
CONSIDERATION	K AH N S IH D ER EY SH AH N
CONSIDERATIONS	K AH N S IH D ER EY SH AH N Z
CONSIDERED	K AH N S IH D ER D
CONSIDERING	K AH N S IH D ER IH NG
CONSIDERS	K AH N S IH D ER Z
CONSUETUDE	K AA N S UW AH T Y UW D
CONSUETUDES	K AA N S UW AH T Y UW D Z
CONTENDED	K AH N T EH N D IH D
CONTENDER	K AH N T EH N D ER
CONTENDERS	K AH N T EH N D ER Z
COOLHEADED	K UW L HH EH D IH D
COPRESIDENT	K OW P R EH Z AH D AH N T
COPRESIDENTS	K OW P R EH Z AH D AH N T S
COPYDESK	K AA P IY D EH S K
COPYDESKS	K AA P IY D EH S K S
COPYHOLDER	K AA P IY HH OW L D ER
COPYHOLDERS	K AA P IY HH OW L D ER Z
COPYREADER	K AA P IY R IY D ER
COPYREADERS	K AA P IY R IY D ER Z
CORDED	K AO R D AH D
CORDELLE	K AA R D EH L
CORDELLED	K AA R D EH L D
CORDELLES	K AA R D EH L Z
CORDELLING	K AA R D EH L AH NG
CORDER	K AO R D ER
CORDERS	K AO R D ER Z
COREDEEM	K OW R IY D IY M
COREDEEMED	K OW R IY D IY M D
COREDEEMING	K OW R IY D IY M IH NG
COREDEEMS	K OW R IY D IY M Z
CORESIDENT	K OW R EH Z AH D AH N T
CORESIDENTIAL	K OW R EH Z AH D EH N CH AH L
CORESIDENTS	K OW R EH Z AH D AH N T S
CORESPONDENT	K AO R AH S P AA N D AH N T
CORESPONDENTS	K OW R IH S P AA N D AH N T S
CORIANDER	K AO R IY AE N D ER
CORIANDERS	K AO R IY AE N D ER Z
COROMANDEL	K OW R AH M AE N D AH L
COROMANDELS	K OW R AH M AE N D AH L Z
CORRADE	K AA R EY D
CORRADED	K AA R EY D AH D
CORRADES	K AA R EY D Z
CORRECTITUDE	K AH R EH K T AH T UW D
CORRECTITUDES	K AH R EH K T AH T UW D Z
CORRESPONDED	K AO R AH S P AA N D IH D
CORRESPONDENCE	K AO R AH S P AA N D AH N S
CORRESPONDENCES	K AO R AH S P AA N D AH N S IH Z
CORRESPONDENCIES	K AO R AH S P AA N D AH N S IY Z
CORRESPONDENCY	K AO R AH S P AA N D AH N S IY
CORRESPONDENT	K AO R AH S P AA N D AH N T
CORRESPONDENTS	K AO R AH S P AA N D AH N T S
CORRODE	K ER OW D
CORRODED	K ER OW D IH D
CORRODES	K ER OW D Z
COUDE	K OW Y UW D IY
COULDEST	K OW AH L D AH S T
COUNTERBADE	K AW N T ER B IY EY D
COUNTERBIDDEN	K AW N T ER B IH D AH N
COUNTERBLOCKADE	K AW N T ER B L AA K EY D
COUNTERBLOCKADED	K AW N T ER B L AA K EY D IH D
COUNTERBLOCKADES	K AW N T ER B L AA K EY D Z
COUNTERDEMAND	K AW N T ER D IH M AE N D
COUNTERDEMANDS	K AW N T ER D IH M AE N D Z
COUNTERDEMONSTRATE	K AW N T ER D EH M AH N S T R AH T
COUNTERDEMONSTRATED	K AW N T ER D EH M AH N S T R EY T IH D
COUNTERDEMONSTRATES	K AW N T ER D EH M AH N S T R AH T S
COUNTERDEMONSTRATING	K AW N T ER D EH M AH N S T R EY T IH NG
COUNTERDEMONSTRATION	K AW N T ER D EH M AH N S T R EY SH AH N
COUNTERDEMONSTRATIONS	K AW N T ER D EH M AH N S T R EY SH AH N Z
COUNTERDEMONSTRATOR	K AW N T ER D EH M AH N S T R AH T ER
COUNTERDEMONSTRATORS	K AW N T ER D EH M AH N S T R AH T ER Z
COUNTERDEPLOYMENT	K AW N T ER D IH P L OY M AH N T
COUNTERDEPLOYMENTS	K AW N T ER D IH P L OY M AH N T S
COUNTEREVIDENCE	K AW N T ER EH V AH D AH N S
COUNTEREVIDENCES	K AW N T ER EH V AH D AH N S IH Z
COUNTERMANDED	K OW AH N T AH R M AE N D AH D
COUNTERORDER	K AW N T ER AO R D ER
COUNTERORDERED	K AW N T ER AO R D ER D
COUNTERORDERING	K AW N T ER AO R D ER IH NG
COUNTERORDERS	K AW N T ER AO R D ER Z
COUNTERRAIDED	K AW N T ER R EY D IH D
COUNTERTENDENCIES	K AW N T ER T EH N D AH N S IY Z
COUNTERTENDENCY	K AW N T ER T EH N D AH N S IY
COUNTERTRADE	K AW N T ER T R EY D
COUNTERTRADES	K AW N T ER T R EY D Z
COUNTRYSIDE	K AH N T R IY S AY D
COUNTRYSIDES	K AH N T R IY S AY D Z
COUNTRYWIDE	K AH N T R IY W AY D
COURTSIDE	K OW R T S AY D
COURTSIDES	K OW R T S AY D Z
COUVADE	K OW Y AH V EY D
COUVADES	K OW Y AH V EY D Z
COWHIDE	K AW HH AY D
COWHIDED	K AW HH AY D IH D
COWHIDES	K AW HH AY D Z
COXITIDES	K OW Z AH T AY D Z
CRASSITUDE	K R AE S AH T UW D
CRASSITUDES	K R AE S AH T UW D Z
CREDENCE	K R IY D AH N S
CREDENCES	K R EH D AH N S IH Z
CREDENDA	K R AH D EH N D AH
CREDENDUM	K R AH D EH N D AH M
CREDENT	K R EH D AH N T
CREDENTIAL	K R IH D EH N SH AH L
CREDENTIAL(2)	K R AH D EH N SH AH L
CREDENTIALED	K R AH D EH N SH AH L D
CREDENTIALING	K R IH D EH N CH AH L IH NG
CREDENTIALISM	K R IH D EH N CH AH L IH Z AH M
CREDENTIALISMS	K R IH D EH N CH AH L IH Z AH M Z
CREDENTIALLED	K R IH D EH N CH AH L D
CREDENTIALLING	K R IH D EH N CH AH L IH NG
CREDENTIALS	K R AH D EH N SH AH L Z
CREDENZA	K R AH D EH N Z AH
CREDENZAS	K R AH D EH N Z AH Z
CROOKEDER	K R UH K AH D ER
CROOKEDEST	K R UH K AH D AH S T
CROSSBANDED	K R AO S B AE N D IH D
CROUSTADE	K R AW S T EY D
CROUSTADES	K R AW S T EY D Z
CROWDED	K R AW D AH D
CROWDED(2)	K R AW D IH D
CROWDEDNESS	K R AW D AH D N AH S
CROWDEDNESSES	K R AW D AH D N AH S IH Z
CROWDER	K R AW D ER
CROWDERS	K R AW D ER Z
CRUDDED	K R AH D AH D
CRUDE	K R UW D
CRUDELY	K R UW D L IY
CRUDENESS	K R UW D N AH S
CRUDENESSES	K R UW D N AH S IH Z
CRUDER	K R UW D ER
CRUDES	K R UW D Z
CRUDEST	K R UW D AH S T
CRUNODE	K R UW N OW D
CRUNODES	K R UW N OW D Z
CRUSADE	K R UW S EY D
CRUSADED	K R UW S EY D IH D
CRUSADER	K R UW S EY D ER
CRUSADERS	K R UW S EY D ER Z
CRUSADES	K R UW S EY D Z
CUCKOLDED	K AH K OW L D AH D
CULLENDER	K AH L EH N D AH R
CULLENDERS	K AH L EH N D AH R Z
CURBSIDE	K ER B S AY D
CURBSIDES	K ER B S AY D Z
CURDED	K ER D IH D
CURSEDER	K ER S T ER
CURSEDEST	K ER S T AH S T
CUSPIDES	K AH S AY D Z
CUSTODES	K AH S T OW D Z
CYANAMIDE	S AY AE N AH M AY D
CYANAMIDES	S AY AE N AH M AY D Z
CYANIDE	S AY AH N AY D
CYANIDE(2)	S AY N AY D
CYANIDED	S AY AH N AY D AH D
CYANIDES	S AY AH N AY D Z
CYCADEOID	S AH K EY D IY OY D
CYCADEOIDS	S AH K EY D IY OY D Z
CYCLODEXTRIN	S IH K L AH D EH K S T R AH N
CYCLODEXTRINS	S IH K L AH D EH K S T R AH N Z
CYCLOHEXIMIDE	S IH K L AH HH EH K S AH M AY D
CYCLOHEXIMIDES	S IH K L AH HH EH K S AH M AY D Z
CYCLOPHOSPHAMIDE	S IH K L AH F AA S AH M AY D
CYCLOPHOSPHAMIDES	S IH K L AH F AA S AH M AY D Z
CYDER	S AY D AH R
CYDERS	S IH D AH R Z
CYLINDER	S IH L AH N D ER
CYLINDER(2)	S IH L IH N D ER
CYLINDERED	S IH L AH N D ER D
CYLINDERING	S IH L AH N D ER IH NG
CYLINDERS	S IH L AH N D ER Z
CYSTITIDES	S IH S T AH T AY D Z
DAMNDEST	D AE M N D AH S T
DAMNDESTS	D AE M N D AH S T S
DAMNEDER	D AE M D ER
DAMNEDEST	D AE M D AH S T
DAMNEDESTS	D AE M D AH S T S
DANDELION	D AE N D AH L AY AH N
DANDELIONS	D AE N D AH L AY AH N Z
DANDER	D AE N D AH R
DANDERED	D AE N D IY R D
DANDERING	D AE N D IY R AH NG
DANDERS	D AE N D AH R Z
DAREDEVIL	D EH R D EH V AH L
DAREDEVILRIES	D EH R D EH V AH L R IY Z
DAREDEVILRY	D EH R D EH V AH L R IY
DAREDEVILS	D EH R D EH V AH L Z
DAREDEVILTRIES	D EH R D EH V AH L T R AY Z
DAREDEVILTRY	D EH R D EH V AH L T R AY
DARNDEST	D AA R N D AH S T
DARNDESTS	D AA R N D AH S T S
DARNEDER	D AA R N D ER
DARNEDEST	D AA R N D EH S T
DARNEDEST(2)	D AA R N EH S T
DAUNDER	D AO N D AH R
DAUNDERED	D AO N D IY R D
DAUNDERING	D AO N D IY R AH NG
DAUNDERS	D AO N D AH R Z
DAYSIDE	D EY S AY D
DAYSIDES	D EY S AY D Z
DAYTRADER	D EY T R EY D ER
DAYTRADERS	D EY T R EY D ER Z
DE	D IY
DE(2)	D EY
DE(3)	D AH
DEACIDIFICATION	D IY AE S AH D AH F AH K EY SH AH N
DEACIDIFICATIONS	D IY AE S AH D AH F AH K EY SH AH N Z
DEACIDIFIED	D IY AE S AH D AH F AY D
DEACIDIFIES	D IY AE S AH D AH F AY Z
DEACIDIFY	D IY AE S AH D AH F AY
DEACIDIFYING	D IY AE S AH D AH F AY IH NG
DEACON	D IY K AH N
DEACONED	D IY K AH N D
DEACONESS	D IY K AH N AH S
DEACONESSES	D IY K AH N AH S IH Z
DEACONING	D IY K AH N IH NG
DEACONRIES	D IY K AH N R IY Z
DEACONRY	D IY K AH N R IY
DEACONS	D IY K AH N Z
DEACTIVATE	D IY AE K T IH V EY T
DEACTIVATED	D IY AE K T IH V EY T IH D
DEACTIVATES	D IY AE K T IH V AH T S
DEACTIVATING	D IY AE K T IH V EY T IH NG
DEACTIVATION	D IY AE K T IH V EY SH AH N
DEACTIVATIONS	D IY AE K T IH V EY SH AH N Z
DEACTIVATOR	D IY AE K T IH V AH T ER
DEACTIVATORS	D IY AE K T IH V AH T ER Z
DEAD	D EH D
DEADBEAT	D EH D B IY T
DEADBEATS	D EH D B IY T S
DEADBOLT	D EH D B OW L T
DEADBOLTS	D EH D B OW L T S
DEADEN	D EH D AH N
DEADENED	D EH D AH N D
DEADENER	D EH D AH N ER
DEADENERS	D EH D AH N ER Z
DEADENING	D EH D AH N IH NG
DEADENING(2)	D EH D N IH NG
DEADENINGLY	D EH D AH N IH NG L IY
DEADENINGS	D EH D AH N IH NG Z
DEADENS	D EH D AH N Z
DEADER	D EH D ER
DEADEST	D EH D AH S T
DEADEYE	D EH D AY
DEADEYES	D EH D AY Z
DEADFALL	D EH D F AO L
DEADFALLS	D EH D F AO L Z
DEADHEAD	D EH D HH EH D
DEADHEADED	D EH D HH EH D IH D
DEADHEADING	D EH D HH EH D IH NG
DEADHEADS	D EH D HH EH D Z
DEADLIER	D EH D L IY ER
DEADLIEST	D EH D L IY AH S T
DEADLIFT	D EH D L IH F T
DEADLIFTED	D EH D L IH F T IH D
DEADLIFTING	D EH D L IH F T IH NG
DEADLIFTS	D EH D L IH F T S
DEADLIGHT	D EH D L AY T
DEADLIGHTS	D EH D L AY T S
DEADLINE	D EH D L AY N
DEADLINES	D EH D L AY N Z
DEADLINESS	D EH D L IY N AH S
DEADLINESSES	D EH D L IY N AH S IH Z
DEADLOCK	D EH D L AA K
DEADLOCKED	D EH D L AA K T
DEADLOCKING	D EH D L AA K IH NG
DEADLOCKS	D EH D L AA K S
DEADLY	D EH D L IY
DEADNESS	D EH D N AH S
DEADNESSES	D EH D N AH S IH Z
DEADPAN	D EH D P AE N
DEADPANNED	D EH D P AE N D
DEADPANNER	D EH D P AE N ER
DEADPANNERS	D EH D P AE N ER Z
DEADPANNING	D EH D P AE N IH NG
DEADPANS	D EH D P AE N Z
DEADS	D EH D Z
DEADWEIGHT	D EH D W EY T
DEADWEIGHTS	D EH D W EY T S
DEADWOOD	D EH D W UH D
DEADWOODS	D EH D W UH D Z
DEAERATE	D IY AE ER AH T
DEAERATED	D IY AE ER EY T IH D
DEAERATES	D IY AE ER AH T S
DEAERATING	D IY AE ER EY T IH NG
DEAERATION	D IY AE ER EY SH AH N
DEAERATIONS	D IY AE ER EY SH AH N Z
DEAERATOR	D IY AE ER AH T ER
DEAERATORS	D IY AE ER AH T ER Z
DEAF	D EH F
DEAFEN	D EH F AH N
DEAFENED	D EH F AH N D
DEAFENING	D EH F AH N IH NG
DEAFENING(2)	D EH F N IH NG
DEAFENINGLY	D EH F AH N IH NG L IY
DEAFENS	D EH F AH N Z
DEAFER	D EH F ER
DEAFEST	D EH F AH S T
DEAFISH	D EH F IH SH
DEAFLY	D EH F L IY
DEAFNESS	D EH F N AH S
DEAFNESSES	D EH F N AH S IH Z
DEAIR	D IY EH R
DEAIRED	D IY EH R D
DEAIRING	D IY EH R IH NG
DEAIRS	D IY EH R Z
DEAL	D IY L
DEALATE	D IY L AH T
DEALATED	D IY L EY T IH D
DEALATES	D IY L AH T S
DEALATION	D IY L EY SH AH N
DEALATIONS	D IY L EY SH AH N Z
DEALER	D IY L ER
DEALERS	D IY L ER Z
DEALERSHIP	D IY L ER SH IH P
DEALERSHIPS	D IY L ER SH IH P S
DEALFISH	D IY L F IH SH
DEALFISHES	D IY L F IH SH IH Z
DEALING	D IY L IH NG
DEALINGS	D IY L IH NG Z
DEALS	D IY L Z
DEALT	D EH L T
DEAMINASE	D IY AE M AH N EY Z
DEAMINASES	D IY AE M AH N EY Z AH Z
DEAMINATE	D IY AH M AY N AH T
DEAMINATED	D IY AH M AY N EY T IH D
DEAMINATES	D IY AH M AY N AH T S
DEAMINATING	D IY AH M AY N EY T IH NG
DEAMINATION	D IY AH M AY N EY SH AH N
DEAMINATIONS	D IY AH M AY N EY SH AH N Z
DEAN	D IY N
DEANED	D IY N D
DEANERIES	D IY N AH R IY Z
DEANERY	D IY N AH R IY
DEANING	D IY N IH NG
DEANS	D IY N Z
DEANSHIP	D IY N SH IH P
DEANSHIPS	D IY N SH IH P S
DEAR	D IH R
DEARER	D IH R ER
DEAREST	D IH R AH S T
DEARIE	D IH ER IY
DEARIES	D IH ER IY Z
DEARLY	D IH R L IY
DEARNESS	D IH ER N AH S
DEARNESSES	D IH ER N AH S IH Z
DEARS	D IH ER Z
DEARTH	D ER TH
DEARTHS	D ER TH S
DEARY	D IH R IY
DEASH	D IY AE SH
DEASHED	D IY AH SH EH D
DEASHES	D IY AE SH IH Z
DEASHING	D IY AE SH IH NG
DEASIL	D IY AE S AH L
DEATH	D EH TH
DEATHBED	D EH TH B EH D
DEATHBEDS	D EH TH B EH D Z
DEATHBLOW	D EH TH B L OW
DEATHBLOWS	D EH TH B L OW Z
DEATHCUP	D EH TH K AH P
DEATHCUPS	D EH TH K AH P S
DEATHFUL	D EH TH F AH L
DEATHLESS	D EH TH L AH S
DEATHLESSLY	D EH TH L AH S L IY
DEATHLESSNESS	D EH TH L AH S N AH S
DEATHLESSNESSES	D EH TH L AH S N AH S IH Z
DEATHLIKE	D EH TH L AY K
DEATHLY	D EH TH L IY
DEATHS	D EH TH S
DEATHSMAN	D EH TH S M AE N
DEATHSMEN	D EH TH S M EH N
DEATHTRAP	D EH TH T R AE P
DEATHTRAPS	D EH TH T R AE P S
DEATHWATCH	D EH TH W AA CH
DEATHWATCHES	D EH TH W AA CH IH Z
DEATHY	D EH TH IY
DEAVE	D IY EY V
DEAVED	D IY EY V D
DEAVES	D IY EY V Z
DEAVING	D IY EY V AH NG
DEB	D EH B
DEBACLE	D AH B AA K AH L
DEBACLES	D EY B AA K AH L Z
DEBAR	D IY B AA R
DEBARK	D IY B AA R K
DEBARKATION	D IY B AA R K EY SH AH N
DEBARKATIONS	D IY B AA R K EY SH AH N Z
DEBARKED	D IY B AA R K T
DEBARKING	D IY B AA R K IH NG
DEBARKS	D IY B AA R K S
DEBARMENT	D IH B AA R M AH N T
DEBARMENTS	D IY B AA R M AH N T S
DEBARRED	D IY B AA R D
DEBARRING	D IY B AA R IH NG
DEBARS	D IY B AA R Z
DEBASE	D AH B EY S
DEBASED	D AH B EY S T
DEBASEMENT	D AH B EY S M AH N T
DEBASEMENTS	D IY B EY S M AH N T S
DEBASER	D IY B EY S ER
DEBASERS	D IY B EY S ER Z
DEBASES	D IY B EY S IH Z
DEBASING	D IH B EY S IH NG
DEBATABLE	D AH B EY T AH B AH L
DEBATE	D AH B EY T
DEBATED	D AH B EY T IH D
DEBATEMENT	D AH B EY T M AH N T
DEBATEMENTS	D AH B EY T M AH N T S
DEBATER	D AH B EY T ER
DEBATERS	D AH B EY T ER Z
DEBATES	D AH B EY T S
DEBATING	D AH B EY T IH NG
DEBAUCH	D AH B AO CH
DEBAUCHED	D AH B AO CH T
DEBAUCHEE	D AH B AO CH IY
DEBAUCHEES	D AH B AO CH IY Z
DEBAUCHER	D AH B AO CH ER
DEBAUCHERIES	D AH B AO CH AH R IY Z
DEBAUCHERS	D AH B AO CH ER Z
DEBAUCHERY	D AH B AO CH ER IY
DEBAUCHES	D AH B AO CH IH Z
DEBAUCHING	D AH B AO CH IH NG
DEBEAK	D IH B AH AE K
DEBEAKED	D IH B AH EY K T
DEBEAKING	D IY B IH AH K IH NG
DEBEAKS	D IH B AH AE K S
DEBENTURE	D AH B EH N CH ER
DEBENTURES	D AH B EH N CH ER Z
DEBILITATE	D AH B IH L AH T EY T
DEBILITATED	D AH B IH L AH T EY T IH D
DEBILITATES	D AH B IH L AH T AH T S
DEBILITATING	D AH B IH L AH T EY T IH NG
DEBILITATION	D AH B IH L AH T EY SH AH N
DEBILITATIONS	D AH B IH L AH T EY SH AH N Z
DEBILITIES	D AH B IH L AH T IY Z
DEBILITY	D AH B IH L AH T IY
DEBIT	D EH B IH T
DEBITED	D IY B AY T EH D
DEBITING	D IY B AY T IH NG
DEBITS	D IY B IH T S
DEBONAIR	D EH B AH N EH R
DEBONAIRLY	D EH B AH N EH R L IY
DEBONAIRNESS	D EH B AH N EH R N AH S
DEBONAIRNESSES	D EH B AH N EH R N AH S IH Z
DEBONE	D IY B OW N
DEBONED	D IY B OW N D
DEBONER	D IY B OW N ER
DEBONERS	D IY B OW N ER Z
DEBONES	D IY B OW N Z
DEBONING	D IY B OW N IH NG
DEBOUCH	D AH B AW CH
DEBOUCHE	D AH B AW CH
DEBOUCHED	D AH B AW CH T
DEBOUCHES	D AH B AW CH AH Z
DEBOUCHING	D AH B AW CH AH NG
DEBOUCHMENT	D AH B AW CH M AH N T
DEBOUCHMENTS	D AH B AW CH M AH N T S
DEBRIDE	D IY B R AY D
DEBRIDED	D IY B R AY D IH D
DEBRIDEMENT	D IY B R AY D M AH N T
DEBRIDEMENTS	D IY B R AY D M AH N T S
DEBRIDES	D IY B R AY D Z
DEBRIDING	D IY B R AY D IH NG
DEBRIEF	D IH B R IY F
DEBRIEFED	D IH B R IY F T
DEBRIEFING	D IH B R IY F IH NG
DEBRIEFINGS	D IY B R IY F IH NG Z
DEBRIEFS	D IH B R IY F S
DEBRIS	D AH B R IY
DEBRUISE	D IY B R UW Z
DEBRUISED	D IY B R UW Z D
DEBRUISES	D IY B R UW Z IH Z
DEBRUISING	D IY B R UW Z IH NG
DEBS	D EH B Z
DEBT	D EH T
DEBTLESS	D EH T L AH S
DEBTOR	D EH T ER
DEBTORS	D EH T ER Z
DEBTS	D EH T S
DEBUG	D IY B AH G
DEBUGGED	D IY B AH G D
DEBUGGER	D IY B UH G ER
DEBUGGERS	D IY B UH G ER Z
DEBUGGING	D IY B AH G IH NG
DEBUGS	D IY B AH G Z
DEBUNK	D IH B AH NG K
DEBUNKED	D IH B AH NG K T
DEBUNKER	D IY B AH NG K ER
DEBUNKERS	D IY B AH NG K ER Z
DEBUNKING	D IH B AH NG K IH NG
DEBUNKS	D IH B AH NG K S
DEBUT	D EY B Y UW
DEBUTANT	D EY B Y UW AH N T
DEBUTANTE	D EH B Y AH T AA N T
DEBUTANTES	D EH B Y AH T AA N T S
DEBUTANTS	D EY B Y UW AH N T S
DEBUTED	D EY B Y UW D
DEBUTED(2)	D EY B Y UW T IH D
DEBUTING	D EY B Y UW T IH NG
DEBUTS	D EY B Y UW Z
DEBYE	D AH B AY
DEBYES	D AH B AY Z
DECADAL	D EH K AH D AH L
DECADE	D EH K EY D
DECADENCE	D EH K AH D AH N S
DECADENCES	D EH K AH D AH N S IH Z
DECADENCIES	D EH K AH D AH N S IY Z
DECADENCY	D EH K AH D AH N S IY
DECADENT	D EH K AH D AH N T
DECADENTLY	D EH K AH D AH N T L IY
DECADENTS	D EH K AH D AH N T S
DECADES	D EH K EY D Z
DECAF	D IY K AE F
DECAFFEINATE	D IY K AE F AH N EY T
DECAFFEINATED	D IY K AE F AH N EY T IH D
DECAFFEINATES	D AH K AE F AH N EY T S
DECAFFEINATING	D IY K AE F AH N EY T IH NG
DECAFFEINATION	D IY K AE F AH N EY SH AH N
DECAFFEINATIONS	D AH K AE F AH N EY T IY AH N Z
DECAFS	D AH K AE F S
DECAGON	D AH K AE G AH N
DECAGONS	D AH K AE G AH N Z
DECAGRAM	D AH K AE G R AH M
DECAGRAMS	D AH K AE G R AH M Z
DECAHEDRA	D AH K AH HH EH D R AH
DECAHEDRON	D AH K AH HH EH D R AH N
DECAHEDRONS	D AH K AH HH EH D R AH N Z
DECAL	D IY S AH L
DECALCIFICATION	D IY K AE L S AH F AH K EY SH AH N
DECALCIFICATIONS	D IY K AE L S AH F AH K EY SH AH N Z
DECALCIFIED	D IY K AE L S AH F AY D
DECALCIFIES	D IY K AE L S AH F AY Z
DECALCIFY	D IY K AE L S AH F AY
DECALCIFYING	D IY K AE L S AH F AY IH NG
DECALCOMANIA	D IY S AH L K OW M EY N IY AH
DECALCOMANIAS	D IY S AH L K OW M EY N IY AH Z
DECALITER	D IH K AH L AY T AH R
DECALITERS	D AH K AE L AH T AH R Z
DECALOG	D AH K AE L AH G
DECALOGS	D AH K AE L AH G Z
DECALOGUE	D AH K AE L AH G
DECALOGUES	D AH K AE L AH G Z
DECALS	D IY K AE L Z
DECAMETER	D AH K AE M AH T AH R
DECAMETERS	D AH K AE M AH T AH R Z
DECAMETHONIUM	D AH K AE M AH TH OW N IY AH M
DECAMETHONIUMS	D AH K AE M AH TH OW N IY AH M Z
DECAMETRIC	D AH K AE M AH T R AH K
DECAMP	D AH K AE M P
DECAMPED	D IY K AE M P T
DECAMPING	D IY K AE M P IH NG
DECAMPMENT	D IY K AE M P M AH N T
DECAMPMENTS	D IY K AE M P M AH N T S
DECAMPS	D IY K AE M P S
DECANAL	D IY K AH N AE L
DECANE	D IY K EY N
DECANES	D IY K EY N Z
DECANT	D AH K AE N T
DECANTATION	D IY S AH N T EY SH AH N
DECANTATIONS	D IY S AH N T EY SH AH N Z
DECANTED	D IY S AH N T IH D
DECANTER	D IY K AE N T ER
DECANTERS	D IY K AE N T ER Z
DECANTING	D AH K AE N T IH NG
DECANTS	D IY S AH N T S
DECAPITATE	D IY K AE P AH T EY T
DECAPITATED	D IY K AE P AH T EY T IH D
DECAPITATES	D AH K AE P AH T EY T S
DECAPITATING	D AH K AE P AH T EY T AH NG
DECAPITATION	D IH K AE P IH T EY SH AH N
DECAPITATIONS	D IH K AE P IH T EY SH AH N Z
DECAPITATOR	D AH K AE P AH T EY T AH R
DECAPITATORS	D AH K AH P IH T AH T AH R Z
DECAPOD	D AH K AE P AH D
DECAPODAN	D AH K AE P AH D AH N
DECAPODANS	D AH K AE P AH D AH N Z
DECAPODOUS	D AH K AE P AH D AH S
DECAPODS	D AH K AE P AH D Z
DECARBONATE	D IY K AA R B AH N AH T
DECARBONATED	D IY K AA R B AH N EY T IH D
DECARBONATES	D IY K AA R B AH N AH T S
DECARBONATING	D IY K AA R B AH N EY T IH NG
DECARBONATION	D IY K AA R B AH N EY SH AH N
DECARBONATIONS	D IY K AA R B AH N EY SH AH N Z
DECARBONIZE	D IY K AA R B AH N AY Z
DECARBONIZED	D IY K AA R B AH N AY Z D
DECARBONIZER	D IY K AA R B AH N AY Z ER
DECARBONIZERS	D IY K AA R B AH N AY Z ER Z
DECARBONIZES	D IY K AA R B AH N AY Z IH Z
DECARBONIZING	D IY K AA R B AH N AY Z IH NG
DECARBOXYLASE	D AH K AH R B AA K S AH L EY Z
DECARBOXYLASES	D AH K AH R B AA K S AH L EY Z AH Z
DECARBOXYLATE	D IY S ER B AA K S IY L EY T
DECARBOXYLATED	D IY S ER B AA K S IY L EY T IH D
DECARBOXYLATES	D IY S ER B AA K S IY L EY T S
DECARBOXYLATING	D IY S ER B AA K S IY L EY T IH NG
DECARBOXYLATION	D IY S ER B AA K S IY L EY SH AH N
DECARBOXYLATIONS	D IY S ER B AA K S IY L EY SH AH N Z
DECARBURIZATION	D IY S ER B IY Y ER AH Z EY SH AH N
DECARBURIZATIONS	D IY S ER B IY Y ER AH Z EY SH AH N Z
DECARBURIZE	D IY S ER B IY Y ER AY Z
DECARBURIZED	D IY S ER B IY Y ER AY Z D
DECARBURIZES	D IY S ER B IY Y ER AY Z IH Z
DECARBURIZING	D IY S ER B IY Y ER AY Z IH NG
DECARE	D IY K EH R
DECARES	D IY K EH R Z
DECASUALIZATION	D IY K AE ZH AH W AH L AH Z EY SH AH N
DECASUALIZATIONS	D IY K AE ZH AH W AH L AH Z EY SH AH N Z
DECASYLLABIC	D AH K AH S IH L AH B AH K
DECASYLLABICS	D AH K AH S IH L AH B AH S Z
DECASYLLABLE	D AH K AH S IH L AH B AH L
DECASYLLABLES	D AH K AH S IH L AH B AH L Z
DECATHLETE	D IY K AE TH L IY T
DECATHLETES	D AH K AE TH L IY T S
DECATHLON	D IY K AE TH L AO N
DECATHLONS	D IH K AE TH L AH N Z
DECAY	D IH K EY
DECAYED	D IH K EY D
DECAYER	D IH K EY ER
DECAYERS	D IH K EY ER Z
DECAYING	D IH K EY IH NG
DECAYS	D AH K EY Z
DECEASE	D IH S IY S
DECEASED	D IH S IY S T
DECEASES	D IY S IY S IH Z
DECEASING	D IY S IY S IH NG
DECEDENT	D EH S IY D AH N T
DECEDENTS	D EH S IY D AH N T S
DECEIT	D IH S IY T
DECEITFUL	D IH S IY T F AH L
DECEITFULLY	D AH S IY T F AH L IY
DECEITFULNESS	D AH S IY T F AH L N AH S
DECEITFULNESSES	D AH S IY T F AH L N AH S IH Z
DECEITS	D IH S IY T S
DECEIVABLE	D IH S IY V AH B AH L
DECEIVE	D IH S IY V
DECEIVED	D IH S IY V D
DECEIVER	D IH S IY V ER
DECEIVERS	D IH S IY V ER Z
DECEIVES	D IH S IY V Z
DECEIVING	D IH S IY V IH NG
DECEIVINGLY	D IH S IY V IH NG L IY
DECELERATE	D IH S EH L ER EY T
DECELERATED	D IH S EH L ER EY T IH D
DECELERATES	D IY S EH L AH R EY T S
DECELERATING	D IH S EH L ER EY T IH NG
DECELERATION	D IH S EH L ER EY SH AH N
DECELERATIONS	D IY S EH L AH R EY SH AH N Z
DECELERATOR	D IY S EH L AH R EY T ER
DECELERATORS	D IY S EH L AH R EY T ER Z
DECEMVIR	D AH S EH M V AH R
DECEMVIRAL	D AH S EH M V AH R AH L
DECEMVIRATE	D AH S EH M V AH R EY T
DECEMVIRATES	D AH S EH M V AH R EY T S
DECEMVIRI	D AH S EH M V AH R IY
DECEMVIRS	D AH S EH M V AH R Z
DECENARIES	D IY S AH N EH R IY Z
DECENARY	D IY S AH N EH R IY
DECENCIES	D IY S AH N S IY Z
DECENCY	D IY S AH N S IY
DECENNIA	D AH S EH N IY AH
DECENNIAL	D AH S EH N IY AH L
DECENNIALLY	D IY S AH N IY AH L IY
DECENNIALS	D IY S AH N IY AH L Z
DECENNIUM	D AH S EH N IY AH M
DECENNIUMS	D AH S EH N IY AH M Z
DECENT	D IY S AH N T
DECENTER	D IY S EH N T ER
DECENTERED	D IY S EH N T ER D
DECENTERING	D IY S EH N T ER IH NG
DECENTERS	D IY S EH N T ER Z
DECENTEST	D IY S AH N T AH S T
DECENTLY	D IY S AH N T L IY
DECENTRALIZATION	D IH S EH N T R AH L IH Z EY SH AH N
DECENTRALIZATIONS	D IY S EH N T R AH L AH Z EY SH AH N Z
DECENTRALIZE	D IH S EH N T R AH L AY Z
DECENTRALIZED	D IH S EH N T R AH L AY Z D
DECENTRALIZES	D IY S EH N T R AH L AY Z IH Z
DECENTRALIZING	D IH S EH N T R AH L AY Z IH NG
DECENTRE	D IY S EH N T ER
DECENTRED	D IY S EH N T ER D
DECENTRES	D IY S EH N T ER Z
DECENTRING	D IY S EH N T ER IH NG
DECEPTION	D IH S EH P SH AH N
DECEPTIONAL	D IH S EH P SH AH N AH L
DECEPTIONS	D IH S EH P SH AH N Z
DECEPTIVE	D IH S EH P T IH V
DECEPTIVELY	D IH S EH P T IH V L IY
DECEPTIVENESS	D IH S EH P T IH V N AH S
DECEPTIVENESSES	D IH S EH P T IH V N AH S IH Z
DECEREBRATE	D IY S EH R AH B R AH T
DECEREBRATED	D IY S EH R AH B R EY T IH D
DECEREBRATES	D IY S EH R AH B R AH T S
DECEREBRATING	D IY S EH R AH B R EY T IH NG
DECEREBRATION	D IY S EH R AH B R EY SH AH N
DECEREBRATIONS	D IY S EH R AH B R EY SH AH N Z
DECERN	D AH S AH R N
DECERNED	D AH S AH R N D
DECERNING	D AH S AH R N AH NG
DECERNS	D AH S AH R N Z
DECERTIFICATION	D IY S ER T AH F AH K EY SH AH N
DECERTIFICATIONS	D IY S ER T AH F AH K EY SH AH N Z
DECERTIFIED	D IY S ER T AH F AY D
DECERTIFIES	D IY S ER T AH F AY Z
DECERTIFY	D IY S ER T AH F AY
DECERTIFYING	D IY S ER T AH F AY IH NG
DECHLORINATE	D IY K L OW R IY N AH T
DECHLORINATED	D IY K L OW R IY N EY T IH D
DECHLORINATES	D IY K L OW R IY N AH T S
DECHLORINATING	D IY K L OW R IY N EY T IH NG
DECHLORINATION	D IY K L OW R IY N EY SH AH N
DECHLORINATIONS	D IY K L OW R IY N EY SH AH N Z
DECIARE	D AH S AY AH R
DECIARES	D AH S AY AH R Z
DECIBEL	D EH S AH B EH L
DECIBELS	D EH S AH B AH L Z
DECIDABILITIES	D IH S AY D AH B IH L AH T EH Z
DECIDABILITY	D IH S AY D AH B IH L AH T EH
DECIDABLE	D IH S AY D AH B AH L
DECIDE	D IH S AY D
DECIDED	D IH S AY D IH D
DECIDEDLY	D IH S AY D AH D L IY
DECIDEDNESS	D IH S AY D AH D N AH S
DECIDEDNESSES	D IH S AY D AH D N AH S IH Z
DECIDER	D IH S AY D ER
DECIDERS	D IY S AY D ER Z
DECIDES	D IH S AY D Z
DECIDING	D IH S AY D IH NG
DECIDUA	D AH S IH D Y UW AH
DECIDUAE	D AH S IH D Y UW IY
DECIDUAL	D AH S IH D Y AH W AH
DECIDUAS	D AH S IH D Y UW AH Z
DECIDUATE	D AH S IH D Y UW EY T
DECIDUOUS	D IH S IH JH UW AH S
DECIDUOUSNESS	D AH S IH D Y UW AW Z N AH S
DECIDUOUSNESSES	D AH S IH D Y UW AW Z N EH S AH Z
DECIGRAM	D AH S IH G R AH M
DECIGRAMS	D AH S IH G R AH M Z
DECILE	D IY S AH L
DECILES	D IY S AH L Z
DECILITER	D EH S AH L IY T ER
DECILITERS	D AH S IH L AH T AH R Z
DECILLION	D AH S IH L IY AH N
DECILLIONS	D AH S IH L IY AH N Z
DECIMAL	D EH S AH M AH L
DECIMALIZATION	D EH S AH M AH L AH Z EY SH AH N
DECIMALIZATIONS	D EH S AH M AH L AH Z EY SH AH N Z
DECIMALIZE	D EH S AH M AH L AY Z
DECIMALIZED	D EH S AH M AH L AY Z D
DECIMALIZES	D EH S AH M AH L AY Z IH Z
DECIMALIZING	D EH S AH M AH L AY Z IH NG
DECIMALLY	D EH S AH M AH L IY
DECIMALS	D EH S AH M AH L Z
DECIMATE	D EH S AH M EY T
DECIMATED	D EH S AH M EY T IH D
DECIMATES	D IH S AH M EY T S
DECIMATING	D EH S AH M EY T IH NG
DECIMATION	D EH S AH M EY SH AH N
DECIMATIONS	D AH S AH M EY T IY AH N Z
DECIMETER	D AH S IH M AH T AH R
DECIMETERS	D AH S IH M AH T AH R Z
DECIPHER	D IH S AY F ER
DECIPHERABLE	D IY S AY F ER AH B AH L
DECIPHERED	D IH S AY F ER D
DECIPHERER	D IY S AY F ER ER
DECIPHERERS	D IY S AY F ER ER Z
DECIPHERING	D AH S AY F ER IH NG
DECIPHERMENT	D IY S AY F ER M AH N T
DECIPHERMENTS	D IY S AY F ER M AH N T S
DECIPHERS	D IY S AY F ER Z
DECISION	D IH S IH ZH AH N
DECISIONAL	D IH S IH ZH AH N AH L
DECISIONED	D IH S IH ZH AH N D
DECISIONING	D IH S IH ZH AH N IH NG
DECISIONS	D IH S IH ZH AH N Z
DECISIVE	D IH S AY S IH V
DECISIVELY	D IH S AY S IH V L IY
DECISIVENESS	D IH S AY S IH V N AH S
DECISIVENESSES	D AH S AY S IH V N AH S IH Z
DECK	D EH K
DECKED	D EH K T
DECKEL	D IH K EH L
DECKELS	D IH K EH L Z
DECKER	D EH K ER
DECKERS	D IY S ER Z
DECKHAND	D EH K HH AE N D
DECKHANDS	D EH K HH AE N D Z
DECKHOUSE	D EH K HH AW S
DECKHOUSES	D EH K HH AW S IH Z
DECKING	D EH K IH NG
DECKINGS	D EH K IH NG Z
DECKLE	D IH K AH L
DECKLES	D EH K AH L Z
DECKS	D EH K S
DECLAIM	D IH K L EY M
DECLAIMED	D IH K L EY M D
DECLAIMER	D IY K L EY M ER
DECLAIMERS	D IY K L EY M ER Z
DECLAIMING	D IY K L EY M IH NG
DECLAIMS	D IY K L EY M Z
DECLAMATION	D IY K L AE M EY SH AH N
DECLAMATIONS	D IY K L AE M EY SH AH N Z
DECLAMATORY	D IH K L AE M AH T OW R IY
DECLARABLE	D IY K L AE R AH B AH L
DECLARANT	D IH K L EH R AH N T
DECLARANTS	D IY K L AE R AH N T S
DECLARATION	D EH K L ER EY SH AH N
DECLARATIONS	D EH K L ER EY SH AH N Z
DECLARATIVE	D IH K L AE R AH T IH V
DECLARATIVELY	D IH K L AE R AH T IH V L IY
DECLARATORY	D IH K L EH R AH T AO R IY
DECLARE	D IH K L EH R
DECLARED	D IH K L EH R D
DECLARER	D IY K L AE R ER
DECLARERS	D IY K L AE R ER Z
DECLARES	D IH K L EH R Z
DECLARING	D IH K L EH R IH NG
DECLASS	D IY K L AE S
DECLASSE	D IH K L AE S
DECLASSED	D IY K L AE S T
DECLASSES	D IY K L AE S IH Z
DECLASSIFICATION	D IY K L AE S AH F AH K EY SH AH N
DECLASSIFICATIONS	D IY K L AE S AH F AH K EY SH AH N Z
DECLASSIFIED	D IH K L AE S AH F AY D
DECLASSIFIES	D IY K L AE S AH F AY Z
DECLASSIFY	D IH K L AE S AH F AY
DECLASSIFYING	D IY K L AE S AH F AY IH NG
DECLASSING	D IY K L AE S IH NG
DECLAW	D IY K L AO
DECLAWED	D IY K L AO D
DECLAWING	D IY K L AO IH NG
DECLAWS	D IY K L AO Z
DECLENSION	D IH K L EH N Z IY AH N
DECLENSIONAL	D IH K L EH N S IY AH N AH L
DECLENSIONS	D IH K L EH N S IY AH N Z
DECLINABLE	D IH K L AY N AH B AH L
DECLINATION	D EH K L AH N EY SH AH N
DECLINATIONAL	D EH K L AH N EY SH AH N AH L
DECLINATIONS	D EH K L AH N EY SH AH N Z
DECLINE	D IH K L AY N
DECLINED	D IH K L AY N D
DECLINER	D IH K L AY N ER
DECLINERS	D IH K L AY N ER Z
DECLINES	D IH K L AY N Z
DECLINING	D IH K L AY N IH NG
DECLIVITIES	D IH K L IH V AH T IY Z
DECLIVITOUS	D IH K L IH V AH T AH S
DECLIVITY	D IH K L IH V AH T IY
DECO	D EH K OW
DECOCT	D AH K AA K T
DECOCTED	D AH K AA K T AH D
DECOCTING	D AH K AA K T AH NG
DECOCTION	D AH K AA K AH N
DECOCTIONS	D AH K AH K T AY AH N Z
DECOCTS	D AH K AA K T S
DECODE	D IH K OW D
DECODED	D IH K OW D AH D
DECODER	D IH K OW D ER
DECODERS	D IH K OW D ER Z
DECODES	D IH K OW D Z
DECODING	D IH K OW D IH NG
DECOLLATE	D IY K AH L EY T
DECOLLATED	D IY K AH L EY T IH D
DECOLLATES	D IY K AH L EY T S
DECOLLATING	D IY K AH L EY T IH NG
DECOLLATION	D IY K AH L EY SH AH N
DECOLLATIONS	D IY K AH L EY SH AH N Z
DECOLLETAGE	D EY K AA L AH T AA ZH
DECOLLETAGES	D EY K AA L AH T AA ZH IH Z
DECOLLETE	D IH K AH L IY T
DECOLLETES	D IH K AH L IY T S
DECOLONIZATION	D IY K OW L AH N AH Z EY SH AH N
DECOLONIZATIONS	D IY K OW L AH N AH Z EY SH AH N Z
DECOLONIZE	D IY K AA L AH N AY Z
DECOLONIZED	D IY K AA L AH N AY Z D
DECOLONIZES	D IY K AA L AH N AY Z IH Z
DECOLONIZING	D IY K AA L AH N AY Z IH NG
DECOLOR	D IY K AH L ER
DECOLORED	D IY K AH L ER D
DECOLORING	D IY K AH L ER IH NG
DECOLORIZATION	D IY K AH L ER AH Z EY SH AH N
DECOLORIZATIONS	D IY K AH L ER AH Z EY SH AH N Z
DECOLORIZE	D IY K AH L ER AY Z
DECOLORIZED	D IY K AH L ER AY Z D
DECOLORIZER	D IY K AH L ER AY Z ER
DECOLORIZERS	D IY K AH L ER AY Z ER Z
DECOLORIZES	D IY K AH L ER AY Z IH Z
DECOLORIZING	D IY K AH L ER AY Z IH NG
DECOLORS	D IY K AH L ER Z
DECOLOUR	D IY K AH L ER
DECOLOURED	D IY K AH L ER D
DECOLOURING	D IY K AH L ER IH NG
DECOLOURS	D IY K AH L ER Z
DECOMMISSION	D IY K AH M IH SH AH N
DECOMMISSIONED	D IY K AH M IH SH AH N D
DECOMMISSIONING	D IY K AH M IH SH AH N IH NG
DECOMMISSIONS	D IY K AH M IH SH AH N Z
DECOMPENSATE	D IY K AA M P AH N S EY T
DECOMPENSATED	D IY K AA M P AH N S EY T IH D
DECOMPENSATES	D IY K AA M P AH N S EY T S
DECOMPENSATING	D IY K AA M P AH N S EY T IH NG
DECOMPENSATION	D IY K AH M P EH N S EY SH AH N
DECOMPENSATIONS	D IY K AH M P EH N S EY SH AH N Z
DECOMPOSABILITIES	D IY K AH M P OW Z AH B IH L AH T EH Z
DECOMPOSABILITY	D IY K AH M P OW Z AH B IH L AH T EH
DECOMPOSABLE	D IY K AH M P OW Z AH B AH L
DECOMPOSE	D IY K AH M P OW Z
DECOMPOSED	D IY K AH M P OW Z D
DECOMPOSER	D IY K AH M P OW Z ER
DECOMPOSERS	D IY K AH M P OW Z ER Z
DECOMPOSES	D IY K AH M P OW Z IH Z
DECOMPOSING	D IY K AH M P OW Z IH NG
DECOMPOSITION	D IY K AH M P OW Z IH SH AH N
DECOMPOSITION(2)	D IY K AH M P AH Z IH SH AH N
DECOMPOSITIONS	D IY K AA M P AH Z IH SH AH N Z
DECOMPOUND	D IY K AH M P AW N D
DECOMPRESS	D IY K AH M P R EH S
DECOMPRESSED	D IY K AH M P R EH S T
DECOMPRESSES	D IY K AH M P R EH S IH Z
DECOMPRESSING	D IY K AH M P R EH S IH NG
DECOMPRESSION	D IY K AH M P R EH SH AH N
DECOMPRESSIONS	D IY K AH M P R EH SH AH N Z
DECONCENTRATE	D IY K AA N S AH N T R EY T
DECONCENTRATED	D IY K AA N S AH N T R EY T IH D
DECONCENTRATES	D IY K AA N S AH N T R EY T S
DECONCENTRATING	D IY K AA N S AH N T R EY T IH NG
DECONCENTRATION	D IY K AA N S AH N T R EY SH AH N
DECONCENTRATIONS	D IY K AA N S AH N T R EY SH AH N Z
DECONDITION	D IY K AH N D IH SH AH N
DECONDITIONED	D IY K AH N D IH SH AH N D
DECONDITIONING	D IY K AH N D IH SH AH N IH NG
DECONDITIONS	D IY K AH N D IH SH AH N Z
DECONGEST	D IY K AH N JH EH S T
DECONGESTANT	D IH K AH N JH EH S T AH N T
DECONGESTANT(2)	D IY K AH N JH EH S T AH N T
DECONGESTANTS	D IH K AH N JH EH S T AH N T S
DECONGESTANTS(2)	D IY K AH N JH EH S T AH N T S
DECONGESTED	D IY K AH N JH EH S T IH D
DECONGESTING	D IY K AH N JH EH S T IH NG
DECONGESTION	D IY K AH N JH EH S SH AH N
DECONGESTIONS	D IY K AH N JH EH S SH AH N Z
DECONGESTIVE	D IY K AH N JH EH S T IH V
DECONGESTS	D IY K AH N JH EH S T S
DECONSECRATE	D IY K AA N S AH K R EY T
DECONSECRATED	D IY K AA N S AH K R EY T IH D
DECONSECRATES	D IY K AA N S AH K R EY T S
DECONSECRATING	D IY K AA N S AH K R EY T IH NG
DECONSECRATION	D IY K AA N S AH K R EY SH AH N
DECONSECRATIONS	D IY K AA N S AH K R EY SH AH N Z
DECONSTRUCT	D IY K AH N S T R AH K T
DECONSTRUCTED	D IY K AH N S T R AH K T IH D
DECONSTRUCTING	D IY K AH N S T R AH K T IH NG
DECONSTRUCTION	D IY K AH N S T R AH K SH AH N
DECONSTRUCTIONIST	D IY K AH N S T R AH K SH AH N IH S T
DECONSTRUCTIONISTS	D IY K AH N S T R AH K SH AH N IH S T S
DECONSTRUCTIONS	D IY K AH N S T R AH K SH AH N Z
DECONSTRUCTIVE	D IY K AH N S T R AH K T IH V
DECONSTRUCTOR	D IY K AH N S T R AH K T ER
DECONSTRUCTORS	D IY K AH N S T R AH K T ER Z
DECONSTRUCTS	D IY K AH N S T R AH K T S
DECONTAMINATE	D IY K AH N T AE M AH N EY T
DECONTAMINATED	D IY K AH N T AE M AH N EY T IH D
DECONTAMINATES	D IY K AH N T AE M AH N AH T S
DECONTAMINATING	D IY K AH N T AE M AH N EY T IH NG
DECONTAMINATION	D IY K AH N T AE M AH N EY SH AH N
DECONTAMINATIONS	D IY K AH N T AE M AH N EY SH AH N Z
DECONTAMINATOR	D IY K AH N T AE M AH N AH T ER
DECONTAMINATORS	D IY K AH N T AE M AH N AH T ER Z
DECONTROL	D IY K AH N T R OW L
DECONTROLLED	D IY K AH N T R OW L D
DECONTROLLING	D IY K AH N T R OW L IH NG
DECONTROLS	D IY K AH N T R OW L Z
DECOR	D IH K AO R
DECOR(2)	D EY K AO R
DECORATE	D EH K ER EY T
DECORATED	D EH K ER EY T AH D
DECORATED(2)	D EH K ER EY T IH D
DECORATES	D EH K AH R EY T S
DECORATING	D EH K ER EY T IH NG
DECORATION	D EH K ER EY SH AH N
DECORATIONS	D EH K ER EY SH AH N Z
DECORATIVE	D EH K R AH T IH V
DECORATIVELY	D EH K AH R EY T IH V L IY
DECORATIVENESS	D EH K AH R EY T IH V N AH S
DECORATIVENESSES	D EH K AH R EY T IH V N AH S IH Z
DECORATOR	D EH K ER EY T ER
DECORATORS	D EH K ER EY T ER Z
DECOROUS	D EH K ER AH S
DECOROUSLY	D EH K AH R AH S L IY
DECOROUSNESS	D EH K AH R AH S N AH S
DECOROUSNESSES	D EH K AH R AH S N AH S IH Z
DECORS	D EY K AO R Z
DECORTICATE	D IY K AO R T AH K EY T
DECORTICATED	D IY K AO R T AH K EY T IH D
DECORTICATES	D IY K AO R T AH K EY T S
DECORTICATING	D IY K AO R T AH K EY T IH NG
DECORTICATION	D IY K AO R T AH K EY SH AH N
DECORTICATIONS	D IY K AO R T AH K EY SH AH N Z
DECORTICATOR	D IY K AO R T AH K EY T ER
DECORTICATORS	D IY K AO R T AH K EY T ER Z
DECORUM	D IH K AO R AH M
DECORUMS	D IH K OW R AH M Z
DECOS	D AH K AA Z
DECOUPAGE	D IY K UW P EY IH JH
DECOUPAGED	D IY K UW P EY IH JH D
DECOUPAGES	D IY K UW P EY IH JH IH Z
DECOUPAGING	D IY K UW P EY IH JH IH NG
DECOUPLE	D IY K AH P AH L
DECOUPLED	D IY K AH P AH L D
DECOUPLES	D IY K AH P AH L Z
DECOUPLING	D IY K AH P L IH NG
DECOY	D AH K OY
DECOYED	D IY K OY D
DECOYER	D IY K OY ER
DECOYERS	D IY K OY ER Z
DECOYING	D IY K OY IH NG
DECOYS	D IY K OY Z
DECREASE	D IH K R IY S
DECREASE(2)	D IY K R IY S
DECREASED	D IH K R IY S T
DECREASED(2)	D IY K R IY S T
DECREASES	D IH K R IY S AH Z
DECREASES(2)	D IH K R IY S IH Z
DECREASES(3)	D IY K R IY S IH Z
DECREASING	D IH K R IY S IH NG
DECREASING(2)	D IY K R IY S IH NG
DECREASINGLY	D IH K R IY S IH NG L IY
DECREE	D IH K R IY
DECREED	D IH K R IY D
DECREEING	D IH K R IY IH NG
DECREER	D EH K R IH R
DECREERS	D IH K R IH R Z
DECREES	D IH K R IY Z
DECREMENT	D EH K R AH M AH N T
DECREMENTAL	D EH K R AH M AH N T AH L
DECREMENTED	D EH K R AH M AH N T IH D
DECREMENTING	D EH K R AH M AH N T IH NG
DECREMENTS	D EH K R AH M AH N T S
DECREPIT	D AH K R EH P IH T
DECREPITATE	D IH K R EH P AH T EY T
DECREPITATED	D IH K R EH P AH T EY T AH D
DECREPITATES	D IH K R EH P AH T EY T S
DECREPITATING	D IH K R EH P AH T EY T AH NG
DECREPITATION	D IH K R EH P AH T EY SH AH N
DECREPITATIONS	D IH K R EH P AH T EY T IY AH N Z
DECREPITLY	D AH K R EH P IH T L IY
DECREPITUDE	D IY K R EY P AH T UW D
DECREPITUDES	D IY K R EY P AH T UW D Z
DECRESCENDO	D IY K R IH SH EH N D OW
DECRESCENDOS	D IY K R IH SH EH N D OW Z
DECRESCENT	D IY K R EH S AH N T
DECRETAL	D IH K R IY T AH L
DECRETALS	D IH K R EH T AH L Z
DECRETIVE	D IH K R IY T AH V
DECRETORY	D IH K R AH T AO R IY
DECRIAL	D IY S R IY AH L
DECRIALS	D IY S R IY AH L Z
DECRIED	D IH K R AY D
DECRIER	D IY S R IY ER
DECRIERS	D IY S R IY ER Z
DECRIES	D IH K R AY Z
DECRIMINALIZATION	D IY K R IH M AH N AH L AH Z EY SH AH N
DECRIMINALIZATIONS	D IY K R IH M AH N AH L AH Z EY SH AH N Z
DECRIMINALIZE	D IY K R IH M AH N AH L AY Z
DECRIMINALIZED	D IY K R IH M AH N AH L AY Z D
DECRIMINALIZES	D IY K R IH M AH N AH L AY Z IH Z
DECRIMINALIZING	D IY K R IH M AH N AH L AY Z IH NG
DECROWN	D IY K R AW N
DECROWNED	D IY K R AW N D
DECROWNING	D IY K R AW N IH NG
DECROWNS	D IY K R AW N Z
DECRY	D IH K R AY
DECRYING	D IH K R AY IH NG
DECRYPT	D IY K R IH P T
DECRYPTED	D IY K R IH P T IH D
DECRYPTING	D IY K R IH P T IH NG
DECRYPTION	D IY K R IH P SH AH N
DECRYPTIONS	D IY K R IH P SH AH N Z
DECRYPTS	D IY K R IH P T S
DECUMAN	D IH K Y UW M AH N
DECUMBENT	D AH K AH M B AH N T
DECUPLE	D IH K Y UW P AH L
DECUPLED	D IY K AH P L EH D
DECUPLES	D AH K AH P AH L Z
DECUPLING	D IY K AH P L IH NG
DECURIES	D IY K Y UH R IY Z
DECURION	D IY S Y ER IY AH N
DECURIONS	D IY S Y ER IY AH N Z
DECURRENT	D IY K ER AH N T
DECURVE	D IY K ER V
DECURVED	D IY K ER V D
DECURVES	D IY K ER V Z
DECURVING	D IY K ER V IH NG
DECURY	D IY S Y ER IY
DECUSSATE	D IH K AH S EY T
DECUSSATED	D IH K AH S EY T AH D
DECUSSATES	D IH K AH S EY T S
DECUSSATING	D IH K AH S EY T AH NG
DECUSSATION	D IH K AH S EY SH AH N
DECUSSATIONS	D AH K AH S EY T IY AH N Z
DEDAL	D IY D AH L
DEDANS	D AH D AE N Z
DEDICATE	D EH D AH K EY T
DEDICATED	D EH D AH K EY T AH D
DEDICATEDLY	D EH D IH K AH T AH D L IY
DEDICATEE	D EH D IH K AH T IY
DEDICATEES	D EH D IH K AH T IY Z
DEDICATES	D EH D IH K EY T S
DEDICATING	D EH D IH K EY T IH NG
DEDICATION	D EH D AH K EY SH AH N
DEDICATIONS	D EH D IH K EY SH AH N Z
DEDICATOR	D EH D IH K AH T ER
DEDICATORS	D EH D IH K AH T ER Z
DEDICATORY	D EH D IH K AH T OW R IY
DEDIFFERENTIATE	D IY D IH F AH R EH N CH IY AH T
DEDIFFERENTIATED	D IY D IH F AH R EH N CH IY EY T IH D
DEDIFFERENTIATES	D IY D IH F AH R EH N CH IY AH T S
DEDIFFERENTIATING	D IY D IH F AH R EH N CH IY EY T IH NG
DEDIFFERENTIATION	D IY D IH F AH R EH N CH IY EY SH AH N
DEDIFFERENTIATIONS	D IY D IH F AH R EH N CH IY EY SH AH N Z
DEDUCE	D IH D UW S
DEDUCED	D IH D UW S T
DEDUCES	D IH D UW S IH Z
DEDUCIBLE	D IH D UW S AH B AH L
DEDUCING	D IH D UW S IH NG
DEDUCT	D IH D AH K T
DEDUCTED	D IH D AH K T IH D
DEDUCTIBILITIES	D IY D AH K T AH B IH L AH T IY Z
DEDUCTIBILITY	D IH D AH K T AH B IH L AH T IY
DEDUCTIBLE	D IH D AH K T AH B AH L
DEDUCTIBLES	D IH D AH K T AH B AH L Z
DEDUCTING	D IH D AH K T IH NG
DEDUCTION	D IH D AH K SH AH N
DEDUCTIONS	D IH D AH K SH AH N Z
DEDUCTIVE	D IH D AH K T AH V
DEDUCTIVELY	D IH D AH K T AH V L IY
DEDUCTS	D IH D AH K T S
DEE	D IY
DEED	D IY D
DEEDED	D IY D AH D
DEEDED(2)	D IY D IH D
DEEDIER	D IY D IY ER
DEEDIEST	D IY D IY AH S T
DEEDING	D IY D IH NG
DEEDLESS	D IY D L AH S
DEEDS	D IY D Z
DEEDY	D IY D IY
DEEJAY	D IY EH JH EY IY
DEEJAYS	D IY AH JH EY Z
DEEM	D IY M
DEEMED	D IY M D
DEEMING	D IY M IH NG
DEEMPHASIZE	D IY EH M F AH S AY Z
DEEMPHASIZED	D IY EH M F AH S AY Z D
DEEMPHASIZES	D IY EH M F AH S AY Z IH Z
DEEMPHASIZING	D IY EH M F AH S AY Z IH NG
DEEMS	D IY M Z
DEEMSTER	D IY M S T ER
DEEMSTERS	D IY M S T ER Z
DEEP	D IY P
DEEPEN	D IY P AH N
DEEPENED	D IY P AH N D
DEEPENER	D IY P AH N ER
DEEPENERS	D IY P AH N ER Z
DEEPENING	D IY P AH N IH NG
DEEPENS	D IY P AH N Z
DEEPER	D IY P ER
DEEPEST	D IY P AH S T
DEEPLY	D IY P L IY
DEEPNESS	D IY P N AH S
DEEPNESSES	D IY P N AH S IH Z
DEEPS	D IY P S
DEEPWATER	D IY P W AO T ER
DEER	D IH R
DEERBERRIES	D IH ER B EH R IY Z
DEERBERRY	D IH ER B EH R IY
DEERFLIES	D IH ER F L AY Z
DEERFLY	D IH ER F L AY
DEERHOUND	D IH ER HH AW N D
DEERHOUNDS	D IH ER HH AW N D Z
DEERLIKE	D IH ER L AY K
DEERS	D IH ER Z
DEERSKIN	D IH R S K IH N
DEERSKINS	D IH ER S K IH N Z
DEERSTALKER	D IH ER S T AO K ER
DEERSTALKERS	D IH ER S T AO K ER Z
DEERWEED	D IH ER W IY D
DEERWEEDS	D IH ER W IY D Z
DEERYARD	D IH ER Y AA R D
DEERYARDS	D IH ER Y AA R D Z
DEES	D IY Z
DEESCALATE	D IY EH S K AH L EY T
DEESCALATED	D IY EH S K AH L EY T IH D
DEESCALATES	D IY EH S K AH L EY T S
DEESCALATING	D IY EH S K AH L EY T IH NG
DEESCALATION	D IY EH S K AH L EY SH AH N
DEESCALATIONS	D IY EH S K AH L EY SH AH N Z
DEET	D IY T
DEETS	D IY T S
DEEWAN	D IY Y UW AH N
DEEWANS	D IY Y UW AH N Z
DEFACE	D IH F EY S
DEFACED	D IH F EY S T
DEFACEMENT	D IY F EY S M AH N T
DEFACEMENTS	D IY F EY S M AH N T S
DEFACER	D IY F EY S ER
DEFACERS	D IY F EY S ER Z
DEFACES	D IY F EY S IH Z
DEFACING	D IH F EY S IH NG
DEFALCATE	D AH F AE L K EY T
DEFALCATED	D AH F AE L K EY T AH D
DEFALCATES	D AH F AE L K EY T S
DEFALCATING	D AH F AE L K EY T AH NG
DEFALCATION	D AH F AE L K EY SH AH N
DEFALCATIONS	D AH F AE L K EY T IY AH N Z
DEFALCATOR	D AH F AE L K EY T AH R
DEFALCATORS	D AH F AE L K AH T AH R Z
DEFAMATION	D EH F AH M EY SH AH N
DEFAMATIONS	D IY F EY M EY SH AH N Z
DEFAMATORY	D IH F AE M AH T AO R IY
DEFAME	D IH F EY M
DEFAMED	D IH F EY M D
DEFAMER	D IY F EY M ER
DEFAMERS	D IY F EY M ER Z
DEFAMES	D IY F EY M Z
DEFAMING	D IY F EY M IH NG
DEFANG	D IY F AE NG
DEFANGED	D IY F AE NG D
DEFANGING	D IY F AE NG IH NG
DEFANGS	D IY F AE NG Z
DEFAT	D IY F AE T
DEFATS	D IY F AE T S
DEFATTED	D IY F AE T IH D
DEFATTING	D IY F AE T IH NG
DEFAULT	D IH F AO L T
DEFAULTED	D IH F AO L T IH D
DEFAULTER	D IH F AO L T ER
DEFAULTERS	D IH F AO L T ER Z
DEFAULTING	D IH F AO L T IH NG
DEFAULTS	D IH F AO L T S
DEFEASANCE	D IH F IY Z AH N S
DEFEASANCES	D IY F IY Z AH N S IH Z
DEFEASIBILITIES	D IY F IY Z AH B IH L AH T IY Z
DEFEASIBILITY	D IY F IY Z AH B IH L AH T IY
DEFEASIBLE	D IY F IY Z AH B AH L
DEFEAT	D IH F IY T
DEFEATED	D IH F IY T AH D
DEFEATED(2)	D IH F IY T IH D
DEFEATER	D IH F IY T ER
DEFEATERS	D IH F IY T ER Z
DEFEATING	D IH F IY T IH NG
DEFEATISM	D IH F IY T IH Z AH M
DEFEATISMS	D IH F IY T IH Z AH M Z
DEFEATIST	D IH F IY T IH S T
DEFEATISTS	D IH F IY T IH S T S
DEFEATS	D IH F IY T S
DEFEATURE	D IH F IY CH ER
DEFEATURES	D IH F IY CH ER Z
DEFECATE	D EH F IH K EY T
DEFECATED	D EH F IH K EY T IH D
DEFECATES	D EH F IH K EY T S
DEFECATING	D EH F IH K EY T IH NG
DEFECATION	D EH F IH K EY SH AH N
DEFECATIONS	D EH F IH K EY SH AH N Z
DEFECT	D IY F EH K T
DEFECT(2)	D IH F EH K T
DEFECTED	D IH F EH K T IH D
DEFECTING	D IH F EH K T IH NG
DEFECTION	D IH F EH K SH AH N
DEFECTIONS	D IH F EH K SH AH N Z
DEFECTIVE	D IH F EH K T IH V
DEFECTIVELY	D IY F EH K T IH V L IY
DEFECTIVENESS	D IY F EH K T IH V N AH S
DEFECTIVENESSES	D IY F EH K T IH V N AH S IH Z
DEFECTIVES	D IY F EH K T IH V Z
DEFECTOR	D IH F EH K T ER
DEFECTORS	D IH F EH K T ER Z
DEFECTS	D IY F EH K T S
DEFECTS(2)	D IH F EH K T S
DEFEMINIZATION	D AH F AH M AH N AH Z EY SH AH N
DEFEMINIZATIONS	D AH F EH M AH N AH Z EY T IY AH N Z
DEFEMINIZE	D AH F EH M AH N AY Z
DEFEMINIZED	D AH F EH M AH N AY Z D
DEFEMINIZES	D AH F EH M AH N AY Z AH Z
DEFEMINIZING	D AH F EH M AH N AY Z AH NG
DEFENCE	D IH F EH N S
DEFENCEMAN	D IY F EH N S M AE N
DEFENCEMEN	D IY F EH N S M EH N
DEFENCES	D IY F EH N S IH Z
DEFEND	D IH F EH N D
DEFENDABLE	D IY F EH N D AH B AH L
DEFENDANT	D IH F EH N D AH N T
DEFENDANTS	D IH F EH N D AH N T S
DEFENDED	D IH F EH N D AH D
DEFENDED(2)	D IH F EH N D IH D
DEFENDER	D IH F EH N D ER
DEFENDERS	D IH F EH N D ER Z
DEFENDING	D IH F EH N D IH NG
DEFENDS	D IH F EH N D Z
DEFENESTRATE	D IY F EH N AH S T R EY T
DEFENESTRATED	D IY F EH N AH S T R EY T IH D
DEFENESTRATES	D IY F EH N AH S T R EY T S
DEFENESTRATING	D IY F EH N AH S T R EY T IH NG
DEFENESTRATION	D IY F EH N EH S T R EY SH AH N
DEFENESTRATIONS	D IY F EH N AH S T R AE SH AH N Z
DEFENSE	D IH F EH N S
DEFENSED	D IH F EH N S T
DEFENSELESS	D IH F EH N S L AH S
DEFENSELESSLY	D IH F EH N S L AH S L IY
DEFENSELESSNESS	D IH F EH N S L AH S N AH S
DEFENSELESSNESSES	D IH F EH N S L AH S N AH S IH Z
DEFENSEMAN	D IH F EH N S M AE N
DEFENSEMEN	D IH F EH N S M EH N
DEFENSES	D IH F EH N S AH Z
DEFENSES(2)	D IH F EH N S IH Z
DEFENSIBILITIES	D IH F EH N S AH B IH L AH T IY Z
DEFENSIBILITY	D IH F EH N S AH B IH L AH T IY
DEFENSIBLE	D IH F EH N S AH B AH L
DEFENSIBLY	D IH F EH N S AH B L IY
DEFENSING	D IH F EH N S IH NG
DEFENSIVE	D IH F EH N S IH V
DEFENSIVELY	D IH F EH N S IH V L IY
DEFENSIVENESS	D IH F EH N S IH V N AH S
DEFENSIVENESSES	D IH F EH N S IH V N AH S IH Z
DEFENSIVES	D IH F EH N S IH V Z
DEFER	D IH F ER
DEFERENCE	D EH F ER AH N S
DEFERENCE(2)	D EH F R AH N S
DEFERENCES	D EH F AH R AH N S IH Z
DEFERENT	D EH F AH R AH N T
DEFERENTIAL	D EH F ER EH N CH AH L
DEFERENTIAL(2)	D EH F ER EH N SH AH L
DEFERENTIALLY	D EH F AH R AH N T IY AH L IY
DEFERENTS	D EH F AH R AH N T S
DEFERMENT	D IH F ER M AH N T
DEFERMENTS	D IH F ER M AH N T S
DEFERRABLE	D IH F ER AH B AH L
DEFERRABLES	D IH F ER AH B AH L Z
DEFERRAL	D IH F ER AH L
DEFERRALS	D IH F ER AH L Z
DEFERRED	D IH F ER D
DEFERRER	D IH F ER ER
DEFERRERS	D IH F ER ER Z
DEFERRING	D IH F ER IH NG
DEFERS	D IH F ER Z
DEFERVESCENCE	D AH F AH R V EH S AH N S
DEFERVESCENCES	D AH F AH R V AH S EH N S AH Z
DEFI	D AH F IY
DEFIANCE	D IH F AY AH N S
DEFIANCES	D IH F AY AH N S IH Z
DEFIANT	D IH F AY AH N T
DEFIANTLY	D IH F AY AH N T L IY
DEFIBRILLATE	D AH F IH B R AH L EY T
DEFIBRILLATED	D AH F IH B R AH L EY T AH D
DEFIBRILLATES	D AH F IH B R AH L EY T S
DEFIBRILLATING	D AH F IH B R AH L EY T AH NG
DEFIBRILLATION	D AH F IH B R AH L EY SH AH N
DEFIBRILLATIONS	D AH F IH B R AH L EY T IY AH N Z
DEFIBRILLATOR	D IY F IH B R IH L EY T ER
DEFIBRILLATORS	D IY F IH B R IH L EY T ER Z
DEFIBRINATE	D IY F AY B R AH N AH T
DEFIBRINATED	D IY F AY B R AH N EY T IH D
DEFIBRINATES	D IY F AY B R AH N AH T S
DEFIBRINATING	D IY F AY B R AH N EY T IH NG
DEFIBRINATION	D IY F AY B R AH N EY SH AH N
DEFIBRINATIONS	D IY F AY B R AH N EY SH AH N Z
DEFICIENCIES	D IH F IH SH AH N S IY Z
DEFICIENCY	D IH F IH SH AH N S IY
DEFICIENT	D IH F IH SH AH N T
DEFICIENTLY	D IH F IH SH AH N T L IY
DEFICIENTS	D IH F IH SH AH N T S
DEFICIT	D EH F AH S AH T
DEFICITS	D EH F IH S IH T S
DEFIED	D IH F AY D
DEFIER	D IH F AY ER
DEFIERS	D IH F AY ER Z
DEFIES	D IH F AY Z
DEFILADE	D IY F AY L EY D
DEFILADED	D IY F AY L EY D IH D
DEFILADES	D IY F AY L EY D Z
DEFILADING	D IY F AY L EY D IH NG
DEFILE	D IY F AY L
DEFILED	D IY F AY L D
DEFILEMENT	D IY F AY L M AH N T
DEFILEMENTS	D IY F AY L M AH N T S
DEFILER	D IY F AY L ER
DEFILERS	D IY F AY L ER Z
DEFILES	D IY F AY L Z
DEFILING	D IH F AY L IH NG
DEFINABLE	D IH F AY N AH B AH L
DEFINABLY	D IH F AY N AH B L IY
DEFINE	D IH F AY N
DEFINED	D IH F AY N D
DEFINEMENT	D IH F AY N M AH N T
DEFINEMENTS	D IH F AY N M AH N T S
DEFINER	D IH F AY N ER
DEFINERS	D IH F AY N ER Z
DEFINES	D IH F AY N Z
DEFINIENDA	D AH F AH N IY N D AH
DEFINIENDUM	D AH F AH N IY N D AH M
DEFINIENS	D IH F AY N IY AH N Z
DEFINIENTIA	D AH F AH N IY N CH IY AH
DEFINING	D IH F AY N IH NG
DEFINITE	D EH F AH N AH T
DEFINITELY	D EH F AH N AH T L IY
DEFINITENESS	D EH F AH N AH T N AH S
DEFINITENESSES	D EH F AH N AH T N AH S IH Z
DEFINITION	D EH F AH N IH SH AH N
DEFINITIONAL	D EH F AH N IH SH AH N AH L
DEFINITIONS	D EH F AH N IH SH AH N Z
DEFINITIVE	D IH F IH N IH T IH V
DEFINITIVELY	D IH F IH N IH T IH V L IY
DEFINITIVENESS	D IH F IH N AH T IH V N AH S
DEFINITIVENESSES	D IH F IH N AH T IH V N AH S IH Z
DEFINITIVES	D IH F IH N AH T IH V Z
DEFINITIZE	D EH F AH N AH T AY Z
DEFINITIZED	D EH F AH N AH T AY Z D
DEFINITIZES	D EH F AH N AH T AY Z IH Z
DEFINITIZING	D EH F AH N AH T AY Z IH NG
DEFINITUDE	D IH F AY N AH T UW D
DEFINITUDES	D IH F AY N AH T UW D Z
DEFIS	D IH F AY Z
DEFLAGRATE	D IY F L EY G R AH T
DEFLAGRATED	D IY F L EY G R EY T IH D
DEFLAGRATES	D IY F L EY G R AH T S
DEFLAGRATING	D IY F L EY G R EY T IH NG
DEFLAGRATION	D IY F L EY G R EY SH AH N
DEFLAGRATIONS	D IY F L EY G R EY SH AH N Z
DEFLATE	D IH F L EY T
DEFLATED	D IH F L EY T IH D
DEFLATER	D IH F L EY T ER
DEFLATERS	D IH F L EY T ER Z
DEFLATES	D IH F L EY T S
DEFLATING	D IH F L EY T IH NG
DEFLATION	D IH F L EY SH AH N
DEFLATIONARY	D IH F L EY SH AH N EH R IY
DEFLATIONS	D IH F L EY SH AH N Z
DEFLATOR	D IH F L EY T ER
DEFLATORS	D IH F L EY T ER Z
DEFLEA	D IY F L IY
DEFLEAED	D IY F L IY D
DEFLEAING	D IY F L IY IH NG
DEFLEAS	D IY F L IY Z
DEFLECT	D IH F L EH K T
DEFLECTABLE	D IH F L EH K T AH B AH L
DEFLECTED	D IH F L EH K T IH D
DEFLECTING	D IH F L EH K T IH NG
DEFLECTION	D IH F L EH K SH AH N
DEFLECTIONS	D IH F L EH K SH AH N Z
DEFLECTIVE	D IH F L EH K T IH V
DEFLECTOR	D IH F L EH K T ER
DEFLECTORS	D IH F L EH K T ER Z
DEFLECTS	D IH F L EH K T S
DEFLEXED	D IY F L EH K S T
DEFLORATION	D IY F L OW R EY SH AH N
DEFLORATIONS	D IY F L OW R EY SH AH N Z
DEFLOWER	D IY F L AW ER
DEFLOWERED	D IY F L AW ER D
DEFLOWERER	D IY F L AW ER ER
DEFLOWERERS	D IY F L AW ER ER Z
DEFLOWERING	D IY F L AW ER IH NG
DEFLOWERS	D IY F L AW ER Z
DEFOAM	D IY F OW M
DEFOAMED	D IY F OW M D
DEFOAMER	D IY F OW M ER
DEFOAMERS	D IY F OW M ER Z
DEFOAMING	D IY F OW M IH NG
DEFOAMS	D IY F OW M Z
DEFOCUS	D IY F OW K AH S
DEFOCUSED	D IY F OW K AH S T
DEFOCUSES	D IY F OW K AH S IH Z
DEFOCUSING	D IY F OW K AH S IH NG
DEFOCUSSED	D IY F OW K AH S T
DEFOCUSSES	D IY F OW K AH S IH Z
DEFOCUSSING	D IY F OW K AH S IH NG
DEFOG	D IY F AA G
DEFOGGED	D IY F AA G D
DEFOGGER	D IY F AA G ER
DEFOGGERS	D IY F AA G ER Z
DEFOGGING	D IY F AA G IH NG
DEFOGS	D IY F AA G Z
DEFOLIANT	D IH F OW L IY AH N T
DEFOLIANTS	D IH F OW L IY AH N T S
DEFOLIATE	D AH F AA L AY EY T
DEFOLIATED	D AH F AA L AY EY T AH D
DEFOLIATES	D AH F AA L AY EY T S
DEFOLIATING	D AH F AA L AY EY T AH NG
DEFOLIATION	D AH F AA L AY EY SH AH N
DEFOLIATIONS	D AH F OW L IY EY T IY AH N Z
DEFOLIATOR	D AH F AA L AY EY T AH R
DEFOLIATORS	D AH F AH L IY AH T AH R Z
DEFORCE	D IY F OW R S
DEFORCED	D IY F OW R S T
DEFORCEMENT	D IY F OW R S M AH N T
DEFORCEMENTS	D IY F OW R S M AH N T S
DEFORCES	D IY F OW R S IH Z
DEFORCING	D IY F OW R S IH NG
DEFOREST	D IH F AO R AH S T
DEFORESTATION	D IH F AO R IH S T EY SH AH N
DEFORESTATIONS	D IY F AO R AH S T EY SH AH N Z
DEFORESTED	D IY F AO R AH S T IH D
DEFORESTING	D IY F AO R AH S T IH NG
DEFORESTS	D IY F AO R AH S T S
DEFORM	D IY F AO R M
DEFORMABLE	D IY F AO R M AH B AH L
DEFORMALIZE	D IY F AO R M AH L AY Z
DEFORMALIZED	D IY F AO R M AH L AY Z D
DEFORMALIZES	D IY F AO R M AH L AY Z IH Z
DEFORMALIZING	D IY F AO R M AH L AY Z IH NG
DEFORMATION	D IY F AO R M EY SH AH N
DEFORMATIONAL	D IY F AO R M EY SH AH N AH L
DEFORMATIONS	D IY F AO R M EY SH AH N Z
DEFORMATIVE	D IY F AO R M AH T IH V
DEFORMED	D IH F AO R M D
DEFORMER	D IY F AO R M ER
DEFORMERS	D IY F AO R M ER Z
DEFORMING	D IY F AO R M IH NG
DEFORMITIES	D IH F AO R M AH T IY Z
DEFORMITY	D IH F AO R M AH T IY
DEFORMS	D IY F AO R M Z
DEFRAUD	D IH F R AO D
DEFRAUDED	D IH F R AO D IH D
DEFRAUDER	D IY F R AO D ER
DEFRAUDERS	D IY F R AO D ER Z
DEFRAUDING	D IH F R AO D IH NG
DEFRAUDS	D IY F R AO D Z
DEFRAY	D IH F R EY
DEFRAYABLE	D IH F R EY AH B AH L
DEFRAYAL	D IH F R EY AH L
DEFRAYALS	D IH F R EY AH L Z
DEFRAYED	D IH F R EY D
DEFRAYER	D IH F R EY ER
DEFRAYERS	D IH F R EY ER Z
DEFRAYING	D IH F R EY IH NG
DEFRAYS	D IH F R EY Z
DEFROCK	D IY F R AA K
DEFROCKED	D IY F R AA K T
DEFROCKING	D IY F R AA K IH NG
DEFROCKS	D IY F R AA K S
DEFROST	D IH F R AO S T
DEFROSTED	D IY F R AO S T IH D
DEFROSTER	D IY F R AO S T ER
DEFROSTERS	D IY F R AO S T ER Z
DEFROSTING	D IH F R AO S T IH NG
DEFROSTS	D IY F R AO S T S
DEFT	D EH F T
DEFTER	D EH F T ER
DEFTEST	D EH F T AH S T
DEFTLY	D EH F T L IY
DEFTNESS	D EH F T N AH S
DEFTNESSES	D EH F T N AH S IH Z
DEFUNCT	D IH F AH NG K T
DEFUND	D IY F AH N D
DEFUNDED	D IY F AH N D IH D
DEFUNDING	D IY F AH N D IH NG
DEFUNDS	D IY F AH N D Z
DEFUSE	D IH F Y UW Z
DEFUSED	D IH F Y UW Z D
DEFUSED(2)	D IY F Y UW Z D
DEFUSES	D IY F Y UW Z IH Z
DEFUSING	D IH F Y UW Z IH NG
DEFUZE	D IH F Y UW Z
DEFUZED	D IH F Y UW Z D
DEFUZES	D IH F Y UW Z AH Z
DEFUZING	D IH F Y UW Z AH NG
DEFY	D IH F AY
DEFYING	D IH F AY IH NG
DEGAGE	D IY G EY JH
DEGAME	D IY G EY M
DEGAMES	D IY G EY M Z
DEGAMI	D AH G AE M IY
DEGAMIS	D IY G EY M IY Z
DEGAS	D EY G AH S
DEGAS(2)	D EY G AH
DEGASES	D IY G AE S IH Z
DEGASSED	D IY G AE S T
DEGASSER	D IY G AE S ER
DEGASSERS	D IY G AE S ER Z
DEGASSES	D IY G AE S IH Z
DEGASSING	D IY G AE S IH NG
DEGAUSS	D IY G AW S
DEGAUSSED	D IY G AW S T
DEGAUSSER	D IY G AW S ER
DEGAUSSERS	D IY G AW S ER Z
DEGAUSSES	D IY G AW S IH Z
DEGAUSSING	D IY G AW S IH NG
DEGENERACIES	D IY JH EH N ER AH S IY Z
DEGENERACY	D IH JH EH N ER AH S IY
DEGENERATE	D IH JH EH N ER AH T
DEGENERATE(2)	D IH JH EH N ER EY T
DEGENERATED	D IH JH EH N ER EY T IH D
DEGENERATELY	D IY JH EH N ER AH T L IY
DEGENERATENESS	D IY JH EH N ER AH T N AH S
DEGENERATENESSES	D IY JH EH N ER AH T N AH S IH Z
DEGENERATES	D IH JH EH N ER AH T S
DEGENERATING	D IH JH EH N ER EY T IH NG
DEGENERATION	D IH JH EH N ER EY SH AH N
DEGENERATIONS	D IY JH EH N ER EY SH AH N Z
DEGENERATIVE	D IH JH EH N ER AH T IH V
DEGERM	D IY JH ER M
DEGERMED	D IY JH ER M D
DEGERMING	D IY JH ER M IH NG
DEGERMS	D IY JH ER M Z
DEGLACIATED	D IH G L AE S AY EY T AH D
DEGLACIATION	D IH G L AE S AY EY SH AH N
DEGLACIATIONS	D IH G L EY S IY EY T IY AH N Z
DEGLAMORIZATION	D IY G L AE M ER AH Z EY SH AH N
DEGLAMORIZATIONS	D IY G L AE M ER AH Z EY SH AH N Z
DEGLAMORIZE	D IY G L AE M ER AY Z
DEGLAMORIZED	D IY G L AE M ER AY Z D
DEGLAMORIZES	D IY G L AE M ER AY Z IH Z
DEGLAMORIZING	D IY G L AE M ER AY Z IH NG
DEGLAZE	D IY G L EY Z
DEGLAZED	D IY G L EY Z D
DEGLAZES	D IY G L EY Z IH Z
DEGLAZING	D IY G L EY Z IH NG
DEGLUTITION	D EH G L Y AH T IH SH AH N
DEGLUTITIONS	D IH G L AH T IH T IY AH N Z
DEGRADABLE	D IH G R EY D AH B AH L
DEGRADATION	D EH G R AH D EY SH AH N
DEGRADATIONS	D EH G R AH D EY SH AH N Z
DEGRADATIVE	D IY G R EY D AH T IH V
DEGRADE	D IH G R EY D
DEGRADED	D IH G R EY D AH D
DEGRADED(2)	D IH G R EY D IH D
DEGRADEDLY	D IY G R EY D AH D L IY
DEGRADER	D IY G R EY D ER
DEGRADERS	D IY G R EY D ER Z
DEGRADES	D IH G R EY D Z
DEGRADING	D IH G R EY D IH NG
DEGRADINGLY	D IY G R EY D IH NG L IY
DEGRANULATION	D IY G R AE N Y UW L EY SH AH N
DEGRANULATIONS	D IY G R AE N Y UW L EY SH AH N Z
DEGREASE	D IY G R IY S
DEGREASED	D IY G R IY S T
DEGREASER	D IY G R IY S ER
DEGREASERS	D IY G R IY S ER Z
DEGREASES	D IY G R IY S IH Z
DEGREASING	D IY G R IY S IH NG
DEGREE	D IH G R IY
DEGREED	D IH G R IY D
DEGREES	D IH G R IY Z
DEGRESSIVE	D IH G R EH S AH V
DEGRESSIVELY	D IH G R EH S AY V L IY
DEGRINGOLADE	D IY G R IH N G OW L EY D
DEGRINGOLADES	D IY G R IH N G OW L EY D Z
DEGUM	D IY G AH M
DEGUMMED	D IY G AH M D
DEGUMMING	D IY G AH M IH NG
DEGUMS	D IY G AH M Z
DEGUST	D IY G AH S T
DEGUSTATION	D IY G AH S T EY SH AH N
DEGUSTATIONS	D IY G AH S T EY SH AH N Z
DEGUSTED	D IY G AH S T IH D
DEGUSTING	D IY G AH S T IH NG
DEGUSTS	D IY G AH S T S
DEHISCE	D AH HH IH S
DEHISCED	D AH HH IH S T
DEHISCENCE	D AH HH IH S AH N S
DEHISCENCES	D AH HH IH S EH N S AH Z
DEHISCENT	D AH HH IH S AH N T
DEHISCES	D AH HH IH S AH Z
DEHISCING	D AH HH IH S AH NG
DEHORN	D IY HH AO R N
DEHORNED	D IY HH AO R N D
DEHORNER	D IY HH AO R N ER
DEHORNERS	D IY HH AO R N ER Z
DEHORNING	D IY HH AO R N IH NG
DEHORNS	D IY HH AO R N Z
DEHORT	D AH HH AO R T
DEHORTED	D AH HH AO R T AH D
DEHORTING	D AH HH AO R T AH NG
DEHORTS	D AH HH AO R T S
DEHUMANIZATION	D IY HH Y UW M AH N AH Z EY SH AH N
DEHUMANIZATIONS	D IY HH Y UW M EY N AH Z EY SH AH N Z
DEHUMANIZE	D IH HH Y UW M AH N AY Z
DEHUMANIZED	D IH HH Y UW M AH N AY Z D
DEHUMANIZES	D IY HH Y UW M EY N AY Z IH Z
DEHUMANIZING	D IY HH Y UW M AH N AY Z IH NG
DEHUMIDIFICATION	D IY HH Y UW M AH D AH F AH K EY SH AH N
DEHUMIDIFICATIONS	D IY HH Y UW M AH D AH F AH K EY SH AH N Z
DEHUMIDIFIED	D IY HH Y UW M IH D AH F AY D
DEHUMIDIFIER	D IY HH Y UW M IH D AH F AY ER
DEHUMIDIFIERS	D IY HH Y UW M IH D AH F AY ER Z
DEHUMIDIFIES	D IY HH Y UW M IH D AH F AY Z
DEHUMIDIFY	D IY HH Y UW M IH D AH F AY
DEHUMIDIFYING	D IY HH Y UW M IH D AH F AY IH NG
DEHYDRATE	D IH HH AY D R EY T
DEHYDRATED	D IH HH AY D R EY T AH D
DEHYDRATES	D IY HH AY D R EY T S
DEHYDRATING	D IY HH AY D R EY T IH NG
DEHYDRATION	D IY HH AY D R EY SH AH N
DEHYDRATIONS	D IY HH AY D R EY SH AH N Z
DEHYDRATOR	D IY HH AY D R EY T ER
DEHYDRATORS	D IY HH AY D R EY T ER Z
DEHYDROCHLORINASE	D AH HH AH D R AA K L AO R AH N EY Z
DEHYDROCHLORINASES	D AH HH AH D R AA K L AO R AH N EY Z AH Z
DEHYDROCHLORINATE	D AH HH IH D R AA K L AO R AH N EY T
DEHYDROCHLORINATED	D AH HH IH D R AA K L AO R AH N EY T AH D
DEHYDROCHLORINATES	D AH HH IH D R AA K L AO R AH N EY T S
DEHYDROCHLORINATING	D AH HH IH D R AA K L AO R AH N EY T AH NG
DEHYDROCHLORINATION	D AH HH IH D R AA K L AO R AH N EY SH AH N
DEHYDROCHLORINATIONS	D AH HH AH D R AA K L AH R AH N EY T IY AH N Z
DEHYDROGENASE	D AH HH IH D R AA JH AH N EY Z
DEHYDROGENASES	D AH HH IH D R AA JH AH N EY Z AH Z
DEHYDROGENATE	D IY HH AY D R AH JH AH N AH T
DEHYDROGENATED	D IY HH AY D R AH JH AH N EY T IH D
DEHYDROGENATES	D IY HH AY D R AH JH AH N AH T S
DEHYDROGENATING	D IY HH AY D R AH JH AH N EY T IH NG
DEHYDROGENATION	D IY HH AY D R AH JH AH N EY SH AH N
DEHYDROGENATIONS	D IY HH AY D R AH JH AH N EY SH AH N Z
DEICE	D IY AY S
DEICED	D IY AY S T
DEICER	D IY AY S ER
DEICERS	D IY AY S ER Z
DEICES	D IY AY S IH Z
DEICIDAL	D IY AY S AH D AH L
DEICIDE	D IY AH S AY D
DEICIDES	D IY AH S AY D Z
DEICING	D IY AY S IH NG
DEICTIC	D IY IH K T AH K
DEIFIC	D IY IH F AH K
DEIFICAL	D IY AH F IH S AH L
DEIFICATION	D IY AH F AH K EY SH AH N
DEIFICATIONS	D IY AH F AH K EY SH AH N Z
DEIFIED	D IY AH F AY D
DEIFIER	D IY IH F AY AH R
DEIFIERS	D IY AH F IY R Z
DEIFIES	D IY AH F AY Z
DEIFORM	D IY IH F AH R M
DEIFY	D IY AH F AY
DEIFYING	D IY IH F AY AH NG
DEIGN	D EY N
DEIGNED	D EY N D
DEIGNING	D EY N IH NG
DEIGNS	D EY N Z
DEIL	D IY IH L
DEILS	D IY AH L Z
DEINDUSTRIALIZATION	D IY IH N D AH S T R IY AH L AH Z EY SH AH N
DEINDUSTRIALIZATIONS	D IY IH N D AH S T R IY AH L AH Z EY SH AH N Z
DEINDUSTRIALIZE	D IY IH N D AH S T R IY AH L AY Z
DEINDUSTRIALIZED	D IY IH N D AH S T R IY AH L AY Z D
DEINDUSTRIALIZES	D IY IH N D AH S T R IY AH L AY Z IH Z
DEINDUSTRIALIZING	D IY IH N D AH S T R IY AH L AY Z IH NG
DEINONYCHUS	D IY AH N AA N AH CH AH S
DEINONYCHUSES	D IY AH N AA N AH CH UW Z AH Z
DEINSTITUTIONALIZATION	D IY IH N S T IH T UW SH AH N AH L AH Z EY SH AH N
DEINSTITUTIONALIZATIONS	D IY IH N S T AH T UW SH AH N AH L AH Z EY SH AH N Z
DEINSTITUTIONALIZE	D IY IH N S T IH T UW SH AH N AH L AY Z
DEINSTITUTIONALIZED	D IY IH N S T AH T UW SH AH N AH L AY Z D
DEINSTITUTIONALIZES	D IY IH N S T AH T UW SH AH N AH L AY Z IH Z
DEINSTITUTIONALIZING	D IY IH N S T AH T UW SH AH N AH L AY Z IH NG
DEIONIZATION	D IY IY AH N AH Z EY SH AH N
DEIONIZATIONS	D IY IY AH N AH Z EY SH AH N Z
DEIONIZE	D IY IY AH N AY Z
DEIONIZED	D IY IY AH N AY Z D
DEIONIZER	D IY IY AH N AY Z ER
DEIONIZERS	D IY IY AH N AY Z ER Z
DEIONIZES	D IY IY AH N AY Z IH Z
DEIONIZING	D IY IY AH N AY Z IH NG
DEISM	D IY IH Z AH M
DEISMS	D IY IH Z AH M Z
DEIST	D IY IH S T
DEISTIC	D IY IH S T AH K
DEISTICAL	D IY IH S T IH S AH L
DEISTICALLY	D IY IH S T AH K AE L IY
DEISTS	D IY IH S T S
DEITIES	D IY AH T IY Z
DEITY	D IY AH T IY
DEIXIS	D IY IH K S AH S
DEIXISES	D IY IH K S AY Z AH Z
DEJECT	D IH JH EH K T
DEJECTA	D AH JH EH K T AH
DEJECTED	D IH JH EH K T IH D
DEJECTEDLY	D IH JH EH K T AH D L IY
DEJECTEDNESS	D IH JH EH K T AH D N AH S
DEJECTEDNESSES	D IH JH EH K T AH D N AH S IH Z
DEJECTING	D IH JH EH K T IH NG
DEJECTION	D IH JH EH K SH AH N
DEJECTIONS	D IH JH EH K SH AH N Z
DEJECTS	D IH JH EH K T S
DEJEUNER	D AH JH UW N AH R
DEJEUNERS	D AH JH UW N AH R Z
DEKAGRAM	D AH K AE G R AH M
DEKAGRAMS	D AH K AE G R AH M Z
DEKALITER	D IH K AH L AY T AH R
DEKALITERS	D AH K AE L AH T AH R Z
DEKAMETER	D AH K AE M AH T AH R
DEKAMETERS	D AH K AE M AH T AH R Z
DEKAMETRIC	D AH K AE M AH T R AH K
DEKARE	D AH K AE R
DEKARES	D AH K AE R Z
DEKE	D AH K IY
DEKED	D IY K T
DEKES	D IY K S
DEKING	D IY K IH NG
DEKKO	D IH K OW
DEKKOS	D IH K AA Z
DEL	D EH L
DELAINE	D IH L EY N
DELAINES	D AH L EY N Z
DELAMINATE	D IY L AE M AH N AH T
DELAMINATED	D IY L AE M AH N EY T IH D
DELAMINATES	D IY L AE M AH N AH T S
DELAMINATING	D IY L AE M AH N EY T IH NG
DELAMINATION	D IY L AE M AH N EY SH AH N
DELAMINATIONS	D IY L AE M AH N EY SH AH N Z
DELATE	D IY L EY T
DELATED	D IY L EY T IH D
DELATES	D IY L EY T S
DELATING	D IY L EY T IH NG
DELATION	D IY L EY SH AH N
DELATIONS	D IY L EY SH AH N Z
DELATOR	D IY L EY T ER
DELATORS	D IY L EY T ER Z
DELAY	D IH L EY
DELAYED	D IH L EY D
DELAYER	D IY L EY ER
DELAYERS	D IY L EY ER Z
DELAYING	D IH L EY IH NG
DELAYS	D IH L EY Z
DELE	D IY L IY
DELEAD	D IY L IY D
DELEADED	D IY L EH D AH D
DELEADING	D IY L IY D IH NG
DELEADS	D IY L IY D Z
DELEAVE	D IY L IY V
DELEAVED	D IY L IY V D
DELEAVES	D IY L IY V Z
DELEAVING	D IY L IY V IH NG
DELECTABILITIES	D AH L EH K T AH B IH L AH T AY Z
DELECTABILITY	D AH L EH K T AH B IH L AH T IY
DELECTABLE	D IH L EH K T AH B AH L
DELECTABLES	D AH L EH K T AH B AH L Z
DELECTABLY	D AH L EH K T AH B L IY
DELECTATION	D IY L EH K T EY SH AH N
DELECTATIONS	D IY L EH K T EY SH AH N Z
DELED	D IY L EH D
DELEGABLE	D EH L IH G AH B AH L
DELEGACIES	D EH L IH G AH S IY Z
DELEGACY	D EH L IH G AH S IY
DELEGATE	D EH L AH G EY T
DELEGATE(2)	D EH L AH G AH T
DELEGATED	D EH L AH G EY T AH D
DELEGATEE	D IY L EH G AH T IY
DELEGATEES	D IY L EH G AH T IY Z
DELEGATES	D EH L AH G EY T S
DELEGATES(2)	D EH L AH G AH T S
DELEGATING	D EH L AH G EY T IH NG
DELEGATION	D EH L AH G EY SH AH N
DELEGATIONS	D EH L AH G EY SH AH N Z
DELEGATOR	D EH L IH G AH T ER
DELEGATORS	D EH L IH G AH T ER Z
DELEGITIMATION	D IY L IH JH IH T AH M EY SH AH N
DELEGITIMATIONS	D IY L IH JH IH T AH M EY SH AH N Z
DELEING	D AH L IY AH NG
DELES	D IY L Z
DELETE	D IH L IY T
DELETED	D IH L IY T AH D
DELETERIOUS	D EH L AH T IH R IY AH S
DELETERIOUSLY	D IY L EH T AH R IY AH S L IY
DELETERIOUSNESS	D IY L EH T AH R IY AH S N AH S
DELETERIOUSNESSES	D IY L EH T AH R IY AH S N AH S IH Z
DELETES	D IH L IY T S
DELETING	D IH L IY T IH NG
DELETION	D IH L IY SH AH N
DELETIONS	D IH L IY SH AH N Z
DELF	D EH L F
DELFS	D EH L F S
DELFT	D EH L F T
DELFTS	D EH L F T S
DELFTWARE	D EH L F T W EH R
DELFTWARES	D IH L F T W AE R Z
DELI	D EH L IY
DELIBERATE	D IH L IH B ER AH T
DELIBERATE(2)	D IH L IH B ER EY T
DELIBERATE(3)	D IH L IH B R AH T
DELIBERATED	D IH L IH B ER EY T IH D
DELIBERATELY	D IH L IH B ER AH T L IY
DELIBERATELY(2)	D IH L IH B R AH T L IY
DELIBERATENESS	D IH L IH B AH R AH T N AH S
DELIBERATENESSES	D IH L IH B AH R AH T N AH S IH Z
DELIBERATES	D IH L IH B ER EY T S
DELIBERATES(2)	D IH L IH B R EY T S
DELIBERATING	D IH L IH B ER EY T IH NG
DELIBERATION	D IH L IH B ER EY SH AH N
DELIBERATIONS	D IH L IH B ER EY SH AH N Z
DELIBERATIVE	D IH L IH B ER EY T IH V
DELIBERATIVE(2)	D IH L IH B R AH T IH V
DELIBERATIVELY	D IH L IH B AH R AH T IH V L IY
DELIBERATIVENESS	D IH L IH B AH R AH T IH V N AH S
DELIBERATIVENESSES	D IH L IH B AH R AH T IH V N AH S IH Z
DELICACIES	D EH L IH K AH S IY Z
DELICACY	D EH L AH K AH S IY
DELICACY(2)	D EH L IH K AH S IY
DELICATE	D EH L AH K AH T
DELICATELY	D EH L AH K AH T L IY
DELICATES	D EH L IH K AH T S
DELICATESSEN	D EH L IH K AH T EH S AH N
DELICATESSENS	D EH L IH K AH T EH S AH N Z
DELICIOUS	D IH L IH SH AH S
DELICIOUSLY	D IH L IH SH AH SH L IY
DELICIOUSNESS	D IH L IH SH AH S N AH S
DELICIOUSNESSES	D IH L IH SH AH S N AH S IH Z
DELICT	D AH L IH K T
DELICTS	D AH L IH K T S
DELIGHT	D IH L AY T
DELIGHTED	D IH L AY T AH D
DELIGHTED(2)	D IH L AY T IH D
DELIGHTEDLY	D IH L AY T AH D L IY
DELIGHTEDNESS	D IH L AY T AH D N AH S
DELIGHTEDNESSES	D IH L AY T AH D N AH S IH Z
DELIGHTER	D IH L AY T ER
DELIGHTERS	D IH L AY T ER Z
DELIGHTFUL	D IH L AY T F AH L
DELIGHTFULLY	D IH L AY T F AH L IY
DELIGHTFULNESS	D IH L AY T F AH L N AH S
DELIGHTFULNESSES	D IH L AY T F AH L N AH S IH Z
DELIGHTING	D IH L AY T IH NG
DELIGHTS	D IH L AY T S
DELIGHTSOME	D IH L AY T S AH M
DELIME	D IY L AY M
DELIMED	D IY L AY M D
DELIMES	D IY L AY M Z
DELIMING	D IY L AY M IH NG
DELIMIT	D IY L IH M AH T
DELIMITATION	D IY L IH M AH T EY SH AH N
DELIMITATIONS	D IY L IH M AH T EY SH AH N Z
DELIMITED	D IY L IH M AH T IH D
DELIMITER	D IY L IH M AH T ER
DELIMITERS	D IY L IH M AH T ER Z
DELIMITING	D IY L IH M AH T IH NG
DELIMITS	D IY L IH M AH T S
DELINEATE	D IH L IH N IY EY T
DELINEATED	D IH L IH N IY EY T IH D
DELINEATES	D IH L IH N IY EY T S
DELINEATING	D IH L IH N IY EY T IH NG
DELINEATION	D IH L IH N IY EY SH AH N
DELINEATIONS	D IY L IH N IY EY SH AH N Z
DELINEATIVE	D IH L IH N IY EY T IH V
DELINEATOR	D IH L IH N IY EY T ER
DELINEATORS	D IH L IH N IY EY T ER Z
DELINQUENCIES	D IH L IH NG K W AH N S IY Z
DELINQUENCY	D IH L IH NG K W AH N S IY
DELINQUENT	D IH L IH NG K W AH N T
DELINQUENTLY	D IH L IH NG K W AH N T L IY
DELINQUENTS	D IH L IH NG K W AH N T S
DELIQUESCE	D IH L AH K EH S
DELIQUESCED	D IH L AH K EH S T
DELIQUESCENCE	D IH L AH K EH S AH N S
DELIQUESCENCES	D IH L AH K AH S EH N S AH Z
DELIQUESCENT	D IH L AH K EH S AH N T
DELIQUESCES	D IH L AH K EH S AH Z
DELIQUESCING	D IH L AH K EH S AH NG
DELIRIA	D AH L IH R IY AH
DELIRIOUS	D IH L IH R IY AH S
DELIRIOUSLY	D AH L AH R IY OW AH S L IY
DELIRIOUSNESS	D AH L IH R IY AW Z N AH S
DELIRIOUSNESSES	D AH L IH R IY AW Z N EH S AH Z
DELIRIUM	D IH L IH R IY AH M
DELIRIUMS	D IH L IH R IY AH M Z
DELIS	D IY L AH S
DELIST	D IY L IH S T
DELISTED	D IY L IH S T IH D
DELISTING	D IY L IH S T IH NG
DELISTS	D IY L IH S T S
DELIVER	D IH L IH V ER
DELIVERABILITIES	D IH L IH V ER AH B IH L AH T EH Z
DELIVERABILITY	D IH L IH V ER AH B IH L AH T EH
DELIVERABLE	D IH L IH V ER AH B AH L
DELIVERABLE(2)	D IH L IH V R AH B AH L
DELIVERANCE	D IH L IH V ER AH N S
DELIVERANCE(2)	D IH L IH V R AH N S
DELIVERANCES	D IH L IH V ER AH N S IH Z
DELIVERED	D IH L IH V ER D
DELIVERER	D IH L IH V ER ER
DELIVERERS	D IH L IH V ER ER Z
DELIVERIES	D IH L IH V ER IY Z
DELIVERIES(2)	D IH L IH V R IY Z
DELIVERING	D IH L IH V ER IH NG
DELIVERS	D IH L IH V ER Z
DELIVERY	D IH L IH V ER IY
DELIVERYMAN	D IH L IH V AH R IY M AE N
DELIVERYMEN	D IH L IH V AH R IY M EH N
DELL	D EH L
DELLIES	D EH L IY Z
DELLS	D EH L Z
DELLY	D EH L IY
DELOCALIZATION	D IY L OW K AE L AH Z EY SH AH N
DELOCALIZATIONS	D IY L OW K AE L AH Z EY SH AH N Z
DELOCALIZE	D IY L OW K AE L AY Z
DELOCALIZED	D IY L OW K AE L AY Z D
DELOCALIZES	D IY L OW K AE L AY Z IH Z
DELOCALIZING	D IY L OW K AE L AY Z IH NG
DELOUSE	D IY L AW Z
DELOUSED	D IY L AW Z D
DELOUSER	D IY L AW S ER
DELOUSERS	D IY L AW S ER Z
DELOUSES	D IY L AW S IH Z
DELOUSING	D IY L AW S IH NG
DELPHIC	D EH L F IH K
DELPHICALLY	D IH L F AH K AE L IY
DELPHINIUM	D IH L F IH N IY AH M
DELPHINIUMS	D IH L F IH N IY AH M Z
DELS	D EH L Z
DELT	D EH L T
DELTA	D EH L T AH
DELTAIC	D EH L T EY IH K
DELTAS	D EH L T AH Z
DELTIC	D EH L T AH K
DELTOID	D EH L T OY D
DELTOIDEI	D IH L T OY D IY
DELTOIDEUS	D IH L T OY D IY AH S
DELTOIDS	D EH L T OY D Z
DELTS	D EH L T S
DELUDE	D IH L UW D
DELUDED	D IH L UW D IH D
DELUDER	D IH L UW D ER
DELUDERS	D IH L UW D ER Z
DELUDES	D IH L UW D Z
DELUDING	D IH L UW D IH NG
DELUGE	D EH L Y UW JH
DELUGED	D EH L Y UW JH D
DELUGES	D EH L Y UW JH IH Z
DELUGING	D EH L Y UW JH IH NG
DELUSION	D IH L UW ZH AH N
DELUSIONAL	D IH L UW ZH AH N AH L
DELUSIONARY	D IH L UW ZH AH N EH R IY
DELUSIONS	D IH L UW ZH AH N Z
DELUSIVE	D IY L AH S AH V
DELUSIVELY	D IH L AH S AY V L IY
DELUSIVENESS	D IH L AH S AY V N AH S
DELUSIVENESSES	D AH L AH S IH V AH N EH S AH Z
DELUSORY	D IY L AH S AO R IY
DELUSTER	D IY L AH S T ER
DELUSTERED	D IY L AH S T ER D
DELUSTERING	D IY L AH S T ER IH NG
DELUSTERS	D IY L AH S T ER Z
DELUXE	D AH L AH K S
DELVE	D EH L V
DELVED	D EH L V D
DELVER	D EH L V ER
DELVERS	D EH L V ER Z
DELVES	D EH L V Z
DELVING	D EH L V IH NG
DEMAGNETIZATION	D IY M AE G N AH T AH Z EY SH AH N
DEMAGNETIZATIONS	D IY M AE G N AH T AH Z EY SH AH N Z
DEMAGNETIZE	D IY M AE G N AH T AY Z
DEMAGNETIZED	D IY M AE G N AH T AY Z D
DEMAGNETIZER	D IY M AE G N AH T AY Z ER
DEMAGNETIZERS	D IY M AE G N AH T AY Z ER Z
DEMAGNETIZES	D IY M AE G N AH T AY Z IH Z
DEMAGNETIZING	D IY M AE G N AH T AY Z IH NG
DEMAGOG	D AH M AE G AH G
DEMAGOGED	D IH M AH G OW JH D
DEMAGOGIC	D EH M AH G AA JH IH K
DEMAGOGICALLY	D AH M AH G AA JH AH K AE L IY
DEMAGOGIES	D AH M AE G AH JH AY Z
DEMAGOGING	D IH M AH G OW JH AH NG
DEMAGOGS	D AH M AE G AH G Z
DEMAGOGUE	D EH M AH G AA G
DEMAGOGUED	D EH M AH G AA G D
DEMAGOGUERIES	D EH M AH G AA G AH R IY Z
DEMAGOGUERY	D EH M AH G AA G ER IY
DEMAGOGUES	D EH M AH G AA G Z
DEMAGOGUING	D EH M AH G AA G IH NG
DEMAGOGY	D EH M AH G AA JH IY
DEMAND	D IH M AE N D
DEMANDABLE	D IH M AE N D AH B AH L
DEMANDANT	D IH M AE N D AH N T
DEMANDANTS	D IH M AE N D AH N T S
DEMANDED	D IH M AE N D AH D
DEMANDED(2)	D IH M AE N D IH D
DEMANDER	D IH M AE N D ER
DEMANDERS	D IH M AE N D ER Z
DEMANDING	D IH M AE N D IH NG
DEMANDINGLY	D IH M AE N D IH NG L IY
DEMANDINGNESS	D IH M AE N D IH NG N AH S
DEMANDINGNESSES	D IH M AE N D IH NG N AH S IH Z
DEMANDS	D IH M AE N D Z
DEMANTOID	D IY M AE N T OW AH D
DEMANTOIDS	D IY M AE N T OW AH D Z
DEMARCATE	D IY M AA R K EY T
DEMARCATED	D IY M AA R K EY T IH D
DEMARCATES	D IY M AA R K EY T S
DEMARCATING	D IY M AA R K EY T IH NG
DEMARCATION	D IY M AA R K EY SH AH N
DEMARCATIONS	D IY M AA R K EY SH AH N Z
DEMARCHE	D IH M AA R CH
DEMARCHE(2)	D IY M AA R CH
DEMARCHES	D IY M AA R CH IH Z
DEMARK	D AH M AA R K
DEMARKED	D IY M AA R K T
DEMARKING	D IY M AA R K IH NG
DEMARKS	D IY M AA R K S
DEMAST	D IY M AE S T
DEMASTED	D IY M AE S T IH D
DEMASTING	D IY M AE S T IH NG
DEMASTS	D IY M AE S T S
DEMATERIALIZATION	D IY M AH T IH R IY AH L AH Z EY SH AH N
DEMATERIALIZATIONS	D IY M AH T IH R IY AH L AH Z EY SH AH N Z
DEMATERIALIZE	D IY M AH T IH R IY AH L AY Z
DEMATERIALIZED	D IY M AH T IH R IY AH L AY Z D
DEMATERIALIZES	D IY M AH T IH R IY AH L AY Z IH Z
DEMATERIALIZING	D IY M AH T IH R IY AH L AY Z IH NG
DEME	D AH M IY
DEMEAN	D IH M IY N
DEMEANED	D IH M IY N D
DEMEANING	D IH M IY N IH NG
DEMEANOR	D IH M IY N ER
DEMEANORS	D IH M IY N ER Z
DEMEANOUR	D AH M IY N AH R
DEMEANOURS	D AH M AH N OW Y AH R Z
DEMEANS	D IH M IY N Z
DEMENT	D AH M EH N T
DEMENTED	D IH M EH N T IH D
DEMENTEDLY	D IY M EH N T EH D L IY
DEMENTEDNESS	D IY M EH N T EH D N AH S
DEMENTEDNESSES	D IY M EH N T EH D N AH S IH Z
DEMENTIA	D IH M EH N SH IY AH
DEMENTIAL	D IY M EH N T IY AH L
DEMENTIAS	D AH M EH N T IY AH Z
DEMENTING	D AH M EH N T AH NG
DEMENTS	D AH M EH N T S
DEMERARA	D AH M EH R AH R AH
DEMERARAS	D AH M EH R AH R AH Z
DEMERGE	D IY M ER JH
DEMERGED	D IY M ER JH D
DEMERGER	D IY M ER JH ER
DEMERGERED	D IY M ER JH ER D
DEMERGERING	D IY M ER JH ER IH NG
DEMERGERS	D IY M ER JH ER Z
DEMERGES	D IY M ER JH IH Z
DEMERGING	D IY M ER JH IH NG
DEMERIT	D IY M EH R AH T
DEMERITED	D IY M EH R AH T IH D
DEMERITING	D IY M EH R AH T IH NG
DEMERITS	D IY M EH R AH T S
DEMERSAL	D AH M EH R Z AH L
DEMES	D IY M Z
DEMESNE	D AH M EH Z N
DEMESNES	D AH M EH Z N Z
DEMETON	D IY M EH T AO N
DEMETONS	D IY M EH T AO N Z
DEMIES	D AH M AY Z
DEMIGOD	D AH M IH G AH D
DEMIGODDESS	D AH M AH G AA D AH S
DEMIGODDESSES	D AH M AH G AA D EH S AH Z
DEMIGODS	D AH M IH G AH D Z
DEMIJOHN	D AH M IH JH AH N
DEMIJOHNS	D AH M IH JH AH N Z
DEMILITARIZATION	D IY M IH L AH T ER AH Z EY SH AH N
DEMILITARIZATIONS	D IY M IH L AH T ER AH Z EY SH AH N Z
DEMILITARIZE	D IY M IH L AH T ER AY Z
DEMILITARIZED	D IY M IH L AH T ER AY Z D
DEMILITARIZES	D IY M IH L AH T ER AY Z IH Z
DEMILITARIZING	D IY M IH L AH T ER AY Z IH NG
DEMILUNE	D IH M AH L UW N
DEMILUNES	D IH M AH L UW N Z
DEMIMONDAINE	D AH M IH M AH N D EY N
DEMIMONDAINES	D AH M IH M AH N D EY N Z
DEMIMONDE	D AH M IH M AH N D
DEMIMONDES	D AH M IH M AH N D Z
DEMINERALIZATION	D IY M IH N AH R AH L AH Z EY SH AH N
DEMINERALIZATIONS	D IY M IH N AH R AH L AH Z EY SH AH N Z
DEMINERALIZE	D IY M IH N AH R AH L AY Z
DEMINERALIZED	D IY M IH N AH R AH L AY Z D
DEMINERALIZER	D IY M IH N AH R AH L AY Z ER
DEMINERALIZERS	D IY M IH N AH R AH L AY Z ER Z
DEMINERALIZES	D IY M IH N AH R AH L AY Z IH Z
DEMINERALIZING	D IY M IH N AH R AH L AY Z IH NG
DEMIREP	D AH M IH R AH P
DEMIREPS	D AH M IH R AH P S
DEMISE	D IH M AY Z
DEMISED	D IH M AY Z D
DEMISEMIQUAVER	D AH M AH S AH M IH K W EY V AH R
DEMISEMIQUAVERS	D AH M AH S AH M IH K W AH V AH R Z
DEMISES	D IH M AY Z IH Z
DEMISING	D IH M AY Z IH NG
DEMISSION	D IY M IH SH AH N
DEMISSIONS	D IY M IH SH AH N Z
DEMIT	D IH M IH T
DEMITASSE	D AH M IH T AH S
DEMITASSES	D IH M IH T AE S IH Z
DEMITS	D IH M IH T S
DEMITTED	D IH M IH T IH D
DEMITTING	D IH M IH T IH NG
DEMIURGE	D AH M AY AH R JH
DEMIURGES	D AH M AY AH R JH AH Z
DEMIURGIC	D AH M AY AH R JH AH K
DEMIURGICAL	D AH M AY AH R JH IH S AH L
DEMIVOLT	D IH M AH V OW L T
DEMIVOLTS	D IH M AH V OW L T S
DEMIWORLD	D AH M IH W AH R L D
DEMIWORLDS	D AH M IH W AH R L D Z
DEMO	D EH M OW
DEMOB	D IY M AA B
DEMOBBED	D IY M AA B D
DEMOBBING	D IY M AA B IH NG
DEMOBILIZATION	D IY M OW B AH L AY Z EY SH AH N
DEMOBILIZATION(2)	D IY M OW B AH L AH Z EY SH AH N
DEMOBILIZATIONS	D IY M OW B AH L AH Z EY SH AH N Z
DEMOBILIZE	D IH M OW B AH L AY Z
DEMOBILIZED	D IH M OW B AH L AY Z D
DEMOBILIZES	D IH M OW B AH L AY Z IH Z
DEMOBILIZING	D IH M OW B AH L AY Z IH NG
DEMOBS	D IY M AA B Z
DEMOCRACIES	D IH M AA K R AH S IY Z
DEMOCRACY	D IH M AA K R AH S IY
DEMOCRAT	D EH M AH K R AE T
DEMOCRATIC	D EH M AH K R AE T IH K
DEMOCRATICALLY	D EH M AH K R AE T IH K L IY
DEMOCRATIZATION	D IH M AA K R AH T AH Z EY SH AH N
DEMOCRATIZATIONS	D IH M AA K R AH T AH Z EY SH AH N Z
DEMOCRATIZE	D IH M AA K R AH T AY Z
DEMOCRATIZED	D IH M AA K R AH T AY Z D
DEMOCRATIZER	D IH M AA K R AH T AY Z ER
DEMOCRATIZERS	D IH M AA K R AH T AY Z ER Z
DEMOCRATIZES	D IH M AA K R AH T AY Z IH Z
DEMOCRATIZING	D IH M AA K R AH T AY Z IH NG
DEMOCRATS	D EH M AH K R AE T S
DEMODE	D IY M OW D
DEMODED	D IY M OW D IH D
DEMODULATE	D IY M AA JH AH L EY T
DEMODULATED	D IY M AA JH AH L EY T AH D
DEMODULATES	D IY M AA JH AH L EY T S
DEMODULATING	D IY M AA JH UW L EY T IH NG
DEMODULATION	D IY M AA JH AH L EY SH AH N
DEMODULATIONS	D IY M AA JH UW L EY SH AH N Z
DEMODULATOR	D IY M AA JH UW L AH T ER
DEMODULATORS	D IY M AA JH UW L AH T ER Z
DEMOED	D AH M OW D
DEMOGRAPHER	D IH M AA G R AH F ER
DEMOGRAPHERS	D IH M AA G R AH F ER Z
DEMOGRAPHIC	D EH M AH G R AE F IH K
DEMOGRAPHICAL	D EH M AH G R AE F IH K AH L
DEMOGRAPHICALLY	D EH M AH G R AE F IH K L IY
DEMOGRAPHICS	D EH M AH G R AE F IH K S
DEMOGRAPHIES	D IH M AA G R AH F IY Z
DEMOGRAPHY	D IH M AA G R AH F IY
DEMOING	D AH M OW AH NG
DEMOISELLE	D AH M OY S AH L
DEMOISELLES	D AH M OY S AH L Z
DEMOLISH	D IH M AA L IH SH
DEMOLISHED	D IH M AA L IH SH T
DEMOLISHER	D IH M AA L IH SH ER
DEMOLISHERS	D IH M AA L IH SH ER Z
DEMOLISHES	D IH M AA L IH SH AH Z
DEMOLISHING	D IH M AA L IH SH IH NG
DEMOLISHMENT	D IH M AA L IH SH M AH N T
DEMOLISHMENTS	D IH M AA L IH SH M AH N T S
DEMOLITION	D EH M AH L IH SH AH N
DEMOLITIONIST	D EH M AH L IH SH AH N IH S T
DEMOLITIONISTS	D EH M AH L IH SH AH N IH S T S
DEMOLITIONS	D EH M AH L IH SH AH N Z
DEMON	D IY M AH N
DEMONESS	D IY M AH N AH S
DEMONESSES	D IY M AH N AH S IH Z
DEMONETIZATION	D AH M AH N AH T AH Z EY SH AH N
DEMONETIZATIONS	D AH M AA N AH T AH Z EY T IY AH N Z
DEMONETIZE	D AH M AA N AH T AY Z
DEMONETIZED	D AH M AA N AH T AY Z D
DEMONETIZES	D AH M AA N AH T AY Z AH Z
DEMONETIZING	D AH M AA N AH T AY Z AH NG
DEMONIAC	D IH M OW N IY AE K
DEMONIACAL	D IH M OW N IY AE K AH L
DEMONIACALLY	D IH M OW N IY AE K AH L IY
DEMONIACS	D IH M OW N IY AE K S
DEMONIAN	D AH M OW N IY AH N
DEMONIC	D IH M AA N IH K
DEMONICAL	D IY M AH N IH K AH L
DEMONICALLY	D IY M AH N IH K AH L IY
DEMONISE	D IH M AH N AY Z
DEMONISED	D IY M AH N IY Z D
DEMONISES	D IY M AH N IY Z IH Z
DEMONISING	D IY M AH N IY Z IH NG
DEMONISM	D IY M AH N IH Z AH M
DEMONISMS	D IY M AH N IH Z AH M Z
DEMONIST	D IY M AH N IH S T
DEMONISTS	D IY M AH N IH S T S
DEMONIZATION	D IY M AH N AH Z EY SH AH N
DEMONIZATIONS	D IY M AH N AH Z EY SH AH N Z
DEMONIZE	D IY M AH N AY Z
DEMONIZED	D IY M AH N AY Z D
DEMONIZES	D IY M AH N AY Z IH Z
DEMONIZING	D IY M AH N AY Z IH NG
DEMONOLOGICAL	D IY M AA N OW L AA JH IH K AH L
DEMONOLOGIES	D IY M AH N AA L AH JH IY Z
DEMONOLOGIST	D IY M AH N AA L AH JH AH S T
DEMONOLOGISTS	D IY M AH N AA L AH JH AH S T S
DEMONOLOGY	D IY M AH N AA L AH JH IY
DEMONS	D IY M AH N Z
DEMONSTRABILITIES	D EH M AH N S T R AH B IH L AH T EH Z
DEMONSTRABILITY	D EH M AH N S T R AH B IH L AH T EH
DEMONSTRABLE	D EH M AH N S T R AH B AH L
DEMONSTRABLY	D IH M AA N S T R AH B L IY
DEMONSTRATE	D EH M AH N S T R EY T
DEMONSTRATED	D EH M AH N S T R EY T AH D
DEMONSTRATED(2)	D EH M AH N S T R EY T IH D
DEMONSTRATES	D EH M AH N S T R EY T S
DEMONSTRATING	D EH M AH N S T R EY T IH NG
DEMONSTRATION	D EH M AH N S T R EY SH AH N
DEMONSTRATIONAL	D EH M AH N S T R EY SH AH N AH L
DEMONSTRATIONS	D EH M AH N S T R EY SH AH N Z
DEMONSTRATIVE	D IH M AA N S T R AH T IH V
DEMONSTRATIVELY	D IH M AA N S T R AH T IH V L IY
DEMONSTRATIVENESS	D IH M AA N S T R AH T IH V N AH S
DEMONSTRATIVENESSES	D IH M AA N S T R AH T IH V N AH S IH Z
DEMONSTRATIVES	D IH M AA N S T R AH T IH V Z
DEMONSTRATOR	D EH M AH N S T R EY T ER
DEMONSTRATORS	D EH M AH N S T R EY T ER Z
DEMORALIZATION	D IH M AO R AH L IH Z EY SH AH N
DEMORALIZATIONS	D IY M AH R AE L AH Z EY SH AH N Z
DEMORALIZE	D IH M AO R AH L AY Z
DEMORALIZED	D IH M AO R AH L AY Z D
DEMORALIZER	D IY M AH R AE L AY Z ER
DEMORALIZERS	D IY M AH R AE L AY Z ER Z
DEMORALIZES	D IY M AH R AE L AY Z IH Z
DEMORALIZING	D IH M AO R AH L AY Z IH NG
DEMORALIZINGLY	D IY M AH R AE L AY Z IH NG L IY
DEMOS	D EH M OW Z
DEMOSES	D AH M OW Z AH Z
DEMOTE	D IH M OW T
DEMOTED	D IH M OW T IH D
DEMOTES	D IH M OW T S
DEMOTIC	D IY M OW T IH K
DEMOTICS	D IY M OW T IH K S
DEMOTING	D IH M OW T IH NG
DEMOTION	D IH M OW SH AH N
DEMOTIONS	D IH M OW SH AH N Z
DEMOTIST	D IY M OW T IH S T
DEMOTISTS	D IY M OW T IH S T S
DEMOUNT	D IY M AW N T
DEMOUNTABLE	D IY M AW N T AH B AH L
DEMOUNTED	D IY M AW N T IH D
DEMOUNTING	D IY M AW N T IH NG
DEMOUNTS	D IY M AW N T S
DEMPSTER	D EH M P S T ER
DEMPSTERS	D IH M P S T EH R Z
DEMULCENT	D AH M UH L S AH N T
DEMULCENTS	D AH M UH L S AH N T S
DEMULTIPLEXER	D AH M AH L T AH P L EH K S AH R
DEMULTIPLEXERS	D AH M AH L T AH P L EH K S AH R Z
DEMUR	D IH M ER
DEMURE	D IH M Y UH R
DEMURELY	D IH M Y UH R L IY
DEMURENESS	D IH M Y UH R N AH S
DEMURENESSES	D IH M Y UH R N AH S IH Z
DEMURER	D IH M Y UH R ER
DEMUREST	D IH M Y UH R AH S T
DEMURRAGE	D IH M ER IH JH
DEMURRAGES	D IH M ER IH JH IH Z
DEMURRAL	D IH M ER AH L
DEMURRALS	D IH M ER AH L Z
DEMURRED	D IH M ER D
DEMURRER	D IH M ER ER
DEMURRERS	D IH M ER ER Z
DEMURRING	D IH M ER IH NG
DEMURS	D IH M ER Z
DEMY	D IY M IY
DEMYELINATING	D AH M AY EH L AH N EY T AH NG
DEMYELINATION	D AH M AY EH L AH N EY SH AH N
DEMYELINATIONS	D AH M AY AH L AH N EY T IY AH N Z
DEMYSTIFICATION	D IY M IH S T AH F AH K EY SH AH N
DEMYSTIFICATIONS	D IY M IH S T AH F AH K EY SH AH N Z
DEMYSTIFIED	D IY M IH S T AH F AY D
DEMYSTIFIES	D IY M IH S T AH F AY Z
DEMYSTIFY	D IY M IH S T AH F AY
DEMYSTIFYING	D IY M IH S T AH F AY IH NG
DEMYTHOLOGIZATION	D AH M AH TH AH L AH JH AH Z EY SH AH N
DEMYTHOLOGIZATIONS	D AH M AH TH AA L AH JH AH Z EY T IY AH N Z
DEMYTHOLOGIZE	D AH M AH TH AA L AH JH AY Z
DEMYTHOLOGIZED	D AH M AH TH AA L AH JH AY Z D
DEMYTHOLOGIZER	D AH M AH TH AA L AH JH AY Z AH R
DEMYTHOLOGIZERS	D AH M IH TH AH L AA JH AH Z AH R Z
DEMYTHOLOGIZES	D AH M AH TH AA L AH JH AY Z AH Z
DEMYTHOLOGIZING	D AH M AH TH AA L AH JH AY Z AH NG
DEN	D EH N
DENAR	D EH N ER
DENARI	D AH N AE R IY
DENARII	D IH N AE R IY
DENARIUS	D IH N AE R IY AH S
DENARS	D EH N ER Z
DENARY	D EH N EH R IY
DENATIONALIZATION	D IY N AE SH AH N AH L IH Z EY SH AH N
DENATIONALIZATIONS	D IY N AE SH AH N AH L IH Z EY SH AH N Z
DENATIONALIZE	D IH N AE SH AH N AH L AY Z
DENATIONALIZED	D IH N AE SH AH N AH L AY Z D
DENATIONALIZES	D IY N AE SH AH N AH L AY Z IH Z
DENATIONALIZING	D IH N AE SH AH N AH L AY Z IH NG
DENATURALIZATION	D IY N AE CH AH R AH L AH Z EY SH AH N
DENATURALIZATIONS	D IY N AE CH AH R AH L AH Z EY SH AH N Z
DENATURALIZE	D IY N AE CH AH R AH L AY Z
DENATURALIZED	D IY N AE CH AH R AH L AY Z D
DENATURALIZES	D IY N AE CH AH R AH L AY Z IH Z
DENATURALIZING	D IY N AE CH AH R AH L AY Z IH NG
DENATURANT	D IY N EY CH ER AH N T
DENATURANTS	D IY N EY CH ER AH N T S
DENATURATION	D IY N EY CH ER EY SH AH N
DENATURATIONS	D IY N EY CH ER EY SH AH N Z
DENATURE	D IH N EY CH ER
DENATURED	D IH N EY CH ER D
DENATURES	D IY N EY CH ER Z
DENATURING	D IY N EY CH ER IH NG
DENAZIFICATION	D AH N AE Z AH F AH K EY SH AH N
DENAZIFICATIONS	D AH N AE Z AH F AH K EY T IY AH N Z
DENAZIFIED	D AH N AE Z AH F AY D
DENAZIFIES	D AH N AE Z AH F AY Z
DENAZIFY	D AH N AE Z AH F AY
DENAZIFYING	D AH N AH Z IH F AY AH NG
DENDRIFORM	D IH N D R IH F AH R M
DENDRITE	D IH N D R AY T
DENDRITES	D IH N D R AY T S
DENDRITIC	D EH N D R IH T IH K
DENDROCHRONOLOGICAL	D IH N D R AA K R AH N AA L AH JH IH S AH L
DENDROCHRONOLOGICALLY	D IH N D R AA K R AH N AH L AA JH AH K AE L IY
DENDROCHRONOLOGIES	D IH N D R AA K R AH N AA L AH JH AY Z
DENDROCHRONOLOGIST	D IH N D R AA K R AH N AA L AH JH AH S T
DENDROCHRONOLOGISTS	D IH N D R AA K R AH N AA L AH JH AH S T S
DENDROCHRONOLOGY	D EH N D R OW K R AH N AA L AH JH IY
DENDROGRAM	D IH N D R AA G R AH M
DENDROGRAMS	D IH N D R AA G R AH M Z
DENDROID	D EH N D R OY D
DENDROLOGIC	D IH N D R AA L AH JH AH K
DENDROLOGICAL	D IH N D R AA L AH JH IH S AH L
DENDROLOGIES	D IH N D R AA L AH JH AY Z
DENDROLOGIST	D IH N D R AA L AH JH AH S T
DENDROLOGISTS	D IH N D R AA L AH JH AH S T S
DENDROLOGY	D IH N D R AA L AH JH IY
DENDRON	D IH N D R AA N
DENDRONS	D IH N D R AA N Z
DENE	D AH N IY
DENEGATION	D IY N IH G EY SH AH N
DENEGATIONS	D IY N IH G EY SH AH N Z
DENERVATE	D IY N ER V AH T
DENERVATED	D IY N ER V EY T IH D
DENERVATES	D IY N ER V AH T S
DENERVATING	D IY N ER V EY T IH NG
DENERVATION	D IY N ER V EY SH AH N
DENERVATIONS	D IY N ER V EY SH AH N Z
DENES	D IY N Z
DENGUE	D EH N G
DENGUES	D IH N G Z
DENI	D AH N IY
DENIABILITIES	D IH N AY AH B IH L AH T EH Z
DENIABILITY	D IH N AY AH B IH L IH T IY
DENIABLE	D IH N AY AH B AH L
DENIABLY	D IH N AY AH B L IY
DENIAL	D IH N AY AH L
DENIALS	D IH N AY AH L Z
DENIED	D IH N AY D
DENIER	D IH N AY ER
DENIERS	D IH N AY ER Z
DENIES	D IH N AY Z
DENIGRATE	D EH N AH G R EY T
DENIGRATED	D EH N IH G R EY T IH D
DENIGRATES	D AH N IH G R EY T S
DENIGRATING	D EH N IH G R EY T IH NG
DENIGRATION	D AH N IH G R EY SH AH N
DENIGRATIONS	D AH N IH G R EY T IY AH N Z
DENIGRATIVE	D AH N IH G R EY T AH V
DENIGRATOR	D AH N IH G R EY T AH R
DENIGRATORS	D AH N IH G R AH T AH R Z
DENIGRATORY	D AH N IH G R AH T AO R IY
DENIM	D EH N AH M
DENIMS	D AH N IH M Z
DENITRIFICATION	D AH N IH T R AH F AH K EY SH AH N
DENITRIFICATIONS	D AH N IH T R AH F AH K EY T IY AH N Z
DENITRIFIED	D AH N IH T R AH F AY D
DENITRIFIER	D AH N IH T R IH F AY AH R
DENITRIFIERS	D AH N IH T R AH F IY R Z
DENITRIFIES	D AH N IH T R AH F AY Z
DENITRIFY	D AH N IH T R AH F AY
DENITRIFYING	D AH N IH T R IH F AY AH NG
DENIZEN	D EH N AH Z AH N
DENIZENED	D EH N AY Z AH N D
DENIZENING	D EH N AY Z AH N IH NG
DENIZENS	D EH N AH Z AH N Z
DENNED	D EH N D
DENNING	D EH N IH NG
DENOMINAL	D IY N AA M AH N AH L
DENOMINATE	D IH N AA M AH N EY T
DENOMINATED	D IH N AA M AH N EY T IH D
DENOMINATES	D IH N AA M AH N EY T S
DENOMINATING	D IH N AA M AH N EY T IH NG
DENOMINATION	D IH N AO M AH N EY SH AH N
DENOMINATIONAL	D IH N AO M AH N EY SH AH N AH L
DENOMINATIONALISM	D IY N AA M AH N EY SH AH N AH L IH Z AH M
DENOMINATIONALISMS	D IY N AA M AH N EY SH AH N AH L IH Z AH M Z
DENOMINATIONS	D IH N AO M AH N EY SH AH N Z
DENOMINATIVE	D IH N AA M AH N EY T IH V
DENOMINATIVES	D IH N AA M AH N EY T IH V Z
DENOMINATOR	D IH N AA M AH N EY T ER
DENOMINATORS	D IH N AA M AH N EY T ER Z
DENOTATION	D IY N OW T EY SH AH N
DENOTATIONS	D IY N OW T EY SH AH N Z
DENOTATIVE	D IY N OW T AH T IH V
DENOTE	D IH N OW T
DENOTED	D IH N OW T AH D
DENOTEMENT	D IY N OW T M AH N T
DENOTEMENTS	D IY N OW T M AH N T S
DENOTES	D IH N OW T S
DENOTING	D IH N OW T IH NG
DENOTIVE	D IY N OW T IH V
DENOUEMENT	D EY N UW M AA N
DENOUEMENTS	D EY N UW M AA N Z
DENOUNCE	D IH N AW N S
DENOUNCED	D IH N AW N S T
DENOUNCEMENT	D IH N AW N S M AH N T
DENOUNCEMENTS	D IH N AW N S M AH N T S
DENOUNCER	D IH N AW N S ER
DENOUNCERS	D IH N AW N S ER Z
DENOUNCES	D IH N AW N S IH Z
DENOUNCING	D IH N AW N S IH NG
DENS	D EH N Z
DENSE	D EH N S
DENSELY	D EH N S L IY
DENSENESS	D EH N S N AH S
DENSENESSES	D EH N S N AH S IH Z
DENSER	D EH N S ER
DENSEST	D EH N S AH S T
DENSIFICATION	D EH N S AH F AH K EY SH AH N
DENSIFICATIONS	D EH N S AH F AH K EY SH AH N Z
DENSIFIED	D EH N S AH F AY D
DENSIFIES	D EH N S AH F AY Z
DENSIFY	D EH N S AH F AY
DENSIFYING	D EH N S AH F AY IH NG
DENSITIES	D EH N S AH T IY Z
DENSITOMETER	D EH N S AH T AA M AH T ER
DENSITOMETERS	D IH N S AH T AA M AH T AH R Z
DENSITOMETRIC	D IH N S IH T AH M AH T R AH K
DENSITOMETRIES	D EH N S AH T AA M AH T R IY Z
DENSITOMETRY	D EH N S AH T AA M AH T R IY
DENSITY	D EH N S AH T IY
DENSITY(2)	D EH N S IH T IY
DENT	D EH N T
DENTAL	D EH N T AH L
DENTALIA	D IH N T EY L Y AH
DENTALIUM	D IH N T EY L IY AH M
DENTALIUMS	D IH N T EY L IY AH M Z
DENTALLY	D EH N T AH L IY
DENTALS	D EH N T AH L Z
DENTATE	D EH N T AH T
DENTATED	D EH N T EY T IH D
DENTED	D EH N T IH D
DENTICLE	D IH N T IH K AH L
DENTICLES	D IH N T IH K AH L Z
DENTICULATE	D EH N T IH S AH L EY T
DENTICULATED	D EH N T IH S AH L EY T AH D
DENTICULATION	D EH N T IH S AH L EY SH AH N
DENTICULATIONS	D IH N T IH K Y AH L EY T IY AH N Z
DENTIFORM	D IH N T IH F AH R M
DENTIFRICE	D IH N T IH F R AH S
DENTIFRICES	D IH N T IH F R AH S
DENTIL	D IH N T IH L
DENTILED	D EH N T AY L D
DENTILS	D EH N T AH L Z
DENTIN	D EH N T AH N
DENTINAL	D EH N T AY N AH L
DENTINE	D EH N T IY N
DENTINES	D EH N T AY N Z
DENTING	D EH N T IH NG
DENTINS	D EH N T IH N Z
DENTIST	D EH N T AH S T
DENTIST(2)	D EH N T IH S T
DENTISTRIES	D EH N T IH S T R IY Z
DENTISTRY	D EH N T IH S T R IY
DENTISTS	D EH N T IH S T S
DENTITION	D EH N T IH SH AH N
DENTITIONS	D EH N T IH SH AH N Z
DENTOID	D EH N T OW AH D
DENTS	D EH N T S
DENTULOUS	D EH N T Y AH L AH S
DENTURAL	D EH N CH ER AH L
DENTURE	D EH N CH ER
DENTURES	D EH N CH ER Z
DENTURIST	D EH N CH ER IH S T
DENTURISTS	D EH N CH ER IH S T S
DENUCLEARIZATION	D IY N UW K L IY ER AH Z EY SH AH N
DENUCLEARIZATIONS	D IY N UW K L IY ER AH Z EY SH AH N Z
DENUCLEARIZE	D IY N UW K L IY ER AY Z
DENUCLEARIZED	D IH N UW K L IY ER AY Z D
DENUCLEARIZED(2)	D IY N UW K L IY ER AY Z D
DENUCLEARIZES	D IY N UW K L IY ER AY Z IH Z
DENUCLEARIZING	D IY N UW K L IY ER AY Z IH NG
DENUDATE	D IY N UW D AH T
DENUDATED	D IY N UW D EY T IH D
DENUDATES	D IY N UW D AH T S
DENUDATING	D IY N UW D EY T IH NG
DENUDATION	D IY N UW D EY SH AH N
DENUDATIONS	D IY N UW D EY SH AH N Z
DENUDE	D IH N UW D
DENUDED	D IH N UW D IH D
DENUDEMENT	D IY N UW D M AH N T
DENUDEMENTS	D IY N UW D M AH N T S
DENUDER	D IY N UW D ER
DENUDERS	D IY N UW D ER Z
DENUDES	D IY N UW D Z
DENUDING	D IH N UW D IH NG
DENUMERABILITIES	D IY N UW M ER AH B IH L AH T EH Z
DENUMERABILITY	D IY N UW M ER AH B IH L AH T EH
DENUMERABLE	D IY N UW M ER AH B AH L
DENUMERABLY	D IY N UW M ER AH B L IY
DENUNCIATION	D IH N AH N S IY EY SH AH N
DENUNCIATIONS	D IH N AH N S IY EY SH AH N Z
DENUNCIATIVE	D AH N AH N S AY EY T AH V
DENUNCIATORY	D AH N AH N S AY AH T AO R IY
DENY	D IH N AY
DENYING	D IH N AY IH NG
DENYINGLY	D IH N AY IH NG L IY
DEODAND	D IY AA D AH N D
DEODANDS	D IY AA D AH N D Z
DEODAR	D IY OW D AH R
DEODARA	D IY AA D AH R AH
DEODARAS	D IY AA D AH R AH Z
DEODARS	D IY AA D AH R Z
DEODORANT	D IY OW D ER AH N T
DEODORANTS	D IY OW D ER AH N T S
DEODORIZATION	D IY OW D ER AH Z EY SH AH N
DEODORIZATIONS	D IY OW D ER AH Z EY SH AH N Z
DEODORIZE	D IY OW D ER AY Z
DEODORIZED	D IY OW D ER AY Z D
DEODORIZER	D IY OW D ER AY Z ER
DEODORIZERS	D IY OW D ER AY Z ER Z
DEODORIZES	D IY OW D ER AY Z IH Z
DEODORIZING	D IY OW D ER AY Z IH NG
DEONTIC	D IY AA N T AH K
DEONTOLOGICAL	D IY AA N T AH L AA JH IH K AH L
DEONTOLOGIES	D IY AA N T AA L AH JH AY Z
DEONTOLOGIST	D IY AA N T AA L AH JH AH S T
DEONTOLOGISTS	D IY AA N T AA L AH JH AH S T S
DEONTOLOGY	D IY AA N T AA L AH JH IY
DEORBIT	D IY AO R B IH T
DEORBITED	D IY AO R B AH T IH D
DEORBITING	D IY AO R B AH T IH NG
DEORBITS	D IY AO R B AH T S
DEOXIDATION	D IY AA K S AH D EY SH AH N
DEOXIDATIONS	D IY AA K S AH D EY SH AH N Z
DEOXIDIZE	D IY AA K S AY D AY Z
DEOXIDIZED	D IY AA K S AY D AY Z D
DEOXIDIZER	D IY AA K S AY D AY Z ER
DEOXIDIZERS	D IY AA K S AY D AY Z ER Z
DEOXIDIZES	D IY AA K S AY D AY Z IH Z
DEOXIDIZING	D IY AA K S AY D AY Z IH NG
DEOXY	D IY AA K S IY
DEOXYGENATE	D IY AA K S IH JH AH N AH T
DEOXYGENATED	D IY AA K S IH JH AH N EY T IH D
DEOXYGENATES	D IY AA K S IH JH AH N AH T S
DEOXYGENATING	D IY AA K S IH JH AH N EY T IH NG
DEOXYGENATION	D IY AA K S IH JH AH N EY SH AH N
DEOXYGENATIONS	D IY AA K S IH JH AH N EY SH AH N Z
DEOXYRIBONUCLEASE	D IY AH K S AH R AH B AA N AH K L IY Z
DEOXYRIBONUCLEASES	D IY AH K S AH R AH B AA N AH K L IY Z AH Z
DEOXYRIBONUCLEOTIDE	D IY AH K S AH R AH B AH N AH K L IY AH T AY D
DEOXYRIBONUCLEOTIDES	D IY AH K S AH R AH B AH N AH K L IY AH T AY D Z
DEOXYRIBOSE	D IY AA K S IH R AH B OW Z
DEOXYRIBOSES	D IY AA K S IY R IH B AA S IH Z
DEPAINT	D IY P EY N T
DEPAINTED	D IY P EY N T IH D
DEPAINTING	D IY P EY N T IH NG
DEPAINTS	D IY P EY N T S
DEPART	D IH P AA R T
DEPARTED	D IH P AA R T IH D
DEPARTEE	D IY P AA R T IY
DEPARTEES	D IY P AA R T IY Z
DEPARTING	D IH P AA R T IH NG
DEPARTMENT	D IH P AA R T M AH N T
DEPARTMENTAL	D IH P AA R T M EH N AH L
DEPARTMENTAL(2)	D IH P AA R T M EH N T AH L
DEPARTMENTALIZATION	D IH P AA R T M EH N T AH L AH Z EY SH AH N
DEPARTMENTALIZATIONS	D IH P AA R T M EH N T AH L AH Z EY SH AH N Z
DEPARTMENTALIZE	D IH P AA R T M EH N T AH L AY Z
DEPARTMENTALIZE(2)	D IH P AA R T M EH N AH L AY Z
DEPARTMENTALIZED	D IH P AA R T M EH N T AH L AY Z D
DEPARTMENTALIZED(2)	D IH P AA R T M EH N AH L AY Z D
DEPARTMENTALIZES	D IH P AA R T M EH N T AH L AY Z IH Z
DEPARTMENTALIZING	D IH P AA R T M EH N T AH L AY Z IH NG
DEPARTMENTALLY	D IH P AA R T M EH N T AH L IY
DEPARTMENTS	D IH P AA R T M AH N T S
DEPARTS	D IH P AA R T S
DEPARTURE	D IH P AA R CH ER
DEPARTURES	D IH P AA R CH ER Z
DEPAUPERATE	D IY P AO P ER AH T
DEPEND	D IH P EH N D
DEPENDABILITIES	D IH P EH N D AH B IH L AH T EH Z
DEPENDABILITY	D IH P EH N D AH B IH L IH T IY
DEPENDABLE	D IH P EH N D AH B AH L
DEPENDABLENESS	D IH P EH N D AH B AH L N AH S
DEPENDABLENESSES	D IH P EH N D AH B AH L N AH S IH Z
DEPENDABLY	D IY P EH N D AE B L IY
DEPENDANCE	D IY P EH N D AE N S
DEPENDANCES	D IY P EH N D AE N S IH Z
DEPENDANT	D IY P EH N D AH N T
DEPENDANTS	D IY P EH N D AH N T S
DEPENDED	D IH P EH N D AH D
DEPENDED(2)	D IH P EH N D IH D
DEPENDENCE	D IH P EH N D AH N S
DEPENDENCES	D IH P EH N D AH N S IH Z
DEPENDENCIES	D IH P EH N D AH N S IY Z
DEPENDENCY	D IH P EH N D AH N S IY
DEPENDENT	D IH P EH N D AH N T
DEPENDENTLY	D IY P EH N D EH N T L IY
DEPENDENTS	D IH P EH N D AH N T S
DEPENDING	D IH P EH N D IH NG
DEPENDS	D IH P EH N D Z
DEPERM	D AH P AH R M
DEPERMED	D AH P AH R M D
DEPERMING	D AH P AH R M AH NG
DEPERMS	D AH P AH R M Z
DEPERSONALIZATION	D IY P ER S AH N AH L AH Z EY SH AH N
DEPERSONALIZATIONS	D IY P ER S AH N AH L AH Z EY SH AH N Z
DEPERSONALIZE	D IY P ER S AH N AH L AY Z
DEPERSONALIZE(2)	D IY P ER S N AH L AY Z
DEPERSONALIZED	D IY P ER S AH N AH L AY Z D
DEPERSONALIZES	D IY P ER S AH N AH L AY Z IH Z
DEPERSONALIZING	D IY P ER S AH N AH L AY Z IH NG
DEPHOSPHORYLATE	D IY F AA S F ER IY L EY T
DEPHOSPHORYLATED	D IY F AA S F ER IY L EY T IH D
DEPHOSPHORYLATES	D IY F AA S F ER IY L EY T S
DEPHOSPHORYLATING	D IY F AA S F ER IY L EY T IH NG
DEPHOSPHORYLATION	D IY F AA S F ER IY L EY SH AH N
DEPHOSPHORYLATIONS	D IY F AA S F ER IY L EY SH AH N Z
DEPICT	D IH P IH K T
DEPICTED	D IH P IH K T AH D
DEPICTED(2)	D IH P IH K T IH D
DEPICTER	D IH P IH K T ER
DEPICTERS	D IH P IH K T ER Z
DEPICTING	D IH P IH K T IH NG
DEPICTION	D IH P IH K SH AH N
DEPICTIONS	D IH P IH K SH AH N Z
DEPICTOR	D IH P IH K T ER
DEPICTORS	D IH P IH K T ER Z
DEPICTS	D IH P IH K T S
DEPICTS(2)	D IH P IH K S
DEPIGMENTATION	D IY P IH G M AH N T EY SH AH N
DEPIGMENTATIONS	D IY P IH G M AH N T EY SH AH N Z
DEPILATE	D IY P AY L AH T
DEPILATED	D IY P AY L EY T IH D
DEPILATES	D IY P AY L AH T S
DEPILATING	D IY P AY L EY T IH NG
DEPILATION	D IY P AY L EY SH AH N
DEPILATIONS	D IY P AY L EY SH AH N Z
DEPILATORIES	D IY P AY L AH T OW R IY Z
DEPILATORY	D IH P IH L AH T AO R IY
DEPLANE	D IY P L EY N
DEPLANED	D IY P L EY N D
DEPLANES	D IY P L EY N Z
DEPLANING	D IY P L EY N IH NG
DEPLETABLE	D IH P L IY T AH B AH L
DEPLETE	D IH P L IY T
DEPLETED	D IH P L IY T IH D
DEPLETES	D IH P L IY T S
DEPLETING	D IH P L IY T IH NG
DEPLETION	D IH P L IY SH AH N
DEPLETIONS	D IH P L IY SH AH N Z
DEPLETIVE	D IH P L IY T IH V
DEPLORABLE	D IH P L AO R AH B AH L
DEPLORABLENESS	D IH P L OW R AH B AH L N AH S
DEPLORABLENESSES	D IH P L OW R AH B AH L N AH S IH Z
DEPLORABLY	D IH P L OW R AH B L IY
DEPLORE	D IH P L AO R
DEPLORED	D IH P L AO R D
DEPLORER	D IH P L OW R ER
DEPLORERS	D IH P L OW R ER Z
DEPLORES	D IH P L AO R Z
DEPLORING	D IH P L AO R IH NG
DEPLORINGLY	D IH P L OW R IH NG L IY
DEPLOY	D IH P L OY
DEPLOYABLE	D IH P L OY AH B AH L
DEPLOYED	D IH P L OY D
DEPLOYING	D IH P L OY IH NG
DEPLOYMENT	D IH P L OY M AH N T
DEPLOYMENTS	D IH P L OY M AH N T S
DEPLOYS	D IH P L OY Z
DEPLUME	D IY P L UW M
DEPLUMED	D IY P L UW M D
DEPLUMES	D IY P L UW M Z
DEPLUMING	D IY P L UW M IH NG
DEPOLARIZATION	D IY P OW L ER AH Z EY SH AH N
DEPOLARIZATIONS	D IY P OW L ER AH Z EY SH AH N Z
DEPOLARIZE	D IY P OW L ER AY Z
DEPOLARIZED	D IY P OW L ER AY Z D
DEPOLARIZER	D IY P OW L ER AY Z ER
DEPOLARIZERS	D IY P OW L ER AY Z ER Z
DEPOLARIZES	D IY P OW L ER AY Z IH Z
DEPOLARIZING	D IY P OW L ER AY Z IH NG
DEPOLISH	D IY P AA L IH SH
DEPOLISHED	D IY P AA L IH SH T
DEPOLISHES	D IY P AA L IH SH IH Z
DEPOLISHING	D IY P AA L IH SH IH NG
DEPOLITICIZATION	D IY P AA L AH T IH K AH Z EY SH AH N
DEPOLITICIZATIONS	D IY P AA L AH T IH K AH Z EY SH AH N Z
DEPOLITICIZE	D IY P AA L AH T IH K AY Z
DEPOLITICIZED	D IY P AA L AH T IH K AY Z D
DEPOLITICIZES	D IY P AA L AH T IH K AY Z IH Z
DEPOLITICIZING	D IY P AA L AH T IH K AY Z IH NG
DEPOLYMERIZATION	D IY P AA L AH M ER AH Z EY SH AH N
DEPOLYMERIZATIONS	D IY P AA L AH M ER AH Z EY SH AH N Z
DEPOLYMERIZE	D IY P AA L AH M ER AY Z
DEPOLYMERIZED	D IY P AA L AH M ER AY Z D
DEPOLYMERIZES	D IY P AA L AH M ER AY Z IH Z
DEPOLYMERIZING	D IY P AA L AH M ER AY Z IH NG
DEPONE	D AH P OW N
DEPONED	D AH P OW N D
DEPONENT	D AH P OW N AH N T
DEPONENTS	D AH P AA N AH N T S
DEPONES	D AH P OW N Z
DEPONING	D AH P OW N AH NG
DEPOPULATE	D IY P AA P Y AH L EY T
DEPOPULATED	D IY P AA P Y AH L EY T IH D
DEPOPULATES	D IY P AA P Y AH L AH T S
DEPOPULATING	D IY P AA P Y AH L EY T IH NG
DEPOPULATION	D IH P AA P Y AH L EY SH AH N
DEPOPULATION(2)	D IY P AA P Y AH L EY SH AH N
DEPOPULATIONS	D IY P AA P Y AH L EY SH AH N Z
DEPORT	D IH P AO R T
DEPORTABLE	D IY P OW R T AH B AH L
DEPORTATION	D IY P AO R T EY SH AH N
DEPORTATIONS	D IY P AO R T EY SH AH N Z
DEPORTED	D IH P AO R T AH D
DEPORTEE	D IY P AO R T IY
DEPORTEES	D IY P AO R T IY Z
DEPORTING	D IH P AO R T IH NG
DEPORTMENT	D AH P AO R T M AH N T
DEPORTMENTS	D IY P OW R T M AH N T S
DEPORTS	D IY P OW R T S
DEPOSAL	D IY P OW Z AH L
DEPOSALS	D IY P OW Z AH L Z
DEPOSE	D IH P OW Z
DEPOSED	D IH P OW Z D
DEPOSER	D IY P OW Z ER
DEPOSERS	D IY P OW Z ER Z
DEPOSES	D IY P OW Z IH Z
DEPOSING	D IY P OW Z IH NG
DEPOSIT	D AH P AA Z IH T
DEPOSIT(2)	D IH P AA Z AH T
DEPOSITARIES	D AH P AA Z IH T EH R IY Z
DEPOSITARY	D AH P AA Z IH T EH R IY
DEPOSITARY(2)	D IH P AA Z IH T EH R IY
DEPOSITED	D AH P AA Z IH T IH D
DEPOSITED(2)	D IH P AA Z AH T AH D
DEPOSITING	D AH P AA Z IH T IH NG
DEPOSITION	D EH P AH Z IH SH AH N
DEPOSITIONAL	D EH P AH Z IH SH AH N AH L
DEPOSITIONS	D EH P AH Z IH SH AH N Z
DEPOSITOR	D AH P AA Z IH T ER
DEPOSITORIES	D AH P AA Z IH T ER IY Z
DEPOSITORS	D AH P AA Z IH T ER Z
DEPOSITORY	D IH P AA Z AH T AO R IY
DEPOSITS	D AH P AA Z IH T S
DEPOSITS(2)	D IH P AA Z AH T S
DEPOT	D IY P OW
DEPOTS	D IY P OW Z
DEPRAVATION	D EH P R AH V EY SH AH N
DEPRAVATIONS	D IH P R EY V EY SH AH N Z
DEPRAVE	D IY P R EY V
DEPRAVED	D IY P R EY V D
DEPRAVEDLY	D IH P R EY V AH D L IY
DEPRAVEDNESS	D IH P R EY V AH D N AH S
DEPRAVEDNESSES	D IH P R EY V AH D N AH S IH Z
DEPRAVEMENT	D IH P R EY V M AH N T
DEPRAVEMENTS	D IH P R EY V M AH N T S
DEPRAVER	D IH P R EY V ER
DEPRAVERS	D IH P R EY V ER Z
DEPRAVES	D IH P R EY V Z
DEPRAVING	D IH P R EY V IH NG
DEPRAVITIES	D IH P R AE V AH T IY Z
DEPRAVITY	D IH P R AE V AH T IY
DEPRECATE	D EH P R AH K EY T
DEPRECATED	D EH P R AH K EY T AH D
DEPRECATES	D EH P R AH K EY T S
DEPRECATING	D EH P R AH K EY T IH NG
DEPRECATINGLY	D IY P R IY K EY T IH NG L IY
DEPRECATION	D IY P R IY K EY SH AH N
DEPRECATIONS	D IY P R IY K EY SH AH N Z
DEPRECATORILY	D EH P R IH K AH T OW R IY L IY
DEPRECATORY	D EH P R IH K AH T OW R IY
DEPRECIABLE	D IH P R IH SH AH B AH L
DEPRECIATE	D IH P R IY SH IY EY T
DEPRECIATED	D IH P R IY SH IY EY T IH D
DEPRECIATES	D IH P R IY SH IY EY T S
DEPRECIATING	D IH P R IY SH IY EY T IH NG
DEPRECIATINGLY	D IH P R IY SH IY EY T IH NG L IY
DEPRECIATION	D IH P R IY SH IY EY SH AH N
DEPRECIATIONS	D IH P R IY SH IY EY SH AH N Z
DEPRECIATIVE	D IH P R IY SH IY EY T IH V
DEPRECIATOR	D IH P R IY SH IY EY T ER
DEPRECIATORS	D IH P R IY SH IY EY T ER Z
DEPRECIATORY	D IH P R IY SH IY EY T ER IY
DEPREDATE	D EH P R AH D EY T
DEPREDATED	D EH P R AH D EY T IH D
DEPREDATES	D EH P R AH D EY T S
DEPREDATING	D EH P R AH D EY T IH NG
DEPREDATION	D EH P R AH D EY SH AH N
DEPREDATIONS	D EH P R AH D EY SH AH N Z
DEPREDATOR	D EH P R AH D EY T ER
DEPREDATORS	D EH P R AH D EY T ER Z
DEPREDATORY	D EH P R AH D EY T ER IY
DEPRESS	D IH P R EH S
DEPRESSANT	D IH P R EH S AH N T
DEPRESSANTS	D IH P R EH S AH N T S
DEPRESSED	D IH P R EH S T
DEPRESSES	D IH P R EH S AH Z
DEPRESSES(2)	D IH P R EH S IH Z
DEPRESSIBLE	D IY P R EH S AH B AH L
DEPRESSING	D IH P R EH S IH NG
DEPRESSINGLY	D IH P R EH S IH NG L IY
DEPRESSION	D IH P R EH SH AH N
DEPRESSIONS	D IH P R EH SH AH N Z
DEPRESSIVE	D IH P R EH S IH V
DEPRESSIVELY	D IY P R EH S IH V L IY
DEPRESSIVES	D IY P R EH S IH V Z
DEPRESSOR	D IY P R EH S ER
CEANOTHUS	S IY N AH TH AH S
BDELLIUM	B D EH L IY AH M
KOHL	K OW L
IF	IH F
OINK	OY NG K
PINOT	P IH N AH T
TMESES	T M IY Z AH Z
