EA	IY AH
ABEAM	AH B IY M
ABOIDEAU	AH B OY D IY UW
ABOIDEAUS	AH B OY D IY AH S
ABOIDEAUX	AH B OY D IY AH K S
ABOITEAU	AH B OY T IY UW
ABOITEAUS	AH B OY T IY AH S
ABOITEAUX	AH B OY T IY AH K S
ABREACT	AE B R IY AE K T
ABREACTED	AE B R IY AE K T IH D
ABREACTING	AE B R IY AE K T IH NG
ABREACTION	AE B R IY AE K SH AH N
ABREACTIONS	AE B R IY AE K SH AH N Z
ABREACTS	AE B R IY AE K T S
ABREAST	AH B R EH S T
ACHILLEA	AH CH IH L IY AH
ACHILLEAS	AH CH IH L IY Z
ACIDHEAD	AE S AH D HH EH D
ACIDHEADS	AE S AH D HH EH D Z
ACREAGE	EY K AH R IH JH
ACREAGE(2)	EY K R IH JH
ACREAGES	EY K ER IH JH IH Z
ACULEATE	AE K Y UW L IY EY T
ADENOHYPOPHYSEAL	AE D AH N AH HH IH P AH F IH Z IY AH L
ADMEASURE	AE D M IY ZH Y AH R
ADMEASURED	AE D M IY ZH Y AH R D
ADMEASUREMENT	AE D M AH S UH R M AH N T
ADMEASUREMENTS	AE D M AH S UH R AH M AH N T S
ADMEASURES	AE D M IY ZH Y AH R Z
ADMEASURING	AE D M IY ZH Y AH R AH NG
AFEARD	EY F AH R D
AFEARED	AH F IH ER D
AGLEAM	AH G L IY M
AGREEABILITIES	AH G R IY AH B IH L AH T EH Z
AGREEABILITY	AH G R IY AH B IH L AH T EH
AGREEABLE	AH G R IY AH B AH L
AGREEABLENESS	AH G R IY AH B AH L N AH S
AGREEABLENESSES	AH G R IY AH B AH L N AH S IH Z
AGREEABLY	AH G R IY AH B L IY
AHEAD	AH HH EH D
AIRHEAD	EH R HH EH D
AIRHEADED	AH IH R HH EH D IH D
AIRHEADS	AH IH R HH EH D Z
AIRSTREAM	AH IH R S T R IY M
AIRSTREAMS	AH IH R S T R IY M Z
ALEATORIC	EY L AH T ER IH K
ALEATORY	EY L IY AH T AO R IY
ALLHEAL	AO L HH IY L
ALLHEALS	AO L HH IY L Z
ALREADY	AO L R EH D IY
ALREADY(2)	AO R EH D IY
ALTHAEA	AE L TH IY AH
ALTHAEAS	AE L TH IY AH Z
ALTHEA	AE L TH IY AH
ALTHEAS	AE L TH IY AH Z
AMEBEAN	AH M IY B IY AH N
AMENORRHEA	AH M EH N ER R IY AH
AMENORRHEAS	AH M EH N ER R IY AH Z
AMOEBEAN	AH M OW EH B IY AH N
AMPHITHEATER	AE M F AH TH IY EY T ER
AMPHITHEATERS	AE M F AH TH IY EY T ER Z
AMPHITHEATRIC	AE M F AH TH IY T R AH K
AMPHITHEATRICAL	AE M F AH TH IY T R IH S AH L
AMPHITHEATRICALLY	AE M F AH TH IY T R AH K AE L IY
ANCONEAL	AE NG K OW N IY AH L
ANEAR	AH N IH ER
ANEARED	AH N IH ER D
ANEARING	AH N IH ER IH NG
ANEARS	AH N IH ER Z
ANNEAL	AH N IY L
ANNEALED	AE N IY L D
ANNEALER	AE N IY L AH R
ANNEALERS	AE N IY L AH R Z
ANNEALING	AH N IY L IH NG
ANNEALS	AE N IY L Z
ANTBEAR	AE N T B AE ER
ANTBEARS	AE N T B AE ER Z
ANTEATER	AE N T IY T ER
ANTEATERS	AE N T IY T ER Z
ANTIBUREAUCRATIC	AE N T AY B Y UH R AH K R AE T IH K
ANTICREATIVE	AE N T AY K R IY EY T IH V
ANTIDIARRHEAL	AE N T AH D AY AE R IY AH L
ANTILEAK	AE N T AY L IY K
ANTINAUSEA	AE N T AY N AO Z IY AH
ANTINUCLEAR	AE N T AY N UW K L IY ER
ANTIPLEASURE	AE N T AY P L EH ZH ER
ANTIPLEASURES	AE N T AY P L EH ZH ER Z
ANTIPODEAN	AE N T AH P OW D IY AH N
ANTIPODEANS	AE N T AH P AH D IY N Z
ANTIREALISM	AE N T AY R IY L IH Z AH M
ANTIREALISMS	AE N T AY R IY L IH Z AH M Z
ANTIREALIST	AE N T AY R IY L IH S T
ANTIREALISTS	AE N T AY R IY L IH S T S
ANTIWEAR	AE N T AY W AE ER
APEAK	AH P IY K
APNEA	AE P N IY AH
APNEAL	AE P N IY AH L
APNEAS	AE P N IY Z
APNOEA	AE P N OW AH AH
APNOEAL	AE P N OW IY AH L
APNOEAS	AE P N OW AH AH Z
APOGEAL	AH P OW JH IY AH L
APOGEAN	AH P OW JH IY AH N
APOPHYSEAL	AE P AH F IH Z IY AH L
APPEAL	AH P IY L
APPEALABILITIES	AH P IY L AH B IH L AH T EH Z
APPEALABILITY	AH P IY L AH B IH L AH T EH
APPEALABLE	AH P IY L AH B AH L
APPEALED	AH P IY L D
APPEALER	AH P IY L ER
APPEALERS	AH P IY L ER Z
APPEALING	AH P IY L IH NG
APPEALINGLY	AH P IY L IH NG L IY
APPEALS	AH P IY L Z
APPEAR	AH P IH R
APPEARANCE	AH P IH R AH N S
APPEARANCES	AH P IH R AH N S AH Z
APPEARED	AH P IH R D
APPEARING	AH P IH R IH NG
APPEARS	AH P IH R Z
APPEASABLE	AH P IY Z AH B AH L
APPEASE	AH P IY Z
APPEASED	AH P IY Z D
APPEASEMENT	AH P IY Z M AH N T
APPEASEMENTS	AH P IY Z M AH N T S
APPEASER	AH P IY Z ER
APPEASERS	AH P IY Z ER Z
APPEASES	AH P IY Z IH Z
APPEASING	AH P IY Z IH NG
ARBOREAL	AA R B AO R IY AH L
ARBOREALLY	AA R B OW R IY AH L IY
ARBUTEAN	AA R B Y UW T IY AH N
ARCHAEA	AA R K IY AH
ARCHAEAL	AA R K EY IY AH L
ARCHAEAN	AA R K IY AH N
ARCHAEANS	AA R K IY AH N Z
ARCHDEACON	AA R CH D IY K AH N
ARCHDEACONRIES	AA R CH D IY K AH N R IY Z
ARCHDEACONRY	AA R CH D IY K AH N R IY
ARCHDEACONS	AA R CH D IY K AH N Z
AREA	EH R IY AH
AREAE	AE R IY
AREAL	AH R IY L
AREALLY	AH R IY AH L AY
AREAS	EH R IY AH Z
AREAWAY	AH R IY AH W EY
AREAWAYS	AH R IY AH W EY Z
ARREAR	AH R IH ER
ARREARAGE	ER IY R IH JH
ARREARAGES	ER IH R IH JH IH Z
ARREARS	ER IH R Z
ARROWHEAD	AE R OW HH EH D
ARROWHEAD(2)	EH R OW HH EH D
ARROWHEADS	AE R OW HH EH D Z
ARROWHEADS(2)	EH R OW HH EH D Z
ASEA	AH Z IY AH
ASEA(2)	EY EH S IY EY
AUREATE	AO R IY EY T
AUROREAN	AH R AO R IY AH N
AWEARY	AH W IH R IY
AWEATHER	AH W EH DH ER
AZALEA	AH Z EY L Y AH
AZALEAS	AH Z EY L Y AH Z
BACCALAUREATE	B AE K AH L AO R IY AH T
BACCALAUREATES	B AE K AH L AO R IY EY T S
BACKBEAT	B AE K B IY T
BACKBEATS	B AE K B IY T S
BACKBREAKER	B AE K B R EY K ER
BACKBREAKERS	B AE K B R EY K ER Z
BACKBREAKING	B AE K B R EY K IH NG
BACKSEAT	B AE K S IY T
BACKSEATS	B AE K S IY T S
BAKEMEAT	B EY K M IY T
BAKEMEATS	B EY K M IY T S
BALDHEAD	B AO L D HH EH D
BALDHEADED	B AO L D HH EH D IH D
BALDHEADS	B AO L D HH EH D Z
BALNEAL	B AE L N IY AH L
BANDEAU	B AE N D IY UW
BANDEAUS	B AE N D IY AH S
BANDEAUX	B AE N D IY AH K S
BANDLEADER	B AE N D L IY D ER
BANDLEADERS	B AE N D L IY D ER Z
BARATHEA	B AH R AE TH IY AH
BARATHEAS	B AE R AH TH IY Z
BAREHEAD	B EH R HH EH D
BAREHEADED	B EH R HH EH D IH D
BARRELHEAD	B AE R AH L HH EH D
BARRELHEADS	B AE R AH L HH EH D Z
BATEAU	B AE T OW
BATEAUX	B EY T IY AH K S
BATTEAU	B AE T IY UW
BATTEAUX	B AE T IY AH K S
BEACH	B IY CH
BEACHBOY	B IY CH B OY
BEACHBOYS	B IY CH B OY Z
BEACHCOMB	B IY CH K OW M
BEACHCOMBED	B IY CH K OW M D
BEACHCOMBER	B IY CH K OW M ER
BEACHCOMBERS	B IY CH K OW M ER Z
BEACHCOMBING	B IY CH K OW M IH NG
BEACHCOMBS	B IY CH K OW M Z
BEACHED	B IY CH T
BEACHES	B IY CH AH Z
BEACHES(2)	B IY CH IH Z
BEACHFRONT	B IY CH F R AA N T
BEACHFRONTS	B IY CH F R AA N T S
BEACHGOER	B IY CH G OW ER
BEACHGOERS	B IY CH G OW ER Z
BEACHHEAD	B IY CH HH EH D
BEACHHEADS	B IY CH HH EH D Z
BEACHIER	B IY CH IY ER
BEACHIEST	B IY CH IY AH S T
BEACHING	B IY CH IH NG
BEACHSIDE	B IY CH S AY D
BEACHWEAR	B IY CH W AE ER
BEACHY	B IY CH IY
BEACON	B IY K AH N
BEACONED	B IY K AH N D
BEACONING	B IY K AH N IH NG
BEACONS	B IY K AH N Z
BEAD	B IY D
BEADED	B IY D IH D
BEADIER	B IY D IY ER
BEADIEST	B IY D IY AH S T
BEADILY	B IY D IY L IY
BEADING	B IY D IH NG
BEADINGS	B IY D IH NG Z
BEADLE	B IY D AH L
BEADLES	B IY D AH L Z
BEADLIKE	B IY D L AY K
BEADMAN	B IY D M AE N
BEADMEN	B IY D M EH N
BEADROLL	B IY D R OW L
BEADROLLS	B IY D R OW L Z
BEADS	B IY D Z
BEADSMAN	B IY D Z M AE N
BEADSMEN	B IY D Z M EH N
BEADWORK	B IY D W ER K
BEADWORKS	B IY D W ER K S
BEADY	B IY D IY
BEAGLE	B IY G AH L
BEAGLES	B IY G AH L Z
BEAK	B IY K
BEAKED	B AH EY K T
BEAKER	B IY K ER
BEAKERS	B IY K ER Z
BEAKIER	B AH AE K AY AH R
BEAKIEST	B AH AE K AY AH S T
BEAKLESS	B AH AE K L AH S
BEAKLIKE	B IY K L AY K
BEAKS	B AH AE K S
BEAKY	B AH EY K IY
BEAM	B IY M
BEAMED	B IY M D
BEAMIER	B IH EY M IY ER
BEAMIEST	B IH EY M IY AH S T
BEAMILY	B IH EY M IY L IY
BEAMING	B IY M IH NG
BEAMISH	B IY M IH SH
BEAMISHLY	B IY M IH SH L IY
BEAMLESS	B IY M L AH S
BEAMLIKE	B IY M L AY K
BEAMS	B IY M Z
BEAMY	B IY M IY
BEAN	B IY N
BEANBAG	B IY N B AE G
BEANBAGS	B IY N B AE G Z
BEANBALL	B IY N B AO L
BEANBALLS	B IY N B AO L Z
BEANED	B IY N D
BEANERIES	B IY N AH R IY Z
BEANERY	B IY N AH R IY
BEANIE	B IY N IY
BEANIES	B IY N IY Z
BEANING	B IY N IH NG
BEANLIKE	B IY N L AY K
BEANO	B AH AE N OW
BEANOS	B IY N AA S
BEANPOLE	B IY N P OW L
BEANPOLES	B IY N P OW L Z
BEANS	B IY N Z
BEANSTALK	B IY N S T AO K
BEANSTALKS	B IY N S T AO K S
BEAR	B EH R
BEARABILITIES	B AE ER AH B IH L AH T EH Z
BEARABILITY	B AE ER AH B IH L AH T EH
BEARABLE	B EH R AH B AH L
BEARABLY	B EH R AH B L IY
BEARBAITING	B AE ER B EY T IH NG
BEARBAITINGS	B AE ER B EY T IH NG Z
BEARBERRIES	B AE ER B EH R IY Z
BEARBERRY	B AE ER B EH R IY
BEARCAT	B AE ER K AE T
BEARCATS	B AE ER K AE T S
BEARD	B IH R D
BEARDED	B IH R D AH D
BEARDEDNESS	B IH ER D AH D N AH S
BEARDEDNESSES	B IH ER D AH D N AH S IH Z
BEARDING	B IH ER D IH NG
BEARDLESS	B IH AA R D L AH S
BEARDS	B IH R D Z
BEARDTONGUE	B IH ER D T AH NG
BEARDTONGUES	B IH ER D T AH NG Z
BEARER	B EH R ER
BEARERS	B EH R ER Z
BEARHUG	B AE ER HH AH G
BEARHUGS	B AE ER HH AH G Z
BEARING	B EH R IH NG
BEARINGS	B EH R IH NG Z
BEARISH	B EH R IH SH
BEARISHLY	B EH R IH SH L IY
BEARISHNESS	B EH R IH SH N AH S
BEARISHNESSES	B AE ER IH SH N AH S IH Z
BEARLIKE	B AE ER L AY K
BEARS	B EH R Z
BEARSKIN	B AE ER S K IH N
BEARSKINS	B AE ER S K IH N Z
BEARWOOD	B AE ER W UH D
BEARWOODS	B AE ER W UH D Z
BEAST	B IY S T
BEASTIE	B IY S T IY
BEASTIES	B IY S T IY Z
BEASTINGS	B IY S T IH NG Z
BEASTLIER	B IY S T L IY ER
BEASTLIEST	B IY S T L IY AH S T
BEASTLINESS	B IY S T L IY N AH S
BEASTLINESSES	B IY S T L IY N AH S IH Z
BEASTLY	B IY S T L IY
BEASTS	B IY S T S
BEAT	B IY T
BEATABLE	B IY T AH B AH L
BEATEN	B IY T AH N
BEATER	B IY T ER
BEATERS	B IY T ER Z
BEATIFIC	B IY AH T IH F IH K
BEATIFICALLY	B IY AH T IH F IH K AH L IY
BEATIFICATION	B IY AE T AH F AH K EY SH AH N
BEATIFICATIONS	B IY AE T AH F AH K EY SH AH N Z
BEATIFIED	B IY AE T AH F AY D
BEATIFIES	B IY T AH F AY Z
BEATIFY	B IY AE T AH F AY
BEATIFYING	B IY T AH F AY IH NG
BEATING	B IY T IH NG
BEATINGS	B IY T IH NG Z
BEATITUDE	B IY AE T AH T UW D
BEATITUDES	B IY AE T AH T UW D Z
BEATLESS	B IY T L AH S
BEATNIK	B IY T N IH K
BEATNIKS	B IY T N IH K S
BEATS	B IY T S
BEAU	B OW
BEAUCOUP	B OW K UW
BEAUISH	B OW IH SH
BEAUS	B OW Z
BEAUT	B AH AO T
BEAUTEOUS	B Y UW T IY AH S
BEAUTEOUSLY	B Y UW T IY AH S L IY
BEAUTEOUSNESS	B Y UW T IY AH S N AH S
BEAUTEOUSNESSES	B Y UW T IY AH S N AH S IH Z
BEAUTICIAN	B Y UW T IH SH AH N
BEAUTICIANS	B AH AH T IH S IY AH N Z
BEAUTIES	B Y UW T IY Z
BEAUTIFICATION	B IH AH Y UW T AH F AH K EY SH AH N
BEAUTIFICATIONS	B AH AO T AH F AH K EY T IY AH N Z
BEAUTIFIED	B AH AO T AH F AY D
BEAUTIFIER	B AH AH T IH F AY AH R
BEAUTIFIERS	B AH AO T AH F IY R Z
BEAUTIFIES	B AH AO T AH F AY Z
BEAUTIFUL	B Y UW T AH F AH L
BEAUTIFULER	B Y UW T IY F AH L ER
BEAUTIFULEST	B Y UW T IY F AH L AH S T
BEAUTIFULLY	B Y UW T AH F L IY
BEAUTIFULNESS	B Y UW T IY F AH L N AH S
BEAUTIFULNESSES	B Y UW T IY F AH L N AH S IH Z
BEAUTIFY	B Y UW T IH F AY
BEAUTIFYING	B AH AH T IH F AY AH NG
BEAUTS	B IH AH Y UW T S
BEAUTY	B Y UW T IY
BEAUX	B OW
BEAVER	B IY V ER
BEAVERBOARD	B IY V ER B OW R D
BEAVERBOARDS	B IY V ER B OW R D Z
BEAVERED	B IY V ER D
BEAVERING	B IY V ER IH NG
BEAVERS	B IY V ER Z
BEDEAFEN	B IH D EH F AH N
BEDEAFENED	B IH D EH F AH N D
BEDEAFENING	B IH D EH F AH N IH NG
BEDEAFENS	B IH D EH F AH N Z
BEDSPREAD	B EH D S P R EH D
BEDSPREADS	B EH D S P R EH D Z
BEDSTEAD	B EH D S T EH D
BEDSTEADS	B EH D S T EH D Z
BEEBREAD	B IY B R EH D
BEEBREADS	B IY B R EH D Z
BEEFEATER	B IY F IY T ER
BEEFEATERS	B IY F IY T ER Z
BEEFSTEAK	B IY F S T EY K
BEEFSTEAKS	B IY F S T EY K S
BEFLEA	B IH F L IY
BEFLEAED	B IH F L IY D
BEFLEAING	B IH F L IY IH NG
BEFLEAS	B IH F L IY Z
BEHEAD	B IH HH EH D
BEHEAD(2)	B IY HH EH D
BEHEADED	B IH HH EH D IH D
BEHEADING	B IH HH EH D IH NG
BEHEADINGS	B IH HH EH D IH NG Z
BEHEADS	B IH HH EH D Z
BELEAGUER	B IH L IY G ER
BELEAGUERED	B IH L IY G ER D
BELEAGUERING	B IH L IY G ER IH NG
BELEAGUERMENT	B IH L IY G ER M AH N T
BELEAGUERMENTS	B IH L IY G ER M AH N T S
BELEAGUERS	B IH L IY G ER Z
BELEAP	B IH L IY P
BELEAPED	B IH L IY P T
BELEAPING	B IH L IY P IH NG
BELEAPS	B IH L IY P S
BELEAPT	B IH L EH P T
BEMEAN	B IH M IY N
BEMEANED	B IH M IY N D
BEMEANING	B IH M IY N IH NG
BEMEANS	B IH M IY N Z
BENEATH	B IH N IY TH
BEQUEATH	B IH K W IY TH
BEQUEATHAL	B IH K W IY TH AH L
BEQUEATHALS	B IH K W IY TH AH L Z
BEQUEATHED	B AH K W IY TH T
BEQUEATHING	B IH K W IY TH IH NG
BEQUEATHS	B IH K W IY TH S
BEREAVE	B ER IY V
BEREAVED	B ER IY V D
BEREAVEMENT	B ER IY V M AH N T
BEREAVEMENTS	B IH R IY V M AH N T S
BEREAVER	B IH R IY V ER
BEREAVERS	B IH R IY V ER Z
BEREAVES	B IH R IY V Z
BEREAVING	B IH R IY V IH NG
BESMEAR	B IH S M IH ER
BESMEARED	B IH S M IH ER D
BESMEARING	B IH S M IH ER IH NG
BESMEARS	B IH S M IH ER Z
BESPEAK	B IH S P IY K
BESPEAKING	B IH S P IY K IH NG
BESPEAKS	B IH S P IY K S
BESPREAD	B IH S P R EH D
BESPREADING	B IH S P R EH D IH NG
BESPREADS	B IH S P R EH D Z
BESTEAD	B IH S T EH D
BESTEADED	B IH S T EH D IH D
BESTEADING	B IH S T EH D IH NG
BESTEADS	B IH S T EH D Z
BEWEARIED	B IH W IH R IY D
BEWEARIES	B IH W IH R IY Z
BEWEARY	B IH W IH R IY
BEWEARYING	B IH W IH R IY IH NG
BIGHEAD	B IH G HH EH D
BIGHEADED	B IH G HH EH D IH D
BIGHEADS	B IH G HH EH D Z
BIGHEARTED	B IH G HH AA R T IH D
BIGHEARTEDLY	B IH G HH AA R T AH D L IY
BIGHEARTEDNESS	B IH G HH AA R T AH D N AH S
BIGHEARTEDNESSES	B IH G HH AA R T AH D N AH S IH Z
BILINEAR	B AY L IH N IY ER
BILLHEAD	B IH L HH EH D
BILLHEADS	B IH L HH EH D Z
BINUCLEATE	B AY N UW K L IY AH T
BINUCLEATED	B AY N UW K L IY EY T IH D
BIOCLEAN	B AY AA K L IY AH N
BIOREACTOR	B AY OW R AE K T ER
BIOREACTORS	B AY OW R AE K T ER Z
BITEABLE	B AY T AH B AH L
BIYEARLY	B AY Y IH ER L IY
BLACKHEAD	B L AE K HH EH D
BLACKHEADS	B L AE K HH EH D Z
BLACKHEART	B L AE K HH AA R T
BLACKHEARTS	B L AE K HH AA R T S
BLACKLEAD	B L AE K L IY D
BLACKLEADS	B L AE K L IY D Z
BLEACH	B L IY CH
BLEACHABLE	B L IY CH AH B AH L
BLEACHED	B L IY CH T
BLEACHER	B L IY CH ER
BLEACHERITE	B L IY CH AH R AY T
BLEACHERITES	B L IY CH AH R AY T S
BLEACHERS	B L IY CH ER Z
BLEACHES	B L IY CH IH Z
BLEACHING	B L IY CH IH NG
BLEAK	B L IY K
BLEAKER	B L IY K ER
BLEAKEST	B L IY K AH S T
BLEAKISH	B L IY K IH SH
BLEAKLY	B L IY K L IY
BLEAKNESS	B L IY K N AH S
BLEAKNESSES	B L IY K N AH S IH Z
BLEAKS	B L IY K S
BLEAR	B L IH ER
BLEARED	B L IH ER D
BLEARIER	B L IH ER IY ER
BLEARIEST	B L IH ER IY AH S T
BLEARILY	B L IH ER IY L IY
BLEARINESS	B L IH ER IY N AH S
BLEARINESSES	B L IH ER IY N AH S IH Z
BLEARING	B L IH ER IH NG
BLEARS	B L IH ER Z
BLEARY	B L IH R IY
BLEAT	B L IY T
BLEATED	B L IY T IH D
BLEATER	B L IY T ER
BLEATERS	B L IY T ER Z
BLEATING	B L IY T IH NG
BLEATS	B L IY T S
BLOCKHEAD	B L AA K HH EH D
BLOCKHEADS	B L AA K HH EH D Z
BLOODSTREAM	B L AH D S T R IY M
BLOODSTREAMS	B L AH D S T R IY M Z
BLUEBEARD	B L UW B IY R D
BLUEBEARDS	B L UW B IH ER D Z
BLUEHEAD	B L UW HH EH D
BLUEHEADS	B L UW HH EH D Z
BLUEJEANS	B L UW JH IY N Z
BOGBEAN	B AO G B IY N
BOGBEANS	B AO G B IY N Z
BOHEA	B AA HH IY AH
BOHEAS	B AH HH IY Z
BOLTHEAD	B OW L T HH EH D
BOLTHEADS	B OW L T HH EH D Z
BONEHEAD	B OW N HH EH D
BONEHEADED	B OW N HH EH D IH D
BONEHEADEDNESS	B OW N HH EH D AH D N AH S
BONEHEADEDNESSES	B OW N HH EH D AH D N AH S IH Z
BONEHEADS	B OW N HH EH D Z
BONEMEAL	B OW N M IY L
BONEMEALS	B OW N M IY L Z
BORDEAUX	B AO R D OW
BORDEREAU	B AO R D IY R IY UW
BORDEREAUX	B AO R D IY R IY AH K S
BOREAL	B AO R AH L
BOUGAINVILLAEA	B AW G EY N V IH L IY AH
BOUGAINVILLAEAS	B AW G EY N V IH L IY AH Z
BOUGAINVILLEA	B UW G EY N V IH L IY AH
BOUGAINVILLEAS	B AW G EY N V IH L IY Z
BOWHEAD	B AW HH EH D
BOWHEADS	B AW HH EH D Z
BRACTEAL	B R AE K T IY AH L
BRACTEATE	B R AE K T IY EY T
BRAINTEASER	B R EY N T IY Z ER
BRAINTEASERS	B R EY N T IY Z ER Z
BRAKEAGE	B R EY K IH JH
BRAKEAGES	B R EY K IH JH IH Z
BREACH	B R IY CH
BREACHED	B R IY CH T
BREACHER	B R IY CH ER
BREACHERS	B R IY CH ER Z
BREACHES	B R IY CH IH Z
BREACHING	B R IY CH IH NG
BREAD	B R EH D
BREADBASKET	B R EH D B AE S K AH T
BREADBASKETS	B R EH D B AE S K AH T S
BREADBOARD	B R EH D B OW R D
BREADBOARDED	B R EH D B OW R D IH D
BREADBOARDING	B R EH D B OW R D IH NG
BREADBOARDS	B R EH D B OW R D Z
BREADBOX	B R EH D B AA K S
BREADBOXES	B R EH D B AA K S IH Z
BREADCRUMB	B R EH D K R AH M
BREADCRUMBS	B R EH D K R AH M Z
BREADED	B R EH D IH D
BREADFRUIT	B R EH D F R UW T
BREADFRUITS	B R EH D F R UW T S
BREADING	B R EH D IH NG
BREADLINE	B R EH D L AY N
BREADLINES	B R EH D L AY N Z
BREADNUT	B R EH D N AH T
BREADNUTS	B R EH D N AH T S
BREADS	B R EH D Z
BREADSTICK	B R EH D S T IH K
BREADSTICKS	B R EH D S T IH K S
BREADSTUFF	B R EH D S T AH F
BREADSTUFFS	B R EH D S T AH F S
BREADTH	B R EH D TH
BREADTHS	B R EH D TH S
BREADTHWISE	B R EH D TH W AY Z
BREADWINNER	B R EH D W IH N ER
BREADWINNERS	B R EH D W IH N ER Z
BREADWINNING	B R EH D W IH N IH NG
BREADWINNINGS	B R EH D W IH N IH NG Z
BREADY	B R EH D IY
BREAK	B R EY K
BREAKABLE	B R EY K AH B AH L
BREAKABLES	B R EY K AH B AH L Z
BREAKAGE	B R EY K IH JH
BREAKAGES	B R EY K IH JH IH Z
BREAKAWAY	B R EY K AH W EY
BREAKAWAYS	B R EY K AH W EY Z
BREAKDOWN	B R EY K D AW N
BREAKDOWNS	B R EY K D AW N Z
BREAKER	B R EY K ER
BREAKERS	B R EY K ER Z
BREAKEVEN	B R EY K IY V AH N
BREAKEVENS	B R EY K IY V AH N Z
BREAKFAST	B R EH K F AH S T
BREAKFASTED	B R EH K F AH S T IH D
BREAKFASTER	B R EH K F AH S T ER
BREAKFASTERS	B R EH K F AH S T ER Z
BREAKFASTING	B R EH K F AH S T IH NG
BREAKFASTS	B R EH K F AH S T S
BREAKFRONT	B R EY K F R AH N T
BREAKFRONTS	B R EY K F R AH N T S
BREAKING	B R EY K IH NG
BREAKINGS	B R EY K IH NG Z
BREAKNECK	B R EY K N EH K
BREAKOUT	B R EY K AW T
BREAKOUTS	B R EY K AW T S
BREAKS	B R EY K S
BREAKSAWAY	B R EY K S AH W EY
BREAKTHROUGH	B R EY K TH R UW
BREAKTHROUGHS	B R EY K TH R UW Z
BREAKUP	B R EY K AH P
BREAKUPS	B R EY K AH P S
BREAKWATER	B R EY K W AO T ER
BREAKWATERS	B R EY K W AO T ER Z
BREAM	B R IY M
BREAMED	B R IY M D
BREAMING	B R IY M AH NG
BREAMS	B R IY M Z
BREAST	B R EH S T
BREASTBONE	B R EH S T B OW N
BREASTBONES	B R EH S T B OW N Z
BREASTED	B R EH S T AH D
BREASTED(2)	B R EH S T IH D
BREASTING	B R EH S T IH NG
BREASTPLATE	B R EH S T P L EY T
BREASTPLATES	B R EH S T P L EY T S
BREASTS	B R EH S T S
BREASTSTROKE	B R EH S T S T R OW K
BREASTSTROKER	B R EH S T S T R OW K ER
BREASTSTROKERS	B R EH S T S T R OW K ER Z
BREASTSTROKES	B R EH S T S T R OW K S
BREASTWORK	B R EH S T W ER K
BREASTWORKS	B R EH S T W ER K S
BREATH	B R EH TH
BREATHABILITIES	B R IY DH AH B IH L AH T EH Z
BREATHABILITY	B R IY DH AH B IH L AH T EH
BREATHABLE	B R IY DH AH B AH L
BREATHE	B R IY DH
BREATHED	B R IY DH D
BREATHER	B R IY DH ER
BREATHERS	B R IY DH ER Z
BREATHES	B R IY DH Z
BREATHIER	B R EH TH IY ER
BREATHIEST	B R EH TH IY AH S T
BREATHILY	B R EH TH IY L IY
BREATHINESS	B R EH TH IY N AH S
BREATHINESSES	B R EH TH IY N AH S IH Z
BREATHING	B R IY DH IH NG
BREATHINGS	B R IY DH IH NG Z
BREATHLESS	B R EH TH L AH S
BREATHLESSLY	B R EH TH L AH S L IY
BREATHLESSNESS	B R EH TH L AH S N AH S
BREATHLESSNESSES	B R EH TH L AH S N AH S IH Z
BREATHS	B R EH TH S
BREATHTAKING	B R EH TH T EY K IH NG
BREATHTAKINGLY	B R EH TH T EY K IH NG L IY
BREATHY	B R EH TH IY
BRIDGEABLE	B R IH JH AH B AH L
BRIDGEHEAD	B R IH JH HH EH D
BRIDGEHEADS	B R IH JH HH EH D Z
BROADLEAF	B R AO D L IY F
BROKENHEARTED	B R OW K AH N HH AA R T IH D
BROWBEAT	B R AW B IY T
BROWBEATEN	B R AW B IY T AH N
BROWBEATING	B R AW B IY T IH NG
BROWBEATS	B R AW B IY T S
BUBBLEHEAD	B AH B AH L HH EH D
BUBBLEHEADED	B AH B AH L HH EH D IH D
BUBBLEHEADS	B AH B AH L HH EH D Z
BUCKBEAN	B AH K B IY N
BUCKBEANS	B AH K B IY N Z
BUCKWHEAT	B AH K W IY T
BUCKWHEATS	B AH K W IY T S
BUFFLEHEAD	B AH F L AH HH IY D
BUFFLEHEADS	B AH F L AH HH IY D Z
BUGBEAR	B AH G B AE ER
BUGBEARS	B AH G B AE ER Z
BULKHEAD	B AH L K HH EH D
BULKHEADS	B AH L K HH EH D Z
BULLHEAD	B UH L HH EH D
BULLHEADED	B UH L HH EH D IH D
BULLHEADEDLY	B UH L HH EH D AH D L IY
BULLHEADEDNESS	B UH L HH EH D AH D N AH S
BULLHEADEDNESSES	B UH L HH EH D AH D N AH S IH Z
BULLHEADS	B UH L HH EH D Z
BUREAU	B Y UH R OW
BUREAUCRACIES	B Y UH R AA K R AH S IY Z
BUREAUCRACY	B Y UH R AA K R AH S IY
BUREAUCRAT	B Y UH R AH K R AE T
BUREAUCRAT(2)	B Y UH R OW K R AE T
BUREAUCRATESE	B Y UH R AH K R AE T IY Z
BUREAUCRATESES	B Y UH R OW K R EY T S IH Z
BUREAUCRATIC	B Y UH R AH K R AE T IH K
BUREAUCRATICALLY	B Y UH R AH K R AE T IH K AH L IY
BUREAUCRATISE	B Y AH R IY AH K R AH T AY Z
BUREAUCRATISED	B Y UH R AH K R AE T IY Z D
BUREAUCRATISES	B Y UH R AH K R AE T IY Z IH Z
BUREAUCRATISING	B Y UH R AH K R AE T IY Z IH NG
BUREAUCRATISM	B Y UH R AH K R AE T IH Z AH M
BUREAUCRATISMS	B Y UH R AH K R AE T IH Z AH M Z
BUREAUCRATIZATION	B Y UH R AH K R AE T AH Z EY SH AH N
BUREAUCRATIZATIONS	B Y UH R AH K R AE T AH Z EY SH AH N Z
BUREAUCRATIZE	B Y UH R AH K R AE T AY Z
BUREAUCRATIZED	B Y UH R AH K R AE T AY Z D
BUREAUCRATIZES	B Y UH R AH K R AE T AY Z IH Z
BUREAUCRATIZING	B Y UH R AH K R AE T AY Z IH NG
BUREAUCRATS	B Y UH R AH K R AE T S
BUREAUCRATS(2)	B Y UH R OW K R AE T S
BUREAUS	B Y UH R OW Z
BUREAUX	B Y UH R IY AH K S
CADUCEAN	K AE D Y UW S IY AH N
CAESAREAN	K EY S ER IY N
CAESAREANS	K EY S ER IY N Z
CALCANEA	K AE L K EY N IY AH
CALCANEAL	K AE L K EY N IY AH L
CALCEATE	K AE L S IY EY T
CALYCEAL	K AH L IH S IY AH L
CAMOUFLAGEABLE	K AE M AH F L AA ZH AH B AH L
CANOEABLE	K AH N UW AH B AH L
CASEASE	K EY S IY Z
CASEASES	K EY S IY Z AH Z
CASEATE	K EY S AH T
CASEATED	K EY S EY T IH D
CASEATES	K EY S AH T S
CASEATING	K EY S EY T IH NG
CASEATION	K EY S EY SH AH N
CASEATIONS	K EY S EY SH AH N Z
CASEBEARER	K EY S B AE ER ER
CASEBEARERS	K EY S B AE ER ER Z
CATHEAD	K AE T HH EH D
CATHEADS	K AE T HH EH D Z
CAVEAT	K EY V IY AE T
CAVEATED	K EY V IY AE T IH D
CAVEATING	K EY V IY AE T IH NG
CAVEATOR	K EY V IY AE T ER
CAVEATORS	K EY V IY AE T ER Z
CAVEATS	K EY V IY AE T S
CEANOTHUS	S IY N AH TH AH S
CEANOTHUSES	S IY N AH TH UW Z AH Z
CEASE	S IY S
CEASED	S IY S T
CEASEFIRE	S IY S F AY ER
CEASEFIRES	S IY S F AY ER Z
CEASELESS	S IY S L IH S
CEASELESSLY	S IY Z L AH S L IY
CEASELESSNESS	S IY S L AH S N AH S
CEASELESSNESSES	S IY S L AH S N AH S IH Z
CEASES	S IY S IH Z
CEASING	S IY S IH NG
CENTAUREA	S EH N T AH Y UH R IY AH
CENTAUREAS	S EH N T AH Y UH R IY AH Z
CEREAL	S IH R IY AH L
CEREALS	S IH R IY AH L Z
CERULEAN	S AH R UW L IY AH N
CERULEANS	S AH R UW L IY AH N Z
CESAREAN	S AH S AE R IY AH N
CESAREANS	S EH S AH R IY N Z
CETACEAN	S IH T EY SH AH N
CETACEAN(2)	S IY T EY SH AH N
CETACEANS	S EH T AH S IY N Z
CHALYBEATE	CH AH L AY B IY EY T
CHALYBEATES	CH AH L AY B IY EY T S
CHANGEABILITIES	CH EY N JH AH B IH L AH T EH Z
CHANGEABILITY	CH EY N JH AH B IH L AH T EH
CHANGEABLE	CH EY N JH AH B AH L
CHANGEABLENESS	CH EY N JH AH B AH L N AH S
CHANGEABLENESSES	CH EY N JH AH B AH L N AH S IH Z
CHANGEABLY	CH EY N JH AH B L IY
CHAPEAU	CH EY P IY UW
CHAPEAUS	CH EY P IY AH S
CHAPEAUX	CH EY P IY AH K S
CHARGEABLE	CH AA R JH AH B AH L
CHATEAU	SH AE T OW
CHATEAUBRIAND	CH EY T IY AH B R IY AH N D
CHATEAUBRIANDS	CH EY T IY AH B R IY AH N D Z
CHATEAUS	SH AE T OW Z
CHATEAUX	SH AH T OW
CHEAP	CH IY P
CHEAPEN	CH IY P AH N
CHEAPENED	CH IY P AH N D
CHEAPENING	CH IY P AH N IH NG
CHEAPENS	CH IY P AH N Z
CHEAPER	CH IY P ER
CHEAPEST	CH IY P AH S T
CHEAPIE	CH IY P IY
CHEAPIES	CH IY P IY Z
CHEAPISH	CH IY P IH SH
CHEAPISHLY	CH IY P IH SH L IY
CHEAPJACK	CH IY P JH AE K
CHEAPJACKS	CH IY P JH AE K S
CHEAPLY	CH IY P L IY
CHEAPNESS	CH IY P N AH S
CHEAPNESSES	CH IY P N AH S IH Z
CHEAPO	CH IY P OW
CHEAPOS	CH IY P AA S
CHEAPS	CH IY P S
CHEAPSKATE	CH IY P S K EY T
CHEAPSKATES	CH IY P S K EY T S
CHEAT	CH IY T
CHEATED	CH IY T AH D
CHEATED(2)	CH IY T IH D
CHEATER	CH IY T ER
CHEATERS	CH IY T ER Z
CHEATING	CH IY T IH NG
CHEATS	CH IY T S
CHEERLEAD	CH IH ER L IY D
CHEERLEADER	CH IH R L IY D ER
CHEERLEADERS	CH IH R L IY D ER Z
CHEERLEADING	CH IH R L IY D IH NG
CHEERLEADS	CH IH ER L IY D Z
CHICKENHEARTED	CH IH K AH N HH AA R T IH D
CHICKPEA	CH IH K P IY
CHICKPEAS	CH IH K P IY Z
CHILDBEARING	CH AY L D B EH R IH NG
CHILDBEARINGS	CH AY L D B AE ER IH NG Z
CHOREA	CH AO R IY AH
CHOREAL	CH OW R AH L
CHOREAS	CH AH R IY Z
CHOWDERHEAD	CH AW D ER HH EH D
CHOWDERHEADED	CH AW D ER HH EH D IH D
CHOWDERHEADS	CH AW D ER HH EH D Z
CHUCKLEHEAD	CH AH K AH L HH EH D
CHUCKLEHEADED	CH AH K AH L HH EH D IH D
CHUCKLEHEADS	CH AH K AH L HH EH D Z
CINEAST	S AH N IY S T
CINEASTE	S AH N IY S T
CINEASTES	S AH N IY S T S
CINEASTS	S AH N IY S T S
CITEABLE	S AY T AH B AH L
CLEAN	K L IY N
CLEANABILITIES	K L IY N AH B IH L AH T EH Z
CLEANABILITY	K L IY N AH B IH L AH T EH
CLEANABLE	K L IY N AH B AH L
CLEANED	K L IY N D
CLEANER	K L IY N ER
CLEANERS	K L IY N ER Z
CLEANEST	K L IY N AH S T
CLEANHANDED	K L IY N HH AE N D IH D
CLEANING	K L IY N IH NG
CLEANLIER	K L IY N L IY ER
CLEANLIEST	K L IY N L IY AH S T
CLEANLINESS	K L EH N L IY N IH S
CLEANLINESSES	K L IY N L IY N AH S IH Z
CLEANLY	K L IY N L IY
CLEANNESS	K L IY N IH S
CLEANNESSES	K L IY N AH S IH Z
CLEANS	K L IY N Z
CLEANSE	K L EH N Z
CLEANSED	K L EH N Z D
CLEANSER	K L EH N Z ER
CLEANSERS	K L EH N Z ER Z
CLEANSES	K L EH N Z IH Z
CLEANSING	K L EH N Z IH NG
CLEANUP	K L IY N AH P
CLEANUPS	K L IY N AH P S
CLEAR	K L IH R
CLEARABLE	K L IH ER AH B AH L
CLEARANCE	K L IH R AH N S
CLEARANCES	K L IH R AH N S IH Z
CLEARED	K L IH R D
CLEARER	K L IH R ER
CLEARERS	K L IH ER ER Z
CLEAREST	K L IH R IH S T
CLEARHEADED	K L IH ER HH EH D IH D
CLEARHEADEDLY	K L IH ER HH EH D AH D L IY
CLEARHEADEDNESS	K L IH ER HH EH D AH D N AH S
CLEARHEADEDNESSES	K L IH ER HH EH D AH D N AH S IH Z
CLEARING	K L IH R IH NG
CLEARINGHOUSE	K L IH R IH NG HH AW S
CLEARINGHOUSES	K L IY R IH NG HH AW S IH Z
CLEARINGS	K L IH ER IH NG Z
CLEARLY	K L IH R L IY
CLEARNESS	K L IH R N AH S
CLEARNESSES	K L IH ER N AH S IH Z
CLEARS	K L IH R Z
CLEARSTORIES	K L IH ER S T OW R IY Z
CLEARSTORY	K L IH ER S T OW R IY
CLEARWING	K L IH ER W IH NG
CLEARWINGS	K L IH ER W IH NG Z
CLEAT	K L IY T
CLEATED	K L IY T IH D
CLEATING	K L IY T IH NG
CLEATS	K L IY T S
CLEAVABLE	K L IY V AH B AH L
CLEAVAGE	K L IY V AH JH
CLEAVAGE(2)	K L IY V IH JH
CLEAVAGES	K L IY V IH JH IH Z
CLEAVE	K L IY V
CLEAVED	K L IY V D
CLEAVER	K L IY V ER
CLEAVERS	K L IY V ER Z
CLEAVES	K L IY V Z
CLEAVING	K L IY V IH NG
CLOSEABLE	K L OW Z AH B AH L
CLOVERLEAF	K L OW V ER L IY F
CLOVERLEAFS	K L OW V ER L IY F S
CLOVERLEAVES	K L OW V ER L IY V Z
CLYPEAL	K L AY P IY AH L
CLYPEATE	K L AY P IY EY T
COAPPEAR	K OW AH P IH ER
COAPPEARED	K OW AH P IH ER D
COAPPEARING	K OW AH P IH ER IH NG
COAPPEARS	K OW AH P IH ER Z
COCCYGEAL	K AA K S AY JH IY AH L
COCHINEAL	K OW CH AY N AH L
COCHINEALS	K OW CH AY N AH L Z
COCHLEA	K AA K L IY AH
COCHLEAE	K OW K L IY
COCHLEAR	K AA K L IY ER
COCHLEAS	K OW K L IY Z
COCREATE	K OW K R IY EY T
COCREATED	K OW K R IY EY T IH D
COCREATES	K OW K R IY EY T S
COCREATING	K OW K R IY EY T IH NG
COCREATOR	K OW K R IY EY T ER
COCREATORS	K OW K R IY EY T ER Z
COFEATURE	K OW F IY CH ER
COFEATURED	K OW F IY CH ER D
COFEATURES	K OW F IY CH ER Z
COFEATURING	K OW F IY CH ER IH NG
COHEAD	K OW HH EH D
COHEADED	K OW HH EH D IH D
COHEADING	K OW HH EH D IH NG
COHEADS	K OW HH EH D Z
COKEHEAD	K OW K HH EH D
COKEHEADS	K OW K HH EH D Z
COLDHEARTED	K OW L D HH AA R T IH D
COLDHEARTEDLY	K OW L D HH AA R T AH D L IY
COLDHEARTEDNESS	K OW L D HH AA R T AH D N AH S
COLDHEARTEDNESSES	K OW L D HH AA R T AH D N AH S IH Z
COLEAD	K OW L IY D
COLEADER	K OW L IY D ER
COLEADERS	K OW L IY D ER Z
COLEADING	K OW L IY D IH NG
COLEADS	K OW L IY D Z
COLINEAR	K OW L IH N IY ER
COLINEARITIES	K OW L IH N IY ER AH T IY Z
COLINEARITY	K OW L IH N IY ER AH T IY
COLLEAGUE	K AA L IY G
COLLEAGUES	K AA L IY G Z
COLLEAGUESHIP	K AA L IY G SH IH P
COLLEAGUESHIPS	K AA L IY G SH IH P S
COLLECTANEA	K AA L EH K T EY N IY AH
COLLINEAR	K AA L AY N IY AH R
COLLINEARITIES	K AA L AH N IY R AH T AY Z
COLLINEARITY	K AA L AH N IY R AH T IY
COMMONWEAL	K AA M AH N W IY L
COMMONWEALS	K AA M AH N W IY L Z
COMMONWEALTH	K AA M AH N W EH L TH
COMMONWEALTHS	K AA M AH N W EH L TH S
COMPLEAT	K AH M P L IY T
CONCEAL	K AH N S IY L
CONCEALABLE	K AH N S IY L AH B AH L
CONCEALED	K AH N S IY L D
CONCEALER	K AH N S IY L ER
CONCEALERS	K AH N S IY L ER Z
CONCEALING	K AH N S IY L IH NG
CONCEALINGLY	K AH N S IY L IH NG L IY
CONCEALMENT	K AH N S IY L M AH N T
CONCEALMENTS	K AH N S IY L M AH N T S
CONCEALS	K AH N S IY L Z
CONGEAL	K AH N JH IY L
CONGEALED	K AH N JH IY L D
CONGEALING	K AH N JH IY L IH NG
CONGEALMENT	K AH N JH IY L M AH N T
CONGEALMENTS	K AH N JH IY L M AH N T S
CONGEALS	K AH N JH IY L Z
COOLHEADED	K UW L HH EH D IH D
COPPERHEAD	K AA P ER HH EH D
COPPERHEADS	K AA P ER HH EH D Z
COPYREAD	K AA P IY R IY D
COPYREADER	K AA P IY R IY D ER
COPYREADERS	K AA P IY R IY D ER Z
COPYREADING	K OW P AY ER EY D IH NG
COPYREADS	K AA P IY R IY D Z
CORESEARCHER	K OW R IY S ER CH ER
CORESEARCHERS	K OW R IY S ER CH ER Z
CORNBREAD	K AO R N B R EH D
CORNBREADS	K AO R N B R EH D Z
CORNEA	K AO R N IY AH
CORNEAE	K AA R N IY
CORNEAL	K AO R N IY L
CORNEAS	K AO R N IY AH Z
CORNMEAL	K AO R N M IY L
CORNMEALS	K AO R N M IY L Z
CORPOREAL	K AO R P OW R IY AH L
CORPOREALITIES	K AO R P OW R IY AE L AH T IY Z
CORPOREALITY	K AO R P OW R IY AE L AH T IY
CORPOREALLY	K AO R P OW R IY AH L IY
CORPOREALNESS	K AO R P OW R IY AH L N AH S
CORPOREALNESSES	K AO R P OW R IY AH L N AH S IH Z
COTEAU	K OW T IY UW
COTEAUS	K OW T IY AH S
COTEAUX	K OW T IY AH K S
COTONEASTER	K OW T OW N AE S T ER
COTONEASTERS	K OW T OW N AE S T ER Z
COTQUEAN	K OW T AE N
COTQUEANS	K OW T W IY N Z
COUNTERCOUNTERMEASURE	K AW N T ER K AW N T ER M EH ZH ER
COUNTERCOUNTERMEASURES	K AW N T ER K AW N T ER M EH ZH ER Z
COUNTERMEASURE	K AW N T ER M EH ZH ER
COUNTERMEASURES	K AW N T ER M EH ZH ER Z
COUNTERPLEA	K AW N T ER P L IY
COUNTERPLEAS	K AW N T ER P L IY Z
COUNTERREACTION	K AW N T ER R IY AE K SH AH N
COUNTERREACTIONS	K AW N T ER R IY AE K SH AH N Z
COUNTERSTREAM	K AW N T ER S T R IY M
COUNTERSTREAMS	K AW N T ER S T R IY M Z
COUNTERTHREAT	K AW N T ER TH R EH T
COUNTERTHREATS	K AW N T ER TH R EH T S
COUNTRYSEAT	K AH N T R IY S IY T
COUNTRYSEATS	K AH N T R IY S IY T S
COUTEAU	K OW Y UW T IY UW
COUTEAUX	K OW Y UW T IY AH K S
COWPEA	K AW P IY
COWPEAS	K AW P IY Z
CRABMEAT	K R AE B M IY T
CRABMEATS	K R AE B M IY T S
CREAK	K R IY K
CREAKED	K R IY K T
CREAKIER	K R IY K IY ER
CREAKIEST	K R IY K IY AH S T
CREAKILY	K R IY K IY L IY
CREAKINESS	K R IY K IY N AH S
CREAKINESSES	K R IY K IY N AH S IH Z
CREAKING	K R IY K IH NG
CREAKS	K R IY K S
CREAKY	K R IY K IY
CREAM	K R IY M
CREAMCUPS	K R IY M K AH P S
CREAMED	K R IY M D
CREAMER	K R IY M ER
CREAMERIES	K R IY M AH R IY Z
CREAMERS	K R IY M ER Z
CREAMERY	K R IY M ER IY
CREAMIER	K R IY M IY ER
CREAMIEST	K R IY M IY IH S T
CREAMILY	K R IY M IY L IY
CREAMINESS	K R IY M IY N AH S
CREAMINESSES	K R IY M IY N AH S IH Z
CREAMING	K R IY M IH NG
CREAMPUFF	K R IY M P AH F
CREAMPUFFS	K R IY M P AH F S
CREAMS	K R IY M Z
CREAMWARE	K R IY M W EH R
CREAMWARES	K R IY M W EH R Z
CREAMY	K R IY M IY
CREASE	K R IY S
CREASED	K R IY S T
CREASELESS	K R IY S L AH S
CREASER	K R IY S ER
CREASERS	K R IY S ER Z
CREASES	K R IY S IH Z
CREASIER	K R IY S IY ER
CREASIEST	K R IY S IY AH S T
CREASING	K R IY S IH NG
CREASY	K R IY S IY
CREATE	K R IY EY T
CREATED	K R IY EY T AH D
CREATED(2)	K R IY EY T IH D
CREATES	K R IY EY T S
CREATIN	K R IY T AH N
CREATINE	K R IY T AY N
CREATINES	K R IY T AY N Z
CREATING	K R IY EY T IH NG
CREATININE	K R IY T AH N AY N
CREATININES	K R IY T AH N AY N Z
CREATINS	K R IY T AH N Z
CREATION	K R IY EY SH AH N
CREATIONISM	K R IY EY SH AH N IH Z AH M
CREATIONISMS	K R IY EY SH AH N IH Z AH M Z
CREATIONIST	K R IY EY SH AH N IH S T
CREATIONISTS	K R IY EY SH AH N IH S T S
CREATIONS	K R IY EY SH AH N Z
CREATIVE	K R IY EY T IH V
CREATIVELY	K R IY EY T IH V L IY
CREATIVENESS	K R IY EY T IH V N AH S
CREATIVENESSES	K R IY EY T IH V N AH S IH Z
CREATIVITIES	K R IY EY T IH V AH T IY Z
CREATIVITY	K R IY EY T IH V AH T IY
CREATOR	K R IY EY T ER
CREATORS	K R IY EY T ER Z
CREATURAL	K R IY CH ER AH L
CREATURE	K R IY CH ER
CREATUREHOOD	K R IY CH ER HH UH D
CREATUREHOODS	K R IY CH ER HH UH D Z
CREATURELINESS	K R IY CH ER L IY N AH S
CREATURELINESSES	K R IY CH ER L IY N AH S IH Z
CREATURELY	K R IY CH ER L IY
CREATURES	K R IY CH ER Z
CRISPBREAD	K R IH S P B R EH D
CRISPBREADS	K R IH S P B R EH D Z
CROSSBEAM	K R AO S B IY M
CROSSBEAMS	K R AO S B IY M Z
CROSSBEARER	K R AO S B AE ER ER
CROSSBEARERS	K R AO S B AE ER ER Z
CROSSHEAD	K R AO S HH EH D
CROSSHEADS	K R AO S HH EH D Z
CRUSTACEA	K R AH S T EY S IY AH
CRUSTACEAN	K R AH S T EY SH AH N
CRUSTACEANS	K R AH S T EY SH AH N Z
CUDBEAR	K AH D B AE ER
CUDBEARS	K AH D B AE ER Z
CUNEAL	K Y UW N IY AH L
CUNEATE	K Y UW N IY EY T
CUNEATED	K Y UW N IY EY T AH D
CUNEATIC	K Y UW N IY AH T AH K
CUPBEARER	K AH P B AE ER ER
CUPBEARERS	K AH P B AE ER ER Z
CURVILINEAR	K AH R V AH L AY N IY AH R
CURVILINEARITIES	K AH R V AH L AH N IY R AH T AY Z
CURVILINEARITY	K AH R V IH L AH N IY R AH T IY
CYCLOPEAN	S AY K L AH P IY AH N
CYSTEAMINE	S IH S T AH M AY N
CYSTEAMINES	S IH S T AH M AY N Z
DAHABEAH	D AH HH EY B IY AH
DAHABEAHS	D AE HH AH B IY Z
DAMAGEABILITIES	D AE M IH JH AH B IH L AH T EH Z
DAMAGEABILITY	D AE M IH JH AH B IH L AH T EH
DANCEABLE	D AE N S AH B AH L
DATEABLE	D EY T AH B AH L
DAYBREAK	D EY B R EY K
DAYBREAKS	D EY B R EY K S
DAYDREAM	D EY D R IY M
DAYDREAMED	D EY D R IY M D
DAYDREAMER	D EY D R IY M ER
DAYDREAMERS	D EY D R IY M ER Z
DAYDREAMING	D EY D R IY M IH NG
DAYDREAMLIKE	D EY D R IY M L AY K
DAYDREAMS	D EY D R IY M Z
DAYDREAMT	D EY D R EH M T
DEACIDIFICATION	D IY AE S AH D AH F AH K EY SH AH N
DEACIDIFICATIONS	D IY AE S AH D AH F AH K EY SH AH N Z
DEACIDIFIED	D IY AE S AH D AH F AY D
DEACIDIFIES	D IY AE S AH D AH F AY Z
DEACIDIFY	D IY AE S AH D AH F AY
DEACIDIFYING	D IY AE S AH D AH F AY IH NG
DEACON	D IY K AH N
DEACONED	D IY K AH N D
DEACONESS	D IY K AH N AH S
DEACONESSES	D IY K AH N AH S IH Z
DEACONING	D IY K AH N IH NG
DEACONRIES	D IY K AH N R IY Z
DEACONRY	D IY K AH N R IY
DEACONS	D IY K AH N Z
DEACTIVATE	D IY AE K T IH V EY T
DEACTIVATED	D IY AE K T IH V EY T IH D
DEACTIVATES	D IY AE K T IH V AH T S
DEACTIVATING	D IY AE K T IH V EY T IH NG
DEACTIVATION	D IY AE K T IH V EY SH AH N
DEACTIVATIONS	D IY AE K T IH V EY SH AH N Z
DEACTIVATOR	D IY AE K T IH V AH T ER
DEACTIVATORS	D IY AE K T IH V AH T ER Z
DEAD	D EH D
DEADBEAT	D EH D B IY T
DEADBEATS	D EH D B IY T S
DEADBOLT	D EH D B OW L T
DEADBOLTS	D EH D B OW L T S
DEADEN	D EH D AH N
DEADENED	D EH D AH N D
DEADENER	D EH D AH N ER
DEADENERS	D EH D AH N ER Z
DEADENING	D EH D AH N IH NG
DEADENING(2)	D EH D N IH NG
DEADENINGLY	D EH D AH N IH NG L IY
DEADENINGS	D EH D AH N IH NG Z
DEADENS	D EH D AH N Z
DEADER	D EH D ER
DEADEST	D EH D AH S T
DEADEYE	D EH D AY
DEADEYES	D EH D AY Z
DEADFALL	D EH D F AO L
DEADFALLS	D EH D F AO L Z
DEADHEAD	D EH D HH EH D
DEADHEADED	D EH D HH EH D IH D
DEADHEADING	D EH D HH EH D IH NG
DEADHEADS	D EH D HH EH D Z
DEADLIER	D EH D L IY ER
DEADLIEST	D EH D L IY AH S T
DEADLIFT	D EH D L IH F T
DEADLIFTED	D EH D L IH F T IH D
DEADLIFTING	D EH D L IH F T IH NG
DEADLIFTS	D EH D L IH F T S
DEADLIGHT	D EH D L AY T
DEADLIGHTS	D EH D L AY T S
DEADLINE	D EH D L AY N
DEADLINES	D EH D L AY N Z
DEADLINESS	D EH D L IY N AH S
DEADLINESSES	D EH D L IY N AH S IH Z
DEADLOCK	D EH D L AA K
DEADLOCKED	D EH D L AA K T
DEADLOCKING	D EH D L AA K IH NG
DEADLOCKS	D EH D L AA K S
DEADLY	D EH D L IY
DEADNESS	D EH D N AH S
DEADNESSES	D EH D N AH S IH Z
DEADPAN	D EH D P AE N
DEADPANNED	D EH D P AE N D
DEADPANNER	D EH D P AE N ER
DEADPANNERS	D EH D P AE N ER Z
DEADPANNING	D EH D P AE N IH NG
DEADPANS	D EH D P AE N Z
DEADS	D EH D Z
DEADWEIGHT	D EH D W EY T
DEADWEIGHTS	D EH D W EY T S
DEADWOOD	D EH D W UH D
DEADWOODS	D EH D W UH D Z
DEAERATE	D IY AE ER AH T
DEAERATED	D IY AE ER EY T IH D
DEAERATES	D IY AE ER AH T S
DEAERATING	D IY AE ER EY T IH NG
DEAERATION	D IY AE ER EY SH AH N
DEAERATIONS	D IY AE ER EY SH AH N Z
DEAERATOR	D IY AE ER AH T ER
DEAERATORS	D IY AE ER AH T ER Z
DEAF	D EH F
DEAFEN	D EH F AH N
DEAFENED	D EH F AH N D
DEAFENING	D EH F AH N IH NG
DEAFENING(2)	D EH F N IH NG
DEAFENINGLY	D EH F AH N IH NG L IY
DEAFENS	D EH F AH N Z
DEAFER	D EH F ER
DEAFEST	D EH F AH S T
DEAFISH	D EH F IH SH
DEAFLY	D EH F L IY
DEAFNESS	D EH F N AH S
DEAFNESSES	D EH F N AH S IH Z
DEAIR	D IY EH R
DEAIRED	D IY EH R D
DEAIRING	D IY EH R IH NG
DEAIRS	D IY EH R Z
DEAL	D IY L
DEALATE	D IY L AH T
DEALATED	D IY L EY T IH D
DEALATES	D IY L AH T S
DEALATION	D IY L EY SH AH N
DEALATIONS	D IY L EY SH AH N Z
DEALER	D IY L ER
DEALERS	D IY L ER Z
DEALERSHIP	D IY L ER SH IH P
DEALERSHIPS	D IY L ER SH IH P S
DEALFISH	D IY L F IH SH
DEALFISHES	D IY L F IH SH IH Z
DEALING	D IY L IH NG
DEALINGS	D IY L IH NG Z
DEALS	D IY L Z
DEALT	D EH L T
DEAMINASE	D IY AE M AH N EY Z
DEAMINASES	D IY AE M AH N EY Z AH Z
DEAMINATE	D IY AH M AY N AH T
DEAMINATED	D IY AH M AY N EY T IH D
DEAMINATES	D IY AH M AY N AH T S
DEAMINATING	D IY AH M AY N EY T IH NG
DEAMINATION	D IY AH M AY N EY SH AH N
DEAMINATIONS	D IY AH M AY N EY SH AH N Z
DEAN	D IY N
DEANED	D IY N D
DEANERIES	D IY N AH R IY Z
DEANERY	D IY N AH R IY
DEANING	D IY N IH NG
DEANS	D IY N Z
DEANSHIP	D IY N SH IH P
DEANSHIPS	D IY N SH IH P S
DEAR	D IH R
DEARER	D IH R ER
DEAREST	D IH R AH S T
DEARIE	D IH ER IY
DEARIES	D IH ER IY Z
DEARLY	D IH R L IY
DEARNESS	D IH ER N AH S
DEARNESSES	D IH ER N AH S IH Z
DEARS	D IH ER Z
DEARTH	D ER TH
DEARTHS	D ER TH S
DEARY	D IH R IY
DEASH	D IY AE SH
DEASHED	D IY AH SH EH D
DEASHES	D IY AE SH IH Z
DEASHING	D IY AE SH IH NG
DEASIL	D IY AE S AH L
DEATH	D EH TH
DEATHBED	D EH TH B EH D
DEATHBEDS	D EH TH B EH D Z
DEATHBLOW	D EH TH B L OW
DEATHBLOWS	D EH TH B L OW Z
DEATHCUP	D EH TH K AH P
DEATHCUPS	D EH TH K AH P S
DEATHFUL	D EH TH F AH L
DEATHLESS	D EH TH L AH S
DEATHLESSLY	D EH TH L AH S L IY
DEATHLESSNESS	D EH TH L AH S N AH S
DEATHLESSNESSES	D EH TH L AH S N AH S IH Z
DEATHLIKE	D EH TH L AY K
DEATHLY	D EH TH L IY
DEATHS	D EH TH S
DEATHSMAN	D EH TH S M AE N
DEATHSMEN	D EH TH S M EH N
DEATHTRAP	D EH TH T R AE P
DEATHTRAPS	D EH TH T R AE P S
DEATHWATCH	D EH TH W AA CH
DEATHWATCHES	D EH TH W AA CH IH Z
DEATHY	D EH TH IY
DEAVE	D IY EY V
DEAVED	D IY EY V D
DEAVES	D IY EY V Z
DEAVING	D IY EY V AH NG
DEBEAK	D IH B AH AE K
DEBEAKED	D IH B AH EY K T
DEBEAKING	D IY B IH AH K IH NG
DEBEAKS	D IH B AH AE K S
DECEASE	D IH S IY S
DECEASED	D IH S IY S T
DECEASES	D IY S IY S IH Z
DECEASING	D IY S IY S IH NG
DECREASE	D IH K R IY S
DECREASE(2)	D IY K R IY S
DECREASED	D IH K R IY S T
DECREASED(2)	D IY K R IY S T
DECREASES	D IH K R IY S AH Z
DECREASES(2)	D IH K R IY S IH Z
DECREASES(3)	D IY K R IY S IH Z
DECREASING	D IH K R IY S IH NG
DECREASING(2)	D IY K R IY S IH NG
DECREASINGLY	D IH K R IY S IH NG L IY
DEFEASANCE	D IH F IY Z AH N S
DEFEASANCES	D IY F IY Z AH N S IH Z
DEFEASIBILITIES	D IY F IY Z AH B IH L AH T IY Z
DEFEASIBILITY	D IY F IY Z AH B IH L AH T IY
DEFEASIBLE	D IY F IY Z AH B AH L
DEFEAT	D IH F IY T
DEFEATED	D IH F IY T AH D
DEFEATED(2)	D IH F IY T IH D
DEFEATER	D IH F IY T ER
DEFEATERS	D IH F IY T ER Z
DEFEATING	D IH F IY T IH NG
DEFEATISM	D IH F IY T IH Z AH M
DEFEATISMS	D IH F IY T IH Z AH M Z
DEFEATIST	D IH F IY T IH S T
DEFEATISTS	D IH F IY T IH S T S
DEFEATS	D IH F IY T S
DEFEATURE	D IH F IY CH ER
DEFEATURES	D IH F IY CH ER Z
DEFLEA	D IY F L IY
DEFLEAED	D IY F L IY D
DEFLEAING	D IY F L IY IH NG
DEFLEAS	D IY F L IY Z
DEGREASE	D IY G R IY S
DEGREASED	D IY G R IY S T
DEGREASER	D IY G R IY S ER
DEGREASERS	D IY G R IY S ER Z
DEGREASES	D IY G R IY S IH Z
DEGREASING	D IY G R IY S IH NG
DELEAD	D IY L IY D
DELEADED	D IY L EH D AH D
DELEADING	D IY L IY D IH NG
DELEADS	D IY L IY D Z
DELEAVE	D IY L IY V
DELEAVED	D IY L IY V D
DELEAVES	D IY L IY V Z
DELEAVING	D IY L IY V IH NG
DELINEATE	D IH L IH N IY EY T
DELINEATED	D IH L IH N IY EY T IH D
DELINEATES	D IH L IH N IY EY T S
DELINEATING	D IH L IH N IY EY T IH NG
DELINEATION	D IH L IH N IY EY SH AH N
DELINEATIONS	D IY L IH N IY EY SH AH N Z
DELINEATIVE	D IH L IH N IY EY T IH V
DELINEATOR	D IH L IH N IY EY T ER
DELINEATORS	D IH L IH N IY EY T ER Z
DEMEAN	D IH M IY N
DEMEANED	D IH M IY N D
DEMEANING	D IH M IY N IH NG
DEMEANOR	D IH M IY N ER
DEMEANORS	D IH M IY N ER Z
DEMEANOUR	D AH M IY N AH R
DEMEANOURS	D AH M AH N OW Y AH R Z
DEMEANS	D IH M IY N Z
DENUCLEARIZATION	D IY N UW K L IY ER AH Z EY SH AH N
DENUCLEARIZATIONS	D IY N UW K L IY ER AH Z EY SH AH N Z
DENUCLEARIZE	D IY N UW K L IY ER AY Z
DENUCLEARIZED	D IH N UW K L IY ER AY Z D
DENUCLEARIZED(2)	D IY N UW K L IY ER AY Z D
DENUCLEARIZES	D IY N UW K L IY ER AY Z IH Z
DENUCLEARIZING	D IY N UW K L IY ER AY Z IH NG
DEOXYRIBONUCLEASE	D IY AH K S AH R AH B AA N AH K L IY Z
DEOXYRIBONUCLEASES	D IY AH K S AH R AH B AA N AH K L IY Z AH Z
DEREALIZATION	D IY R IY L AH Z EY SH AH N
DEREALIZATIONS	D IY R IY L AH Z EY SH AH N Z
DIAGNOSEABLE	D AY IH G N OW S AH B AH L
DIAPHYSEAL	D AY AH F IH Z IY AH L
DIARRHEA	D AY ER IY AH
DIARRHEAL	D AY AE R IY AH L
DIARRHEAS	D AY ER IY AH Z
DIARRHOEA	D AY ER IY AH
DIARRHOEAS	D AY AH R IY AH Z
DISAGREEABLE	D IH S AH G R IY AH B AH L
DISAGREEABLENESS	D IH S AH G R IY AH B AH L N AH S
DISAGREEABLENESSES	D IH S AH G R IY AH B AH L N AH S IH Z
DISAGREEABLY	D IH S AH G R IY AH B L IY
DISAPPEAR	D IH S AH P IH R
DISAPPEAR(2)	D IH S AH P IY R
DISAPPEARANCE	D IH S AH P IH R AH N S
DISAPPEARANCE(2)	D IH S AH P IY R AH N S
DISAPPEARANCES	D IH S AH P IH R AH N S IH Z
DISAPPEARANCES(2)	D IH S AH P IY R AH N S IH Z
DISAPPEARED	D IH S AH P IH R D
DISAPPEARED(2)	D IH S AH P IY R D
DISAPPEARING	D IH S AH P IH R IH NG
DISAPPEARING(2)	D IH S AH P IY R IH NG
DISAPPEARS	D IH S AH P IH R Z
DISAPPEARS(2)	D IH S AH P IY R Z
DISCHARGEABLE	D IH S CH AA R JH AH B AH L
DISCOURAGEABLE	D IH S K ER IH JH AH B AH L
DISEASE	D IH Z IY Z
DISEASED	D IH Z IY Z D
DISEASES	D IH Z IY Z AH Z
DISEASES(2)	D IH Z IY Z IH Z
DISEASING	D IH Z IY Z IH NG
DISHEARTEN	D IH S HH AA R T AH N
DISHEARTENED	D IH S HH AA R T AH N D
DISHEARTENING	D IH S HH AA R T AH N IH NG
DISHEARTENING(2)	D IH S HH AA R T N IH NG
DISHEARTENINGLY	D IH S HH AA R T AH N IH NG L IY
DISHEARTENMENT	D IH S HH AA R T AH N M AH N T
DISHEARTENMENTS	D IH S HH AA R T AH N M AH N T S
DISHEARTENS	D IH S HH AA R T AH N Z
DISLIKEABLE	D IH S L AY K AH B AH L
DISPLACEABLE	D IH S P L EY S AH B AH L
DISPLEASE	D IH S P L IY Z
DISPLEASED	D IH S P L IY Z D
DISPLEASES	D IH S P L IY Z IH Z
DISPLEASING	D IH S P L IY Z IH NG
DISPLEASURE	D IH S P L EH ZH ER
DISPLEASURES	D IH S P L EH ZH ER Z
DISPREAD	D IH S R IY AE D
DISPREADING	D IH S R IY EY D AH NG
DISPREADS	D IH S R IY AE D Z
DISSEAT	D IH S IY T
DISSEATED	D IH S IY T IH D
DISSEATING	D IH S IY T IH NG
DISSEATS	D IH S IY T S
DISSERVICEABLE	D IH S ER V AH S AH B AH L
DOGEAR	D AA G IY R
DOGEARED	D AA G IY R D
DOGEARING	D AA G IY R IH NG
DOGEARS	D AA G IY R Z
DOPEHEAD	D OW P HH EH D
DOPEHEADS	D OW P HH EH D Z
DOUBLEHEADER	D AH B AH L HH EH D ER
DOUBLEHEADERS	D AH B AH L HH EH D ER Z
DOUBLESPEAK	D AH B AH L S P IY K
DOUBLESPEAKER	D AH B AH L S P IY K ER
DOUBLESPEAKERS	D AH B AH L S P IY K ER Z
DOUBLESPEAKS	D AH B AH L S P IY K S
DOWNBEAT	D AW N B IY T
DOWNBEATS	D AW N B IY T S
DOWNHEARTED	D AW N HH AA R T IH D
DOWNHEARTEDLY	D AW N HH AA R T AH D L IY
DOWNHEARTEDNESS	D AW N HH AA R T AH D N AH S
DOWNHEARTEDNESSES	D AW N HH AA R T AH D N AH S IH Z
DOWNSTREAM	D AW N S T R IY M
DRAGONHEAD	D R AE G AH N HH EH D
DRAGONHEADS	D R AE G AH N HH EH D Z
DRAPEABILITIES	D R EY P AH B IH L AH T EH Z
DRAPEABILITY	D R EY P AH B IH L AH T EH
DRAPEABLE	D R EY P AH B AH L
DREAD	D R EH D
DREADED	D R EH D IH D
DREADFUL	D R EH D F AH L
DREADFULLY	D R EH D F AH L IY
DREADFULNESS	D R EH D F AH L N AH S
DREADFULNESSES	D R EH D F AH L N AH S IH Z
DREADFULS	D R EH D F AH L Z
DREADING	D R EH D IH NG
DREADLOCK	D R EH D L AA K
DREADLOCKS	D R EH D L AA K S
DREADNOUGHT	D R EH D N AO T
DREADNOUGHTS	D R EH D N AO T S
DREADS	D R EH D Z
DREAM	D R IY M
DREAMED	D R IY M D
DREAMER	D R IY M ER
DREAMERS	D R IY M ER Z
DREAMFUL	D R IY M F AH L
DREAMFULLY	D R IY M F AH L IY
DREAMFULNESS	D R IY M F AH L N AH S
DREAMFULNESSES	D R IY M F AH L N AH S IH Z
DREAMIER	D R IY M IY ER
DREAMIEST	D R IY M IY AH S T
DREAMILY	D R IY M IY L IY
DREAMINESS	D R IY M IY N AH S
DREAMINESSES	D R IY M IY N AH S IH Z
DREAMING	D R IY M IH NG
DREAMLAND	D R IY M L AE N D
DREAMLANDS	D R IY M L AE N D Z
DREAMLESS	D R IY M L AH S
DREAMLESSLY	D R IY M L AH S L IY
DREAMLESSNESS	D R IY M L AH S N AH S
DREAMLESSNESSES	D R IY M L AH S N AH S IH Z
DREAMLIKE	D R IY M L AY K
DREAMS	D R IY M Z
DREAMT	D R EH M T
DREAMTIME	D R IY M T AY M
DREAMTIMES	D R IY M T AY M Z
DREAMWORLD	D R IY M W ER L D
DREAMWORLDS	D R IY M W ER L D Z
DREAMY	D R IY M IY
DREAR	D R IH ER
DREARIER	D R IH ER IY ER
DREARIES	D R IH ER IY Z
DREARIEST	D R IH ER IY AH S T
DREARILY	D R IH ER IY L IY
DREARINESS	D R IY R IY N AH S
DREARINESSES	D R IH ER IY N AH S IH Z
DREARS	D R IH ER Z
DREARY	D R IH R IY
DRIVEABILITIES	D R AY V AH B IH L AH T EH Z
DRIVEABILITY	D R AY V AH B IH L AH T EH
DRIVEABLE	D R AY V AH B AH L
DROPHEAD	D R AA P HH EH D
DROPHEADS	D R AA P HH EH D Z
DRUMBEAT	D R AH M B IY T
DRUMBEATER	D R AH M B IY T ER
DRUMBEATERS	D R AH M B IY T ER Z
DRUMBEATING	D R AH M B IY T IH NG
DRUMBEATINGS	D R AH M B IY T IH NG Z
DRUMBEATS	D R AH M B IY T S
DRUMHEAD	D R AH M HH EH D
DRUMHEADS	D R AH M HH EH D Z
DULCINEA	D AH L S IH N IY AH
DULCINEAS	D AH L S AH N IY Z
DUMBHEAD	D AH M HH EH D
DUMBHEADS	D AH M HH EH D Z
DUNDERHEAD	D AH N D AH R IY D
DUNDERHEADED	D AH N D AH R IY D AH D
DUNDERHEADS	D AH N D AH R IY D Z
DUNDREARIES	D AH N D R IH ER IY Z
DUSTHEAP	D AH S T HH IY P
DUSTHEAPS	D AH S T HH IY P S
DYEABILITIES	D AY AH B IH L AH T EH Z
DYEABILITY	D AY AH B IH L AH T EH
DYEABLE	D AY AH B AH L
DYSMENORRHEA	D IH Z M AH N AO R IY AH
DYSMENORRHEAS	D IH Z M AH N AO R IY Z
DYSPNEA	D IH S P N IY AH
DYSPNEAL	D IH S N IY AH L
DYSPNEAS	D IH S N IY Z
DYSPNOEA	D IH S N OW AH AH
DYSPNOEAS	D IH S N OW AH AH Z
EACH	IY CH
EAGER	IY G ER
EAGERER	IY G ER ER
EAGEREST	IY G ER AH S T
EAGERLY	IY G ER L IY
EAGERNESS	IY G ER N AH S
EAGERNESSES	IY G ER N AH S IH Z
EAGERS	IY G ER Z
EAGLE	IY G AH L
EAGLES	IY G AH L Z
EAGLET	IY IH JH L AH T
EAGLETS	IY G L AH T S
EAGRE	IY G AH R
EAGRES	IY G AH R Z
EALDORMAN	EH L D AO R M AH N
EALDORMEN	EH L D AO R M AH N
EANLING	IY N L AH NG
EANLINGS	IY N L AH NG Z
EAR	IY R
EAR(2)	IH R
EARACHE	IH ER EY K
EARACHES	IH ER EY K S
EARDROP	IH ER D R AA P
EARDROPS	IH ER D R AA P S
EARDRUM	IH ER D R AH M
EARDRUMS	IH ER D R AH M Z
EARED	IH R D
EARFLAP	IH ER F L AE P
EARFLAPS	IH ER F L AE P S
EARFUL	IY R F AH L
EARFULS	IH ER F AH L Z
EARING	IH ER IH NG
EARINGS	IH ER IH NG Z
EARL	ER L
EARLAP	IH ER L AE P
EARLAPS	IH ER L AE P S
EARLDOM	ER L D AH M
EARLDOMS	ER L D AH M Z
EARLESS	IH R L AH S
EARLESS(2)	IY R L AH S
EARLIER	ER L IY ER
EARLIEST	ER L IY AH S T
EARLINESS	ER L IY N AH S
EARLINESSES	ER L IY N AH S IH Z
EARLOBE	IH ER L OW B
EARLOBES	IH ER L OW B Z
EARLOCK	IH ER L AA K
EARLOCKS	IH ER L AA K S
EARLS	ER L Z
EARLSHIP	ER L SH IH P
EARLSHIPS	ER L SH IH P S
EARLY	ER L IY
EARLYWOOD	ER L IY W UH D
EARLYWOODS	ER L IY W UH D Z
EARMARK	IH R M AA R K
EARMARK(2)	IY R M AA R K
EARMARKED	IH R M AA R K T
EARMARKED(2)	IY R M AA R K T
EARMARKING	IH R M AA R K IH NG
EARMARKING(2)	IY R M AA R K IH NG
EARMARKS	IH R M AA R K S
EARMARKS(2)	IY R M AA R K S
EARMUFF	IH R M AH F
EARMUFF(2)	IY R M AH F
EARMUFFS	IH R M AH F S
EARMUFFS(2)	IY R M AH F S
EARN	ER N
EARNED	ER N D
EARNER	ER N ER
EARNERS	ER N ER Z
EARNEST	ER N IH S T
EARNESTLY	ER N AH S T L IY
EARNESTNESS	ER N AH S T N AH S
EARNESTNESSES	ER N AH S T N AH S IH Z
EARNESTS	ER N AH S T S
EARNING	ER N IH NG
EARNINGS	ER N IH NG Z
EARNS	ER N Z
EARPHONE	IH R F OW N
EARPHONE(2)	IY R F OW N
EARPHONES	IH R F OW N Z
EARPHONES(2)	IY R F OW N Z
EARPIECE	IH R P IY S
EARPIECE(2)	IY R P IY S
EARPIECES	IH R P IY S IH Z
EARPIECES(2)	IY R P IY S IH Z
EARPLUG	IH R P L AH G
EARPLUG(2)	IY R P L AH G
EARPLUGS	IH R P L AH G Z
EARPLUGS(2)	IY R P L AH G Z
EARRING	IH R IH NG
EARRING(2)	IY R IH NG
EARRINGS	IH R IH NG Z
EARRINGS(2)	IY R IH NG Z
EARS	IH R Z
EARS(2)	IY R Z
EARSHOT	IH R SH AA T
EARSHOT(2)	IY R SH AA T
EARSHOTS	IH ER SH AA T S
EARSPLITTING	IH ER S P L IH T IH NG
EARSTONE	IH ER S T OW N
EARSTONES	IH ER S T OW N Z
EARTH	ER TH
EARTHBORN	ER TH B AO R N
EARTHBOUND	ER TH B AW N D
EARTHED	ER TH T
EARTHEN	ER TH AH N
EARTHENWARE	ER TH AH N W EH R
EARTHENWARES	ER TH AH N W EH R Z
EARTHIER	ER TH IY ER
EARTHIEST	ER TH IY AH S T
EARTHILY	ER TH IY L IY
EARTHINESS	ER TH IY N AH S
EARTHINESSES	ER TH IY N AH S IH Z
EARTHING	ER TH IH NG
EARTHLIER	ER TH L IY ER
EARTHLIEST	ER TH L IY AH S T
EARTHLIGHT	ER TH L AY T
EARTHLIGHTS	ER TH L AY T S
EARTHLIKE	ER TH L AY K
EARTHLINESS	ER TH L IY N AH S
EARTHLINESSES	ER TH L IY N AH S IH Z
EARTHLING	ER TH L IH NG
EARTHLINGS	ER TH L IH NG Z
EARTHLY	ER TH L IY
EARTHMAN	ER TH M AE N
EARTHMEN	ER TH M EH N
EARTHMOVER	ER TH M UW V ER
EARTHMOVERS	ER TH M UW V ER Z
EARTHMOVING	ER TH M UW V IH NG
EARTHMOVINGS	ER TH M UW V IH NG Z
EARTHNUT	ER TH N AH T
EARTHNUTS	ER TH N AH T S
EARTHPEA	ER TH P IY
EARTHPEAS	ER TH P IY Z
EARTHQUAKE	ER TH K W EY K
EARTHQUAKES	ER TH K W EY K S
EARTHRISE	ER TH R AY Z
EARTHRISES	ER TH R IY Z IH Z
EARTHS	ER TH S
EARTHSET	ER TH S EH T
EARTHSETS	ER TH S EH T S
EARTHSHAKER	ER TH SH EY K ER
EARTHSHAKERS	ER TH SH EY K ER Z
EARTHSHAKING	ER TH SH EY K IH NG
EARTHSHAKINGLY	ER TH SH EY K IH NG L IY
EARTHSHINE	ER TH SH AY N
EARTHSHINES	ER TH SH AY N Z
EARTHSTAR	ER TH S T AA R
EARTHSTARS	ER TH S T AA R Z
EARTHWARD	ER TH W ER D
EARTHWARDS	ER TH W ER D Z
EARTHWORK	ER TH W ER K
EARTHWORKS	ER TH W ER K S
EARTHWORM	ER TH W ER M
EARTHWORMS	ER TH W ER M Z
EARTHY	ER TH IY
EARWAX	IH R W AE K S
EARWAX(2)	IY R W AE K S
EARWAXES	IH ER W AE K S IH Z
EARWIG	IH ER W IH G
EARWIGGED	IH ER W IH G D
EARWIGGING	IH ER W IH G IH NG
EARWIGS	IH ER W IH G Z
EARWITNESS	IH ER W IH T N AH S
EARWITNESSES	IH ER W IH T N AH S IH Z
EARWORM	IH ER W ER M
EARWORMS	IH ER W ER M Z
EASE	IY Z
EASED	IY Z D
EASEFUL	IY Z F AH L
EASEFULLY	IY Z F AH L IY
EASEL	IY Z AH L
EASELS	IY Z AH L Z
EASEMENT	IY Z M AH N T
EASEMENTS	IY Z M AH N T S
EASES	IY Z IH Z
EASIER	IY Z IY ER
EASIES	IY Z IY Z
EASIEST	IY Z IY AH S T
EASILY	IY Z AH L IY
EASINESS	IY Z IY N AH S
EASINESSES	IY Z IY N AH S IH Z
EASING	IY Z IH NG
EAST	IY S T
EASTBOUND	IY S T B AW N D
EASTER	IY S T ER
EASTERLIES	IY S T ER L IY Z
EASTERLY	IY S T ER L IY
EASTERN	IY S T ER N
EASTERNER	IY S T ER N ER
EASTERNERS	IY S T ER N ER Z
EASTERNMOST	IY S T ER N M OW S T
EASTERS	IY S T ER Z
EASTING	IY S T IH NG
EASTINGS	IY S T IH NG Z
EASTS	IY S T S
EASTWARD	IY S T W ER D
EASTWARDS	IY S T W ER D Z
EASY	IY Z IY
EASYGOING	IY Z IY G OW IH NG
EASYGOINGNESS	IY Z IY G OW IH NG N AH S
EASYGOINGNESSES	IY Z IY G OW IH NG N AH S IH Z
EAT	IY T
EATABLE	IY T AH B AH L
EATABLES	IY T AH B AH L Z
EATEN	IY T AH N
EATER	IY T ER
EATERIES	IY T ER IY Z
EATERS	IY T ER Z
EATERY	IY T ER IY
EATH	IY TH
EATING	IY T IH NG
EATINGS	IY T IH NG Z
EATS	IY T S
EAU	OW
EAUX	OW
EAUX(2)	OW Z
EAVE	IY V
EAVED	IY V D
EAVES	IY V Z
EAVESDROP	IY V Z D R AA P
EAVESDROPPED	IY V EH Z D R AH P T
EAVESDROPPER	IY V EH Z D R AA P AH R
EAVESDROPPERS	IY V AH Z D R AA P AH R Z
EAVESDROPPING	IY V Z D R AA P IH NG
EAVESDROPS	IY V EH Z D R AH P S
ECHINACEA	EH CH AH N EY S IY AH
ECHINACEAS	EH CH AH N AH S IY Z
ECOFREAK	EH K AH F R IY K
ECOFREAKS	EH K AH F R IY K S
EFFACEABLE	IH F EY S AH B AH L
EGGBEATER	EH G B IY T ER
EGGBEATERS	EH G B IY T ER Z
EGGHEAD	EH G HH EH D
EGGHEADED	EH G HH EH D IH D
EGGHEADEDNESS	EH G HH EH D AH D N AH S
EGGHEADEDNESSES	EH G HH EH D AH D N AH S IH Z
EGGHEADS	EH G HH EH D Z
ELECTROWEAK	AH L EH K T R OW IY K
ELODEA	AH L OW D IY AH
ELODEAS	EH L AH D IY Z
EMBRACEABLE	IH M B R EY S AH B AH L
EMPYREAL	IH M P AY ER AH L
EMPYREAN	IH M P AY R IY AH N
EMPYREANS	IH M P AH R IY N Z
ENDEAR	EH N D IY R
ENDEARED	EH N D IY R D
ENDEARING	EH N D IY R IH NG
ENDEARINGLY	EH N D IH ER IH NG L IY
ENDEARMENT	IH N D IH R M AH N T
ENDEARMENTS	EH N D IH ER M AH N T S
ENDEARS	EH N D IH ER Z
ENDEAVOR	IH N D EH V ER
ENDEAVORED	IH N D EH V ER D
ENDEAVORING	IH N D EH V ER IH NG
ENDEAVORING(2)	IH N D EH V R IH NG
ENDEAVORS	IH N D EH V ER Z
ENDEAVOUR	IH N D EH V ER
ENDEAVOURED	IH N D IY AH V OW Y AH R D
ENDEAVOURING	IH N D IY AH V OW Y AH R AH NG
ENDEAVOURS	IH N D IY AH V OW Y AH R Z
ENDLEAF	EH N D L IY F
ENDLEAVES	EH N D L IY V Z
ENDONUCLEASE	IH N D AA N AH K L IY Z
ENDONUCLEASES	IH N D AA N AH K L IY Z AH Z
ENDOSTEA	EH N D AA S T IY
ENDOSTEAL	EH N D UW S T IY L
ENDOSTEALLY	EH N D UW S T IY L IY
ENDOTRACHEAL	IH N D AA T R AE CH IY AH L
ENFORCEABILITIES	EH N F OW R S AH B IH L AH T EH Z
ENFORCEABILITY	EH N F AO R S AH B IH L IH T IY
ENFORCEABLE	EH N F AO R S AH B AH L
ENLARGEABLE	EH N L AA R JH AH B AH L
ENNEAD	IH N IY D
ENNEADIC	IH N IY D AH K
ENNEADS	IH N IY D Z
ENNEAGON	IH N IY G AH N
ENNEAGONS	IH N IY G AH N Z
ENSHEATH	EH N SH IY TH
ENSHEATHE	EH N SH IY DH
ENSHEATHED	EH N SH IY DH D
ENSHEATHES	EH N SH IY DH Z
ENSHEATHING	EH N SH IY DH IH NG
ENSHEATHS	EH N SH IY TH S
ENTREAT	EH N T R IY T
ENTREATED	EH N T R IY T IH D
ENTREATIES	EH N T R IY T IY Z
ENTREATING	EH N T R IY T IH NG
ENTREATINGLY	EH N T R IY T IH NG L IY
ENTREATMENT	EH N T R IY T M AH N T
ENTREATMENTS	EH N T R IY T M AH N T S
ENTREATS	EH N T R IY T S
ENTREATY	EH N T R IY T IY
ENUCLEATE	AH N AH K L IY EY T
ENUCLEATED	AH N AH K L IY EY T AH D
ENUCLEATES	AH N AH K L IY EY T S
ENUCLEATING	AH N AH K L IY EY T AH NG
ENUCLEATION	AH N AH K L IY EY SH AH N
ENUCLEATIONS	AH N AH K L IY T IY AH N Z
ENWREATHE	EH N R IY DH
ENWREATHED	EH N R IY DH D
ENWREATHES	EH N R IY DH Z
ENWREATHING	EH N R IY DH IH NG
EPICUREAN	EH P AH K Y UH R IY AH N
EPICUREANISM	EH P IH K Y UH R IY AH N IH Z AH M
EPICUREANISMS	EH P IH K Y UH R IY AH N IH Z AH M Z
EPICUREANS	EH P IH K Y UH R IY AH N Z
EPIGEAL	AH P IH JH IY AH L
EPIGEAN	AH P AY JH IY AH N
EPIPHYSEAL	EH P AH F IH Z IY AH L
ESCHEAT	IH S CH IY T
ESCHEATABLE	IH S CH IY T AH B AH L
ESCHEATED	IH S CH IY T IH D
ESCHEATING	IH S CH IY T IH NG
ESCHEATS	IH S CH IY T S
ESOPHAGEAL	EH S AH F IH JH IY AH L
ESTREAT	EH S T R IY T
ESTREATED	EH S T R IY EY T AH D
ESTREATING	EH S T R IY EY T AH NG
ESTREATS	EH S T R IY EY T S
ETHEREAL	IH TH IH R IY AH L
ETHEREALITIES	IH TH IH R IY AH L AH T IY Z
ETHEREALITY	IH TH IH R IY AH L AH T IY
ETHEREALIZATION	IH TH IH R IY AH L AH Z EY SH AH N
ETHEREALIZATIONS	IH TH IH R IY AH L AH Z EY SH AH N Z
ETHEREALIZE	IH TH IH R IY AH L AY Z
ETHEREALIZED	IH TH IH R IY AH L AY Z D
ETHEREALIZES	IH TH IH R IY AH L AY Z IH Z
ETHEREALIZING	IH TH IH R IY AH L AY Z IH NG
ETHEREALLY	IH TH IH R IY AH L IY
ETHEREALNESS	IH TH IH R IY AH L N AH S
ETHEREALNESSES	IH TH IH R IY AH L N AH S IH Z
EUCLIDEAN	Y UW K L AY D IY AH N
EUPNEA	Y UW P N IY AH
EUPNEAS	Y UW P N IY Z
EUPNOEA	Y UW P N OW AH AH
EUPNOEAS	Y UW P N OW AH AH Z
EXCHANGEABILITIES	IH K S CH EY N JH AH B IH L AH T EH Z
EXCHANGEABILITY	IH K S CH EY N JH AH B IH L AH T EH
EXCHANGEABLE	IH K S CH EY N JH AH B AH L
EXONUCLEASE	IH G Z AA N AH K L IY Z
EXONUCLEASES	IH G Z AA N AH K L IY Z AH Z
EXTRACORPOREAL	EH K S T R AH K AO R P OW R IY AH L
EXTRACORPOREALLY	EH K S T R AH K AO R P OW R IY AH L IY
EXTRANUCLEAR	EH K S T R AH N UW K L IY ER
EYEABLE	AY AH B AH L
EYEBEAM	AY B IY M
EYEBEAMS	AY B IY M Z
EYEWEAR	AY W EH R
FACEABLE	F EY S AH B AH L
FADEAWAY	F EY D AH W EY
FADEAWAYS	F EY D AH W EY Z
FAINEANT	F EY N IY AH N T
FAINEANTS	F EY N IY N T S
FAINTHEARTED	F EY N T HH AA R T IH D
FAINTHEARTEDLY	F EY N T HH AA R T AH D L IY
FAINTHEARTEDNESS	F EY N T HH AA R T AH D N AH S
FAINTHEARTEDNESSES	F EY N T HH AA R T AH D N AH S IH Z
FAIRLEAD	F EH R L IY D
FAIRLEADER	F EH R L IY D ER
FAIRLEADERS	F EH R L IY D ER Z
FAIRLEADS	F EH R L IY D Z
FARMSTEAD	F AA R M S T EH D
FARMSTEADS	F AA R M S T EH D Z
FATHEAD	F AE T HH EH D
FATHEADED	F AE T HH EH D IH D
FATHEADEDLY	F AE T HH EH D AH D L IY
FATHEADEDNESS	F AE T HH EH D AH D N AH S
FATHEADEDNESSES	F AE T HH EH D AH D N AH S IH Z
FATHEADS	F AE T HH EH D Z
FEAL	F IY AH L
FEALTIES	F IY AH L T IY Z
FEALTY	F IY AH L T IY
FEALTY(2)	F IY L T IY
FEAR	F IH R
FEARED	F IH R D
FEARER	F IH ER ER
FEARERS	F IH ER ER Z
FEARFUL	F IH R F AH L
FEARFULLER	F IH ER F AH L ER
FEARFULLEST	F IH ER F AH L AH S T
FEARFULLY	F IH ER F AH L IY
FEARFULNESS	F IH ER F AH L N AH S
FEARFULNESSES	F IH ER F AH L N AH S IH Z
FEARING	F IH R IH NG
FEARLESS	F IH R L AH S
FEARLESSLY	F IH ER L AH S L IY
FEARLESSNESS	F IH ER L AH S N AH S
FEARLESSNESSES	F IH ER L AH S N AH S IH Z
FEARS	F IH R Z
FEARSOME	F IH R S AH M
FEARSOMELY	F IH ER S AH M L IY
FEARSOMENESS	F IH ER S AH M N AH S
FEARSOMENESSES	F IH ER S AH M N AH S IH Z
FEASANCE	F IY Z AH N S
FEASANCES	F IY Z AH N S IH Z
FEASE	F IY Z
FEASED	F IY Z D
FEASES	F IY Z AH Z
FEASIBILITIES	F IY Z AH B IH L AH T IY Z
FEASIBILITY	F IY Z AH B IH L AH T IY
FEASIBLE	F IY Z AH B AH L
FEASIBLY	F IY Z AH B L IY
FEASING	F IY Z AH NG
FEAST	F IY S T
FEASTED	F IY S T IH D
FEASTER	F IY S T ER
FEASTERS	F IY S T ER Z
FEASTFUL	F IY S T F AH L
FEASTING	F IY S T IH NG
FEASTS	F IY S T S
FEAT	F IY T
FEATER	F IY T ER
FEATEST	F IY T AH S T
FEATHER	F EH DH ER
FEATHERBED	F EH DH ER B EH D
FEATHERBEDDED	F EH DH ER B EH D IH D
FEATHERBEDDING	F EH DH ER B EH D IH NG
FEATHERBEDDINGS	F EH DH ER B EH D IH NG Z
FEATHERBEDS	F EH DH ER B EH D Z
FEATHERBRAIN	F EH DH ER B R EY N
FEATHERBRAINED	F EH DH ER B R EY N D
FEATHERBRAINS	F EH DH ER B R EY N Z
FEATHERED	F EH DH ER D
FEATHEREDGE	F EH DH ER EH JH
FEATHEREDGED	F EH DH ER EH JH D
FEATHEREDGES	F EH DH ER EH JH IH Z
FEATHEREDGING	F EH DH ER EH JH IH NG
FEATHERHEAD	F EH DH ER HH EH D
FEATHERHEADED	F EH DH ER HH EH D IH D
FEATHERHEADS	F EH DH ER HH EH D Z
FEATHERIER	F EH DH ER IY ER
FEATHERIEST	F EH DH ER IY AH S T
FEATHERING	F EH DH ER IH NG
FEATHERING(2)	F EH DH R IH NG
FEATHERINGS	F EH DH ER IH NG Z
FEATHERLESS	F EH DH ER L AH S
FEATHERLIGHT	F EH DH ER L AY T
FEATHERS	F EH DH ER Z
FEATHERSTITCH	F EH DH ER S T IH CH
FEATHERSTITCHED	F EH DH ER S T IH CH T
FEATHERSTITCHES	F EH DH ER S T IH CH IH Z
FEATHERSTITCHING	F EH DH ER S T IH CH IH NG
FEATHERWEIGHT	F EH DH ER W EY T
FEATHERWEIGHTS	F EH DH ER W EY T S
FEATHERY	F EH DH ER IY
FEATHERY(2)	F EH DH R IY
FEATLIER	F IY T L IY ER
FEATLIEST	F IY T L IY AH S T
FEATLY	F IY T L IY
FEATS	F IY T S
FEATURE	F IY CH ER
FEATURED	F IY CH ER D
FEATURELESS	F IY CH ER L AH S
FEATURES	F IY CH ER Z
FEATURETTE	F IY CH ER EH T
FEATURETTES	F IY CH ER EH T S
FEATURING	F IY CH ER IH NG
FEAZE	F IY Z
FEAZED	F IY Z D
FEAZES	F IY Z AH Z
FEAZING	F IY Z AH NG
FIDDLEHEAD	F IH D AH L HH EH D
FIDDLEHEADS	F IH D AH L HH EH D Z
FIGEATER	F IH G IY T ER
FIGEATERS	F IH G IY T ER Z
FIGUREHEAD	F IH G Y ER HH EH D
FIGUREHEADS	F IH G Y ER HH EH D Z
FILEABLE	F AY L AH B AH L
FINEABLE	F AY N AH B AH L
FIREABLE	F AY ER AH B AH L
FIREARM	F AY ER AA R M
FIREARM(2)	F AY R AA R M
FIREARMS	F AY ER AA R M Z
FIREARMS(2)	F AY R AA R M Z
FIREBREAK	F AY ER B R EY K
FIREBREAKS	F AY ER B R EY K S
FISHMEAL	F IH SH M IY L
FISHMEALS	F IH SH M IY L Z
FLAMBEAU	F L AE M B IY UW
FLAMBEAUS	F L AE M B IY AH S
FLAMBEAUX	F L AE M B IY AH K S
FLATHEAD	F L AE T HH EH D
FLATHEADS	F L AE T HH EH D Z
FLEA	F L IY
FLEABAG	F L IY B AE G
FLEABAGS	F L IY B AE G Z
FLEABANE	F L IY B EY N
FLEABANES	F L IY B EY N Z
FLEABITE	F L IY B AY T
FLEABITES	F L IY B AY T S
FLEAHOPPER	F L IY HH AA P ER
FLEAHOPPERS	F L IY HH AA P ER Z
FLEAM	F L IY M
FLEAMS	F L IY M Z
FLEAPIT	F L IY P IH T
FLEAPITS	F L IY P IH T S
FLEAS	F L IY Z
FLEAWORT	F L IY W AO R T
FLEAWORTS	F L IY W AO R T S
FLYLEAF	F L AY L IY F
FLYLEAVES	F L AY L IY V Z
FOOTGEAR	F UH T G IH ER
FOOTGEARS	F UH T G IH ER Z
FOOTWEAR	F UH T W EH R
FORBEAR	F AO R B AE ER
FORBEARANCE	F AO R B EH R AH N S
FORBEARANCES	F AO R B AE ER AH N S IH Z
FORBEARER	F AO R B AE ER ER
FORBEARERS	F AO R B AE ER ER Z
FORBEARING	F AO R B AE ER IH NG
FORBEARS	F AO R B AE ER Z
FORCEMEAT	F OW R S M IY T
FORCEMEATS	F OW R S M IY T S
FOREARM	F AO R AA R M
FOREARMED	F OW R AA R M D
FOREARMING	F OW R AA R M IH NG
FOREARMS	F AO R AA R M Z
FOREBEAR	F AO R B EH R
FOREBEARS	F AO R B EH R Z
FOREHEAD	F AO R HH EH D
FOREHEADS	F AO R HH EH D Z
FOREPEAK	F OW R P IY K
FOREPEAKS	F OW R P IY K S
FOREREACH	F OW R IY CH
FOREREACHED	F OW R IY CH T
FOREREACHES	F OW R IY CH IH Z
FOREREACHING	F OW R IY CH IH NG
FORESEEABILITIES	F OW R S IY AH B IH L AH T EH Z
FORESEEABILITY	F OW R S IY AH B IH L AH T EH
FORESEEABLE	F AO R S IY AH B AH L
FORESPEAK	F OW R S P IY K
FORESPEAKING	F OW R S P IY K IH NG
FORESPEAKS	F OW R S P IY K S
FORESWEAR	F OW R S W AE ER
FORESWEARING	F OW R S W AE ER IH NG
FORESWEARS	F OW R S W AE ER Z
FORGEABILITIES	F OW R JH AH B IH L AH T EH Z
FORGEABILITY	F OW R JH AH B IH L AH T EH
FORGEABLE	F OW R JH AH B AH L
FORMALWEAR	F AO R M AH L W AE ER
FORSWEAR	F AO R S W EH R
FORSWEARING	F AO R S W AE ER IH NG
FORSWEARS	F AO R S W AE ER Z
FOUNTAINHEAD	F AW N T AH N HH EH D
FOUNTAINHEADS	F AW N T AH N HH EH D Z
FOVEA	F OW V IY AH
FOVEAE	F OW V IY
FOVEAL	F OW V IY AH L
FOVEAS	F OW V IY Z
FOVEATE	F OW V IY EY T
FOVEATED	F OW V IY EY T AH D
FRAMEABLE	F R EY M AH B AH L
FREAK	F R IY K
FREAKED	F R IY K T
FREAKIER	F R IY K IY ER
FREAKIEST	F R IY K IY AH S T
FREAKILY	F R IY K IY L IY
FREAKINESS	F R IY K IY N AH S
FREAKINESSES	F R IY K IY N AH S IH Z
FREAKING	F R IY K IH NG
FREAKISH	F R IY K IH SH
FREAKISHLY	F R IY K IH SH L IY
FREAKISHNESS	F R IY K IH SH N AH S
FREAKISHNESSES	F R IY K IH SH N AH S IH Z
FREAKOUT	F R IY K AW T
FREAKOUTS	F R IY K AW T S
FREAKS	F R IY K S
FREAKY	F R IY K IY
FREEHEARTED	F R IY HH AA R T IH D
FREEHEARTEDLY	F R IY HH AA R T AH D L IY
FRICANDEAU	F R AH K AE N D IY UW
FRICANDEAUS	F R AH K AE N D IY AH S
FRICANDEAUX	F R AH K AE N D IY AH K S
FUNEREAL	F Y UW N IY R IY AH L
FUNEREALLY	F Y UW N AH R IY L IY
FURBEARER	F ER B AE ER ER
FURBEARERS	F ER B AE ER ER Z
FURCRAEA	F AH R K R IY AH
FURCRAEAS	F AH R K R IY AH Z
GALACTORRHEA	G AE L AE K T ER R IY AH
GALACTORRHEAS	G AE L AE K T ER R IY AH Z
GALATEA	G AE L AH T IY AH
GALATEAS	G AE L AH T IY Z
GALEA	G EY L IY AH
GALEAE	G EY L IY
GALEAS	G EY L IY Z
GALEATE	G EY L AH T
GALEATED	G EY L EY T IH D
GALLEASS	G AE L IY S
GALLEASSES	G AE L IY S AH Z
GASTRAEA	G AE S T R IY AH
GASTRAEAS	G AE S T R IY AH Z
GASTREA	G AE S T R IY AH
GASTREAS	G AE S T R IY Z
GASTROESOPHAGEAL	G AE S T R OW EH S AH F IH JH IY AH L
GATEAU	G AA T OW
GATEAUS	G EY T IY AH S
GATEAUX	G EY T IY AH K S
GEANTICLINE	JH IY N T AH K L AY N
GEANTICLINES	JH IY N T AH K L AY N Z
GEAR	G IH R
GEARBOX	G IH R B AA K S
GEARBOXES	G IH R B AA K S IH Z
GEARCASE	G IH ER K EY S
GEARCASES	G IH ER K EY S IH Z
GEARCHANGE	G IH ER CH EY N JH
GEARCHANGES	G IH ER CH EY N JH IH Z
GEARED	G IH R D
GEARING	G IH R IH NG
GEARINGS	G IH ER IH NG Z
GEARLESS	G IH ER L AH S
GEARS	G IH R Z
GEARSHIFT	G IH ER SH IH F T
GEARSHIFTS	G IH ER SH IH F T S
GEARWHEEL	G IH ER W IY L
GEARWHEELS	G IH ER W IY L Z
GENEALOGICAL	JH IY N AH L AA JH IH K AH L
GENEALOGICALLY	JH IY N AH L AA JH IH K AH L IY
GENEALOGIES	JH IY N IY AA L AH JH IY Z
GENEALOGIST	JH IY N AH L AA G IH S T
GENEALOGISTS	JH IY N AH L AA G IH S T S
GENEALOGY	JH IY N IY AA L AH JH IY
GILTHEAD	G IH L T HH EH D
GILTHEADS	G IH L T HH EH D Z
GINGERBREAD	JH IH N JH ER B R EH D
GINGERBREADED	JH IH N JH ER B R EH D IH D
GINGERBREADS	JH IH N JH ER B R EH D Z
GINGERBREADY	JH IH N JH ER B R EH D IY
GIVEABLE	G IH V AH B AH L
GIVEAWAY	G IH V AH W EY
GIVEAWAYS	G IH V AH W EY Z
GLEAM	G L IY M
GLEAMED	G L IY M D
GLEAMER	G L IY M ER
GLEAMERS	G L IY M ER Z
GLEAMIER	G L IY M IY ER
GLEAMIEST	G L IY M IY AH S T
GLEAMING	G L IY M IH NG
GLEAMS	G L IY M Z
GLEAMY	G L IY M IY
GLEAN	G L IY N
GLEANABLE	G L IY N AH B AH L
GLEANED	G L IY N D
GLEANER	G L IY N ER
GLEANERS	G L IY N ER Z
GLEANING	G L IY N IH NG
GLEANINGS	G L IY N IH NG Z
GLEANS	G L IY N Z
GLOSSOPHARYNGEAL	G L AA S AA F AH R IH N JH IY AH L
GLOSSOPHARYNGEALS	G L AA S AH F AE R AH N JH IY L Z
GLUTEAL	G L UW T IY AH L
GODHEAD	G AA D HH EH D
GODHEADS	G AA D HH EH D Z
GOLDENSEAL	G OW L D AH N S IY L
GOLDENSEALS	G OW L D AH N S IY L Z
GONORRHEA	G AA N ER IY AH
GONORRHEAL	G AH N AO R IY AH L
GONORRHEAS	G AO N ER R IY AH Z
GRAYBEARD	G R EY B IY R D
GRAYBEARDS	G R EY B IY R D Z
GRAZEABLE	G R EY Z AH B AH L
GREASE	G R IY S
GREASEBALL	G R IY S B AO L
GREASEBALLS	G R IY S B AO L Z
GREASED	G R IY S T
GREASELESS	G R IY S L AH S
GREASEPAINT	G R IY S P EY N T
GREASEPAINTS	G R IY S P EY N T S
GREASEPROOF	G R IY S P R UW F
GREASEPROOFS	G R IY S P R UW F S
GREASER	G R IY S ER
GREASERS	G R IY S ER Z
GREASES	G R IY S IH Z
GREASEWOOD	G R IY S W UH D
GREASEWOODS	G R IY S W UH D Z
GREASIER	G R IY S IY ER
GREASIEST	G R IY S IY AH S T
GREASILY	G R IY S IY L IY
GREASINESS	G R IY S IY N AH S
GREASINESSES	G R IY S IY N AH S IH Z
GREASING	G R IY S IH NG
GREASY	G R IY S IY
GREAT	G R EY T
GREATCOAT	G R EY T K OW T
GREATCOATS	G R EY T K OW T S
GREATEN	G R EY T AH N
GREATENED	G R EY T AH N D
GREATENING	G R EY T AH N IH NG
GREATENS	G R EY T AH N Z
GREATER	G R EY T ER
GREATEST	G R EY T AH S T
GREATHEARTED	G R EY T HH AA R T IH D
GREATHEARTEDLY	G R EY T HH AA R T AH D L IY
GREATHEARTEDNESS	G R EY T HH AA R T AH D N AH S
GREATHEARTEDNESSES	G R EY T HH AA R T AH D N AH S IH Z
GREATLY	G R EY T L IY
GREATNESS	G R EY T N AH S
GREATNESSES	G R EY T N AH S IH Z
GREATS	G R EY T S
GREAVE	G R IY V
GREAVED	G R IY V D
GREAVES	G R IY V Z
GREENHEAD	G R IY N HH EH D
GREENHEADS	G R IY N HH EH D Z
GREENHEART	G R IY N HH AA R T
GREENHEARTS	G R IY N HH AA R T S
GROSBEAK	G R OW S B IY K
GROSBEAKS	G R OW S B IY K S
GROUNDBREAKER	G R AW N D B R EY K ER
GROUNDBREAKERS	G R AW N D B R EY K ER Z
GROUNDBREAKING	G R AW N D B R EY K IH NG
GROUNDBREAKING(2)	G R AW N B R EY K IH NG
GUINEA	G IH N IY
GUINEAS	G IH N IY Z
GYNAECEA	JH AH N IY S IY AH
HAIRBREADTH	HH EH R B R EH D TH
HAIRBREADTHS	HH EH R B R EH D TH S
HAIRSBREADTH	HH EH R Z B R EH D TH
HAIRSBREADTHS	HH EH R Z B R EH D TH S
HAIRSTREAK	HH EH R S T R IY K
HAIRSTREAKS	HH EH R S T R IY K S
HALFBEAK	HH AE L F B IY K
HALFBEAKS	HH AE L F B IY K S
HALFHEARTED	HH AE F HH AA R T IH D
HALFHEARTEDLY	HH AE F HH AA R T AH D L IY
HALFHEARTEDNESS	HH AE F HH AA R T AH D N AH S
HALFHEARTEDNESSES	HH AE F HH AA R T AH D N AH S IH Z
HALTERBREAK	HH AO L T ER B R EY K
HALTERBREAKING	HH AO L T ER B R EY K IH NG
HALTERBREAKS	HH AO L T ER B R EY K S
HAMMERHEAD	HH AE M ER HH EH D
HAMMERHEADS	HH AE M ER HH EH D Z
HANDBREADTH	HH AE N D B R EH D TH
HANDBREADTHS	HH AE N D B R EH D TH S
HANDLEABLE	HH AE N D AH L AH B AH L
HANDSBREADTH	HH AE N D Z B R EH D TH
HANDSBREADTHS	HH AE N D Z B R EH D TH S
HARDHEAD	HH AA R D HH EH D
HARDHEADED	HH AA R D HH EH D IH D
HARDHEADEDLY	HH AA R D HH EH D AH D L IY
HARDHEADEDNESS	HH AA R D HH EH D AH D N AH S
HARDHEADEDNESSES	HH AA R D HH EH D AH D N AH S IH Z
HARDHEADS	HH AA R D HH EH D Z
HARDHEARTED	HH AA R D HH AA R T IH D
HARDHEARTEDLY	HH AA R D HH AA R T AH D L IY
HARDHEARTEDNESS	HH AA R D HH AA R T AH D N AH S
HARDHEARTEDNESSES	HH AA R D HH AA R T AH D N AH S IH Z
HASHHEAD	HH AE SH HH EH D
HASHHEADS	HH AE SH HH EH D Z
HATEABLE	HH EY T AH B AH L
HEAD	HH EH D
HEADACHE	HH EH D EY K
HEADACHES	HH EH D EY K S
HEADACHIER	HH EH D EY K IY ER
HEADACHIEST	HH EH D EY K IY AH S T
HEADACHY	HH EH D EY K IY
HEADBAND	HH EH D B AE N D
HEADBANDS	HH EH D B AE N D Z
HEADBOARD	HH EH D B AO R D
HEADBOARDS	HH EH D B AO R D Z
HEADCHEESE	HH EH D CH IY Z
HEADCHEESES	HH EH D CH IY Z IH Z
HEADCOUNT	HH EH D K AW N T
HEADCOUNTS	HH EH D K AW N T S
HEADDRESS	HH EH D R EH S
HEADDRESSES	HH EH D D R EH S AH Z
HEADED	HH EH D AH D
HEADED(2)	HH EH D IH D
HEADER	HH EH D ER
HEADERS	HH EH D ER Z
HEADFIRST	HH EH D F ER S T
HEADFISH	HH EH D F IH SH
HEADFISHES	HH EH D F IH SH IH Z
HEADFOREMOST	HH EH D F OW R M OW S T
HEADGATE	HH EH D G EY T
HEADGATES	HH EH D G EY T S
HEADGEAR	HH EH D G IH R
HEADGEARS	HH EH D G IH ER Z
HEADHUNT	HH EH D HH AH N T
HEADHUNTED	HH EH D HH AH N T IH D
HEADHUNTER	HH EH D HH AH N T ER
HEADHUNTERS	HH EH D HH AH N T ER Z
HEADHUNTING	HH EH D HH AH N T IH NG
HEADHUNTS	HH EH D HH AH N T S
HEADIER	HH EH D IY ER
HEADIEST	HH EH D IY AH S T
HEADILY	HH EH D IY L IY
HEADINESS	HH EH D IY N AH S
HEADINESSES	HH EH D IY N AH S IH Z
HEADING	HH EH D IH NG
HEADINGS	HH EH D IH NG Z
HEADLAMP	HH EH D L AE M P
HEADLAMPS	HH EH D L AE M P S
HEADLAND	HH EH D L AE N D
HEADLANDS	HH EH D L AE N D Z
HEADLESS	HH EH D L AH S
HEADLESSNESS	HH EH D L AH S N AH S
HEADLESSNESSES	HH EH D L AH S N AH S IH Z
HEADLIGHT	HH EH D L AY T
HEADLIGHTS	HH EH D L AY T S
HEADLINE	HH EH D L AY N
HEADLINED	HH EH D L AY N D
HEADLINER	HH EH D L AY N ER
HEADLINERS	HH EH D L AY N ER Z
HEADLINES	HH EH D L AY N Z
HEADLINING	HH EH D L AY N IH NG
HEADLOCK	HH EH D L AA K
HEADLOCKS	HH EH D L AA K S
HEADLONG	HH EH D L AO NG
HEADMAN	HH EH D M AH N
HEADMASTER	HH EH D M AE S T ER
HEADMASTERS	HH EH D M AE S T ER Z
HEADMASTERSHIP	HH EH D M AE S T ER SH IH P
HEADMASTERSHIPS	HH EH D M AE S T ER SH IH P S
HEADMEN	HH EH D M EH N
HEADMISTRESS	HH EH D M IH S T R AH S
HEADMISTRESSES	HH EH D M IH S T R AH S AH Z
HEADMOST	HH EH D M OW S T
HEADNOTE	HH EH D N OW T
HEADNOTES	HH EH D N OW T S
HEADPHONE	HH EH D F OW N
HEADPHONES	HH EH D F OW N Z
HEADPIECE	HH EH D P IY S
HEADPIECES	HH EH D P IY S IH Z
HEADPIN	HH EH D P IH N
HEADPINS	HH EH D P IH N Z
HEADQUARTER	HH EH D K W AO R T ER
HEADQUARTER(2)	HH EH D K AO R T ER
HEADQUARTERED	HH EH D K AO R T ER D
HEADQUARTERED(2)	HH EH D K W AO R T ER D
HEADQUARTERING	HH EH D K W AO R T ER IH NG
HEADQUARTERS	HH EH D K W AO R T ER Z
HEADQUARTERS(2)	HH EH D K AO R T ER Z
HEADRACE	HH EH D R EY S
HEADRACES	HH EH D R EY S IH Z
HEADREST	HH EH D R EH S T
HEADRESTS	HH EH D R EH S T S
HEADROOM	HH EH D R UW M
HEADROOMS	HH EH D R UW M Z
HEADS	HH EH D Z
HEADSAIL	HH EH D S EY L
HEADSAILS	HH EH D S EY L Z
HEADSET	HH EH D S EH T
HEADSETS	HH EH D S EH T S
HEADSHIP	HH EH D SH IH P
HEADSHIPS	HH EH D SH IH P S
HEADSHRINKER	HH EH D SH R IH NG K ER
HEADSHRINKERS	HH EH D SH R IH NG K ER Z
HEADSMAN	HH EH D Z M AH N
HEADSMEN	HH EH D Z M EH N
HEADSPACE	HH EH D S P EY S
HEADSPACES	HH EH D S P EY S IH Z
HEADSPRING	HH EH D S P R IH NG
HEADSPRINGS	HH EH D S P R IH NG Z
HEADSTALL	HH EH D S T AO L
HEADSTALLS	HH EH D S T AO L Z
HEADSTAND	HH EH D S T AE N D
HEADSTANDS	HH EH D S T AE N D Z
HEADSTAY	HH EH D S T EY
HEADSTAYS	HH EH D S T EY Z
HEADSTOCK	HH EH D S T AA K
HEADSTOCKS	HH EH D S T AA K S
HEADSTONE	HH EH D S T OW N
HEADSTONES	HH EH D S T OW N Z
HEADSTREAM	HH EH D S T R IY M
HEADSTREAMS	HH EH D S T R IY M Z
HEADSTRONG	HH EH D S T R AO NG
HEADWAITER	HH EH D W EY T ER
HEADWAITERS	HH EH D W EY T ER Z
HEADWATER	HH EH D W AO T ER
HEADWATERS	HH EH D W AO T ER Z
HEADWAY	HH EH D W EY
HEADWAYS	HH EH D W EY Z
HEADWIND	HH EH D W IH N D
HEADWINDS	HH EH D W IH N D Z
HEADWORD	HH EH D W ER D
HEADWORDS	HH EH D W ER D Z
HEADWORK	HH EH D W ER K
HEADWORKS	HH EH D W ER K S
HEADY	HH EH D IY
HEAL	HH IY L
HEALABLE	HH IY L AH B AH L
HEALED	HH IY L D
HEALER	HH IY L ER
HEALERS	HH IY L ER Z
HEALING	HH IY L IH NG
HEALINGS	HH IY L IH NG Z
HEALS	HH IY L Z
HEALTH	HH EH L TH
HEALTHFUL	HH EH L TH F AH L
HEALTHFULLY	HH EH L TH F AH L IY
HEALTHFULNESS	HH EH L TH F AH L N AH S
HEALTHFULNESSES	HH EH L TH F AH L N AH S IH Z
HEALTHIER	HH EH L TH IY ER
HEALTHIEST	HH EH L TH IY IH S T
HEALTHILY	HH EH L TH IY L IY
HEALTHINESS	HH EH L TH IY N AH S
HEALTHINESSES	HH EH L TH IY N AH S IH Z
HEALTHS	HH EH L TH S
HEALTHY	HH EH L TH IY
HEAP	HH IY P
HEAPED	HH IY P T
HEAPING	HH IY P IH NG
HEAPS	HH IY P S
HEAR	HH IY R
HEARABLE	HH IH ER AH B AH L
HEARD	HH ER D
HEARER	HH IY R ER
HEARERS	HH IY R ER Z
HEARING	HH IY R IH NG
HEARINGS	HH IY R IH NG Z
HEARKEN	HH IH ER K EH N
HEARKENED	HH IH ER K EH N D
HEARKENING	HH IH ER K EH N IH NG
HEARKENS	HH AA R K AH N Z
HEARS	HH IY R Z
HEARSAY	HH IY R S EY
HEARSAYS	HH IH ER S EY Z
HEARSE	HH ER S
HEARSED	HH ER S T
HEARSES	HH ER S IH Z
HEARSING	HH ER S IH NG
HEART	HH AA R T
HEARTACHE	HH AA R T EY K
HEARTACHES	HH AA R T EY K S
HEARTBEAT	HH AA R T B IY T
HEARTBEATS	HH AA R T B IY T S
HEARTBREAK	HH AA R T B R EY K
HEARTBREAKER	HH AA R T B R EY K ER
HEARTBREAKERS	HH AA R T B R EY K ER Z
HEARTBREAKING	HH AA R T B R EY K IH NG
HEARTBREAKINGLY	HH AA R T B R EY K IH NG L IY
HEARTBREAKS	HH AA R T B R EY K S
HEARTBROKEN	HH AA R T B R OW K AH N
HEARTBURN	HH AA R T B ER N
HEARTBURNING	HH AA R T B ER N IH NG
HEARTBURNINGS	HH AA R T B ER N IH NG Z
HEARTBURNS	HH AA R T B ER N Z
HEARTED	HH AA R T AH D
HEARTED(2)	HH AA R T IH D
HEARTEN	HH AA R T AH N
HEARTENED	HH AA R T AH N D
HEARTENING	HH AA R T AH N IH NG
HEARTENING(2)	HH AA R T N IH NG
HEARTENINGLY	HH AA R T AH N IH NG L IY
HEARTENS	HH AA R T AH N Z
HEARTFELT	HH AA R T F EH L T
HEARTH	HH AA R TH
HEARTHS	HH AA R TH S
HEARTHSTONE	HH AA R TH S T OW N
HEARTHSTONES	HH AA R TH S T OW N Z
HEARTIER	HH AA R T IY ER
HEARTIES	HH AA R T IY Z
HEARTIEST	HH AA R T IY AH S T
HEARTILY	HH AA R T AH L IY
HEARTINESS	HH AA R T IY N AH S
HEARTINESSES	HH AA R T IY N AH S IH Z
HEARTING	HH AA R T IH NG
HEARTLAND	HH AA R T L AE N D
HEARTLANDS	HH AA R T L AE N D Z
HEARTLESS	HH AA R T L AH S
HEARTLESSLY	HH AA R T L AH S L IY
HEARTLESSNESS	HH AA R T L AH S N AH S
HEARTLESSNESSES	HH AA R T L AH S N AH S IH Z
HEARTRENDING	HH IH ER T R EH N D IH NG
HEARTRENDINGLY	HH IH ER T R EH N D IH NG L IY
HEARTS	HH AA R T S
HEARTSEASE	HH AA R T S IY Z
HEARTSEASES	HH AA R T S IY Z IH Z
HEARTSICK	HH AA R T S IH K
HEARTSICKNESS	HH AA R T S IH K N AH S
HEARTSICKNESSES	HH AA R T S IH K N AH S IH Z
HEARTSOME	HH AA R T S AH M
HEARTSOMELY	HH AA R T S AH M L IY
HEARTSORE	HH AA R T S OW R
HEARTSTRING	HH AA R T S T R IH NG
HEARTSTRINGS	HH AA R T S T R IH NG Z
HEARTTHROB	HH AA R T TH R AA B
HEARTTHROBS	HH AA R T TH R AA B Z
HEARTWARMING	HH AA R T W AO R M IH NG
HEARTWOOD	HH AA R T W UH D
HEARTWOODS	HH AA R T W UH D Z
HEARTWORM	HH AA R T W ER M
HEARTWORMS	HH AA R T W ER M Z
HEARTY	HH AA R T IY
HEAT	HH IY T
HEATABLE	HH IY T AH B AH L
HEATED	HH IY T AH D
HEATED(2)	HH IY T IH D
HEATEDLY	HH IY T IH D L IY
HEATER	HH IY T ER
HEATERS	HH IY T ER Z
HEATH	HH IY TH
HEATHEN	HH IY DH AH N
HEATHENDOM	HH IY DH AH N D AH M
HEATHENDOMS	HH IY DH AH N D AH M Z
HEATHENISH	HH IY DH AH N IH SH
HEATHENISHLY	HH IY DH AH N IH SH L IY
HEATHENISM	HH IY DH AH N IH Z AH M
HEATHENISMS	HH IY DH AH N IH Z AH M Z
HEATHENIZE	HH IY DH AH N AY Z
HEATHENIZED	HH IY DH AH N AY Z D
HEATHENIZES	HH IY DH AH N AY Z IH Z
HEATHENIZING	HH IY DH AH N AY Z IH NG
HEATHENS	HH IY DH AH N Z
HEATHER	HH EH DH ER
HEATHERS	HH EH DH ER Z
HEATHERY	HH EH DH ER IY
HEATHIER	HH IY TH AY AH R
HEATHIEST	HH IY TH AY AH S T
HEATHLAND	HH IY TH L AH N D
HEATHLANDS	HH IY TH L AH N D Z
HEATHLESS	HH IY TH L AH S
HEATHLIKE	HH IY TH L AY K
HEATHS	HH IY TH S
HEATHY	HH IY TH IY
HEATING	HH IY T IH NG
HEATLESS	HH IY T L AH S
HEATPROOF	HH IY T P R UW F
HEATS	HH IY T S
HEATSTROKE	HH IY T S T R OW K
HEATSTROKES	HH IY T S T R OW K S
HEAUME	HH IY UW M
HEAUMES	HH IY UW M Z
HEAVE	HH IY V
HEAVED	HH IY V D
HEAVEN	HH EH V AH N
HEAVENLIER	HH EH V AH N L IY ER
HEAVENLIEST	HH EH V AH N L IY AH S T
HEAVENLINESS	HH EH V AH N L IY N AH S
HEAVENLINESSES	HH EH V AH N L IY N AH S IH Z
HEAVENLY	HH EH V AH N L IY
HEAVENS	HH EH V AH N Z
HEAVENWARD	HH EH V AH N W ER D
HEAVENWARDS	HH EH V AH N W ER D Z
HEAVER	HH IY V ER
HEAVERS	HH IY V ER Z
HEAVES	HH IY V Z
HEAVIER	HH EH V IY ER
HEAVIES	HH EH V IY Z
HEAVIEST	HH EH V IY AH S T
HEAVILY	HH EH V AH L IY
HEAVINESS	HH EH V IY N AH S
HEAVINESSES	HH EH V IY N AH S IH Z
HEAVING	HH IY V IH NG
HEAVY	HH EH V IY
HEAVYHEARTED	HH EH V IY HH AA R T IH D
HEAVYHEARTEDLY	HH EH V IY HH AA R T AH D L IY
HEAVYHEARTEDNESS	HH EH V IY HH AA R T AH D N AH S
HEAVYHEARTEDNESSES	HH EH V IY HH AA R T AH D N AH S IH Z
HEAVYSET	HH EH V IY S EH T
HEAVYWEIGHT	HH EH V IY W EY T
HEAVYWEIGHTS	HH EH V IY W EY T S
HEPATOPANCREAS	HH EH P AH T AH P AE NG K R IY Z
HEPATOPANCREASES	HH AH P AH T AA P AH NG K R IY Z AH Z
HERCULEAN	HH ER K Y UW L IY AH N
HEREABOUT	HH IH R AH B AW T
HEREABOUTS	HH IH R AH B AW T S
HEREAFTER	HH IH R AE F T ER
HEREAFTERS	HH IH R AE F T ER Z
HEREAT	HH IY R IY T
HEREAWAY	HH IY R IY W EY IY
HEREAWAYS	HH IY R AH W EY Z
HERMAEAN	HH AH R M IY AH N
HIDEAWAY	HH AY D AH W EY
HIDEAWAYS	HH AY D AH W EY Z
HIREABLE	HH AY ER AH B AH L
HOGSHEAD	HH AA G Z HH EH D
HOGSHEADS	HH AA G Z HH EH D Z
HOMESTEAD	HH OW M S T EH D
HOMESTEADED	HH OW M S T EH D IH D
HOMESTEADER	HH OW M S T EH D ER
HOMESTEADERS	HH OW M S T EH D ER Z
HOMESTEADING	HH OW M S T EH D IH NG
HOMESTEADS	HH OW M S T EH D Z
HOMONUCLEAR	HH OW M OW N UW K L IY ER
HONEYEATER	HH AH N IY IY T ER
HONEYEATERS	HH AH N IY IY T ER Z
HOOFBEAT	HH UW F B IY T
HOOFBEATS	HH UW F B IY T S
HOPHEAD	HH AA P HH EH D
HOPHEADS	HH AA P HH EH D Z
HORNBEAM	HH AO R N B IY M
HORNBEAMS	HH AO R N B IY M Z
HORSEBEAN	HH AO R S B IY N
HORSEBEANS	HH AO R S B IY N Z
HORSEFEATHERS	HH AO R S F EH DH ER Z
HOTHEAD	HH AA T HH EH D
HOTHEADED	HH AA T HH EH D IH D
HOTHEADEDLY	HH AA T HH EH D AH D L IY
HOTHEADEDNESS	HH AA T HH EH D AH D N AH S
HOTHEADEDNESSES	HH AA T HH EH D AH D N AH S IH Z
HOTHEADS	HH AA T HH EH D Z
HOUSEBREAK	HH AW S B R EY K
HOUSEBREAKER	HH AW S B R EY K ER
HOUSEBREAKERS	HH AW S B R EY K ER Z
HOUSEBREAKING	HH AW S B R EY K IH NG
HOUSEBREAKINGS	HH AW S B R EY K IH NG Z
HOUSEBREAKS	HH AW S B R EY K S
HOUSECLEAN	HH AW S K L IY N
HOUSECLEANED	HH AW S K L IY N D
HOUSECLEANING	HH AW S K L IY N IH NG
HOUSECLEANINGS	HH AW S K L IY N IH NG Z
HOUSECLEANS	HH AW S K L IY N Z
HYDRANGEA	HH IH D R AE N JH IY AH
HYDRANGEAS	HH IH D R AE N JH IY Z
HYDROXYUREA	HH IH D R AA K S AY UH R IY AH
HYDROXYUREAS	HH IH D R AA K S AY AH R IY Z
HYMENEAL	HH AH M IY N IY AH L
HYMENEALLY	HH IH M AH N IY L IY
HYMENEALS	HH IH M AH N IY L Z
HYOIDEAN	HH AY OY D IY AH N
HYPERBOREAN	HH AY P ER B AO R IY AH N
HYPERBOREANS	HH AY P AH R B AH R IY N Z
HYPERPNEA	HH AY P AH R N IY
HYPERPNEAS	HH AY P AH R N IY Z
HYPERREACTIVE	HH AY P ER R IY AE K T IH V
HYPERREACTIVITIES	HH AY P ER R IY AE K T IH V AH T IY Z
HYPERREACTIVITY	HH AY P ER R IY AE K T IH V AH T IY
HYPERREACTOR	HH AY P ER R IY AE K T ER
HYPERREACTORS	HH AY P ER R IY AE K T ER Z
HYPERREALISM	HH AY P ER R IY L IH Z AH M
HYPERREALISMS	HH AY P ER R IY L IH Z AH M Z
HYPERREALIST	HH AY P ER R IY L IH S T
HYPERREALISTIC	HH AY P ER R IY AH L IH S T IH K
HYPOGEA	HH AH P OW JH IY AH
HYPOGEAL	HH AH P OW JH IY AH L
HYPOGEAN	HH AH P OW JH IY AH N
HYPONEA	HH AH P OW N IY AH
HYPONEAS	HH IH P AH N IY Z
HYPOPHYSEAL	HH AY P AH F IH Z IY AH L
HYPOPNEA	HH AH P AA P N IY AH
HYPOPNEAS	HH AH P AA P N IY Z
ICEBREAKER	AY S B R EY K ER
ICEBREAKERS	AY S B R EY K ER Z
IDEA	AY D IY AH
IDEAL	AY D IY L
IDEALESS	AY D IY AH L AH S
IDEALISE	IH D AH L AY Z
IDEALISED	AY D IY AH L IY Z D
IDEALISES	AY D IY AH L IY Z IH Z
IDEALISING	AY D IY AH L IY Z IH NG
IDEALISM	AY D IY L IH Z AH M
IDEALISMS	AY D IY L IH Z AH M Z
IDEALIST	AY D IY L IH S T
IDEALISTIC	AY D IY AH L IH S T IH K
IDEALISTICALLY	AY D IY AH L IH S T IH K AH L IY
IDEALISTS	AY D IY AH L IH S T S
IDEALITIES	AY D IY L AH T IY Z
IDEALITY	AY D IY L AH T IY
IDEALIZATION	AY D IY L AH Z EY SH AH N
IDEALIZATIONS	AY D IY L AH Z EY SH AH N Z
IDEALIZE	AY D IY AH L AY Z
IDEALIZED	AY D IY AH L AY Z D
IDEALIZER	AY D IY L AY Z ER
IDEALIZERS	AY D IY L AY Z ER Z
IDEALIZES	AY D IY AH L AY Z IH Z
IDEALIZING	AY D IY AH L AY Z IH NG
IDEALLESS	AY D IY L AH S
IDEALLY	AY D IY L IY
IDEALOGIES	AY D IY AH L AA G IY Z
IDEALOGUE	AH D IY L AH G
IDEALOGUES	AH D IY L AH G Z
IDEALOGY	AY D IY AH L AA G IY
IDEALS	AY D IY L Z
IDEAS	AY D IY AH Z
IDEATE	AY D IY EY T
IDEATED	AY D IY EY T IH D
IDEATES	AY D IY EY T S
IDEATING	AY D IY EY T IH NG
IDEATION	AY D IY EY SH AH N
IDEATIONAL	AY D IY EY SH AH N AH L
IDEATIONALLY	AY D IY EY SH AH N AH L IY
IDEATIONS	AY D IY EY SH AH N Z
IDEATIVE	AY D IY EY T IH V
ILEA	IH L IY AH
ILEAC	AH L IY K
ILEAL	IH L IY AH L
IMMEASURABLE	IH M EH ZH ER AE B AH L
IMMEASURABLENESS	IH M EH ZH ER AH B AH L N AH S
IMMEASURABLENESSES	IH M EH ZH ER AH B AH L N AH S IH Z
IMMEASURABLY	IH M EH ZH ER AE B L IY
IMMUNOREACTIVE	IH M Y UW N AH R IY K T AH V
IMMUNOREACTIVITIES	IH M Y UW N AH R IY K T IH V AH T AY Z
IMMUNOREACTIVITY	IH M Y UW N AH R IY K T IH V AH T IY
IMPEACH	IH M P IY CH
IMPEACHABLE	IH M P IY CH AH B AH L
IMPEACHED	IH M P IY CH T
IMPEACHES	IH M P IY CH AH Z
IMPEACHING	IH M P IY CH IH NG
IMPEACHMENT	IH M P IY CH M AH N T
IMPEACHMENTS	IH M P IY CH M AH N T S
IMPEARL	IH M P ER L
IMPEARLED	IH M P ER L D
IMPEARLING	IH M P AE ER L IH NG
IMPEARLS	IH M P ER L Z
IMPERMEABILITIES	IH M P ER M IY AH B IH L AH T EH Z
IMPERMEABILITY	IH M P ER M IY AH B IH L AH T EH
IMPERMEABLE	IH M P ER M IY AH B AH L
IMPLEAD	IH M P L IY D
IMPLEADED	IH M P L IY D IH D
IMPLEADING	IH M P L IY D IH NG
IMPLEADS	IH M P L IY D Z
INAPPEASABLE	IH N AH P IY Z AH B AH L
INBREATHE	IH N B R IY DH
INBREATHED	IH N B R IY DH D
INBREATHES	IH N B R IY DH Z
INBREATHING	IH N B R IY DH IH NG
INCHMEAL	IH N CH M IY L
INCORPOREAL	IH N K AO R P OW R IY AH L
INCORPOREALLY	IH N K AO R P OW R IY AH L IY
INCREASABLE	IH N K R IY S AH B AH L
INCREASE	IH N K R IY S
INCREASED	IH N K R IY S T
INCREASER	IH N K R IY S ER
INCREASERS	IH N K R IY S ER Z
INCREASES	IH N K R IY S IH Z
INCREASING	IH N K R IY S IH NG
INCREASINGLY	IH N K R IY S IH NG G L IY
INCREATE	IH N K R IY EY T
INDEFEASIBILITIES	IH N D IY F IY Z AH B IH L AH T IY Z
INDEFEASIBILITY	IH N D IY F IY Z AH B IH L AH T IY
INDEFEASIBLE	IH N D IY F IY Z AH B AH L
INDEFEASIBLY	IH N D IY F IY Z AH B L IY
INEARTH	IH N ER TH
INEARTHED	IH N ER TH T
INEARTHING	IH N ER TH IH NG
INEARTHS	IH N ER TH S
INEFFACEABILITIES	IH N IH F EY S AH B IH L AH T EH Z
INEFFACEABILITY	IH N IH F EY S AH B IH L AH T EH
INEFFACEABLE	IH N IH F EY S AH B AH L
INEFFACEABLY	IH N IH F EY S AH B L IY
INFEASIBILITIES	IH N F IY Z AH B IH L AH T IY Z
INFEASIBILITY	IH N F IY Z AH B IH L AH T IY
INFEASIBLE	IH N F IY Z AH B AH L
INFLUENCEABLE	IH N F L UW AH N S AH B AH L
INSEAM	IH N S IY M
INSEAMS	IH N S IY M Z
INSHEATH	IH N SH IY TH
INSHEATHED	IH N SH IY DH D
INSHEATHING	IH N SH IY DH IH NG
INSHEATHS	IH N SH IY TH S
INSTEAD	IH N S T EH D
INTERCHANGEABILITIES	IH N T ER CH EY N JH AH B IH L AH T EH Z
INTERCHANGEABILITY	IH N T ER CH EY N JH AH B IH L AH T EH
INTERCHANGEABLE	IH N T ER CH EY N JH AH B AH L
INTERCHANGEABLE(2)	IH N ER CH EY N JH AH B AH L
INTERCHANGEABLENESS	IH N T ER CH EY N JH AH B AH L N AH S
INTERCHANGEABLENESSES	IH N T ER CH EY N JH AH B AH L N AH S IH Z
INTERCHANGEABLY	IH N T ER CH EY N JH AH B L IY
INTERCHANGEABLY(2)	IH N ER CH EY N JH AH B L IY
INTERDEALER	IH N T ER D IY L ER
INTERDEALERS	IH N T ER D IY L ER Z
INTERLEAVE	IH N T ER L IY V
INTERLEAVED	IH N T ER L IY V D
INTERLEAVES	IH N T ER L IY V Z
INTERLEAVING	IH N T ER L IY V IH NG
INTERLINEAR	IH N T ER L IH N IY ER
INTERLINEARLY	IH N T ER L IH N IY ER L IY
INTERLINEARS	IH N T ER L IH N IY ER Z
INTERLINEATION	IH N T ER L IH N IY EY SH AH N
INTERLINEATIONS	IH N T ER L IH N IY EY SH AH N Z
INTERNUCLEAR	IH N T ER N UW K L IY ER
INTEROCEAN	IH N T ER OW SH AH N
INTEROCEANIC	IH N T ER OW SH IY AE N IH K
INTERPERMEATE	IH N T ER P ER M IY AH T
INTERPERMEATED	IH N T ER P ER M IY EY T IH D
INTERPERMEATES	IH N T ER P ER M IY AH T S
INTERPERMEATING	IH N T ER P ER M IY EY T IH NG
INTERPHALANGEAL	IH N T AH R F AH L AE N JH IY AH L
INTERPLEAD	IH N T ER P L IY D
INTERPLEADED	IH N T ER P L IY D IH D
INTERPLEADER	IH N T ER P L IY D ER
INTERPLEADERS	IH N T ER P L IY D ER Z
INTERPLEADING	IH N T ER P L IY D IH NG
INTERPLEADS	IH N T ER P L IY D Z
INTERWEAVE	IH N T ER W IY V
INTERWEAVED	IH N T ER W IY V D
INTERWEAVES	IH N T ER W IY V Z
INTERWEAVING	IH N T ER W IY V IH NG
INTRANSIGEANCE	IH N T R AH N S AY JH IY AH N S
INTRANSIGEANCES	IH N T R AH N S AY JH IY AE N S AH Z
INTRANSIGEANT	IH N T R AH N S AY JH IY AH N T
INTRANSIGEANTLY	IH N T R AH N S AH JH IY N T L IY
INTRANSIGEANTS	IH N T R AH N S AH JH IY N T S
INTRAPERITONEAL	IH N T R AH P AH R AH T OW N IY AH L
INTRAPERITONEALLY	IH N T R AH P AH R IH T AH N IY L IY
INTREAT	IH N T R IY T
INTREATED	IH N T R IY T IH D
INTREATING	IH N T R IY T IH NG
INTREATS	IH N T R IY T S
INWEAVE	IH N W IY V
INWEAVED	IH N W IY V D
INWEAVES	IH N W IY V Z
INWEAVING	IH N W IY V IH NG
IPOMOEA	IH P AH M OW AH AH
IPOMOEAS	IH P AH M OW AH AH Z
IRONHEARTED	AY ER N HH AA R T IH D
IRREAL	IH R IY L
IRREALITIES	IH R IY AE L AH T IY Z
IRREALITY	IH R IY AE L AH T IY
IRREMEABLE	AH R AH M IY AH B AH L
IRREPEALABILITIES	IH R IH P IY L AH B IH L AH T EH Z
IRREPEALABILITY	IH R IH P IY L AH B IH L AH T EH
IRREPEALABLE	IH R IH P IY L AH B AH L
IRREPLACEABILITIES	IH R IY P L EY S AH B IH L AH T EH Z
IRREPLACEABILITY	IH R IY P L EY S AH B IH L AH T EH
IRREPLACEABLE	IH R AH P L EY S AH B AH L
IRREPLACEABLENESS	IH R IY P L EY S AH B AH L N AH S
IRREPLACEABLENESSES	IH R IY P L EY S AH B AH L N AH S IH Z
IRREPLACEABLY	IH R IY P L EY S AH B L IY
ISOLEAD	IH S AH L IY D
ISOLEADS	IH S AH L IY D Z
JAILBREAK	JH EY L B R EY K
JAILBREAKS	JH EY L B R EY K S
JAMBEAU	JH AE M B OW
JAMBEAUX	JH AE M B IY AH K S
JARHEAD	JH AA R HH EH D
JARHEADS	JH AA R HH EH D Z
JAWBREAKER	JH AO B R EY K ER
JAWBREAKERS	JH AO B R EY K ER Z
JEALOUS	JH EH L AH S
JEALOUSIES	JH EH L AH S IY Z
JEALOUSLY	JH EH L AH S L IY
JEALOUSNESS	JH EH L AH S N IH S
JEALOUSNESSES	JH EH L AH S N AH S IH Z
JEALOUSY	JH EH L AH S IY
JEAN	JH IY N
JEANS	JH IY N Z
JELLYBEAN	JH EH L IY B IY N
JELLYBEANS	JH EH L IY B IY N Z
JETBEAD	JH EH T B IY D
JETBEADS	JH EH T B IY D Z
JIVEASS	JH AY V AE S
JUGHEAD	JH AH G HH EH D
JUGHEADS	JH AH G HH EH D Z
JUICEHEAD	JH UW S HH EH D
JUICEHEADS	JH UW S HH EH D Z
KEA	K IY
KEAS	K IY Z
KINDHEARTED	K AY N D HH AA R T IH D
KINDHEARTEDLY	K AY N D HH AA R T AH D L IY
KINDHEARTEDNESS	K AY N D HH AA R T AH D N AH S
KINDHEARTEDNESSES	K AY N D HH AA R T AH D N AH S IH Z
KLEAGLE	K L IY G AH L
KLEAGLES	K L IY G AH L Z
KNEAD	N IY D
KNEADABLE	N IY D AH B AH L
KNEADED	N IY D IH D
KNEADER	N IY D ER
KNEADERS	N IY D ER Z
KNEADING	N IY D IH NG
KNEADS	N IY D Z
KNITWEAR	N IH T W EH R
KNOWLEDGEABILITIES	N AA L IH JH AH B IH L AH T EH Z
KNOWLEDGEABILITY	N AA L IH JH AH B IH L AH T EH
KNOWLEDGEABLE	N AA L AH JH AH B AH L
KNOWLEDGEABLENESS	N AA L IH JH AH B AH L N AH S
KNOWLEDGEABLENESSES	N AA L IH JH AH B AH L N AH S IH Z
KNOWLEDGEABLY	N AA L IH JH AH B L IY
KNUCKLEHEAD	N AH K AH L HH EH D
KNUCKLEHEADED	N AH K AH L HH EH D IH D
KNUCKLEHEADS	N AH K AH L HH EH D Z
LACTEAL	L AE K T IY AH L
LACTEALS	L AE K T IY L Z
LACTEAN	L AE K T IY AH N
LARGEHEARTED	L AA R JH HH AA R T IH D
LARGEHEARTEDNESS	L AA R JH HH AA R T AH D N AH S
LARGEHEARTEDNESSES	L AA R JH HH AA R T AH D N AH S IH Z
LARYNGEAL	L AA R IH N JH IY AH L
LARYNGEALS	L AE R AH N JH IY L Z
LAUREATE	L AO R IY AH T
LAUREATED	L AO R IY AH T IH D
LAUREATES	L AO R IY AH T S
LAUREATESHIP	L AO R IY AH T SH IH P
LAUREATESHIPS	L AO R IY AH T SH IH P S
LAUREATING	L AO R IY AH T IH NG
LAUREATION	L AO R IY AH SH AH N
LAUREATIONS	L AO R IY AH SH AH N Z
LAWBREAKER	L AO B R EY K ER
LAWBREAKERS	L AO B R EY K ER Z
LAWBREAKING	L AO B R EY K IH NG
LAWBREAKINGS	L AO B R EY K IH NG Z
LEA	L IY
LEACH	L IY CH
LEACHABILITIES	L IY CH AH B IH L AH T EH Z
LEACHABILITY	L IY CH AH B IH L AH T EH
LEACHABLE	L IY CH AH B AH L
LEACHATE	L IY CH AH T
LEACHATES	L IY CH AH T S
LEACHED	L IY CH T
LEACHER	L IY CH ER
LEACHERS	L IY CH ER Z
LEACHES	L IY CH IH Z
LEACHIER	L IY CH IY ER
LEACHIEST	L IY CH IY AH S T
LEACHING	L IY CH IH NG
LEACHY	L IY CH IY
LEAD	L EH D
LEAD(2)	L IY D
LEADED	L EH D IH D
LEADEN	L EH D AH N
LEADENLY	L EH D AH N L IY
LEADENNESS	L EH D AH N AH S
LEADENNESSES	L EH D AH N AH S IH Z
LEADER	L IY D ER
LEADERBOARD	L IY D ER B OW R D
LEADERBOARDS	L IY D ER B OW R D Z
LEADERLESS	L IY D ER L AH S
LEADERS	L IY D ER Z
LEADERSHIP	L IY D ER SH IH P
LEADERSHIPS	L IY D ER SH IH P S
LEADIER	L IY D IY ER
LEADIEST	L IY D IY AH S T
LEADING	L IY D IH NG
LEADINGS	L IY D IH NG Z
LEADLESS	L IY D L AH S
LEADMAN	L IY D M AE N
LEADMEN	L IY D M EH N
LEADOFF	L IY D AO F
LEADOFFS	L IY D AO F S
LEADPLANT	L IY D P L AE N T
LEADPLANTS	L IY D P L AE N T S
LEADS	L IY D Z
LEADSCREW	L IY D S K R UW
LEADSCREWS	L IY D S K R UW Z
LEADSMAN	L IY D Z M AE N
LEADSMEN	L IY D Z M EH N
LEADWORK	L EH D W ER K
LEADWORKS	L IY D W ER K S
LEADWORT	L IY D W AH R T
LEADWORTS	L IY D W AH R T S
LEADY	L IY D IY
LEAF	L IY F
LEAFAGE	L IY F IH JH
LEAFAGES	L IY F IH JH IH Z
LEAFED	L IY F T
LEAFHOPPER	L IY F HH AA P ER
LEAFHOPPERS	L IY F HH AA P ER Z
LEAFIER	L IY F IY ER
LEAFIEST	L IY F IY AH S T
LEAFING	L IY F IH NG
LEAFLESS	L IY F L AH S
LEAFLET	L IY F L AH T
LEAFLETED	L IY F L AH T IH D
LEAFLETEER	L IY F L AH T IH R
LEAFLETEERS	L IY F L AH T IH R Z
LEAFLETING	L IY F L AH T IH NG
LEAFLETS	L IY F L AH T S
LEAFLETTED	L IY F L AH T IH D
LEAFLETTING	L IY F L AH T IH NG
LEAFLIKE	L IY F L AY K
LEAFS	L IY F S
LEAFSTALK	L IY F S T AO K
LEAFSTALKS	L IY F S T AO K S
LEAFWORM	L IY F W ER M
LEAFWORMS	L IY F W ER M Z
LEAFY	L IY F IY
LEAGUE	L IY G
LEAGUED	L IY G D
LEAGUER	L IY G ER
LEAGUERED	L IY G ER D
LEAGUERING	L IY G ER IH NG
LEAGUERS	L IY G ER Z
LEAGUES	L IY G Z
LEAGUING	L IY G IH NG
LEAK	L IY K
LEAKAGE	L IY K AH JH
LEAKAGE(2)	L IY K IH JH
LEAKAGES	L IY K IH JH IH Z
LEAKED	L IY K T
LEAKER	L IY K ER
LEAKERS	L IY K ER Z
LEAKIER	L IY K IY ER
LEAKIEST	L IY K IY AH S T
LEAKILY	L IY K IY L IY
LEAKINESS	L IY K IY N AH S
LEAKINESSES	L IY K IY N AH S IH Z
LEAKING	L IY K IH NG
LEAKLESS	L IY K L AH S
LEAKPROOF	L IY K P R UW F
LEAKS	L IY K S
LEAKY	L IY K IY
LEAL	L IY L
LEALLY	L IY L IY
LEALTIES	L EH L T AY Z
LEALTY	L IY L T IY
LEAN	L IY N
LEANED	L IY N D
LEANER	L IY N ER
LEANERS	L IY N ER Z
LEANEST	L IY N AH S T
LEANING	L IY N IH NG
LEANINGS	L IY N IH NG Z
LEANLY	L IY N L IY
LEANNESS	L IY N AH S
LEANNESSES	L IY N AH S IH Z
LEANS	L IY N Z
LEANT	L IY AH N T
LEAP	L IY P
LEAPED	L EH P T
LEAPED(2)	L IY P T
LEAPER	L IY P ER
LEAPERS	L IY P ER Z
LEAPFROG	L IY P F R AO G
LEAPFROGGED	L IY P F R AO G D
LEAPFROGGING	L IY P F R AO G IH NG
LEAPFROGS	L IY P F R AO G Z
LEAPING	L IY P IH NG
LEAPS	L IY P S
LEAPT	L EH P T
LEAPT(2)	L IY P T
LEAR	L IH R
LEARIER	L IY R AY AH R
LEARIEST	L IY R AY AH S T
LEARN	L ER N
LEARNABLE	L ER N AH B AH L
LEARNED	L ER N D
LEARNED(2)	L ER N IH D
LEARNEDLY	L ER N AH D L IY
LEARNEDNESS	L ER N AH D N AH S
LEARNEDNESSES	L ER N AH D N AH S IH Z
LEARNER	L ER N ER
LEARNERS	L ER N ER Z
LEARNING	L ER N IH NG
LEARNINGS	L ER N IH NG Z
LEARNS	L ER N Z
LEARNT	L ER N T
LEARS	L IY R Z
LEARY	L IH R IY
LEAS	L IY Z
LEASABLE	L IY S AH B AH L
LEASE	L IY S
LEASEBACK	L IY S B AE K
LEASEBACKS	L IY S B AE K S
LEASED	L IY S T
LEASEHOLD	L IY S HH OW L D
LEASEHOLDER	L IY S HH OW L D ER
LEASEHOLDERS	L IY S HH OW L D ER Z
LEASEHOLDS	L IY S HH OW L D Z
LEASER	L IY S ER
LEASERS	L IY S ER Z
LEASES	L IY S IH Z
LEASH	L IY SH
LEASHED	L IY SH T
LEASHES	L IY SH IH Z
LEASHING	L IY SH IH NG
LEASING	L IY S IH NG
LEASINGS	L IY S IH NG Z
LEAST	L IY S T
LEASTS	L IY S T S
LEASTWAYS	L IY S T W EY Z
LEASTWISE	L IY S T W AY Z
LEATHER	L EH DH ER
LEATHERBACK	L EH DH ER B AE K
LEATHERBACKS	L EH DH ER B AE K S
LEATHERED	L EH DH ER D
LEATHERETTE	L EH DH ER EH T
LEATHERETTES	L EH DH ER EH T S
LEATHERING	L EH DH ER IH NG
LEATHERLEAF	L EH DH ER L IY F
LEATHERLEAVES	L EH DH ER L IY V Z
LEATHERLIKE	L EH DH ER L AY K
LEATHERN	L IY TH AH R N
LEATHERNECK	L EH DH ER N EH K
LEATHERNECKS	L EH DH ER N EH K S
LEATHERS	L EH DH ER Z
LEATHERWOOD	L EH DH ER W UH D
LEATHERWOODS	L EH DH ER W UH D Z
LEATHERY	L EH DH ER IY
LEAVE	L IY V
LEAVED	L IY V D
LEAVEN	L EH V AH N
LEAVENED	L EH V AH N D
LEAVENING	L EH V AH N IH NG
LEAVENINGS	L EH V AH N IH NG Z
LEAVENS	L EH V AH N Z
LEAVER	L IY V ER
LEAVERS	L IY V ER Z
LEAVES	L IY V Z
LEAVIER	L IY V IY ER
LEAVIEST	L IY V IY AH S T
LEAVING	L IY V IH NG
LEAVINGS	L IY V IH NG Z
LEAVY	L IY V IY
LEISUREWEAR	L EH ZH ER W AE ER
LETHEAN	L EH DH IY AH N
LETTERHEAD	L EH T ER HH EH D
LETTERHEADS	L EH T ER HH EH D Z
LEUKORRHEA	L UW K AO R IY AH
LEUKORRHEAL	L UW K AO R IY AH L
LEUKORRHEAS	L UW K AO R IY Z
LEVELHEADED	L EH V AH L HH EH D IH D
LEVELHEADEDNESS	L EH V AH L HH EH D AH D N AH S
LEVELHEADEDNESSES	L EH V AH L HH EH D AH D N AH S IH Z
LIGHTHEADED	L AY T HH EH D AH D
LIGHTHEARTED	L AY T HH AA R T IH D
LIGHTHEARTEDLY	L AY T HH AA R T AH D L IY
LIGHTHEARTEDNESS	L AY T HH AA R T AH D N AH S
LIGHTHEARTEDNESSES	L AY T HH AA R T AH D N AH S IH Z
LIKEABLE	L AY K AH B AH L
LIMEADE	L AY M EY D
LIMEADES	L AY M EY D Z
LINEABLE	L AY N AH B AH L
LINEAGE	L IH N IY AH JH
LINEAGES	L IH N IY IH JH IH Z
LINEAL	L IH N IY AH L
LINEALITIES	L IH N IY AH L AH T IY Z
LINEALITY	L IH N IY AH L AH T IY
LINEALLY	L IH N IY AH L IY
LINEAMENT	L AH N IY M AH N T
LINEAMENTAL	L AY N AH M EH N T AH L
LINEAMENTS	L AH N IY M AH N T S
LINEAR	L IH N IY ER
LINEARISE	L AY N AH R AY Z
LINEARISED	L AY N EH R IY Z D
LINEARISES	L AY N EH R IY Z IH Z
LINEARISING	L AY N EH R IY Z IH NG
LINEARITIES	L IH N IY ER AH T IY Z
LINEARITY	L IH N IY ER AH T IY
LINEARIZATION	L IH N IY ER AH Z EY SH AH N
LINEARIZATIONS	L IH N IY ER AH Z EY SH AH N Z
LINEARIZE	L IH N IY ER AY Z
LINEARIZED	L IH N IY ER AY Z D
LINEARIZES	L IH N IY ER AY Z IH Z
LINEARIZING	L IH N IY ER AY Z IH NG
LINEARLY	L IH N IY ER L IY
LINEATE	L AY N AH T
LINEATED	L AY N EY T IH D
LINEATION	L IH N IY EY SH AH N
LINEATIONS	L IH N IY EY SH AH N Z
LINOLEATE	L AH N OW L IY EY T
LINOLEATES	L AH N OW L IY EY T S
LIONHEARTED	L AY AH N HH AA R T IH D
LIPREADING	L IH P R IY D IH NG
LIPREADINGS	L IH P R IY D IH NG Z
LIVEABILITIES	L IH V AH B IH L AH T EH Z
LIVEABILITY	L IH V AH B IH L AH T EH
LIVEABLE	L IH V AH B AH L
LOGGERHEAD	L AA G ER HH EH D
LOGGERHEADS	L AA G ER HH EH D Z
LOGORRHEA	L AA G ER R IY AH
LOGORRHEAS	L AA G ER R IY AH Z
LONGHEAD	L AO NG HH EH D
LONGHEADED	L AO NG HH EH D IH D
LONGHEADEDNESS	L AO NG HH EH D AH D N AH S
LONGHEADEDNESSES	L AO NG HH EH D AH D N AH S IH Z
LONGHEADS	L AO NG HH EH D Z
LONGLEAF	L AO NG L IY F
LONGLEAVES	L AO NG L IY V Z
LOREAL	L OW R AH L
LOUDSPEAKER	L AW D S P IY K ER
LOUDSPEAKERS	L AW D S P IY K ER Z
LOUNGEWEAR	L AW N JH W AE ER
LOVEABLE	L AH V AH B AH L
LOVEABLY	L AH V AH B L IY
LOVESEAT	L AH V S IY T
LOVESEATS	L AH V S IY T S
LOWLIHEAD	L OW L AH HH IY D
LOWLIHEADS	L OW L AH HH IY D Z
LUNCHMEAT	L AH N CH M IY T
LUNCHMEATS	L AH N CH M IY T S
LUNKHEAD	L AH NG K IY D
LUNKHEADED	L AH NG K IY D AH D
LUNKHEADS	L AH NG K IY D Z
LUTEA	L UW T IY AH
LUTEAL	L UW T AH L
LYCEA	L IH S IY AH
LYNCEAN	L IH N S IY AH N
MACHINEABILITIES	M AH SH IY N AH B IH L AH T EH Z
MACHINEABILITY	M AH SH IY N AH B IH L AH T EH
MACHINEABLE	M AH SH IY N AH B AH L
MACRONUCLEAR	M AE K R AH N AH K L IY AH R
MAIDENHEAD	M EY D AH N HH EH D
MAIDENHEADS	M EY D AH N HH EH D Z
MAINSTREAM	M EY N S T R IY M
MAINSTREAMED	M EY N S T R IY M D
MAINSTREAMING	M EY N S T R IY M IH NG
MAINSTREAMS	M EY N S T R IY M Z
MAKEABLE	M EY K AH B AH L
MAKEREADIES	M EY K R EH D IY Z
MAKEREADY	M EY K R EH D IY
MALEATE	M EY L AH T
MALEATES	M EY L AH T S
MALFEASANCE	M AE L F IY Z AH N S
MALFEASANCES	M AE L F IY Z AH N S IH Z
MALLEABILITIES	M AE L IY AH B IH L AH T EH Z
MALLEABILITY	M AE L IY AH B IH L AH T IY
MALLEABLE	M AE L IY AH B AH L
MALTREAT	M AE L T R IY T
MALTREATED	M AE L T R IY T IH D
MALTREATER	M AE L T R IY T ER
MALTREATERS	M AE L T R IY T ER Z
MALTREATING	M AE L T R IY T IH NG
MALTREATMENT	M AE L T R IY T M AH N T
MALTREATMENTS	M AE L T R IY T M AH N T S
MALTREATS	M AE L T R IY T S
MANAGEABILITIES	M AE N IH JH AH B IH L AH T EH Z
MANAGEABILITY	M AE N IH JH AH B IH L AH T EH
MANAGEABLE	M AE N IH JH AH B AH L
MANAGEABLENESS	M AE N IH JH AH B AH L N AH S
MANAGEABLENESSES	M AE N IH JH AH B AH L N AH S IH Z
MANAGEABLY	M AE N IH JH AH B L IY
MANTEAU	M AE N T IY UW
MANTEAUS	M AE N T IY AH S
MANTEAUX	M AE N T IY AH K S
MARMOREAL	M AA R M AO R IY AH L
MARMOREALLY	M AA R M AH R IY L IY
MARMOREAN	M AA R M AO R IY AH N
MARRIAGEABILITIES	M AE R IH JH AH B IH L AH T EH Z
MARRIAGEABILITY	M AE R IH JH AH B IH L AH T EH
MARRIAGEABLE	M AE R IH JH AH B AH L
MASTHEAD	M AE S T HH EH D
MASTHEADED	M AE S T HH EH D IH D
MASTHEADING	M AE S T HH EH D IH NG
MASTHEADS	M AE S T HH EH D Z
MATRILINEAL	M AE T R IH L IH N IY AH L
MATRILINEALLY	M AE T R IH L AH N IY L IY
MAUSOLEA	M AH S OW L IY AH
MEAD	M IY D
MEADOW	M EH D OW
MEADOWLAND	M EH D OW L AE N D
MEADOWLANDS	M EH D OW L AE N D Z
MEADOWLARK	M EH D OW L AA R K
MEADOWLARKS	M EH D OW L AA R K S
MEADOWS	M EH D OW Z
MEADOWSWEET	M EH D OW S W IY T
MEADOWSWEETS	M EH D OW S W IY T S
MEADOWY	M EH D OW IY
MEADS	M IY D Z
MEAGER	M IY G ER
MEAGERLY	M IY G ER L IY
MEAGERNESS	M IY G ER N AH S
MEAGERNESSES	M IY G ER N AH S IH Z
MEAGRE	M IY G AH R
MEAGRELY	M IY G R L IY
MEAL	M IY L
MEALIE	M IY L IY
MEALIER	M IY L IY ER
MEALIES	M IY L IY Z
MEALIEST	M IY L IY AH S T
MEALLESS	M IY L AH S
MEALS	M IY L Z
MEALTIME	M IY L T AY M
MEALTIMES	M IY L T AY M Z
MEALWORM	M IY L W ER M
MEALWORMS	M IY L W ER M Z
MEALY	M IY L IY
MEALYBUG	M IY L IY B AH G
MEALYBUGS	M IY L IY B AH G Z
MEALYMOUTHED	M IY L IY M AW TH T
MEAN	M IY N
MEANDER	M IY AE N D ER
MEANDERED	M IY AE N D ER D
MEANDERING	M IY AE N D ER IH NG
MEANDERS	M IY AE N D ER Z
MEANDROUS	M IY N D R AH S
MEANER	M IY N ER
MEANERS	M IY N ER Z
MEANEST	M IY N AH S T
MEANIE	M IY N IY
MEANIES	M IY N IY Z
MEANING	M IY N IH NG
MEANINGFUL	M IY N IH NG F AH L
MEANINGFULLY	M IY N IH NG F AH L IY
MEANINGFULNESS	M IY N IH NG F AH L N AH S
MEANINGFULNESSES	M IY N IH NG F AH L N AH S IH Z
MEANINGLESS	M IY N IH NG L AH S
MEANINGLESSLY	M IY N IH NG L AH S L IY
MEANINGLESSNESS	M IY N IH NG L AH S N AH S
MEANINGLESSNESSES	M IY N IH NG L AH S N AH S IH Z
MEANINGLY	M IY N IH NG L IY
MEANINGS	M IY N IH NG Z
MEANLY	M IY N L IY
MEANNESS	M IY N N AH S
MEANNESSES	M IY N AH S IH Z
MEANS	M IY N Z
MEANSPIRITED	M IY N S P IH R AH T IH D
MEANT	M EH N T
MEANTIME	M IY N T AY M
MEANTIMES	M IY N T AY M Z
MEANWHILE	M IY N W AY L
MEANWHILES	M IY N W AY L Z
MEANY	M IY N IY
MEASLE	M IY Z AH L
MEASLED	M IY Z AH L D
MEASLES	M IY Z AH L Z
MEASLIER	M IY Z L AY AH R
MEASLIEST	M IY Z L AY AH S T
MEASLY	M IY Z L IY
MEASURABILITIES	M EH ZH ER AH B IH L AH T EH Z
MEASURABILITY	M EH ZH ER AH B IH L AH T EH
MEASURABLE	M EH ZH ER AH B AH L
MEASURABLY	M EH ZH ER AH B L IY
MEASURE	M EH ZH ER
MEASURED	M EH ZH ER D
MEASUREDLY	M EH ZH ER AH D L IY
MEASURELESS	M EH ZH ER L AH S
MEASUREMENT	M EH ZH ER M AH N T
MEASUREMENTS	M EH ZH ER M AH N T S
MEASURER	M EH ZH ER ER
MEASURERS	M EH ZH ER ER Z
MEASURES	M EH ZH ER Z
MEASURING	M EH ZH ER IH NG
MEAT	M IY T
MEATAL	M IY T AH L
MEATBALL	M IY T B AO L
MEATBALLS	M IY T B AO L Z
MEATED	M IY T IH D
MEATHEAD	M IY T HH EH D
MEATHEADS	M IY T HH EH D Z
MEATIER	M IY T IY ER
MEATIEST	M IY T IY AH S T
MEATILY	M IY T IY L IY
MEATINESS	M IY T IY N AH S
MEATINESSES	M IY T IY N AH S IH Z
MEATLESS	M IY T L AH S
MEATLOAF	M IY T L OW F
MEATLOAVES	M IY T L OW V Z
MEATMAN	M IY T M AE N
MEATMEN	M IY T M EH N
MEATPACKING	M IY T P AE K IH NG
MEATPACKINGS	M IY T P AE K IH NG Z
MEATS	M IY T S
MEATUS	M IY EY T AH S
MEATUSES	M IY T Y UW S IH Z
MEATY	M IY T IY
MEDITERRANEAN	M EH D AH T ER EY N IY AH N
MEGADEAL	M EH G AH D IY L
MEGADEALS	M EH G AH D IY L Z
MEGADEATH	M EH G AH D EH TH
MEGADEATHS	M EH G AH D IY TH S
MENARCHEAL	M EH N AA R K HH IY L
MENINGEAL	M AH N IH N JH IY AH L
MENSWEAR	M EH N Z W EY R
MESOGLEA	M AH S AA G L IY AH
MESOGLEAS	M AH S AA G L IY Z
MESOGLOEA	M EH S AH G L OW AH AH
MESOGLOEAS	M EH S AH G L OW AH AH Z
MICROBEAM	M AY K R OW B IY M
MICROBEAMS	M AY K R OW B IY M Z
MICROEARTHQUAKE	M AY K R OW ER TH K W EY K
MICROEARTHQUAKES	M AY K R OW ER TH K W EY K S
MICROREADER	M AY K R OW R IY D ER
MICROREADERS	M AY K R OW R IY D ER Z
MICROWAVEABLE	M AY K R OW W EY V AH B AH L
MIDSTREAM	M IH D S T R IY M
MIDSTREAMS	M IH D S T R IY M Z
MIDYEAR	M IH D Y IH R
MIDYEARS	M IH D Y IH ER Z
MILEAGE	M AY L AH JH
MILEAGE(2)	M AY L IH JH
MILEAGES	M AY L IH JH IH Z
MILLSTREAM	M IH L S T R IY M
MILLSTREAMS	M IH L S T R IY M Z
MINCEMEAT	M IH N S M IY T
MINCEMEATS	M IH N S M IY T S
MINEABLE	M AY N AH B AH L
MISCELLANEA	M IH S EH L EY N IY AH
MISCREANT	M IH S K R IY AH N T
MISCREANTS	M IH S K R IY AH N T S
MISCREATE	M IH S K R IY EY T
MISCREATED	M IH S K R IY EY T IH D
MISCREATES	M IH S K R IY EY T S
MISCREATING	M IH S K R IY EY T IH NG
MISCREATION	M IH S K R IY EY SH AH N
MISCREATIONS	M IH S K R IY EY SH AH N Z
MISDEAL	M IH S D IY L
MISDEALING	M IH S D IY L IH NG
MISDEALS	M IH S D IY L Z
MISDEALT	M IH S D EH L T
MISDEMEANANT	M IH S D IH M IY N AH N T
MISDEMEANANTS	M IH S D IH M IY N AH N T S
MISDEMEANOR	M IH S D AH M IY N ER
MISDEMEANORS	M IH S D AH M IY N ER Z
MISEASE	M IH S IY Z
MISEASES	M IH S IY Z IH Z
MISEAT	M IH S IY T
MISEATEN	M IH S IY T AH N
MISEATING	M IH S IY T IH NG
MISEATS	M IH S IY T S
MISFEASANCE	M IH S F IY Z AH N S
MISFEASANCES	M IH S F IY Z AH N S IH Z
MISFEASOR	M IH S F IY Z ER
MISFEASORS	M IH S F IY Z ER Z
MISHEAR	M IH S HH IY R
MISHEARD	M IH S HH ER D
MISHEARING	M IH S HH IH ER IH NG
MISHEARS	M IH S HH IH ER Z
MISLEAD	M IH S L IY D
MISLEADER	M IH S L IY D ER
MISLEADERS	M IH S L IY D ER Z
MISLEADING	M IH S L IY D IH NG
MISLEADINGLY	M IH S L IY D IH NG L IY
MISLEADS	M IH S L IY D Z
MISLEARED	M IH S L IY R D
MISLEARN	M IH S L ER N
MISLEARNED	M IH S L ER N D
MISLEARNING	M IH S L ER N IH NG
MISLEARNS	M IH S L ER N Z
MISLEARNT	M IH S L AH R N T
MISMEASUREMENT	M IH S M EH ZH ER M AH N T
MISMEASUREMENTS	M IH S M EH ZH ER M AH N T S
MISPLEAD	M IH S P L IY D
MISPLEADED	M IH S P L IY D IH D
MISPLEADING	M IH S P L IY D IH NG
MISPLEADS	M IH S P L IY D Z
MISREAD	M IH S R IY D
MISREAD(2)	M IH S R EH D
MISREADING	M IH S R IY D IH NG
MISREADS	M IH S R IY D Z
MISSEAT	M IH S IY T
MISSEATED	M IH S IY T IH D
MISSEATING	M IH S IY T IH NG
MISSEATS	M IH S IY T S
MISSPEAK	M IH S S P IY K
MISSPEAK(2)	M IH S P IY K
MISSPEAKING	M IH S P IY K IH NG
MISSPEAKS	M IH S P IY K S
MISTEACH	M IH S T IY CH
MISTEACHES	M IH S T IY CH IH Z
MISTEACHING	M IH S T IY CH IH NG
MISTREAT	M IH S T R IY T
MISTREATED	M IH S T R IY T IH D
MISTREATING	M IH S T R IY T IH NG
MISTREATMENT	M IH S T R IY T M AH N T
MISTREATMENTS	M IH S T R IY T M AH N T S
MISTREATS	M IH S T R IY T S
MONOGENEAN	M AA N AH JH IY N IY AH N
MONOGENEANS	M AH N AA JH AH N IY N Z
MONONUCLEAR	M AA N AH N UW K L IY ER
MONONUCLEARS	M AA N OW N UW K L IY ER Z
MONONUCLEATE	M AA N OW N UW K L IY AH T
MONONUCLEATED	M AA N OW N UW K L IY EY T IH D
MOONBEAM	M UW N B IY M
MOONBEAMS	M UW N B IY M Z
MORCEAU	M AO R S IY UW
MORCEAUX	M AO R S IY AH K S
MOVEABLE	M UW V AH B AH L
MOVEABLES	M UW V AH B AH L Z
MOVEABLY	M UW V AH B L IY
MUDDLEHEADED	M AH D AH L HH EH D AH D
MUDDLEHEADED(2)	M AH D AH L HH EH D IH D
MUDDLEHEADEDLY	M AH D AH L HH EH D AH D L IY
MUDDLEHEADEDNESS	M AH D AH L HH EH D AH D N AH S
MUDDLEHEADEDNESSES	M AH D AH L HH EH D AH D N AH S IH Z
MULTIHEADED	M AH L T AY HH EH D IH D
MULTINUCLEAR	M AH L T AY N UW K L IY ER
MULTINUCLEATE	M AH L T AY N UW K L IY AH T
MULTINUCLEATED	M AH L T AY N UW K L IY EY T IH D
MULTIWARHEAD	M AH L T AY W AO R HH EH D
MULTIYEAR	M AH L T IY Y IY R
NAILHEAD	N EY L HH EH D
NAILHEADS	N EY L HH EH D Z
NAMEABLE	N EY M AH B AH L
NASOPHARYNGEAL	N AH S AA F AH R IH N JH IY AH L
NAUSEA	N AO Z IY AH
NAUSEANT	N AO Z IY AH N T
NAUSEANTS	N AH S IY N T S
NAUSEAS	N AO Z IY AH Z
NAUSEATE	N AO Z IY EY T
NAUSEATED	N AO Z IY EY T AH D
NAUSEATES	N AO ZH IY EY T S
NAUSEATING	N AO ZH IY EY T IH NG
NAUSEATINGLY	N AO ZH IY EY T IH NG L IY
NEANDERTHAL	N IY AE N D ER TH AO L
NEANDERTHALS	N IY AE N D ER TH AO L Z
NEAP	N IY P
NEAPS	N IY P S
NEAR	N IH R
NEARBY	N IH R B AY
NEARED	N IH R D
NEARER	N IH R ER
NEAREST	N IH R AH S T
NEARING	N IH R IH NG
NEARLIER	N IH R L IY ER
NEARLIEST	N IH R L IY AH S T
NEARLY	N IH R L IY
NEARNESS	N IH ER N AH S
NEARNESSES	N IH ER N AH S IH Z
NEARS	N IH R Z
NEARSHORE	N IH ER SH OW R
NEARSIDE	N IH ER S AY D
NEARSIDES	N IH ER S AY D Z
NEARSIGHTED	N IY R S AY T IH D
NEARSIGHTEDLY	N IH ER S AY T AH D L IY
NEARSIGHTEDNESS	N IY R S AY T IH D N AH S
NEARSIGHTEDNESSES	N IH ER S AY T AH D N AH S IH Z
NEAT	N IY T
NEATEN	N IY T AH N
NEATENED	N IY T AH N D
NEATENING	N IY T AH N IH NG
NEATENS	N IY T AH N Z
NEATER	N IY T ER
NEATEST	N IY T AH S T
NEATH	N IY TH
NEATHERD	N IY T HH ER D
NEATHERDS	N IY T HH ER D Z
NEATLY	N IY T L IY
NEATNESS	N IY T N AH S
NEATNESSES	N IY T N AH S IH Z
NEATS	N IY T S
NECKWEAR	N EH K W EH R
NEMERTEAN	N AH M AH R T IY AH N
NEMERTEANS	N EH M AH R T IY N Z
NEOREALISM	N IY OW R IY L IH Z AH M
NEOREALISMS	N IY OW R IY L IH Z AH M Z
NEOREALIST	N IY OW R IY L IH S T
NEOREALISTIC	N IY OW R IY AH L IH S T IH K
NEOREALISTS	N IY OW R IY L IH S T S
NEPENTHEAN	N AH P EH N DH IY AH N
NEUROHYPOPHYSEAL	N Y UH R AH HH IH P AH F IH Z IY AH L
NEWSBREAK	N UW Z B R EY K
NEWSBREAKS	N UW Z B R EY K S
NEWSDEALER	N UW Z D IY L ER
NEWSDEALERS	N UW Z D IY L ER Z
NEWSPEAK	N UW S P IY K
NEWSPEAKS	N UW S P IY K S
NEWSREADER	N UW Z R IY D ER
NEWSREADERS	N UW Z R IY D ER Z
NIGHTWEAR	N AY T W AE ER
NONAPPEARANCE	N AA N AH P IH ER AH N S
NONAPPEARANCES	N AA N AH P IH ER AH N S IH Z
NONBEARING	N AA N B AE ER IH NG
NONBREAKABLE	N AA N B R EY K AH B AH L
NONBREATHING	N AA N B R IY DH IH NG
NONCOLLINEAR	N AA N K AH L AY N IY AH R
NONCREATIVE	N AA N K R IY EY T IH V
NONCREATIVITIES	N AA N K R IY EY T IH V AH T IY Z
NONCREATIVITY	N AA N K R IY EY T IH V AH T IY
NONDECREASING	N AA N D IH K R IY S IH NG
NONEARNING	N AA N ER N IH NG
NONEARNINGS	N AA N ER N IH NG Z
NONENFORCEABILITIES	N AA N EH N F OW R S AH B IH L AH T EH Z
NONENFORCEABILITY	N AA N EH N F OW R S AH B IH L AH T EH
NONFEASANCE	N AA N F IY Z AH N S
NONFEASANCES	N AA N F IY Z AH N S IH Z
NONGREASY	N AA N G R IY S IY
NONIDEAL	N AA N AY D IY L
NONINCREASING	N AA N IH N K R IY S IH NG
NONINTERCHANGEABLE	N AA N IH N T ER CH EY N JH AH B AH L
NONLEADED	N AA N L EH D AH D
NONLEAFY	N AA N L IY F IY
NONLEAGUE	N AA N L IY G
NONLINEAL	N AA N L IH N IY AH L
NONLINEAR	N AA N L IH N IY ER
NONLINEARITIES	N AA N L IH N IY ER AH T IY Z
NONLINEARITY	N AA N L IH N IY ER AH T IY
NONMAINSTREAM	N AA N M EY N S T R IY M
NONMALLEABLE	N AA N M AE L IY AH B AH L
NONMEANINGFUL	N AA N M IY N IH NG F AH L
NONMEASURABLE	N AA N M EH ZH ER AH B AH L
NONMEAT	N AA N M IY T
NONNUCLEAR	N AA N UW K L IY ER
NONNUCLEATED	N AA N UW K L IY EY T IH D
NONPEAK	N AA N P IY K
NONREACTIVE	N AA N R IY AE K T IH V
NONREACTOR	N AA N R IY AE K T ER
NONREACTORS	N AA N R IY AE K T ER Z
NONREADER	N AA N R IY D ER
NONREADERS	N AA N R IY D ER Z
NONREADING	N AA N R IY D IH NG
NONREALISTIC	N AA N R IY AH L IH S T IH K
NONREAPPOINTMENT	N AA N R IY AH P OY N T M AH N T
NONREAPPOINTMENTS	N AA N R IY AH P OY N T M AH N T S
NONSEASONAL	N AA N S IY Z AH N AH L
NONSPEAKER	N AA N S P IY K ER
NONSPEAKERS	N AA N S P IY K ER Z
NONSPEAKING	N AA N S P IY K IH NG
NONSTEADY	N AA N S T EH D IY
NONTEACHING	N AA N T IY CH IH NG
NONTHEATRICAL	N AA N TH IY AE T R IH K AH L
NONTHREATENING	N AA N TH R EH T AH N IH NG
NONTREATMENT	N AA N T R IY T M AH N T
NONTREATMENTS	N AA N T R IY T M AH N T S
NORTHEAST	N AO R TH IY S T
NORTHEASTER	N AO R TH IY S T ER
NORTHEASTERLY	N AO R TH IY S T ER L IY
NORTHEASTERN	N AO R TH IY S T ER N
NORTHEASTERNMOST	N AO R TH IY S T ER N M OW S T
NORTHEASTERS	N AO R TH IY S T ER Z
NORTHEASTS	N AO R TH IY S T S
NORTHEASTWARD	N AO R TH IY S T W ER D
NORTHEASTWARDS	N AO R TH IY S T W ER D Z
NOTICEABLE	N OW T AH S AH B AH L
NOTICEABLY	N OW T IH S AH B L IY
NOUVEAU	N UW V OW
NUCLEAL	N UW K L IY AH L
NUCLEAR	N UW K L IY ER
NUCLEASE	N AH K L IY Z
NUCLEASES	N AH K L IY Z AH Z
NUCLEATE	N UW K L IY AH T
NUCLEATED	N UW K L IY EY T IH D
NUCLEATES	N UW K L IY AH T S
NUCLEATING	N UW K L IY EY T IH NG
NUCLEATION	N UW K L IY EY SH AH N
NUCLEATIONS	N UW K L IY EY SH AH N Z
NUCLEATOR	N UW K L IY AH T ER
NUCLEATORS	N UW K L IY AH T ER Z
NUTMEAT	N AH T M IY T
NUTMEATS	N AH T M IY T S
NYMPHEAN	N IH M F IY AH N
OATMEAL	OW T M IY L
OATMEALS	OW T M IY L Z
OBEAH	OW B IY AH
OBEAHISM	OW B IY IH Z AH M
OBEAHISMS	OW B IY HH AH Z AH M Z
OBEAHS	OW B IY Z
OCEAN	OW SH AH N
OCEANARIA	OW S AH N AE R IY AH
OCEANARIUM	OW S AH N AE R IY AH M
OCEANARIUMS	OW S AH N AE R IY AH M Z
OCEANAUT	OW S IY N AH T
OCEANAUTS	OW S IY N AH Y UW T S
OCEANFRONT	OW SH AH N F R AH N T
OCEANFRONTS	OW SH AH N F R AH N T S
OCEANGOING	OW SH AH N G OW IH NG
OCEANIC	OW SH IY AE N IH K
OCEANOGRAPHER	OW SH AH N AA G R AH F ER
OCEANOGRAPHERS	OW S AH N AA G R AH F AH R Z
OCEANOGRAPHIC	OW SH AH N AH G R AE F IH K
OCEANOGRAPHICAL	OW SH AH N AH G R AE F IH K AH L
OCEANOGRAPHICALLY	OW SH AH N AH G R AE F IH K AH L IY
OCEANOGRAPHIES	OW SH AH N AA G R AH F IY Z
OCEANOGRAPHY	OW SH AH N AA G R AH F IY
OCEANOLOGIES	OW SH AH N AA L AH JH IY Z
OCEANOLOGIST	OW SH AH N AA L AH JH AH S T
OCEANOLOGISTS	OW SH AH N AA L AH JH AH S T S
OCEANOLOGY	OW SH AH N AA L AH JH IY
OCEANS	OW SH AH N Z
OCHREA	AA K R IY AH
OCHREAE	AA K R IY
OCREA	AA K R IY AH
OCREAE	AA K R IY
OCREATE	AA K R IY EY T
ODEA	AA D IY AH
OEDIPEAN	OW AH D AY P IY AH N
OFFBEAT	AO F B IY T
OFFBEATS	AO F B IY T S
OLEA	AA L IY AH
OLEA(2)	OW L IY
OLEAGINOUS	OW L IY AE JH AH N AH S
OLEAGINOUSLY	OW L AH JH IH N OW AH S L IY
OLEAGINOUSNESS	OW L IY JH AH N AW Z N AH S
OLEAGINOUSNESSES	OW L IY JH AH N AW Z N EH S AH Z
OLEANDER	OW L IY AE N D ER
OLEANDERS	OW L IY AE N D ER Z
OLEANDOMYCIN	OW L IY N D AA M AH S AH N
OLEANDOMYCINS	OW L IY N D AA M AH S AH N Z
OLEASTER	OW L IY AE S T ER
OLEASTERS	OW L IY S T AH R Z
OLEATE	OW L IY EY T
OLEATES	OW L IY EY T S
ONSTREAM	AO N S T R IY M
OPENHEARTED	OW P AH N HH AA R T IH D
OPENHEARTEDLY	OW P AH N HH AA R T AH D L IY
OPENHEARTEDNESS	OW P AH N HH AA R T AH D N AH S
OPENHEARTEDNESSES	OW P AH N HH AA R T AH D N AH S IH Z
ORANGEADE	AO R IH N JH EY D
ORANGEADES	AO R IH N JH EY D Z
ORDEAL	AO R D IY L
ORDEALS	AO R D IY L Z
OREAD	AH R IY D
OREADS	AH R IY D Z
ORGEAT	AO R JH IY T
ORGEATS	AO R JH IY EY T S
OROPHARYNGEAL	AH R AA F AH R IH N JH IY AH L
OSTEAL	AA S T IY AH L
OUTBEAM	AW T B IY M
OUTBEAMED	AW T B IY M D
OUTBEAMING	AW T B IY M IH NG
OUTBEAMS	AW T B IY M Z
OUTBLEAT	AW T B L IY T
OUTBLEATED	AW T B L IY T IH D
OUTBLEATING	AW T B L IY T IH NG
OUTBLEATS	AW T B L IY T S
OUTBREAK	AW T B R EY K
OUTBREAKS	AW T B R EY K S
OUTCHEAT	AW T CH IY T
OUTCHEATED	AW T CH IY T IH D
OUTCHEATING	AW T CH IY T IH NG
OUTCHEATS	AW T CH IY T S
OUTDREAM	AW T D R IY M
OUTDREAMED	AW T D R IY M D
OUTDREAMING	AW T D R IY M IH NG
OUTDREAMS	AW T D R IY M Z
OUTDREAMT	AW T D R EH M T
OUTEARN	AW T ER N
OUTEARNED	AW T ER N D
OUTEARNING	AW T ER N IH NG
OUTEARNS	AW T ER N Z
OUTEAT	AW T IY T
OUTEATEN	AW T IY T AH N
OUTEATING	AW T IY T IH NG
OUTEATS	AW T IY T S
OUTERWEAR	AW T ER W EH R
OUTFEAST	AW T F IY S T
OUTFEASTED	AW T F IY S T IH D
OUTFEASTING	AW T F IY S T IH NG
OUTFEASTS	AW T F IY S T S
OUTHEAR	AW T HH IH ER
OUTHEARD	AW T HH ER D
OUTHEARING	AW T HH IH ER IH NG
OUTHEARS	AW T HH IH ER Z
OUTLEAP	AW T L IY P
OUTLEAPED	AW T L IY P T
OUTLEAPING	AW T L IY P IH NG
OUTLEAPS	AW T L IY P S
OUTLEAPT	AW T L EH P T
OUTLEARN	AW T L ER N
OUTLEARNED	AW T L ER N D
OUTLEARNING	AW T L ER N IH NG
OUTLEARNS	AW T L ER N Z
OUTLEARNT	AW T L AH R N T
OUTPREACH	AW T P R IY CH
OUTPREACHED	AW T P R IY CH T
OUTPREACHES	AW T P R IY CH IH Z
OUTPREACHING	AW T P R IY CH IH NG
OUTREACH	AW T R IY CH
OUTREACHED	AW T R IY CH T
OUTREACHES	AW T R IY CH IH Z
OUTREACHING	AW T R IY CH IH NG
OUTREAD	AW T R IY D
OUTREADING	AW T R IY D IH NG
OUTREADS	AW T R IY D Z
OUTSPEAK	AW T S P IY K
OUTSPEAKING	AW T S P IY K IH NG
OUTSPEAKS	AW T S P IY K S
OUTSPREAD	AW T S P R EH D
OUTSPREADING	AW T S P R EH D IH NG
OUTSPREADS	AW T S P R EH D Z
OUTSWEAR	AW T S W AE ER
OUTSWEARING	AW T S W AE ER IH NG
OUTSWEARS	AW T S W AE ER Z
OUTWEAR	AW T W AE ER
OUTWEARIED	AW T W IH R IY D
OUTWEARIES	AW T W IH R IY Z
OUTWEARING	AW T W AE ER IH NG
OUTWEARS	AW T W AE ER Z
OUTWEARY	AW T W IH R IY
OUTWEARYING	AW T W IH R IY IH NG
OVERBEAR	OW V ER B AE ER
OVERBEARING	OW V ER B EH R IH NG
OVERBEARINGLY	OW V ER B AE ER IH NG L IY
OVERBEARS	OW V ER B AE ER Z
OVERBEAT	OW V ER B IY T
OVERBEATEN	OW V ER B IY T AH N
OVERBEATING	OW V ER B IY T IH NG
OVERBEATS	OW V ER B IY T S
OVERBLEACH	OW V ER B L IY CH
OVERBLEACHED	OW V ER B L IY CH T
OVERBLEACHES	OW V ER B L IY CH IH Z
OVERBLEACHING	OW V ER B L IY CH IH NG
OVERBREATHING	OW V ER B R IY DH IH NG
OVERBREATHINGS	OW V ER B R IY DH IH NG Z
OVERCLEAN	OW V ER K L IY N
OVERCLEANED	OW V ER K L IY N D
OVERCLEANING	OW V ER K L IY N IH NG
OVERCLEANS	OW V ER K L IY N Z
OVERCLEAR	OW V ER K L IH ER
OVERCLEARED	OW V ER K L IH ER D
OVERCLEARING	OW V ER K L IH ER IH NG
OVERCLEARS	OW V ER K L IH ER Z
OVERDEAR	OW V ER D IH ER
OVEREAGER	OW V ER IY G ER
OVEREAGERNESS	OW V ER IY G ER N AH S
OVEREAGERNESSES	OW V ER IY G ER N AH S IH Z
OVEREARNEST	OW V ER ER N AH S T
OVEREASY	OW V ER IY Z IY
OVEREAT	OW V ER IY T
OVEREATEN	OW V ER IY T AH N
OVEREATER	OW V ER IY T ER
OVEREATERS	OW V ER IY T ER Z
OVEREATING	OW V ER IY T IH NG
OVEREATS	OW V ER IY T S
OVERFEAR	OW V ER F IH ER
OVERFEARED	OW V ER F IH ER D
OVERFEARING	OW V ER F IH ER IH NG
OVERFEARS	OW V ER F IH ER Z
OVERHEAD	OW V ER HH EH D
OVERHEADS	OW V ER HH EH D Z
OVERHEAP	OW V ER HH IY P
OVERHEAPED	OW V ER HH IY P T
OVERHEAPING	OW V ER HH IY P IH NG
OVERHEAPS	OW V ER HH IY P S
OVERHEAR	OW V ER HH IY R
OVERHEARD	OW V ER HH ER D
OVERHEARING	OW V ER HH IY R IH NG
OVERHEARS	OW V ER HH IY R Z
OVERHEAT	OW V ER HH IY T
OVERHEATED	OW V ER HH IY T IH D
OVERHEATING	OW V ER HH IY T IH NG
OVERHEATS	OW V ER HH IY T S
OVERIDEALISTIC	OW V ER AY D IY AH L IH S T IH K
OVERIDEALIZE	OW V ER AY D IY L AY Z
OVERIDEALIZED	OW V ER AY D IY L AY Z D
OVERIDEALIZES	OW V ER AY D IY L AY Z IH Z
OVERIDEALIZING	OW V ER AY D IY L AY Z IH NG
OVERLEAF	OW V ER L IY F
OVERLEAP	OW V ER L IY P
OVERLEAPED	OW V ER L IY P T
OVERLEAPING	OW V ER L IY P IH NG
OVERLEAPS	OW V ER L IY P S
OVERLEAPT	OW V ER L EH P T
OVERLEARN	OW V ER L ER N
OVERLEARNED	OW V ER L ER N D
OVERLEARNING	OW V ER L ER N IH NG
OVERLEARNS	OW V ER L ER N Z
OVERNEAR	OW V ER N IH ER
OVERNEAT	OW V ER N IY T
OVERREACH	OW V ER R IY CH
OVERREACHED	OW V ER R IY CH T
OVERREACHER	OW V ER R IY CH ER
OVERREACHERS	OW V ER R IY CH ER Z
OVERREACHES	OW V ER R IY CH IH Z
OVERREACHING	OW V ER R IY CH IH NG
OVERREACT	OW V ER R IY AE K T
OVERREACTED	OW V ER R IY AE K T IH D
OVERREACTING	OW V ER R IY AE K T IH NG
OVERREACTION	OW V ER R IY AE K SH AH N
OVERREACTIONS	OW V ER R IY AE K SH AH N Z
OVERREACTS	OW V ER R IY AE K T S
OVERSEA	OW V ER S IY
OVERSEAS	OW V ER S IY Z
OVERSPREAD	OW V ER S P R EH D
OVERSPREADING	OW V ER S P R EH D IH NG
OVERSPREADS	OW V ER S P R EH D Z
OVERTREAT	OW V ER T R IY T
OVERTREATED	OW V ER T R IY T IH D
OVERTREATING	OW V ER T R IY T IH NG
OVERTREATMENT	OW V ER T R IY T M AH N T
OVERTREATMENTS	OW V ER T R IY T M AH N T S
OVERTREATS	OW V ER T R IY T S
OVERWEAK	OW V ER W IY K
OVERWEAR	OW V ER W AE ER
OVERWEARING	OW V ER W AE ER IH NG
OVERWEARS	OW V ER W AE ER Z
OVERWEARY	OW V ER W IH R IY
OVERZEAL	OW V ER Z IY L
OVERZEALOUS	OW V ER Z EH L AH S
OVERZEALOUSLY	OW V ER Z EH L AH S L IY
OVERZEALOUSNESS	OW V ER Z EH L AH S N AH S
OVERZEALOUSNESSES	OW V ER Z EH L AH S N AH S IH Z
OVERZEALS	OW V ER Z IY L Z
OXHEART	AA K S HH AA R T
OXHEARTS	AA K S HH AA R T S
PACKTHREAD	P AE K TH R EH D
PACKTHREADS	P AE K TH R EH D Z
PAEAN	P IY AH N
PAEANISM	P IY AH N IH Z AH M
PAEANISMS	P IY AH N IH Z AH M Z
PAEANS	P IY AH N Z
PAGEANT	P AE JH AH N T
PAGEANTRIES	P AE JH AH N T R IY Z
PAGEANTRY	P AE JH AH N T R IY
PAGEANTS	P AE JH AH N T S
PALEA	P EY L IY AH
PALEAE	P EY L IY
PALEAL	P EY L AH L
PALLBEARER	P AO L B AE ER ER
PALLBEARERS	P AO L B AE ER ER Z
PAMPEAN	P AE M P IY AH N
PAMPEANS	P AE M P IY N Z
PANACEA	P AE N AH S IY AH
PANACEAN	P AH N EY S IY AH N
PANACEAS	P AE N AH S IY AH Z
PANCREAS	P AE N K R IY AH S
PANCREASES	P AE N K R IY S IH Z
PANCREATECTOMIES	P AE NG K R AH T EH K T AH M AY Z
PANCREATECTOMIZED	P AE NG K R AH T EH K T AH M AY Z D
PANCREATECTOMY	P AE NG K R AH T EH K T AH M IY
PANCREATIC	P AE N K R IY AE T IH K
PANCREATIN	P AE NG K R IY T AH N
PANCREATINS	P AE NG K R IY T AH N Z
PANCREATITIDES	P AE NG K R IY T AH T AY D Z
PANCREATITIS	P AE N K R IY EY T AH T IY Z
PARANOEA	P AE R AH N OW AH AH
PARANOEAS	P AE R AH N OW AH AH Z
PATHBREAKING	P AE TH B R EY K IH NG
PATRILINEAL	P AE T R IH L IH N IY AH L
PEA	P IY
PEACE	P IY S
PEACEABLE	P IY S AH B AH L
PEACEABLENESS	P IY S AH B AH L N AH S
PEACEABLENESSES	P IY S AH B AH L N AH S IH Z
PEACEABLY	P IY S AH B L IY
PEACED	P IY S T
PEACEFUL	P IY S F AH L
PEACEFULLER	P IY S F AH L ER
PEACEFULLEST	P IY S F AH L AH S T
PEACEFULLY	P IY S F AH L IY
PEACEFULNESS	P IY S F AH L N AH S
PEACEFULNESSES	P IY S F AH L N AH S IH Z
PEACEKEEPER	P IY S K IY P ER
PEACEKEEPERS	P IY S K IY P ER Z
PEACEKEEPING	P IY S K IY P IH NG
PEACEKEEPINGS	P IY S K IY P IH NG Z
PEACEMAKER	P IY S M EY K ER
PEACEMAKERS	P IY S M EY K ER Z
PEACEMAKING	P IY S M EY K IH NG
PEACEMAKINGS	P IY S M EY K IH NG Z
PEACENIK	P IY S N IH K
PEACENIKS	P IY S AH N AH K S
PEACES	P IY S IH Z
PEACETIME	P IY S T AY M
PEACETIMES	P IY S T AY M Z
PEACH	P IY CH
PEACHED	P IY CH T
PEACHER	P IY CH ER
PEACHERS	P IY CH ER Z
PEACHES	P IY CH AH Z
PEACHES(2)	P IY CH IH Z
PEACHIER	P IY CH IY ER
PEACHIEST	P IY CH IY AH S T
PEACHING	P IY CH IH NG
PEACHY	P IY CH IY
PEACING	P IY S IH NG
PEACOAT	P IY K OW T
PEACOATS	P IY K OW T S
PEACOCK	P IY K AA K
PEACOCKED	P IY K AA K T
PEACOCKIER	P IY K AA K IY ER
PEACOCKIEST	P IY K AA K IY AH S T
PEACOCKING	P IY K AA K IH NG
PEACOCKISH	P IY K AA K IH SH
PEACOCKS	P IY K AA K S
PEACOCKY	P IY K AA K IY
PEAFOWL	P IY F AW L
PEAFOWLS	P IY F AW L Z
PEAG	P IY G
PEAGE	P IY AH JH
PEAGES	P IY AH JH AH Z
PEAGS	P IY AH JH Z
PEAHEN	P IY HH EH N
PEAHENS	P IY HH EH N Z
PEAK	P IY K
PEAKED	P IY K T
PEAKEDNESS	P IY K AH D N AH S
PEAKEDNESSES	P IY K AH D N AH S IH Z
PEAKIER	P IY K IY ER
PEAKIEST	P IY K IY AH S T
PEAKING	P IY K IH NG
PEAKISH	P IY K IH SH
PEAKLESS	P IY K L AH S
PEAKLIKE	P IY K L AY K
PEAKS	P IY K S
PEAKY	P IY K IY
PEAL	P IY L
PEALED	P IY L D
PEALIKE	P IY L AY K
PEALING	P IY L IH NG
PEALS	P IY L Z
PEAN	P IY AH N
PEANS	P IY N Z
PEANUT	P IY N AH T
PEANUTS	P IY N AH T S
PEAR	P EH R
PEARL	P ER L
PEARLASH	P AE ER L AE SH
PEARLASHES	P AE ER L AE SH IH Z
PEARLED	P ER L D
PEARLER	P ER L ER
PEARLERS	P ER L ER Z
PEARLESCENCE	P AH R L EH S AH N S
PEARLESCENCES	P AH R L AH S EH N S AH Z
PEARLESCENT	P AH R L EH S AH N T
PEARLIER	P ER L IY ER
PEARLIEST	P ER L IY AH S T
PEARLING	P ER L IH NG
PEARLITE	P AH R L AY T
PEARLITES	P AH R L AY T S
PEARLITIC	P AE ER L IH T IH K
PEARLIZED	P ER L AY Z D
PEARLS	P ER L Z
PEARLY	P ER L IY
PEARMAIN	P AE ER M EY N
PEARMAINS	P AE ER M EY N Z
PEARS	P EH R Z
PEART	P ER T
PEARTER	P AH R T AH R
PEARTEST	P AE ER T EH S T
PEARTLY	P AH R T L IY
PEAS	P IY Z
PEASANT	P EH Z AH N T
PEASANTRIES	P EH Z AH N T R IY Z
PEASANTRY	P EH Z AH N T R IY
PEASANTS	P EH Z AH N T S
PEASCOD	P IY Z K AA D
PEASCODS	P IY Z K AA D Z
PEASE	P IY Z
PEASE(2)	P IY S
PEASECOD	P IY S AH K AH D
PEASECODS	P IY S AH K AH D Z
PEASEN	P IY S EH N
PEASES	P IY Z IH Z
PEASHOOTER	P IY SH UW T ER
PEASHOOTERS	P IY SH UW T ER Z
PEAT	P IY T
PEATIER	P IY T IH ER
PEATIEST	P IY T AY AH S T
PEATS	P IY EY T S
PEATY	P IY T IY
PEAVEY	P IY V IY
PEAVEYS	P IY V EY Z
PEAVIES	P IY V AY Z
PEAVY	P IY V IY
PEREA	P ER IY AH
PERIGEAL	P AH R IH JH IY AH L
PERIGEAN	P AH R AY JH IY AH N
PERINEA	P AH R AH N IY AH
PERINEAL	P AH R IH N IY AH L
PERIOSTEA	P AH R AY AA S T IY AH
PERIOSTEAL	P AH R AY AA S T IY AH L
PERITONEA	P AH R AH T OW N IY AH
PERITONEAL	P AH R AH T OW N IY AH L
PERITONEALLY	P AH R IH T AH N IY L IY
PERMEABILITIES	P ER M IY AH B IH L AH T EH Z
PERMEABILITY	P ER M IY AH B IH L IH T IY
CHABLIS	SH AH B L IY
DE	D IY
DE(2)	D EY
DE(3)	D AH
JEHAD	JH EH HH AH D
KEA	K IY
VOCABLE	V OW K AH B AH L
NU	N UW
WEAVE	W IY V
