EE	IY
ABDUCTEE	AE B D AH K T IY
ABDUCTEES	AE B D AH K T IY Z
ABSENTEE	AE B S AH N T IY
ABSENTEEISM	AE B S AH N T IY IH Z AH M
ABSENTEEISMS	AE B S AH N T IY IH Z AH M Z
ABSENTEES	AE B S AH N T IY Z
ACCEPTEE	AE K S EH P T IY
ACCEPTEES	AE K S EH P T IY Z
ACKEE	AE K IY IY
ACKEES	AE K IY Z
ADDRESSEE	AE D R EH S IY
ADDRESSEES	AH D R EH S IY Z
ADEEM	AH D IY M
ADEEMED	AH D IY M D
ADEEMING	AH D IY M IH NG
ADEEMS	AH D IY M Z
ADOPTEE	AH D AA P T IY
ADOPTEES	AH D AA P T IY Z
ADVISEE	AH D V AY Z IY
ADVISEES	AH D V AY Z IY Z
AFREET	AE F R IY T
AFREETS	AE F R IY T S
AGEE	EY JH IY
AGLEE	AH G L IY
AGREE	AH G R IY
AGREEABILITIES	AH G R IY AH B IH L AH T EH Z
AGREEABILITY	AH G R IY AH B IH L AH T EH
AGREEABLE	AH G R IY AH B AH L
AGREEABLENESS	AH G R IY AH B AH L N AH S
AGREEABLENESSES	AH G R IY AH B AH L N AH S IH Z
AGREEABLY	AH G R IY AH B L IY
AGREED	AH G R IY D
AGREEING	AH G R IY IH NG
AGREEMENT	AH G R IY M AH N T
AGREEMENTS	AH G R IY M AH N T S
AGREES	AH G R IY Z
AGUEWEED	EY G Y UW W IY D
AGUEWEEDS	EY G Y UW W IY D Z
AIRSPEED	EH R S P IY D
AIRSPEEDS	AH IH R S P IY D Z
AJEE	EY JH IY IY
AKEE	EY K IY IY
AKEES	EY K IY Z
ALEE	AH L IY
ALIENEE	EY L IY AH N IY
ALIENEES	EY L IY AH N IY Z
ALLEE	AH L IY
ALLEES	AO L IY Z
ALLOTTEE	AH L AA T IY
ALLOTTEES	AH L AA T IY Z
ALLSEED	AO L S IY D
ALLSEEDS	AO L S IY D Z
AMBEER	AE M B IH R
AMBEERS	AE M B AH R Z
AMEER	EY M IH R
AMEERATE	EY M AH R EY T
AMEERATES	EY M AH R EY T S
AMEERS	EY M AH R Z
AMPUTEE	AE M P Y AH T IY
AMPUTEES	AE M P Y AH T IY Z
AMREETA	AE M R IY T AH
AMREETAS	AE M R IY T AH Z
ANISEED	AE N AH S IY D
ANISEEDS	AE N AH S T S
ANTEED	AE N T IY D
ANTIFREEZE	AE N T IY F R IY Z
ANTIFREEZES	AE N T AY F R IY Z IH Z
ANTIPROFITEERING	AE N T AY P R AA F AH T IH R IH NG
ANTIRACKETEERING	AE N T AY R AE K AH T IH R IH NG
ANTISLEEP	AE N T AY S L IY P
ANTIWEED	AE N T AY W IY D
APEEK	AH P IY K
APOGEE	AE P AH JH IY
APOGEES	AE P AH JH IY Z
APPELLEE	AH P EH L IY
APPELLEES	AH P EH L IY Z
APPOINTEE	AH P OY N T IY
APPOINTEES	AH P OY N T IY Z
APPRAISEE	AH P R EY Z IY
APPRAISEES	AH P R EY Z IY Z
ARRESTEE	AH R EH S T IY
ARRESTEES	AH R EH S T IY Z
ASLEEP	AH S L IY P
ASSIGNEE	AH S AY N IY
ASSIGNEES	AH S AY N IY Z
ATTENDEE	AH T EH N D IY
ATTENDEES	AH T EH N D IY Z
ATWEEN	AE T W IY AH N
AUCTIONEER	AA K SH AH N IH R
AUCTIONEERS	AO K SH AH N IH R Z
AWARDEE	AH W AO R D IY
AWARDEES	AH W AO R D IY Z
AWEE	AH W IY
AXLETREE	AE K S AH L T R IY
AXLETREES	AE K S AH L T R IY Z
AXSEED	AE K S IY D
AXSEEDS	AE K S IY D Z
BACKSTREET	B AE K S T R IY T
BACKSTREETS	B AE K S T R IY T S
BAILEE	B EY L IY
BAILEES	B EY L IY Z
BAKSHEESH	B AE K IY SH
BAKSHEESHES	B AE K IY SH AH Z
BALEEN	B AH L IY N
BALEENS	B EY L AH N Z
BALLADEER	B AE L AH D IH R
BALLADEERS	B AE L AH D IH R Z
BANDOLEER	B AE N D AH L IH ER
BANDOLEERS	B AE N D AH L IH ER Z
BANSHEE	B AE N SH IY
BANSHEES	B AE N SH IY Z
BARGEE	B AA R JH IY
BARGEES	B AA R JH IY Z
BARKEEP	B AA R K IY P
BARKEEPER	B AA R K IY P ER
BARKEEPERS	B AA R K IY P ER Z
BARKEEPS	B AA R K IY P S
BAUBEE	B AH B IY IY
BAUBEES	B AH B IY Z
BAWBEE	B AH B IY IY
BAWBEES	B AH B IY Z
BAYADEER	B EY EY D IH R
BAYADEERS	B EY EY D IH R Z
BEBEERU	B AH B AH EH R UW
BEBEERUS	B IH B AH IY R AH S
BEDSHEET	B EH D SH IY T
BEDSHEETS	B EH D SH IY T S
BEE	B IY
BEEBEE	B IY B IY
BEEBEES	B IY B IY Z
BEEBREAD	B IY B R EH D
BEEBREADS	B IY B R EH D Z
BEECH	B IY CH
BEECHDROPS	B IY CH D R AA P S
BEECHEN	B IY CH AH N
BEECHES	B IY CH IH Z
BEECHIER	B IY CH IY ER
BEECHIEST	B IY CH IY AH S T
BEECHNUT	B IY CH N AH T
BEECHNUTS	B IY CH N AH T S
BEECHY	B IY CH IY
BEEF	B IY F
BEEFALO	B AH EH F AH L OW
BEEFALOES	B IY F AE L OW Z
BEEFALOS	B IY F AH L AA S
BEEFCAKE	B IY F K EY K
BEEFCAKES	B IY F K EY K S
BEEFEATER	B IY F IY T ER
BEEFEATERS	B IY F IY T ER Z
BEEFED	B IY F T
BEEFIER	B IY F IY ER
BEEFIEST	B IY F IY AH S T
BEEFILY	B IY F IY L IY
BEEFING	B IY F IH NG
BEEFLESS	B IY F L AH S
BEEFS	B IY F S
BEEFSTEAK	B IY F S T EY K
BEEFSTEAKS	B IY F S T EY K S
BEEFWOOD	B IY F W UH D
BEEFWOODS	B IY F W UH D Z
BEEFY	B IY F IY
BEEHIVE	B IY HH AY V
BEEHIVES	B IY HH AY V Z
BEEKEEPER	B IY K IY P ER
BEEKEEPERS	B IY K IY P ER Z
BEEKEEPING	B IY K IY P IH NG
BEEKEEPINGS	B IY K IY P IH NG Z
BEELIKE	B IY L AY K
BEELINE	B IY L AY N
BEELINED	B IY L AY N D
BEELINES	B IY L AY N Z
BEELINING	B IY L AY N IH NG
BEEN	B IH N
BEEN(2)	B AH N
BEEP	B IY P
BEEPED	B IY P T
BEEPER	B IY P ER
BEEPERS	B IY P ER Z
BEEPING	B IY P IH NG
BEEPS	B IY P S
BEER	B IH R
BEERIER	B IY AH R IY ER
BEERIEST	B IY AH R IY AH S T
BEERS	B IH R Z
BEERY	B IH R IY
BEES	B IY Z
BEESTINGS	B IY AH S T IH NG Z
BEESWAX	B IY Z W AE K S
BEESWAXES	B IY Z W AE K S IH Z
BEESWING	B IY S W IH NG
BEESWINGS	B IY S W IH NG Z
BEET	B IY T
BEETLE	B IY T AH L
BEETLED	B IY T AH L D
BEETLER	B IY T AH L ER
BEETLERS	B IY T AH L ER Z
BEETLES	B IY T AH L Z
BEETLING	B IY T L IH NG
BEETROOT	B IY T R UW T
BEETROOTS	B IY T R UW T S
BEETS	B IY T S
BEEVES	B IH IY V Z
BEEYARD	B IY Y AA R D
BEEYARDS	B IY Y AA R D Z
BEEZER	B AH IY Z AH R
BEEZERS	B AH EH Z AH R Z
BEGGARWEED	B EH G ER W IY D
BEGGARWEEDS	B EH G ER W IY D Z
BEJEEZUS	B AH JH IY Z AH S
BELLEEK	B IH L IY K
BELLEEKS	B IH L IY K S
BENDEE	B EH N D IY
BENDEES	B EH N D IY Z
BERSEEM	B IY ER S IY M
BERSEEMS	B IY ER S IY M Z
BESCREEN	B IH S K R IY N
BESCREENED	B IH S K R IY N D
BESCREENING	B IH S K R IY N IH NG
BESCREENS	B IH S K R IY N Z
BESEECH	B IY S IY CH
BESEECHED	B IY S IY CH T
BESEECHES	B IH S IY CH IH Z
BESEECHING	B IY S IY CH IH NG
BESEECHINGLY	B IH S IY CH IH NG L IY
BESEEM	B IH S IY M
BESEEMED	B IH S IY M D
BESEEMING	B IH S IY M IH NG
BESEEMS	B IH S IY M Z
BETWEEN	B IH T W IY N
BETWEEN(2)	B IY T W IY N
BETWEENBRAIN	B IH T W IY N B R EY N
BETWEENBRAINS	B IH T W IY N B R EY N Z
BETWEENNESS	B IH T W IY N AH S
BETWEENNESSES	B IH T W IY N EH S AH Z
BETWEENTIMES	B IH T W IY N T AY M Z
BETWEENWHILES	B IH T W IY N W AH L Z
BEWEEP	B IH W IY P
BEWEEPING	B IH W IY P IH NG
BEWEEPS	B IH W IY P S
BHEESTIE	B HH IY S T AY
BHEESTIES	B HH IY S T AY Z
BHEESTY	B HH IY S T IY
BIDARKEE	B AY D AA R K IY
BIDARKEES	B AY D AA R K IY Z
BIGFEET	B IH G F IY T
BINDWEED	B AY N D W IY D
BINDWEEDS	B AY N D W IY D Z
BIOENGINEER	B AY OW EH N JH AH N IH R
BIOENGINEERED	B AY OW EH N JH AH N IH R D
BIOENGINEERING	B AY OW EH N JH AH N IH R IH NG
BIOENGINEERINGS	B AY OW AH N JH IH N AH R AH NG Z
BIOENGINEERS	B AY OW EH N JH AH N AH R Z
BIOFEEDBACK	B AY OW F IY D B AE K
BIOFEEDBACKS	B AY AH F IY D AH K S
BIOGRAPHEE	B AY AA G R AH F IY IY
BIOGRAPHEES	B AY AA G R AH F IY Z
BIRDSEED	B ER D S IY D
BIRDSEEDS	B ER D S IY D Z
BITTERSWEET	B IH T ER S W IY T
BITTERSWEETLY	B IH T ER S W IY T L IY
BITTERSWEETNESS	B IH T ER S W IY T N AH S
BITTERSWEETNESSES	B IH T ER S W IY T N AH S IH Z
BITTERSWEETS	B IH T ER S W IY T S
BITTERWEED	B IH T ER W IY D
BITTERWEEDS	B IH T ER W IY D Z
BIWEEKLIES	B AY W IY K L IY Z
BIWEEKLY	B AY W IY K L IY
BLEED	B L IY D
BLEEDER	B L IY D ER
BLEEDERS	B L IY D ER Z
BLEEDING	B L IY D IH NG
BLEEDINGS	B L IY D IH NG Z
BLEEDS	B L IY D Z
BLEEP	B L IY P
BLEEPED	B L IY P T
BLEEPING	B L IY P IH NG
BLEEPS	B L IY P S
BLUEWEED	B L UW W IY D
BLUEWEEDS	B L UW W IY D Z
BOOKKEEPER	B UH K K IY P ER
BOOKKEEPERS	B UH K K IY P ER Z
BOOKKEEPING	B UH K K IY P IH NG
BOOKKEEPINGS	B UH K IY P IH NG Z
BOOTEE	B UW T IY
BOOTEES	B UW T IY Z
BOPEEP	B OW P IY P
BOPEEPS	B OW P IY P S
BOREEN	B AO R AH N
BOREENS	B AO R AH N Z
BOTONEE	B AA T AH N IY IY
BOTONNEE	B AA T AH N IY IY
BOUCHEE	B AW CH IY IY
BOUCHEES	B AW CH IY Z
BOURREE	B AH R IY IY
BOURREES	B OW R IY Z
BOURTREE	B AH R T R IY IY
BOURTREES	B AH R T R IY Z
BREE	B R IY
BREECH	B R IY CH
BREECHBLOCK	B R IY CH B L AA K
BREECHBLOCKS	B R IY CH B L AA K S
BREECHCLOTH	B R IY CH K L AO TH
BREECHCLOTHS	B R IY CH K L AO TH S
BREECHCLOUT	B R IY CH K L AW T
BREECHCLOUTS	B R IY CH K L AW T S
BREECHED	B R IY CH T
BREECHES	B R IY CH IH Z
BREECHING	B R IY CH IH NG
BREECHINGS	B R IY CH IH NG Z
BREECHLOADER	B R IY CH L OW D ER
BREECHLOADERS	B R IY CH L OW D ER Z
BREED	B R IY D
BREEDER	B R IY D ER
BREEDERS	B R IY D ER Z
BREEDING	B R IY D IH NG
BREEDINGS	B R IY D IH NG Z
BREEDS	B R IY D Z
BREEKS	B R IY K S
BREES	B R IY Z
BREEZE	B R IY Z
BREEZED	B R IY Z D
BREEZELESS	B R IY Z L AH S
BREEZES	B R IY Z IH Z
BREEZEWAY	B R IY Z W EY
BREEZEWAYS	B R IY Z W EY Z
BREEZIER	B R IY Z IY ER
BREEZIEST	B R IY Z IY AH S T
BREEZILY	B R IY Z IY L IY
BREEZINESS	B R IY Z IY N AH S
BREEZINESSES	B R IY Z IY N AH S IH Z
BREEZING	B R IY Z IH NG
BREEZY	B R IY Z IY
BRIBEE	B R AY B IY
BRIBEES	B R AY B IY Z
BROADSHEET	B R AO D SH IY T
BROADSHEETS	B R AO D SH IY T S
BUCCANEER	B AH K AH N IY R
BUCCANEERED	B AH K EY N AH R D
BUCCANEERING	B AH K EY N AH R AH NG
BUCCANEERISH	B AH K EY N AH R AH SH
BUCCANEERS	B AH K AH N IY R Z
BUCKEEN	B AH K IY AH N
BUCKEENS	B AH K IY N Z
BUCKSHEE	B AH K IY IY
BUCKSHEES	B AH K IY Z
BUCKTEETH	B AH K T IY TH
BUDGETEER	B AH JH IH T IH R
BUDGETEERS	B AH JH IH T IH R Z
BUGLEWEED	B Y UW G AH L W IY D
BUGLEWEEDS	B Y UW G AH L W IY D Z
BUGSEED	B AH G S IY D
BUGSEEDS	B AH G S IY D Z
BULLWEED	B UH L W IY D
BULLWEEDS	B UH L W IY D Z
BUMBLEBEE	B AH M B AH L B IY
BUMBLEBEES	B AH M B AH L B IY Z
BUNGEE	B AH N JH IY
BUNGEES	B AH NG IY Z
BURGEE	B ER G IY
BURGEES	B AH R JH IY Z
BURSEED	B ER S T
BURSEEDS	B ER S T S
BURWEED	B AH R W IY D
BURWEEDS	B AH R W IY D Z
BUTTERWEED	B AH T ER W IY D
BUTTERWEEDS	B AH T ER W IY D Z
BYSTREET	B AY S T R IY T
BYSTREETS	B AY S T R IY T S
CALIPEE	K AE L AH P IY IY
CALIPEES	K AE L AH P IY Z
CALLIPEE	K AE L AH P IY IY
CALLIPEES	K AE L AH P IY Z
CAMELEER	K AE M AH L IH R
CAMELEERS	K AE M AH L IH R Z
CAMPOREE	K AE M P ER IY
CAMPOREES	K AE M P ER IY Z
CANNONEER	K AE N AH N IH R
CANNONEERS	K AE N AH N IH R Z
CANTEEN	K AE N T IY N
CANTEENS	K AE N T IY N Z
CARABINEER	K AA R AH B IH N IH R
CARABINEERS	K AA R AH B IH N IH R Z
CARAGEEN	K EH R IH JH AH N
CARAGEENS	K EH R IH JH AH N Z
CAREEN	K ER IY N
CAREENED	K ER IY N D
CAREENER	K AH R IY N ER
CAREENERS	K AH R IY N ER Z
CAREENING	K ER IY N IH NG
CAREENS	K ER IY N Z
CAREER	K ER IH R
CAREERED	K AH R IH ER D
CAREERER	K AH R IH ER ER
CAREERERS	K AH R IH ER ER Z
CAREERING	K ER IH R IH NG
CAREERISM	K ER IY R IH Z AH M
CAREERISMS	K AH R IH ER IH Z AH M Z
CAREERIST	K ER IH R IH S T
CAREERISTS	K ER IH R IH S T S
CAREERS	K ER IH R Z
CAREFREE	K EH R F R IY
CARPETWEED	K AA R P AH T W IY D
CARPETWEEDS	K AA R P AH T W IY D Z
CARRAGEEN	K AA R IH JH AH N
CARRAGEENAN	K AE R AH JH IY N AH N
CARRAGEENANS	K AE R AH JH IY N AH N Z
CARRAGEENIN	K AA R IH JH AH N IH N
CARRAGEENINS	K AA R IH JH AH N IH N Z
CARRAGEENS	K AA R IH JH AH N Z
CARRAGHEEN	K AE R AE IY AH N
CARRAGHEENS	K AE R AH IY N Z
CARTWHEEL	K AA R T W IY L
CARTWHEELED	K AA R T W IY L D
CARTWHEELER	K AA R T W IY L ER
CARTWHEELERS	K AA R T W IY L ER Z
CARTWHEELING	K AA R T W IY L IH NG
CARTWHEELS	K AA R T W IY L Z
CEE	S IY
CEES	S IY Z
CHAINWHEEL	CH EY N W IY L
CHAINWHEELS	CH EY N W IY L Z
CHANTICLEER	CH AE N T IH K L IH ER
CHANTICLEERS	CH AE N T IH K L IH ER Z
CHARIOTEER	CH AE R IY AH T IH R
CHARIOTEERS	CH AE R IY AH T IH R Z
CHEECHAKO	CH IY CH AH K OW
CHEECHAKOS	CH IY CH AH K AH Z
CHEEK	CH IY K
CHEEKBONE	CH IY K B OW N
CHEEKBONES	CH IY K B OW N Z
CHEEKED	CH IY K T
CHEEKFUL	CH IY K F AH L
CHEEKFULS	CH IY K F AH L Z
CHEEKIER	CH IY K IY ER
CHEEKIEST	CH IY K IY AH S T
CHEEKILY	CH IY K IY L IY
CHEEKINESS	CH IY K IY N AH S
CHEEKINESSES	CH IY K IY N AH S IH Z
CHEEKING	CH IY K IH NG
CHEEKS	CH IY K S
CHEEKY	CH IY K IY
CHEEP	CH IY P
CHEEPED	CH IY P T
CHEEPER	CH IY P AH R
CHEEPERS	CH IY P AH R Z
CHEEPING	CH IY P AH NG
CHEEPS	CH IY P S
CHEER	CH IH R
CHEERED	CH IH R D
CHEERER	CH IH ER ER
CHEERERS	CH IH ER ER Z
CHEERFUL	CH IH R F AH L
CHEERFULLER	CH IH ER F AH L ER
CHEERFULLEST	CH IH ER F AH L AH S T
CHEERFULLY	CH IH R F AH L IY
CHEERFULLY(2)	CH IH R F L IY
CHEERFULNESS	CH IH R F AH L N AH S
CHEERFULNESSES	CH IH ER F AH L N AH S IH Z
CHEERIER	CH IH R IY ER
CHEERIEST	CH IH R IY AH S T
CHEERILY	CH IH ER IY L IY
CHEERINESS	CH IH ER IY N AH S
CHEERINESSES	CH IH ER IY N AH S IH Z
CHEERING	CH IH R IH NG
CHEERIO	CH IH R IY OW
CHEERIOS	CH IH R IY OW S
CHEERLEAD	CH IH ER L IY D
CHEERLEADER	CH IH R L IY D ER
CHEERLEADERS	CH IH R L IY D ER Z
CHEERLEADING	CH IH R L IY D IH NG
CHEERLEADS	CH IH ER L IY D Z
CHEERLED	CH IH ER L EH D
CHEERLESS	CH IH ER L AH S
CHEERLESSLY	CH IH ER L AH S L IY
CHEERLESSNESS	CH IH ER L AH S N AH S
CHEERLESSNESSES	CH IH ER L AH S N AH S IH Z
CHEERLY	CH IH ER L IY
CHEERO	CH IH R OW
CHEEROS	CH IH ER AA S
CHEERS	CH IH R Z
CHEERY	CH IH R IY
CHEESE	CH IY Z
CHEESEBURGER	CH IY Z B ER G ER
CHEESEBURGERS	CH IY Z B ER G ER Z
CHEESECAKE	CH IY Z K EY K
CHEESECAKES	CH IY Z K EY K S
CHEESECLOTH	CH IY Z K L AO TH
CHEESECLOTHS	CH IY Z K L AO TH S
CHEESED	CH IY Z D
CHEESEPARING	CH IY Z P EH R IH NG
CHEESEPARINGS	CH IY Z P EH R IH NG Z
CHEESES	CH IY Z IH Z
CHEESIER	CH IY Z IY ER
CHEESIEST	CH IY Z IY IH S T
CHEESILY	CH IY Z IY L IY
CHEESINESS	CH IY Z IY N AH S
CHEESINESSES	CH IY Z IY N AH S IH Z
CHEESING	CH IY Z IH NG
CHEESY	CH IY Z IY
CHEETAH	CH IY T AH
CHEETAHS	CH IY T AH Z
CHICKADEE	CH IH K EY D IY
CHICKADEES	CH IH K EY D IY Z
CHICKAREE	CH IH K ER IY
CHICKAREES	CH IH K ER IY Z
CHICKEE	CH IH K IY
CHICKEES	CH IH K IY Z
CHICKWEED	CH IH K W IY D
CHICKWEEDS	CH IH K W IY D Z
CHIMPANZEE	CH IH M P AE N Z IY
CHIMPANZEES	CH IH M P AE N Z IY Z
CHINCHERINCHEE	CH IH NG K AH R AH N CH IY IY
CHINCHERINCHEES	CH IH NG K AH R IH NG K IY Z
CHIVAREE	CH AY V ER IY
CHIVAREED	CH IH V AH R IY D
CHIVAREEING	CH AY V ER IY IH NG
CHIVAREES	CH AY V ER IY Z
CHUTNEE	CH AH T N IY IY
CHUTNEES	CH AH T N IY Z
CICOREE	S IH K AH R IY IY
CICOREES	S IH K AH R IY Z
CLEEK	K L IY K
CLEEKED	K L IY K T
CLEEKING	K L IY K AH NG
CLEEKS	K L IY K S
CLIPSHEET	K L IH P SH IY T
CLIPSHEETS	K L IH P SH IY T S
CLUBFEET	K L AH B F IY T
COATEE	K OW T IY
COATEES	K OW T IY Z
COFFEE	K AA F IY
COFFEE(2)	K AO F IY
COFFEECAKE	K AO F IY K EY K
COFFEECAKES	K AO F IY K EY K S
COFFEEHOUSE	K AO F IY HH AW S
COFFEEHOUSES	K AO F IY HH AW S IH Z
COFFEEMAKER	K AO F IY M EY K ER
COFFEEMAKERS	K AO F IY M EY K ER Z
COFFEEPOT	K AO F IY P AA T
COFFEEPOTS	K AO F IY P AA T S
COFFEES	K AO F IY Z
COGWHEEL	K AA G W IY L
COGWHEELS	K AA G W IY L Z
COLESEED	K OW L S IY D
COLESEEDS	K OW L S IY D Z
COLESSEE	K OW L EH S IY
COLESSEES	K OW L EH S IY Z
COLLEEN	K AA L IY N
COLLEENS	K AA L IY N Z
COMMANDEER	K AA M AH N D IH R
COMMANDEERED	K AA M AH N D IH R D
COMMANDEERING	K AA M AH N D IH ER IH NG
COMMANDEERS	K AA M AH N D IH ER Z
COMMITTEE	K AH M IH T IY
COMMITTEEMAN	K AH M IH T IY M AH N
COMMITTEEMEN	K AH M IH T IY M EH N
COMMITTEES	K AH M IH T IY Z
COMMITTEEWOMAN	K AH M IH T IY W UH M AH N
COMMITTEEWOMEN	K AH M IH T IY W IH M AH N
COMMUNICATEE	K AH M Y UW N AH K AH T IY
COMMUNICATEES	K AH M Y UW N AH K AH T IY Z
COMPEER	K AH M P IH ER
COMPEERED	K AH M P IH ER D
COMPEERING	K AH M P IH ER IH NG
COMPEERS	K AH M P IH ER Z
CONFEREE	K AA N F ER IY
CONFEREES	K AA N F ER IY Z
CONGEE	K AA N JH IY IY
CONGEED	K AA N JH IY D
CONGEEING	K AA N JH IY AH NG
CONGEES	K AA N JH IY Z
CONOMINEE	K OW N AA M AH N IY
CONOMINEES	K OW N AA M AH N IY Z
CONSIGNEE	K AH N S AY N IY
CONSIGNEES	K AH N S AY N IY Z
CONTACTEE	K AA N T AE K T IY
CONTACTEES	K AA N T AE K T IY Z
CONVENTIONEER	K AH N V EH N SH AH N IH R
CONVENTIONEERS	K AH N V EH N SH AH N IH R Z
COOEE	K UW IY
COOEED	K OW OW AH T
COOEEING	K UW IY IH NG
COOEES	K UW IY Z
COREDEEM	K OW R IY D IY M
COREDEEMED	K OW R IY D IY M D
COREDEEMING	K OW R IY D IY M IH NG
COREDEEMS	K OW R IY D IY M Z
CORROBOREE	K AH R AA B AH R IY
CORROBOREES	K AH R AA B AH R IY Z
CORVEE	K AO R V IY IY
CORVEES	K AA R V IY Z
CORYPHEE	K OW R AH F IY IY
CORYPHEES	K OW R AH F IY Z
COTRUSTEE	K OW T R AH S T IY
COTRUSTEES	K OW T R AH S T IY Z
COTTONSEED	K AA T AH N S IY D
COTTONSEEDS	K AA T AH N S IY D Z
COTTONWEED	K AA T AH N W IY D
COTTONWEEDS	K AA T AH N W IY D Z
COULEE	K UW L IY
COULEES	K OW Y AH L IY Z
COUNSELEE	K AW N S AH L IY
COUNSELEES	K AW N S AH L IY Z
COVENANTEE	K AH V AH N AH N T IY
COVENANTEES	K AH V AH N AH N T IY Z
CRAZYWEED	K R EY Z IY W IY D
CRAZYWEEDS	K R EY Z IY W IY D Z
CREED	K R IY D
CREEDAL	K R IY D AH L
CREEDS	K R IY D Z
CREEK	K R IY K
CREEKS	K R IY K S
CREEL	K R IY L
CREELED	K R IY L D
CREELING	K R IY L AH NG
CREELS	K R IY L Z
CREEP	K R IY P
CREEPAGE	K R IY P IH JH
CREEPAGES	K R IY P IH JH IH Z
CREEPER	K R IY P ER
CREEPERS	K R IY P ER Z
CREEPIE	K R IY P IY
CREEPIER	K R IY P IY ER
CREEPIES	K R IY P IY Z
CREEPIEST	K R IY P IY AH S T
CREEPILY	K R IY P IY L IY
CREEPINESS	K R IY P IY N IH S
CREEPINESSES	K R IY P IY N AH S IH Z
CREEPING	K R IY P IH NG
CREEPS	K R IY P S
CREEPY	K R IY P IY
CREESE	K R IY Z
CREESES	K R IY Z AH Z
CREESH	K R IY SH
CREESHED	K R IY SH T
CREESHES	K R IY SH AH Z
CREESHING	K R IY SH AH NG
CROSSBREED	K R AO S B R IY D
CROSSBREEDING	K R AO S B R IY D IH NG
CROSSBREEDS	K R AO S B R IY D Z
CROSSTREES	K R AO S T R IY Z
CROWFEET	K R OW F IY T
CROWKEEPER	K R OW K IY P ER
CROWKEEPERS	K R OW K IY P ER Z
CUDWEED	K AH D W IY D
CUDWEEDS	K AH D W IY D Z
DANEWEED	D AE N Y UW IY D
DANEWEEDS	D AE N Y UW IY D Z
DASHEEN	D AE SH IY AH N
DASHEENS	D AH SH IY N Z
DEBAUCHEE	D AH B AO CH IY
DEBAUCHEES	D AH B AO CH IY Z
DECREE	D IH K R IY
DECREED	D IH K R IY D
DECREEING	D IH K R IY IH NG
DECREER	D EH K R IH R
DECREERS	D IH K R IH R Z
DECREES	D IH K R IY Z
DEDICATEE	D EH D IH K AH T IY
DEDICATEES	D EH D IH K AH T IY Z
DEE	D IY
DEED	D IY D
DEEDED	D IY D AH D
DEEDED(2)	D IY D IH D
DEEDIER	D IY D IY ER
DEEDIEST	D IY D IY AH S T
DEEDING	D IY D IH NG
DEEDLESS	D IY D L AH S
DEEDS	D IY D Z
DEEDY	D IY D IY
DEEJAY	D IY EH JH EY IY
DEEJAYS	D IY AH JH EY Z
DEEM	D IY M
DEEMED	D IY M D
DEEMING	D IY M IH NG
DEEMPHASIZE	D IY EH M F AH S AY Z
DEEMPHASIZED	D IY EH M F AH S AY Z D
DEEMPHASIZES	D IY EH M F AH S AY Z IH Z
DEEMPHASIZING	D IY EH M F AH S AY Z IH NG
DEEMS	D IY M Z
DEEMSTER	D IY M S T ER
DEEMSTERS	D IY M S T ER Z
DEEP	D IY P
DEEPEN	D IY P AH N
DEEPENED	D IY P AH N D
DEEPENER	D IY P AH N ER
DEEPENERS	D IY P AH N ER Z
DEEPENING	D IY P AH N IH NG
DEEPENS	D IY P AH N Z
DEEPER	D IY P ER
DEEPEST	D IY P AH S T
DEEPLY	D IY P L IY
DEEPNESS	D IY P N AH S
DEEPNESSES	D IY P N AH S IH Z
DEEPS	D IY P S
DEEPWATER	D IY P W AO T ER
DEER	D IH R
DEERBERRIES	D IH ER B EH R IY Z
DEERBERRY	D IH ER B EH R IY
DEERFLIES	D IH ER F L AY Z
DEERFLY	D IH ER F L AY
DEERHOUND	D IH ER HH AW N D
DEERHOUNDS	D IH ER HH AW N D Z
DEERLIKE	D IH ER L AY K
DEERS	D IH ER Z
DEERSKIN	D IH R S K IH N
DEERSKINS	D IH ER S K IH N Z
DEERSTALKER	D IH ER S T AO K ER
DEERSTALKERS	D IH ER S T AO K ER Z
DEERWEED	D IH ER W IY D
DEERWEEDS	D IH ER W IY D Z
DEERYARD	D IH ER Y AA R D
DEERYARDS	D IH ER Y AA R D Z
DEES	D IY Z
DEESCALATE	D IY EH S K AH L EY T
DEESCALATED	D IY EH S K AH L EY T IH D
DEESCALATES	D IY EH S K AH L EY T S
DEESCALATING	D IY EH S K AH L EY T IH NG
DEESCALATION	D IY EH S K AH L EY SH AH N
DEESCALATIONS	D IY EH S K AH L EY SH AH N Z
DEET	D IY T
DEETS	D IY T S
DEEWAN	D IY Y UW AH N
DEEWANS	D IY Y UW AH N Z
DEGREE	D IH G R IY
DEGREED	D IH G R IY D
DEGREES	D IH G R IY Z
DELEGATEE	D IY L EH G AH T IY
DELEGATEES	D IY L EH G AH T IY Z
DEPARTEE	D IY P AA R T IY
DEPARTEES	D IY P AA R T IY Z
DEPORTEE	D IY P AO R T IY
DEPORTEES	D IY P AO R T IY Z
DESIGNEE	D EH Z IH G N IY
DESIGNEES	D EH Z IH G N IY Z
DETAINEE	D IY T EY N IY
DETAINEES	D IH T EY N IY Z
DEVISEE	D IY V IH Z IY
DEVISEES	D IY V IH Z IY Z
DEVOTEE	D EH V AH T IY
DEVOTEES	D EH V AH T IY Z
DISAGREE	D IH S AH G R IY
DISAGREEABLE	D IH S AH G R IY AH B AH L
DISAGREEABLENESS	D IH S AH G R IY AH B AH L N AH S
DISAGREEABLENESSES	D IH S AH G R IY AH B AH L N AH S IH Z
DISAGREEABLY	D IH S AH G R IY AH B L IY
DISAGREED	D IH S AH G R IY D
DISAGREEING	D IH S AH G R IY IH NG
DISAGREEMENT	D IH S AH G R IY M AH N T
DISAGREEMENTS	D IH S AH G R IY M AH N T S
DISAGREES	D IH S AH G R IY Z
DISCHARGEE	D IH S CH AA R JH IY
DISCHARGEES	D IH S CH AA R JH IY Z
DISCREET	D IH S K R IY T
DISCREETER	D IH S K R IY T ER
DISCREETEST	D IH S K R IY T AH S T
DISCREETLY	D IH S K R IY T L IY
DISCREETNESS	D IH S K R IY T N AH S
DISCREETNESSES	D IH S K R IY T N AH S IH Z
DISESTEEM	D IH S IH S T IY M
DISESTEEMED	D IH S IH S T IY M D
DISESTEEMING	D IH S IH S T IY M IH NG
DISESTEEMS	D IH S IH S T IY M Z
DISTRIBUTEE	D IH S T R IH B Y UW T IY
DISTRIBUTEES	D IH S T R IH B Y UW T IY Z
DIVORCEE	D AH V AO R S IY
DIVORCEE(2)	D AH V AO R S EY
DIVORCEES	D AH V OW R S IY Z
DOGTEETH	D AO G T IY TH
DOMINEER	D AA M AH N IH R
DOMINEERED	D AA M AH N IH R D
DOMINEERING	D AA M AH N IH R IH NG
DOMINEERINGLY	D AA M AH N IH R IH NG L IY
DOMINEERINGNESS	D AA M AH N IY R IH NG N AH S
DOMINEERINGNESSES	D AA M AH N IY R IH NG N AH S IH Z
DOMINEERS	D AA M AH N IH R Z
DONEE	D AA N IY
DONEES	D AA N IY Z
DONNEE	D AA N IY
DONNEES	D AA N IY Z
DOOLEE	D UW L IY IY
DOOLEES	D UW L IY Z
DOORKEEPER	D AO R K IY P ER
DOORKEEPERS	D OW R K IY P ER Z
DRAFTEE	D R AE F T IY
DRAFTEES	D R AE F T IY Z
DRAGEE	D R AE G IY
DRAGEES	D R AE G IY Z
DRAWEE	D R AO IY
DRAWEES	D R AO IY Z
DREE	D R IY
DREED	D R IY D
DREEING	D R IY AH NG
DREES	D R IY Z
DUCKWEED	D AH K W IY D
DUCKWEEDS	D AH K W IY D Z
DUDEEN	D Y UW D IY AH N
DUDEENS	D Y UW D IY N Z
DUNGAREE	D AH NG ER IY
DUNGAREES	D AH NG ER IY Z
DWEEB	D W IY B
DWEEBS	D W IY B Z
DYEWEED	D AY W IY D
DYEWEEDS	D AY W IY D Z
EEL	IY L
EELGRASS	IY L G R AE S
EELGRASSES	IY L G R AE S IH Z
EELIER	IY L IY ER
EELIEST	IY L IY AH S T
EELLIKE	IY L L AY K
EELPOUT	IY L P AW T
EELPOUTS	IY L P AW T S
EELS	IY L Z
EELWORM	IY L W ER M
EELWORMS	IY L W ER M Z
EELY	IY L IY
EERIE	IH R IY
EERIER	IH R IY ER
EERIEST	IH R IY AH S T
EERILY	IH R AH L IY
EERINESS	IH R AH N AH S
EERINESSES	IH R AH N EH S AH Z
EERY	IY AH R IY
EIGHTEEN	EY T IY N
EIGHTEENS	EY T IY N Z
EIGHTEENTH	EY T IY N TH
EIGHTEENTHS	EY T IY N TH S
ELECTEE	IH L EH K T IY
ELECTEES	IH L EH K T IY Z
ELECTIONEER	IH L EH K SH AH N IH R
ELECTIONEERED	IH L EH K SH AH N IH R D
ELECTIONEERER	IH L EH K SH AH N IH R ER
ELECTIONEERERS	IH L EH K SH AH N IH R ER Z
ELECTIONEERING	IH L EH K SH AH N IH R IH NG
ELECTIONEERS	IH L EH K SH AH N IH R Z
ELEEMOSYNARY	IY L IY M AH S AH N EH R IY
EMCEE	EH M S IY
EMCEED	IH M S IY D
EMCEEING	EH M S IY IH NG
EMCEES	EH M S IY Z
EMEER	IY M IH R
EMEERATE	IH M AH R EY T
EMEERATES	IH M AH R EY T S
EMEERS	AH M IH R Z
EMPLOYEE	EH M P L OY IY
EMPLOYEE(2)	IH M P L OY IY
EMPLOYEES	EH M P L OY IY Z
EMPLOYEES(2)	IH M P L OY IY Z
ENDORSEE	IH N D AO R S IY
ENDORSEES	IH N D AO R S IY Z
ENFEEBLE	EH N F IY B AH L
ENFEEBLED	EH N F IY B AH L D
ENFEEBLEMENT	EH N F IY B AH L M AH N T
ENFEEBLEMENTS	EH N F IY B AH L M AH N T S
ENFEEBLES	EH N F IY B AH L Z
ENFEEBLING	EH N F IY B AH L IH NG
ENGINEER	EH N JH AH N IH R
ENGINEERED	EH N JH AH N IY R D
ENGINEERING	EH N JH AH N IH R IH NG
ENGINEERINGS	EH N JH AH N IH R IH NG Z
ENGINEERS	EH N JH AH N IH R Z
ENLISTEE	EH N L IH S T IY
ENLISTEES	EH N L IH S T IY Z
ENNUYEE	IH N Y UW AY IY IY
ENROLLEE	EH N R OW L IY
ENROLLEES	EH N R OW L IY Z
ENSHRINEE	EH N SH R AY N IY
ENSHRINEES	EH N SH R AY N IY Z
ENTREE	AA N T R EY
ENTREES	AA N T R EY Z
ENWHEEL	EH N W IY L
ENWHEELED	EH N W IY L D
ENWHEELING	EH N W IY L IH NG
ENWHEELS	EH N W IY L Z
EPEE	IY P IY IY
EPEEIST	IY P IY AH S T
EPEEISTS	IY P IY AH S T S
EPEES	IY P IY Z
EPOPEE	EH P AH P IY IY
EPOPEES	EH P AH P IY Z
ESCAPEE	IH S K EY P IY
ESCAPEES	IH S K EY P IY Z
ESTEEM	EH S T IY M
ESTEEMED	EH S T IY M D
ESTEEMING	IH S T IY M IH NG
ESTEEMS	IH S T IY M Z
ETOUFFEE	AH T AW F IY IY
ETOUFFEES	AH T AW F IY Z
ETWEE	EH T W IY IY
ETWEES	EH T W IY Z
EVACUEE	IH V AE K Y UW IY
EVACUEE(2)	IY V AE K Y UW IY
EVACUEES	IH V AE K Y UW IY Z
EVACUEES(2)	IY V AE K Y UW IY Z
EVERGREEN	EH V ER G R IY N
EVERGREENS	EH V ER G R IY N Z
EVICTEE	IH V IH K T IY
EVICTEES	IH V IH K T IY Z
EXAMINEE	EH G Z AE M AH N IY
EXAMINEES	EH G Z AE M AH N IY Z
EXCEED	IH K S IY D
EXCEEDED	IH K S IY D AH D
EXCEEDED(2)	IH K S IY D IH D
EXCEEDER	IH K S IY D ER
EXCEEDERS	IH K S IY D ER Z
EXCEEDING	IH K S IY D IH NG
EXCEEDINGLY	IH K S IY D IH NG L IY
EXCEEDS	IH K S IY D Z
EXPELLEE	IH K S P EH L IY
EXPELLEES	IH K S P EH L IY Z
EYETEETH	AY T IY TH
FAKEER	F EY K IH R
FAKEERS	F EY K IH R Z
FARSEEING	F AA R S IY IH NG
FEDAYEE	F EH D EY IY IY
FEDAYEEN	F AH D EY IY AH N
FEE	F IY
FEEBLE	F IY B AH L
FEEBLEMINDED	F IY B AH L M AY N D IH D
FEEBLEMINDEDLY	F IY B AH L M AY N D AH D L IY
FEEBLEMINDEDNESS	F IY B AH L M AY N D AH D N AH S
FEEBLEMINDEDNESSES	F IY B AH L M AY N D AH D N AH S IH Z
FEEBLENESS	F IY B AH L N AH S
FEEBLENESSES	F IY B AH L N AH S IH Z
FEEBLER	F IY B AH L ER
FEEBLEST	F IY B AH L AH S T
FEEBLISH	F IY B AH L IH SH
FEEBLY	F IY B L IY
FEED	F IY D
FEEDABLE	F IY D AH B AH L
FEEDBACK	F IY D B AE K
FEEDBACKS	F IY D B AE K S
FEEDBAG	F IY D B AE G
FEEDBAGS	F IY D B AE G Z
FEEDBOX	F IY D B AA K S
FEEDBOXES	F IY D B AA K S IH Z
FEEDER	F IY D ER
FEEDERS	F IY D ER Z
FEEDHOLE	F IY D HH OW L
FEEDHOLES	F IY D HH OW L Z
FEEDING	F IY D IH NG
FEEDINGS	F IY D IH NG Z
FEEDLOT	F IY D L AA T
FEEDLOTS	F IY D L AA T S
FEEDS	F IY D Z
FEEDSTOCK	F IY D S T AA K
FEEDSTOCKS	F IY D S T AA K S
FEEDSTUFF	F IY D S T AH F
FEEDSTUFFS	F IY D S T AH F S
FEEING	F IY IH NG
FEEL	F IY L
FEELER	F IY L ER
FEELERS	F IY L ER Z
FEELESS	F IY L AH S
FEELING	F IY L IH NG
FEELINGLY	F IY L IH NG L IY
FEELINGNESS	F IY L IH NG N AH S
FEELINGNESSES	F IY L IH NG N AH S IH Z
FEELINGS	F IY L IH NG Z
FEELS	F IY L Z
FEES	F IY Z
FEET	F IY T
FEETFIRST	F IY T F ER S T
FEETLESS	F IY T L AH S
FEEZE	F IY Z
FEEZED	F IY Z D
FEEZES	F IY Z AH Z
FEEZING	F IY Z IH NG
FELLAHEEN	F EH L AE HH IY AH N
FENUGREEK	F EH N UW G R IY K
FENUGREEKS	F EH N Y AH G R IY K S
FEOFFEE	F IY AH F IY IY
FEOFFEES	F IY AA F IY Z
FIANCEE	F IY AE N S IY
FIANCEES	F IY AA N S EY IY Z
FICTIONEER	F IH K SH AH N IH R
FICTIONEERING	F IH K SH AH N IH R IH NG
FICTIONEERINGS	F IH K SH AH N IH R IH NG Z
FICTIONEERS	F IH K SH AH N IH R Z
FIFTEEN	F IH F T IY N
FIFTEENS	F IH F T IY N Z
FIFTEENTH	F IH F T IY N TH
FIFTEENTHS	F IH F T IY N TH S
FILAGREE	F IH L AH G R IY IY
FILAGREED	F AH L AE G R IY D
FILAGREEING	F AH L AE G R IY AH NG
FILAGREES	F AH L AE G R IY Z
FILAREE	F AY L ER IY
FILAREES	F AY L ER IY Z
FILIGREE	F IH L AH G R IY
FILIGREED	F AH L IH G R IY D
FILIGREEING	F IH L AH G R IY IH NG
FILIGREES	F IH L AH G R IY Z
FIREWEED	F AY ER W IY D
FIREWEEDS	F AY ER W IY D Z
FITCHEE	F IH CH IY
FLAMBEE	F L AE M B IY IY
FLAMBEED	F L AE M IY D
FLATFEET	F L AE T F IY T
FLAXSEED	F L AE K S IY D
FLAXSEEDS	F L AE K S IY D Z
FLEE	F L IY
FLEECE	F L IY S
FLEECED	F L IY S T
FLEECER	F L IY S AH R
FLEECERS	F L IY S AH R Z
FLEECES	F L IY S IH Z
FLEECH	F L IY CH
FLEECHED	F L IY CH T
FLEECHES	F L IY CH AH Z
FLEECHING	F L IY CH AH NG
FLEECIER	F L IY S AY AH R
FLEECIEST	F L IY S AY AH S T
FLEECILY	F L IY S AH L IY
FLEECING	F L IY S IH NG
FLEECY	F L IY S IY
FLEEING	F L IY IH NG
FLEER	F L IH R
FLEERED	F L IY R EH D
FLEERING	F L IY R IH NG
FLEERINGLY	F L IY R IH NG L IY
FLEERS	F L IH R Z
FLEES	F L IY Z
FLEET	F L IY T
FLEETED	F L IY T IH D
FLEETER	F L IY T ER
FLEETEST	F L IY T AH S T
FLEETING	F L IY T IH NG
FLEETINGLY	F L IY T IH NG L IY
FLEETINGNESS	F L IY T IH NG N AH S
FLEETINGNESSES	F L IY T IH NG N AH S IH Z
FLEETLY	F L IY T L IY
FLEETNESS	F L IY T N AH S
FLEETNESSES	F L IY T N AH S IH Z
FLEETS	F L IY T S
FLYWHEEL	F L AY W IY L
FLYWHEELS	F L AY W IY L Z
FOREFEEL	F OW R F IY L
FOREFEELING	F OW R F IY L IH NG
FOREFEELS	F OW R F IY L Z
FOREFEET	F OW R F IY T
FORESEE	F AO R S IY
FORESEEABILITIES	F OW R S IY AH B IH L AH T EH Z
FORESEEABILITY	F OW R S IY AH B IH L AH T EH
FORESEEABLE	F AO R S IY AH B AH L
FORESEEING	F AO R S IY IH NG
FORESEEN	F AO R S IY N
FORESEER	F OW R Z IH R
FORESEERS	F OW R Z IH R Z
FORESEES	F AO R S IY Z
FORESHEET	F OW R SH IY T
FORESHEETS	F OW R SH IY T S
FORMEE	F AO R M IY
FOURCHEE	F AH R CH IY IY
FOURTEEN	F AO R T IY N
FOURTEENER	F OW R T IY N ER
FOURTEENERS	F OW R T IY N ER Z
FOURTEENS	F AO R T IY N Z
FOURTEENTH	F AO R T IY N TH
FOURTEENTHS	F OW R T IY N TH S
FRANCHISEE	F R AE N CH AY Z IY
FRANCHISEES	F R AE N CH AY Z IY Z
FREE	F R IY
FREEBASE	F R IY B EY S
FREEBASED	F R IY B EY S T
FREEBASER	F R IY B EY S ER
FREEBASERS	F R IY B EY S ER Z
FREEBASES	F R IY B EY S IH Z
FREEBASING	F R IY B EY S IH NG
FREEBEE	F R IY B IY
FREEBEES	F R IY B IY Z
FREEBIE	F R IY B IY
FREEBIES	F R IY B IY Z
FREEBOARD	F R IY B OW R D
FREEBOARDS	F R IY B OW R D Z
FREEBOOT	F R IY B UW T
FREEBOOTED	F R IY B UW T IH D
FREEBOOTER	F R IY B UW T ER
FREEBOOTERS	F R IY B UW T ER Z
FREEBOOTING	F R IY B UW T IH NG
FREEBOOTS	F R IY B UW T S
FREEBORN	F R IY B ER N
FREED	F R IY D
FREEDMAN	F R IY D M AH N
FREEDMEN	F R IY D M AH N
FREEDOM	F R IY D AH M
FREEDOMS	F R IY D AH M Z
FREEDWOMAN	F R IY D W AH M AH N
FREEDWOMEN	F R IY D W AH M AH N
FREEFORM	F R IY F AO R M
FREEHAND	F R IY HH AE N D
FREEHANDED	F R IY HH AE N D IH D
FREEHANDEDLY	F R IY HH AE N D AH D L IY
FREEHANDEDNESS	F R IY HH AE N D AH D N AH S
FREEHANDEDNESSES	F R IY HH AE N D AH D N AH S IH Z
FREEHEARTED	F R IY HH AA R T IH D
FREEHEARTEDLY	F R IY HH AA R T AH D L IY
FREEHOLD	F R IY HH OW L D
FREEHOLDER	F R IY HH OW L D ER
FREEHOLDERS	F R IY HH OW L D ER Z
FREEHOLDS	F R IY HH OW L D Z
FREEING	F R IY IH NG
FREELANCE	F R IY L AE N S
FREELANCED	F R IY L AE N S T
FREELANCER	F R IY L AE N S ER
FREELANCERS	F R IY L AE N S ER Z
FREELANCES	F R IY L AE N S IH Z
FREELANCING	F R IY L AE N S IH NG
FREELOAD	F R IY L OW D
FREELOADED	F R IY L OW D IH D
FREELOADER	F R IY L OW D ER
FREELOADERS	F R IY L OW D ER Z
FREELOADING	F R IY L OW D IH NG
FREELOADS	F R IY L OW D Z
FREELY	F R IY L IY
FREEMAN	F R IY M AH N
FREEMARTIN	F R IY M AA R T AH N
FREEMARTINS	F R IY M AA R T AH N Z
FREEMASONRIES	F R IY M EY S AH N R IY Z
FREEMASONRY	F R IY M EY S AH N R IY
FREEMEN	F R IY M EH N
FREENESS	F R IY N AH S
FREENESSES	F R IY N AH S IH Z
FREER	F R IY ER
FREERS	F R IH R Z
FREES	F R IY Z
FREESIA	F R IY ZH IY AH
FREESIAS	F R IY S IY AH Z
FREEST	F R IY IH S T
FREESTANDING	F R IY S T AE N D IH NG
FREESTONE	F R IY S T OW N
FREESTONES	F R IY S T OW N Z
FREESTYLE	F R IY S T AY L
FREESTYLER	F R IY S T AY L ER
FREESTYLERS	F R IY S T AY L ER Z
FREESTYLES	F R IY S T AY L Z
FREETHINKER	F R IY TH IH NG K ER
FREETHINKERS	F R IY TH IH NG K ER Z
FREETHINKING	F R IY TH IH NG K IH NG
FREETHINKINGS	F R IY TH IH NG K IH NG Z
FREEWARE	F R IY W EH R
FREEWARES	F R IY W EH R Z
FREEWAY	F R IY W EY
FREEWAYS	F R IY W EY Z
FREEWHEEL	F R IY W IY L
FREEWHEELED	F R IY W IY L D
FREEWHEELER	F R IY W IY L ER
FREEWHEELERS	F R IY W IY L ER Z
FREEWHEELING	F R IY W IY L IH NG
FREEWHEELING(2)	F R IY HH W IY L IH NG
FREEWHEELINGLY	F R IY W IY L IH NG L IY
FREEWHEELS	F R IY W IY L Z
FREEWILL	F R IY W IH L
FREEWRITING	F R IY R AY T IH NG
FREEWRITINGS	F R IY R AY T IH NG Z
FREEZE	F R IY Z
FREEZER	F R IY Z ER
FREEZERS	F R IY Z ER Z
FREEZES	F R IY Z IH Z
FREEZING	F R IY Z IH NG
FREEZINGLY	F R IY Z IH NG L IY
FRICASSEE	F R IH K AH S IY IY
FRICASSEED	F R AH K AE S IY D
FRICASSEEING	F R AH K AE S IY AH NG
FRICASSEES	F R AH K AE S IY Z
FRISBEE	F R IH S B IY
FRISBEES	F R AY Z B IY Z
FRISEE	F R AY Z IY
FRISEES	F R AY Z IY Z
FUSEE	F Y UW Z IY
FUSEES	F Y UW Z IY Z
FUSILEER	F Y UW Z AH L IH R
FUSILEERS	F Y UW Z AH L IH R Z
FUZEE	F Y UW Z IY IY
FUZEES	F Y UW Z IY Z
GADGETEER	G AE JH AH T IH R
GADGETEERS	G AE JH AH T IH R Z
GALILEE	G AE L AH L IY
GALILEES	G AE L AH L IY Z
GAMEKEEPER	G EY M K IY P ER
GAMEKEEPERS	G EY M K IY P ER S
GAPESEED	G EY P S IY D
GAPESEEDS	G EY P S IY D Z
GARNISHEE	G AA R N AH SH IY IY
GARNISHEED	G AA R N AH SH IY D
GARNISHEEING	G AA R N IH SH IY AH NG
GARNISHEES	G AA R N AH SH IY Z
GATEKEEPER	G EY T K IY P ER
GATEKEEPERS	G EY T K IY P ER Z
GATEKEEPING	G EY T K IY P IH NG
GAZETTEER	G AH Z EH T IH R
GAZETTEERS	G AH Z EH T IH R Z
GEARWHEEL	G IH ER W IY L
GEARWHEELS	G IH ER W IY L Z
GEE	JH IY
GEED	JH IY D
GEEGAW	JH IY G AH
GEEGAWS	JH IY G AH Z
GEEING	JH IY IH NG
GEEK	G IY K
GEEKIER	JH IY K AY AH R
GEEKIEST	JH IY K AY AH S T
GEEKS	G IY K S
GEEKY	G IY K IY
GEEPOUND	JH IY P AW N D
GEEPOUNDS	JH IY P AW N D Z
GEES	JH IY S
GEESE	G IY S
GEEST	JH IY AH S T
GEESTS	JH IY S T S
GEEZ	JH IY Z
GEEZER	JH IY Z AH R
GEEZERS	JH IY Z AH R Z
GELEE	JH EH L IY
GELEES	JH EH L IY Z
GENTEEL	JH EH N T IY L
GENTEELER	JH EH N T IY L ER
GENTEELEST	JH EH N T IY L AH S T
GENTEELISM	JH EH N T IY L IH Z AH M
GENTEELISMS	JH EH N T IY L IH Z AH M Z
GENTEELLY	JH EH N T IY L IY
GENTEELNESS	JH EH N T IY L N AH S
GENTEELNESSES	JH EH N T IY L N AH S IH Z
GERMFREE	JH ER M F R IY
GHEE	G IY
GHEES	G IY Z
GLACEED	G L EY S IY D
GLEE	G L IY
GLEED	G L IY D
GLEEDS	G L IY D Z
GLEEFUL	G L IY F AH L
GLEEFULLY	G L IY F AH L IY
GLEEFULNESS	G L IY F AH L N AH S
GLEEFULNESSES	G L IY F AH L N AH S IH Z
GLEEK	G L IY K
GLEEKED	G L IY K T
GLEEKING	G L IY K IH NG
GLEEKS	G L IY K S
GLEEMAN	G L IY M AE N
GLEEMEN	G L IY M EH N
GLEES	G L IY Z
GLEESOME	G L IY S AH M
GLEET	G L IY T
GLEETED	G L IY T EH D
GLEETIER	G L IY T IH ER
GLEETIEST	G L IY T AY AH S T
GLEETING	G L IY T AH NG
GLEETS	G L IY T S
GLEETY	G L IY T IY
GOALKEEPER	G OW L K IY P ER
GOALKEEPERS	G OW L K IY P ER Z
GOATEE	G OW T IY
GOATEED	G OW EY T IH D
GOATEES	G OW T IY Z
GOBONEE	G OW B OW N IY
GRANDEE	G R AE N D IY
GRANDEES	G R AE N D IY Z
GRANTEE	G R AE N T IY
GRANTEES	G R AE N T IY Z
GRATINEE	G R AE T AH N IY IY
GRATINEED	G R AE T AH N IY D
GRATINEEING	G R AH T IH N IY AH NG
GRATINEES	G R AE T AH N IY Z
GREE	G R IY
GREED	G R IY D
GREEDIER	G R IY D IY ER
GREEDIEST	G R IY D IY IH S T
GREEDILY	G R IY D AH L IY
GREEDINESS	G R IY D IY N AH S
GREEDINESSES	G R IY D IY N AH S IH Z
GREEDS	G R IY D Z
GREEDY	G R IY D IY
GREEGREE	G R IY G R IY IY
GREEGREES	G R IY G R IY Z
GREEING	G R IY AH NG
GREEK	G R IY K
GREEN	G R IY N
GREENBACK	G R IY N B AE K
GREENBACKER	G R IY N B AE K ER
GREENBACKERS	G R IY N B AE K ER Z
GREENBACKISM	G R IY N B AE K IH Z AH M
GREENBACKISMS	G R IY N B AE K IH Z AH M Z
GREENBACKS	G R IY N B AE K S
GREENBELT	G R IY N B EH L T
GREENBELTS	G R IY N B EH L T S
GREENBRIER	G R IY N B R AY AH R
GREENBRIERS	G R IY N B R IY R Z
GREENBUG	G R IY N B AH G
GREENBUGS	G R IY N B AH G Z
GREENED	G R IY N D
GREENER	G R IY N ER
GREENERIES	G R IY N AH R IY Z
GREENERY	G R IY N ER IY
GREENEST	G R IY N IH S T
GREENFIELD	G R IY N F IY L D
GREENFINCH	G R IY N F IH N CH
GREENFINCHES	G R IY N F IH N CH IH Z
GREENFLIES	G R IY N F L AY Z
GREENFLY	G R IY N F L AY
GREENGAGE	G R IY N G EY JH
GREENGAGES	G R IY N G EY JH IH Z
GREENGROCER	G R IY N G R OW S ER
GREENGROCERIES	G R IY N G R OW S R IY Z
GREENGROCERS	G R IY N G R OW S ER Z
GREENGROCERY	G R IY N G R OW S R IY
GREENHEAD	G R IY N HH EH D
GREENHEADS	G R IY N HH EH D Z
GREENHEART	G R IY N HH AA R T
GREENHEARTS	G R IY N HH AA R T S
GREENHORN	G R IY N HH AO R N
GREENHORNS	G R IY N HH AO R N Z
GREENHOUSE	G R IY N HH AW S
GREENHOUSES	G R IY N HH AW S IH Z
GREENHOUSES(2)	G R IY N HH AW Z AH Z
GREENIE	G R IY N IY
GREENIER	G R IY N IY ER
GREENIES	G R IY N IY Z
GREENIEST	G R IY N IY AH S T
GREENING	G R IY N IH NG
GREENINGS	G R IY N IH NG Z
GREENISH	G R IY N IH SH
GREENISHNESS	G R IY N IH SH N AH S
GREENISHNESSES	G R IY N IH SH N AH S IH Z
GREENKEEPER	G R IY N K IY P ER
GREENKEEPERS	G R IY N K IY P ER Z
GREENLET	G R IY N L AH T
GREENLETS	G R IY N L AH T S
GREENLING	G R IY N L IH NG
GREENLINGS	G R IY N L IH NG Z
GREENLY	G R IY N L IY
GREENMAIL	G R IY N M EY L
GREENMAILED	G R IY N M EY L D
GREENMAILER	G R IY N M EY L ER
GREENMAILERS	G R IY N M EY L ER Z
GREENMAILING	G R IY N M EY L IH NG
GREENMAILS	G R IY N M EY L Z
GREENNESS	G R IY N N AH S
GREENNESSES	G R IY N AH S IH Z
GREENOCKITE	G R IY N AH K AY T
GREENOCKITES	G R IY N AH K AY T S
GREENROOM	G R IY N R UW M
GREENROOMS	G R IY N R UW M Z
GREENS	G R IY N Z
GREENSAND	G R IY N S AE N D
GREENSANDS	G R IY N S AE N D Z
GREENSHANK	G R IY N SH AE NG K
GREENSHANKS	G R IY N SH AE NG K S
GREENSICK	G R IY N S IH K
GREENSICKNESS	G R IY N S IH K N AH S
GREENSICKNESSES	G R IY N S IH K N AH S IH Z
GREENSKEEPER	G R IY N Z K IY P ER
GREENSKEEPERS	G R IY N Z K IY P ER Z
GREENSTONE	G R IY N S T OW N
GREENSTONES	G R IY N S T OW N Z
GREENSTUFF	G R IY N S T AH F
GREENSTUFFS	G R IY N S T AH F S
GREENSWARD	G R IY N S W AO R D
GREENSWARDS	G R IY N S W AO R D Z
GREENTH	G R IY N TH
GREENTHS	G R IY N TH S
GREENWAY	G R IY N W EY
GREENWAYS	G R IY N W EY Z
GREENWING	G R IY N W IH NG
GREENWINGS	G R IY N W IH NG Z
GREENWOOD	G R IY N W UH D
GREENWOODS	G R IY N W UH D Z
GREENY	G R IY N IY
GREES	G R IY Z
GREET	G R IY T
GREETED	G R IY T AH D
GREETED(2)	G R IY T IH D
GREETER	G R IY T ER
GREETERS	G R IY T ER Z
GREETING	G R IY T IH NG
GREETINGS	G R IY T IH NG Z
GREETS	G R IY T S
GROUNDSHEET	G R AW N D SH IY T
GROUNDSHEETS	G R AW N D SH IY T S
GROUNDSKEEPER	G R AW N D S K IY P ER
GROUNDSKEEPERS	G R AW N D S K IY P ER Z
GUARANTEE	G EH R AH N T IY
GUARANTEED	G EH R AH N T IY D
GUARANTEEING	G EH R AH N T IY IH NG
GUARANTEES	G EH R AH N T IY Z
GULFWEED	G AH L F W IY D
GULFWEEDS	G AH L F W IY D Z
GUMTREE	G AH M T R IY
GUMTREES	G AH M T R IY Z
GUMWEED	G AH M W IY D
GUMWEEDS	G AH M W IY D Z
HACKEE	HH AE K IY
HACKEES	HH AE K IY Z
HADJEE	HH AE JH IY IY
HADJEES	HH AE JH IY Z
HAKEEM	HH AA K IY M
HAKEEMS	HH EY K IY M Z
HANDWHEEL	HH AE N D W IY L
HANDWHEELS	HH AE N D W IY L Z
HAREEM	HH AH R IY M
HAREEMS	HH AH R IY M Z
HARTEBEEST	HH AA R T IY B IY AH S T
HARTEBEESTS	HH AA R T AH B IY S T S
HASHEESH	HH AH SH IY SH
HASHEESHES	HH AH SH IY SH AH Z
HAWKWEED	HH AO K W IY D
HAWKWEEDS	HH AO K W IY D Z
HAYSEED	HH EY S IY D
HAYSEEDS	HH EY S IY D Z
HEADCHEESE	HH EH D CH IY Z
HEADCHEESES	HH EH D CH IY Z IH Z
HEED	HH IY D
HEEDED	HH IY D AH D
HEEDED(2)	HH IY D IH D
HEEDER	HH IY D ER
HEEDERS	HH IY D ER Z
HEEDFUL	HH IY D F AH L
HEEDFULLY	HH IY D F AH L IY
HEEDFULNESS	HH IY D F AH L N AH S
HEEDFULNESSES	HH IY D F AH L N AH S IH Z
HEEDING	HH IY D IH NG
HEEDLESS	HH IY D L AH S
HEEDLESSLY	HH IY D L AH S L IY
HEEDLESSNESS	HH IY D L AH S N AH S
HEEDLESSNESSES	HH IY D L AH S N AH S IH Z
HEEDS	HH IY D Z
HEEHAW	HH IY HH AH
HEEHAWED	HH IY HH AH D
HEEHAWING	HH IY HH AH AH NG
HEEHAWS	HH IY HH AH Z
HEEL	HH IY L
HEELBALL	HH IY L B AO L
HEELBALLS	HH IY L B AO L Z
HEELED	HH IY L D
HEELER	HH IY L ER
HEELERS	HH IY L ER Z
HEELING	HH IY L IH NG
HEELINGS	HH IY L IH NG Z
HEELLESS	HH IY L AH S
HEELPIECE	HH IY L P IY S
HEELPIECES	HH IY L P IY S IH Z
HEELPOST	HH IY L P OW S T
HEELPOSTS	HH IY L P OW S T S
HEELS	HH IY L Z
HEELTAP	HH IY L T AE P
HEELTAPS	HH IY L T AE P S
HEEZE	HH IY Z
HEEZED	HH IY Z D
HEEZES	HH IY Z AH Z
HEEZING	HH IY Z AH NG
HELPMEET	HH EH L P M IY T
HELPMEETS	HH EH L P M IY T S
HEMPSEED	HH EH M P S IY D
HEMPSEEDS	HH EH M P S IY D Z
HEMPWEED	HH EH M P W IY D
HEMPWEEDS	HH EH M P W IY D Z
HOGWEED	HH AA G W IY D
HOGWEEDS	HH AA G W IY D Z
HONEYBEE	HH AH N IY B IY
HONEYBEES	HH AH N IY B IY Z
HONEYCREEPER	HH AH N IY K R IY P ER
HONEYCREEPERS	HH AH N IY K R IY P ER Z
HONOREE	AA N ER IY
HONOREES	AA N ER IY Z
HORSEWEED	HH AO R S W IY D
HORSEWEEDS	HH AO R S W IY D Z
HOUSEKEEP	HH AW S K IY P
HOUSEKEEPER	HH AW S K IY P ER
HOUSEKEEPERS	HH AW S K IY P ER Z
HOUSEKEEPING	HH AW S K IY P IH NG
HOUSEKEEPINGS	HH AW S K IY P IH NG Z
HOUSEKEEPS	HH AW S K IY P S
HOUSELEEK	HH AW S AH L IY K
HOUSELEEKS	HH AW S AH L IY K S
HUMVEE	HH AH M V IY
HUMVEES	HH AH M V IY Z
IMPHEE	IH M F IY IY
IMPHEES	IH M F IY Z
INBREED	IH N B R IY D
INBREEDING	IH N B R IY D IH NG
INBREEDINGS	IH N B R IY D IH NG Z
INBREEDS	IH N B R IY D Z
INDEED	IH N D IY D
INDICTEE	IH N D AY T IY
INDICTEES	IH N D AY T IY Z
INDISCREET	IH N D IH S K R IY T
INDISCREETLY	IH N D IH S K R IY T L IY
INDISCREETNESS	IH N D IH S K R IY T N AH S
INDISCREETNESSES	IH N D IH S K R IY T N AH S IH Z
INDORSEE	IH N D AO R S IY
INDORSEES	IH N D AO R S IY Z
INDUCTEE	IH N D AH K T IY
INDUCTEES	IH N D AH K T IY Z
INNKEEPER	IH N K IY P ER
INNKEEPERS	IH N K IY P ER Z
INTERBREED	IH N T ER B R IY D
INTERBREEDING	IH N T ER B R IY D IH NG
INTERBREEDS	IH N T ER B R IY D Z
INTERNEE	IH N T ER N IY
INTERNEES	IH N T ER N IY Z
INTERROGATEE	IH N T EH R AH G EY T IY
INTERROGATEES	IH N T EH R AH G EY T IY Z
INTERROGEE	IH N T AH R AH JH IY IY
INTERROGEES	IH N T AH R AH JH IY Z
INTERVIEWEE	IH N T ER V Y UW IY
INTERVIEWEES	IH N T ER V Y UW IY Z
INVITEE	IH N V AY T IY
INVITEES	IH N V AY T IY Z
IRONWEED	AY ER N W IY D
IRONWEEDS	AY ER N W IY D Z
IRREDEEMABLE	IH R IY D IY M AH B AH L
IRREDEEMABLY	IH R IH D IY M AH B L IY
JAMBOREE	JH AE M B AO R IY
JAMBOREES	JH AE M B AO R IY Z
JAYGEE	JH EY JH IY IY
JAYGEES	JH EY JH IY Z
JAYVEE	JH EY V IY IY
JAYVEES	JH EY V IY Z
JEE	JH IY
JEED	JH IY D
JEEING	JH IY AH NG
JEEP	JH IY P
JEEPED	JH IY P T
JEEPERS	JH IY P ER Z
JEEPING	JH IY P IH NG
JEEPNEY	JH IY P N IY
JEEPNEYS	JH IY P N EY Z
JEEPS	JH IY P S
JEER	JH IH R
JEERED	JH IH R D
JEERER	JH IH ER ER
JEERERS	JH IH ER ER Z
JEERING	JH IY R IH NG
JEERINGLY	JH IH ER IH NG L IY
JEERS	JH IY R Z
JEES	JH IY Z
JEEZ	JH IY Z
JEREED	JH AH R IY D
JEREEDS	JH IY R IY D Z
JERREED	JH EH R IY D
JERREEDS	JH EH R IY D Z
JEWELWEED	JH UW AH L W IY D
JEWELWEEDS	JH UW AH L W IY D Z
JIMSONWEED	JH IH M S AH N W IY D
JIMSONWEEDS	JH IH M S AH N W IY D Z
JINNEE	JH IH N IY IY
JUBILEE	JH UW B AH L IY
JUBILEES	JH UW B AH L IY Z
JUNKETEER	JH AH NG K AH T IH R
JUNKETEERS	JH AH NG K IY T AH R Z
KAFFEEKLATSCH	K AE F IY K L AH T S
KAFFEEKLATSCHES	K AE F IY K L AH T S
KAMSEEN	K AE M Z IY AH N
KAMSEENS	K AE M Z IY N Z
KEDGEREE	K EH JH AH R IY IY
KEDGEREES	K EH JH AH R IY Z
KEEF	K IY F
KEEFS	K IY F S
KEEK	K IY K
KEEKED	K IY K T
KEEKING	K IY K AH NG
KEEKS	K IY K S
KEEL	K IY L
KEELAGE	K IY L IH JH
KEELAGES	K IY L IH JH IH Z
KEELBOAT	K IY L B OW T
KEELBOATS	K IY L B OW T S
KEELED	K IY L D
KEELHALE	K IY L HH EY L
KEELHALED	K IY L HH EY L D
KEELHALES	K IY L HH EY L Z
KEELHALING	K IY L HH EY L IH NG
KEELHAUL	K IY L HH AO L
KEELHAULED	K IY L HH AO L D
KEELHAULING	K IY L HH AO L IH NG
KEELHAULS	K IY L HH AO L Z
KEELING	K IY L IH NG
KEELLESS	K IY L AH S
KEELS	K IY L Z
KEELSON	K EH L S AH N
KEELSONS	K EH L S AH N Z
KEEN	K IY N
KEENED	K IY N D
KEENER	K IY N ER
KEENERS	K IY N ER Z
KEENEST	K IY N AH S T
KEENING	K IY N IH NG
KEENLY	K IY N L IY
KEENNESS	K IY N AH S
KEENNESSES	K IY N AH S IH Z
KEENS	K IY N Z
KEEP	K IY P
KEEPABLE	K IY P AH B AH L
KEEPER	K IY P ER
KEEPERS	K IY P ER Z
KEEPING	K IY P IH NG
KEEPINGS	K IY P IH NG Z
KEEPS	K IY P S
KEEPSAKE	K IY P S EY K
KEEPSAKES	K IY P S EY K S
KEESHOND	K IY SH AH N D
KEESHONDEN	K IY SH AA N D AH N
KEESHONDS	K IY SH AH N D Z
KEESTER	K IY EH S T AH R
KEESTERS	K IY S T AH R Z
KEET	K IY T
KEETS	K IY T S
KEEVE	K IY V
KEEVES	K IY V Z
KHAMSEEN	K HH AE M Z IY AH N
KHAMSEENS	K HH AE M Z IY N Z
KIDNAPEE	K IH D N AE P IY
KIDNAPEES	K IH D N AE P IY Z
KIDNAPPEE	K IH D N AE P IY
KIDNAPPEES	K IH D N AE P IY Z
KILLDEE	K IH L D IY IY
KILLDEER	K IH L D IH ER
KILLDEERS	K IH L D IH ER Z
KILLDEES	K IH L D IY Z
KIMCHEE	K IH M CH IY
KIMCHEES	K IH M CH IY Z
KNAPWEED	N AE P W IY D
KNAPWEEDS	N AE P W IY D Z
KNEE	N IY
KNEECAP	N IY K AE P
KNEECAPPED	N IY K AE P T
KNEECAPPING	N IY K AE P IH NG
KNEECAPPINGS	N IY K AE P IH NG Z
KNEECAPS	N IY K AE P S
KNEED	N IY D
KNEEHOLE	N IY HH OW L
KNEEHOLES	N IY HH OW L Z
KNEEING	N IY IH NG
KNEEL	N IY L
KNEELED	N IY L D
KNEELER	N IY L ER
KNEELERS	N IY L ER Z
KNEELING	N IY L IH NG
KNEELS	N IY L Z
KNEEPAD	N IY P AE D
KNEEPADS	N IY P AE D Z
KNEEPAN	N IY P AE N
KNEEPANS	N IY P AE N Z
KNEES	N IY Z
KNEESOCK	N IY S AA K
KNEESOCKS	N IY S AA K S
KNOTWEED	N AA T W IY D
KNOTWEEDS	N AA T W IY D Z
KOKANEE	K AA K AH N IY IY
KOKANEES	K AA K AH N IY Z
KREEP	K R IY P
KREEPS	K R IY P S
LAREE	L AH R IY IY
LAREES	L AH R IY Z
LARYNGECTOMEE	L AH R IH N JH AH K T AH M IY IY
LARYNGECTOMEES	L AH R IH N JH EH K T AH M IY Z
LATEEN	L EY T AH N
LATEENER	L EY T AH N ER
LATEENERS	L EY T AH N ER Z
LATEENS	L EY T AH N Z
LAVEER	L EY V IH R
LAVEERED	L EY V AH R D
LAVEERING	L EY V AH R AH NG
LAVEERS	L EY V AH R Z
LEAFLETEER	L IY F L AH T IH R
LEAFLETEERS	L IY F L AH T IH R Z
LEE	L IY
LEEBOARD	L IY B OW R D
LEEBOARDS	L IY B OW R D Z
LEECH	L IY CH
LEECHED	L IY CH T
LEECHES	L IY CH IH Z
LEECHING	L IY CH AH NG
LEECHLIKE	L IY CH L AY K
LEEK	L IY K
LEEKS	L IY K S
LEER	L IH ER
LEERED	L IH ER D
LEERIER	L IY R IY ER
LEERIEST	L IY R IY AH S T
LEERILY	L IY R IY L IY
LEERING	L IH ER IH NG
LEERINGLY	L IH ER IH NG L IY
LEERS	L IH ER Z
LEERY	L IH R IY
LEES	L IY Z
LEET	L IY T
LEETS	L IY T S
LEEWARD	L IY W ER D
LEEWARDS	L IY W ER D Z
LEEWAY	L IY W EY
LEEWAYS	L IY W EY Z
LEGATEE	L EH G AH T IY
LEGATEES	L EH G AH T IY Z
LESSEE	L EH S IY
LESSEES	L EH S IY Z
LEVEE	L EH V IY
LEVEED	L IY V IY D
LEVEEING	L EH V IY IH NG
LEVEES	L EH V IY Z
LIBELEE	L AY B AH L IY
LIBELEES	L AY B AH L IY Z
LIBELLEE	L AY B AH L IY
LIBELLEES	L AY B AH L IY Z
LICENCEE	L AY S AH N S IY
LICENCEES	L AY S AH N S IY Z
LICENSEE	L AY S AH N S IY
LICENSEES	L AY S AH N S IY Z
LICHEE	L AH CH IY IY
LICHEES	L AH CH IY Z
LINEBREEDING	L AY N B R IY D IH NG
LINEBREEDINGS	L AY N B R IY D IH NG Z
LINSEED	L IH N S IY D
LINSEEDS	L IH N S IY D Z
LISTEE	L IH S T IY
LISTEES	L IH S T IY Z
LOCKKEEPER	L AA K IY P ER
LOCKKEEPERS	L AA K IY P ER Z
LOCOWEED	L AA K OW IY D
LOCOWEEDS	L AA K OW IY D Z
LORIKEET	L AO R AH K IY T
LORIKEETS	L AO R AH K IY T S
LUNGEE	L AH N JH IY
LUNGEES	L AH N JH IY Z
LYCEE	L AY S IY IY
LYCEES	L AY S IY Z
LYCHEE	L AH CH IY IY
LYCHEES	L AH CH IY Z
MACHREE	M AE K R IY IY
MACHREES	M AE K R IY Z
MAHARANEE	M AE HH AH R AH N IY IY
MAHARANEES	M AE HH AH R AH N IY Z
MAINSHEET	M EY N SH IY T
MAINSHEETS	M EY N SH IY T S
MALLEE	M AE L IY IY
MALLEES	M AE L IY IY Z
MAMMEE	M AE M IY IY
MAMMEES	M AE M IY Z
MANATEE	M AE N AH T IY
MANATEES	M AE N AH T IY Z
MANCHINEEL	M AE N CH IH N IY L
MANCHINEELS	M AE N CH IH N IY L Z
MANGOSTEEN	M AE NG G OW S T IY N
MANGOSTEENS	M AE NG G OW S T IY N Z
MARKETEER	M AA R K AH T IH R
MARKETEERS	M AA R K AH T IH R Z
MARQUEE	M AA R K IY
MARQUEES	M AA R K IY Z
MATINEE	M AE T IH N EY
MATINEES	M AE T IH N EY Z
MAVOURNEEN	M AH V OW R N IY AH N
MAVOURNEENS	M AE V AH R N IY N Z
MAYWEED	M EY W IY D
MAYWEEDS	M EY W IY D Z
MEADOWSWEET	M EH D OW S W IY T
MEADOWSWEETS	M EH D OW S W IY T S
MEED	M IY D
MEEDS	M IY D Z
MEEK	M IY K
MEEKER	M IY K ER
MEEKEST	M IY K AH S T
MEEKLY	M IY K L IY
MEEKNESS	M IY K N AH S
MEEKNESSES	M IY K N AH S IH Z
MEERKAT	M IH R K AH T
MEERKATS	M IH R K EY T S
MEERSCHAUM	M IH R S AH M
MEERSCHAUMS	M IH R S AH M Z
MEET	M IY T
MEETER	M IY T ER
MEETERS	M IY T ER Z
MEETING	M IY T IH NG
MEETINGHOUSE	M IY T IH NG HH AW S
MEETINGHOUSES	M IY T IH NG HH AW S IH Z
MEETINGS	M IY T IH NG Z
MEETLY	M IY T L IY
MEETNESS	M IY T N AH S
MEETNESSES	M IY T N AH S IH Z
MEETS	M IY T S
MELEE	M EY L EY
MELEES	M EY L EY Z
MESEEMED	M IY S IY M D
MESEEMETH	M IY S IY M AH TH
MESEEMS	M IY S IY M Z
MESTEE	M IY Z T IY
MESTEES	M IY Z T IY Z
MIDWEEK	M IH D W IY K
MIDWEEKLY	M IH D W IY K L IY
MIDWEEKS	M IH D W IY K S
MIJNHEER	M IH JH N IH R
MIJNHEERS	M IH JH N HH AH R Z
MILKWEED	M IH L K W IY D
MILKWEEDS	M IH L K W IY D Z
MILLIDEGREE	M IH L AH D AH G R IY IY
MILLIDEGREES	M IH L AH D EH G R IY Z
MINESWEEPER	M AY N S W IY P ER
MINESWEEPERS	M AY N S W IY P ER Z
MINESWEEPING	M AY N S W IY P IH NG
MINESWEEPINGS	M AY N S W IY P IH NG Z
MISDEED	M IH S D IY D
MISDEEDS	M IH S D IY D Z
MISDEEM	M IH S D IY M
MISDEEMED	M IH S D IY M D
MISDEEMING	M IH S D IY M IH NG
MISDEEMS	M IH S D IY M Z
MISESTEEM	M IH S IH S T IY M
MISESTEEMED	M IH S IH S T IY M D
MISESTEEMING	M IH S IH S T IY M IH NG
MISESTEEMS	M IH S IH S T IY M Z
MISKEEP	M IH S K IY P
MISKEEPING	M IH S K IY P IH NG
MISKEEPS	M IH S K IY P S
MISMEET	M IH S M IY T
MISMEETING	M IH S M IY T IH NG
MISMEETS	M IH S M IY T S
MISSILEER	M IH S AH L IH R
MISSILEERS	M IH S AH L IH R Z
MISSTEER	M IH S T IH ER
MISSTEERED	M IH S T IH ER D
MISSTEERING	M IH S T IH ER IH NG
MISSTEERS	M IH S T IH ER Z
MONGEESE	M AA N JH IY Z
MOONSEED	M UW N S IY D
MOONSEEDS	M UW N S IY D Z
MOREEN	M AO R IY N
MOREENS	M AH R IY N Z
MORTGAGEE	M AO R G IH JH IY
MORTGAGEES	M AO R G IH JH IY Z
MOUNTAINEER	M AW N T IH N IH R
MOUNTAINEERING	M AW N T IH N IH R IH NG
MOUNTAINEERINGS	M AW N T AH N IH R IH NG Z
MOUNTAINEERS	M AW N T IH N IH R Z
MOUTHBREEDER	M AW TH B R IY D ER
MOUTHBREEDERS	M AW TH B R IY D ER Z
MUGGEE	M AH G IY
MUGGEES	M AH G IY Z
MUJAHEDEEN	M UW JH AH HH EH D IY N
MUJAHIDEEN	M UW JH AH HH EH D IY N
MULETEER	M Y UW L AH T IH R
MULETEERS	M Y UW L IY T AH R Z
MULTISCREEN	M AH L T AY S K R IY N
MULTISPEED	M AH L T AY S P IY D
MURDEREE	M ER D ER IY
MURDEREES	M ER D ER IY Z
MUSKETEER	M AH S K AH T IY R
MUSKETEERS	M AH S K AH T IY R Z
MUSTEE	M AH S T IY IY
MUSTEES	M AH S T IY Z
MUTINEER	M Y UW T AH N IH R
MUTINEERED	M Y UW T AH N IH R D
MUTINEERING	M Y UW T AH N IH R IH NG
MUTINEERS	M Y UW T IH N IH R Z
MYNHEER	M AH N EH R
MYNHEERS	M AH N EH R Z
NANKEEN	N AE NG K IY AH N
NANKEENS	N AE NG K IY N Z
NEE	N IY
NEED	N IY D
NEEDED	N IY D AH D
NEEDED(2)	N IY D IH D
NEEDER	N IY D ER
NEEDERS	N IY D ER Z
NEEDFUL	N IY D F AH L
NEEDFULLY	N IY D F AH L IY
NEEDFULNESS	N IY D F AH L N AH S
NEEDFULNESSES	N IY D F AH L N AH S IH Z
NEEDFULS	N IY D F AH L Z
NEEDIER	N IY D IY ER
NEEDIEST	N IY D IY IH S T
NEEDILY	N IY D IY L IY
NEEDINESS	N IY D IY N AH S
NEEDINESSES	N IY D IY N AH S IH Z
NEEDING	N IY D IH NG
NEEDLE	N IY D AH L
NEEDLED	N IY D AH L D
NEEDLEFISH	N IY D AH L F IH SH
NEEDLEFISHES	N IY D AH L F IH SH IH Z
NEEDLELIKE	N IY D AH L L AY K
NEEDLEPOINT	N IY D AH L P OY N T
NEEDLEPOINTS	N IY D AH L P OY N T S
NEEDLER	N IY D AH L ER
NEEDLER(2)	N IY D L ER
NEEDLERS	N IY D AH L ER Z
NEEDLES	N IY D AH L Z
NEEDLESS	N IY D L AH S
NEEDLESSLY	N IY D L AH S L IY
NEEDLESSNESS	N IY D L AH S N AH S
NEEDLESSNESSES	N IY D L AH S N AH S IH Z
NEEDLEWOMAN	N IY D AH L W UH M AH N
NEEDLEWOMEN	N IY D AH L W IH M AH N
NEEDLEWORK	N IY D AH L W ER K
NEEDLEWORKER	N IY D AH L W ER K ER
NEEDLEWORKERS	N IY D AH L W ER K ER Z
NEEDLEWORKS	N IY D AH L W ER K S
NEEDLING	N IY D L IH NG
NEEDLINGS	N IY D L IH NG Z
NEEDS	N IY D Z
NEEDY	N IY D IY
NEEM	N IY M
NEEMS	N IY M Z
NEEP	N IY P
NEEPS	N IY P S
NEGLIGEE	N EH G L IH JH IY
NEGLIGEES	N EH G L IH JH IY Z
NEWSREEL	N UW Z R IY L
NEWSREELS	N UW Z R IY L Z
NEWSWEEKLIES	N UW Z W IY K L IY Z
NEWSWEEKLY	N UW Z W IY K L IY
NGWEE	N G W IY
NINETEEN	N AY N T IY N
NINETEENS	N AY N T IY N Z
NINETEENTH	N AY N T IY N TH
NINETEENTHS	N AY N T IY N TH S
NOMINEE	N AA M AH N IY
NOMINEES	N AA M AH N IY Z
NONBREEDER	N AA N B R IY D ER
NONBREEDERS	N AA N B R IY D ER Z
NONBREEDING	N AA N B R IY D IH NG
NONBREEDINGS	N AA N B R IY D IH NG Z
NONCAREER	N AA N K AH R IH ER
NONDEGREE	N AA N D IH G R IY
NONEMPLOYEE	N AA N IH M P L OY IY IY
NONEMPLOYEES	N AA N IH M P L OY IY IY Z
NONENGINEERING	N AA N EH N JH AH N IH R IH NG
NONENGINEERINGS	N AA N EH N JH AH N IH R IH NG Z
NONFREEZING	N AA N F R IY Z IH NG
NONGREEN	N AA N G R IY N
NONMEETING	N AA N M IY T IH NG
NONMEETINGS	N AA N M IY T IH NG Z
NONSPEECH	N AA N S P IY CH
NOSEBLEED	N OW Z B L IY D
NOSEBLEEDS	N OW Z B L IY D Z
NOSEWHEEL	N OW Z W IY L
NOSEWHEELS	N OW Z W IY L Z
OBLIGEE	AH B L AY JH IY
OBLIGEES	AH B L AY JH IY Z
OFFSCREEN	AO F S K R IY N
OGEE	OW JH IY IY
OGEES	OW JH IY Z
OILSEED	OY L S IY D
OILSEEDS	OY L S IY D Z
ONSCREEN	AA N S K R IY N
OPTIONEE	AA P SH AH N IY
OPTIONEES	AA P SH AH N IY Z
ORIENTEER	OW R IY EH N T IH R
ORIENTEERING	OW R IY EH N T IH R IH NG
ORIENTEERINGS	OW R IY EH N T IH R IH NG Z
ORIENTEERS	OW R IY EH N T IH R Z
OUTBREED	AW T B R IY D
OUTBREEDING	AW T B R IY D IH NG
OUTBREEDINGS	AW T B R IY D IH NG Z
OUTBREEDS	AW T B R IY D Z
OUTFEEL	AW T F IY L
OUTFEELING	AW T F IY L IH NG
OUTFEELS	AW T F IY L Z
OUTKEEP	AW T K IY P
OUTKEEPING	AW T K IY P IH NG
OUTKEEPS	AW T K IY P S
OUTPREEN	AW T P R IY N
OUTPREENED	AW T P R IY N D
OUTPREENING	AW T P R IY N IH NG
OUTPREENS	AW T P R IY N Z
OUTSEE	AW T S IY
OUTSEEING	AW T S IY IH NG
OUTSEEN	AW T S IY N
OUTSEES	AW T S IY Z
OUTSLEEP	AW T S L IY P
OUTSLEEPING	AW T S L IY P IH NG
OUTSLEEPS	AW T S L IY P S
OUTSPEED	AW T S P IY D
OUTSPEEDED	AW T S P IY D IH D
OUTSPEEDING	AW T S P IY D IH NG
OUTSPEEDS	AW T S P IY D Z
OUTSTEER	AW T S T IH ER
OUTSTEERED	AW T S T IH ER D
OUTSTEERING	AW T S T IH ER IH NG
OUTSTEERS	AW T S T IH ER Z
OUTWEEP	AW T W IY P
OUTWEEPING	AW T W IY P IH NG
OUTWEEPS	AW T W IY P S
OVERENGINEER	OW V ER EH N JH AH N IH R
OVERENGINEERED	OW V ER EH N JH AH N IH R D
OVERENGINEERING	OW V ER EH N JH AH N IH R IH NG
OVERENGINEERS	OW V ER EH N JH AH N IH R Z
OVERFEED	OW V ER F IY D
OVERFEEDING	OW V ER F IY D IH NG
OVERFEEDS	OW V ER F IY D Z
OVERFREE	OW V ER F R IY
OVERKEEN	OW V ER K IY N
OVERMEEK	OW V ER M IY K
OVERSEE	OW V ER S IY
OVERSEED	OW V ER S IY D
OVERSEEDED	OW V ER S IY D IH D
OVERSEEDING	OW V ER S IY D IH NG
OVERSEEDS	OW V ER S IY D Z
OVERSEEING	OW V ER S IY IH NG
OVERSEEN	OW V ER S IY N
OVERSEER	OW V ER S IY ER
OVERSEERS	OW V ER S IY ER Z
OVERSEES	OW V ER S IY Z
OVERSLEEP	OW V ER S L IY P
OVERSLEEPING	OW V ER S L IY P IH NG
OVERSLEEPS	OW V ER S L IY P S
OVERSTEER	OW V ER S T IH ER
OVERSTEERS	OW V ER S T IH ER Z
OVERSWEET	OW V ER S W IY T
OVERSWEETEN	OW V ER S W IY T AH N
OVERSWEETENED	OW V ER S W IY T AH N D
OVERSWEETENING	OW V ER S W IY T AH N IH NG
OVERSWEETENS	OW V ER S W IY T AH N Z
OVERSWEETNESS	OW V ER S W IY T N AH S
OVERSWEETNESSES	OW V ER S W IY T N AH S IH Z
OVERWEEN	AH V AH R W IY AH N
OVERWEENED	AA V AH R W IY N D
OVERWEENING	AA V AH R W IY N AH NG
OVERWEENINGLY	AH V AH R W AH N IH NG L IY
OVERWEENS	AA V AH R W IY N Z
PAMPHLETEER	P AE M F L AH T IH R
PAMPHLETEERED	P AE M F L AH T IH R D
PAMPHLETEERING	P AE M F L AH T IH R IH NG
PAMPHLETEERS	P AE M F L AH T IH R Z
PARAKEET	P EH R AH K IY T
PARAKEETS	P EH R AH K IY T S
PARDEE	P AA R D IY
PAROLEE	P ER OW L IY
PAROLEES	P ER OW L IY Z
PARRAKEET	P AE R AH K IY T
PARRAKEETS	P AE R AH K IY T S
PASSEE	P AE S IY
PATENTEE	P AE T AH N T IY
PATENTEES	P AE T AH N T IY Z
PATTEE	P AE T IY
PAVEED	P EY V D
PAWNEE	P AO N IY
PAWNEES	P AO N IY Z
PAYEE	P EY IY
PAYEES	P EY IY Z
PEACEKEEPER	P IY S K IY P ER
PEACEKEEPERS	P IY S K IY P ER Z
PEACEKEEPING	P IY S K IY P IH NG
PEACEKEEPINGS	P IY S K IY P IH NG Z
PEDIGREE	P EH D AH G R IY
PEDIGREED	P AH D IH G R IY D
PEDIGREES	P EH D AH G R IY Z
PEE	P IY
PEEBEEN	P IY B IY AH N
PEEBEENS	P IY B IY AH N Z
PEED	P IY D
PEEING	P IY IH NG
PEEK	P IY K
PEEKABOO	P IY K AH B UW
PEEKABOOS	P IY K AH B UW Z
PEEKED	P IY K T
PEEKING	P IY K IH NG
PEEKS	P IY K S
PEEL	P IY L
PEELABLE	P IY L AH B AH L
PEELED	P IY L D
PEELER	P IY L ER
PEELERS	P IY L ER Z
PEELING	P IY L IH NG
PEELINGS	P IY L IH NG Z
PEELS	P IY L Z
PEEN	P IY AH N
PEENED	P IY N D
PEENING	P IY N AH NG
PEENS	P IY N Z
PEEP	P IY P
PEEPED	P IY P T
PEEPER	P IY P ER
PEEPERS	P IY P ER Z
PEEPHOLE	P IY P HH OW L
PEEPHOLES	P IY P HH OW L Z
PEEPING	P IY P IH NG
PEEPS	P IY P S
PEEPSHOW	P IY P SH OW
PEEPSHOWS	P IY P SH OW Z
PEEPUL	P IY P AH L
PEEPULS	P IY P Y AH L Z
PEER	P IH R
PEERAGE	P IH R AH JH
PEERAGES	P IH ER IH JH IH Z
PEERED	P IH R D
PEERESS	P IH ER AH S
PEERESSES	P IH ER AH S IH Z
PEERIE	P IH ER IY
PEERIES	P IY R IY Z
PEERING	P IY R IH NG
PEERLESS	P IH R L IH S
PEERLESSLY	P IH ER L AH S L IY
PEERS	P IH R Z
PEERY	P IY R IY
PEES	P IY Z
PEESWEEP	P IY S W IY P
PEESWEEPS	P IY S W IY P S
PEETWEET	P IY T W IY T
PEETWEETS	P IY T W IY T S
PEEVE	P IY V
PEEVED	P IY V D
PEEVES	P IY V Z
PEEVING	P IY V AH NG
PEEVISH	P IY V IH SH
PEEVISHLY	P IY V IH SH L IY
PEEVISHNESS	P IY V IH SH N AH S
PEEVISHNESSES	P IY V IH SH N EH S AH Z
PEEWEE	P IY W IY
PEEWEES	P IY W IY Z
PEEWIT	P IY W IH T
PEEWITS	P IY W IH T S
PENSEE	P EH N S IY
PENSEES	P EH N S IY Z
PEPPERTREE	P EH P ER T R IY
PEPPERTREES	P EH P ER T R IY Z
PERIGEE	P AH R AH JH IY IY
PERIGEES	P AH R AH JH IY Z
PERMITTEE	P ER M IH T IY
PERMITTEES	P ER M IH T IY Z
PERSECUTEE	P ER S IH K Y UW T IY
PERSECUTEES	P ER S IH K Y UW T IY Z
PEWEE	P Y UW IY
PEWEES	P Y UW IY Z
PHARISEE	F AE R AH Z IY IY
PHARISEES	F AE R AH Z IY Z
PICKEER	P IH K IH R
PICKEERED	P IH K IH R D
PICKEERING	P IH K IH R IH NG
PICKEERS	P IH K IH R Z
PICKERELWEED	P IH K AH R EH L W IY D
PICKERELWEEDS	P IH K EH R AH L W IY D Z
PICOTEE	P IH K AH T IY IY
PICOTEES	P IH K AH T IY Z
PIGWEED	P IH G W IY D
PIGWEEDS	P IH G W IY D Z
PINWEED	P IH N W IY D
PINWEEDS	P IH N W IY D Z
PINWHEEL	P IH N W IY L
PINWHEELED	P IH N W IY L D
PINWHEELING	P IH N W IY L IH NG
PINWHEELS	P IH N W IY L Z
PIONEER	P AY AH N IH R
PIONEERED	P AY AH N IH R D
PIONEERING	P AY AH N IH R IH NG
PIONEERS	P AY AH N IH R Z
PISTAREEN	P IH S T AE R IY AH N
PISTAREENS	P IH S T AH R IY N Z
PISTOLEER	P IH S T AH L IH R
PISTOLEERS	P IH S T AH L IH R Z
PLEDGEE	P L EH JH IY
PLEDGEES	P L EH JH IY Z
POKEWEED	P OW K W IY D
POKEWEEDS	P OW K W IY D Z
POLLEE	P OW L IY
POLLEES	P OW L IY Z
POMMEE	P AA M IY IY
PONDWEED	P AA N D W IY D
PONDWEEDS	P AA N D W IY D Z
PONGEE	P AA N JH IY IY
PONGEES	P AH NG IY Z
POSTEEN	P OW S T IY AH N
POSTEENS	P AA S T IY N Z
POSTFREEZE	P OW S T F R IY Z
POSTTEEN	P OW S T IY N
POTEEN	P OW T IY AH N
POTEENS	P OW T IY N Z
POTHEEN	P OW DH IY AH N
POTHEENS	P AH TH IY N Z
POTTEEN	P AA T IY N
POTTEENS	P AA T IY N Z
PREE	P R IY
PREECLAMPSIA	P R IY EH K L AE M P S IY AH
PREECLAMPSIAS	P R IY EH K L AE M P S IY AH Z
PREECLAMPTIC	P R IY EH K L AH M P T AH K
PREED	P R IY D
PREEDIT	P R IY EH D AH T
PREEDITED	P R IY EH D AH T IH D
PREEDITING	P R IY EH D AH T IH NG
PREEDITS	P R IY EH D AH T S
PREEING	P R IY IY AH NG
PREELECT	P R IY IH L EH K T
PREELECTED	P R IY IH L EH K T IH D
PREELECTING	P R IY IH L EH K T IH NG
PREELECTION	P R IY IH L EH K SH AH N
PREELECTIONS	P R IY IH L EH K SH AH N Z
PREELECTRIC	P R IY IH L EH K T R IH K
PREELECTS	P R IY IH L EH K T S
PREEMBARGO	P R IY IH M B AA R G OW
PREEMERGENCE	P R IY IH M ER JH AH N S
PREEMERGENT	P R IY IH M ER JH AH N T
PREEMIE	P R IY AH M AY
PREEMIES	P R IY AH M Y S
PREEMINENCE	P R IY EH M AH N AH N S
PREEMINENCES	P R IY EH M AH N AH N S IH Z
PREEMINENT	P R IY EH M AH N AH N T
PREEMINENTLY	P R IY EH M AH N AH N T L IY
PREEMPLOYMENT	P R IY IH M P L OY M AH N T
PREEMPLOYMENTS	P R IY IH M P L OY M AH N T S
PREEMPT	P R IY EH M P T
PREEMPTED	P R IY EH M P T IH D
PREEMPTING	P R IY EH M P T IH NG
PREEMPTION	P R IY EH M P SH AH N
PREEMPTIONS	P R IY AH M T AY AH N Z
PREEMPTIVE	P R IY EH M P T IH V
PREEMPTIVELY	P R IY EH M P T IH V L IY
PREEMPTOR	P R IY EH M P T AH R
PREEMPTORS	P R IY AH M T AO R Z
PREEMPTORY	P R IY EH M P T AH R IY
PREEMPTS	P R IY EH M P T S
PREEN	P R IY N
PREENACT	P R IY EH N AE K T
PREENACTED	P R IY EH N AE K T IH D
PREENACTING	P R IY EH N AE K T IH NG
PREENACTS	P R IY EH N AE K T S
PREENED	P R IY N D
PREENER	P R IY N ER
PREENERS	P R IY N ER Z
PREENING	P R IY N IH NG
PREENROLLMENT	P R IY EH N R OW L M AH N T
PREENROLLMENTS	P R IY EH N R OW L M AH N T S
PREENS	P R IY N Z
PREERECT	P R IY IH R EH K T
PREERECTED	P R IY IH R EH K T IH D
PREERECTING	P R IY IH R EH K T IH NG
PREERECTS	P R IY IH R EH K T S
PREES	P R IY Z
PREESTABLISH	P R IY IH S T AE B L IH SH
PREESTABLISHED	P R IY IH S T AE B L IH SH T
PREESTABLISHES	P R IY IH S T AE B L IH SH IH Z
PREESTABLISHING	P R IY IH S T AE B L IH SH IH NG
PREETHICAL	P R IY EH TH IH K AH L
PREEXILIC	P R IY EH K S AY L IH K
PREEXIST	P R IY IH G Z IH S T
PREEXISTED	P R IY IH G Z IH S T IH D
PREEXISTENCE	P R IY EH G Z IH S T AH N S
PREEXISTENCES	P R IY EH G Z IH S T AH N S IH Z
PREEXISTENT	P R IY EH G Z IH S T AH N T
PREEXISTING	P R IY IH G Z IH S T IH NG
PREEXISTS	P R IY IH G Z IH S T S
PREEXPERIMENT	P R IY IH K S P EH R AH M AH N T
PREEXPERIMENTS	P R IY IH K S P EH R AH M AH N T S
PREFREEZE	P R IY F R IY Z
PREFREEZES	P R IY F R IY Z IH Z
PREFREEZING	P R IY F R IY Z IH NG
PREMEET	P R IY M IY T
PRESCREEN	P R IY S K R IY N
PRESCREENED	P R IY S K R IY N D
PRESCREENING	P R IY S K R IY N IH NG
PRESCREENINGS	P R IY S K R IY N IH NG Z
PRESCREENS	P R IY S K R IY N Z
PRESENTEE	P R EH Z AH N T IY
PRESENTEES	P R EH Z AH N T IY Z
PRESLEEP	P R IY S L IY P
PRESWEETEN	P R IY S W IY T AH N
PRESWEETENED	P R IY S W IY T AH N D
PRESWEETENING	P R IY S W IY T AH N IH NG
PRESWEETENS	P R IY S W IY T AH N Z
PRETEEN	P R IY T IY N
PRETEENS	P R IY T IY N Z
PRITHEE	P R AY TH IY
PRIVATEER	P R AY V AH T IH R
PRIVATEERED	P R AY V AH T IH R D
PRIVATEERING	P R AY V AH T IH R IH NG
PRIVATEERS	P R AY V AH T IH R Z
PROCEED	P R AH S IY D
PROCEED(2)	P R OW S IY D
PROCEED(3)	P ER S IY D
PROCEEDED	P R AH S IY D AH D
PROCEEDED(2)	P R OW S IY D IH D
PROCEEDING	P R AH S IY D IH NG
PROCEEDING(2)	P R OW S IY D IH NG
PROCEEDINGS	P R OW S IY D IH NG Z
PROCEEDINGS(2)	P R AH S IY D IH NG Z
PROCEEDS	P R AH S IY D Z
PROCEEDS(2)	P R OW S IY D Z
PROFITEER	P R AA F AH T IH R
PROFITEERED	P R AA F AH T IH R D
PROFITEERING	P R AA F AH T IH R IH NG
PROFITEERS	P R AA F AH T IH R Z
PROMISEE	P R AA M AH S IY
PROMISEES	P R AA M AH S IY Z
PROTEGEE	P R OW T AH ZH EY IY
PROTEGEES	P R OW T AH ZH EY IY Z
PRYTHEE	P R AY TH IY
PUGAREE	P AH G ER IY
PUGAREES	P AH G ER IY Z
PUGGAREE	P AH G ER IY
PUGGAREES	P AH G ER IY Z
PUGGREE	P AH G R IY IY
PUGGREES	P AH G R IY Z
PUGREE	P AH G R IY IY
PUGREES	P AH G R IY Z
PUMPKINSEED	P AH M P K AH N S IY D
PUMPKINSEEDS	P AH M P K AH N S IY D Z
PUPPETEER	P AH P AH T IY R
PUPPETEERS	P AH P AH T IY R Z
PUREE	P Y UH R EY
PUREED	P Y UH R D
PUREEING	P Y UH R IH NG
PUREES	P Y UH R IY Z
PUTTEE	P AH T IY
PUTTEES	P AH T IY Z
QUEEN	K W IY N
QUEENDOM	K W IY N D AH M
QUEENDOMS	K W IY N D AH M Z
QUEENED	K W IY N D
QUEENING	K W IY N IH NG
QUEENLIER	K W IY N L IY ER
QUEENLIEST	K W IY N L IY AH S T
QUEENLINESS	K W IY N L IY N AH S
QUEENLINESSES	K W IY N L IY N AH S IH Z
QUEENLY	K W IY N L IY
QUEENS	K W IY N Z
QUEENSHIP	K W IY N SH IH P
QUEENSHIPS	K W IY N SH IH P S
QUEENSIDE	K W IY N S AY D
QUEENSIDES	K W IY N S AY D Z
QUEER	K W IH R
QUEERED	K W IH ER D
QUEERER	K W IH R ER
QUEEREST	K W IH ER AH S T
QUEERING	K W IH ER IH NG
QUEERISH	K W IH ER IH SH
QUEERLY	K W IH ER L IY
QUEERNESS	K W IH ER N AH S
QUEERNESSES	K W IH ER N AH S IH Z
QUEERS	K W IH R Z
RACKETEER	R AE K IH T IH R
RACKETEERED	R AE K AH T IH R D
RACKETEERING	R AE K IH T IH R IH NG
RACKETEERS	R AE K AH T IH R Z
RAGEE	R EY JH IY
RAGEES	R EY JH IY Z
RAGGEE	R AE G IY
RAGGEES	R AE G IY Z
RAGWEED	R AE G W IY D
RAGWEEDS	R AE G W IY D Z
RAKEE	R EY K IY
RAKEES	R EY K IY Z
RAMEE	R AE M IY
RAMEES	R AE M IY Z
RANEE	R AE N IY
RANEES	R AE N IY Z
RAPESEED	R EY P S IY D
RAPESEEDS	R EY P S IY D Z
RAPPAREE	R AE P ER IY
RAPPAREES	R AE P ER IY Z
RAPPEE	R AE P IY
RAPPEES	R AE P IY Z
RATAFEE	R AE T AH F IY
RATAFEES	R AE T AH F IY Z
RATTEEN	R AE T IY N
RATTEENS	R AE T IY N Z
RAZEE	R EY Z IY
RAZEED	R EY Z D
RAZEEING	R EY Z IH NG
RAZEES	R EY Z IY Z
REBREED	R IY B R IY D
REBREEDING	R IY B R IY D IH NG
REBREEDS	R IY B R IY D Z
REDEEM	R IH D IY M
REDEEMABLE	R IH D IY M AH B AH L
REDEEMED	R IH D IY M D
REDEEMER	R IY D IY M ER
REDEEMERS	R IY D IY M ER Z
REDEEMING	R IH D IY M IH NG
REDEEMS	R AH D IY M Z
REE	R IY
REEARN	R IY ER N
REEARNED	R IY ER N D
REEARNING	R IY ER N IH NG
REEARNS	R IY ER N Z
REECHIER	R IY EH CH AY AH R
REECHIEST	R IY EH CH AY AH S T
REECHO	R IY EH K OW
REECHOED	R IY EH K OW D
REECHOES	R IY EH K OW Z
REECHOING	R IY EH K OW IH NG
REECHY	R IY EH CH IY
REED	R IY D
REEDBIRD	R IY D B ER D
REEDBIRDS	R IY D B ER D Z
REEDBUCK	R IY D B AH K
REEDBUCKS	R IY D B AH K S
REEDED	R IY D IH D
REEDIER	R IY D IY ER
REEDIEST	R IY D IY AH S T
REEDIFIED	R IY EH D AH F AY D
REEDIFIES	R IY EH D AH F AY Z
REEDIFY	R IY EH D AH F AY
REEDIFYING	R IY EH D AH F AY IH NG
REEDILY	R IY D IY L IY
REEDINESS	R IY D IY N AH S
REEDINESSES	R IY D IY N AH S IH Z
REEDING	R IY D IH NG
REEDINGS	R IY D IH NG Z
REEDIT	R IY EH D AH T
REEDITED	R IY EH D AH T IH D
REEDITING	R IY EH D AH T IH NG
REEDITION	R IY IH D IH SH AH N
REEDITIONS	R IY IH D IH SH AH N Z
REEDITS	R IY EH D AH T S
REEDLIKE	R IY D L AY K
REEDLING	R IY D L IH NG
REEDLINGS	R IY D L IH NG Z
REEDMAN	R IY D M AE N
REEDMEN	R IY D M EH N
REEDS	R IY D Z
REEDUCATE	R IY EH JH AH K EY T
REEDUCATED	R IY EH JH AH K EY T IH D
REEDUCATES	R IY EH JH AH K AH T S
REEDUCATING	R IY EH JH AH K EY T IH NG
REEDUCATION	R IY EH JH AH K EY SH AH N
REEDUCATIONS	R IY EH JH AH K EY SH AH N Z
REEDUCATIVE	R IY EH JH AH K AH T IH V
REEDY	R IY D IY
REEF	R IY F
REEFABLE	R IY F AH B AH L
REEFED	R IY F T
REEFER	R IY F ER
REEFERS	R IY F ER Z
REEFIER	R IY F IY ER
REEFIEST	R IY F IY AH S T
REEFING	R IY F IH NG
REEFS	R IY F S
REEFY	R IY F IY
REEJECT	R IY IH JH EH K T
REEJECTED	R IY IH JH EH K T IH D
REEJECTING	R IY IH JH EH K T IH NG
REEJECTS	R IY IH JH EH K T S
REEK	R IY K
REEKED	R IY K T
REEKER	R IY K ER
REEKERS	R IY K ER Z
REEKIER	R IY K IY ER
REEKIEST	R IY K IY AH S T
REEKING	R IY K IH NG
REEKS	R IY K S
REEKY	R IY K IY
REEL	R IY L
REELABLE	R IY L AH B AH L
REELECT	R IY IH L EH K T
REELECTED	R IY IH L EH K T AH D
REELECTED(2)	R IY IH L EH K T IH D
REELECTING	R IY IH L EH K T IH NG
REELECTION	R IY IH L EH K SH AH N
REELECTIONS	R IY IH L EH K SH AH N Z
REELECTS	R IY IH L EH K T S
REELED	R IY L D
REELER	R IY L ER
REELERS	R IY L ER Z
REELIGIBILITIES	R IY EH L IH JH AH B IH L AH T IY Z
REELIGIBILITY	R IY EH L IH JH AH B IH L AH T IY
REELIGIBLE	R IY EH L IH JH AH B AH L
REELING	R IY L IH NG
REELS	R IY L Z
REEMBARK	R IY IH M B AA R K
REEMBARKED	R IY IH M B AA R K T
REEMBARKING	R IY IH M B AA R K IH NG
REEMBARKS	R IY IH M B AA R K S
REEMBODIED	R IY IH M B AA D IY D
REEMBODIES	R IY IH M B AA D IY Z
REEMBODY	R IY IH M B AA D IY
REEMBODYING	R IY IH M B AA D IY IH NG
REEMBROIDER	R IY IH M B R OY D ER
REEMBROIDERED	R IY IH M B R OY D ER D
REEMBROIDERING	R IY IH M B R OY D ER IH NG
REEMBROIDERS	R IY IH M B R OY D ER Z
REEMERGE	R IY IH M ER JH
REEMERGED	R IY IH M ER JH D
REEMERGENCE	R IY IH M ER JH AH N S
REEMERGENCES	R IY IH M ER JH AH N S IH Z
REEMERGES	R IY IH M ER JH IH Z
REEMERGING	R IY IH M ER JH IH NG
REEMISSION	R IY IY M IH SH AH N
REEMISSIONS	R IY IY M IH SH AH N Z
REEMIT	R IY IY M IH T
REEMITS	R IY IY M IH T S
REEMITTED	R IY IY M IH T IH D
REEMITTING	R IY IY M IH T IH NG
REEMPHASES	R IY EH M F AH S IY Z
REEMPHASIS	R IY EH M F AH S AH S
REEMPHASIZE	R IY EH M F AH S AY Z
REEMPHASIZED	R IY EH M F AH S AY Z D
REEMPHASIZES	R IY EH M F AH S AY Z IH Z
REEMPHASIZING	R IY EH M F AH S AY Z IH NG
REEMPLOY	R IY IH M P L OY
REEMPLOYED	R IY IH M P L OY IY D
REEMPLOYING	R IY IH M P L OY IY IH NG
REEMPLOYMENT	R IY IH M P L OY M AH N T
REEMPLOYMENTS	R IY IH M P L OY M AH N T S
REEMPLOYS	R IY IH M P L OY Z
REENACT	R IY IH N AE K T
REENACTED	R IY IH N AE K T IH D
REENACTING	R IY EH N AE K T IH NG
REENACTMENT	R IY IH N AE K T M AH N T
REENACTMENTS	R IY IH N AE K T M AH N T S
REENACTS	R IY IH N AE K T S
REENCOUNTER	R IY IH N K AW N T ER
REENCOUNTERED	R IY IH N K AW N T ER D
REENCOUNTERING	R IY IH N K AW N T ER IH NG
REENCOUNTERS	R IY IH N K AW N T ER Z
REENDOW	R IY EH N D AW
REENDOWED	R IY EH N D AW D
REENDOWING	R IY EH N D AW IH NG
REENDOWS	R IY EH N D AW Z
REENERGIZE	R IY AH N AH R JH AY Z
REENERGIZED	R IY AH N AH R JH AY Z D
REENERGIZES	R IY AH N AH R JH AY Z AH Z
REENERGIZING	R IY AH N AH R JH AY Z AH NG
REENFORCE	R IY EH N F OW R S
REENFORCED	R IY EH N F OW R S T
REENFORCES	R IY EH N F OW R S IH Z
REENFORCING	R IY EH N F OW R S IH NG
REENGAGE	R IY EH N G EY JH
REENGAGED	R IY EH N G EY JH D
REENGAGEMENT	R IY EH N G EY JH M AH N T
REENGAGEMENTS	R IY EH N G EY JH M AH N T S
REENGAGES	R IY EH N G EY JH IH Z
REENGAGING	R IY EH N G EY JH IH NG
REENGINEER	R IY EH N JH AH N IH R
REENGINEERED	R IY EH N JH AH N IH R D
REENGINEERING	R IY EH N JH AH N IH R IH NG
REENGINEERS	R IY EH N JH AH N IH R Z
REENGRAVE	R IY EH N G R EY V
REENGRAVED	R IY EH N G R EY V D
REENGRAVES	R IY EH N G R EY V Z
REENGRAVING	R IY EH N G R EY V IH NG
REENJOY	R IY EH N JH OY
REENJOYED	R IY EH N JH OY D
REENJOYING	R IY EH N JH OY IH NG
REENJOYS	R IY EH N JH OY Z
REENLIST	R IY EH N L IH S T
REENLISTED	R IY EH N L IH S T IH D
REENLISTING	R IY EH N L IH S T IH NG
REENLISTMENT	R IY EH N L IH S T M AH N T
REENLISTMENTS	R IY EH N L IH S T M AH N T S
REENLISTS	R IY EH N L IH S T S
REENROLL	R IY EH N R OW L
REENROLLED	R IY EH N R OW L D
REENROLLING	R IY EH N R OW L IH NG
REENROLLS	R IY EH N R OW L Z
REENTER	R IY IH N T ER
REENTERED	R IY IH N T ER D
REENTERING	R IY IH N T ER IH NG
REENTERS	R IY EH N T ER Z
REENTHRONE	R IY EH N TH R OW N
REENTHRONED	R IY EH N TH R OW N D
REENTHRONES	R IY EH N TH R OW N Z
REENTHRONING	R IY EH N TH R OW N IH NG
REENTRANCE	R IY EH N T R AH N S
REENTRANCES	R IY EH N T R AH N S IH Z
REENTRANT	R IY EH N T R AH N T
REENTRANTS	R IY EH N T R AH N T S
REENTRIES	R IY EH N T R IY Z
REENTRY	R IY IH N T R IY
REEQUIP	R IY IH K W IH P
REEQUIPMENT	R IY IH K W IH P M AH N T
REEQUIPMENTS	R IY IH K W IH P M AH N T S
REEQUIPPED	R IY IH K W IH P T
REEQUIPPING	R IY IH K W IH P IH NG
REEQUIPS	R IY IH K W IH P S
REERECT	R IY IH R EH K T
REERECTED	R IY IH R EH K T IH D
REERECTING	R IY IH R EH K T IH NG
REERECTS	R IY IH R EH K T S
REES	R IY Z
REESCALATE	R IY EH S K AH L EY T
REESCALATED	R IY EH S K AH L EY T IH D
REESCALATES	R IY EH S K AH L EY T S
REESCALATING	R IY EH S K AH L EY T IH NG
REESCALATION	R IY EH S K AH L EY SH AH N
REESCALATIONS	R IY EH S K AH L EY SH AH N Z
REEST	R IY AH S T
REESTABLISH	R IY IH S T AE B L IH SH
REESTABLISHED	R IY IH S T AE B L IH SH T
REESTABLISHES	R IY IH S T AE B L IH SH IH Z
REESTABLISHING	R IY IH S T AE B L IH SH IH NG
REESTABLISHMENT	R IY IH S T AE B L IH SH M AH N T
REESTABLISHMENTS	R IY IH S T AE B L IH SH M AH N T S
REESTED	R IY EH S T AH D
REESTIMATE	R IY EH S T AH M AH T
REESTIMATED	R IY EH S T AH M EY T IH D
REESTIMATES	R IY EH S T AH M AH T S
REESTIMATING	R IY EH S T AH M EY T IH NG
REESTING	R IY EH S T AH NG
REESTS	R IY EH S T S
REEVALUATE	R IY IH V AE L UW EY T
REEVALUATED	R IY IH V AE L Y UW EY T IH D
REEVALUATES	R IY IH V AE L Y AH W EY T S
REEVALUATING	R IY IH V AE L Y UW EY T IH NG
REEVALUATION	R IY IH V AE L Y UW EY SH AH N
REEVALUATIONS	R IY IH V AE L Y AH W EY SH AH N Z
REEVE	R IY V
REEVED	R IY IY V D
REEVES	R IY V Z
REEVING	R IY IY V IH NG
REEVOKE	R IY IH V OW K
REEVOKED	R IY IH V OW K T
REEVOKES	R IY IH V OW K S
REEVOKING	R IY IH V OW K IH NG
REEXAMINATION	R IY IH G Z AE M AH N EY SH AH N
REEXAMINATIONS	R IY EH G Z AE M AH N EY SH AH N Z
REEXAMINE	R IY EH G Z AE M AH N
REEXAMINED	R IY IH G Z AE M AH N D
REEXAMINES	R IY EH G Z AE M AH N Z
REEXAMINING	R IY IH G Z AE M AH N IH NG
REEXPEL	R IY IH K S P EH L
REEXPELLED	R IY IH K S P EH L D
REEXPELLING	R IY IH K S P EH L IH NG
REEXPELS	R IY IH K S P EH L Z
REEXPERIENCE	R IY IH K S P IH R IY AH N S
REEXPERIENCED	R IY IH K S P IH R IY AH N S T
REEXPERIENCES	R IY IH K S P IH R IY AH N S IH Z
REEXPERIENCING	R IY IH K S P IH R IY AH N S IH NG
REEXPLORE	R IY IH K S P L OW R
REEXPLORED	R IY IH K S P L OW R D
REEXPLORES	R IY IH K S P L OW R Z
REEXPLORING	R IY IH K S P L OW R IH NG
REEXPORT	R IY EH K S P AO R T
REEXPORTATION	R IY EH K S P OW R T EY SH AH N
REEXPORTATIONS	R IY EH K S P OW R T EY SH AH N Z
REEXPORTED	R IY EH K S P OW R T IH D
REEXPORTING	R IY EH K S P OW R T IH NG
REEXPORTS	R IY EH K S P AO R T S
REEXPOSE	R IY IH K S P OW Z
REEXPOSED	R IY IH K S P OW Z D
REEXPOSES	R IY IH K S P OW Z IH Z
REEXPOSING	R IY IH K S P OW Z IH NG
REEXPOSURE	R IY IH K S P OW ZH ER
REEXPOSURES	R IY IH K S P OW ZH ER Z
REEXPRESS	R IY IH K S P R EH S
REEXPRESSED	R IY IH K S P R EH S T
REEXPRESSES	R IY IH K S P R EH S IH Z
REEXPRESSING	R IY IH K S P R EH S IH NG
REFEED	R IY F IY D
REFEEDING	R IY F IY D IH NG
REFEEDS	R IY F IY D Z
REFEEL	R IY F IY L
REFEELING	R IY F IY L IH NG
REFEELS	R IY F IY L Z
REFEREE	R EH F ER IY
REFEREED	R IH F AH R IY D
REFEREEING	R EH F AH R IY IH NG
REFEREES	R EH F ER IY Z
REFREEZE	R IY F R IY Z
REFREEZES	R IY F R IY Z IH Z
REFREEZING	R IY F R IY Z IH NG
REFUGEE	R EH F Y UW JH IY
REFUGEEISM	R EH F Y UW JH IH Z AH M
REFUGEEISMS	R EH F Y UW JH IH Z AH M Z
REFUGEES	R EH F Y UW JH IY Z
REGREEN	R IY G R IY N
REGREENED	R IY G R IY N D
REGREENING	R IY G R IY N IH NG
REGREENS	R IY G R IY N Z
REGREET	R IY G R IY T
REGREETED	R IY G R IY T IH D
REGREETING	R IY G R IY T IH NG
REGREETS	R IY G R IY T S
REHEEL	R IY HH IY L
REHEELED	R IY HH IY L D
REHEELING	R IY HH IY L IH NG
REHEELS	R IY HH IY L Z
REINDEER	R EY N D IH R
REINDEERS	R IY IH N D IH ER Z
REJECTEE	R IH JH EH K T IY
REJECTEES	R IH JH EH K T IY Z
RELOCATEE	R IY L OW K AH T IY
RELOCATEES	R IY L OW K AH T IY Z
REMEET	R IY M IY T
REMEETING	R IY M IY T IH NG
REMEETS	R IY M IY T S
REPARTEE	R EH P ER T IY
REPARTEES	R EH P ER T IY Z
RESCREEN	R IY S K R IY N
RESCREENED	R IY S K R IY N D
RESCREENING	R IY S K R IY N IH NG
RESCREENS	R IY S K R IY N Z
RESEE	R IY S IY
RESEED	R IY S IY D
RESEEDED	R IY S IY D IH D
RESEEDING	R IY S IY D IH NG
RESEEDS	R IY S IY D Z
RESEEING	R IY S IY IH NG
RESEEK	R IY S IY K
RESEEKING	R IY S IY K IH NG
RESEEKS	R IY S IY K S
RESEEN	R IY S IY N
RESEES	R IY S IY Z
RETIREE	R IY T AY R IY
RETIREES	R IY T AY R IY Z
RETURNEE	R IH T ER N IY
RETURNEES	R IH T ER N IY Z
RICHWEED	R IH CH W IY D
RICHWEEDS	R IH CH W IY D Z
ROCKETEER	R AA K AH T IH R
ROCKETEERS	R AA K AH T IH R Z
ROCKWEED	R AA K W IY D
ROCKWEEDS	R AA K W IY D Z
ROOFTREE	R UW F T R IY
ROOFTREES	R UW F T R IY Z
ROSINWEED	R AH S IH N W IY D
ROSINWEEDS	R AA S AH N W IY D Z
RUPEE	R UW P IY
RUPEES	R UW P IY Z
RUSHEE	R AH SH IY
RUSHEES	R AH SH IY Z
SADDLETREE	S AE D AH L T R IY
SADDLETREES	S AE D AH L T R IY Z
SAFEKEEPING	S EY F K IY P IH NG
SAFEKEEPINGS	S EY F K IY P IH NG Z
SALVAGEE	S AE L V IH JH IY
SALVAGEES	S AE L V IH JH IY Z
SANDPEEP	S AE N D P IY P
SANDPEEPS	S AE N D P IY P S
SANGAREE	S AE NG G AH R IY
SANGAREES	S AE NG G AH R IY Z
SAREE	S AH R IY IY
SAREES	S AH R IY Z
SATEEN	S EY T IY AH N
SATEENS	S EY T IY N Z
SAUTEED	S AO T EY D
SAWTEETH	S AO T IY TH
SCHEELITE	S K IY L AY T
SCHEELITES	S K IY L AY T S
SCHMEER	S K M IY AH R
SCHMEERED	S K M IH R D
SCHMEERING	S K M IH R AH NG
SCHMEERS	S K M IH R Z
SCOREKEEPER	S K AO R K IY P ER
SCOREKEEPERS	S K AO R K IY P ER Z
SCREE	S K R IY
SCREECH	S K R IY CH
SCREECHED	S K R IY CH T
SCREECHER	S K R IY CH ER
SCREECHERS	S K R IY CH ER Z
SCREECHES	S K R IY CH IH Z
SCREECHIER	S K R IY CH IY ER
SCREECHIEST	S K R IY CH IY AH S T
SCREECHING	S K R IY CH IH NG
SCREECHY	S K R IY CH IY
SCREED	S K R IY D
SCREEDED	S K R IY D AH D
SCREEDING	S K R IY D AH NG
SCREEDS	S K R IY D Z
SCREEN	S K R IY N
SCREENABLE	S K R IY N AH B AH L
SCREENED	S K R IY N D
SCREENER	S K R IY N ER
SCREENERS	S K R IY N ER Z
SCREENING	S K R IY N IH NG
SCREENINGS	S K R IY N IH NG Z
SCREENLAND	S K R IY N L AE N D
SCREENLANDS	S K R IY N L AE N D Z
SCREENPLAY	S K R IY N P L EY
SCREENPLAYS	S K R IY N P L EY Z
SCREENS	S K R IY N Z
SCREENWRITER	S K R IY N R AY T ER
SCREENWRITERS	S K R IY N R AY T ER Z
SCREES	S K R IY Z
SCRUTINEER	S K R UW T AH N IH R
SCRUTINEERS	S K R UW T AH N AH R Z
SEAWEED	S IY W IY D
SEAWEEDS	S IY W IY D Z
SEE	S IY
SEEABLE	S IY AH B AH L
SEECATCH	S IY K AE CH
SEECATCHIE	S IY K AE CH IY
SEED	S IY D
SEEDBED	S IY D B EH D
SEEDBEDS	S IY D B EH D Z
SEEDCAKE	S IY D K EY K
SEEDCAKES	S IY D K EY K S
SEEDCASE	S IY D K EY S
SEEDCASES	S IY D K EY S IH Z
SEEDEATER	S IY D IY T ER
SEEDEATERS	S IY D IY T ER Z
SEEDED	S IY D AH D
SEEDED(2)	S IY D IH D
SEEDER	S IY D ER
SEEDERS	S IY D ER Z
SEEDIER	S IY D IY ER
SEEDIEST	S IY D IY AH S T
SEEDILY	S IY D IY L IY
SEEDINESS	S IY D IY N AH S
SEEDINESSES	S IY D IY N AH S IH Z
SEEDING	S IY D IH NG
SEEDLESS	S IY D L AH S
SEEDLIKE	S IY D L AY K
SEEDLING	S IY D L IH NG
SEEDLINGS	S IY D L IH NG Z
SEEDMAN	S IY D M AE N
SEEDMEN	S IY D M EH N
SEEDPOD	S IY D P AA D
SEEDPODS	S IY D P AA D Z
SEEDS	S IY D Z
SEEDSMAN	S IY D Z M AH N
SEEDSMEN	S IY D Z M EH N
SEEDTIME	S IY D T AY M
SEEDTIMES	S IY D T AY M Z
SEEDY	S IY D IY
SEEING	S IY IH NG
SEEINGS	S IY IH NG Z
SEEK	S IY K
SEEKER	S IY K ER
SEEKERS	S IY K ER Z
SEEKING	S IY K IH NG
SEEKS	S IY K S
SEEL	S IY L
SEELED	S IY L EH D
SEELING	S IY L IH NG
SEELS	S IY L Z
SEELY	S IY L IY
SEEM	S IY M
SEEMED	S IY M D
SEEMER	S IY M ER
SEEMERS	S IY M ER Z
SEEMING	S IY M IH NG
SEEMINGLY	S IY M IH NG L IY
SEEMINGS	S IY M IH NG Z
SEEMLIER	S IY M L IY ER
SEEMLIEST	S IY M L IY AH S T
SEEMLINESS	S IY M L IY N AH S
SEEMLINESSES	S IY M L IY N AH S IH Z
SEEMLY	S IY M L IY
SEEMS	S IY M Z
SEEN	S IY N
SEEP	S IY P
SEEPAGE	S IY P IH JH
SEEPAGES	S IY P IH JH IH Z
SEEPED	S IY P T
SEEPIER	S IY P IY ER
SEEPIEST	S IY P IY AH S T
SEEPING	S IY P IH NG
SEEPS	S IY P S
SEEPY	S IY P IY
SEER	S IY R
SEERESS	S IH R AH S
SEERESSES	S AH R EH S AH Z
SEERS	S IY R Z
SEERSUCKER	S IH ER S AH K ER
SEERSUCKERS	S IH ER S AH K ER Z
SEES	S IY Z
SEESAW	S IY S AO
SEESAWED	S IY S AO D
SEESAWING	S IY S AO IH NG
SEESAWS	S IY S AO Z
SEETHE	S IY DH
SEETHED	S IY TH T
SEETHES	S IY TH S
SEETHING	S IY DH IH NG
SELECTEE	S AH L EH K T IY
SELECTEES	S AH L EH K T IY Z
SEMIEVERGREEN	S EH M IY EH V ER G R IY N
SEMISWEET	S EH M IY S W IY T
SEMIWEEKLIES	S EH M IY W IY K L IY Z
SEMIWEEKLY	S EH M IY W IY K L IY
SETTEE	S EH T IY
SETTEES	S EH T IY Z
SEVENTEEN	S EH V AH N T IY N
SEVENTEENS	S EH V AH N T IY N Z
SEVENTEENTH	S EH V AH N T IY N TH
SEVENTEENTHS	S EH V AH N T IY N TH S
SHAGREEN	SH EY G R IY AH N
SHAGREENS	SH AE G R IY N Z
SHEBEEN	SH IY B IY AH N
SHEBEENS	SH IY B IY N Z
SHEEN	SH IY N
SHEENED	SH IY N D
SHEENEY	SH IY N IY
SHEENEYS	SH IY N EY Z
SHEENFUL	SH IY N F AH L
SHEENIE	SH IY N IY
SHEENIER	SH IY N IY ER
SHEENIES	SH IY N IY Z
SHEENIEST	SH IY N IY AH S T
SHEENING	SH IY N IH NG
SHEENS	SH IY N Z
SHEENY	SH IY N IY
SHEEP	SH IY P
SHEEPBERRIES	SH IY P B EH R IY Z
SHEEPBERRY	SH IY P B EH R IY
SHEEPCOT	SH IY P K AA T
SHEEPCOTE	SH IY P OW T
SHEEPCOTES	SH IY P OW T S
SHEEPCOTS	SH IY P K AA T S
SHEEPDOG	SH IY P D AO G
SHEEPDOGS	SH IY P D AO G Z
SHEEPFOLD	SH IY P F OW L D
SHEEPFOLDS	SH IY P F OW L D Z
SHEEPHERDER	SH IY P HH ER D ER
SHEEPHERDERS	SH IY P HH ER D ER Z
SHEEPHERDING	SH IY P HH ER D IH NG
SHEEPHERDINGS	SH IY P HH ER D IH NG Z
SHEEPISH	SH IY P IH SH
SHEEPISHLY	SH IY P IH SH L IY
SHEEPISHNESS	SH IY P IH SH N AH S
SHEEPISHNESSES	SH IY P IH SH N AH S IH Z
SHEEPLIKE	SH IY P L AY K
SHEEPMAN	SH IY P M AE N
SHEEPMEN	SH IY P M EH N
SHEEPSHANK	SH IY P SH AE NG K
SHEEPSHANKS	SH IY P SH AE NG K S
SHEEPSHEAD	SH IY P S HH EH D
SHEEPSHEADS	SH IY P S HH EH D Z
SHEEPSHEARER	SH IY P SH IH ER ER
SHEEPSHEARERS	SH IY P SH IH ER ER Z
SHEEPSHEARING	SH IY P SH IH ER IH NG
SHEEPSHEARINGS	SH IY P SH IH ER IH NG Z
SHEEPSKIN	SH IY P S K IH N
SHEEPSKINS	SH IY P S K IH N Z
SHEER	SH IH R
SHEERED	SH IH ER D
SHEERER	SH IY R ER
SHEEREST	SH IH ER AH S T
SHEERING	SH IH ER IH NG
SHEERLEGS	SH IH ER L EH G Z
SHEERLY	SH IH ER L IY
SHEERNESS	SH IH ER N AH S
SHEERNESSES	SH IH ER N AH S IH Z
SHEERS	SH IH ER Z
SHEESH	SH IY SH
SHEET	SH IY T
SHEETED	SH IY T IH D
SHEETER	SH IY T ER
SHEETERS	SH IY T ER Z
SHEETFED	SH IY T F EH D
SHEETING	SH IY T IH NG
SHEETINGS	SH IY T IH NG Z
SHEETLIKE	SH IY T L AY K
SHEETS	SH IY T S
SHEEVE	SH IY V
SHEEVES	SH IY V Z
SHEREEF	SH IY R IY F
SHEREEFS	SH IY R IY F S
SHIKAREE	SH IH K AH R IY IY
SHIKAREES	SH IH K AH R IY Z
SHIRTSLEEVE	SH ER T S L IY V
SHIRTSLEEVED	SH ER T S L IY V D
SHIRTSLEEVES	SH ER T S L IY V Z
SHIVAREE	SH IH V AH R IY IY
SHIVAREED	SH IH V AH R IY D
SHIVAREEING	SH AH V AE R IY AH NG
SHIVAREES	SH IH V AH R IY Z
SHOETREE	SH UW T R IY
SHOETREES	SH UW T R IY Z
SHOPKEEPER	SH AA P K IY P ER
SHOPKEEPERS	SH AA P K IY P ER Z
SICKEE	S IH K IY
SICKEES	S IH K IY Z
SIGHTSEE	S AY T S IY
SIGHTSEEING	S AY T S IY IH NG
SIGHTSEEN	S AY T S IY N
SIGHTSEER	S AY T S IY ER
SIGHTSEER(2)	S AY T S IY R
SIGHTSEERS	S AY T S IY ER Z
SIGHTSEERS(2)	S AY T S IY R Z
SIGHTSEES	S AY T S IY Z
SIGNEE	S AY N IY
SIGNEES	S AY N IY Z
SILKSCREEN	S IH L K S K R IY N
SILKSCREENS	S IH L K S K R IY N Z
SILKWEED	S IH L K W IY D
SILKWEEDS	S IH L K W IY D Z
SILVERWEED	S IH L V ER W IY D
SILVERWEEDS	S IH L V ER W IY D Z
SINGLETREE	S IH NG G AH L T R IY
SINGLETREES	S IH NG G AH L T R IY Z
SIREE	S AY ER IY
SIREES	S AY ER IY Z
SIRREE	S ER IY
SIRREES	S ER IY Z
SIXTEEN	S IH K S T IY N
SIXTEENMO	S IH K S T IY N M OW
SIXTEENMOS	S IH K S T IY N M AH Z
SIXTEENS	S IH K S T IY N Z
SIXTEENTH	S IH K S T IY N TH
SIXTEENTHS	S IH K S T IY N TH S
SKEE	S K IY
SKEED	S K IY D
SKEEING	S K IY AH NG
SKEEN	S K IY N
SKEENS	S K IY N Z
SKEES	S K IY Z
SKEET	S K IY T
SKEETER	S K IY T ER
SKEETERS	S K IY T ER Z
SKEETS	S K IY T S
SKREEGH	S K R IY
SKREEGHED	S K R IY D
SKREEGHING	S K R IY AH NG
SKREEGHS	S K R IY Z
SLEEK	S L IY K
SLEEKED	S L IY K T
SLEEKEN	S L IY K AH N
SLEEKENED	S L IY K AH N D
SLEEKENING	S L IY K AH N IH NG
SLEEKENS	S L IY K AH N Z
SLEEKER	S L IY K ER
SLEEKEST	S L IY K AH S T
SLEEKIER	S L IY K IY ER
SLEEKIEST	S L IY K IY AH S T
SLEEKING	S L IY K IH NG
SLEEKIT	S L IY K AH T
SLEEKLY	S L IY K L IY
SLEEKNESS	S L IY K N AH S
SLEEKNESSES	S L IY K N AH S IH Z
SLEEKS	S L IY K S
SLEEKY	S L IY K IY
SLEEP	S L IY P
SLEEPER	S L IY P ER
SLEEPERS	S L IY P ER Z
SLEEPIER	S L IY P IY ER
SLEEPIEST	S L IY P IY AH S T
SLEEPILY	S L IY P AH L IY
SLEEPINESS	S L IY P IY N AH S
SLEEPINESSES	S L IY P IY N AH S IH Z
SLEEPING	S L IY P IH NG
SLEEPINGS	S L IY P IH NG Z
SLEEPLESS	S L IY P L AH S
SLEEPLESSLY	S L IY P L AH S L IY
SLEEPLESSNESS	S L IY P L AH S N AH S
SLEEPLESSNESSES	S L IY P L AH S N AH S IH Z
SLEEPLIKE	S L IY P L AY K
SLEEPOVER	S L IY P OW V ER
SLEEPOVERS	S L IY P OW V ER Z
SLEEPS	S L IY P S
SLEEPWALK	S L IY P W AO K
SLEEPWALKED	S L IY P W AO K T
SLEEPWALKER	S L IY P W AO K ER
SLEEPWALKERS	S L IY P W AO K ER Z
SLEEPWALKING	S L IY P W AO K IH NG
SLEEPWALKS	S L IY P W AO K S
SLEEPWEAR	S L IY P W EH R
SLEEPY	S L IY P IY
SLEEPYHEAD	S L IY P IY HH EH D
SLEEPYHEADS	S L IY P IY HH EH D Z
SLEET	S L IY T
SLEETED	S L IY T IH D
SLEETIER	S L IY T IY ER
SLEETIEST	S L IY T IY AH S T
SLEETING	S L IY T IH NG
SLEETS	S L IY T S
SLEETY	S L IY T IY
SLEEVE	S L IY V
SLEEVED	S L IY V D
SLEEVELESS	S L IY V L IH S
SLEEVELET	S L IY V L AH T
SLEEVELETS	S L IY V L AH T S
SLEEVES	S L IY V Z
SLEEVING	S L IY V IH NG
SLOGANEER	S L OW G AH N IH R
SLOGANEERED	S L OW G AH N IH R D
SLOGANEERING	S L OW G AH N IH R IH NG
SLOGANEERS	S L OW G AH N IH R Z
SMARTWEED	S M AA R T W IY D
SMARTWEEDS	S M AA R T W IY D Z
SMEEK	S M IY K
SMEEKED	S M IY K T
SMEEKING	S M IY K AH NG
SMEEKS	S M IY K S
SMITHEREENS	S M IH DH ER IY N Z
SMOKESCREEN	S M OW K S K R IY N
SMOKESCREENS	S M OW K S K R IY N Z
SNAGGLETEETH	S N AE G L IY T IY AH TH
SNAKEWEED	S N EY K W IY D
SNAKEWEEDS	S N EY K W IY D Z
SNAPWEED	S N AE P W IY D
SNAPWEEDS	S N AE P W IY D Z
SNEER	S N IH R
SNEERED	S N IH R D
SNEERER	S N IH ER ER
SNEERERS	S N IH ER ER Z
SNEERFUL	S N IH ER F AH L
SNEERING	S N IH R IH NG
SNEERS	S N IH R Z
SNEESH	S N IY SH
SNEESHES	S N IY SH AH Z
SNEEZE	S N IY Z
SNEEZED	S N IY Z D
SNEEZER	S N IY Z ER
SNEEZERS	S N IY Z ER Z
SNEEZES	S N IY Z IH Z
SNEEZEWEED	S N IY Z W IY D
SNEEZEWEEDS	S N IY Z W IY D Z
SNEEZIER	S N IY Z IY ER
SNEEZIEST	S N IY Z IY AH S T
SNEEZING	S N IY Z IH NG
SNEEZY	S N IY Z IY
SNICKERSNEE	S N IH K AH R S N IY IY
SNICKERSNEES	S N IH K AH R S N IY Z
SOIGNEE	S W AA N Y EY
SOIREE	S W AA R EY
SOIREES	S W AA R EY Z
SONNETEER	S AA N AH T IH R
SONNETEERING	S AA N AH T IH R IH NG
SONNETEERINGS	S AA N AH T IH R IH NG Z
SONNETEERS	S AA N AH T IH R Z
SOUFFLEED	S UW F L EY D
SPAHEE	S P AE IY IY
SPAHEES	S P AH HH IY Z
SPALPEEN	S P AE L P IY AH N
SPALPEENS	S P AE L P IY N Z
SPEECH	S P IY CH
SPEECHES	S P IY CH AH Z
SPEECHES(2)	S P IY CH IH Z
SPEECHIFIED	S P IY CH AH F AY D
SPEECHIFIES	S P IY CH AH F AY Z
SPEECHIFY	S P IY CH AH F AY
SPEECHIFYING	S P IY CH AH F AY IH NG
SPEECHLESS	S P IY CH L AH S
SPEECHLESSLY	S P IY CH L AH S L IY
SPEECHLESSNESS	S P IY CH L AH S N AH S
SPEECHLESSNESSES	S P IY CH L AH S N AH S IH Z
SPEECHWRITER	S P IY CH R AY T ER
SPEECHWRITERS	S P IY CH R AY T ER Z
SPEED	S P IY D
SPEEDBALL	S P IY D B AO L
SPEEDBALLED	S P IY D B AO L D
SPEEDBALLING	S P IY D B AO L IH NG
SPEEDBALLS	S P IY D B AO L Z
SPEEDBOAT	S P IY D B OW T
SPEEDBOATING	S P IY D B OW T IH NG
SPEEDBOATINGS	S P IY D B OW T IH NG Z
SPEEDBOATS	S P IY D B OW T S
SPEEDED	S P IY D IH D
SPEEDER	S P IY D ER
SPEEDERS	S P IY D ER Z
SPEEDIER	S P IY D IY ER
SPEEDIEST	S P IY D IY AH S T
SPEEDILY	S P IY D AH L IY
SPEEDINESS	S P IY D IY N AH S
SPEEDINESSES	S P IY D IY N AH S IH Z
SPEEDING	S P IY D IH NG
SPEEDINGS	S P IY D IH NG Z
SPEEDO	S P IY D OW
SPEEDOMETER	S P IY D AA M AH T ER
SPEEDOMETERS	S P IH D AA M AH T ER Z
SPEEDOS	S P IY D AA S
SPEEDS	S P IY D Z
SPEEDSTER	S P IY D S T ER
SPEEDSTERS	S P IY D S T ER Z
SPEEDUP	S P IY D AH P
SPEEDUPS	S P IY D AH P S
SPEEDWAY	S P IY D W EY
SPEEDWAYS	S P IY D W EY Z
SPEEDWELL	S P IY D W EH L
SPEEDWELLS	S P IY D W EH L Z
SPEEDY	S P IY D IY
SPEEL	S P IY L
SPEELED	S P IY L D
SPEELING	S P IY L AH NG
SPEELS	S P IY L Z
SPEER	S P IH R
SPEERED	S P IH ER D
SPEERING	S P IH ER IH NG
SPEERINGS	S P IH ER IH NG Z
SPEERS	S P IH ER Z
SPLAYFEET	S P L EY F IY T
SPLEEN	S P L IY N
SPLEENFUL	S P L IY N F AH L
SPLEENIER	S P L IY N IY ER
SPLEENIEST	S P L IY N IY AH S T
SPLEENS	S P L IY N Z
SPLEENWORT	S P L IY N W AH R T
SPLEENWORTS	S P L IY N W AH R T S
SPLEENY	S P L IY N IY
SPONDEE	S P AA N D IY IY
SPONDEES	S P AA N D IY Z
SPREADSHEET	S P R EH D SH IY T
SPREADSHEETS	S P R EH D SH IY T S
SPREE	S P R IY
SPREES	S P R IY Z
SQUEEGEE	S K W IY JH IY
SQUEEGEED	S K W IY JH IY D
SQUEEGEEING	S K W IY JH IY AH NG
SQUEEGEES	S K W IY JH IY Z
SQUEEZABILITIES	S K W IY Z AH B IH L AH T EH Z
SQUEEZABILITY	S K W IY Z AH B IH L AH T EH
SQUEEZABLE	S K W IY Z AH B AH L
SQUEEZE	S K W IY Z
SQUEEZED	S K W IY Z D
SQUEEZER	S K W IY Z ER
SQUEEZERS	S K W IY Z ER Z
SQUEEZES	S K W IY Z IH Z
SQUEEZING	S K W IY Z IH NG
SQUILGEE	S K W IH L JH IY IY
SQUILGEED	S K W IH L JH IY D
SQUILGEEING	S K W IH L JH IY AH NG
SQUILGEES	S K W IH L JH IY Z
SQUIREEN	S K W AY ER AH N
SQUIREENS	S K W AY ER AH N Z
STANDEE	S T AE N D IY
STANDEES	S T AE N D IY Z
STEED	S T IY D
STEEDS	S T IY D Z
STEEK	S T IY K
STEEKED	S T IY K T
STEEKING	S T IY K AH NG
STEEKS	S T IY K S
STEEL	S T IY L
STEELED	S T IY L D
STEELHEAD	S T IY L HH EH D
STEELHEADS	S T IY L HH EH D Z
STEELIE	S T IY L IY
STEELIER	S T IY L IY ER
STEELIES	S T IY L IY Z
STEELIEST	S T IY L IY AH S T
STEELINESS	S T IY L IY N AH S
STEELINESSES	S T IY L IY N AH S IH Z
STEELING	S T IY L IH NG
STEELMAKER	S T IY L M EY K ER
STEELMAKERS	S T IY L M EY K ER Z
STEELMAKING	S T IY L M EY K IH NG
STEELMAKINGS	S T IY L M EY K IH NG Z
STEELS	S T IY L Z
STEELWORK	S T IY L W ER K
STEELWORKER	S T IY L W ER K ER
STEELWORKERS	S T IY L W ER K ER Z
STEELWORKS	S T IY L W ER K S
STEELY	S T IY L IY
STEELYARD	S T IY L Y AA R D
STEELYARDS	S T IY L Y AA R D Z
STEENBOK	S T IY N B AH K
STEENBOKS	S T IY N B AH K S
STEEP	S T IY P
STEEPED	S T IY P T
STEEPEN	S T IY P AH N
STEEPENED	S T IY P AH N D
STEEPENING	S T IY P AH N IH NG
STEEPENS	S T IY P AH N Z
STEEPER	S T IY P ER
STEEPERS	S T IY P ER Z
STEEPEST	S T IY P AH S T
STEEPING	S T IY P IH NG
STEEPISH	S T IY P IH SH
STEEPLE	S T IY P AH L
STEEPLEBUSH	S T IY P AH L B UH SH
STEEPLEBUSHES	S T IY P AH L B UH SH IH Z
STEEPLECHASE	S T IY P AH L CH EY S
STEEPLECHASER	S T IY P AH L CH EY S ER
STEEPLECHASERS	S T IY P AH L CH EY S ER Z
STEEPLECHASES	S T IY P AH L CH EY S IH Z
STEEPLECHASING	S T IY P AH L CH EY S IH NG
STEEPLECHASINGS	S T IY P AH L CH EY S IH NG Z
STEEPLED	S T IY P AH L D
STEEPLEJACK	S T IY P AH L JH AE K
STEEPLEJACKS	S T IY P AH L JH AE K S
STEEPLES	S T IY P AH L Z
STEEPLY	S T IY P L IY
STEEPNESS	S T IY P N AH S
STEEPNESSES	S T IY P N AH S IH Z
STEEPS	S T IY P S
STEER	S T IH R
STEERABLE	S T IH ER AH B AH L
STEERAGE	S T IH ER IH JH
STEERAGES	S T IH ER IH JH IH Z
STEERAGEWAY	S T IH ER EY JH W EY
STEERAGEWAYS	S T IH ER EY JH W EY Z
STEERED	S T IH R D
STEERER	S T IH ER ER
STEERERS	S T IH ER ER Z
STEERING	S T IH R IH NG
STEERS	S T IH R Z
STEERSMAN	S T IH ER Z M AE N
STEERSMEN	S T IH ER Z M EH N
STEEVE	S T IY V
STEEVED	S T IY V D
STEEVES	S T IY V Z
STEEVING	S T IY V IH NG
STEEVINGS	S T IY V IH NG Z
STICKSEED	S T IH K S IY D
STICKSEEDS	S T IH K S IY D Z
STICKWEED	S T IH K W IY D
STICKWEEDS	S T IH K W IY D Z
STINGAREE	S T IH NG ER IY
STINGAREES	S T IH NG ER IY Z
STINKWEED	S T IH NG K W IY D
STINKWEEDS	S T IH NG K W IY D Z
STOCKBREEDER	S T AA K B R IY D ER
STOCKBREEDERS	S T AA K B R IY D ER Z
STOCKKEEPER	S T AA K IY P ER
STOCKKEEPERS	S T AA K IY P ER Z
STOREKEEPER	S T AO R K IY P ER
STOREKEEPERS	S T AO R K IY P ER Z
STREEK	S T R IY K
STREEKED	S T R IY K T
STREEKER	S T R IY K AH R
STREEKERS	S T R IY K AH R Z
STREEKING	S T R IY K AH NG
STREEKS	S T R IY K S
STREEL	S T R IY L
STREELED	S T R IY L D
STREELING	S T R IY L AH NG
STREELS	S T R IY L Z
STREET	S T R IY T
STREETCAR	S T R IY T K AA R
STREETCARS	S T R IY T K AA R Z
STREETLAMP	S T R IY T L AE M P
STREETLAMPS	S T R IY T L AE M P S
STREETLIGHT	S T R IY T L AY T
STREETLIGHTS	S T R IY T L AY T S
STREETS	S T R IY T S
STREETSCAPE	S T R IY T S K EY P
STREETSCAPES	S T R IY T S K EY P S
STREETWALKER	S T R IY T W AO K ER
STREETWALKERS	S T R IY T W AO K ER Z
STREETWALKING	S T R IY T W AO K IH NG
STREETWALKINGS	S T R IY T W AO K IH NG Z
STREETWISE	S T R IY T W AY Z
SUBBREED	S AH B R IY D
SUBBREEDS	S AH B R IY D Z
SUBCOMMITTEE	S AH B K AH M IH T IY
SUBCOMMITTEES	S AH B K AH M IH T IY Z
SUBFREEZING	S AH B F R IY Z IH NG
SUBTEEN	S AH B T IY N
SUBTEENS	S AH B T IY N Z
SUCCEED	S AH K S IY D
SUCCEEDED	S AH K S IY D AH D
SUCCEEDED(2)	S AH K S IY D IH D
SUCCEEDER	S AH K S IY D ER
SUCCEEDERS	S AH K S IY D ER Z
SUCCEEDING	S AH K S IY D IH NG
SUCCEEDS	S AH K S IY D Z
SUMMITEER	S AH M IH T IH R
SUMMITEERS	S AH M IH T IH R Z
SUMPWEED	S AH M P W IY D
SUMPWEEDS	S AH M P W IY D Z
SUNSCREEN	S AH N S K R IY N
SUNSCREENING	S AH N S K R IY N IH NG
SUNSCREENS	S AH N S K R IY N Z
SUNSEEKER	S AH N S IY K ER
SUNSEEKERS	S AH N S IY K ER Z
SUPERSWEET	S UW P ER S W IY T
SUTTEE	S AH T IY IY
SUTTEES	S AH T IY Z
SWEENIES	S W IY N AY Z
SWEENY	S W IY N IY
SWEEP	S W IY P
SWEEPBACK	S W IY P B AE K
SWEEPBACKS	S W IY P B AE K S
SWEEPER	S W IY P ER
SWEEPERS	S W IY P ER Z
SWEEPIER	S W IY P IY ER
SWEEPIEST	S W IY P IY AH S T
SWEEPING	S W IY P IH NG
SWEEPINGLY	S W IY P IH NG L IY
SWEEPINGNESS	S W IY P IH NG N AH S
SWEEPINGNESSES	S W IY P IH NG N AH S IH Z
SWEEPINGS	S W IY P IH NG Z
SWEEPS	S W IY P S
SWEEPSTAKE	S W IY P S T EY K
SWEEPSTAKES	S W IY P S T EY K S
SWEEPY	S W IY P IY
SWEER	S W IY AH R
SWEET	S W IY T
SWEETBREAD	S W IY T B R EH D
SWEETBREADS	S W IY T B R EH D Z
SWEETBRIAR	S W IY T B R AY ER
SWEETBRIARS	S W IY T B R AY ER Z
SWEETBRIER	S W IY T B R AY AH R
SWEETBRIERS	S W IY T B R IY R Z
SWEETEN	S W IY T AH N
SWEETENED	S W IY T AH N D
SWEETENER	S W IY T AH N ER
SWEETENER(2)	S W IY T N ER
SWEETENERS	S W IY T AH N ER Z
SWEETENERS(2)	S W IY T N ER Z
SWEETENING	S W IY T AH N IH NG
SWEETENING(2)	S W IY T N IH NG
SWEETENINGS	S W IY T AH N IH NG Z
SWEETENS	S W IY T AH N Z
SWEETER	S W IY T ER
SWEETEST	S W IY T AH S T
SWEETHEART	S W IY T HH AA R T
SWEETHEARTS	S W IY T HH AA R T S
SWEETIE	S W IY T IY
SWEETIES	S W IY T IY Z
SWEETING	S W IY T IH NG
SWEETINGS	S W IY T IH NG Z
SWEETISH	S W IY T IH SH
SWEETISHLY	S W IY T IH SH L IY
SWEETLY	S W IY T L IY
SWEETMEAT	S W IY T M IY T
SWEETMEATS	S W IY T M IY T S
SWEETNESS	S W IY T N AH S
SWEETNESSES	S W IY T N AH S IH Z
SWEETS	S W IY T S
SWEETSHOP	S W IY T SH AA P
SWEETSHOPS	S W IY T SH AA P S
SWEETSOP	S W IY T S AA P
SWEETSOPS	S W IY T S AA P S
SWINGLETREE	S W IH N G L AH T R IY IY
SWINGLETREES	S W IH N G L EH T R IY Z
SYCEE	S AY S IY IY
SYCEES	S AY S IY Z
TARWEED	T AA R W IY D
TARWEEDS	T AA R W IY D Z
TEE	T IY
TEED	T IY D
TEEING	T IY IH NG
TEEL	T IY L
TEELS	T IY L Z
TEEM	T IY M
TEEMED	T IY M D
TEEMER	T IY M ER
TEEMERS	T IY M ER Z
TEEMING	T IY M IH NG
TEEMINGLY	T IY M IH NG L IY
TEEMINGNESS	T IY M IH NG N AH S
TEEMINGNESSES	T IY M IH NG N AH S IH Z
TEEMS	T IY M Z
TEEN	T IY N
TEENAGE	T IY N EY JH
TEENAGED	T IY N EY JH D
TEENAGER	T IY N EY JH ER
TEENAGERS	T IY N EY JH ER Z
TEENER	T IY N ER
TEENERS	T IY N ER Z
TEENFUL	T IY N F AH L
TEENIER	T IY N IY ER
TEENIEST	T IY N IY AH S T
TEENS	T IY N Z
TEENSIER	T IY N Z IY ER
TEENSIEST	T IY N Z IY AH S T
TEENSY	T IY N S IY
TEENTSIER	T IY N T S AY AH R
TEENTSIEST	T IY N T S AY AH S T
TEENTSY	T IY N T S IY
TEENY	T IY N IY
TEENYBOP	T IY N IY B AA P
TEENYBOPPER	T IY N IY B AA P ER
TEENYBOPPERS	T IY N IY B AA P ER Z
TEEPEE	T IY P IY
TEEPEES	T IY P IY Z
TEES	T IY Z
TEETER	T IY T ER
TEETERBOARD	T IY T ER B OW R D
TEETERBOARDS	T IY T ER B OW R D Z
TEETERED	T IY T ER D
TEETERING	T IY T ER IH NG
TEETERS	T IY T ER Z
TEETH	T IY TH
TEETHE	T IY DH
TEETHED	T IY DH D
TEETHER	T IY DH ER
TEETHERS	T IY DH ER Z
TEETHES	T IY DH Z
TEETHING	T IY DH IH NG
TEETHINGS	T IY DH IH NG Z
TEETHRIDGE	T IY TH R IH JH
TEETHRIDGES	T IY TH R IH JH IH Z
TEETOTAL	T IY T OW T AH L
TEETOTALED	T IY T OW T AH L D
TEETOTALER	T IY T OW T EY L ER
TEETOTALERS	T IY T OW T AH L ER Z
TEETOTALING	T IY T OW T AH L IH NG
TEETOTALISM	T IY T OW T AH L IH Z AH M
TEETOTALISMS	T IY T OW T AH L IH Z AH M Z
TEETOTALIST	T IY T OW T AH L IH S T
TEETOTALISTS	T IY T OW T AH L IH S T S
TEETOTALLED	T IY T OW T AH L D
TEETOTALLER	T IY T OW T AH L ER
TEETOTALLERS	T IY T OW T AH L ER Z
TEETOTALLING	T IY T OW T AH L IH NG
TEETOTALLY	T IY T OW T AH L IY
TEETOTALS	T IY T OW T AH L Z
TEETOTUM	T IY T AH T AH M
TEETOTUMS	T IY T AH T AH M Z
TENDERFEET	T EH N D ER F IY T
TEPEE	T IY P IY
TEPEES	T IY P IY Z
TERREEN	T EH R IY AH N
TERREENS	T EH R IY N Z
TESTEE	T EH S T IY
TESTEES	T EH S T IY Z
THEE	DH IY
THEELIN	TH IY L AH N
THEELINS	TH IY L AH N Z
THEELOL	TH IY L AH L
THEELOLS	TH IY L AH L Z
THIMBLEWEED	TH IH M B AH L W IY D
THIMBLEWEEDS	TH IH M B AH L W IY D Z
THIRTEEN	TH ER T IY N
THIRTEENS	TH ER T IY N Z
THIRTEENTH	TH ER T IY N TH
THIRTEENTHS	TH ER T IY N TH S
THREE	TH R IY
THREEFOLD	TH R IY F OW L D
THREEP	TH R IY P
THREEPED	TH R IY P EH D
THREEPENCE	TH R IY P AH N S
THREEPENCES	TH R IY P EH N S AH Z
THREEPENNY	TH R IY P EH N IY
THREEPING	TH R IY P IH NG
THREEPS	TH R IY P S
THREES	TH R IY Z
THREESCORE	TH R IY S K OW R
THREESOME	TH R IY S AH M
THREESOMES	TH R IY S AH M Z
THUGGEE	TH AH G IY
THUGGEES	TH AH G IY Z
THUMBWHEEL	TH AH M W IY L
THUMBWHEELS	TH AH M W IY L Z
TICKSEED	T IH K S IY D
TICKSEEDS	T IH K S IY D Z
TIMEKEEPER	T AY M K IY P ER
TIMEKEEPERS	T AY M K IY P ER Z
TIMEKEEPING	T AY M K IY P IH NG
TIMEKEEPINGS	T AY M K IY P IH NG Z
TIRRIVEE	T AH R AH V IY IY
TIRRIVEES	T AH R AH V IY Z
TOFFEE	T AA F IY
TOFFEES	T AA F IY Z
TOPEE	T AA P IY
TOPEES	T AA P IY Z
TOUPEE	T UW P EY
TOUPEES	T UW P IY Z
TOWHEE	T OW IY IY
TOWHEES	T OW HH IY Z
TOWNEE	T AW N IY
TOWNEES	T AW N IY Z
TRAINEE	T R EY N IY
TRAINEES	T R EY N IY Z
TRAINEESHIP	T R EY N IY SH IH P
TRAINEESHIPS	T R EY N IY SH IH P S
TRANSFEREE	T R AE N S F ER IY
TRANSFEREES	T R AE N S F ER IY Z
TRANSPORTEE	T R AE N S P OW R T IY
TRANSPORTEES	T R AE N S P OW R T IY Z
TREE	T R IY
TREED	T R IY D
TREEHOPPER	T R IY HH AA P ER
TREEHOPPERS	T R IY HH AA P ER Z
TREEING	T R IY IH NG
TREELAWN	T R IY L AO N
TREELAWNS	T R IY L AO N Z
TREELESS	T R IY L AH S
TREELIKE	T R IY L AY K
TREEN	T R IY N
TREENAIL	T R IY N EY L
TREENAILS	T R IY N EY L Z
TREENS	T R IY N Z
TREENWARE	T R IY N W AH R
TREENWARES	T R IY N W AH R Z
TREES	T R IY Z
TREETOP	T R IY T AO P
TREETOPS	T R IY T AO P S
TRIWEEKLIES	T R AH W IY K L AY Z
TRIWEEKLY	T R AH W IY K L IY
TROCHEE	T R AH CH IY IY
TROCHEES	T R AH CH IY Z
TRUSTEE	T R AH S T IY
TRUSTEED	T R AH S T IY D
TRUSTEEING	T R AH S T IY IH NG
TRUSTEES	T R AH S T IY Z
TRUSTEESHIP	T R AH S T IY SH IH P
TRUSTEESHIPS	T R AH S T IY SH IH P S
TULLIBEE	T AH L AH B IY IY
TULLIBEES	T AH L AH B IY Z
TUMBLEWEED	T AH M B AH L W IY D
TUMBLEWEEDS	T AH M B AH L W IY D Z
TUREEN	T Y UH R IY AH N
TUREENS	T Y AH R IY N Z
TUTEE	T Y UW T IY IY
TUTEES	T Y UW T IY Z
TWEE	T W IY
TWEED	T W IY D
TWEEDIER	T W IY D IY ER
TWEEDIEST	T W IY D IY AH S T
TWEEDINESS	T W IY D IY N AH S
TWEEDINESSES	T W IY D IY N AH S IH Z
TWEEDLE	T W IY D AH L
TWEEDLED	T W IY D L EH D
TWEEDLES	T W IY D AH L Z
TWEEDLING	T W IY D L IH NG
TWEEDS	T W IY D Z
TWEEDY	T W IY D IY
TWEEN	T W IY N
TWEENIES	T W IY N AY Z
TWEENY	T W IY N IY
TWEET	T W IY T
TWEETED	T W IY T AH D
TWEETER	T W IY T AH R
TWEETERS	T W IY T AH R Z
TWEETING	T W IY T AH NG
TWEETS	T W IY T S
TWEEZE	T W IY Z
TWEEZED	T W IY Z D
TWEEZER	T W IY Z ER
TWEEZERS	T W IY Z ER Z
TWEEZES	T W IY Z IH Z
TWEEZING	T W IY Z IH NG
TYEE	T AY IY IY
TYEES	T AY IY Z
UMPTEEN	AH M P T IY N
UMPTEENTH	AH M P T IY N TH
UMTEENTH	AH M T IY N TH
UNBESEEMING	AH N B IH S IY M IH NG
UNBREECH	AH N B R IY CH
UNBREECHED	AH N B R IY CH T
UNBREECHES	AH N B R IY CH IH Z
UNBREECHING	AH N B R IY CH IH NG
UNDEE	AH N D IY IY
UNDERFEED	AH N D ER F IY D
UNDERFEEDING	AH N D ER F IY D IH NG
UNDERFEEDS	AH N D ER F IY D Z
UNDERSTEER	AH N D ER S T IH ER
UNDERSTEERED	AH N D ER S T IH ER D
UNDERSTEERING	AH N D ER S T IH ER IH NG
UNDERSTEERS	AH N D ER S T IH ER Z
UNFEELING	AH N F IY L IH NG
UNFEELINGLY	AH N F IY L IH NG L IY
UNFEELINGNESS	AH N F IY L IH NG N AH S
UNFEELINGNESSES	AH N F IY L IH NG N AH S IH Z
UNFORESEEABLE	AH N F AO R S IY AH B AH L
UNFORESEEN	AH N F AO R S IY N
UNFREE	AH N F R IY
UNFREED	AH N F R IY D
UNFREEDOM	AH N F R IY D AH M
UNFREEDOMS	AH N F R IY D AH M Z
UNFREEING	AH N F R IY IH NG
UNFREES	AH N F R IY Z
UNFREEZE	AH N F R IY Z
UNFREEZES	AH N F R IY Z IH Z
UNFREEZING	AH N F R IY Z IH NG
UNGENTEEL	AH N JH EH N T IY L
UNGREEDY	AH N G R IY D IY
UNHEEDED	AH N HH IY D IH D
UNHEEDING	AH N HH IY D IH NG
UNMEET	AH N M IY T
UNMEETLY	AH N M IY T L IY
UNNEEDED	AH N N IY D IH D
UNPEELED	AH N P IY L D
UNREDEEMABLE	AH N R IY D IY M AH B AH L
UNREDEEMED	AH N R IY D IY M D
UNREEL	AH N R IY L
UNREELED	AH N R IY L D
UNREELER	AH N R IY L ER
UNREELERS	AH N R IY L ER Z
UNREELING	AH N R IY L IH NG
UNREELS	AH N R IY L Z
UNREEVE	AH N R IY IY V
UNREEVED	AH N R IY IY V D
UNREEVES	AH N R IY IY V Z
UNREEVING	AH N R IY IY V IH NG
UNSCREENED	AH N S K R IY N D
UNSEEDED	AH N S IY D IH D
UNSEEING	AH N S IY IH NG
UNSEEMLIER	AH N S IY M L IY ER
UNSEEMLIEST	AH N S IY M L IY AH S T
UNSEEMLINESS	AH N S IY M L IY N AH S
UNSEEMLINESSES	AH N S IY M L IY N AH S IH Z
UNSEEMLY	AH N S IY M L IY
UNSEEN	AH N S IY N
UNSTEEL	AH N S T IY L
UNSTEELED	AH N S T IY L D
UNSTEELING	AH N S T IY L IH NG
UNSTEELS	AH N S T IY L Z
UNSWEETENED	AH N S W IY T AH N D
UNWEEDED	AH N W IY D IH D
UNWEETING	AH N W IY T AH NG
UNWEETINGLY	AH N W IY T IH NG G AH L IY
UPKEEP	AH P K IY P
UPKEEPS	AH P K IY P S
UPSWEEP	AH P S W IY P
UPSWEEPING	AH P S W IY P IH NG
UPSWEEPS	AH P S W IY P S
VACCINEE	V AE K S IY N IY
VACCINEES	V AE K S IY N IY Z
VAKEEL	V EY K IY L
VAKEELS	V EY K IY L Z
VEE	V IY
VEEJAY	V IY JH EY IY
VEEJAYS	V IY JH EY Z
VEENA	V IY N AH
VEENAS	V IY N AH Z
VEEP	V IY P
VEEPEE	V IY P IY IY
VEEPEES	V IY P IY Z
VEEPS	V IY P S
VEER	V IH R
VEERED	V IH R D
VEERIES	V IH ER IY Z
VEERING	V IH R IH NG
VEERINGLY	V IH ER IH NG L IY
VEERS	V IH R Z
VEERY	V IH ER IY
VEES	V IY Z
VELVETEEN	V EH L V IY T IY AH N
VELVETEENS	V EH L V AH T IY N Z
VENDEE	V EH N D IY
VENDEES	V EH N D IY Z
VENEER	V AH N IH R
VENEERED	V AH N IH ER D
VENEERER	V AH N IH ER ER
VENEERERS	V AH N IH ER ER Z
VENEERING	V AH N IH ER IH NG
VENEERINGS	V AH N IH ER IH NG Z
VENEERS	V AH N IH R Z
VESTEE	V EH S T IY
VESTEES	V EH S T IY Z
VISEED	V AY S T
VOLUNTEER	V AA L AH N T IH R
VOLUNTEERED	V AA L AH N T IH R D
VOLUNTEERING	V AO L AH N T IH R IH NG
VOLUNTEERISM	V AO L AH N T IH R IH Z AH M
VOLUNTEERISMS	V AA L AH N T IH ER IH Z AH M Z
VOLUNTEERS	V AA L AH N T IH R Z
VOUCHEE	V AW CH IY
VOUCHEES	V AW CH IY Z
WARRANTEE	W AO R AH N T IY
WARRANTEES	W AO R AH N T IY Z
WATERWEED	W AO T ER W IY D
WATERWEEDS	W AO T ER W IY D Z
WATERWHEEL	W AO T ER W IY L
WATERWHEELS	W AO T ER W IY L Z
WAXWEED	W AE K S W IY D
WAXWEEDS	W AE K S W IY D Z
WEBFEET	W EH B F IY T
WEE	W IY
WEED	W IY D
WEEDED	W IY D IH D
WEEDER	W IY D ER
WEEDERS	W IY D ER Z
WEEDIER	W IY D IY ER
WEEDIEST	W IY D IY AH S T
WEEDILY	W IY D IY L IY
WEEDINESS	W IY D IY N AH S
WEEDINESSES	W IY D IY N AH S IH Z
WEEDING	W IY D IH NG
WEEDLESS	W IY D L AH S
WEEDLIKE	W IY D L AY K
WEEDS	W IY D Z
WEEDY	W IY D IY
WEEK	W IY K
WEEKDAY	W IY K D EY
WEEKDAYS	W IY K D EY Z
WEEKEND	W IY K EH N D
WEEKEND(2)	W IY K IH N D
WEEKENDED	W IY K EH N D IH D
WEEKENDER	W IY K EH N D ER
WEEKENDERS	W IY K EH N D ER Z
WEEKENDING	W IY K EH N D IH NG
WEEKENDS	W IY K EH N D Z
WEEKLIES	W IY K L IY Z
WEEKLONG	W IY K L AO NG
WEEKLY	W IY K L IY
WEEKNIGHT	W IY N AY T
WEEKNIGHTS	W IY N AY T S
WEEKS	W IY K S
WEEL	W IY L
WEEN	W IY AH N
WEENED	W IY N D
WEENIE	W IY N AY
WEENIER	W IY N AY AH R
WEENIES	W IY N AY Z
WEENIEST	W IY N AY AH S T
WEENING	W IY N AH NG
WEENS	W IY N Z
WEENSIER	W IY N S AY AH R
WEENSIEST	W IY N S AY AH S T
WEENSY	W IY N Z IY
WEENY	W IY N IY
WEEP	W IY P
WEEPER	W IY P ER
WEEPERS	W IY P ER Z
WEEPIE	W IY P IY
WEEPIER	W IY P IY ER
WEEPIES	W IY P IY Z
WEEPIEST	W IY P IY AH S T
WEEPING	W IY P IH NG
WEEPINGS	W IY P IH NG Z
WEEPS	W IY P S
WEEPY	W IY P IY
WEER	W IY AH R
WEES	W IY Z
WEEST	W IY AH S T
WEET	W IY T
WEETED	W IY T EH D
WEETING	W IY T AH NG
WEETS	W IY T S
WEEVER	W IY V AH R
WEEVERS	W IY V AH R Z
WEEVIL	W IY V AH L
WEEVILED	W IY V AY L D
WEEVILLY	W IY V IH L IY
WEEVILS	W IY V AH L Z
WEEVILY	W IY V IH L IY
WEEWEE	W IY W IY
WEEWEED	W IY W IY D
WEEWEEING	W IY W IY IH NG
WEEWEES	W IY W IY Z
WHANGEE	W AA N JH IY IY
WHANGEES	W AH NG IY Z
WHEE	W IY
WHEEDLE	W IY D AH L
WHEEDLED	W IY D AH L D
WHEEDLER	W IY D AH L ER
WHEEDLERS	W IY D AH L ER Z
WHEEDLES	W IY D AH L Z
WHEEDLING	W IY D AH L IH NG
WHEEL	W IY L
WHEEL(2)	HH W IY L
WHEELBARROW	W IY L B EH R OW
WHEELBARROW(2)	HH W IY L B EH R OW
WHEELBARROWED	W IY L B AE R OW D
WHEELBARROWING	W IY L B AE R OW IH NG
WHEELBARROWS	W IY L B EH R OW Z
WHEELBARROWS(2)	HH W IY L B EH R OW Z
WHEELBASE	W IY L B EY S
WHEELBASE(2)	HH W IY L B EY S
WHEELBASES	W IY L B EY S IH Z
WHEELCHAIR	W IY L CH EH R
WHEELCHAIR(2)	HH W IY L CH EH R
WHEELCHAIRS	W IY L CH EH R Z
WHEELCHAIRS(2)	HH W IY L CH EH R Z
WHEELED	W IY L D
WHEELED(2)	HH W IY L D
WHEELER	W IY L ER
WHEELER(2)	HH W IY L ER
WHEELERS	W IY L ER Z
WHEELERS(2)	HH W IY L ER Z
WHEELHORSE	W IY L HH AO R S
WHEELHORSES	W IY L HH AO R S IH Z
WHEELHOUSE	W IY L HH AW S
WHEELHOUSES	W IY L HH AW S IH Z
WHEELIE	W IY L IY
WHEELIES	W IY L IY Z
WHEELING	W IY L IH NG
WHEELING(2)	HH W IY L IH NG
WHEELINGS	W IY L IH NG Z
WHEELLESS	W IY L AH S
WHEELMAN	W IY L M AE N
WHEELMEN	W IY L M EH N
WHEELS	W IY L Z
WHEELS(2)	HH W IY L Z
WHEELSMAN	W IY L Z M AE N
WHEELSMEN	W IY L Z M EH N
WHEELWORK	W IY L W ER K
WHEELWORKS	W IY L W ER K S
WHEELWRIGHT	W IY L R AY T
WHEELWRIGHT(2)	HH W IY L R AY T
WHEELWRIGHTS	W IY L R AY T S
WHEEN	W IY AH N
WHEENS	W IY N Z
WHEEP	W IY P
WHEEPED	W IY P T
WHEEPING	W IY P AH NG
WHEEPLE	W IY P AH L
WHEEPLED	W IY P AH L D
WHEEPLES	W IY P AH L Z
WHEEPLING	W IY P L AH NG
WHEEPS	W IY P S
WHEEZE	W IY Z
WHEEZE(2)	HH W IY Z
WHEEZED	W IY Z D
WHEEZER	W IY Z ER
WHEEZERS	W IY Z ER Z
WHEEZES	W IY Z AH Z
WHEEZES(2)	HH W IY Z AH Z
WHEEZES(3)	W IY Z IH Z
WHEEZIER	W IY Z IY ER
WHEEZIEST	W IY Z IY AH S T
WHEEZILY	W IY Z IY L IY
WHEEZINESS	W IY Z IY N AH S
WHEEZINESSES	W IY Z IY N AH S IH Z
WHEEZING	W IY Z IH NG
WHEEZING(2)	HH W IY Z IH NG
WHEEZY	W IY Z IY
WHIFFLETREE	W IH F L AH T R IY IY
WHIFFLETREES	W IH F L EH T R IY Z
WHIGMALEERIE	W IH G M EY L AH R AY
WHIGMALEERIES	W IH G M EY L AH R AY Z
WHIPPLETREE	W IH P L AH T R IY IY
WHIPPLETREES	W IH P L EH T R IY Z
WHOOPEE	W UW P IY
WHOOPEE(2)	HH W UW P IY
WHOOPEES	W UW P IY Z
WILDEBEEST	W IH L D IY B IY AH S T
WILDEBEESTS	W IH L D AH B IY S T S
WINDSCREEN	W IH N D S K R IY N
WINDSCREENS	W IH N D S K R IY N Z
WINTERGREEN	W IH N T ER G R IY N
WINTERGREENS	W IH N T ER G R IY N Z
WITCHWEED	W IH CH W IY D
WITCHWEEDS	W IH CH W IY D Z
WORKSHEET	W ER K SH IY T
WORKSHEETS	W ER K SH IY T S
WORKWEEK	W ER K W IY K
WORKWEEKS	W ER K W IY K S
WORMSEED	W ER M S IY D
WORMSEEDS	W ER M S IY D Z
YEELIN	Y IY L AH N
YEELINS	Y IY L AH N Z
YESTREEN	Y EH S T R IY AH N
YESTREENS	Y EH S T R IY N Z
YIPPEE	Y IH P IY
YOGEE	Y OW JH IY IY
YOGEES	Y OW JH IY Z
ZAREEBA	Z AH R IY B AH
ZAREEBAS	Z AH R IY B AH Z
ZEE	Z IY
ZEES	Z IY Z
ZOOKEEPER	Z UW K IY P ER
ZOOKEEPERS	Z UW K IY P ER Z
BE	B IY
PNEUMA	N Y UW M AH
NTH	EH N TH
PFENNIG	F EH N IH G
IKAT	IH K AH T
KEA	K IY
HOEING	HH OW IH NG
