EI	IY
ABSEIL	AE B S IY L
ABSEILED	AE B S IY AH L D
ABSEILING	AE B S IY AH L AH NG
ABSEILS	AE B S IY AH L Z
ABSENTEEISM	AE B S AH N T IY IH Z AH M
ABSENTEEISMS	AE B S AH N T IY IH Z AH M Z
ACROLEIN	AE K R OW L IY N
ACROLEINS	AE K R AH L IY N Z
ACULEI	AE K Y AH L IY
AGAPEIC	AH G EY P IH K
AGEING	EY JH IH NG
AGEINGS	EY JH IH NG Z
AGEISM	EY JH IH Z AH M
AGEISMS	EY JH IH Z AH M Z
AGEIST	EY JH IH S T
AGEISTS	EY JH IH S T S
AGREEING	AH G R IY IH NG
AIRFREIGHT	EH R F R EY T
AIRFREIGHTED	AH IH R F R EY T IH D
AIRFREIGHTING	AH IH R F R EY T IH NG
AIRFREIGHTS	AH IH R F R EY T S
ALBEIT	AO L B IY IH T
ALLOGENEIC	AE L AH JH IY N IY AH K
AMENORRHEIC	AE M AH N AO R IY AH K
ANISEIKONIA	AE N AH S AH K OW N Y AH
ANISEIKONIAS	AE N AH S AH K OW N Y AH Z
ANISEIKONIC	AE N AY S AY K AA N IH K
ANTEING	AE N T IY IH NG
ANTIAPARTHEID	AE N T AY AH P AA R T EY T
ANTIAPARTHEIDS	AE N T AY AH P AA R T EY T S
ANTICOUNTERFEITING	AE N T AY K AW N T ER F IH T IH NG
ANTIFOREIGN	AE N T AY F AO R AH N
ANTIFOREIGNER	AE N T AY F AO R AH N ER
ANTISEIZURE	AE N T AY S IY ZH ER
APARTHEID	AH P AA R T AY T
APARTHEID(2)	AH P AA R T AY D
APARTHEIDS	AH P AA R T EY T S
APNEIC	AE P N IY AH K
APNOEIC	AE P N OW AH AH K
APODEICTIC	AE P AH D IY K T AH K
APOGEIC	AH P OW JH IY AH K
APOLIPOPROTEIN	AH P AH L AH P AA P R AH T IY N
APOLIPOPROTEINS	AH P AH L AH P AA P R AH T IY N Z
APPERCEIVE	AE P AH R S IY AH V
APPERCEIVED	AE P AH R S IY AH V D
APPERCEIVES	AE P AH R S IY AH V Z
APPERCEIVING	AE P AH R S IY AH V AH NG
APPLIQUEING	AE P L AH K EY IH NG
ARANEID	AE R AH N IY D
ARANEIDS	AE R AH N IY D Z
AREIC	AE R IY AH K
ATHEISM	AH TH AY S AH M
ATHEISM(2)	EY TH IY IH Z AH M
ATHEISMS	AH TH IY Z AH M Z
ATHEIST	EY TH IY AH S T
ATHEISTIC	EY TH IY IH S T IH K
ATHEISTICAL	EY TH IY IH S T IH K AH L
ATHEISTICALLY	EY TH IY IH S T IH K AH L IY
ATHEISTS	EY TH IY AH S T S
AUREI	AO R IY
AWEIGH	AH W EY
AWEING	AO IH NG
BANTAMWEIGHT	B AE N T AH M W EY T
BANTAMWEIGHTS	B AE N T AH M W EY T S
BEIGE	B EY ZH
BEIGES	B EY ZH AH Z
BEIGNET	B AH IH G N AH T
BEIGNETS	B AH IH G N AH T S
BEIGY	B EY ZH IY
BEING	B IY IH NG
BEINGS	B IY IH NG Z
BINGEING	B IH N JH IH NG
BIRDIEING	B ER D IY IH NG
BLUEING	B L UW IH NG
BLUEINGS	B L UW IH NG Z
BLUEISH	B L UW IH SH
BOOGIEING	B UW JH IY AH NG
BRAUNSCHWEIGER	B R AO N S W EY JH AH R
BRAUNSCHWEIGERS	B R AO N S W EY JH AH R Z
BUDDLEIA	B AH D L IY AH
BUDDLEIAS	B AH D L IY AH Z
CADUCEI	K AE D Y AH S IY
CAFFEIN	K AE F IY N
CAFFEINATED	K AE F IH N EY T AH D
CAFFEINE	K AE F IY N
CAFFEINES	K AE F IY N Z
CAFFEINS	K AE F IY N Z
CALCANEI	K AE L K AH N IY
CANOEING	K AH N UW IH NG
CANOEIST	K AH N UW AH S T
CANOEISTS	K AH N UW IH S T S
CASEIC	K EY S IH K
CASEIN	K EY S IY N
CASEINATE	K EY S IY N AH T
CASEINATES	K EY S IY N AH T S
CASEINS	K EY S IY N Z
CASTEISM	K AE S T IH Z AH M
CASTEISMS	K AE S T IH Z AH M Z
CEIBA	S IY B AH
CEIBAS	S IY B AH Z
CEIL	S IY L
CEILED	S IY AH L D
CEILER	S IY AH L AH R
CEILERS	S IY L AH R Z
CEILING	S IY L IH NG
CEILINGED	S EH L IH NG D
CEILINGS	S IY L IH NG Z
CEILOMETER	S IY AH L AA M AH T AH R
CEILOMETERS	S IY L AA M AH T AH R Z
CEILS	S IY AH L Z
CEINTURE	S IY N T Y AH R
CEINTURES	S IY N T Y AH R Z
CEPHEID	S AH F IY D
CEPHEIDS	S AH F IY D Z
CHASSEING	CH AE S IY AH NG
CHECKREIN	CH EH K R EY N
CHECKREINS	CH EH K R EY N Z
CHIVAREEING	CH AY V ER IY IH NG
CHOREIC	CH OW R IH K
CHOREIFORM	CH AH R IY F AH R M
CHROMOPROTEIN	K R AH M AA P R AH T IY N
CHROMOPROTEINS	K R AH M AA P R AH T IY N Z
CICISBEI	S AH S IH Z IY
CICISBEISM	S AH S IH Z IY IH Z AH M
CICISBEISMS	S IH S AH Z IY Z AH M Z
CLEIDOIC	K L IY D OW AH K
CLEISTOGAMIC	K L IY S T AH G AH M AH K
CLEISTOGAMIES	K L IY S T AA G AH M AY Z
CLEISTOGAMOUS	K L IY S T AA G AH M AH S
CLEISTOGAMOUSLY	K L IY S T AH G AE M OW AH S L IY
CLEISTOGAMY	K L IY S T AA G AH M IY
CLEVEITE	K L IY V EY T
CLEVEITES	K L IY V EY T S
CLUEING	K L UW IH NG
CLUPEID	K L UW P IY D
CLUPEIDS	K L UW P IY D Z
CLYPEI	K L IH P IY
CODEIA	K OW D IY IY AH
CODEIAS	K OW D IY AY AH Z
CODEIN	K OW D IY IH N
CODEINA	K OW D IY AH N AA
CODEINAS	K OW D IY AH N AE Z
CODEINE	K OW D IY IH N
CODEINES	K OW D IY AY N Z
CODEINS	K OW D IY IH N Z
COHEIR	K OW EH R
COHEIRESS	K OW EH R AH S
COHEIRESSES	K OW EH R AH S IH Z
COHEIRS	K OW EH R Z
CONCEIT	K AH N S IY T
CONCEITED	K AH N S IY T AH D
CONCEITEDLY	K AH N S IY T AH D L IY
CONCEITEDNESS	K AH N S IY T AH D N AH S
CONCEITEDNESSES	K AH N S IY T AH D N AH S IH Z
CONCEITING	K AH N S IY T IH NG
CONCEITS	K AH N S IY T S
CONCEIVABILITIES	K AH N S IY V AH B IH L AH T EH Z
CONCEIVABILITY	K AH N S IY V AH B IH L AH T EH
CONCEIVABLE	K AH N S IY V AH B AH L
CONCEIVABLENESS	K AH N S IY V AH B AH L N AH S
CONCEIVABLENESSES	K AH N S IY V AH B AH L N AH S IH Z
CONCEIVABLY	K AH N S IY V AH B L IY
CONCEIVE	K AH N S IY V
CONCEIVED	K AH N S IY V D
CONCEIVER	K AH N S IY V ER
CONCEIVERS	K AH N S IY V ER Z
CONCEIVES	K AH N S IY V Z
CONCEIVING	K AH N S IY V IH NG
CONCERTMEISTER	K AA N S AH R T M IY S T AH R
CONCERTMEISTERS	K AA N S AH R T M IY S T AH R Z
CONGEEING	K AA N JH IY AH NG
CONTEMPORANEITIES	K AA N T EH M P AH R AH N AH T AY Z
CONTEMPORANEITY	K AA N T EH M P AH R AH N IY AH T IY
COOEEING	K UW IY IH NG
CORBEIL	K AO R B AY L
CORBEILLE	K AA R B IY L
CORBEILLES	K AA R B IY L Z
CORBEILS	K AA R B IY AH L Z
COREIGN	K OW R EY N
COREIGNS	K OW R EY N Z
CORPOREITIES	K AA R P AH R AH T AY Z
CORPOREITY	K AA R P AH R IY AH T IY
CORYPHAEI	K OW R IH F IY IY
COUNTERFEIT	K AW N T ER F IH T
COUNTERFEIT(2)	K AW N ER F IH T
COUNTERFEITED	K AW N T ER F IH T IH D
COUNTERFEITED(2)	K AW N ER F IH T IH D
COUNTERFEITER	K AW N T ER F IH T ER
COUNTERFEITER(2)	K AW N ER F IH T ER
COUNTERFEITERS	K AW N T ER F IH T ER Z
COUNTERFEITERS(2)	K AW N ER F IH T ER Z
COUNTERFEITING	K AW N T ER F IH T IH NG
COUNTERFEITING(2)	K AW N ER F IH T IH NG
COUNTERFEITS	K AW N T ER F IH T S
COUNTERFEITS(2)	K AW N ER F IH T S
COUNTERSURVEILLANCE	K AW N T ER S ER V EY L AH N S
COUNTERSURVEILLANCES	K AW N T ER S ER V EY L AH N S IH Z
COUNTERWEIGHT	K AW N T ER W EY T
COUNTERWEIGHTED	K AW N T ER W EY T IH D
COUNTERWEIGHTING	K AW N T ER W EY T IH NG
COUNTERWEIGHTS	K AW N T ER W EY T S
CROCEIN	K R OW S IY N
CROCEINE	K R OW S IY N
CROCEINES	K R OW S IY N Z
CROCEINS	K R OW S IY N Z
CRUISERWEIGHT	K R UW Z ER W EY T
CRUISERWEIGHTS	K R UW Z ER W EY T S
CRUZEIRO	K R UW Z IY R OW
CRUZEIROS	K R UW Z IY R AH Z
CUEING	K Y UW IH NG
CUNEIFORM	K Y UW N IY AH F AO R M
CUNEIFORMS	K Y UW N IY F AH R M Z
CYSTEIN	S IH S T IY N
CYSTEINE	S IH S T IY N
CYSTEINES	S IH S T IY N Z
CYSTEINS	S IH S T IY N Z
DEADWEIGHT	D EH D W EY T
DEADWEIGHTS	D EH D W EY T S
DECAFFEINATE	D IY K AE F AH N EY T
DECAFFEINATED	D IY K AE F AH N EY T IH D
DECAFFEINATES	D AH K AE F AH N EY T S
DECAFFEINATING	D IY K AE F AH N EY T IH NG
DECAFFEINATION	D IY K AE F AH N EY SH AH N
DECAFFEINATIONS	D AH K AE F AH N EY T IY AH N Z
DECEIT	D IH S IY T
DECEITFUL	D IH S IY T F AH L
DECEITFULLY	D AH S IY T F AH L IY
DECEITFULNESS	D AH S IY T F AH L N AH S
DECEITFULNESSES	D AH S IY T F AH L N AH S IH Z
DECEITS	D IH S IY T S
DECEIVABLE	D IH S IY V AH B AH L
DECEIVE	D IH S IY V
DECEIVED	D IH S IY V D
DECEIVER	D IH S IY V ER
DECEIVERS	D IH S IY V ER Z
DECEIVES	D IH S IY V Z
DECEIVING	D IH S IY V IH NG
DECEIVINGLY	D IH S IY V IH NG L IY
DECREEING	D IH K R IY IH NG
DEICE	D IY AY S
DEICED	D IY AY S T
DEICER	D IY AY S ER
DEICERS	D IY AY S ER Z
DEICES	D IY AY S IH Z
DEICIDAL	D IY AY S AH D AH L
DEICIDE	D IY AH S AY D
DEICIDES	D IY AH S AY D Z
DEICING	D IY AY S IH NG
DEICTIC	D IY IH K T AH K
DEIFIC	D IY IH F AH K
DEIFICAL	D IY AH F IH S AH L
DEIFICATION	D IY AH F AH K EY SH AH N
DEIFICATIONS	D IY AH F AH K EY SH AH N Z
DEIFIED	D IY AH F AY D
DEIFIER	D IY IH F AY AH R
DEIFIERS	D IY AH F IY R Z
DEIFIES	D IY AH F AY Z
DEIFORM	D IY IH F AH R M
DEIFY	D IY AH F AY
DEIFYING	D IY IH F AY AH NG
DEIGN	D EY N
DEIGNED	D EY N D
DEIGNING	D EY N IH NG
DEIGNS	D EY N Z
DEIL	D IY IH L
DEILS	D IY AH L Z
DEINDUSTRIALIZATION	D IY IH N D AH S T R IY AH L AH Z EY SH AH N
DEINDUSTRIALIZATIONS	D IY IH N D AH S T R IY AH L AH Z EY SH AH N Z
DEINDUSTRIALIZE	D IY IH N D AH S T R IY AH L AY Z
DEINDUSTRIALIZED	D IY IH N D AH S T R IY AH L AY Z D
DEINDUSTRIALIZES	D IY IH N D AH S T R IY AH L AY Z IH Z
DEINDUSTRIALIZING	D IY IH N D AH S T R IY AH L AY Z IH NG
DEINONYCHUS	D IY AH N AA N AH CH AH S
DEINONYCHUSES	D IY AH N AA N AH CH UW Z AH Z
DEINSTITUTIONALIZATION	D IY IH N S T IH T UW SH AH N AH L AH Z EY SH AH N
DEINSTITUTIONALIZATIONS	D IY IH N S T AH T UW SH AH N AH L AH Z EY SH AH N Z
DEINSTITUTIONALIZE	D IY IH N S T IH T UW SH AH N AH L AY Z
DEINSTITUTIONALIZED	D IY IH N S T AH T UW SH AH N AH L AY Z D
DEINSTITUTIONALIZES	D IY IH N S T AH T UW SH AH N AH L AY Z IH Z
DEINSTITUTIONALIZING	D IY IH N S T AH T UW SH AH N AH L AY Z IH NG
DEIONIZATION	D IY IY AH N AH Z EY SH AH N
DEIONIZATIONS	D IY IY AH N AH Z EY SH AH N Z
DEIONIZE	D IY IY AH N AY Z
DEIONIZED	D IY IY AH N AY Z D
DEIONIZER	D IY IY AH N AY Z ER
DEIONIZERS	D IY IY AH N AY Z ER Z
DEIONIZES	D IY IY AH N AY Z IH Z
DEIONIZING	D IY IY AH N AY Z IH NG
DEISM	D IY IH Z AH M
DEISMS	D IY IH Z AH M Z
DEIST	D IY IH S T
DEISTIC	D IY IH S T AH K
DEISTICAL	D IY IH S T IH S AH L
DEISTICALLY	D IY IH S T AH K AE L IY
DEISTS	D IY IH S T S
DEITIES	D IY AH T IY Z
DEITY	D IY AH T IY
DEIXIS	D IY IH K S AH S
DEIXISES	D IY IH K S AY Z AH Z
DELEING	D AH L IY AH NG
DELTOIDEI	D IH L T OY D IY
DEVEIN	D IY V EY N
DEVEINED	D IY V EY N D
DEVEINING	D IY V EY N IH NG
DEVEINS	D IY V EY N Z
DIAPHANEITIES	D AY AH F AH N AH T AY Z
DIAPHANEITY	D AY AH F AH N IY AH T IY
DIARRHEIC	D AY AE R IY AH K
DIEING	D AY IH NG
DISAGREEING	D IH S AH G R IY IH NG
DISSEISE	D IH S AY Z
DISSEISED	D IH S IY AH S T
DISSEISES	D IH S AY Z AH Z
DISSEISIN	D IH S AY S AH N
DISSEISING	D IH S AY Z AH NG
DISSEISINS	D IH S AY S AH N Z
DISSEISOR	D IH S AY Z AH R
DISSEISORS	D IH S AY S AH R Z
DISSEIZE	D IH S IY Z
DISSEIZED	D IH S IY Z D
DISSEIZES	D IH S IY Z IH Z
DISSEIZIN	D IH S AY Z AH N
DISSEIZING	D IH S IY Z IH NG
DISSEIZINS	D IH S AY Z AH N Z
DITHEISM	D AY DH IY IH Z AH M
DITHEISMS	D AH TH IY Z AH M Z
DITHEIST	D AY DH IY AH S T
DITHEISTS	D AH TH IY S T S
DREEING	D R IY AH NG
DREICH	D R IY CH
DREIDEL	D R IY D AH L
DREIDELS	D R IY D AH L Z
DREIDL	D R IY D L
DREIDLS	D R IY D L Z
DREIGH	D R EY
DYEING	D AY IH NG
DYEINGS	D AY IH NG Z
DYNEIN	D AH N IY N
DYNEINS	D AH N IY N Z
DYSMENORRHEIC	D IH Z M AH N AO R IY AH K
DYSPNEIC	D IH S N IY AH K
EDELWEISS	EY D AH L V AY S
EDELWEISSES	EH D AH L W IY S AH Z
EICOSANOID	IY K AA S AH N OY D
EICOSANOIDS	IY K AA S AH N OY D Z
EIDE	AY D
EIDER	IY D AH R
EIDERDOWN	IY D AH R D OW N
EIDERDOWNS	IY D AH R D OW N Z
EIDERS	IY D AH R Z
EIDETIC	AY D EH T IH K
EIDETICALLY	AY D EH T IH K AH L IY
EIDOLA	IY D AH L AH
EIDOLIC	IY D AH L AH K
EIDOLON	IY D AH L AH N
EIDOLONS	IY D AH L AH N Z
EIDOS	IY D AH Z
EIGENMODE	EY JH AH N M OW D
EIGENMODES	EY JH AH N M OW D Z
EIGENVALUE	AY G AH N V AE L Y UW
EIGENVALUES	AY G AH N V AE L Y UW Z
EIGENVECTOR	EY JH EH N V EH K T AH R
EIGENVECTORS	EY JH AH N V EH K T AH R Z
EIGHT	EY T
EIGHTBALL	EY T B AO L
EIGHTBALLS	EY T B AO L Z
EIGHTEEN	EY T IY N
EIGHTEENS	EY T IY N Z
EIGHTEENTH	EY T IY N TH
EIGHTEENTHS	EY T IY N TH S
EIGHTFOLD	EY T F OW L D
EIGHTH	EY T TH
EIGHTH(2)	EY TH
EIGHTHLY	EY T TH L IY
EIGHTHS	EY T TH S
EIGHTIES	EY T IY Z
EIGHTIETH	EY T IY IH TH
EIGHTIETHS	EY T IY IH TH S
EIGHTS	EY T S
EIGHTVO	EY T V OW
EIGHTVOS	EY T V AH Z
EIGHTY	EY T IY
EIKON	IY K AH N
EIKONES	IY K OW N Z
EIKONS	IY K AH N Z
EINKORN	IY NG K AH R N
EINKORNS	IY NG K AH R N Z
EINSTEIN	AY N S T AY N
EINSTEINIUM	IY N S T IY N IY AH M
EINSTEINIUMS	IY N S T IY N IY AH M Z
EINSTEINS	IY N S T IY N Z
EIRENIC	IY R AH N AH K
EISEGESES	IY S AH JH IY Z AH Z
EISEGESIS	IY S IY JH AH S AH S
EISTEDDFOD	IY S T EH D F AH D
EISTEDDFODAU	IY S T EH D F AH D AH
EISTEDDFODIC	IY S T EH D F AH D AH K
EISTEDDFODS	IY S T EH D F AH D Z
EISWEIN	IY S W IY N
EISWEINS	IY S W IY N Z
EITHER	IY DH ER
EITHER(2)	AY DH ER
EMCEEING	EH M S IY IH NG
ENCEINTE	IH N S IY N T
ENCEINTES	IH N S IY N T S
EPEEIST	IY P IY AH S T
EPEEISTS	IY P IY AH S T S
EPEIRIC	IY P IY R AH K
EPEIROGENIC	IY P IY R AH JH AH N AH K
EPEIROGENICALLY	IY P AH R AH JH EH N AH K AE L IY
EPEIROGENIES	IY P AH R AA JH AH N AY Z
EPEIROGENY	IY P AH R AA JH AH N IY
EPIGEIC	AH P AY JH IY AH K
EPOPOEIA	EH P AH P OW EH IY AH
EPOPOEIAS	EH P AH P OW EH IY AH Z
EUPNEIC	Y UW P N IY AH K
EUPNOEIC	Y UW P N OW AH AH K
EXTEMPORANEITIES	IH K S T EH M P AH R AH N AH T AY Z
EXTEMPORANEITY	IH K S T EH M P AH R AH N IY AH T IY
EYEING	AY IH NG
FADEIN	F EY D IH N
FADEINS	F EY D IH N Z
FARSEEING	F AA R S IY IH NG
FEATHERWEIGHT	F EH DH ER W EY T
FEATHERWEIGHTS	F EH DH ER W EY T S
FEEING	F IY IH NG
FEIGN	F EY N
FEIGNED	F EY N D
FEIGNER	F EY N ER
FEIGNERS	F EY N ER Z
FEIGNING	F EY N IH NG
FEIGNS	F EY N Z
FEIJOA	F IY JH OW AH
FEIJOAS	F IY JH OW Z
FEINT	F EY N T
FEINTED	F EY N T IH D
FEINTING	F EY N T IH NG
FEINTS	F EY N T S
FEIRIE	F IY R AY
FEIST	F AY S T
FEISTIER	F IY S T AY AH R
FEISTIEST	F IY S T AY AH S T
FEISTINESS	F IY S T AH N AH S
FEISTINESSES	F IY S T AH N EH S AH Z
FEISTS	F IY S T S
FEISTY	F AY S T IY
FETOPROTEIN	F AH T AA P R AH T IY N
FETOPROTEINS	F AH T AA P R AH T IY N Z
FIDEISM	F AY D IY IH Z AH M
FIDEISMS	F AH D IY Z AH M Z
FIDEIST	F AY D IY AH S T
FIDEISTIC	F AH D IY S T AH K
FIDEISTS	F AH D IY S T S
FILAGREEING	F AH L AE G R IY AH NG
FILIGREEING	F IH L AH G R IY IH NG
FLAMBEING	F L AE M IY AH NG
FLAVOPROTEIN	F L AH V AA P R AH T IY N
FLAVOPROTEINS	F L AH V AA P R AH T IY N Z
FLEEING	F L IY IH NG
FLEISHIG	F L IY SH AH G
FLUORESCEIN	F L UH R EH S IY AH N
FLUORESCEINS	F L UH R EH S IY AH N Z
FLYWEIGHT	F L AY W EY T
FLYWEIGHTS	F L AY W EY T S
FOREIGN	F AO R AH N
FOREIGN(2)	F AA R AH N
FOREIGNER	F AO R AH N ER
FOREIGNER(2)	F AA R AH N ER
FOREIGNER(3)	F AO R N ER
FOREIGNER(4)	F AA R N ER
FOREIGNERS	F AO R AH N ER Z
FOREIGNERS(2)	F AA R AH N ER Z
FOREIGNERS(3)	F AO R N ER Z
FOREIGNERS(4)	F AA R N ER Z
FOREIGNISM	F AO R AH N IH Z AH M
FOREIGNISMS	F AO R AH N IH Z AH M Z
FOREIGNNESS	F AO R AH N AH S
FOREIGNNESSES	F AO R AH N AH S IH Z
FORESEEING	F AO R S IY IH NG
FORFEIT	F AO R F IH T
FORFEITABLE	F AO R F AH T AH B AH L
FORFEITED	F AO R F IH T IH D
FORFEITER	F AO R F AH T ER
FORFEITERS	F AO R F AH T ER Z
FORFEITING	F AO R F AH T IH NG
FORFEITS	F AO R F IH T S
FORFEITURE	F AO R F AH CH ER
FORFEITURES	F AO R F AH CH ER Z
FRAULEIN	F R AH L IY N
FRAULEINS	F R AH L IY N Z
FREEING	F R IY IH NG
FREIGHT	F R EY T
FREIGHTAGE	F R EY T IH JH
FREIGHTAGES	F R EY T IH JH IH Z
FREIGHTED	F R EY T IH D
FREIGHTER	F R EY T ER
FREIGHTERS	F R EY T ER Z
FREIGHTING	F R EY T IH NG
FREIGHTS	F R EY T S
FRICASSEEING	F R AH K AE S IY AH NG
GAEING	G IY AH NG
GALLEIN	G AE L IY N
GALLEINS	G AE L IY N Z
GARNISHEEING	G AA R N IH SH IY AH NG
GEEING	JH IY IH NG
GEGENSCHEIN	G EY G AH N SH AY N
GEGENSCHEINS	G EY G AH N SH AY N Z
GEISHA	G EY SH AH
GEISHAS	G IY SH AH Z
GEMEINSCHAFT	JH IY M IY N S AH F T
GEMEINSCHAFTEN	JH IY M IY N S AE F T AH N
GEMEINSCHAFTS	JH IY M IY N S AH F T S
GEMUTLICHKEIT	JH AH M AH T L AH CH IY T
GEMUTLICHKEITS	JH AH M AH T L AH CH IY T S
GESUNDHEIT	G AH Z UH N D HH AY T
GIEING	JH IY AH NG
GLACEING	G L EY S IY AH NG
GLEIZATION	G L IY AH Z EY SH AH N
GLEIZATIONS	G L IY Z EY T IY AH N Z
GLUEING	G L UW IH NG
GLUTEI	G L UW T IY
GLYCOPROTEIN	G L AH K AA P R AH T IY N
GLYCOPROTEINS	G L AH K AA P R AH T IY N Z
GNEISS	N AY S
GNEISSES	N IY S AH Z
GNEISSIC	N IY S AH K
GNEISSOID	N IY S OY D
GNEISSOSE	N IY S OW Z
GRATINEEING	G R AH T IH N IY AH NG
GREEING	G R IY AH NG
GREIGE	G R EY JH
GREIGES	G R EY JH AH Z
GREISEN	G R EY Z AH N
GREISENS	G R EY Z AH N Z
GUARANTEEING	G EH R AH N T IY IH NG
GUMSHOEING	G AH M SH UW IH NG
GYPSEIAN	JH IH P S IY IY AH N
HAECCEITIES	HH IY K S AH T AY Z
HAECCEITY	HH IY K S IY AH T IY
HAEING	HH IY AH NG
HEAVYWEIGHT	HH EH V IY W EY T
HEAVYWEIGHTS	HH EH V IY W EY T S
HEIFER	HH AY F ER
HEIFER(2)	HH EH F ER
HEIFERS	HH EH F ER Z
HEIFERS(2)	HH AY F ER Z
HEIGH	HH EY
HEIGHT	HH AY T
HEIGHTEN	HH AY T AH N
HEIGHTENED	HH AY T AH N D
HEIGHTENING	HH AY T AH N IH NG
HEIGHTENING(2)	HH AY T N IH NG
HEIGHTENS	HH AY T AH N Z
HEIGHTH	HH AY TH
HEIGHTHS	HH EY TH S
HEIGHTS	HH AY T S
HEIL	HH AY L
HEILED	HH IY AH L D
HEILING	HH EY L IH NG
HEILS	HH IY AH L Z
HEIMISH	HH IY M AH SH
HEINIE	HH IY N AY
HEINIES	HH IY N AY Z
HEINOUS	HH EY N AH S
HEINOUSLY	HH IY N OW AH S L IY
HEINOUSNESS	HH IY N AW Z N AH S
HEINOUSNESSES	HH IY N AW Z N EH S AH Z
HEIR	EH R
HEIRDOM	EH R D AH M
HEIRDOMS	EH R D AH M Z
HEIRED	EH R D
HEIRESS	EH R AH S
HEIRESSES	EH R AH S IH Z
HEIRING	EH R IH NG
HEIRLESS	EH R L AH S
HEIRLOOM	EH R L UW M
HEIRLOOMS	EH R L UW M Z
HEIRS	EH R Z
HEIRSHIP	EH R SH IH P
HEIRSHIPS	EH R SH IH P S
HEISHI	HH IY SH IY
HEIST	HH AY S T
HEISTED	HH AY S T IH D
HEISTER	HH AY S T ER
HEISTERS	HH EY S T ER Z
HEISTING	HH AY S T IH NG
HEISTS	HH AY S T S
HEMATEIN	HH EH M AH T IH N
HEMATEINS	HH EH M AH T IH N Z
HEMOPROTEIN	HH AH M AA P R AH T IY N
HEMOPROTEINS	HH AH M AA P R AH T IY N Z
HENOTHEISM	HH AH N OW DH IY IH Z AH M
HENOTHEISMS	HH EH N AH TH IY Z AH M Z
HENOTHEIST	HH AH N OW DH IY AH S T
HENOTHEISTIC	HH EH N AH TH IY S T AH K
HENOTHEISTS	HH EH N AH TH IY S T S
HEREIN	HH IH R IH N
HEREINABOVE	HH IY R IY N AH B OW V
HEREINAFTER	HH IH R AH N AE F T ER
HEREINBEFORE	HH IY R IY N B AH F AH R
HEREINBELOW	HH IY R IY N B AH L OW
HEREINTO	HH IY R IY N T OW
HETEROGENEITIES	HH AH T EH R AH JH AH N AH T AY Z
HETEROGENEITY	HH EH T ER AH JH IH N IY AH T IY
HETEROGENEITY(2)	HH EH T ER AH JH IH N EY AH T IY
HEXEREI	HH EH K S AH R IY
HEXEREIS	HH EH K S IH R IY AH S
HIEING	HH IY AH NG
HOEING	HH OW IH NG
HOGTIEING	HH AA G T AY IH NG
HOLSTEIN	HH OW L S T IY N
HOLSTEINS	HH OW L S T IY N Z
HOMOGENEITIES	HH OW M AH JH AH N IY AH T IY Z
HOMOGENEITY	HH AA M AH JH AH N IY AH T IY
HORDEIN	HH OW R D IH N
HORDEINS	HH OW R D IH N Z
HORSESHOEING	HH AO R S SH UW IH NG
HOWBEIT	HH OW B IY T
HUNDREDWEIGHT	HH AH N D R AH D W EY T
HUNDREDWEIGHTS	HH AH N D R AH D W EY T S
HYGEIST	HH AY JH IY AH S T
HYGEISTS	HH AH JH IY S T S
HYGIEIST	HH IH JH IY AH S T
HYGIEISTS	HH IH JH IY AH S T S
HYPERPNEIC	HH AY P AH R N IY AH K
IDONEITIES	IH D AH N AH T AY Z
IDONEITY	IH D AH N IY AH T IY
ILEITIDES	IH L AH T AY D Z
ILEITIS	AY L IY AY T AH S
IMPERCEIVABLE	IH M P ER S IY V AH B AH L
INBEING	IH N B IY IH NG
INBEINGS	IH N B IY IH NG Z
INCONCEIVABILITIES	IH N K AH N S IY V AH B IH L AH T EH Z
INCONCEIVABILITY	IH N K AH N S IY V AH B IH L AH T EH
INCONCEIVABLE	IH N K AH N S IY V AH B AH L
INCONCEIVABLENESS	IH N K AH N S IY V AH B AH L N AH S
INCONCEIVABLENESSES	IH N K AH N S IY V AH B AH L N AH S IH Z
INCONCEIVABLY	IH N K AH N S IY V AH B L IY
INCORPOREITIES	IH N K AH R P AH R AH T AY Z
INCORPOREITY	IH N K AH R P AH R IY AH T IY
INHOMOGENEITIES	IH N HH OW M AH JH AH N IY AH T IY Z
INHOMOGENEITY	IH N HH OW M AH JH AH N IY AH T IY
INSTANTANEITIES	IH N S T AE N T AH N AH T AY Z
INSTANTANEITY	IH N S T AE N T AH N IY AH T IY
INVEIGH	IH N V EY
INVEIGHED	IH N V EY D
INVEIGHER	IH N V EY ER
INVEIGHERS	IH N V EY ER Z
INVEIGHING	IH N V EY IH NG
INVEIGHS	IH N V EY Z
INVEIGLE	IH N V EY G AH L
INVEIGLED	IH N V EY G AH L D
INVEIGLEMENT	IH N V EY G L M AH N T
INVEIGLEMENTS	IH N V EY G L AH M AH N T S
INVEIGLER	IH N V EY G L AH R
INVEIGLERS	IH N V EY G L AH R Z
INVEIGLES	IH N V EY G AH L Z
INVEIGLING	IH N V EY G L AH NG
ISOCHEIM	IH S AH CH IY M
ISOCHEIMS	IH S AH CH IY M Z
ISOGENEIC	IH S AH JH IY N IY AH K
ISSEI	IH S IY
ISSEIS	IH S IY AH S
JADEITE	JH EY D AY T
JADEITES	JH EY D IY T S
JEEING	JH IY AH NG
KALEIDOSCOPE	K AH L AY D AH S K OW P
KALEIDOSCOPES	K AH L AY D AH S K OW P S
KALEIDOSCOPIC	K AH L AY D AH S K OW P IH K
KALEIDOSCOPICALLY	K AH L AY D AH S K OW P IH K AH L IY
KALLIKREIN	K AE L AH K R IY N
KALLIKREINS	K AE L AH K R IY N Z
KAPELLMEISTER	K AE P AH L M IY S T AH R
KAPELLMEISTERS	K AE P AH L M IY S T AH R Z
KARATEIST	K AH R EY T IY AH S T
KARATEISTS	K AE R AH T IY S T S
KEIR	K IY R
KEIRS	K IY R Z
KEISTER	K IY IH S T ER
KEISTERS	K IY S T ER Z
KEITLOA	K IY T L OW AH
KEITLOAS	K IY T L OW Z
KIBEI	K IH B IY
KIBEIS	K AY B IY AH S
KNEEING	N IY IH NG
LAMMERGEIER	L AE M ER JH IY ER
LAMMERGEIERS	L AE M ER JH IY ER Z
LANDSLEIT	L AE N D S L IY T
LANGBEINITE	L AE N G AH N AY T
LANGBEINITES	L AE N G AH N AY T S
LEI	L EY
LEIS	L EY Z
LEISHMANIA	L IY SH M EY N Y AH
LEISHMANIAL	L IY SH M EY N IY AH L
LEISHMANIAS	L IY SH M EY N Y AH Z
LEISHMANIASES	L IY SH M EY N IY EY Z AH Z
LEISHMANIASIS	L IY SH M EY N Y AH S AH S
LEISTER	L IY S T ER
LEISTERED	L IY S T IY R D
LEISTERING	L IY S T IY R AH NG
LEISTERS	L IY S T AH R Z
LEISURE	L EH ZH ER
LEISURE(2)	L IY ZH ER
LEISURED	L EH ZH ER D
LEISURELINESS	L EH ZH ER L IY N AH S
LEISURELINESSES	L EH ZH ER L IY N AH S IH Z
LEISURELY	L IY Z ER L IY
LEISURES	L EH ZH ER Z
LEISUREWEAR	L EH ZH ER W AE ER
LEITMOTIF	L AY T M OW T IY F
LEITMOTIFS	L AY T M OW T IY F S
LEITMOTIV	L AY T M OW T IY F
LEITMOTIVS	L AY T M OW T IY F S
LEVEEING	L EH V IY IH NG
LIGHTWEIGHT	L AY T W EY T
LIGHTWEIGHTS	L AY T W EY T S
LIPOPROTEIN	L IH P AH P R OW T IY N
LIPOPROTEINS	L IH P OW P R OW T IY N Z
LOGORRHEIC	L AH G AO R IY AH K
LOMEIN	L OW M IY N
LOMEINS	L OW M IY N Z
LONGEING	L AO NG IY AH NG
LUGEING	L UW JH IY AH NG
LUTEIN	L UW T IH N
LUTEINIZATION	L UW T IH N AH Z EY SH AH N
LUTEINIZATIONS	L UW T IH N AH Z EY SH AH N Z
LUTEINIZE	L UW T IH N AY Z
LUTEINIZED	L UW T IH N AY Z D
LUTEINIZES	L UW T IH N AY Z IH Z
LUTEINIZING	L UW T IH N AY Z IH NG
LUTEINS	L UW T IH N Z
LWEI	L W IY
LWEIS	L W IY AH S
MACRONUCLEI	M AE K R AH N AH K L IY
MADEIRA	M AH D IH R AH
MADEIRAS	M EY D IY R AH Z
MADELEINE	M AE D AH L EH N
MADELEINES	M AE D AH L IY N Z
MAKEWEIGHT	M EY K W EY T
MAKEWEIGHTS	M EY K W EY T S
MALLEI	M AE L IY
MARBLEISE	M AA R B L IY Z
MARBLEISED	M AA R B AH L IY Z D
MARBLEISES	M AA R B AH L IY Z IH Z
MARBLEISING	M AA R B AH L IY Z IH NG
MARBLEIZE	M AA R B AH L AY Z
MARBLEIZED	M AA R B AH L AY Z D
MARBLEIZES	M AA R B AH L AY Z IH Z
MARBLEIZING	M AA R B AH L AY Z IH NG
MEIKLE	M IY K AH L
MEINIE	M IY N AY
MEINIES	M IY N AY Z
MEINY	M IY N IY
MEIOSES	M IY OW Z AH Z
MEIOSIS	M AY OW S AH S
MEIOTIC	M IY AH T AH K
MEIOTICALLY	M IY AA T AH K AE L IY
MEITNERIUM	M IY T N IY R IY AH M
MEITNERIUMS	M IY T N IY R IY AH M Z
MESSEIGNEURS	M EH S AH N IY Y AH R Z
MICRONUCLEI	M AY K R OW N UW K L IY AY
MICROSEISM	M AY K R AH S IY AH Z AH M
MICROSEISMIC	M AY K R OW S AY Z M IH K
MICROSEISMICITIES	M AY K R OW S AY Z M IH K AH T IY Z
MICROSEISMICITY	M AY K R OW S AY Z M IH K AH T IY
MICROSEISMS	M AY K R AH S AY Z AH M Z
MIDDLEWEIGHT	M IH D AH L W EY T
MIDDLEWEIGHTS	M IH D AH L W EY T S
MILREIS	M AY L R IY AH S
MISCONCEIVE	M IH S K AH N S IY V
MISCONCEIVED	M IH S K AH N S IY V D
MISCONCEIVER	M IH S K AH N S IY V ER
MISCONCEIVERS	M IH S K AH N S IY V ER Z
MISCONCEIVES	M IH S K AH N S IY V Z
MISCONCEIVING	M IH S K AH N S IY V IH NG
MISONEISM	M AH S OW N IY IH Z AH M
MISONEISMS	M IH S AH N IY Z AH M Z
MISPERCEIVE	M IH S P ER S IY V
MISPERCEIVED	M IH S P ER S IY V D
MISPERCEIVES	M IH S P ER S IY V Z
MISPERCEIVING	M IH S P ER S IY V IH NG
MONOTHEISM	M AA N AH TH IY IH Z AH M
MONOTHEISMS	M AA N AH TH IY Z AH M Z
MONOTHEIST	M AH N OW DH IY AH S T
MONOTHEISTIC	M AA N OW TH IY IH S T IH K
MONOTHEISTICAL	M AA N OW TH IY IH S T IH K AH L
MONOTHEISTICALLY	M AA N OW TH IY IH S T IH K AH L IY
MONOTHEISTS	M AA N AH TH IY S T S
MONSEIGNEUR	M AA N S EY G N AH R
MONTEITH	M AA N T IY IY TH
MONTEITHS	M AA N T IY IY TH S
MUCOPROTEIN	M Y UW K AA P R AH T IY N
MUCOPROTEINS	M Y UW K AA P R AH T IY N Z
MULLEIN	M UH L IY N
MULLEINS	M UH L IY N Z
MUREIN	M Y AH R IY N
MUREINS	M Y AH R IY N Z
MYTHOPOEIA	M IH TH AH P OW EH IY AH
MYTHOPOEIAS	M IH TH AH P OW EH IY AH Z
MYTHOPOEIC	M AH TH AA P OW AH AH K
NARCEIN	N AA R S IY N
NARCEINE	N AA R S IY N
NARCEINES	N AA R S IY N Z
NARCEINS	N AA R S IY N Z
NECROPOLEIS	N EH K R AH P OW L IY AH S
NEIF	N IY F
NEIFS	N IY F S
NEIGH	N EY
NEIGHBOR	N EY B ER
NEIGHBORED	N EY B ER D
NEIGHBORHOOD	N EY B ER HH UH D
NEIGHBORHOODS	N EY B ER HH UH D Z
NEIGHBORING	N EY B ER IH NG
NEIGHBORLINESS	N EY B ER L IY N AH S
NEIGHBORLINESSES	N EY B ER L IY N AH S IH Z
NEIGHBORLY	N EY B ER L IY
NEIGHBORS	N EY B ER Z
NEIGHBOUR	N EY B ER
NEIGHBOURED	N EY B ER D
NEIGHBOURING	N EY B ER IH NG
NEIGHBOURS	N EY B ER Z
NEIGHED	N EY D
NEIGHING	N EY AH NG
NEIGHS	N EY Z
NEIST	N IY AH S T
NEITHER	N IY DH ER
NEITHER(2)	N AY DH ER
NEREID	N IY R IY D
NEREIDES	N IY R IY D Z
NEREIDS	N IY R IY D Z
NEREIS	N IH R IY AH S
NEREISES	N IY R IY Z AH Z
NISEI	N IH S EY
NISEIS	N AY Z IY AH S
NONBEING	N AA N B IY IH NG
NONBEINGS	N AA N B IY IH NG Z
NONFORFEITABLE	N AA N F AO R F AH T AH B AH L
NONFORFEITURE	N AA N F AO R F AH CH ER
NONFORFEITURES	N AA N F AO R F AH CH ER Z
NONPAREIL	N AA N P AH R IY L
NONPAREILS	N AA N P AE R IY AH L Z
NONPROTEIN	N AA N P R OW T IY N
NONRECEIPT	N AA N R IH S IY T
NONRECEIPTS	N AA N R IH S IY T S
NONTHEIST	N AA N DH IY AH S T
NONTHEISTIC	N AA N TH IY IH S T IH K
NONTHEISTS	N AA N TH IY S T S
NUCLEI	N UW K L IY AY
NUCLEIN	N AH K L IY N
NUCLEINS	N AH K L IY N Z
NUCLEOPROTEIN	N AH K L IY AA P R AH T IY N
NUCLEOPROTEINS	N AH K L IY AA P R AH T IY N Z
OBEISANCE	OW B EY S AH N S
OBEISANCES	OW B EY Z AH N S IH Z
OBEISANT	OW B EY Z AH N T
OBEISANTLY	OW B EY Z AH N T L IY
OEILLADE	OW AH AH L EY D
OEILLADES	OW AH AH L EY D Z
OGREISH	OW G ER IH SH
OGREISM	OW G ER IH Z AH M
OGREISMS	OW G ER IH Z AH M Z
OLEIC	OW L IY AH K
OLEIN	OW L IY N
OLEINE	OW L IY N
OLEINES	OW L IY N Z
OLEINS	OW L IY N Z
ONEIRIC	OW N IY R AH K
ONEIRICALLY	OW N IY R AH K AE L IY
ONEIROMANCIES	OW N AH R AH M AE N S AY Z
ONEIROMANCY	OW N IY R AH M AE N S IY
ONOMATOPOEIA	AH N AH M AE T AH P OW EH IY AH
ONOMATOPOEIAS	AH N AH M AE T AH P OW EH IY AH Z
ONOMATOPOEIC	AA N AH M AH T AA P OW AH AH K
ONOMATOPOEICALLY	AH N AH M AE T AH P OW EH AH K AE L IY
ORCEIN	AO R S IY N
ORCEINS	AO R S IY N Z
OREIDE	AH R IY D
OREIDES	AH R IY D Z
OSSEIN	AA S IY N
OSSEINS	AA S IY N Z
OSTEITES	AA S T IY T S
OSTEITIC	AA S T IY T AH K
OSTEITIDES	AA S T AH T AY D Z
OSTEITIS	OW S T IY AY T AH S
OUTSEEING	AW T S IY IH NG
OUTWEIGH	AW T W EY
OUTWEIGHED	AW T W EY D
OUTWEIGHING	AW T W EY IH NG
OUTWEIGHS	AW T W EY Z
OVERDYEING	OW V ER D AY IH NG
OVERSEEING	OW V ER S IY IH NG
OVERWEIGH	OW V ER W EY
OVERWEIGHED	OW V ER W EY D
OVERWEIGHING	OW V ER W EY IH NG
OVERWEIGHS	OW V ER W EY Z
OVERWEIGHT	OW V ER W EY T
OVERWEIGHTED	OW V ER W EY T IH D
OVERWEIGHTING	OW V ER W EY T IH NG
OVERWEIGHTS	OW V ER W EY T S
PANTHEISM	P AE N DH IY IH Z AH M
PANTHEISMS	P AE N TH IY Z AH M Z
PANTHEIST	P AE N TH IY AH S T
PANTHEISTIC	P AE N TH IY IH S T IH K
PANTHEISTICAL	P AE N TH IY AH S T IH K AH L
PANTHEISTICALLY	P AE N TH IY AH S T IH K AH L IY
PANTHEISTS	P AE N TH IY AH S T S
PAPERWEIGHT	P EY P ER W EY T
PAPERWEIGHTS	P EY P ER W EY T S
PAREIRA	P AH R IY R AH
PAREIRAS	P AH R IY R AH Z
PEEING	P IY IH NG
PEIGNOIR	P EY G N OY R
PEIGNOIRS	P EY G N OY R Z
PEIN	P IY N
PEINED	P IY N D
PEINING	P IY N AH NG
PEINS	P IY N Z
PEISE	P IY Z
PEISED	P IY AH S T
PEISES	P IY Z AH Z
PEISING	P IY Z AH NG
PENNYWEIGHT	P EH N IY W EY T
PENNYWEIGHTS	P EH N IY W EY T S
PERCEIVABLE	P ER S IY V AH B AH L
PERCEIVABLY	P ER S IY V AH B L IY
PERCEIVE	P ER S IY V
PERCEIVED	P ER S IY V D
PERCEIVER	P ER S IY V ER
PERCEIVERS	P ER S IY V ER Z
PERCEIVES	P ER S IY V Z
PERCEIVING	P ER S IY V IH NG
PEREIA	P AH R IY AH
PEREION	P AH R IY IY AH N
PEREIOPOD	P AH R IY AH P AH D
PEREIOPODS	P AH R IY AH P AH D Z
PERIPETEIA	P AH R AH P IY T IY AH
PERIPETEIAS	P AH R AH P IY T IY AH Z
PHARMACOPEIA	F AA R M AH K OW P IY AH
PHARMACOPEIAL	F AA R M AH K AH P IY IY AH L
PHARMACOPEIAS	F AA R M AH K OW P IY AH Z
PHARMACOPOEIA	F AA R M AH K AH P IY AH
PHARMACOPOEIAL	F AA R M AH K AA P OW EH IY AH L
PHARMACOPOEIAS	F AA R M AH K AH P IY AH Z
PHENOLPHTHALEIN	F IY N AA L F TH EY L AH N
PHENOLPHTHALEIN(2)	F EH N AA L F TH EY L AH N
PHENOLPHTHALEINS	F AH N OW L F TH AH L IY N Z
PHOSPHOPROTEIN	F AA S AA P R AH T IY N
PHOSPHOPROTEINS	F AA S AA P R AH T IY N Z
PIEING	P AY IH NG
PILEI	P IH L IY
PIXIEISH	P IH K S IY IH SH
PLEBEIAN	P L AH B IY AH N
PLEBEIANISM	P L IH B IY AH N IH Z AH M
PLEBEIANISMS	P L IH B IY AH N IH Z AH M Z
PLEBEIANLY	P L IH B IY AH N L IY
PLEBEIANS	P L AH B IY AH N Z
PLEIAD	P L IY AH D
PLEIADES	P L IY AH D IY Z
PLEIADS	P L IY AH D Z
PLEINAIRISM	P L IY N AH AH R IH Z AH M
PLEINAIRISMS	P L IY N AE AH R AH Z AH M Z
PLEINAIRIST	P L IY N AE AH R AH S T
PLEINAIRISTS	P L IY N AE AH R AH S T S
PLEIOTROPIC	P L IY AA T R AH P AH K
PLEIOTROPIES	P L IY AA T R AH P AY Z
PLEIOTROPY	P L IY AA T R AH P IY
PLUTEI	P L UW T IY
POLEIS	P OW L IY Z
POLTERGEIST	P OW L T ER G AY S T
POLTERGEISTS	P OW L T ER G AY S T S
POLYTHEISM	P AA L IY TH IY IH Z AH M
POLYTHEISMS	P AA L AH TH IY Z AH M Z
POLYTHEIST	P AH L IH DH IY AH S T
POLYTHEISTIC	P AA L IY TH IY IH S T IH K
POLYTHEISTICAL	P OW L IY TH IY IH S T IH K AH L
POLYTHEISTS	P AA L AH TH IY S T S
PRECONCEIVE	P R IY K AH N S IY V
PRECONCEIVED	P R IY K AH N S IY V D
PRECONCEIVES	P R IY K AH N S IY V Z
PRECONCEIVING	P R IY K AH N S IY V IH NG
PREEING	P R IY IY AH NG
PREIGNITION	P R IY AH G N IH SH AH N
PREIGNITIONS	P R IY IH G N IH SH AH N Z
PREIMPLANTATION	P R IY IH M P L AE N T EY SH AH N
PREINAUGURAL	P R IY IH N AO G ER AH L
PREINCORPORATION	P R IY IH N K AO R P ER EY SH AH N
PREINCORPORATIONS	P R IY IH N K AO R P ER EY SH AH N Z
PREINDUCTION	P R IY IH N D AH K SH AH N
PREINDUCTIONS	P R IY IH N D AH K SH AH N Z
PREINDUSTRIAL	P R IY IH N D AH S T R IY AH L
PREINTERVIEW	P R IY IH N T ER V Y UW
PREINTERVIEWED	P R IY IH N T ER V Y UW D
PREINTERVIEWING	P R IY IH N T ER V Y UW IH NG
PREINTERVIEWS	P R IY IH N T ER V Y UW Z
PREINVASION	P R IY IH N V EY ZH AH N
PREMEIOTIC	P R IY M IY AH T AH K
PROCHEIN	P R OW CH IY N
PRONUCLEI	P R OW N UW K L IY AY
PROSOPOPOEIA	P R AH S OW P AH P IY AH
PROSOPOPOEIAS	P R AH S OW P AH P IY AH Z
PROTEI	P R OW T IY
PROTEID	P R OW T IY D
PROTEIDE	P R OW T IY D
PROTEIDES	P R OW T IY D Z
PROTEIDS	P R OW T IY D Z
PROTEIN	P R OW T IY N
PROTEINACEOUS	P R OW T IH N EY SH AH S
PROTEINASE	P R OW T AH N EY Z
PROTEINASES	P R OW T AH N EY Z AH Z
PROTEINS	P R OW T IY N Z
PROTEINURIA	P R OW T IY N Y UH R IY AH
PROTEINURIAS	P R OW T IY N Y UH R IY AH Z
PUREEING	P Y UH R IH NG
QUEUEING	K Y UW IH NG
RAZEEING	R EY Z IH NG
RECEIPT	R IH S IY T
RECEIPT(2)	R IY S IY T
RECEIPTED	R IH S IY T IH D
RECEIPTING	R IH S IY T IH NG
RECEIPTS	R IH S IY T S
RECEIPTS(2)	R IY S IY T S
RECEIVABLE	R IH S IY V AH B AH L
RECEIVABLES	R IH S IY V AH B AH L Z
RECEIVE	R AH S IY V
RECEIVE(2)	R IH S IY V
RECEIVE(3)	R IY S IY V
RECEIVED	R AH S IY V D
RECEIVED(2)	R IH S IY V D
RECEIVED(3)	R IY S IY V D
RECEIVER	R AH S IY V ER
RECEIVER(2)	R IH S IY V ER
RECEIVER(3)	R IY S IY V ER
RECEIVERS	R AH S IY V ER Z
RECEIVERS(2)	R IH S IY V ER Z
RECEIVERS(3)	R IY S IY V ER Z
RECEIVERSHIP	R IH S IY V ER SH IH P
RECEIVERSHIP(2)	R IY S IY V ER SH IH P
RECEIVERSHIPS	R IH S IY V ER SH IH P S
RECEIVES	R AH S IY V Z
RECEIVES(2)	R IH S IY V Z
RECEIVES(3)	R IY S IY V Z
RECEIVING	R AH S IY V IH NG
RECEIVING(2)	R IH S IY V IH NG
RECEIVING(3)	R IY S IY V IH NG
RECONCEIVE	R IY K AH N S IY V
RECONCEIVED	R IY K AH N S IY V D
RECONCEIVES	R IY K AH N S IY V Z
RECONCEIVING	R IY K AH N S IY V IH NG
REDYEING	R IY D AY IH NG
REFEREEING	R EH F AH R IY IH NG
REFUGEEISM	R EH F Y UW JH IH Z AH M
REFUGEEISMS	R EH F Y UW JH IH Z AH M Z
REI	R IY IY
REICHSMARK	R IY IH CH S M AH R K
REICHSMARKS	R IY IH CH S M AH R K S
REIDENTIFIED	R IY AY D EH N T AH F AY D
REIDENTIFIES	R IY AY D EH N T AH F AY Z
REIDENTIFY	R IY AY D EH N T AH F AY
REIDENTIFYING	R IY AY D EH N T AH F AY IH NG
REIF	R IY F
REIFICATION	R IY AH F AH K EY SH AH N
REIFICATIONS	R IY IH F AH K EY T IY AH N Z
REIFIED	R IY AH F AY D
REIFIER	R IY IH F AY AH R
REIFIERS	R IY AH F IY R Z
REIFIES	R IY AH F AY Z
REIFS	R IY IH F S
REIFY	R IY AH F AY
REIFYING	R IY IH F AY AH NG
REIGN	R EY N
REIGNED	R EY N D
REIGNING	R EY N IH NG
REIGNITE	R IY IH G N AY T
REIGNITED	R IY IH G N AY T IH D
REIGNITES	R IY IH G N AY T S
REIGNITING	R IY IH G N AY T IH NG
REIGNITION	R IY IH G N IH SH AH N
REIGNITIONS	R IY IH G N IH SH AH N Z
REIGNS	R EY N Z
REIMAGE	R IY IH M IH JH
REIMAGED	R IY IH M IH JH D
REIMAGES	R IY IH M IH JH IH Z
REIMAGINE	R IY IH M AE JH AH N
REIMAGINED	R IY IH M AE JH AH N D
REIMAGINES	R IY IH M AE JH AH N Z
REIMAGING	R IY IH M IH JH IH NG
REIMAGINING	R IY IH M AE JH AH N IH NG
REIMBURSABLE	R IY IH M B ER S AH B AH L
REIMBURSE	R IY IH M B ER S
REIMBURSED	R IY IH M B ER S T
REIMBURSEMENT	R IY IH M B ER S M AH N T
REIMBURSEMENTS	R IY IH M B ER S M AH N T S
REIMBURSES	R IY IH M B ER S IH Z
REIMBURSING	R IY IH M B ER S IH NG
REIMMERSE	R IY IH M ER S
REIMMERSED	R IY IH M ER S T
REIMMERSES	R IY IH M ER S IH Z
REIMMERSING	R IY IH M ER S IH NG
REIMPLANT	R IY IH M P L AE N T
REIMPLANTATION	R IY IH M P L AE N T EY SH AH N
REIMPLANTATIONS	R IY IH M P L AE N T EY SH AH N Z
REIMPLANTED	R IY IH M P L AE N T IH D
REIMPLANTING	R IY IH M P L AE N T IH NG
REIMPLANTS	R IY IH M P L AE N T S
REIMPORT	R IY IH M P OW R T
REIMPORTATION	R IY IH M P OW R T EY SH AH N
REIMPORTATIONS	R IY IH M P OW R T EY SH AH N Z
REIMPORTED	R IY IH M P OW R T IH D
REIMPORTING	R IY IH M P OW R T IH NG
REIMPORTS	R IY IH M P OW R T S
REIMPOSE	R IY IH M P OW Z
REIMPOSED	R IY IH M P OW Z D
REIMPOSES	R IY IH M P OW Z IH Z
REIMPOSING	R IY IH M P OW Z IH NG
REIMPOSITION	R IY IH M P AH Z IH SH AH N
REIMPOSITIONS	R IY IH M P AH Z IH SH AH N Z
REIMPRESSION	R IY IH M P R EH SH AH N
REIMPRESSIONS	R IY IH M P R EH SH AH N Z
REIN	R EY N
REINCARNATE	R IY IH N K AA R N EY T
REINCARNATED	R IY IH N K AA R N EY T IH D
REINCARNATES	R IY IH N K AA R N AH T S
REINCARNATING	R IY IH N K AA R N EY T IH NG
REINCARNATION	R IY IH N K AA R N EY SH AH N
REINCARNATIONS	R IY IH N K AA R N EY SH AH N Z
REINCITE	R IY IH N S AY T
REINCITED	R IY IH N S AY T IH D
REINCITES	R IY IH N S AY T S
REINCITING	R IY IH N S AY T IH NG
REINCORPORATE	R IY IH N K AO R P ER EY T
REINCORPORATED	R IY IH N K AO R P AH R EY T IH D
REINCORPORATES	R IY IH N K AO R P AH R EY T S
REINCORPORATING	R IY IH N K AO R P ER EY T IH NG
REINCORPORATION	R IY IH N K AO R P ER EY SH AH N
REINCORPORATIONS	R IY IH N K AO R P ER EY SH AH N Z
REINCUR	R IY IH N K ER
REINCURRED	R IY IH N K ER D
REINCURRING	R IY IH N K ER IH NG
REINCURS	R IY IH N K ER Z
REINDEER	R EY N D IH R
REINDEERS	R IY IH N D IH ER Z
REINDEX	R IY IH N D EH K S
REINDEXED	R IY IH N D EH K S T
REINDEXES	R IY IH N D EH K S IH Z
REINDEXING	R IY IH N D EH K S IH NG
REINDICT	R IY IH N D AY T
REINDICTED	R IY IH N D AY T IH D
REINDICTING	R IY IH N D AY T IH NG
REINDICTMENT	R IY IH N D AY T M AH N T
REINDICTMENTS	R IY IH N D AY T M AH N T S
REINDICTS	R IY IH N D AY T S
REINDUCE	R IY IH N D UW S
REINDUCED	R IY IH N D UW S T
REINDUCES	R IY IH N D UW S IH Z
REINDUCING	R IY IH N D UW S IH NG
REINDUCT	R IY IH N D AH K T
REINDUCTED	R IY IH N D AH K T IH D
REINDUCTING	R IY IH N D AH K T IH NG
REINDUCTS	R IY IH N D AH K T S
REINDUSTRIALIZATION	R IY IH N D AH S T R IY AH L AH Z EY SH AH N
REINDUSTRIALIZATIONS	R IY IH N D AH S T R IY AH L AH Z EY SH AH N Z
REINDUSTRIALIZE	R IY IH N D AH S T R IY AH L AY Z
REINDUSTRIALIZED	R IY IH N D AH S T R IY AH L AY Z D
REINDUSTRIALIZES	R IY IH N D AH S T R IY AH L AY Z IH Z
REINDUSTRIALIZING	R IY IH N D AH S T R IY AH L AY Z IH NG
REINED	R EY N D
REINFECT	R IY IH N F EH K T
REINFECTED	R IY IH N F EH K T IH D
REINFECTING	R IY IH N F EH K T IH NG
REINFECTION	R IY IH N F EH K SH AH N
REINFECTIONS	R IY IH N F EH K SH AH N Z
REINFECTS	R IY IH N F EH K T S
REINFESTATION	R IY IH N F EH S T EY SH AH N
REINFESTATIONS	R IY IH N F EH S T EY SH AH N Z
REINFLATE	R IY IH N F L EY T
REINFLATED	R IY IH N F L EY T IH D
REINFLATES	R IY IH N F L EY T S
REINFLATING	R IY IH N F L EY T IH NG
REINFLATION	R IY IH N F L EY SH AH N
REINFLATIONS	R IY IH N F L EY SH AH N Z
REINFORCE	R IY IH N F AO R S
REINFORCEABLE	R IY IH N F OW R S AH B AH L
REINFORCED	R IY IH N F AO R S T
REINFORCEMENT	R IY IH N F AO R S M AH N T
REINFORCEMENTS	R IY IH N F AO R S M AH N T S
REINFORCER	R IY IH N F OW R S ER
REINFORCERS	R IY IH N F OW R S ER Z
REINFORCES	R IY IH N F AO R S IH Z
REINFORCING	R IY IH N F AO R S IH NG
REINFORM	R IY IH N F AO R M
REINFORMED	R IY IH N F AO R M D
REINFORMING	R IY IH N F AO R M IH NG
REINFORMS	R IY IH N F AO R M Z
REINFUSE	R IY IH N F Y UW Z
REINFUSED	R IY IH N F Y UW Z D
REINFUSES	R IY IH N F Y UW Z IH Z
REINFUSING	R IY IH N F Y UW Z IH NG
REINHABIT	R IY IH N HH AE B AH T
REINHABITED	R IY IH N HH AE B AH T IH D
REINHABITING	R IY IH N HH AE B AH T IH NG
REINHABITS	R IY IH N HH AE B AH T S
REINING	R EY N IH NG
REINITIATE	R IY IH N IH SH IY AH T
REINITIATED	R IY IH N IH SH IY EY T IH D
REINITIATES	R IY IH N IH SH IY AH T S
REINITIATING	R IY IH N IH SH IY EY T IH NG
REINJECT	R IY IH N JH EH K T
REINJECTED	R IY IH N JH EH K T IH D
REINJECTING	R IY IH N JH EH K T IH NG
REINJECTION	R IY IH N JH EH K SH AH N
REINJECTIONS	R IY IH N JH EH K SH AH N Z
REINJECTS	R IY IH N JH EH K T S
REINJURE	R IY IH N JH ER
REINJURED	R IY IH N JH ER D
REINJURES	R IY IH N JH ER Z
REINJURIES	R IY IH N JH AH R IY Z
REINJURING	R IY IH N JH ER IH NG
REINJURY	R IY IH N JH AH R IY
REINK	R IY IH NG K
REINKED	R IY IH NG K T
REINKING	R AY NG K IH NG
REINKS	R IY IH NG K S
REINLESS	R EY N L AH S
REINNERVATE	R IY IH N ER V AH T
REINNERVATED	R IY IH N ER V EY T IH D
REINNERVATES	R IY IH N ER V AH T S
REINNERVATING	R IY IH N ER V EY T IH NG
REINNERVATION	R IY IH N ER V EY SH AH N
REINNERVATIONS	R IY IH N ER V EY SH AH N Z
REINOCULATE	R IY IH N AA K Y AH L EY T
REINOCULATED	R IY IH N AA K Y AH L EY T IH D
REINOCULATES	R IY IH N AA K Y AH L EY T S
REINOCULATING	R IY IH N AA K Y AH L EY T IH NG
REINOCULATION	R IY IH N AA K Y AH L EY SH AH N
REINOCULATIONS	R IY IH N AA K Y AH L EY SH AH N Z
REINS	R EY N Z
REINSERT	R IY IH N S ER T
REINSERTED	R IY IH N S ER T IH D
REINSERTING	R IY IH N S ER T IH NG
REINSERTION	R IY IH N S ER SH AH N
REINSERTIONS	R IY IH N S ER SH AH N Z
REINSERTS	R IY IH N S ER T S
REINSMAN	R EY N Z M AE N
REINSMEN	R EY N Z M EH N
REINSPECT	R IY IH N S P EH K T
REINSPECTED	R IY IH N S P EH K T IH D
REINSPECTING	R IY IH N S P EH K T IH NG
REINSPECTION	R IY IH N S P EH K SH AH N
REINSPECTIONS	R IY IH N S P EH K SH AH N S
REINSPECTS	R IY IH N S P EH K T S
REINSPIRE	R IY IH N S P AY ER
REINSPIRED	R IY IH N S P AY ER D
REINSPIRES	R IY IH N S P AY ER Z
REINSPIRING	R IY IH N S P AY ER IH NG
REINSTALL	R IY IH N S T AA L
REINSTALLATION	R IY IH N S T AH L EY SH AH N
REINSTALLATIONS	R IY IH N S T AH L EY SH AH N Z
REINSTALLED	R IY IH N S T AA L D
REINSTALLING	R IY IH N S T AH L IH NG
REINSTALLS	R IY IH N S T AA L Z
REINSTATE	R IY IH N S T EY T
REINSTATED	R IY IH N S T EY T IH D
REINSTATEMENT	R IY IH N S T EY T M AH N T
REINSTATEMENTS	R IY IH N S T AH T M AH N T S
REINSTATES	R IY IH N S T AH T S
REINSTATING	R IY IH N S T EY T IH NG
REINSTITUTE	R IY IH N S T IH T UW T
REINSTITUTED	R IY IH N S T IH T UW T IH D
REINSTITUTES	R IY IH N S T AH T UW T S
REINSTITUTING	R IY IH N S T AH T UW T IH NG
REINSTITUTIONALIZATION	R IY IH N S T AH T UW SH AH N AH L AH Z EY SH AH N
REINSTITUTIONALIZATIONS	R IY IH N S T AH T UW SH AH N AH L AH Z EY SH AH N Z
REINSTITUTIONALIZE	R IY IH N S T AH T UW SH AH N AH L AY Z
REINSTITUTIONALIZED	R IY IH N S T AH T UW SH AH N AH L AY Z D
REINSTITUTIONALIZES	R IY IH N S T AH T UW SH AH N AH L AY Z IH Z
REINSTITUTIONALIZING	R IY IH N S T AH T UW SH AH N AH L AY Z IH NG
REINSURANCE	R IY IH N SH UH R AH N S
REINSURANCES	R IY IH N SH UH R AH N S IH Z
REINSURE	R IY IH N SH UH R
REINSURED	R IY IH N SH UH R D
REINSURER	R IY IH N SH UH R ER
REINSURERS	R IY IH N SH UH R ER Z
REINSURES	R IY IH N SH UH R Z
REINSURING	R IY IH N SH UH R IH NG
REINTEGRATE	R IY IH N T AH G R EY T
REINTEGRATED	R IY IH N T AH G R EY T IH D
REINTEGRATES	R IY IH N T AH G R AH T S
REINTEGRATING	R IY IH N T AH G R EY T IH NG
REINTEGRATION	R IY IH N T AH G R EY SH AH N
REINTEGRATIONS	R IY IH N T AH G R EY SH AH N Z
REINTEGRATIVE	R IY IH N T AH G R AH T IH V
REINTER	R IY IH N T ER
REINTERPRET	R IY IH N T ER P R AH T
REINTERPRETATION	R IY IH N T ER P R AH T EY SH AH N
REINTERPRETATIONS	R IY IH N T ER P R AH T EY SH AH N Z
REINTERPRETED	R IY IH N T ER P R AH T IH D
REINTERPRETING	R IY IH N T ER P R AH T IH NG
REINTERPRETS	R IY IH N T ER P R AH T S
REINTERRED	R IY IH N T ER R EH D
REINTERRING	R IY IH N T ER R IH NG
REINTERS	R IY IH N T ER Z
REINTERVIEW	R IY IH N T ER V Y UW
REINTERVIEWED	R IY IH N T ER V Y UW D
REINTERVIEWING	R IY IH N T ER V Y UW IH NG
REINTERVIEWS	R IY IH N T ER V Y UW Z
REINTRODUCE	R IY IH N T R AH D UW S
REINTRODUCED	R IY IH N T R AH D UW S T
REINTRODUCES	R IY IH N T R AH D UW S IH Z
REINTRODUCING	R IY IH N T R AH D UW S IH NG
REINTRODUCTION	R IY IH N T R AH D AH K SH AH N
REINTRODUCTIONS	R IY IH N T R AH D AH K SH AH N Z
REINVADE	R IY IH N V EY D
REINVADED	R IY IH N V EY D IH D
REINVADES	R IY IH N V EY D Z
REINVADING	R IY IH N V EY D IH NG
REINVASION	R IY IH N V EY ZH AH N
REINVASIONS	R IY IH N V EY ZH AH N Z
REINVENT	R IY IH N V EH N T
REINVENTED	R IY IH N V EH N T IH D
REINVENTING	R IY IH N V EH N T IH NG
REINVENTION	R IY IH N V EH N SH AH N
REINVENTIONS	R IY IH N V EH N CH AH N Z
REINVENTS	R IY IH N V EH N T S
REINVEST	R IY IH N V EH S T
REINVESTED	R IY IH N V EH S T IH D
REINVESTIGATE	R IY IH N V EH S T AH G AH T
REINVESTIGATED	R IY IH N V EH S T AH G EY T IH D
REINVESTIGATES	R IY IH N V EH S T AH G AH T S
REINVESTIGATING	R IY IH N V EH S T AH G EY T IH NG
REINVESTIGATION	R IY IH N V EH S T AH G EY SH AH N
REINVESTIGATIONS	R IY IH N V EH S T AH G EY SH AH N Z
REINVESTING	R IY IH N V EH S T IH NG
REINVESTMENT	R IY IH N V EH S T M AH N T
REINVESTMENT(2)	R IY IH N V EH S M AH N T
REINVESTMENTS	R IY IH N V EH S T M AH N T S
REINVESTS	R IY IH N V EH S T S
REINVESTS(2)	R IY IH N V EH S S
REINVESTS(3)	R IY IH N V EH S
REINVIGORATE	R IY IH N V IH G ER EY T
REINVIGORATED	R IY IH N V IH G ER EY T IH D
REINVIGORATES	R IY IH N V IH G ER AH T S
REINVIGORATING	R IY IH N V IH G ER EY T IH NG
REINVIGORATION	R IY IH N V IH G ER EY SH AH N
REINVIGORATIONS	R IY IH N V IH G ER EY SH AH N Z
REINVIGORATOR	R IY IH N V IH G ER AH T ER
REINVIGORATORS	R IY IH N V IH G ER AH T ER Z
REINVITE	R IY IH N V AY T
REINVITED	R IY IH N V AY T IH D
REINVITES	R IY IH N V AY T S
REINVITING	R IY IH N V AY T IH NG
REINVOKE	R IY IH N V OW K
REINVOKED	R IY IH N V OW K T
REINVOKES	R IY IH N V OW K S
REINVOKING	R IY IH N V OW K IH NG
REIS	R IY Z
REISSUE	R IY IH SH UW
REISSUED	R IY IH SH UW D
REISSUER	R IY IH SH UW ER
REISSUERS	R IY IH SH UW ER Z
REISSUES	R IY IH SH UW Z
REISSUING	R IY IH SH UW IH NG
REITBOK	R IY IH T B AH K
REITBOKS	R IY IH T B AH K S
REITERATE	R IY IH T ER EY T
REITERATED	R IY IH T ER EY T IH D
REITERATES	R IY IH T ER EY S
REITERATING	R IY IH T ER EY T IH NG
REITERATION	R IY IH T ER EY SH AH N
REITERATIONS	R IY IH T ER EY SH AH N Z
REITERATIVE	R IY IH T ER AH T IH V
REITERATIVELY	R IY IH T ER AH T IH V L IY
REIVE	R IY AH V
REIVED	R IY AH V D
REIVER	R IY AH V AH R
REIVERS	R IY IH V AH R Z
REIVES	R IY AH V Z
REIVING	R IY AH V AH NG
RESEEING	R IY S IY IH NG
RESEIZE	R IY S IY Z
RESEIZED	R IY S IY Z D
RESEIZES	R IY S IY Z IH Z
RESEIZING	R IY S IY Z IH NG
RESHOEING	R IY SH UW IH NG
REVEILLE	R AH V EY L
REVEILLES	R AH V EY L Z
REWEIGH	R IY W EY
REWEIGHED	R IY W EY D
REWEIGHING	R IY W EY IH NG
REWEIGHS	R IY W EY Z
RHOMBOIDEI	R AA M B OY D IY
RIBONUCLEOPROTEIN	R AH B AH N AH K L IY AA P R AH T IY N
RIBONUCLEOPROTEINS	R AH B AH N AH K L IY AA P R AH T IY N Z
ROGUEING	R OW G IH NG
ROTTWEILER	R AA T W IY AH L AH R
ROTTWEILERS	R AA T W IY L AH R Z
SABEING	S EY B IY AH NG
SANSEI	S AE N S IY
SANSEIS	S AE N S IY AH S
SAUTEING	S AO T EY IH NG
SCARABAEI	S K AH R AE B IY IY
SCHLOCKMEISTER	S K L AA K M IY S T AH R
SCHLOCKMEISTERS	S K L AA K M IY S T AH R Z
SCHWARMEREI	S K W AO R M AH R IY
SCHWARMEREIS	S K W AO R M IH R IY AH S
SCLEREID	S K L IY R IY D
SCLEREIDS	S K L IY R IY D Z
SCLEROPROTEIN	S K L AH R AA P R AH T IY N
SCLEROPROTEINS	S K L AH R AA P R AH T IY N Z
SEBORRHEIC	S AH B AO R IY AH K
SEEING	S IY IH NG
SEEINGS	S IY IH NG Z
SEGUEING	S EH G IY AH NG
SEI	S AY
SEICENTO	S AY S EH N T OW
SEICENTOS	S AY S EH N T AH Z
SEICHE	S AY CH
SEICHES	S AY CH AH Z
SEIDEL	S AY D AH L
SEIDELS	S AY D AH L Z
SEIF	S IY F
SEIFS	S AY F S
SEIGNEUR	S AY G N AH R
SEIGNEURIAL	S AY N AH Y UH R IY AH L
SEIGNEURIES	S AY G N Y AH R AY Z
SEIGNEURS	S AY N IY Y AH R Z
SEIGNEURY	S AY G N Y AH R IY
SEIGNIOR	S AY G N AY AH R
SEIGNIORAGE	S IY G N IY ER IH JH
SEIGNIORAGES	S AY G N IY AO R AH JH AH Z
SEIGNIORIES	S AY G N IY AH R AY Z
SEIGNIORS	S AY G N IY AH R Z
SEIGNIORY	S AY G N AY AO R IY
SEIGNORAGE	S AY G N AH R AH JH
SEIGNORAGES	S AY G N AO R AH JH AH Z
SEIGNORIAL	S AY G N AO R IY AH L
SEIGNORIES	S AY G N AH R AY Z
SEIGNORY	S AY G N AH R IY
SEINE	S EY N
SEINED	S AY N D
SEINER	S AY N AH R
SEINERS	S AY N AH R Z
SEINES	S AY N Z
SEINING	S AY N AH NG
SEIS	S IY S
SEISABLE	S IY AH S AH B AH L
SEISE	S AY Z
SEISED	S IY AH S T
SEISER	S AY S ER
SEISERS	S AY S AH R Z
SEISES	S AY Z AH Z
SEISIN	S AY S AH N
SEISING	S AY Z AH NG
SEISINGS	S AY S AH NG Z
SEISINS	S AY S AH N Z
SEISM	S IY AH Z AH M
SEISMAL	S AY Z M AH L
SEISMIC	S AY Z M IH K
SEISMICALLY	S AY Z M IH K AH L IY
SEISMICITIES	S AY Z M IH K AH T IY Z
SEISMICITY	S AY Z M IH K AH T IY
SEISMISM	S AY Z M AH Z AH M
SEISMISMS	S AY Z M AH Z AH M Z
SEISMOGRAM	S AY Z M AA G R AH M
SEISMOGRAMS	S AY Z M AA G R AH M Z
SEISMOGRAPH	S AY Z M AH G R AE F
SEISMOGRAPHER	S AY Z M AH G R AE F ER
SEISMOGRAPHERS	S AY Z M AH G R AE F ER Z
SEISMOGRAPHIC	S AY Z M AH G R AE F IH K
SEISMOGRAPHIES	S AY Z M AH G R AE F IY Z
SEISMOGRAPHS	S AY Z M AH G R AE F S
SEISMOGRAPHY	S AY Z M AH G R AE F IY
SEISMOLOGICAL	S AY Z M AH L AO JH AH K AH L
SEISMOLOGIES	S AY Z M AA L AH JH AY Z
SEISMOLOGIST	S AY Z M AA L AH JH IH S T
SEISMOLOGISTS	S AY Z M AA L AH JH IH S T S
SEISMOLOGY	S AY Z M AA L AH JH IY
SEISMOMETER	S AY Z M AA M AH T AH R
SEISMOMETERS	S AY Z M AA M AH T AH R Z
SEISMOMETRIC	S AY Z M AH M AH T R AH K
SEISMOMETRIES	S AY Z M AH M EH T R AY Z
SEISMOMETRY	S AY Z M AH M EH T R IY
SEISMS	S AY Z AH M Z
SEISOR	S AY Z AH R
SEISORS	S AY S AH R Z
SEISURE	S AY ZH Y AH R
SEISURES	S AY ZH Y AH R Z
SEIZABLE	S IY Z AH B AH L
SEIZE	S IY Z
SEIZED	S IY Z D
SEIZER	S IY Z ER
SEIZERS	S IY Z ER Z
SEIZES	S IY Z IH Z
SEIZIN	S AY Z AH N
SEIZING	S IY Z IH NG
SEIZINGS	S IY Z IH NG Z
SEIZINS	S AY Z AH N Z
SEIZOR	S IY Z ER
SEIZORS	S IY Z ER Z
SEIZURE	S IY ZH ER
SEIZURES	S IY ZH ER Z
SEMEIOLOGIES	S IY M IY AA L AH JH AY Z
SEMEIOLOGY	S IY M IY AA L AH JH IY
SEMEIOTIC	S IY M IY AH T AH K
SEMEIOTICS	S IY M IY AH T AH S Z
SEMIDEIFIED	S AH M IY D IY AH F AY D
SEMIDEIFIES	S AH M IY D IY AH F AY Z
SEMIDEIFY	S EH M AH D IY AH F AY
SEMIDEIFYING	S AH M IY D IY IH F AY AH NG
SEREIN	S IY R IY N
SEREINS	S IY R IY N Z
SHEIK	SH IY K
SHEIKDOM	SH IY K D AH M
SHEIKDOMS	SH IY K D AH M Z
SHEIKH	SH IY K
SHEIKHDOM	SH IY K
SHEIKHDOMS	SH IY K D AH M Z
SHEIKHS	SH IY K S
SHEIKS	SH IY K S
SHEILA	SH IY L AH
SHEILAS	SH IY L AH Z
SHEITAN	SH IY T AH N
SHEITANS	SH IY T AH N Z
SHIVAREEING	SH AH V AE R IY AH NG
SHOEING	SH UW IH NG
SIGHTSEEING	S AY T S IY IH NG
SIMULTANEITIES	S AH M UH L T AH N AH T AY Z
SIMULTANEITY	S AH M UH L T AH N IY AH T IY
SINGEING	S IH N JH IH NG
SKEEING	S K IY AH NG
SKEIGH	S K EY
SKEIN	S K EY N
SKEINED	S K IY N D
SKEINING	S K IY N AH NG
SKEINS	S K EY N Z
SKREIGH	S K R EY
SKREIGHED	S K R EY D
SKREIGHING	S K R EY AH NG
SKREIGHS	S K R EY Z
SLEIGH	S L EY
SLEIGHED	S L EY D
SLEIGHER	S L EY AH R
SLEIGHERS	S L EY AH R Z
SLEIGHING	S L EY AH NG
SLEIGHS	S L EY Z
SLEIGHT	S L AY T
SLEIGHTS	S L AY T S
SNOWSHOEING	S N OW SH UW IH NG
SOBEIT	S OW B IY T
SOLEI	S OW L IY
SORTIEING	S AO R T IY IH NG
SOVEREIGN	S AA V R AH N
SOVEREIGNLY	S AA V R AH N L IY
SOVEREIGNS	S AA V R AH N Z
SOVEREIGNTIES	S AA V R AH N T IY Z
SOVEREIGNTY	S AA V R AH N T IY
SPAEING	S P IY AH NG
SPAEINGS	S P IY AH NG Z
SPARTEINE	S P AA R T IY N
SPARTEINES	S P AA R T IY N Z
SPEIL	S P IY L
SPEILED	S P IY AH L D
SPEILING	S P IY AH L AH NG
SPEILS	S P IY AH L Z
SPEIR	S P IH R
SPEIRED	S P IY R D
SPEIRING	S P IY R AH NG
SPEIRS	S P IH R Z
SPEISE	S P IY Z
SPEISES	S P IY Z AH Z
SPEISS	S P IY S
SPEISSES	S P IY S AH Z
SPIEGELEISEN	S P IY JH AH L IY AH S AH N
SPIEGELEISENS	S P IY JH AH L IY S AH N Z
SPONTANEITIES	S P AA N T AH N IY AH T IY Z
SPONTANEITY	S P AA N T AH N IY AH T IY
SPRINGEING	S P R IH NG IY AH NG
SQUEEGEEING	S K W IY JH IY AH NG
SQUILGEEING	S K W IH L JH IY AH NG
STEIN	S T AY N
STEINBOK	S T IY N B AH K
STEINBOKS	S T IY N B AH K S
STEINS	S T AY N Z
STYMIEING	S T AY M IY IH NG
SUBCEILING	S AH B S EH L IH NG
SUBCEILINGS	S AH B S EH L IH NG Z
SUBSEIZURE	S AH B S IY ZH ER
SUBSEIZURES	S AH B S IY ZH ER Z
SUPERHEAVYWEIGHT	S UW P ER HH EH V IY W EY T
SUPERHEAVYWEIGHTS	S UW P ER HH EH V IY W EY T S
SURFEIT	S ER F AH T
SURFEITED	S ER F AH T IH D
SURFEITER	S ER F AH T ER
SURFEITERS	S ER F AH T ER Z
SURFEITING	S ER F AH T IH NG
SURFEITS	S ER F AH T S
SURVEIL	S ER V EY L
SURVEILLANCE	S ER V EY L AH N S
SURVEILLANCES	S ER V EY L AH N S IH Z
SURVEILLANT	S ER V EY L AH N T
SURVEILLANTS	S ER V EY L AH N T S
SURVEILLED	S ER V EY L D
SURVEILLING	S ER V EY L IH NG
SURVEILS	S ER V EY L Z
SWINGEING	S W IH NG IY AH NG
SYNCHRONEITIES	S IH NG K R AH N AH T AY Z
SYNCHRONEITY	S IH NG K R AH N IY AH T IY
SYNGENEIC	S IH N JH IY N IY AH K
TAMEIN	T EY M IH N
TAMEINS	T EY M IH N Z
TEEING	T IY IH NG
TEIGLACH	T EY G L AH CH
TEIID	T IY AH D
TEIIDS	T IY AH D Z
TEIND	T IY N D
TEINDS	T IY N D Z
TERREPLEIN	T EH R AH P L IY N
TERREPLEINS	T EH R AH P L IY N Z
THEIN	TH AY N
THEINE	TH IY N
THEINES	TH IY N Z
THEINS	TH IY N Z
THEIR	DH EH R
THEIRS	DH EH R Z
THEIRSELVES	DH EH R S EH L V Z
THEISM	TH IY IH Z AH M
THEISMS	TH IY Z AH M Z
THEIST	DH IY AH S T
THEISTIC	TH IY IH S T IH K
THEISTICAL	TH IY IH S T IH K AH L
THEISTICALLY	TH IY IH S T IH K AH L IY
THEISTS	TH IY S T S
THEREIN	DH EH R IH N
THEREINAFTER	TH IY R AH N AE F T AH R
THEREINTO	TH IY R IY N T OW
THOLEIITE	TH OW L IY AY T
THOLEIITES	TH OW L IY AY T S
THOLEIITIC	TH OW L IY AH T AH K
TIEING	T AY IH NG
TINEID	T AY N AH D
TINEIDS	T AY N AH D Z
TINGEING	T IH NG IY AH NG
TIPPYTOEING	T IH P IY T OW IH NG
TIPTOEING	T IH P T OW IH NG
TOEING	T OW IH NG
TRACHEID	T R AH CH IY D
TRACHEIDS	T R AH CH IY D Z
TRACHEITIS	T R AE CH IY AY T AH S
TRACHEITISES	T R AE CH AH T AY Z AH Z
TRANSCEIVER	T R AE N S IY V ER
TRANSCEIVERS	T R AE N S IY V ER Z
TREEING	T R IY IH NG
TREILLAGE	T R IY L AH JH
TREILLAGES	T R IY L AH JH AH Z
TRITHEISM	T R AY DH IY IH Z AH M
TRITHEISMS	T R AH TH IY Z AH M Z
TRITHEIST	T R AY DH IY AH S T
TRITHEISTIC	T R AH TH IY S T AH K
TRITHEISTICAL	T R AH TH IY S T IH S AH L
TRITHEISTS	T R AH TH IY S T S
TRUEING	T R UW IH NG
TRUSTEEING	T R AH S T IY IH NG
TURNVEREIN	T AH R N V AH R IY N
TURNVEREINS	T AH R N V AH R IY N Z
TWINGEING	T W IH N JH IH NG
ULTRALIGHTWEIGHT	AH L T R AH L AY T W EY T
UNAGEING	AH N EY JH IH NG
UNCONCEIVABLE	AH N K AH N S IY V AH B AH L
UNDECEIVE	AH N D IH S IY V
UNDECEIVED	AH N D IH S IY V D
UNDECEIVES	AH N D IH S IY V Z
UNDECEIVING	AH N D IH S IY V IH NG
UNDERWEIGHT	AH N D ER W EY T
UNDERWEIGHTS	AH N D ER W EY T S
UNFEIGNED	AH N F EY N D
UNFEIGNEDLY	AH N F EY N AH D L IY
UNFREEING	AH N F R IY IH NG
UNPERCEIVED	AH N P ER S IY V D
UNREINFORCED	AH N R IY IH N F OW R S T
UNSEEING	AH N S IY IH NG
UNSEIZED	AH N S IY Z D
UNVEIL	AH N V EY L
UNVEILED	AH N V EY L D
UNVEILING	AH N V EY L IH NG
UNVEILINGS	AH N V EY L IH NG Z
UNVEILS	AH N V EY L Z
UNVEINED	AH N V EY N D
UNWEIGHT	AH N W EY T
UNWEIGHTED	AH N W EY T IH D
UNWEIGHTING	AH N W EY T IH NG
UNWEIGHTS	AH N W EY T S
URAEI	Y UH R IY IY
UREIC	Y UH R IY AH K
UREIDE	Y AH R IY D
UREIDES	Y AH R IY D Z
UVEITIC	Y UW V EY T AH K
UVEITIDES	Y UW V AH T AY D Z
UVEITIS	Y UW V IY AY T AH S
UVEITISES	Y UW V AH T AY Z AH Z
VEIL	V EY L
VEILED	V EY L D
VEILEDLY	V EY L AH D L IY
VEILER	V EY L ER
VEILERS	V EY L ER Z
VEILING	V EY L IH NG
VEILINGS	V EY L IH NG Z
VEILLIKE	V EY L AY K
VEILS	V EY L Z
VEIN	V EY N
VEINAL	V EY N AH L
VEINED	V EY N D
VEINER	V EY N ER
VEINERS	V EY N ER Z
VEINIER	V EY N IY ER
VEINIEST	V EY N IY AH S T
VEINING	V EY N IH NG
VEININGS	V EY N IH NG Z
VEINLESS	V EY N L AH S
VEINLET	V EY N L AH T
VEINLETS	V EY N L AH T S
VEINLIKE	V EY N L AY K
VEINS	V EY N Z
VEINULE	V EY N Y UW L
VEINULES	V EY N Y UW L Z
VEINULET	V EY N Y UW L AH T
VEINULETS	V EY N Y UW L AH T S
VEINY	V EY N IY
VELLEITIES	V EH L AH T AY Z
VELLEITY	V EH L IY AH T IY
VERMEIL	V ER M AH L
VERMEILS	V ER M AH L Z
VICEREINE	V IH S AH R IY N
VICEREINES	V IH S AH R IY N Z
VILLEIN	V IH L IY N
VILLEINS	V IH L IY N Z
VISEING	V AY S IH NG
VOGUEING	V OW G IH NG
WEEWEEING	W IY W IY IH NG
WEIGELA	W EY JH AH L AH
WEIGELAS	W EY JH AH L AH Z
WEIGELIA	W EY JH IY L Y AH
WEIGELIAS	W EY JH IY L Y AH Z
WEIGH	W EY
WEIGHABLE	W EY AH B AH L
WEIGHED	W EY D
WEIGHER	W EY ER
WEIGHERS	W EY ER Z
WEIGHING	W EY IH NG
WEIGHMAN	W EY M AE N
WEIGHMEN	W EY M EH N
WEIGHS	W EY Z
WEIGHT	W EY T
WEIGHTED	W EY T IH D
WEIGHTER	W EY T ER
WEIGHTERS	W EY T ER Z
WEIGHTIER	W EY T IY ER
WEIGHTIEST	W EY T IY AH S T
WEIGHTILY	W EY T IY L IY
WEIGHTINESS	W EY T IY N AH S
WEIGHTINESSES	W EY T IY N AH S IH Z
WEIGHTING	W EY T IH NG
WEIGHTLESS	W EY T L AH S
WEIGHTLESSLY	W EY T L AH S L IY
WEIGHTLESSNESS	W EY T L AH S N AH S
WEIGHTLESSNESSES	W EY T L AH S N AH S IH Z
WEIGHTLIFTER	W EY T L IH F T ER
WEIGHTLIFTERS	W EY T L IH F T ER Z
WEIGHTLIFTING	W EY T L IH F T IH NG
WEIGHTLIFTINGS	W EY T L IH F T IH NG Z
WEIGHTS	W EY T S
WEIGHTY	W EY T IY
WEIMARANER	W IY M AH R EY N AH R
WEIMARANERS	W IY M AE R AH N AH R Z
WEINER	W AY N ER
WEINERS	W IY N AH R Z
WEIR	W IY R
WEIRD	W IH R D
WEIRDER	W IH R D ER
WEIRDEST	W IH R D AH S T
WEIRDIE	W IH ER D IY
WEIRDIES	W IH ER D IY Z
WEIRDLY	W IH R D L IY
WEIRDNESS	W IH R D N AH S
WEIRDNESSES	W IH ER D N AH S IH Z
WEIRDO	W IH R D OW
WEIRDOES	W IH ER D OW Z
WEIRDOS	W IH R D OW Z
WEIRDS	W IH ER D Z
WEIRDY	W IH ER D IY
WEIRS	W IH ER Z
WEISENHEIMER	W IY S AH N HH IY M AH R
WEISENHEIMERS	W IY S AH N HH IY M AH R Z
WELTERWEIGHT	W EH L T ER W EY T
WELTERWEIGHTS	W EH L T ER W EY T S
WHEREIN	W EH R IH N
WHEREIN(2)	HH W EH R IH N
WHEREINTO	W IY R IY N T OW
WHINGEING	W IH NG IY AH NG
WISENHEIMER	W AY Z AH N HH AY M ER
WISENHEIMERS	W AY Z AH N HH AY M ER Z
XANTHEIN	Z AE N TH IY N
XANTHEINS	Z AE N TH IY N Z
XENOGENEIC	Z EH N AH JH IY N IY AH K
YAHRZEIT	Y AE R Z IY T
YAHRZEITS	Y AE R Z IY T S
ZEIN	Z IY N
ZEINS	Z IY N Z
ZEITGEBER	Z IY T JH IY B AH R
ZEITGEBERS	Z IY T JH AH B AH R Z
ZEITGEIST	T S AY T G AY S T
ZEITGEISTS	T S AY T G AY S T S
KOP	K AA P
COACERVATE	K OW AE S AH R V EY T
MERGANSER	M AH R G AE N Z AH R
FYCE	F AY S
OIL	OY L
LEA	L IY
LWEI	L W IY
