ER	ER
ABACTERIAL	AH B AE K T IH R IY AH L
ABAMPERE	AH B AE M P AH R
ABAMPERES	AE B AH M P IY R Z
ABANDONER	AH B AE N D AH N ER
ABANDONERS	AH B AE N D AH N ER Z
ABASER	AH B EY S ER
ABASERS	AH B EY S ER Z
ABATER	AH B EY T ER
ABATERS	AH B EY T ER Z
ABERRANCE	AE B EH R AH N S
ABERRANCES	AE B EH R AH N S IH Z
ABERRANCIES	AE B EH R AH N S IY Z
ABERRANCY	AE B EH R AH N S IY
ABERRANT	AE B EH R AH N T
ABERRANTLY	AE B EH R AH N T L IY
ABERRANTS	AE B EH R AH N T S
ABERRATED	AE B EH R EY T IH D
ABERRATION	AE B ER EY SH AH N
ABERRATIONAL	AE B ER EY SH AH N AH L
ABERRATIONS	AE B ER EY SH AH N Z
ABETTER	AH B EH T ER
ABETTERS	AH B EH T ER Z
ABHORRER	AH B HH AO R ER
ABHORRERS	AH B HH AO R ER Z
ABIDER	AH B AY D ER
ABIDERS	AH B AY D ER Z
ABJURER	AE B Y AH R AH R
ABJURERS	AE B AH R AH R Z
ABLER	EY B AH L ER
ABLER(2)	EY B L ER
ABOLISHER	AH B AA L IH SH ER
ABOLISHERS	AH B AA L IH SH ER Z
ABORTER	AH B AO R T ER
ABORTERS	AH B AO R T ER Z
ABRADER	AH B R AE D ER
ABRADERS	AH B R AE D ER Z
ABRIDGER	AH B R IH JH ER
ABRIDGERS	AH B R IH JH ER Z
ABRUPTER	AH B R AH P T ER
ABSCONDER	AE B S K AA N D AH R
ABSCONDERS	AE B S K AA N D AH R Z
ABSENTER	AE B S AH N T ER
ABSENTERS	AE B S AH N T ER Z
ABSOLUTER	AE B S AH L UW T ER
ABSOLVER	AE B S OW L V AH R
ABSOLVERS	AE B S OW L V AH R Z
ABSORBER	AH B Z AO R B ER
ABSORBERS	AH B Z AO R B ER Z
ABSTAINER	AH B S T EY N ER
ABSTAINERS	AH B S T EY N ER Z
ABSTERGE	AE B S T AH R JH
ABSTERGED	AE B S T AH R JH D
ABSTERGES	AE B S T AH R JH AH Z
ABSTERGING	AE B S T AH R JH AH NG
ABSTRACTER	AE B S T R AE K T ER
ABSTRACTERS	AE B S T R AE K T ER Z
ABSTRUSER	AH B S T R UW S ER
ABSURDER	AH B S ER D ER
ABUSER	AH B Y UW Z ER
ABUSERS	AH B Y UW Z ER Z
ABUTTER	AH B AH T ER
ABUTTERS	AH B AH T ER Z
ACCEDER	AE K S IY D ER
ACCEDERS	AE K S IY D ER Z
ACCELERANDO	AE K S AH L AH R AE N D OW
ACCELERANDOS	AE K S AH L AH R AE N D AH Z
ACCELERANT	AE K S EH L ER AH N T
ACCELERANTS	AE K S EH L ER AH N T S
ACCELERATE	AE K S EH L ER EY T
ACCELERATED	AE K S EH L ER EY T IH D
ACCELERATES	AE K S EH L ER EY T S
ACCELERATING	AE K S EH L ER EY T IH NG
ACCELERATINGLY	IH K S EH L AH R EY T IH NG L IY
ACCELERATION	AE K S EH L ER EY SH AH N
ACCELERATIONS	IH K S EH L AH R EY SH AH N Z
ACCELERATIVE	IH K S EH L AH R EY T IH V
ACCELERATOR	AE K S EH L ER EY T ER
ACCELERATORS	AE K S EH L ER EY T ER Z
ACCELEROMETER	AE K S EH L ER AA M AH T ER
ACCELEROMETERS	AE K S EH L ER AA M AH T ER Z
ACCEPTER	AE K S EH P T ER
ACCEPTERS	AE K S EH P T ER Z
ACCIPITER	AE K S AH P AY T AH R
ACCIPITERS	AE K S IH P AH T AH R Z
ACCLAIMER	AH K L EY M ER
ACCLAIMERS	AH K L EY M ER Z
ACCLIMATIZER	AE K L AH M EY T AY Z ER
ACCLIMATIZERS	AE K L AH M EY T AY Z ER Z
ACCOMPLISHER	AH K AA M P L IH SH ER
ACCOMPLISHERS	AH K AA M P L IH SH ER Z
ACCORDER	AH K AO R D ER
ACCORDERS	AH K AO R D ER Z
ACCOUTER	AH K UW T ER
ACCOUTERED	AH K UW T ER D
ACCOUTERING	AH K UW T ER IH NG
ACCOUTERMENT	AH K UW T ER M AH N T
ACCOUTERMENTS	AH K UW T ER M AH N T S
ACCOUTERS	AH K UW T ER Z
ACCUSER	AH K Y UW Z ER
ACCUSERS	AH K Y UW Z ER Z
ACERATE	EY S ER AH T
ACERATED	EY S ER EY T IH D
ACERB	AE S AH R B
ACERBATE	EY S ER B EY T
ACERBATED	EY S ER B EY T IH D
ACERBATES	EY S ER B EY T S
ACERBATING	EY S ER B EY T IH NG
ACERBER	EY S ER B IY ER
ACERBEST	EY S ER B EH S T
ACERBIC	AH S EH R B IH K
ACERBICALLY	EY S ER B AY K AO L IY
ACERBITIES	EY S ER B IY AH T IY Z
ACERBITY	EY S ER B IY AH T IY
ACEROLA	AH S EH R AH L AH
ACEROLAS	AH S EH R AH L AH Z
ACEROSE	EY S R OW Z
ACEROUS	EY S ER AH S
ACERVATE	AE S AH R V EY T
ACERVULI	AE S AH R V Y UW L IY
ACERVULUS	AH S AH R V Y AH L AH S
ACETYLCHOLINESTERASE	AH S AH T AH L CH AH L AH N EH S T AH R EY Z
ACETYLCHOLINESTERASES	AH S AH T AH L CH AH L AH N EH S T AH R EY Z AH Z
ACHIER	EY K IY ER
ACHIEVER	AH CH IY V ER
ACHIEVERS	AH CH IY V ER Z
ACIDIFIER	AE S AH D AH F AY ER
ACIDIFIERS	AE S AH D AH F AY ER Z
ACIDIMETER	AE S AH D IH M AH T AH R
ACIDIMETERS	AE S AH D IH M AH T AH R Z
ACIERATE	EY S IY ER AH T
ACIERATED	EY S IY ER EY T IH D
ACIERATES	EY S IY ER AH T S
ACIERATING	EY S IY ER EY T IH NG
ACQUIRER	AH K W AY ER ER
ACQUIRERS	AH K W AY ER ER Z
ACQUITTER	AH K W IH T ER
ACQUITTERS	AH K W IH T ER Z
ACRIDER	AE K R AH D ER
ACTINOMETER	AE K T AH N AA M AH T ER
ACTINOMETERS	AE K T AH N AA M AH T ER Z
ACUTER	AH K Y UW T ER
ADAPTER	AH D AE P T ER
ADAPTERS	AH D AE P T ER Z
ADDER	AE D ER
ADDERS	AE D ER Z
ADDRESSER	AH D R EH S ER
ADDRESSERS	AH D R EH S ER Z
ADDUCER	AH D UW S ER
ADDUCERS	AH D UW S ER Z
ADEPTER	AE D EH P T ER
ADHERE	AH D HH IH R
ADHERED	AE D HH IH R D
ADHERENCE	AH D HH IH R AH N S
ADHERENCES	AE D HH IH ER AH N S IH Z
ADHEREND	AE D HH AH R AH N D
ADHERENDS	AE D HH AH R AH N D Z
ADHERENT	AH D HH IH R AH N T
ADHERENTLY	AE D HH IH ER AH N T L IY
ADHERENTS	AE D HH IH R AH N T S
ADHERER	AE D HH IH ER ER
ADHERERS	AE D HH IH ER ER Z
ADHERES	AH D HH IH R Z
ADHERING	AH D HH IH R IH NG
ADJURER	AE JH Y AH R AH R
ADJURERS	AE JH AH R AH R Z
ADJUSTER	AH JH AH S T ER
ADJUSTERS	AH JH AH S T ER Z
ADMINISTER	AH D M IH N IH S T ER
ADMINISTERED	AH D M IH N IH S T ER D
ADMINISTERING	AE D M IH N IH S T ER IH NG
ADMINISTERS	AE D M IH N IH S T ER Z
ADMIRER	AE D M AY R ER
ADMIRERS	AH D M AY R ER Z
ADMITTER	AH D M IH T ER
ADMITTERS	AH D M IH T ER Z
ADMONISHER	AE D M AA N IH SH ER
ADMONISHERS	AE D M AA N IH SH ER Z
ADOPTER	AH D AA P T ER
ADOPTERS	AH D AA P T ER Z
ADORER	AH D OW R ER
ADORERS	AH D OW R ER Z
ADORNER	AH D AO R N ER
ADORNERS	AH D AO R N ER Z
ADRENERGIC	AE D R AH N AH R JH AH K
ADRENERGICALLY	AE D R AH N AH R JH AH K AE L IY
ADRENOCORTICOSTEROID	AE D R AH N AH K AO R T AH K AA S T AH R OY D
ADRENOCORTICOSTEROIDS	AE D R AH N AH K AH R T AH K AA S T AH R OY D Z
ADROITER	AH D R OY T ER
ADSORBER	AE D Z AO R B ER
ADSORBERS	AE D Z AO R B ER Z
ADULTERANT	AH D AH L T ER AH N T
ADULTERANTS	AH D AH L T ER AH N T S
ADULTERATE	AH D AH L T ER EY T
ADULTERATED	AH D AH L T ER EY T IH D
ADULTERATES	AH D AH L T ER EY T S
ADULTERATING	AH D AH L T ER EY T IH NG
ADULTERATION	AH D AH L T ER EY SH AH N
ADULTERATIONS	AH D AH L T ER EY SH AH N Z
ADULTERATOR	AH D AH L T ER AH T ER
ADULTERATORS	AH D AH L T ER AH T ER Z
ADULTERER	AH D AH L T ER ER
ADULTERERS	AH D AH L T ER ER Z
ADULTERESS	AH D AH L T ER AH S
ADULTERESSES	AH D AH L T ER AH S IH Z
ADULTERIES	AH D AH L T AH R IY Z
ADULTERINE	AH D AH L T AH R AY N
ADULTEROUS	AH D AH L T ER AH S
ADULTEROUSLY	AH D AH L T ER AH S L IY
ADULTERY	AH D AH L T ER IY
ADVANCER	AH D V AE N S ER
ADVANCERS	AH D V AE N S ER Z
ADVENTURER	AE D V EH N CH ER ER
ADVENTURER(2)	AH D V EH N CH ER ER
ADVENTURERS	AE D V EH N CH ER ER Z
ADVENTURERS(2)	AH D V EH N CH ER ER Z
ADVERB	AE D V ER B
ADVERBIAL	AE D V ER B IY AH L
ADVERBIALLY	AE D V ER B IY AH L IY
ADVERBIALS	AE D V ER B IY AH L Z
ADVERBS	AE D V ER B Z
ADVERSARIAL	AE D V ER S EH R IY AH L
ADVERSARIES	AE D V ER S EH R IY Z
ADVERSARINESS	AE D V AH S EH R IY N AH S
ADVERSARINESSES	AE D V AH S EH R IY N AH S IH Z
ADVERSARY	AE D V ER S EH R IY
ADVERSATIVE	AE D V ER S AH T IH V
ADVERSATIVELY	AE D V ER S AH T IH V L IY
ADVERSATIVES	AE D V ER S AH T IH V Z
ADVERSE	AE D V ER S
ADVERSELY	AE D V ER S L IY
ADVERSENESS	AE D V ER S N AH S
ADVERSENESSES	AE D V ER S N AH S IH Z
ADVERSITIES	AE D V ER S AH T IY Z
ADVERSITY	AE D V ER S IH T IY
ADVERT	AE D V ER T
ADVERTED	AE D V ER T IH D
ADVERTENCE	AE D V ER T AH N S
ADVERTENCES	AE D V ER T AH N S IH Z
ADVERTENCIES	AE D V ER T AH N S IY Z
ADVERTENCY	AE D V ER T AH N S IY
ADVERTENT	AE D V ER T AH N T
ADVERTENTLY	AE D V ER T AH N T L IY
ADVERTING	AE D V ER T IH NG
ADVERTISE	AE D V ER T AY Z
ADVERTISED	AE D V ER T AY Z D
ADVERTISEMENT	AE D V ER T AH Z M AH N T
ADVERTISEMENT(2)	AE D V ER T AY Z M AH N T
ADVERTISEMENTS	AE D V ER T AY Z M AH N T S
ADVERTISER	AE D V ER T AY Z ER
ADVERTISERS	AE D V ER T AY Z ER Z
ADVERTISES	AE D V ER T AY Z IH Z
ADVERTISING	AE D V ER T AY Z IH NG
ADVERTISINGS	AE D V ER T AY Z IH NG Z
ADVERTIZE	AE D V ER T AY Z
ADVERTIZED	AE D V ER T AY Z D
ADVERTIZEMENT	AE D V ER T AY Z M AH N T
ADVERTIZEMENTS	AE D V ER T AY Z M AH N T S
ADVERTIZES	AE D V ER T AY Z IH Z
ADVERTIZING	AE D V ER T AY Z IH NG
ADVERTORIAL	AE D V ER T AO R IY AH L
ADVERTORIALS	AE D V ER T AO R IY AH L Z
ADVERTS	AE D V ER T S
ADVISER	AE D V AY Z ER
ADVISERS	AE D V AY Z ER Z
AERATE	AE ER AH T
AERATED	AE ER EY T IH D
AERATES	AE ER AH T S
AERATING	AE ER EY T IH NG
AERATION	AE ER EY SH AH N
AERATIONS	AE ER EY SH AH N Z
AERATOR	AE ER AH T ER
AERATORS	AE ER AH T ER Z
AERENCHYMA	AH R EH NG K AH M AH
AERENCHYMAS	AH R EH NG K AH M AH Z
AERENCHYMATA	EH R AH NG K IH M AH T AH
AERIAL	EH R IY AH L
AERIALIST	AE ER IY AH L IH S T
AERIALISTS	AE ER IY AH L IH S T S
AERIALLY	AE ER IY AH L IY
AERIALS	EH R IY AH L Z
AERIE	EH R IY
AERIED	AE ER IY D
AERIER	AE ER IY ER
AERIES	AE ER IY Z
AERIEST	AE ER IY AH S T
AERIFIED	AE ER AH F AY D
AERIFIES	AE ER AH F AY Z
AERIFORM	EH R AH F AH R M
AERIFY	AE ER AH F AY
AERIFYING	AE ER AH F AY IH NG
AERILY	AE ER IY L IY
AERO	EH R OW
AEROBATIC	EH R AH B AE T IH K
AEROBATICS	EH R AH B AE T IH K S
AEROBE	AH R OW B
AEROBES	AH R OW B Z
AEROBIA	AH R OW B IY AH
AEROBIC	EH R OW B IH K
AEROBICALLY	EH R OW B IH K L IY
AEROBICIZE	AE ER OW B IH K AY Z
AEROBICIZED	AE ER OW B IH K AY Z D
AEROBICIZES	AE ER OW B IH K AY Z IH Z
AEROBICIZING	AE ER OW B IH K AY Z IH NG
AEROBICS	ER OW B IH K S
AEROBIOLOGICAL	EH R AH B IY AA L AH JH IH S AH L
AEROBIOLOGIES	AH R AH B IY AA L AH JH AY Z
AEROBIOLOGY	EH R AH B IY AA L AH JH IY
AEROBIOSES	AH R OW B IY OW Z AH Z
AEROBIOSIS	EH R AH B AY OW S AH S
AEROBIUM	AH R OW B IY AH M
AEROBRAKE	EH R AH B R EY K
AEROBRAKED	EH R AH B R EY K T
AEROBRAKES	EH R AH B R EY K S
AEROBRAKING	EH R AH B R EY K AH NG
AERODROME	EH R AH D R OW M
AERODROMES	EH R AH D R OW M Z
AERODUCT	EH R AH D AH K T
AERODUCTS	EH R AH D AH K T S
AERODYNAMIC	EH R OW D AY N AE M IH K
AERODYNAMICAL	AE R OW D AY N AE M IH K AH L
AERODYNAMICALLY	EH R OW D AY N AE M IH K L IY
AERODYNAMICIST	EH R OW D AY N AE M IH S IH S T
AERODYNAMICISTS	EH R OW D AY N AE M IH S IH S T S
AERODYNAMICISTS(2)	EH R OW D AY N AE M IH S IH S
AERODYNAMICS	EH R OW D AY N AE M IH K S
AERODYNE	EH R AH D AY N
AERODYNES	EH R AH D AY N Z
AEROELASTIC	AH R OW AH L AH S T AH K
AEROELASTICITIES	AH R OW AH L AE S T IH S AH T AY Z
AEROELASTICITY	AH R OW AH L AE S T IH S AH T IY
AEROEMBOLISM	EH R OW EH M B AH L IH Z AH M
AEROEMBOLISMS	EH R OW EH M B AH L AH Z AH M Z
AEROFOIL	EH R AH F OY L
AEROFOILS	AH R AA F OW AH L Z
AEROGEL	EH R AH JH AH L
AEROGELS	EH R AH JH AH L Z
AEROGRAM	AH R AA G R AH M
AEROGRAMME	AH R AA G R AH M
AEROGRAMMES	AH R AA G R AH M Z
AEROGRAMS	AH R AA G R AH M Z
AEROLITE	EH R AH L AY T
AEROLITES	EH R AH L AY T S
AEROLITH	EH R AH L AH TH
AEROLITHS	EH R AH L AH TH S
AEROLOGIES	AE ER AA L AH JH IY Z
AEROLOGY	AE ER AA L AH JH IY
AEROMAGNETIC	EH R AH M AE G N AH T AH K
AEROMECHANICS	EH R AH M EH CH AH N AH S Z
AEROMEDICAL	AH R AA M AH D IH S AH L
AEROMEDICINE	AH R AH M EH D AH S AY N
AEROMEDICINES	AH R AH M EH D AH S AY N Z
AEROMETER	AH R AA M AH T AH R
AEROMETERS	AH R AA M AH T AH R Z
AERONAUT	EH R AH N AH T
AERONAUTIC	EH R OW N AA T AH K
AERONAUTICAL	EH R OW N AA T AH K AH L
AERONAUTICAL(2)	EH R AH N AA T AH K AH L
AERONAUTICALLY	AE R AH N AO T IH K AH L IY
AERONAUTICS	EH R AH N AO T IH K S
AERONAUTS	AH R AA N AH Y UW T S
AERONOMER	EH R AH N OW M AH R
AERONOMERS	AH R AA N AH M AH R Z
AERONOMIC	EH R AH N AH M AH K
AERONOMICAL	AH R AA N AH M IH S AH L
AERONOMIES	AH R AA N AH M AY Z
AERONOMIST	AH R AA N AH M AH S T
AERONOMISTS	AH R AA N AH M AH S T S
AERONOMY	AH R AA N AH M IY
AEROPLANE	EH R AH P L EY N
AEROPLANES	EH R AH P L EY N Z
AEROSAT	EH R AH S AH T
AEROSATS	EH R AH Z EY T S
AEROSOL	EH R AH S AA L
AEROSOLIZATION	AE R AH S AO L AH Z EY SH AH N
AEROSOLIZATIONS	AE R AH S AO L AH Z EY SH AH N Z
AEROSOLIZE	AE R AH S AO L AY Z
AEROSOLIZED	AE R AH S AO L AY Z D
AEROSOLIZES	AE R AH S AO L AY Z IH Z
AEROSOLIZING	AE R AH S AO L AY Z IH NG
AEROSOLS	EH R AH S AA L Z
AEROSPACE	EH R OW S P EY S
AEROSPACES	AE R AH S P EY S IH Z
AEROSTAT	EH R OW S T AE T
AEROSTATICS	AH R AA S T AH T AH S Z
AEROSTATS	EH R OW S T AE T S
AEROTHERMODYNAMIC	EH R AH TH AH R M AA D AH N AH M AH K
AEROTHERMODYNAMICS	EH R AH TH AH R M AH D IH N AH M AH S Z
AERUGO	AH R UW G OW
AERUGOS	AH R UW G AH Z
AERY	AE ER IY
AETHER	AH IY TH ER
AETHERIC	AH IY TH ER IH K
AETHERS	AH IY TH ER Z
AFFECTER	AH F EH K T ER
AFFECTERS	AH F EH K T ER Z
AFFENPINSCHER	AE F EH N P IH N S AH R
AFFENPINSCHERS	AE F AH N P IH N S AH R Z
AFFERENT	AE F ER AH N T
AFFERENTLY	AE F AH R AH N T L IY
AFFERENTS	AE F AH R AH N T S
AFFIRMER	AH F ER M ER
AFFIRMERS	AH F ER M ER Z
AFFIXER	AH F IH K S ER
AFFIXERS	AH F IH K S ER Z
AFFRAYER	AE F R EY AH R
AFFRAYERS	AE F R EY AH R Z
AFLUTTER	AH F L AH T ER
AFTER	AE F T ER
AFTERBIRTH	AE F T ER B ER TH
AFTERBIRTHS	AE F T ER B ER TH S
AFTERBURNER	AE F T ER B ER N ER
AFTERBURNERS	AE F T ER B ER N ER Z
AFTERCARE	AE F T ER K EH R
AFTERCARES	AE F T ER K EH R Z
AFTERCLAP	AE F T ER K L AE P
AFTERCLAPS	AE F T ER K L AE P S
AFTERDECK	AE F T ER D EH K
AFTERDECKS	AE F T ER D EH K S
AFTEREFFECT	AE F T ER AH F EH K T
AFTEREFFECTS	AE F T ER AH F EH K T S
AFTERGLOW	AE F T ER G L OW
AFTERGLOWS	AE F T ER G L OW Z
AFTERIMAGE	AE F T ER IH M IH JH
AFTERIMAGES	AE F T ER IH M IH JH IH Z
AFTERLIFE	AE F T ER L AY F
AFTERLIVES	AE F T ER L AY V Z
AFTERMARKET	AE F T ER M AA R K IH T
AFTERMARKETS	AE F T ER M AA R K IH T S
AFTERMATH	AE F T ER M AE TH
AFTERMATHS	AE F T ER M AE TH S
AFTERMOST	AE F T ER M OW S T
AFTERNOON	AE F T ER N UW N
AFTERNOONS	AE F T ER N UW N Z
AFTERPIECE	AE F T ER P IY S
AFTERPIECES	AE F T ER P IY S IH Z
AFTERS	AE F T ER Z
AFTERSHAVE	AE F T ER SH EY V
AFTERSHAVES	AE F T ER SH EY V Z
AFTERSHOCK	AE F T ER SH AA K
AFTERSHOCKS	AE F T ER SH AA K S
AFTERTASTE	AE F T ER T EY S T
AFTERTASTES	AE F T ER T EY S T S
AFTERTASTES(2)	AE F T ER T EY S
AFTERTAX	AE F T ER T AE K S
AFTERTHOUGHT	AE F T ER TH AA T
AFTERTHOUGHT(2)	AE F T ER TH AO T
AFTERTHOUGHTS	AE F T ER TH AA T S
AFTERTHOUGHTS(2)	AE F T ER TH AO T S
AFTERTIME	AE F T ER T AY M
AFTERTIMES	AE F T ER T AY M Z
AFTERWARD	AE F T ER W ER D
AFTERWARDS	AE F T ER W ER D Z
AFTERWORD	AE F T ER W ER D
AFTERWORDS	AE F T ER W ER D Z
AFTERWORLD	AE F T ER W ER L D
AFTERWORLDS	AE F T ER W ER L D Z
AGAMOSPERMIES	AE G AH M AA S AH R M AY Z
AGAMOSPERMY	AE G AH M AA S AH R M IY
AGER	EY JH ER
AGERATUM	AH JH EH R AH T AH M
AGERATUMS	AH JH EH R AH T AH M Z
AGERS	EY JH ER Z
AGGER	EY JH ER
AGGERS	EY JH ER Z
AGGLOMERATE	AH G L AA M ER EY T
AGGLOMERATED	AH G L AA M AH R EY T IH D
AGGLOMERATES	AH G L AA M AH R EY T S
AGGLOMERATING	AH G L AA M AH R EY T IH NG
AGGLOMERATION	AH G L AA M ER EY SH AH N
AGGLOMERATIONS	AH G L AA M AH R EY SH AH N Z
AGGLOMERATIVE	AH G L AA M AH R EY T IH V
AGGRANDIZER	AE G R AH N D AY Z AH R
AGGRANDIZERS	AE G R AE N D AH Z AH R Z
AGINNER	AH JH IH N ER
AGINNERS	AH JH IH N ER Z
AGLIMMER	AH G L IH M ER
AGLITTER	AH G L IH T ER
AGROFORESTER	AE G R AA F AH R EH S T AH R
AGROFORESTERS	AE G R AH F AH R EH S T AH R Z
AIDER	EY D ER
AIDERS	EY D ER Z
AILERON	EY L ER AA N
AILERONS	EY L ER AA N Z
AIMER	EY M ER
AIMERS	EY M ER Z
AIRER	EH R ER
AIRERS	EH R ER Z
AIRIER	EH R IY ER
AIRLINER	EH R L AY N ER
AIRLINERS	EH R L AY N ER Z
AIRPOWER	EH R P AW ER
AIRPOWERS	AH IH R P AW ER Z
AIRWORTHIER	EH R W ER DH IY ER
AIVER	EY AH V AH R
AIVERS	EY V AH R Z
ALABASTER	AE L AH B AE S T ER
ALABASTERS	AE L AH B AE S T ER Z
ALDER	AO L D ER
ALDERFLIES	AE L D AH R F L AY Z
ALDERFLY	AE L D AH R F L IY
ALDERMAN	AO L D ER M AH N
ALDERMAN(2)	AE L D ER M AH N
ALDERMANIC	AO L D ER M AH N IH K
ALDERMEN	AO L D ER M IH N
ALDERS	AE L D AH R Z
ALDERWOMAN	AE L D AH R W AH M AH N
ALDERWOMEN	AE L D AH R W AH M AH N
ALDOSTERONE	AE L D AA S T AH R OW N
ALDOSTERONES	AE L D AA S T AH R OW N Z
ALDOSTERONISM	AE L D AA S T AH R AH N IH Z AH M
ALDOSTERONISMS	AE L D AH S T EH R AH N AH Z AH M Z
ALERT	AH L ER T
ALERTED	AH L ER T IH D
ALERTER	AH L ER T ER
ALERTEST	AH L ER T AH S T
ALERTING	AH L ER T IH NG
ALERTLY	AH L ER T L IY
ALERTNESS	AH L ER T N AH S
ALERTNESSES	AH L ER T N AH S IH Z
ALERTS	AH L ER T S
ALEXANDER	AE L IH G Z AE N D ER
ALEXANDERS	AE L IH G Z AE N D ER Z
ALGERINE	AE L JH AH R AY N
ALGERINES	AE L JH AH R AY N Z
ALIENER	EY L IY AH N ER
ALIENERS	EY L IY AH N ER Z
ALIGNER	AH L AY N ER
ALIGNERS	AH L AY N ER Z
ALINER	AH L AY N ER
ALINERS	AH L AY N ER Z
ALITERACIES	AH L IH T ER AH S IY Z
ALITERACY	AH L IH T ER AH S IY
ALITERATE	AH L IH T ER AH T
ALITERATES	AH L IH T ER AH T S
ALKALIMETER	AE L K AH L AY M IY T ER
ALKALIMETERS	AE L K AH L AY M IY T ER Z
ALLAYER	AH L EY ER
ALLAYERS	AH L EY ER Z
ALLEGER	AH L EH JH ER
ALLEGERS	AH L EH JH ER Z
ALLEGORIZER	AH L EH JH ER AY Z ER
ALLEGORIZERS	AH L EH JH ER AY Z ER Z
ALLERGEN	AE L ER JH AH N
ALLERGENIC	AO L ER JH IY N IH K
ALLERGENICITIES	AO L ER JH IY N IH K S AH T IY Z
ALLERGENICITY	AO L ER JH IY N IH K S AH T IY
ALLERGENS	AE L ER JH AH N Z
ALLERGIC	AH L ER JH IH K
ALLERGIES	AE L ER JH IY Z
ALLERGIN	AO L ER JH IH N
ALLERGINS	AO L ER JH IH N Z
ALLERGIST	AE L ER JH AH S T
ALLERGISTS	AE L ER JH AH S T S
ALLERGISTS(2)	AE L ER JH AH S
ALLERGY	AE L ER JH IY
ALLITERATE	AH L IH T AH R EY T
ALLITERATED	AH L IH T AH R EY T IH D
ALLITERATES	AH L IH T AH R EY T S
ALLITERATING	AH L IH T AH R EY T IH NG
ALLITERATION	AH L IH T ER EY SH AH N
ALLITERATIONS	AH L IH T AH R EY SH AH N Z
ALLITERATIVE	AH L IH T ER AH T IH V
ALLITERATIVE(2)	AH L IH T ER EY T IH V
ALLITERATIVELY	AH L IH T AH R EY T IH V L IY
ALLOSTERIC	AE L AA S T AH R AH K
ALLOSTERICALLY	AE L AA S T EH R AH K AE L IY
ALLOSTERIES	AE L AA S T AH R AY Z
ALLOSTERY	AE L AH S T EH R IY
ALLOTTER	AH L AA T ER
ALLOTTERS	AH L AA T ER Z
ALLOVER	AO L OW V ER
ALLOVERS	AO L OW V ER Z
ALLURER	AH L UH R ER
ALLURERS	AH L UH R ER Z
ALMNER	AE L M AH R
ALMNERS	AE L M N AH R Z
ALMONER	AA L M AH N ER
ALMONERS	AE L M AH N AH R Z
ALMSGIVER	AE L M Z AH V AH R
ALMSGIVERS	AE L M Z AH V AH R Z
ALPHABETIZER	AE L F AH B EH T AY Z ER
ALPHABETIZERS	AE L F AH B EH T AY Z ER Z
ALPHAMERIC	AE L F AH M IH ER IH K
ALPHANUMERIC	AE L F AH N UW M EH R IH K
ALPHANUMERICAL	AE L F AH N UH M EH R IH K AH L
ALPHANUMERICALLY	AE L F AH N UH M EH R IH K AH L IY
ALPHANUMERICS	AE L F AH N UW M ER IH K S
ALTER	AO L T ER
ALTERABILITIES	AO L T ER AH B IH L AH T EH Z
ALTERABILITY	AO L T ER AH B IH L AH T EH
ALTERABLE	AO L T ER AH B AH L
ALTERABLY	AO L T ER AH B L IY
ALTERANT	AO L T ER AH N T
ALTERANTS	AO L T ER AH N T S
ALTERATION	AO L T ER EY SH AH N
ALTERATIONS	AO L T ER EY SH AH N Z
ALTERCATE	AO L T ER K EY T
ALTERCATED	AO L T ER K EY T IH D
ALTERCATES	AO L T ER K EY T S
ALTERCATING	AO L T ER K EY T IH NG
ALTERCATION	AA L T ER K EY SH AH N
ALTERCATIONS	AA L T ER K EY SH AH N Z
ALTERED	AO L T ER D
ALTERER	AO L T ER ER
ALTERERS	AO L T ER ER Z
ALTERING	AO L T ER IH NG
ALTERNATE	AO L T ER N AH T
ALTERNATE(2)	AO L T ER N EY T
ALTERNATED	AO L T ER N EY T AH D
ALTERNATELY	AO L T ER N AH T L IY
ALTERNATES	AO L T ER N EY T S
ALTERNATING	AO L T ER N EY T IH NG
ALTERNATION	AO L T ER N EY SH AH N
ALTERNATIONS	AO L T ER N AH SH AH N Z
ALTERNATIVE	AO L T ER N AH T IH V
ALTERNATIVELY	AO L T ER N AH T IH V L IY
ALTERNATIVENESS	AO L T ER N AH T IH V N AH S
ALTERNATIVENESSES	AO L T ER N AH T IH V N AH S IH Z
ALTERNATIVES	AO L T ER N AH T IH V Z
ALTERNATOR	AO L T ER N EY T ER
ALTERNATORS	AO L T ER N AH T ER Z
ALTERS	AO L T ER Z
ALTIMETER	AE L T IH M AH T ER
ALTIMETERS	AE L T IH M AH T ER Z
ALTOGETHER	AO L T AH G EH DH ER
ALTOGETHERS	AO L T AH G EH DH ER Z
AMASSER	AH M AE S ER
AMASSERS	AH M AE S ER Z
AMBEER	AE M B IH R
AMBEERS	AE M B AH R Z
AMBER	AE M B ER
AMBERGRIS	AE M B ER G R IH S
AMBERGRISES	AE M B AH R G R AY Z AH Z
AMBERIES	AE M B ER IY Z
AMBERINA	AE M B EH R AH N AH
AMBERINAS	AE M B EH R AH N AH Z
AMBERJACK	AE M B ER JH AE K
AMBERJACKS	AE M B ER JH AE K S
AMBEROID	AE M B AH R OY D
AMBEROIDS	AE M B AH R OY D Z
AMBERS	AE M B ER Z
AMBERY	AE M B ER IY
AMBIDEXTERITIES	AE M B AH D EH K S T EH R AH T AY Z
AMBIDEXTERITY	AE M B AH D EH K S T EH R AH T IY
AMBIVERSION	AE M B AH V EH R Z IY AH N
AMBIVERSIONS	AE M B AH V AH R S IY AH N Z
AMBIVERT	AE M B AH V AH R T
AMBIVERTS	AE M B AH V AH R T S
AMBLER	AE M B L ER
AMBLERS	AE M B AH L ER Z
AMBUSCADER	AE M B AH S K EY D ER
AMBUSCADERS	AE M B AH S K EY D ER Z
AMBUSHER	AE M B UH SH ER
AMBUSHERS	AE M B UH SH ER Z
AMEER	EY M IH R
AMEERATE	EY M AH R EY T
AMEERATES	EY M AH R EY T S
AMEERS	EY M AH R Z
AMENDER	AH M EH N D ER
AMENDERS	AH M EH N D ER Z
AMENTIFEROUS	AH M EH N T IH F AH R AH S
AMERCE	AE M AH R S
AMERCED	AE M AH R S T
AMERCEMENT	AH M AH R S M AH N T
AMERCEMENTS	AH M AH R S AH M AH N T S
AMERCER	AH M ER S ER
AMERCERS	AH M ER S ER Z
AMERCES	AH M AH R S AH Z
AMERCIABLE	AH M ER S IY AH B AH L
AMERCING	AH M AH R S AH NG
AMERICIUM	AE M AH R IH S IY AH M
AMERICIUMS	AE M AH R IH S IY AH M Z
AMINOPTERIN	AE M AH N AA P T AH R AH N
AMINOPTERINS	AE M AH N AA P T AH R AH N Z
AMINOTRANSFERASE	AH M AH N AH T R AE N S AH R EY Z
AMINOTRANSFERASES	AH M AH N AH T R AE N S AH R EY Z AH Z
AMMETER	AE M IY T ER
AMMETERS	AE M IY T ER Z
AMPERAGE	AE M P ER IH JH
AMPERAGES	AE M P EH R AH JH AH Z
AMPERE	AE M P ER
AMPERES	AE M P IY R Z
AMPEROMETRIC	AE M P EH R AH M AH T R AH K
AMPERSAND	AE M P ER S AE N D
AMPERSANDS	AE M P AH R S AH N D Z
AMPHIMACER	AE M F IH M AH S AH R
AMPHIMACERS	AE M F IH M AH S AH R Z
AMPHITHEATER	AE M F AH TH IY EY T ER
AMPHITHEATERS	AE M F AH TH IY EY T ER Z
AMPHOTERIC	AE M F AH T AH R AH K
AMPLER	AE M P AH L ER
AMPLIFIER	AE M P L AH F AY ER
AMPLIFIERS	AE M P L AH F AY ER Z
AMUSER	AH M Y UW Z ER
AMUSERS	AH M Y UW Z ER Z
ANAEROBE	AE N ER OW B
ANAEROBES	AE N ER OW B Z
ANAEROBIC	AE N ER OW B IH K
ANAEROBICALLY	AE N AH R OW B IH K AH L IY
ANAEROBIOSES	AH N AH R OW B IY OW Z AH Z
ANAEROBIOSIS	AH N IY R AH B AY OW S AH S
ANALYSER	AE N AH L AY Z ER
ANALYSERS	AE N AH L AY Z ER Z
ANALYZER	AE N AH L AY Z ER
ANALYZERS	AE N AH L AY Z ER Z
ANCHORPERSON	AE NG K ER P ER S AH N
ANCHORPERSONS	AE NG K ER P ER S AH N Z
ANCIENTER	EY N SH AH N T ER
ANDROSTERONE	AE N D R AA S T AH R OW N
ANDROSTERONES	AE N D R AA S T AH R OW N Z
ANEMOMETER	AE N AH M AA M AH T ER
ANEMOMETERS	AE N AH M AA M AH T AH R Z
ANERGIA	AH N AH R JH IY AH
ANERGIAS	AH N AH R JH IY AH Z
ANERGIC	AE N AH R JH AH K
ANERGIES	AH N AH R JH AY Z
ANERGY	AH N AH R JH IY
ANEROID	AE N AH R OY D
ANEROIDS	AE N AH R OY D Z
ANGER	AE NG G ER
ANGERED	AE NG G ER D
ANGERING	AE NG G ER IH NG
ANGERLESS	AE NG G ER L AH S
ANGERLY	AE NG G ER L IY
ANGERS	AE NG G ER Z
ANGIOSPERM	AE N JH IY AA S AH R M
ANGIOSPERMOUS	AE N JH IY AA S AH R M AH S
ANGIOSPERMS	AE N JH IY AA S AH R M Z
ANGLER	AE NG G L ER
ANGLERFISH	AE NG G AH L ER F IH SH
ANGLERFISHES	AE NG G AH L ER F IH SH IH Z
ANGLERS	AE NG G L ER Z
ANGRIER	AE NG G R IY ER
ANIMADVERSION	AE N AH M AE D EH R Z IY AH N
ANIMADVERSIONS	AE N AH M AH D AH R S IY AH N Z
ANIMADVERT	AE N AH M AE D AH R T
ANIMADVERTED	AE N AH M AE D AH R T AH D
ANIMADVERTING	AE N AH M AE D AH R T AH NG
ANIMADVERTS	AE N AH M AE D AH R T S
ANIMALIER	AE N AH M AH L IY ER
ANIMALIERS	AE N AH M AH L IY ER Z
ANIMATER	AE N AH M AH T ER
ANIMATERS	AE N AH M AH T ER Z
ANKERITE	AE NG K AH R AY T
ANKERITES	AE NG K AH R AY T S
ANNEALER	AE N IY L AH R
ANNEALERS	AE N IY L AH R Z
ANNIVERSARIES	AE N AH V ER S ER IY Z
ANNIVERSARY	AE N AH V ER S ER IY
ANNOUNCER	AH N AW N S ER
ANNOUNCERS	AH N AW N S ER Z
ANNOYER	AH N OY ER
ANNOYERS	AH N OY ER Z
ANOINTER	AH N OY N T AH R
ANOINTERS	AH N OY N T AH R Z
ANOTHER	AH N AH DH ER
ANSERINE	AE N S AH R AY N
ANSERINES	AE N S AH R AY N Z
ANSEROUS	AE N Z ER AH S
ANSWER	AE N S ER
ANSWERABLE	AE N S ER AH B AH L
ANSWERED	AE N S ER D
ANSWERER	AE N S ER ER
ANSWERERS	AE N S ER ER Z
ANSWERING	AE N S ER IH NG
ANSWERS	AE N S ER Z
ANTEATER	AE N T IY T ER
ANTEATERS	AE N T IY T ER Z
ANTECHAMBER	AE N T AH K AE M AH R
ANTECHAMBERS	AE N T AH K AE M B AH R Z
ANTERIOR	AE N T IH R IY ER
ANTERIORLY	AE N T IH R IY ER L IY
ANTEROOM	AE N T AH R UW M
ANTEROOMS	AE N T AH R UW M Z
ANTEVERT	AE N T AH V AH R T
ANTEVERTED	AE N T EH V ER T EH D
ANTEVERTING	AE N T AH V AH R T AH NG
ANTEVERTS	AE N T AH V AH R T S
ANTHER	AE N DH AH R
ANTHERAL	AE N TH AH R AH L
ANTHERID	AE N TH AH R AH D
ANTHERIDIA	AE N TH AH R IH D IY AH
ANTHERIDIAL	AE N TH AH R IH D IY AH L
ANTHERIDIUM	AE N TH AH R IH D IY AH M
ANTHERIDS	AE N TH AH R AH D Z
ANTHERS	AE N TH AH R Z
ANTHOLOGIZER	AE N TH AA L AH JH AY Z AH R
ANTHOLOGIZERS	AE N TH AH L AA JH AH Z AH R Z
ANTIALLERGENIC	AE N T AY AO L ER JH IY N IH K
ANTIALLERGENICS	AE N T AY AO L ER JH IY N IH K S
ANTIBACTERIAL	AE N T IY B AE K T IH R IY AH L
ANTIBACTERIALS	AE N T AY B AE K T IH R IY AH L Z
ANTICANCER	AE N T AY K AE N S ER
ANTICANCER(2)	AE N T IY K AE N S ER
ANTICHOLESTEROL	AE N T AY K AH L EH S T AH R AO L
ANTICHOLINERGIC	AE N T AH CH AA L AH N AH R JH AH K
ANTICHOLINERGICS	AE N T AH CH AA L AH N AH R JH AH S Z
ANTICHOLINESTERASE	AE N T AY K OW L AH N EH S T AH R EY Z
ANTICHOLINESTERASES	AE N T AY K OW L AH N EH S T AH R EY Z IH Z
ANTICLERICAL	AE N T AY K L EH R IH K AH L
ANTICLERICALISM	AE N T AY K L EH R IH K AH L IH Z AH M
ANTICLERICALISMS	AE N T AY K L EH R IH K AH L IH Z AH M Z
ANTICLERICALIST	AE N T AY K L EH R IH K AH L IH S T
ANTICLERICALISTS	AE N T AY K L EH R IH K AH L IH S T S
ANTICLERICALS	AE N T AY K L EH R IH K AH L Z
ANTICOMMERCIAL	AE N T AY K AH M ER SH AH L
ANTICOMMERCIALISM	AE N T AY K AH M ER SH AH L IH Z AH M
ANTICOMMERCIALISMS	AE N T AY K AH M ER SH AH L IH Z AH M Z
ANTICONGLOMERATE	AE N T AY K AH N G L AA M ER AH T
ANTICONSERVATION	AE N T AY K AH N S ER V EY SH AH N
ANTICONSERVATIONIST	AE N T AY K AH N S ER V EY SH AH N IH S T
ANTICONSERVATIONISTS	AE N T AY K AH N S ER V EY SH AH N IH S T S
ANTICONSERVATIONS	AE N T AY K AH N S ER V EY SH AH N Z
ANTICONSUMER	AE N T AY K AH N S UW M ER
ANTICONSUMERS	AE N T AY K AH N S UW M ER Z
ANTICOUNTERFEITING	AE N T AY K AW N T ER F IH T IH NG
ANTIDERIVATIVE	AE N T AY D IH R IH V AH T IH V
ANTIDERIVATIVES	AE N T AY D IH R IH V AH T IH V Z
ANTIDESERTIFICATION	AE N T AY D EH Z ER T AH F AH K EY SH AH N
ANTIEROTIC	AE N T AY IH R AA T IH K
ANTIFEDERALIST	AE N T AY F EH D ER AH L IH S T
ANTIFEDERALISTS	AE N T AY F EH D ER AH L IH S T S
ANTIFERROMAGNET	AE N T AY F EH R OW M AE G N AH T
ANTIFERROMAGNETIC	AE N T AY F EH R OW M AE G N EH T IH K
ANTIFERROMAGNETICALLY	AE N T AY F EH R OW M AE G N EH T IH K AH L IY
ANTIFERROMAGNETISM	AE N T AY F EH R OW M AE G N AH T IH Z AH M
ANTIFERROMAGNETISMS	AE N T AY F EH R OW M AE G N AH T IH Z AH M Z
ANTIFERROMAGNETS	AE N T AY F EH R OW M AE G N AH T S
ANTIFERTILITY	AE N T AY F ER T IH L AH T IY
ANTIFILIBUSTER	AE N T AY F IH L AH B AH S T ER
ANTIFILIBUSTERS	AE N T AY F IH L AH B AH S T ER Z
ANTIFOREIGNER	AE N T AY F AO R AH N ER
ANTIGOVERNMENT	AE N T IY G AH V ER M AH N T
ANTIGOVERNMENT(2)	AE N T AY G AH V ER M AH N T
ANTIGUERRILLA	AE N T AY G AH R IH L AH
ANTIGUERRILLAS	AE N T AY G AH R IH L AH Z
ANTIHERO	AE N T AY HH IY R OW
ANTIHEROES	AE N T AY HH IY R OW Z
ANTIHEROIC	AE N T AY HH IH R OW IH K
ANTIHEROINE	AE N T AY HH EH R AH W AH N
ANTIHEROINES	AE N T AY HH EH R AH W AH N Z
ANTIHERPES	AE N T AH HH AH R P S
ANTIHIERARCHICAL	AE N T AH HH AH R AA R K IH S AH L
ANTIHUNTER	AE N T AY HH AH N T ER
ANTIHYPERTENSIVE	AE N T AY HH AY P ER T EH N S IH V
ANTIHYPERTENSIVES	AE N T AY HH AY P ER T EH N S IH V Z
ANTIHYSTERIC	AE N T AY HH IH S T EH R IH K
ANTIHYSTERICS	AE N T AY HH IH S T EH R IH K S
ANTILIBERAL	AE N T AY L IH B ER AH L
ANTILIBERALISM	AE N T AY L IH B ER AH L IH Z AH M
ANTILIBERALISMS	AE N T AY L IH B ER AH L IH Z AH M Z
ANTILIBERALS	AE N T AY L IH B ER AH L Z
ANTILIBERTARIAN	AE N T AY L IH B ER T EH R IY AH N
ANTILIBERTARIANS	AE N T AY L IH B ER T EH R IY AH N Z
ANTILITERATE	AE N T AY L IH T ER AH T
ANTILITERATES	AE N T AY L IH T ER AH T S
ANTILITTER	AE N T AY L IH T ER
ANTILITTERING	AE N T AY L IH T ER IH NG
ANTIMATERIALISM	AE N T AY M AH T IH R IY AH L IH Z AH M
ANTIMATERIALISMS	AE N T AY M AH T IH R IY AH L IH Z AH M Z
ANTIMATERIALIST	AE N T AY M AH T IH R IY AH L IH S T
ANTIMATERIALISTS	AE N T AY M AH T IH R IY AH L IH S T S
ANTIMATTER	AE T AY M AE T ER
ANTIMATTERS	AE N T AY M AE T ER Z
ANTIMERE	AE N T AY M IH ER
ANTIMERES	AE N T AY M IH ER Z
ANTIMERGER	AE N T AY M ER JH ER
ANTIMODERN	AE N T AY M AA D ER N
ANTIMODERNIST	AE N T AY M AA D ER N IH S T
ANTIMODERNISTS	AE N T AY M AA D ER N IH S T S
ANTIMODERNS	AE N T AY M AA D ER N Z
ANTIPERIODIC	AE N T AY P IH R IY AA D IH K
ANTIPERSONNEL	AE N T AY P ER S AH N EH L
ANTIPERSPIRANT	AE N T AY P ER S P AY R AH N T
ANTIPERSPIRANTS	AE N T AY P ER S P AY R AH N T S
ANTIPOVERTY	AE N T AY P AA V ER T IY
ANTIPOVERTY(2)	AE N T IY P AA V ER T IY
ANTIPROFITEERING	AE N T AY P R AA F AH T IH R IH NG
ANTIQUER	AE N T IY K ER
ANTIQUERS	AE N T IY K ER Z
ANTIRACKETEERING	AE N T AY R AE K AH T IH R IH NG
ANTISERA	AE N T AY S IH R AH
ANTISERUM	AE N T IH S IH R AH M
ANTISERUMS	AE N T IH S IH R AH M Z
ANTISLAVERIES	AE N T AY S L EY V AH R IY Z
ANTISLAVERY	AE N T AY S L EY V AH R IY
ANTISMOKER	AE N T AY S M OW K ER
ANTISMOKERS	AE N T AY S M OW K ER Z
ANTISUBVERSION	AE N T AY S AH B V ER ZH AH N
ANTISUBVERSIONS	AE N T AY S AH B V ER ZH AH N Z
ANTISUBVERSIVE	AE N T AY S AH B V ER S IH V
ANTISUBVERSIVES	AE N T AY S AH B V ER S IH V Z
ANTITAKEOVER	AE N T IY T EY K OW V ER
ANTITERRORISM	AE N T AY T EH R ER IH Z AH M
ANTITERRORISMS	AE N T AY T EH R ER IH Z AH M Z
ANTITERRORIST	AE N T AY T EH R ER IH S T
ANTITERRORISTS	AE N T AY T EH R ER IH S T S
ANTITRUSTER	AE N T AY T R AH S T ER
ANTITRUSTERS	AE N T AY T R AH S T ER Z
ANTITUBERCULAR	AE N T AY T Y AH B AH R K Y AH L AH R
ANTITUBERCULOSIS	AE N T AY T UH B ER K Y AH L OW S AH S
ANTITUBERCULOUS	AE N T AY T Y AH B AH R K Y AH L AH S
ANTIULCER	AE N T AY AH L S ER
ANTIUNIVERSITIES	AE N T AY Y UW N AH V ER S AH T IY Z
ANTIUNIVERSITY	AE N T AY Y UW N AH V ER S AH T IY
ANTLER	AE N T L ER
ANTLERED	AE N T L ER D
ANTLERS	AE N T L ER Z
ANTSIER	AE N T S IY ER
ANYWHERE	EH N IY W EH R
ANYWHERE(2)	EH N IY HH W EH R
ANYWHERES	EH N IY W EH ER Z
APER	EY P ER
APERCU	AH P AH R K UW
APERCUS	AH P AH R K AH S
APERIENT	EY P AH R IY AH N T
APERIENTS	EY P AH R IY AH N T S
APERIES	EY P AH R IY Z
APERIODIC	AH P IH R IY AA D IH K
APERIODICALLY	AH P IH R IY AA D IH K AH L IY
APERIODICITIES	AH P IH R IY AH D IH S AH T IY Z
APERIODICITY	AH P IH R IY AH D IH S AH T IY
APERITIF	AH P EH R AH T IY F
APERITIFS	AH P EH R AH T AH F S
APERS	EY P ER Z
APERTURE	AE P ER CH ER
APERTURES	AE P AH CH UW R Z
APERY	EY P AH R IY
APHAERESES	AE F AH R IY Z AH Z
APHAERESIS	AH F IY R AH S AH S
APHAERETIC	AH F IY R AH T AH K
APHERESES	AE F AH R IY Z AH Z
APHERESIS	AH F IH R AH S AH S
APOLOGIZER	AH P AA L AH JH AY Z AH R
APOLOGIZERS	AE P AH L AA JH AH Z AH R Z
APPEALER	AH P IY L ER
APPEALERS	AH P IY L ER Z
APPEASER	AH P IY Z ER
APPEASERS	AH P IY Z ER Z
APPERCEIVE	AE P AH R S IY AH V
APPERCEIVED	AE P AH R S IY AH V D
APPERCEIVES	AE P AH R S IY AH V Z
APPERCEIVING	AE P AH R S IY AH V AH NG
APPERCEPTION	AE P AH R S EH P AH N
APPERCEPTIONS	AE P AH R S EH P T IY AH N Z
APPERCEPTIVE	AE P AH R S EH P T AH V
APPERTAIN	AE P AH R T EY N
APPERTAINED	AE P AH R T EY N D
APPERTAINING	AE P AH R T EY N AH NG
APPERTAINS	AE P AH R T EY N Z
APPETISER	AE P EH T AH S AH R
APPETISERS	AE P EH T AH S AH R Z
APPETIZER	AE P AH T AY Z ER
APPETIZERS	AE P AH T AY Z ER Z
APPLAUDER	AH P L AO D ER
APPLAUDERS	AH P L AO D ER Z
APPLIER	AH P L AY ER
APPLIERS	AH P L AY ER Z
APPOSER	AE P OW Z AH R
APPOSERS	AE P AH S AH R Z
APPRAISER	AH P R EY Z ER
APPRAISERS	AH P R EY Z ER Z
APPRISER	AE P R AH S AH R
APPRISERS	AE P R AH S AH R Z
APPRIZER	AE P R AY Z AH R
APPRIZERS	AE P R AH Z AH R Z
APPROVER	AH P R UW V ER
APPROVERS	AH P R UW V ER Z
APTER	AE P T ER
APTERAL	AE P T ER AH L
APTERIA	AE P T IY R IY AH
APTERIUM	AE P T IY R IY AH M
APTEROUS	AE P T ER AH S
APTERYX	AE P T AH R AH K S
APTERYXES	AE P T AH R AH K S
AQUAPLANER	AE K W AH P L EY N ER
AQUAPLANERS	AE K W AH P L EY N ER Z
AQUATINTER	AE K W AH T IH N T ER
AQUATINTERS	AE K W AH T IH N T ER Z
AQUIFER	AE K W AH F ER
AQUIFEROUS	AE K W IH F AH R AH S
AQUIFERS	AE K W AH F ER Z
AQUIVER	AH K W IH V ER
ARBITER	AA R B IH T ER
ARBITERS	AA R B AH T ER Z
ARBITRAGER	AA R B IH T R AA ZH ER
ARBITRAGERS	AA R B IH T R AA ZH ER Z
ARCHAEBACTERIA	AA R K IY B AH K T IY R IY AH
ARCHAEBACTERIUM	AA R K IY B AH K T IY R IY AH M
ARCHAEOPTERYX	AA R K IY AA P T AH R AH K S
ARCHAEOPTERYXES	AA R K IY AA P T AH R AH K S
ARCHCONSERVATIVE	AA R CH K AH N S ER V AH T IH V
ARCHCONSERVATIVES	AA R CH K AH N S ER V AH T IH V Z
ARCHENTERA	AA R CH AH N T IH R AH
ARCHENTERON	AA R CH EH N T ER AO N
ARCHENTERONS	AA R CH EH N T ER AO N Z
ARCHER	AA R CH ER
ARCHERFISH	AA R CH ER F IH SH
ARCHERFISHES	AA R CH ER F IH SH IH Z
ARCHERIES	AA R CH AH R IY Z
ARCHERS	AA R CH ER Z
ARCHERY	AA R CH ER IY
ARGENTIFEROUS	AA R JH EH N T IH F AH R AH S
ARGUER	AA R G Y UW ER
ARGUERS	AA R G Y UW ER Z
ARGUFIER	AA R G Y UW F AY AH R
ARGUFIERS	AA R G Y AH F IY R Z
ARIDER	AE R AH D ER
ARMER	AA R M ER
ARMERS	AA R M ER Z
ARMIGER	AA R M IH G ER
ARMIGERAL	AA R M IH JH AH R AH L
ARMIGERO	AA R M IH JH AH R OW
ARMIGEROS	AA R M IH JH AH R AH Z
ARMIGEROUS	AA R M IH JH AH R AH S
ARMIGERS	AA R M AH JH AH R Z
ARMORER	AA R M ER ER
ARMORERS	AA R M ER ER Z
ARMOURER	AA R M ER ER
ARMOURERS	AA R M ER ER Z
AROMATHERAPIES	AH R OW M AH TH EH R AH P IY Z
AROMATHERAPIST	AH R OW M AH TH ER EY P IH S T
AROMATHERAPISTS	AH R OW M AH TH ER EY P IH S T S
AROMATHERAPY	AH R OW M AH TH ER AH P IY
AROUSER	AH R AW Z ER
AROUSERS	AH R AW Z ER Z
ARRANGER	ER EY N JH ER
ARRANGERS	AH R EY N JH ER Z
ARRAYER	AH R EY ER
ARRAYERS	AH R EY ER Z
ARRESTER	AH R EH S T ER
ARRESTERS	AH R EH S T ER Z
ARRIVER	AH R AY V ER
ARRIVERS	AH R AY V ER Z
ARTERIAL	AA R T IH R IY AH L
ARTERIALLY	AA R T IH R IY AH L IY
ARTERIALS	AA R T IH R IY AH L Z
ARTERIES	AA R T ER IY Z
ARTERIOGRAM	AA R T IY R IY AA G R AH M
ARTERIOGRAMS	AA R T IY R IY AA G R AH M Z
ARTERIOGRAPHIC	AA R T IY R IY AA G R AH F AH K
ARTERIOGRAPHIES	AA R T IY R IY AA G R AH F AY Z
ARTERIOGRAPHY	AA R T IY R IY AA G R AH F IY
ARTERIOLAR	AA R T IH R IY OW L ER
ARTERIOLE	AA R T IH R IY OW L
ARTERIOLES	AA R T IH R IY OW L Z
ARTERIOSCLEROSES	AA R T IY R IY AA S L AH R OW Z AH Z
ARTERIOSCLEROSIS	AA R T IH R IY OW S K L ER OW S AH S
ARTERIOSCLEROTIC	AA R T IY R IY AA S L AH R AH T AH K
ARTERIOSCLEROTICS	AA R T IY R IY AA S L EH R AH T AH S Z
ARTERIOVENOUS	AA R T AH R IY AA V AH N AH S
ARTERITIDES	AA R T EH R AH T AY D Z
ARTERITIS	AA R T ER AH T IY Z
ARTERITISES	AA R T ER AH T IY Z IH Z
ARTERY	AA R T ER IY
ARTIER	AA R T IY ER
ARTIFICER	AA R T AH F AH S ER
ARTIFICERS	AA R T AH F AH S ER Z
ARTILLERIES	AA R T IH L AH R IY Z
ARTILLERIST	AA R T IH L ER IH S T
ARTILLERISTS	AA R T IH L ER IH S T S
ARTILLERY	AA R T IH L ER IY
ARTILLERYMAN	AA R T IH L AH R IY M AE N
ARTILLERYMEN	AA R T IH L AH R IY M EH N
ARTSIER	AA R T S IY ER
ASCENDER	AH S EH N D ER
ASCENDERS	AH S EH N D ER Z
ASCERTAIN	AE S ER T EY N
ASCERTAINABLE	AE S ER T EY N AH B AH L
ASCERTAINED	AE S ER T EY N D
ASCERTAINING	AE S ER T EY N IH NG
ASCERTAINMENT	AE S ER T EY N M AH N T
ASCERTAINMENTS	AE S ER T EY N M AH N T S
ASCERTAINS	AE S ER T EY N Z
ASHIER	AH SH AY ER
ASHLER	AE SH L AH R
ASHLERED	AE SH L IY R D
ASHLERING	AE SH L IY R AH NG
ASHLERS	AE SH L AH R Z
ASKER	AE S K ER
ASKERS	AE S K ER Z
ASPER	AE S P ER
ASPERATE	AH Z P ER EY T
ASPERATED	AH Z P ER AH T EH D
ASPERATES	AH Z P ER EY T S
ASPERATING	AH Z P ER EY T IH NG
ASPERGES	AE S AH R JH AH Z
ASPERGILLA	AE S AH R JH IH L AH
ASPERGILLI	AE S AH R JH IH L IY
ASPERGILLOSES	AH Z P ER G IH L AA S IH Z
ASPERGILLOSIS	AH Z P ER G IH L AA S IY Z
ASPERGILLUM	AE S AH R JH IH L AH M
ASPERGILLUMS	AE S AH R JH IH L AH M Z
ASPERGILLUS	AE S AH R JH IH L AH S
ASPERITIES	AE S EH R AH T AY Z
ASPERITY	AH S P EH R IH T IY
ASPERS	AE S AH R Z
ASPERSE	AE S AH R S
ASPERSED	AE S AH R Z D
ASPERSER	AE S EH R Z AH R
ASPERSERS	AE S AH R S AH R Z
ASPERSES	AE S AH R S AH Z
ASPERSING	AH Z P ER S IH NG
ASPERSION	AH S P ER ZH AH N
ASPERSIONS	AH S P ER ZH AH N Z
ASPERSOR	AE S AH R S AH R
ASPERSORS	AE S AH R S AH R Z
ASPHERIC	AH S F IH ER IH K
ASPHERICAL	AH S F IH ER IH K AH L
ASPIRER	AH S P AY ER ER
ASPIRERS	AH S P AY ER ER Z
ASSAILER	AH S EY L ER
ASSAILERS	AH S EY L ER Z
ASSAULTER	AH S AO L T ER
ASSAULTERS	AH S AO L T ER Z
ASSAYER	AE S EY ER
ASSAYERS	AE S EY ER Z
ASSEMBLER	AH S EH M B L ER
ASSEMBLERS	AH S EH M B L ER Z
ASSENTER	AH S EH N T ER
ASSENTERS	AH S EH N T ER Z
ASSERT	AH S ER T
ASSERTED	AH S ER T AH D
ASSERTEDLY	AH S ER T IH D L IY
ASSERTER	AH S ER T ER
ASSERTERS	AH S ER T ER Z
ASSERTING	AH S ER T IH NG
ASSERTION	AH S ER SH AH N
ASSERTIONS	AH S ER SH AH N Z
ASSERTIVE	AH S ER T IH V
ASSERTIVELY	AH S ER T IH V L IY
ASSERTIVENESS	AH S ER T IH V N AH S
ASSERTIVENESSES	AH S ER T IH V N AH S IH Z
ASSERTOR	AH S ER T ER
ASSERTORS	AH S ER T ER Z
ASSERTS	AH S ER T S
ASSEVERATE	AE S EH V ER AH T
ASSEVERATED	AE S EH V ER EY T IH D
ASSEVERATES	AE S EH V ER AH T S
ASSEVERATING	AE S EH V ER EY T IH NG
ASSEVERATION	AE S EH V ER EY SH AH N
ASSEVERATIONS	AE S EH V ER EY SH AH N Z
ASSEVERATIVE	AE S EH V ER AH T IH V
ASSIGNER	AH S AY N ER
ASSIGNERS	AH S AY N ER Z
ASSISTER	AH S IH S T ER
ASSISTERS	AH S IH S T ER Z
ASSORTER	AH S AO R T ER
ASSORTERS	AH S AO R T ER Z
ASSUMER	AH S UW M ER
ASSUMERS	AH S UW M ER Z
ASSURER	AH SH UW R ER
ASSURERS	AH SH UW R ER Z
ASTER	AE S T ER
ASTERIA	AE S T IH R IY AH
ASTERIAS	AE S T IH R IY AH Z
ASTERIATED	AE S T IH R IY AH T EH D
ASTERISK	AE S T ER IH S K
ASTERISKED	AE S T AH R IH S K T
ASTERISKING	AE S T AH R IH S K IH NG
ASTERISKLESS	AE S T AH R IH S K L AH S
ASTERISKS	AE S T AH R IH S K S
ASTERISM	AE S T ER IH Z AH M
ASTERISMS	AE S T ER IH Z AH M Z
ASTERN	AH S T ER N
ASTERNAL	AH S T ER N AH L
ASTEROID	AE S T ER OY D
ASTEROIDAL	AE S T AH R OY D AH L
ASTEROIDS	AE S T ER OY D Z
ASTERS	AE S T ER Z
ASTHENOSPHERE	AE S TH AH N AA S AH R
ASTHENOSPHERES	AE S TH EH N AH S IY R Z
ASTHENOSPHERIC	AE S TH AH N AA S AH R AH K
ASTROLOGER	AH S T R AA L AH JH ER
ASTROLOGERS	AH S T R AA L AH JH ER Z
ASTRONOMER	AH S T R AA N AH M ER
ASTRONOMERS	AH S T R AA N AH M ER Z
ASTROPHOTOGRAPHER	AE S T R AH F AH T AA G R AH F AH R
ASTROPHOTOGRAPHERS	AE S T R AH F AH T AA G R AH F AH R Z
ASUNDER	AH S AH N D ER
ATELIER	EY T L IY ER
ATELIERS	EY T L IY ER Z
ATHEROGENESES	AH TH AH R AA JH AH N IY Z AH Z
ATHEROGENESIS	AE TH AH R AH JH IY N AH S AH S
ATHEROGENIC	AH TH EH R AH JH AH N AH K
ATHEROMA	AH TH EH R AH M AH
ATHEROMAS	AH TH EH R AH M AH Z
ATHEROMATA	AE TH AH R AA M AH T AH
ATHEROMATOUS	AE TH AH R AA M AH T AH S
ATHEROSCLEROSES	AH TH AH R AA S L AH R OW Z AH Z
ATHEROSCLEROSIS	AE TH ER OW S K L ER OW S IH S
ATHEROSCLEROTIC	AE TH AH R AA S L AH R AH T AH K
ATMOMETER	AE T M AA M AH T AH R
ATMOMETERS	AE T M AA M AH T AH R Z
ATMOSPHERE	AE T M AH S F IH R
ATMOSPHERED	AE T M AH S F IH ER D
ATMOSPHERES	AE T M AH S F IH ER Z
ATMOSPHERIC	AE T M AH S F EH R IH K
ATMOSPHERICALLY	AE T M AH S F IH ER IH K AH L IY
ATMOSPHERICS	AE T M AH S F EH R IH K S
ATOMISER	AE T AH M IY Z ER
ATOMISERS	AE T AH M IY Z ER Z
ATOMIZER	AE T AH M AY Z ER
ATOMIZERS	AE T AH M AY Z ER Z
ATONER	AH T OW N ER
ATONERS	AH T OW N ER Z
ATTACHER	AH T AE CH ER
ATTACHERS	AH T AE CH ER Z
ATTACKER	AH T AE K ER
ATTACKERS	AH T AE K ER Z
ATTAINDER	AH T EY N D ER
ATTAINDERS	AE T EY N D AH R Z
ATTAINER	AH T EY N ER
ATTAINERS	AH T EY N ER Z
ATTEMPER	AE T EH M P AH R
ATTEMPERED	AE T AH M P IY R D
ATTEMPERING	AE T AH M P IY R AH NG
ATTEMPERS	AE T EH M P AH R Z
ATTENDER	AH T EH N D ER
ATTENDERS	AH T EH N D ER Z
ATTESTER	AH T EH S T ER
ATTESTERS	AH T EH S T ER Z
ATWITTER	AH T W IH T ER
AUBERGE	AO B AH R JH
AUBERGES	AH B AH R JH AH Z
AUBERGINE	AO B AH R JH AY N
AUBERGINES	AO B AH R JH AY N Z
AUCTIONEER	AA K SH AH N IH R
AUCTIONEERS	AO K SH AH N IH R Z
AUDIOMETER	AO D IY OW M IY T ER
AUDIOMETERS	AO D IY OW M IY T ER Z
AUGER	AO G ER
AUGERS	AO G ER Z
AUGMENTER	AO G M EH N T ER
AUGMENTERS	AO G M EH N T ER Z
AUGURER	AO G ER ER
AUGURERS	AO G ER ER Z
AUGUSTER	AO G AH S T ER
AULDER	AO L D AH R
AUNTLIER	AE N T L IY ER
AURIFEROUS	AH R IH F AH R AH S
AUSLANDER	AW S L AH N D ER
AUSLANDERS	AO Z L AE N D AH R Z
AUSTERE	AO S T IH R
AUSTERELY	AO S T IH R L IY
AUSTERENESS	AO S T IH ER N AH S
AUSTERENESSES	AO S T IH ER N AH S IH Z
AUSTERER	AO S T IH ER ER
AUSTEREST	AO S T IH ER AH S T
AUSTERITIES	AO S T EH R AH T IY Z
AUSTERITY	AO S T EH R IH T IY
AUTHORIZER	AO TH ER AY Z ER
AUTHORIZERS	AO TH ER AY Z ER Z
AUTOBIOGRAPHER	AO T AH B AY AA G R AH F ER
AUTOBIOGRAPHERS	AO T OW B AY AA G R AH F ER Z
AUTOEROTIC	AO T OW IH R AA T IH K
AUTOEROTICISM	AO T OW IH R AA T IH K IH Z AH M
AUTOEROTICISMS	AO T OW IH R AA T IH K IH Z AH M Z
AUTOEROTISM	AO T AH R AH T IH Z AH M
AUTOEROTISMS	AH T AH R AH T AH Z AH M Z
AUTOMAKER	AO T OW M EY K ER
AUTOMAKERS	AO T OW M EY K ER Z
AUTOTRANSFORMER	AO T OW T R AE N S F AO R M ER
AUTOTRANSFORMERS	AO T OW T R AE N S F AO R M ER Z
AUTOWORKER	AO T OW W ER K ER
AUTOWORKERS	AO T OW W ER K ER Z
AVENGER	AH V EH N JH ER
AVENGERS	AH V EH N JH ER Z
AVER	EY V ER
AVERAGE	AE V ER IH JH
AVERAGE(2)	AE V R IH JH
AVERAGED	AE V R IH JH D
AVERAGELY	AE V R IH JH L IY
AVERAGENESS	AE V R IH JH N AH S
AVERAGENESSES	AE V R IH JH N AH S IH Z
AVERAGES	AE V R IH JH IH Z
AVERAGING	AE V R IH JH IH NG
AVERMENT	AH V EH R M AH N T
AVERMENTS	AH V EH R M AH N T S
AVERRED	AE V AH R D
AVERRING	AH V EH R AH NG
AVERS	EY V ER Z
AVERSE	AH V ER S
AVERSELY	AH V ER S L IY
AVERSENESS	AH V ER S N AH S
AVERSENESSES	AH V ER S N AH S IH Z
AVERSION	AH V ER ZH AH N
AVERSIONS	AH V ER ZH AH N Z
AVERSIVE	AH V ER S AH V
AVERSIVELY	AH V ER S IH V L IY
AVERSIVENESS	AH V ER S IH V N AH S
AVERSIVENESSES	AH V ER S IH V N AH S IH Z
AVERT	AH V ER T
AVERTED	AH V ER T AH D
AVERTING	AH V ER T IH NG
AVERTS	AH V ER T S
AVOIDER	AH V OY D ER
AVOIDERS	AH V OY D ER Z
AVOUCHER	AH V AW CH ER
AVOUCHERS	AH V AW CH ER Z
AVOWER	AH V AW ER
AVOWERS	AH V AW ER Z
AWAITER	AH W EY T ER
AWAITERS	AH W EY T ER Z
AWAKENER	AH W EY K AH N ER
AWAKENERS	AH W EY K AH N ER Z
AWARDER	AH W AO R D ER
AWARDERS	AH W AO R D ER Z
AWEATHER	AH W EH DH ER
AWFULLER	AO F AH L ER
AWKWARDER	AO K W ER D ER
AZERTY	AH Z EH R T IY
AZOOSPERMIA	AE Z UW S AH R M IY AH
AZOOSPERMIAS	AE Z UW S AH R M IY AH Z
AZOTOBACTER	AH Z AA T AH B AE K T AH R
AZOTOBACTERS	AE Z AH T AH B AE K T AH R Z
BABBLER	B AE B L ER
BABBLERS	B AE B L ER Z
BABYSITTER	B EY B IY S IH T ER
BABYSITTERS	B EY B IY S IH T ER Z
BACKBENCHER	B AE K B EH N CH ER
BACKBENCHERS	B AE K B EH N CH ER Z
BACKBITER	B AE K B AY T ER
BACKBITERS	B AE K B AY T ER Z
BACKBREAKER	B AE K B R EY K ER
BACKBREAKERS	B AE K B R EY K ER Z
BACKER	B AE K ER
BACKERS	B AE K ER Z
BACKGROUNDER	B AE K G R AW N D ER
BACKGROUNDERS	B AE K G R AW N D ER Z
BACKHANDER	B AE K HH AE N D ER
BACKHANDERS	B AE K HH AE N D ER Z
BACKLASHER	B AE K L AE SH ER
BACKLASHERS	B AE K L AE SH ER Z
BACKPACKER	B AE K P AE K ER
BACKPACKERS	B AE K P AE S ER Z
BACKSCATTER	B AE K S K AE T ER
BACKSCATTERED	B AE K S K AE T ER D
BACKSCATTERING	B AE K S K AE T ER IH NG
BACKSCATTERINGS	B AE K S K AE T ER IH NG Z
BACKSCATTERS	B AE K S K AE T ER Z
BACKSLAPPER	B AE K S L AE P ER
BACKSLAPPERS	B AE K S L AE P ER Z
BACKSLIDER	B AE K S L AY D ER
BACKSLIDERS	B AE K S L AY D ER Z
BACKSTABBER	B AE K S T AE B ER
BACKSTABBERS	B AE K S T AE B ER Z
BACKWATER	B AE K W AO T ER
BACKWATERS	B AE K W AO T ER Z
BACTEREMIA	B AE K T AH R IY M IY AH
BACTEREMIAS	B AE K T AH R IY M IY AH Z
BACTEREMIC	B AE K T AH R AH M AH K
BACTERIA	B AE K T IH R IY AH
BACTERIAL	B AE K T IH R IY AH L
BACTERIALLY	B AE K T IH R IY AH L IY
BACTERIAS	B AE K T IH R IY AH Z
BACTERICIDAL	B AE K T AH R IH S AH D AH L
BACTERICIDALLY	B AE K T AH R IH S AH D AE L IY
BACTERICIDE	B AE K T EH R AH S AY D
BACTERICIDES	B AE K T EH R AH S AY D Z
BACTERIN	B AE K T AH R AH N
BACTERINS	B AE K T AH R AH N Z
BACTERIOCHLOROPHYLL	B AE K T IY R IY AH K L AO R AH F AH L
BACTERIOCHLOROPHYLLS	B AE K T IY R IY AH K L AO R AH F AH L Z
BACTERIOCIN	B AE K T AH R IY AH S AH N
BACTERIOCINS	B AE K T AH R IY AH S AH N Z
BACTERIOLOGIC	B AE K T AH R IY AH L AH JH AH K
BACTERIOLOGICAL	B AE K T AH R IY AA L AH JH IH S AH L
BACTERIOLOGICALLY	B AE K T IY R IY AH L AA JH AH K AE L IY
BACTERIOLOGIES	B AE K T AH R IY AA L AH JH AY Z
BACTERIOLOGIST	B AE K T AH R IY AA L AH JH AH S T
BACTERIOLOGISTS	B AE K T IY R IY AA L AH JH AH S T S
BACTERIOLOGY	B AE K T IH R IY AA L AH JH IY
BACTERIOLYSES	B AE K T IY R IY AH L AY Z AH Z
BACTERIOLYSIS	B AE K T AH R IY AA L AH S AH S
BACTERIOLYTIC	B AE K T AH R IY AH L AH T AH K
BACTERIOPHAGE	B AE K T AH R IY AH F AH JH
BACTERIOPHAGES	B AE K T AH R IY AA F AH JH AH Z
BACTERIOPHAGIES	B AE K T AH R IY AA F AH JH AY Z
BACTERIOPHAGY	B AE K T AH R IY AA F AH JH IY
BACTERIORHODOPSIN	B AE K T AH R IY AH R AH D AA P S AH N
BACTERIORHODOPSINS	B AE K T AH R IY AH R AH D AA P S AH N Z
BACTERIOSTASES	B AE K T IY R IY AH S T EY Z AH Z
BACTERIOSTASIS	B AE K T IY R IY AA S T AH S AH S
BACTERIOSTAT	B AE K T IY R IY AA S T AH T
BACTERIOSTATIC	B AE K T IY R IY AA S T AH T AH K
BACTERIOSTATS	B AE K T IY R IY AH S T EY T S
BACTERIUM	B AE K T IH R IY AH M
BACTERIURIA	B AE K T IY R IY UH R IY AH
BACTERIURIAS	B AE K T IY R IY UH R IY AH Z
BACTERIZATION	B AE K T AH R AH Z EY SH AH N
BACTERIZATIONS	B AE K T AH R AH Z EY T IY AH N Z
BACTERIZE	B AE K T AH R AY Z
BACTERIZED	B AE K T AH R AY Z D
BACTERIZES	B AE K T AH R AY Z AH Z
BACTERIZING	B AE K T AH R AY Z AH NG
BACTEROID	B AE K T AH R OY D
BACTEROIDS	B AE K T AH R OY D Z
BADDER	B AE D ER
BADGER	B AE JH ER
BADGERED	B AE JH ER D
BADGERING	B AE JH ER IH NG
BADGERLY	B AE JH ER L IY
BADGERS	B AE JH ER Z
BAFFLER	B AE F AH L ER
BAFFLERS	B AE F AH L ER Z
BAGGER	B AE G ER
BAGGERS	B AE G ER Z
BAGGIER	B AE G IY ER
BAGPIPER	B AE G P AY P ER
BAGPIPERS	B AE G P AY P ER Z
BAILER	B EY L ER
BAILERS	B EY L ER Z
BAIRNLIER	B AE AH R N L AY AH R
BAITER	B EY T ER
BAITERS	B EY T ER Z
BAKER	B EY K ER
BAKERIES	B EY K ER IY Z
BAKERS	B EY K ER Z
BAKERY	B EY K ER IY
BALANCER	B AE L AH N S ER
BALANCERS	B AE L AH N S ER Z
BALDER	B AO L D ER
BALDERDASH	B AO L D ER D AE SH
BALDERDASHES	B AO L D ER D AE SH IH Z
BALER	B EY L ER
BALERS	B EY L ER Z
BALKER	B AO K ER
BALKERS	B AO K ER Z
BALKIER	B AO K IY ER
BALLADEER	B AE L AH D IH R
BALLADEERS	B AE L AH D IH R Z
BALLCARRIER	B AO L K AE R IY ER
BALLCARRIERS	B AO L K AE R IY ER Z
BALLER	B AO L ER
BALLERINA	B AE L ER IY N AH
BALLERINAS	B AE L ER IY N AH Z
BALLERS	B AO L ER Z
BALLOTER	B AE L AH T ER
BALLOTERS	B AE L AH T ER Z
BALLPLAYER	B AO L P L EY ER
BALLPLAYERS	B AO L P L EY ER Z
BALLSIER	B AO L Z IY ER
BALMIER	B AA M IY ER
BALUSTER	B AH L AH S T AH R
BALUSTERS	B AH L AH S T AH R Z
BANDAGER	B AE N D IH JH ER
BANDAGERS	B AE N D IH JH ER Z
BANDER	B AE N D ER
BANDERILLA	B AE N D AH R IH L AH
BANDERILLAS	B AE N D AH R IH L AH Z
BANDERILLERO	B AE N D AH R IH L AH R OW
BANDERILLEROS	B AE N D ER IH L ER AA S
BANDEROL	B AE N D AH R AH L
BANDEROLE	B AE N D IY R OW L
BANDEROLES	B AE N D IY R OW L Z
BANDEROLS	B AE N D AH R AH L Z
BANDERS	B AE N D ER Z
BANDLEADER	B AE N D L IY D ER
BANDLEADERS	B AE N D L IY D ER Z
BANDMASTER	B AE N D M AE S T ER
BANDMASTERS	B AE N D M AE S T ER Z
BANDOLEER	B AE N D AH L IH ER
BANDOLEERS	B AE N D AH L IH ER Z
BANDOLIER	B AE N D AH L IH R
BANDOLIERS	B AE N D AH L IH R Z
BANEBERRIES	B EY N B EH R IY Z
BANEBERRY	B EY N B EH R IY
BANGER	B AE NG ER
BANGERS	B AE NG ER Z
BANISHER	B AE N IH SH ER
BANISHERS	B AE N IH SH ER Z
BANISTER	B AE N IH S T ER
BANISTERED	B AE N AH S T ER D
BANISTERS	B AE N AH S T ER Z
BANKER	B AE NG K ER
BANKERLY	B AE NG K ER L IY
BANKERS	B AE NG K ER Z
BANKROLLER	B AE NG K R OW L ER
BANKROLLERS	B AE NG K R OW L ER Z
BANNER	B AE N ER
BANNERED	B AE N ER D
BANNERET	B AE N AH R AH T
BANNERETS	B AE N AH R AH T S
BANNERETTE	B AE N ER EH T
BANNERETTES	B AE N ER EH T S
BANNERING	B AE N ER IH NG
BANNEROL	B AE N AH R AH L
BANNEROLS	B AE N AH R AH L Z
BANNERS	B AE N ER Z
BANNISTER	B AE N AH S T ER
BANNISTER(2)	B AE N IH S T ER
BANNISTERS	B AE N IY S T ER Z
BANQUETER	B AE NG K W AH T ER
BANQUETERS	B AE NG K W AH T ER Z
BANTER	B AE N T ER
BANTERED	B AE N T ER D
BANTERER	B AE N T ER ER
BANTERERS	B AE N T ER ER Z
BANTERING	B AE N T ER IH NG
BANTERINGLY	B AE N T ER IH NG L IY
BANTERS	B AE N T ER Z
BAPTISTERIES	B AE P T AH S T R IY Z
BAPTISTERY	B AE P T AH S T R IY
BAPTIZER	B AE P T IH Z ER
BAPTIZERS	B AE P T IH Z ER Z
BARBECUER	B AA R B IH K Y UW ER
BARBECUERS	B AA R B IH K Y UW ER Z
BARBER	B AA R B ER
BARBERED	B AA R B ER D
BARBERING	B AA R B ER IH NG
BARBERRIES	B AA R B ER R IY Z
BARBERRY	B AA R B ER R IY
BARBERS	B AA R B ER Z
BARBERSHOP	B AA R B ER SH AA P
BARBERSHOPS	B AA R B ER SH AA P S
BARDOLATER	B AA R D OW L AH T ER
BARDOLATERS	B AA R D OW L AH T ER Z
BARER	B EH R ER
BARGAINER	B AA R G IH N ER
BARGAINERS	B AA R G IH N ER Z
BARKEEPER	B AA R K IY P ER
BARKEEPERS	B AA R K IY P ER Z
BARKER	B AA R K ER
BARKERS	B AA R K ER Z
BARKIER	B AA R K IY ER
BARMIER	B AA R M AY AH R
BARNIER	B AA R N IY ER
BARNSTORMER	B AA R N S T AO R M ER
BARNSTORMERS	B AA R N S T AO R M ER Z
BAROMETER	B ER AA M IH T ER
BAROMETERS	B ER AA M IH T ER Z
BARRACKER	B AE R AH K ER
BARRACKERS	B AE R AH K ER Z
BARRATER	B AA R AH T ER
BARRATERS	B AA R AH T ER Z
BARRENER	B AE R AH N ER
BARRIER	B AE R IY ER
BARRIER(2)	B EH R IY ER
BARRIERS	B AE R IY ER Z
BARRIERS(2)	B EH R IY ER Z
BARRISTER	B AE R IH S T ER
BARRISTER(2)	B EH R IH S T ER
BARRISTERS	B AE R IH S T ER Z
BARRISTERS(2)	B EH R IH S T ER Z
BARTENDER	B AA R T EH N D ER
BARTENDERS	B AA R T EH N D ER Z
BARTER	B AA R T ER
BARTERED	B AA R T ER D
BARTERER	B AA R T IY R AH R
BARTERERS	B AA R T AH R AH R Z
BARTERING	B AA R T ER IH NG
BARTERS	B AA R T AH R Z
BASELINER	B EY S L AY N ER
BASELINERS	B EY S L AY N ER Z
BASER	B EY S ER
BASERUNNING	B EY S R AH N IH NG
BASERUNNINGS	B EY S R AH N IH NG Z
BASHER	B AE SH ER
BASHERS	B AE SH ER Z
BASIFIER	B EY S AH F AY ER
BASIFIERS	B EY S AH F AY ER Z
BASTER	B EY S T ER
BASTERS	B EY S T ER Z
BATCHER	B AE CH ER
BATCHERS	B AE CH ER Z
BATHER	B EY DH ER
BATHER(2)	B AE DH ER
BATHERS	B EY DH ER Z
BATHERS(2)	B AE DH ER Z
BATHWATER	B AE TH W AO T ER
BATHWATERS	B AE TH W AO T ER Z
BATHYSPHERE	B EY DH IY S F IH ER
BATHYSPHERES	B EY DH IY S F IH ER Z
BATHYTHERMOGRAPH	B AE TH AH TH AH R M AA G R AH F
BATHYTHERMOGRAPHS	B AE TH AH TH AH R M AA G R AH F S
BATTENER	B AE T AH N ER
BATTENERS	B AE T AH N ER Z
BATTER	B AE T ER
BATTERED	B AE T ER D
BATTERIE	B AE T ER IY
BATTERIES	B AE T ER IY Z
BATTERING	B AE T ER IH NG
BATTERS	B AE T ER Z
BATTERY	B AE T ER IY
BATTIER	B AE T IY ER
BATTLER	B AE T AH L ER
BATTLERS	B AE T AH L ER Z
BAULKIER	B AO L K AY AH R
BAWDIER	B AO D IY ER
BAWLER	B AO L ER
BAWLERS	B AO L ER Z
BAYADEER	B EY EY D IH R
BAYADEERS	B EY EY D IH R Z
BAYADERE	B EY EY D AH R
BAYADERES	B EY AH D IY R Z
BAYBERRIES	B EY B EH R IY Z
BAYBERRY	B EY B EH R IY
BEACHCOMBER	B IY CH K OW M ER
BEACHCOMBERS	B IY CH K OW M ER Z
BEACHGOER	B IY CH G OW ER
BEACHGOERS	B IY CH G OW ER Z
BEACHIER	B IY CH IY ER
BEADIER	B IY D IY ER
BEAKER	B IY K ER
BEAKERS	B IY K ER Z
BEAKIER	B AH AE K AY AH R
BEAMIER	B IH EY M IY ER
BEANERIES	B IY N AH R IY Z
BEANERY	B IY N AH R IY
BEARBERRIES	B AE ER B EH R IY Z
BEARBERRY	B AE ER B EH R IY
BEARER	B EH R ER
BEARERS	B EH R ER Z
BEASTLIER	B IY S T L IY ER
BEATER	B IY T ER
BEATERS	B IY T ER Z
BEAUTIFIER	B AH AH T IH F AY AH R
BEAUTIFIERS	B AH AO T AH F IY R Z
BEAUTIFULER	B Y UW T IY F AH L ER
BEAVER	B IY V ER
BEAVERBOARD	B IY V ER B OW R D
BEAVERBOARDS	B IY V ER B OW R D Z
BEAVERED	B IY V ER D
BEAVERING	B IY V ER IH NG
BEAVERS	B IY V ER Z
BEBEERU	B AH B AH EH R UW
BEBEERUS	B IH B AH IY R AH S
BEBOPPER	B IY B AA P ER
BEBOPPERS	B IY B AA P ER Z
BECKONER	B EH K AH N ER
BECKONERS	B EH K AH N ER Z
BEDCHAMBER	B EH D CH EY M B ER
BEDCHAMBERS	B EH D CH EY M B ER Z
BEDCOVER	B EH D K AH V ER
BEDCOVERING	B EH D K AH V ER IH NG
BEDCOVERINGS	B EH D K AH V ER IH NG Z
BEDCOVERS	B EH D K AH V ER Z
BEDDER	B EH D ER
BEDDERS	B EH D ER Z
BEDIAPER	B IH D AY P ER
BEDIAPERED	B IH D AY P ER D
BEDIAPERING	B IH D AY P ER IH NG
BEDIAPERS	B IH D AY P ER Z
BEDMAKER	B EH D M EY K ER
BEDMAKERS	B EH D M EY K ER Z
BEDWETTER	B EH D W EH T ER
BEDWETTERS	B EH D W EH T ER Z
BEECHIER	B IY CH IY ER
BEEFEATER	B IY F IY T ER
BEEFEATERS	B IY F IY T ER Z
BEEFIER	B IY F IY ER
BEEKEEPER	B IY K IY P ER
BEEKEEPERS	B IY K IY P ER Z
BEEPER	B IY P ER
BEEPERS	B IY P ER Z
BEER	B IH R
BEERIER	B IY AH R IY ER
BEERIEST	B IY AH R IY AH S T
BEERS	B IH R Z
BEERY	B IH R IY
BEETLER	B IY T AH L ER
BEETLERS	B IY T AH L ER Z
BEEZER	B AH IY Z AH R
BEEZERS	B AH EH Z AH R Z
BEFINGER	B IH F IH NG G ER
BEFINGERED	B IH F IH NG G ER D
BEFINGERING	B IH F IH NG G ER IH NG
BEFINGERS	B IH F IH NG G ER Z
BEFLOWER	B IH F L AW ER
BEFLOWERED	B IH F L AW ER D
BEFLOWERING	B IH F L AW ER IH NG
BEFLOWERS	B IH F L AW ER Z
BEFOULER	B IH F AW L ER
BEFOULERS	B IH F AW L ER Z
BEGETTER	B IH G EH T ER
BEGETTERS	B IH G EH T ER Z
BEGINNER	B IH G IH N ER
BEGINNERS	B IH G IH N ER Z
BEGUILER	B IH G AY L ER
BEGUILERS	B IH G AY L ER Z
BEHAVER	B IH HH EY V ER
BEHAVERS	B IH HH EY V ER Z
BEHOLDER	B IY HH OW L D ER
BEHOLDERS	B IH HH OW L D ER Z
BEJABERS	B IH JH AE B ER Z
BELCHER	B EH L CH ER
BELCHERS	B EH L CH ER Z
BELEAGUER	B IH L IY G ER
BELEAGUERED	B IH L IY G ER D
BELEAGUERING	B IH L IY G ER IH NG
BELEAGUERMENT	B IH L IY G ER M AH N T
BELEAGUERMENTS	B IH L IY G ER M AH N T S
BELEAGUERS	B IH L IY G ER Z
BELIER	B EH L Y ER
BELIERS	B IH L AY ER Z
BELIEVER	B IH L IY V ER
BELIEVERS	B IH L IY V ER Z
BELITTLER	B IH L IH T AH L ER
BELITTLERS	B IH L IH T AH L ER Z
BELLFLOWER	B EH L F L AW ER
BELLFLOWERS	B EH L F L AW ER Z
BELLIGERENCE	B AH L IH JH ER AH N S
BELLIGERENCES	B AH L IH JH ER AH N S IH Z
BELLIGERENCIES	B AH L IH JH ER AH N S IY Z
BELLIGERENCY	B AH L IH JH ER AH N S IY
BELLIGERENT	B AH L IH JH ER AH N T
BELLIGERENTLY	B AH L IH JH ER AH N T L IY
BELLIGERENTS	B AH L IH JH ER AH N T S
BELLOWER	B EH L OW ER
BELLOWERS	B EH L OW ER Z
BELLWETHER	B EH L W EH DH ER
BELLWETHERS	B EH L W EH DH ER Z
BELLYACHER	B EH L IY EY K ER
BELLYACHERS	B EH L IY EY K ER Z
BELTER	B EH L T ER
BELTERS	B EH L T ER Z
BELVEDERE	B EH L V AH D IH R
BELVEDERE(2)	B EH L V IH D IH R
BELVEDERES	B EH L V AH D IH ER Z
BENCHER	B EH N CH ER
BENCHERS	B EH N CH ER Z
BENCHWARMER	B EH N CH W AO R M ER
BENCHWARMERS	B EH N CH W AO R M ER Z
BENDER	B EH N D ER
BENDERS	B EH N D ER Z
BENEFITER	B EH N AH F IH T ER
BENEFITERS	B EH N AH F IH T ER Z
BERAKE	B IH R EY K
BERAKED	B IH R EY K T
BERAKES	B IH R EY K S
BERAKING	B IH R EY K IH NG
BERASCAL	B IH R AE S K AH L
BERASCALED	B IH R AE S K AH L D
BERASCALING	B IH R AE S K AH L IH NG
BERASCALS	B IH R AE S K AH L Z
BERATE	B IH R EY T
BERATED	B IH R EY T IH D
BERATES	B IH R EY T S
BERATING	B IH R EY T IH NG
BERBERIN	B IY ER B IY ER IH N
BERBERINE	B IH R B AH R AY N
BERBERINES	B IH R B AH R AY N Z
BERBERINS	B IY ER B IY ER IH N Z
BERBERIS	B IY ER B IY AH R IY Z
BERBERISES	B IY ER B IH R AY Z IH Z
BERCEUSE	B IH R S UW Z
BERCEUSES	B IH R S UW Z AH Z
BERDACHE	B IH R D AE CH
BERDACHES	B IH R D AE CH AH Z
BEREAVE	B ER IY V
BEREAVED	B ER IY V D
BEREAVEMENT	B ER IY V M AH N T
BEREAVEMENTS	B IH R IY V M AH N T S
BEREAVER	B IH R IY V ER
BEREAVERS	B IH R IY V ER Z
BEREAVES	B IH R IY V Z
BEREAVING	B IH R IY V IH NG
BEREFT	B ER EH F T
BERET	B EH R AH T
BERET(2)	B EH R EY T
BERETS	B EH R AH T S
BERETS(2)	B EH R EY Z
BERETTA	B ER EH T AH
BERETTAS	B ER EH T AH S
BERG	B ER G
BERGAMOT	B IH R G AE M AH T
BERGAMOTS	B IH R G AE M AH T S
BERGERE	B IH R JH IH R
BERGERES	B IH R JH IY R Z
BERGS	B ER G Z
BERHYME	B IH R AY M
BERHYMED	B IH R AY M D
BERHYMES	B IH R AY M Z
BERHYMING	B IH R AY M IH NG
BERIBBONED	B IH R IH B AH N D
BERIBERI	B EH R IY B EH R IY
BERIBERIS	B EH R IY B EH R IY Z
BERIME	B IH R AY M
BERIMED	B IH R AY M D
BERIMES	B IH R AY M Z
BERIMING	B IH R AY M IH NG
BERINGED	B IH R IH NG D
BERKELIUM	B IH R K IY L IY AH M
BERKELIUMS	B IH R K IY L IY AH M Z
BERLIN	B ER L IH N
BERLINE	B IY ER L AY N
BERLINES	B IY ER L AY N Z
BERLINS	B ER L IH N Z
BERM	B ER M
BERME	B IH R M IY
BERMES	B AH R M Z
BERMS	B ER M Z
BERMUDAS	B ER M Y UW D AH Z
BERNICLE	B IH R N IH K AH L
BERNICLES	B IH R N IH K AH L Z
BEROBED	B IH R OW B D
BEROUGED	B IH R UW ZH D
BERRETTA	B IH R EH T AH
BERRETTAS	B IH R EH T AH Z
BERRIED	B EH R IY D
BERRIES	B EH R IY Z
BERRY	B EH R IY
BERRYING	B EH R IY IH NG
BERRYLIKE	B EH R IY L AY K
BERSEEM	B IY ER S IY M
BERSEEMS	B IY ER S IY M Z
BERSERK	B ER S ER K
BERSERKER	B IH R S AH R K AH R
BERSERKERS	B IH R S AH R K AH R Z
BERSERKLY	B IH R S AH R K L IY
BERSERKS	B IH R S AH R K S
BERTH	B ER TH
BERTHA	B ER TH AH
BERTHAS	B ER TH AH Z
BERTHED	B ER TH T
BERTHING	B ER TH IH NG
BERTHS	B ER TH S
BERTHS(2)	B ER DH Z
BERYL	B EH R AH L
BERYLINE	B IY AH R IY L AY N
BERYLLIUM	B ER IH L IY AH M
BERYLLIUMS	B AH R IH L IY AH M Z
BERYLS	B EH R AH L Z
BESETTER	B IH S EH T ER
BESETTERS	B IH S EH T ER Z
BESHIVER	B IH SH IH V ER
BESHIVERED	B IH SH IH V ER D
BESHIVERING	B IH SH IH V ER IH NG
BESHIVERS	B IH SH IH V ER Z
BESIEGER	B IH S IY JH ER
BESIEGERS	B IH S IY JH ER Z
BESPATTER	B IH S P AE T ER
BESPATTERED	B IH S P AE T ER D
BESPATTERING	B IH S P AE T ER IH NG
BESPATTERS	B IH S P AE T ER Z
BESTSELLER	B EH S T S EH L ER
BESTSELLER(2)	B EH S EH L ER
BESTSELLERDOM	B EH S T S EH L ER D AH M
BESTSELLERDOMS	B EH S T S EH L ER D AH M Z
BESTSELLERS	B EH S T S EH L ER Z
BESTSELLERS(2)	B EH S EH L ER Z
BETATTER	B IH T AE T ER
BETATTERED	B IH T AE T ER D
BETATTERING	B IH T AE T ER IH NG
BETATTERS	B IH T AE T ER Z
BETRAYER	B IH T R EY ER
BETRAYERS	B IH T R EY ER Z
BETTER	B EH T ER
BETTERED	B EH T ER D
BETTERING	B EH T ER IH NG
BETTERMENT	B EH T ER M AH N T
BETTERMENTS	B EH T ER M AH N T S
BETTERS	B EH T ER Z
BEVELER	B EH V AH L ER
BEVELERS	B EH V AH L ER Z
BEVELLER	B EH V AH L ER
BEVELLERS	B EH V AH L ER Z
BEVERAGE	B EH V ER IH JH
BEVERAGE(2)	B EH V R IH JH
BEVERAGES	B EH V R IH JH IH Z
BEWAILER	B IH W EY L ER
BEWAILERS	B IH W EY L ER Z
BEWHISKERED	B IH W IH S K ER D
BEWILDER	B IH W IH L D ER
BEWILDERED	B IH W IH L D ER D
BEWILDEREDLY	B IH W IH L D ER AH D L IY
BEWILDEREDNESS	B IH W IH L D ER AH D N AH S
BEWILDEREDNESSES	B IH W IH L D ER AH D N AH S IH Z
BEWILDERING	B IH W IH L D ER IH NG
BEWILDERINGLY	B IH W IH L D ER IH NG L IY
BEWILDERMENT	B IH W IH L D ER M AH N T
BEWILDERMENTS	B IH W IH L D ER M AH N T S
BEWILDERS	B IH W IH L D ER Z
BEWITCHERIES	B IH W IH CH AH R IY Z
BEWITCHERY	B IH W IH CH AH R IY
BEWRAYER	B AH R EY AH R
BEWRAYERS	B AH R EY AH R Z
BIBBER	B IH B ER
BIBBERIES	B IH B AH R IY Z
BIBBERS	B IH B ER Z
BIBBERY	B IH B AH R IY
BIBLIOGRAPHER	B AY B L AY AA G R AH F AH R
BIBLIOGRAPHERS	B AY B L AY AA G R AH F AH R Z
BIBLIOLATER	B AY B L AY AH L EY T AH R
BIBLIOLATERS	B AY B L AY AA L AH T AH R Z
BIBLIOTHERAPIES	B AY B L AY AH TH EH R AH P AY Z
BIBLIOTHERAPY	B AY B L AY AH TH EH R AH P IY
BICAMERAL	B AY K AE M AH R AH L
BICAMERALISM	B AY K AE M AH R AH L IH Z AH M
BICAMERALISMS	B AY K AE M AH R AH L IH Z AH M Z
BICKER	B IH K ER
BICKERED	B IH K ER D
BICKERER	B IH K ER ER
BICKERERS	B IH K ER ER Z
BICKERING	B IH K ER IH NG
BICKERS	B IH K ER Z
BICYCLER	B AY S IH K AH L ER
BICYCLERS	B AY S IH K AH L ER Z
BIDDER	B IH D ER
BIDDERS	B IH D ER Z
BIDER	B AY D ER
BIDERS	B AY D ER Z
BIER	B IY R
BIERS	B IY R Z
BIGENERIC	B AY JH EH N ER IH K
BIGGER	B IH G ER
BIJOUTERIE	B IH ZH UW T AH R IY
BIJOUTERIES	B IH ZH UW T AH R IY Z
BIKER	B AY K ER
BIKERS	B AY K ER Z
BILANDER	B AY L AE N D ER
BILANDERS	B AY L AE N D ER Z
BILATERAL	B AY L AE T ER AH L
BILATERALISM	B AY L AE T AH R AH L IH Z AH M
BILATERALISMS	B AY L AE T AH R AH L IH Z AH M Z
BILATERALLY	B AY L AE T ER AH L IY
BILAYER	B AY L EY ER
BILAYERS	B AY L EY ER Z
BILBERRIES	B AY L B EH R AY Z
BILBERRY	B AY L B EH R IY
BILGEWATER	B IH L JH W AO T ER
BILGEWATERS	B IH L JH W AO T ER Z
BILGIER	B IH L JH IY ER
BILIVERDIN	B AY L IH V ER D IH N
BILIVERDINS	B AY L IH V ER D IH N Z
BILKER	B IH L K ER
BILKERS	B IH L K ER Z
BILLER	B IH L ER
BILLERS	B IH L ER Z
BILLETER	B IH L IY T ER
BILLETERS	B IH L AH T ER Z
BILLOWIER	B IH L OW IY ER
BIMESTER	B AY M EH S T AH R
BIMESTERS	B AY M EH S T AH R Z
BINDER	B AY N D ER
BINDERIES	B AY N D AH R IY Z
BINDERS	B AY N D ER Z
BINDERY	B AY N D AH R IY
BINGER	B IH NG JH ER
BINGER(2)	B IH NG G ER
BINGERS	B IH N JH ER Z
BIOCONVERSION	B AY AH K AA N V EH R Z IY AH N
BIOCONVERSIONS	B AY AA K AH N V AH R S IY AH N Z
BIODETERIORATION	B AY AA D AH T IY R IY AH R EY SH AH N
BIODETERIORATIONS	B AY AH D AH T IY R IY AH R EY T IY AH N Z
BIODIVERSITIES	B AY AA D AH V AH R S AH T AY Z
BIODIVERSITY	B AY OW D AY V ER S AH T IY
BIOENERGETIC	B AY OW AH N AH R JH AH T AH K
BIOENERGETICS	B AY OW AH N AH R JH AH T AH S Z
BIOENGINEER	B AY OW EH N JH AH N IH R
BIOENGINEERED	B AY OW EH N JH AH N IH R D
BIOENGINEERING	B AY OW EH N JH AH N IH R IH NG
BIOENGINEERINGS	B AY OW AH N JH IH N AH R AH NG Z
BIOENGINEERS	B AY OW EH N JH AH N AH R Z
BIOGEOGRAPHER	B AY OW JH IY AA G R AH F AH R
BIOGEOGRAPHERS	B AY OW JH IY AA G R AH F AH R Z
BIOGRAPHER	B AY AA G R AH F ER
BIOGRAPHERS	B AY AA G R AH F ER Z
BIOHERM	B AY AA HH AH R M
BIOHERMS	B AY AA HH AH R M Z
BIOMARKER	B AY AH M AA R K AH R
BIOMARKERS	B AY AH M AA R K AH R Z
BIOMATERIAL	B AY OW M AH T IH R IY AH L
BIOMATERIALS	B AY OW M AH T IH R IY AH L Z
BIOPOLYMER	B AY AA P AH L AY M AH R
BIOPOLYMERS	B AY AH P AA L AH M AH R Z
BIOSPHERE	B AY OW S F IH R
BIOSPHERES	B AY OW S F IH R Z
BIOSPHERIC	B AY AA S AH R AH K
BIRDER	B ER D ER
BIRDERS	B ER D ER Z
BIRDWATCHER	B ER D W AA CH ER
BIRDWATCHERS	B ER D W AA CH ER Z
BIRLER	B AH R L AH R
BIRLERS	B AY R L EH R Z
BISTER	B AY S T ER
BISTERED	B AY S T ER D
BISTERS	B AY S T ER Z
BITCHERIES	B IH CH AH R IY Z
BITCHERY	B IH CH AH R IY
BITCHIER	B IH CH IY ER
BITER	B AY T ER
BITERS	B AY T ER Z
BITTER	B IH T ER
BITTERBRUSH	B IH T ER B R AH SH
BITTERBRUSHES	B IH T ER B R AH SH IH Z
BITTERED	B IH T ER D
BITTERER	B IH T ER ER
BITTEREST	B IH T ER AH S T
BITTERING	B IH T ER IH NG
BITTERISH	B IH T ER IH SH
BITTERLY	B IH T ER L IY
BITTERN	B AY T AH R N
BITTERNESS	B IH T ER N AH S
BITTERNESSES	B IH T ER N AH S IH Z
BITTERNS	B AY T AH R N Z
BITTERROOT	B IH T ER R UW T
BITTERROOTS	B IH T ER R UW T S
BITTERS	B IH T ER Z
BITTERSWEET	B IH T ER S W IY T
BITTERSWEETLY	B IH T ER S W IY T L IY
BITTERSWEETNESS	B IH T ER S W IY T N AH S
BITTERSWEETNESSES	B IH T ER S W IY T N AH S IH Z
BITTERSWEETS	B IH T ER S W IY T S
BITTERWEED	B IH T ER W IY D
BITTERWEEDS	B IH T ER W IY D Z
BITTIER	B IH T IY ER
BIZARRERIE	B AH Z AA R ER IY
BIZARRERIES	B AH Z AA R AH R IY Z
BLABBER	B L AE B ER
BLABBERED	B L AE B ER D
BLABBERING	B L AE B ER IH NG
BLABBERMOUTH	B L AE B ER M AW TH
BLABBERMOUTHS	B L AE B ER M AW TH S
BLABBERS	B L AE B ER Z
BLACKBERRIES	B L AE K B EH R IY Z
BLACKBERRY	B L AE K B EH R IY
BLACKBIRDER	B L AE K B ER D ER
BLACKBIRDERS	B L AE K B ER D ER Z
BLACKENER	B L AE K AH N ER
BLACKENERS	B L AE K AH N ER Z
BLACKER	B L AE K ER
BLACKHANDER	B L AE K HH AE N D ER
BLACKHANDERS	B L AE K HH AE N D ER Z
BLACKLISTER	B L AE K L IY S T ER
BLACKLISTERS	B L AE K L IY S T ER Z
BLACKMAILER	B L AE K M EY L ER
BLACKMAILERS	B L AE K M EY L ER Z
BLACKWATER	B L AE K W AO T ER
BLACKWATERS	B L AE K W AO T ER Z
BLADDER	B L AE D ER
BLADDERLIKE	B L AE D ER L AY K
BLADDERNUT	B L AE D ER N AH T
BLADDERNUTS	B L AE D ER N AH T S
BLADDERS	B L AE D ER Z
BLADDERWORT	B L AE D AH R W AH R T
BLADDERWORTS	B L AE D AH R W AH R T S
BLADDERY	B L AE D ER IY
BLAEBERRIES	B L IY B EH R AY Z
BLAEBERRY	B L IY B EH R IY
BLAMER	B L EY M ER
BLAMERS	B L EY M ER Z
BLANCHER	B L AE N CH ER
BLANCHERS	B L AE N CH ER Z
BLANDER	B L AE N D ER
BLANDISHER	B L AE N D IH SH ER
BLANDISHERS	B L AE N D IH SH ER Z
BLANKER	B L AE NG K ER
BLANKETFLOWER	B L AE NG K AH T F L AW ER
BLANKETFLOWERS	B L AE NG K AH T F L AW ER Z
BLASPHEMER	B L AE S F IY M ER
BLASPHEMERS	B L AE S F IY M ER Z
BLASTER	B L AE S T ER
BLASTERS	B L AE S T ER Z
BLASTIER	B L AE S T IY ER
BLASTODERM	B L AE S T AH D ER M
BLASTODERMS	B L AE S T AH D AH R M Z
BLASTOMERE	B L AE S T OW M AH R
BLASTOMERES	B L AE S T AH M IY R Z
BLATHER	B L AE DH ER
BLATHERED	B L AH TH IY R D
BLATHERER	B L AH TH IY R AH R
BLATHERERS	B L AE TH AH R AH R Z
BLATHERING	B L AH TH IY R AH NG
BLATHERS	B L AE TH AH R Z
BLATHERSKITE	B L AE TH AH R S AY T
BLATHERSKITES	B L AE TH AH R S AY T S
BLATTER	B L AE T ER
BLATTERED	B L EY T ER D
BLATTERING	B L EY T ER IH NG
BLATTERS	B L EY T ER Z
BLAZER	B L EY Z ER
BLAZERS	B L EY Z ER Z
BLAZONER	B L EY Z AH N ER
BLAZONERS	B L EY Z AH N ER Z
BLEACHER	B L IY CH ER
BLEACHERITE	B L IY CH AH R AY T
BLEACHERITES	B L IY CH AH R AY T S
BLEACHERS	B L IY CH ER Z
BLEAKER	B L IY K ER
BLEARIER	B L IH ER IY ER
BLEATER	B L IY T ER
BLEATERS	B L IY T ER Z
BLEEDER	B L IY D ER
BLEEDERS	B L IY D ER Z
BLENCHER	B L EH N CH AH R
BLENCHERS	B L EH NG K AH R Z
BLENDER	B L EH N D ER
BLENDERS	B L EH N D ER Z
BLESSEDER	B L EH S T ER
BLESSER	B L EH S ER
BLESSERS	B L EH S ER Z
BLETHER	B L EH DH AH R
BLETHERED	B L AH TH IY R D
BLETHERING	B L AH TH IY R AH NG
BLETHERS	B L EH TH AH R Z
BLIGHTER	B L AY T ER
BLIGHTERS	B L AY T ER Z
BLINDER	B L AY N D ER
BLINDERS	B L AY N D ER Z
BLINKER	B L IH NG K ER
BLINKERED	B L IH NG K ER D
BLINKERING	B L IH NG K ER IH NG
BLINKERS	B L IH NG K ER Z
BLISTER	B L IH S T ER
BLISTERED	B L IH S T ER D
BLISTERING	B L IH S T ER IH NG
BLISTERINGLY	B L IH S T ER IH NG L IY
BLISTERS	B L IH S T ER Z
BLISTERY	B L IH S T ER IY
BLITHER	B L AY TH ER
BLITHERED	B L AY TH ER D
BLITHERING	B L AY TH ER IH NG
BLITHERS	B L AY TH ER Z
BLOATER	B L OW T ER
BLOATERS	B L OW T ER Z
BLOCKADER	B L AA K EY D ER
BLOCKADERS	B L AA K EY D ER Z
BLOCKBUSTER	B L AA K B AH S T ER
BLOCKBUSTERS	B L AA K B AH S T ER Z
BLOCKER	B L AA K ER
BLOCKERS	B L AA K ER Z
BLOCKIER	B L AA K IY ER
BLONDER	B L AA N D ER
BLOODIER	B L AH D IY ER
BLOODSUCKER	B L AH D S AH K ER
BLOODSUCKERS	B L AH D S AH K ER Z
BLOOMER	B L UW M ER
BLOOMERIES	B L UW M AH R IY Z
BLOOMERS	B L UW M ER Z
BLOOMERY	B L UW M AH R IY
BLOOMIER	B L UW M IY ER
BLOOPER	B L UW P ER
BLOOPERS	B L UW P ER Z
BLOTCHIER	B L AA T CH IY ER
BLOTTER	B L AA T ER
BLOTTERS	B L AA T ER Z
BLOTTIER	B L AA T IY ER
BLOUSIER	B L AW S IY ER
BLOWER	B L OW ER
BLOWERS	B L OW ER Z
BLOWIER	B L OW IY ER
BLOWSIER	B L OW Z IY ER
BLOWZIER	B L OW Z AY AH R
BLUBBER	B L AH B ER
BLUBBERED	B L AH B ER D
BLUBBERING	B L AH B ER IH NG
BLUBBERS	B L AH B ER Z
BLUBBERY	B L AH B ER IY
BLUCHER	B L AH CH AH R
BLUCHERS	B L AH CH AH R Z
BLUDGER	B L AH JH AH R
BLUDGERS	B L AH JH AH R Z
BLUEBERRIES	B L UW B EH R IY Z
BLUEBERRY	B L UW B EH R IY
BLUER	B L UW ER
BLUESIER	B L UW Z IY ER
BLUFFER	B L AH F ER
BLUFFERS	B L AH F ER Z
BLUNDER	B L AH N D ER
BLUNDERBUSS	B L AH N D ER B AH S
BLUNDERBUSSES	B L AH N D ER B AH S IH Z
BLUNDERED	B L AH N D ER D
BLUNDERER	B L AH N D ER ER
BLUNDERERS	B L AH N D ER ER Z
BLUNDERING	B L AH N D ER IH NG
BLUNDERINGLY	B L AH N D ER IH NG L IY
BLUNDERS	B L AH N D ER Z
BLUNGER	B L AH NG AH R
BLUNGERS	B L AH N JH AH R Z
BLUNTER	B L AH N T ER
BLURRIER	B L ER IY ER
BLURTER	B L ER T ER
BLURTERS	B L ER T ER Z
BLUSHER	B L AH SH ER
BLUSHERS	B L AH SH ER Z
BLUSTER	B L AH S T ER
BLUSTERED	B L AH S T ER D
BLUSTERER	B L AH S T ER ER
BLUSTERERS	B L AH S T ER ER Z
BLUSTERING	B L AH S T ER IH NG
BLUSTERINGLY	B L AH S T ER IH NG L IY
BLUSTEROUS	B L AH S T ER AH S
BLUSTERS	B L AH S T ER Z
BLUSTERY	B L AH S T ER IY
BOARDER	B AO R D ER
BOARDERS	B AO R D ER Z
BOASTER	B OW AH S T ER
BOASTERS	B OW AH S T ER Z
BOATBUILDER	B OW T B IH L D ER
BOATBUILDERS	B OW T B IH L D ER Z
BOATER	B OW T ER
BOATERS	B OW T ER Z
BOBBER	B AA B ER
BOBBERIES	B AA B AH R IY Z
BOBBERS	B AA B ER Z
BOBBERY	B AA B AH R IY
BOBSLEDDER	B AA B S L EH D ER
BOBSLEDDERS	B AA B S L EH D ER Z
BODYBUILDER	B AA D IY B IH L D ER
BODYBUILDERS	B AA D IY B IH L D ER Z
BODYSURFER	B AA D IY S ER F ER
BODYSURFERS	B AA D IY S ER F ER Z
BOGGIER	B AO G IY ER
BOGGLER	B AA G AH L ER
BOGGLERS	B AA G AH L ER Z
BOILER	B OY L ER
BOILERMAKER	B OY L ER M EY K ER
BOILERMAKERS	B OY L ER M EY K ER Z
BOILERPLATE	B OY L ER P L EY T
BOILERPLATES	B OY L ER P L EY T S
BOILERS	B OY L ER Z
BOILERSUIT	B OY L ER S UW T
BOILERSUITS	B OY L ER S UW T S
BOISERIE	B OY Z ER IY
BOISERIES	B OY Z AH R IY Z
BOISTEROUS	B OY S T ER AH S
BOISTEROUS(2)	B OY S T R AH S
BOISTEROUSLY	B OY S T AH R AH S L IY
BOISTEROUSNESS	B OY S T AH R AH S N AH S
BOISTEROUSNESSES	B OY S T AH R AH S N AH S IH Z
BOLDER	B OW L D ER
BOLERO	B OW L EH R OW
BOLEROS	B AA L AH R AH Z
BOLOMETER	B OW L OW M IY T ER
BOLOMETERS	B OW L OW M IY T ER Z
BOLSTER	B OW L S T ER
BOLSTERED	B OW L S T ER D
BOLSTERER	B OW L S T ER ER
BOLSTERERS	B OW L S T ER ER Z
BOLSTERING	B OW L S T ER IH NG
BOLSTERS	B OW L S T ER Z
BOLTER	B OW L T ER
BOLTERS	B OW L T ER Z
BOMBARDIER	B AA M B ER D IH R
BOMBARDIERS	B AA M B ER D IH R Z
BOMBER	B AA M ER
BOMBERS	B AA M ER Z
BONDER	B AA N D ER
BONDERS	B AA N D ER Z
BONDHOLDER	B AA N D HH OW L D ER
BONDHOLDERS	B AA N D HH OW L D ER Z
BONER	B OW N ER
BONERS	B OW N ER Z
BONESETTER	B OW N S EH T ER
BONESETTERS	B OW N S EH T ER Z
BONIER	B AA N Y ER
BONKERS	B AA NG K ER Z
BONNIER	B AA N IY ER
BONNYCLABBER	B AA N IH K L AE B AH R
BONNYCLABBERS	B AA N AH K L AE B AH R Z
BONZER	B AA N Z ER
BOODLER	B UW D L AH R
BOODLERS	B UW D L AH R Z
BOOGER	B UW JH AH R
BOOGERMAN	B UW JH ER M AH N
BOOGERMEN	B UW JH ER M AH N
BOOGERS	B UW JH AH R Z
BOOKBINDER	B UH K B AY N D ER
BOOKBINDERIES	B UH K B AY N D AH R IY Z
BOOKBINDERS	B UH K B AY N D ER Z
BOOKBINDERY	B UH K B AY N D AH R IY
BOOKER	B UH K ER
BOOKERS	B UH K ER Z
BOOKKEEPER	B UH K K IY P ER
BOOKKEEPERS	B UH K K IY P ER Z
BOOKMAKER	B UH K M EY K ER
BOOKMAKERS	B UH K M EY K ER Z
BOOKMARKER	B UH K M AA R K ER
BOOKMARKERS	B UH K M AA R K ER Z
BOOKSELLER	B UH K S EH L ER
BOOKSELLERS	B UH K S EH L ER Z
BOOMER	B UW M ER
BOOMERANG	B UW M ER AE NG
BOOMERANGED	B UW M ER AE NG D
BOOMERANGING	B UW M AH R AE NG IH NG
BOOMERANGS	B UW M AH R AE NG Z
BOOMERS	B UW M ER Z
BOOMIER	B UW M IY ER
BOONDOGGLER	B UW N D AA G L AH R
BOONDOGGLERS	B UW N D AA G L AH R Z
BOOSTER	B UW S T ER
BOOSTERISM	B UW S T ER IH Z AH M
BOOSTERISMS	B UW S T ER IH Z AH M Z
BOOSTERS	B UW S T ER Z
BOOTERIES	B UW T AH R IY Z
BOOTERY	B UW T AH R IY
BOOTLEGGER	B UW T L EH G ER
BOOTLEGGERS	B UW T L EH G ER Z
BOOTLICKER	B UW T L IH K ER
BOOTLICKERS	B UW T L IH K ER Z
BOOZER	B UW Z ER
BOOZERS	B UW Z ER Z
BOOZIER	B UW Z IY ER
BOPPER	B AA P ER
BOPPERS	B AA P ER Z
BORDER	B AO R D ER
BORDEREAU	B AO R D IY R IY UW
BORDEREAUX	B AO R D IY R IY AH K S
BORDERED	B AO R D ER D
BORDERER	B AO R D ER ER
BORDERERS	B AO R D ER ER Z
BORDERING	B AO R D ER IH NG
BORDERLAND	B AO R D ER L AE N D
BORDERLANDS	B AO R D ER L AE N D Z
BORDERLINE	B AO R D ER L AY N
BORDERLINES	B AO R D ER L AY N Z
BORDERS	B AO R D ER Z
BORER	B AO R ER
BORERS	B AO R ER Z
BORROWER	B AA R OW ER
BORROWERS	B AA R OW ER Z
BOSKER	B AA S AH R
BOSKIER	B AA S AY AH R
BOSSIER	B AO S IY ER
BOTCHER	B AA CH AH R
BOTCHERIES	B AA CH AH R AY Z
BOTCHERS	B AA CH AH R Z
BOTCHERY	B AH CH EH R IY
BOTCHIER	B AA CH AY AH R
BOTHER	B AA DH ER
BOTHERATION	B AA DH ER EY SH AH N
BOTHERATIONS	B AA DH ER EY SH AH N Z
BOTHERED	B AA DH ER D
BOTHERING	B AA DH ER IH NG
BOTHERS	B AA DH ER Z
BOTHERSOME	B AA DH ER S AH M
BOTTLER	B AA T L ER
BOTTLERS	B AA T L ER Z
BOTTOMER	B AA T AH M ER
BOTTOMERS	B AA T AH M ER Z
BOULDER	B OW L D ER
BOULDERED	B OW L D ER D
BOULDERS	B OW L D ER Z
BOULDERY	B OW L D ER IY
BOULEVARDIER	B UH L AH V AA R D IY ER
BOULEVARDIERS	B UH L AH V AA R D IY ER Z
BOULEVERSEMENT	B AW L AH V AH R S M AH N T
BOULEVERSEMENTS	B AW L AH V AH R S AH M AH N T S
BOUNCER	B AW N S ER
BOUNCERS	B AW N S ER Z
BOUNCIER	B AW N S IY ER
BOUNDER	B AW N D ER
BOUNDERISH	B AW N D ER IH SH
BOUNDERS	B AW N D ER Z
BOUTONNIERE	B AW T AH N IY R
BOUTONNIERES	B AW T AH N IY R Z
BOUVIER	B UW V IY EY
BOUVIERS	B AW V IY R Z
BOWDLERISE	B OW D L AH R AY Z
BOWDLERISED	B OW D L AH R AH S T
BOWDLERISES	B OW D L AH R AY Z AH Z
BOWDLERISING	B OW D L AH R AY Z AH NG
BOWDLERIZATION	B OW D L AH R AH Z EY SH AH N
BOWDLERIZATIONS	B OW D L AH R AH Z EY T IY AH N Z
BOWDLERIZE	B OW D L AH R AY Z
BOWDLERIZED	B OW D L AH R AY Z D
BOWDLERIZER	B OW D L AH R AY Z AH R
BOWDLERIZERS	B OW D L EH R AH Z AH R Z
BOWDLERIZES	B OW D L AH R AY Z AH Z
BOWDLERIZING	B OW D L AH R AY Z AH NG
BOWER	B AW ER
BOWERBIRD	B AW ER B ER D
BOWERBIRDS	B AW ER B ER D Z
BOWERED	B AW ER D
BOWERIES	B AW AH R IY Z
BOWERING	B AW ER IH NG
BOWERS	B AW ER Z
BOWERY	B AW ER IY
BOWLDER	B OW L D AH R
BOWLDERS	B OW L D AH R Z
BOWLER	B OW L ER
BOWLERS	B OW L ER Z
BOWYER	B OW Y ER
BOWYERS	B AW IY ER Z
BOXBERRIES	B AA K S B EH R IY Z
BOXBERRY	B AA K S B EH R IY
BOXER	B AA K S ER
BOXERS	B AA K S ER Z
BOXIER	B AA K S IY ER
BOYCOTTER	B OY K AA T ER
BOYCOTTERS	B OY K AA T ER Z
BOYSENBERRIES	B OY S EH N B EH R IY Z
BOYSENBERRY	B OY S EH N B EH R IY
BRABBLER	B R AE B L AH R
BRABBLERS	B R AE B L AH R Z
BRACER	B R EY S ER
BRACERO	B R AA CH EH R OW
BRACEROS	B R EY S ER AA S
BRACERS	B R EY S ER Z
BRACHYPTEROUS	B R AH CH IH P T AH R AH S
BRAGGER	B R AE G ER
BRAGGERS	B R AE G ER Z
BRAGGIER	B R AE G IY ER
BRAIDER	B R EY D ER
BRAIDERS	B R EY D ER Z
BRAILLEWRITER	B R EY L R AY T ER
BRAILLEWRITERS	B R EY L R AY T ER Z
BRAINIER	B R EY N IY ER
BRAINPOWER	B R EY N P AW ER
BRAINPOWERS	B R EY N P AW ER Z
BRAINSTORMER	B R EY N S T AO R M ER
BRAINSTORMERS	B R EY N S T AO R M ER Z
BRAINTEASER	B R EY N T IY Z ER
BRAINTEASERS	B R EY N T IY Z ER Z
BRAINWASHER	B R EY N W AA SH ER
BRAINWASHERS	B R EY N W AA SH ER Z
BRAKIER	B R EY K IY ER
BRAMBLIER	B R AE M B AH L IY ER
BRANCHIER	B R AE N CH IY ER
BRANDER	B R AE N D ER
BRANDERS	B R AE N D ER Z
BRANNER	B R AE N ER
BRANNERS	B R AE N ER Z
BRANNIER	B R AE N IY ER
BRASHER	B R AE SH ER
BRASHIER	B R AE SH IY ER
BRASIER	B R AE S AY AH R
BRASIERS	B R EY S IY R Z
BRASSERIE	B R AE S AH R IY
BRASSERIES	B R AE S AH R IY Z
BRASSIER	B R AE S IY ER
BRASSIERE	B R AH Z IH ER
BRASSIERES	B R AH Z IH ER Z
BRATTIER	B R AE T AY AH R
BRAUNSCHWEIGER	B R AO N S W EY JH AH R
BRAUNSCHWEIGERS	B R AO N S W EY JH AH R Z
BRAVER	B R EY V ER
BRAVERIES	B R EY V AH R IY Z
BRAVERS	B R EY V ER Z
BRAVERY	B R EY V ER IY
BRAWER	B R AO ER
BRAWLER	B R AO L ER
BRAWLERS	B R AO L ER Z
BRAWLIER	B R AO L IY ER
BRAWNIER	B R AO N AY AH R
BRAYER	B R EY ER
BRAYERS	B R EY ER Z
BRAZER	B R EY Z AH R
BRAZERS	B R AE Z AH R Z
BRAZIER	B R EY Z IY ER
BRAZIERS	B R EY ZH ER Z
BREACHER	B R IY CH ER
BREACHERS	B R IY CH ER Z
BREADWINNER	B R EH D W IH N ER
BREADWINNERS	B R EH D W IH N ER Z
BREAKER	B R EY K ER
BREAKERS	B R EY K ER Z
BREAKFASTER	B R EH K F AH S T ER
BREAKFASTERS	B R EH K F AH S T ER Z
BREAKWATER	B R EY K W AO T ER
BREAKWATERS	B R EY K W AO T ER Z
BREASTSTROKER	B R EH S T S T R OW K ER
BREASTSTROKERS	B R EH S T S T R OW K ER Z
BREATHER	B R IY DH ER
BREATHERS	B R IY DH ER Z
BREATHIER	B R EH TH IY ER
BREECHLOADER	B R IY CH L OW D ER
BREECHLOADERS	B R IY CH L OW D ER Z
BREEDER	B R IY D ER
BREEDERS	B R IY D ER Z
BREEZIER	B R IY Z IY ER
BREVIER	B R EH V IY ER
BREVIERS	B R EH V IY ER Z
BREWER	B R UW ER
BREWERIES	B R UW ER IY Z
BREWERIES(2)	B R UW R IY Z
BREWERS	B R UW ER Z
BREWERY	B R UW ER IY
BRIBER	B R AY B ER
BRIBERIES	B R AY B AH R IY Z
BRIBERS	B R AY B ER Z
BRIBERY	B R AY B ER IY
BRICKIER	B R IH K IY ER
BRICKLAYER	B R IH K L EY ER
BRICKLAYERS	B R IH K L EY ER Z
BRIDLER	B R AY D AH L ER
BRIDLERS	B R AY D AH L ER Z
BRIEFER	B R IY F ER
BRIEFERS	B R IY F ER Z
BRIER	B R AY ER
BRIERS	B R IY R Z
BRIERY	B R AY AH R IY
BRIGADIER	B R IH G AH D IH R
BRIGADIERS	B R IH G AH D IH ER Z
BRIGHTENER	B R AY T AH N ER
BRIGHTENERS	B R AY T AH N ER Z
BRIGHTER	B R AY T ER
BRIMMER	B R IH M ER
BRIMMERS	B R IH M ER Z
BRINER	B R AY N ER
BRINERS	B R IH N AH R Z
BRINGER	B R IH NG ER
BRINGERS	B R IH NG ER Z
BRINIER	B R IH N AY AH R
BRISKER	B R IH S K ER
BRISTLIER	B R IH S AH L IY ER
BRITTLER	B R IH T L ER
BROACHER	B R OW CH ER
BROACHERS	B R OW CH ER Z
BROADCASTER	B R AO D K AE S T ER
BROADCASTERS	B R AO D K AE S T ER Z
BROADER	B R AO D ER
BROGUERIES	B R AA G W AH R AY Z
BROGUERY	B R AH G EH R IY
BROIDER	B R OY D AH R
BROIDERED	B R OY D IY R D
BROIDERIES	B R OY D AH R AY Z
BROIDERING	B R OY D IY R AH NG
BROIDERS	B R OY D AH R Z
BROIDERY	B R OY D AH R IY
BROILER	B R OY L ER
BROILERS	B R OY L ER Z
BROKER	B R OW K ER
BROKERAGE	B R OW K ER IH JH
BROKERAGE(2)	B R OW K R IH JH
BROKERAGES	B R OW K ER IH JH IH Z
BROKERAGES(2)	B R OW K R IH JH IH Z
BROKERED	B R OW K ER D
BROKERING	B R OW K ER IH NG
BROKERINGS	B R OW K ER IH NG Z
BROKERS	B R OW K ER Z
BRONCOBUSTER	B R AA NG K OW B AH S T ER
BRONCOBUSTERS	B R AA NG K OW B AH S T ER Z
BRONZER	B R AA N Z ER
BRONZERS	B R AA N Z ER Z
BRONZIER	B R AA N Z IY ER
BROODER	B R UW D ER
BROODERS	B R UW D ER Z
BROODIER	B R UW D IY ER
BROOMBALLER	B R UW M B AO L ER
BROOMBALLERS	B R UW M B AO L ER Z
BROOMIER	B R UW M IY ER
BROTHER	B R AH DH ER
BROTHERED	B R AH DH ER D
BROTHERHOOD	B R AH DH ER HH UH D
BROTHERHOODS	B R AH DH ER HH UH D Z
BROTHERING	B R AH DH ER IH NG
BROTHERLINESS	B R AH DH ER L IY N AH S
BROTHERLINESSES	B R AH DH ER L IY N AH S IH Z
BROTHERLY	B R AH DH ER L IY
BROTHERS	B R AH DH ER Z
BROWNER	B R AW N ER
BROWNIER	B R AW N IY ER
BROWNNOSER	B R AW N OW Z ER
BROWNNOSERS	B R AW N OW Z ER Z
BROWSER	B R AW Z ER
BROWSERS	B R AW Z ER Z
BRUISER	B R UW Z ER
BRUISERS	B R UW Z ER Z
BRUITER	B R UW T ER
BRUITERS	B R UW T ER Z
BRUSHER	B R AH SH ER
BRUSHERS	B R AH SH ER Z
BRUSHIER	B R AH SH IY ER
BRUSKER	B R AH S AH R
BRUSQUER	B R AH S K ER
BRUSQUERIE	B R AH S K ER IY
BRUSQUERIES	B R AH S K AH R IY Z
BUBBLER	B AH B AH L ER
BUBBLERS	B AH B AH L ER Z
BUBBLIER	B AH B AH L IY ER
BUCCANEER	B AH K AH N IY R
BUCCANEERED	B AH K EY N AH R D
BUCCANEERING	B AH K EY N AH R AH NG
BUCCANEERISH	B AH K EY N AH R AH SH
BUCCANEERS	B AH K AH N IY R Z
BUCKER	B AH K ER
BUCKEROO	B AH K AH R UW
BUCKEROOS	B AH K AH R UW Z
BUCKERS	B AH K ER Z
BUCKLER	B AH K AH L ER
BUCKLER(2)	B AH K L ER
BUCKLERED	B AH K AH L ER D
BUCKLERING	B AH K AH L ER IH NG
BUCKLERS	B AH K AH L ER Z
BUCKMINSTERFULLERENE	B AH K M AH N S T AH R F UH L AH R IY N
BUCKMINSTERFULLERENES	B AH K M AH N S T AH R F UH L AH R IY N Z
BUDDER	B AH D ER
BUDDERS	B AH D ER Z
BUDGER	B AH JH ER
BUDGERIGAR	B AH JH R IH G ER
BUDGERIGARS	B AH JH R IH G ER Z
BUDGERS	B AH JH ER Z
BUDGETEER	B AH JH IH T IH R
BUDGETEERS	B AH JH IH T IH R Z
BUDGETER	B AH JH AH T ER
BUDGETERS	B AH JH AH T ER Z
BUFFALOBERRIES	B AH F AH L OW B EH R IY Z
BUFFALOBERRY	B AH F AH L OW B EH R IY
BUFFER	B AH F ER
BUFFERED	B AH F ER D
BUFFERING	B AH F ER IH NG
BUFFERS	B AH F ER Z
BUFFETER	B AH F AH T ER
BUFFETERS	B AH F AH T ER Z
BUFFIER	B AH F IY ER
BUFFOONERIES	B AH F UW N AH R IY Z
BUFFOONERY	B AH F UW N AH R IY
BUGGER	B AH G ER
BUGGERED	B UH G ER D
BUGGERIES	B AH G AH R IY Z
BUGGERING	B UH G ER IH NG
BUGGERS	B AH G ER Z
BUGGERY	B AH G AH R IY
BUGGIER	B AH G IY ER
BUGLER	B Y UW G AH L ER
BUGLERS	B Y UW G AH L ER Z
BUILDER	B IH L D ER
BUILDERS	B IH L D ER Z
BULGER	B AH L G ER
BULGERS	B AH L JH ER Z
BULGIER	B AH L JH IY ER
BULKIER	B AH L K IY ER
BULLDOGGER	B UH L D AO G ER
BULLDOGGERS	B UH L D AO G ER Z
BULLDOZER	B UH L D OW Z ER
BULLDOZERS	B UH L D OW Z ER Z
BULLFIGHTER	B UH L F AY T ER
BULLFIGHTERS	B UH L F AY T ER Z
BULLIER	B UH L IY ER
BULLTERRIER	B UH L T EH R IY ER
BULLTERRIERS	B UH L T EH R IY ER Z
BUMBERSHOOT	B AH M B IY ER SH UW T
BUMBERSHOOTS	B AH M B IY ER SH UW T S
BUMBLER	B AH M B AH L ER
BUMBLERS	B AH M B AH L ER Z
BUMMER	B AH M ER
BUMMERS	B AH M ER Z
BUMPER	B AH M P ER
BUMPERED	B AH M P ER D
BUMPERING	B AH M P ER IH NG
BUMPERS	B AH M P ER Z
BUMPIER	B AH M P IY ER
BUNCHBERRIES	B AH N CH B EH R IY Z
BUNCHBERRY	B AH N CH B EH R IY
BUNCHIER	B AH N CH IY ER
BUNDLER	B AH N D AH L ER
BUNDLERS	B AH N D AH L ER Z
BUNGLER	B AH NG G L ER
BUNGLERS	B AH NG G L ER Z
BUNKER	B AH NG K ER
BUNKERED	B AH NG K ER D
BUNKERING	B AH NG K ER IH NG
BUNKERS	B AH NG K ER Z
BUNTER	B AH N T ER
BUNTERS	B AH N T ER Z
BURBLER	B AH R B L AH R
BURBLERS	B AH R B L AH R Z
BURBLIER	B AH R B L AY AH R
BURDENER	B ER D AH N ER
BURDENERS	B ER D AH N ER Z
BURGER	B ER G ER
BURGERS	B ER G ER Z
BURGHER	B ER G ER
BURGHERS	B ER G ER Z
BURGOMASTER	B ER G AH M AE S T ER
BURGOMASTERS	B ER G AH M AE S T ER Z
BURIER	B EH R IY ER
BURIERS	B EH R IY ER Z
BURKER	B ER K ER
BURKERS	B ER K ER Z
BURLADERO	B AH R L AE D AH R OW
BURLADEROS	B ER L EY D ER AA S
BURLER	B ER L ER
BURLERS	B ER L ER Z
BURLESQUER	B ER L EH S K ER
BURLESQUERS	B ER L EH S K ER Z
BURLIER	B ER L IY ER
BURNER	B ER N ER
BURNERS	B ER N ER Z
BURNISHER	B ER N IH SH ER
BURNISHERS	B ER N IH SH ER Z
BURRER	B ER ER
BURRERS	B ER ER Z
BURRIER	B ER IY ER
BURROWER	B ER OW ER
BURROWERS	B ER OW ER Z
BURSERA	B AH R S AH R AH
BURSTER	B ER S T ER
BURSTERS	B ER S T ER Z
BUSHELER	B UH SH AH L ER
BUSHELERS	B UH SH AH L ER Z
BUSHER	B UH SH ER
BUSHERS	B UH SH ER Z
BUSHIER	B UH SH IY ER
BUSHMASTER	B UH SH M AE S T ER
BUSHMASTERS	B UH SH M AE S T ER Z
BUSHRANGER	B UH SH R EY N JH ER
BUSHRANGERS	B UH SH R EY N JH ER Z
BUSHWHACKER	B UH SH W AE K ER
BUSHWHACKERS	B UH SH W AE K ER Z
BUSIER	B IH Z IY ER
BUSINESSPERSON	B IH Z N AH S P ER S AH N
BUSINESSPERSONS	B IH Z N AH S P ER S AH N Z
BUSKER	B AH S K ER
BUSKERS	B AH S AH R Z
BUSTER	B AH S T ER
BUSTERS	B AH S T ER Z
BUSTIER	B AH S T Y ER
BUSTIERS	B AH S T IY ER Z
BUTCHER	B UH CH ER
BUTCHERED	B UH CH ER D
BUTCHERIES	B UH CH AH R IY Z
BUTCHERING	B UH CH ER IH NG
BUTCHERLY	B UH CH ER L IY
BUTCHERS	B UH CH ER Z
BUTCHERY	B UH CH ER IY
BUTLER	B AH T L ER
BUTLERIES	B AH T L ER IY Z
BUTLERS	B AH T L ER Z
BUTLERY	B AH T L ER IY
BUTTER	B AH T ER
BUTTERBALL	B AH T ER B AO L
BUTTERBALLS	B AH T ER B AO L Z
BUTTERCUP	B AH T ER K AH P
BUTTERCUPS	B AH T ER K AH P S
BUTTERED	B AH T ER D
BUTTERFAT	B AH T ER F AE T
BUTTERFATS	B AH T ER F AE T S
BUTTERFINGERED	B AH T ER F IH NG G ER D
BUTTERFINGERS	B AH T ER F IH NG G ER Z
BUTTERFISH	B AH T ER F IH SH
BUTTERFISHES	B AH T ER F IH SH IH Z
BUTTERFLIED	B AH T ER F L AY D
BUTTERFLIES	B AH T ER F L AY Z
BUTTERFLY	B AH T ER F L AY
BUTTERFLYER	B AH T ER F L AY ER
BUTTERFLYERS	B AH T ER F L AY ER Z
BUTTERFLYING	B AH T ER F L AY IH NG
BUTTERIER	B AH T AH R IY ER
BUTTERIES	B AH T AH R IY Z
BUTTERIEST	B AH T AH R IY AH S T
BUTTERING	B AH T ER IH NG
BUTTERLESS	B AH T ER L AH S
BUTTERMILK	B AH T ER M IH L K
BUTTERMILKS	B AH T ER M IH L K S
BUTTERNUT	B AH T ER N AH T
BUTTERNUTS	B AH T ER N AH T S
BUTTERS	B AH T ER Z
BUTTERSCOTCH	B AH T ER S K AA CH
BUTTERSCOTCHES	B AH T ER S K AA CH IH Z
BUTTERWEED	B AH T ER W IY D
BUTTERWEEDS	B AH T ER W IY D Z
BUTTERWORT	B AH T AH R W AH R T
BUTTERWORTS	B AH T AH R W AH R T S
BUTTERY	B AH T ER IY
BUTTONER	B AH T AH N ER
BUTTONERS	B AH T AH N ER Z
BUTTONHOLER	B AH T AH N HH OW L ER
BUTTONHOLERS	B AH T AH N HH OW L ER Z
BUXOMER	B AH K S AH M ER
BUYER	B AY ER
BUYERS	B AY ER Z
BUZZER	B AH Z ER
BUZZERS	B AH Z ER Z
BYLINER	B AY L AY N ER
BYLINERS	B AY L AY N ER Z
BYSTANDER	B AY S T AE N D ER
BYSTANDERS	B AY S T AE N D ER Z
CABALLERO	K AE B AH Y EH R OW
CABALLEROS	K AE B AH L ER AA S
CABDRIVER	K AE B D R AY V ER
CABDRIVERS	K AE B D R AY V ER Z
CABER	K AE B ER
CABERNET	K AE B ER N EY
CABERNETS	K AE B ER N EH T S
CABERNETS(2)	K AE B ER N EY Z
CABERS	K AE B ER Z
CABINETMAKER	K AE B N AH T M EY K ER
CABINETMAKERS	K AE B N AH T M EY K ER Z
CACKLER	K AE K AH L ER
CACKLERS	K AE K AH L ER Z
CADASTER	K AH D AE S T AH R
CADASTERS	K AH D AE S T AH R Z
CADAVER	K AH D AE V ER
CADAVERIC	K AH D AE V ER IH K
CADAVERINE	K AH D AE V AH R AY N
CADAVERINES	K AH D AE V AH R AY N Z
CADAVEROUS	K AH D AE V ER AH S
CADAVEROUSLY	K AH D AE V ER AH S L IY
CADAVERS	K AH D AE V ER Z
CADGER	K AE JH AH R
CADGERS	K AE JH AH R Z
CAFETERIA	K AE F AH T IH R IY AH
CAFETERIAS	K AE F AH T IH R IY AH Z
CAGER	K EY JH ER
CAGERS	K EY JH ER Z
CAGIER	K EY JH IY ER
CAHIER	K AE HH AY AH R
CAHIERS	K AH HH IY R Z
CAJOLER	K AH JH OW L AH R
CAJOLERIES	K AH JH AA L AH R AY Z
CAJOLERS	K AE JH AH L AH R Z
CAJOLERY	K AE JH AH L EH R IY
CAKEWALKER	K EY K W AO K ER
CAKEWALKERS	K EY K W AO K ER Z
CAKIER	K EY K IY ER
CALAMANDER	K AE L AH M AE N D ER
CALAMANDERS	K AE L AH M AE N D AH R Z
CALCIFEROL	K AE L S IH F AH R AH L
CALCIFEROLS	K AE L S IH F AH R AH L Z
CALCIFEROUS	K AE L S IH F AH R AH S
CALDERA	K AE L D EH R AH
CALDERA(2)	K AO L D EH R AH
CALDERAS	K AE L D AH R AH Z
CALENDER	K AH L EH N D AH R
CALENDERED	K AE L AH N D IY R D
CALENDERER	K AE L AH N D IY R AH R
CALENDERERS	K AH L EH N D AH R AH R Z
CALENDERING	K AE L AH N D IY R AH NG
CALENDERS	K AH L EH N D AH R Z
CALIBER	K AE L AH B ER
CALIBERS	K AE L AH B ER Z
CALIPER	K AE L AH P ER
CALIPERED	K AE L AH P ER D
CALIPERING	K AE L AH P ER IH NG
CALIPERS	K AE L AH P ER Z
CALKER	K AE K AH R
CALKERS	K AE L K AH R Z
CALLER	K AO L ER
CALLERS	K AO L ER Z
CALLIGRAPHER	K AH L IH G R AH F ER
CALLIGRAPHERS	K AH L IH G R AH F ER Z
CALLIPER	K AE L AY P AH R
CALLIPERED	K AE L AH P IY R D
CALLIPERING	K AE L AH P IY R AH NG
CALLIPERS	K AE L AH P AH R Z
CALLOWER	K AO L OW ER
CALMER	K AA M ER
CALMER(2)	K AA L M ER
CALORIMETER	K AE L AH R IH M AH T ER
CALORIMETERS	K AE L AH R IH M AH T ER Z
CALOYER	K AE L OY AH R
CALOYERS	K AE L OY AH R Z
CALYPTER	K AH L IH P T AH R
CALYPTERS	K AH L IH P T AH R Z
CAMARADERIE	K AA M ER AA D ER IY
CAMARADERIES	K AA M AH R AA D AH R IY Z
CAMBER	K AE M B ER
CAMBERED	K AE M B IY ER D
CAMBERING	K AE M B IY ER IH NG
CAMBERS	K AE M B IY ER Z
CAMCORDER	K AE M K AO R D ER
CAMCORDERS	K AE M K AO R D ER Z
CAMELEER	K AE M AH L IH R
CAMELEERS	K AE M AH L IH R Z
CAMERA	K AE M ER AH
CAMERA(2)	K AE M R AH
CAMERAE	K AE M AH R IY
CAMERAL	K AE M AH R AH L
CAMERAMAN	K AE M ER AH M AH N
CAMERAMEN	K AE M ER AH M EH N
CAMERAPERSON	K AE M R AH P ER S AH N
CAMERAPERSONS	K AE M R AH P ER S AH N Z
CAMERAS	K AE M ER AH Z
CAMERAS(2)	K AE M R AH Z
CAMERAWOMAN	K AE M R AH W UH M AH N
CAMERAWOMEN	K AE M R AH W IH M AH N
CAMERLENGO	K AE M AH R L EH N G OW
CAMERLENGOS	K AE M AH R L EH N G AH Z
CAMPAIGNER	K AE M P EY N ER
CAMPAIGNERS	K AE M P EY N ER Z
CAMPER	K AE M P ER
CAMPERS	K AE M P ER Z
CAMPIER	K AE M P IY ER
CAMPYLOBACTER	K AE M P IY L AA B AE K T ER
CAMPYLOBACTERS	K AE M P IY L AA B AE K T ER Z
CANALLER	K AH N AE L ER
CANALLERS	K AH N AE L ER Z
CANCELER	K AE N S AH L ER
CANCELERS	K AE N S AH L ER Z
CANCELLER	K AE N S AH L ER
CANCELLERS	K AE N S AH L ER Z
CANCER	K AE N S ER
CANCEROUS	K AE N S ER AH S
CANCEROUSLY	K AE N S ER AH S L IY
CANCERS	K AE N S ER Z
CANDIDER	K AE N D AH D ER
CANDLEBERRIES	K AE N D AH L B EH R IY Z
CANDLEBERRY	K AE N D AH L B EH R IY
CANDLEHOLDER	K AE N D AH L HH OW L D ER
CANDLEHOLDERS	K AE N D AH L HH OW L D ER Z
CANDLELIGHTER	K AE N D AH L AY T ER
CANDLELIGHTERS	K AE N D AH L AY T ER Z
CANDLEPOWER	K AE N D AH L P AW ER
CANDLEPOWERS	K AE N D AH L P AW ER Z
CANDLER	K AE N D AH L ER
CANDLER(2)	K AE N D L ER
CANDLERS	K AE N D AH L ER Z
CANDLESNUFFER	K AE N D AH L S N AH F ER
CANDLESNUFFERS	K AE N D AH L S N AH F ER Z
CANER	K EY N ER
CANERS	K EY N ER Z
CANISTER	K AE N AH S T ER
CANISTER(2)	K AE N IH S T ER
CANISTERS	K AE N AH S T ER Z
CANISTERS(2)	K AE N IH S T ER Z
CANKER	K AE NG K ER
CANKERED	K AE NG K ER D
CANKERING	K AE NG K ER IH NG
CANKEROUS	K AE NG K ER AH S
CANKERS	K AE NG K ER Z
CANKERWORM	K AE NG K ER W ER M
CANKERWORMS	K AE NG K ER W ER M Z
CANNER	K AE N ER
CANNERIES	K AE N ER IY Z
CANNERS	K AE N ER Z
CANNERY	K AE N ER IY
CANNIER	K AE N IY ER
CANNISTER	K AE N IH S T ER
CANNISTERS	K AE N IH S T ER Z
CANNONEER	K AE N AH N IH R
CANNONEERS	K AE N AH N IH R Z
CANTANKEROUS	K AE N T AE NG K ER AH S
CANTANKEROUSLY	K AE N T AE NG K ER AH S L IY
CANTANKEROUSNESS	K AE N T AE NG K ER AH S N AH S
CANTANKEROUSNESSES	K AE N T AE NG K ER AH S N AH S IH Z
CANTER	K AE N T ER
CANTERED	K AE N T ER D
CANTERING	K AE N T ER IH NG
CANTERS	K AE N T ER Z
CANTILEVER	K AE N T AH L IY V ER
CANTILEVERED	K AE N T AH L IY V ER D
CANTILEVERING	K AE N T AH L IY V ER IH NG
CANTILEVERS	K AE N T AH L IY V ER Z
CANVASER	K AE N V AH S ER
CANVASERS	K AE N V AH S ER Z
CANVASSER	K AE N V AH S ER
CANVASSERS	K AE N V AH S ER Z
CAPABLER	K EY P AH B AH L ER
CAPER	K EY P ER
CAPERCAILLIE	K AE P AH R K EY L AY
CAPERCAILLIES	K AH P AH R K EY L AY Z
CAPERCAILZIE	K AE P ER K EY L Z IY
CAPERCAILZIES	K AE P ER K EY L Z IY Z
CAPERED	K EY P ER D
CAPERER	K EY P ER ER
CAPERERS	K EY P ER ER Z
CAPERING	K EY P ER IH NG
CAPERS	K EY P ER Z
CAPMAKER	K AE P M EY K ER
CAPMAKERS	K AE P M EY K ER Z
CAPONIER	K AE P AO N IY ER
CAPONIERS	K AE P AO N IY ER Z
CAPPER	K AE P ER
CAPPERS	K EY P ER Z
CAPSOMER	K EY P S AH M ER
CAPSOMERS	K EY P S AH M ER Z
CAPTURER	K AE P CH ER ER
CAPTURERS	K AE P CH ER ER Z
CARABINEER	K AA R AH B IH N IH R
CARABINEERS	K AA R AH B IH N IH R Z
CARABINER	K AA R AH B IH N ER
CARABINERO	K AE R AH B IH N AH R OW
CARABINEROS	K AA R AH B IH N ER AA S
CARABINERS	K AA R AH B IH N ER Z
CARABINIER	K AA R AH B IH N IY ER
CARABINIERE	K AH R AE B AH N IY R
CARABINIERI	K AE R AH B AH N IY R IY
CARABINIERS	K AA R AH B IH N IY ER Z
CARAVANER	K AE R AH V AE N ER
CARAVANERS	K AE R AH V AE N ER Z
CARAVANNER	K AE R AH V AE N ER
CARAVANNERS	K AE R AH V AE N ER Z
CARAVANSERAI	K AE R AH V AE N S AH R EY
CARAVANSERAIS	K AE R AH V AE N Z IH R AH IY Z
CARBONIFEROUS	K AA R B AH N IH F ER AH S
CARBURETTER	K AA R B IY Y ER EH T ER
CARBURETTERS	K AA R B IY Y ER EH T ER Z
CARDER	K AA R D ER
CARDERS	K AA R D ER Z
CARDHOLDER	K AA R D HH OW L D ER
CARDHOLDERS	K AA R D HH OW L D ER Z
CARDPLAYER	K AA R D P L EY ER
CARDPLAYERS	K AA R D P L EY ER Z
CARDSHARPER	K AA R D SH AA R P ER
CARDSHARPERS	K AA R D SH AA R P ER Z
CAREENER	K AH R IY N ER
CAREENERS	K AH R IY N ER Z
CAREER	K ER IH R
CAREERED	K AH R IH ER D
CAREERER	K AH R IH ER ER
CAREERERS	K AH R IH ER ER Z
CAREERING	K ER IH R IH NG
CAREERISM	K ER IY R IH Z AH M
CAREERISMS	K AH R IH ER IH Z AH M Z
CAREERIST	K ER IH R IH S T
CAREERISTS	K ER IH R IH S T S
CAREERS	K ER IH R Z
CAREFULLER	K EH R F AH L ER
CAREGIVER	K EH R G IH V ER
CAREGIVERS	K EH R G IH V ER Z
CARER	K EH R ER
CARERS	K EH R ER Z
CARESSER	K AH R EH S ER
CARESSERS	K AH R EH S ER Z
CARETAKER	K EH R T EY K ER
CARETAKERS	K EH R T EY K ER Z
CARJACKER	K AA R JH AE K ER
CARJACKERS	K AA R JH AE K ER Z
CARMAKER	K AA R M EY K ER
CARMAKERS	K AA R M EY K ER Z
CAROLER	K AE R AH L ER
CAROLERS	K AE R AH L ER Z
CAROLLER	K AE R AH L ER
CAROLLERS	K AE R AH L ER Z
CAROUSER	K AH R AW Z ER
CAROUSERS	K AH R AW Z ER Z
CARPENTER	K AA R P AH N T ER
CARPENTERED	K AA R P AH N T ER D
CARPENTERING	K AA R P AH N T ER IH NG
CARPENTERS	K AA R P AH N T ER Z
CARPER	K AA R P ER
CARPERS	K AA R P ER Z
CARPETBAGGER	K AA R P AH T B AE G ER
CARPETBAGGERIES	K AA R P AH T B AE G AH R IY Z
CARPETBAGGERS	K AA R P AH T B AE G ER Z
CARPETBAGGERY	K AA R P AH T B AE G AH R IY
CARPOOLER	K AA R P UW L ER
CARPOOLERS	K AA R P UW L ER Z
CARRIER	K AE R IY ER
CARRIER(2)	K EH R IY ER
CARRIERS	K AE R IY ER Z
CARRIERS(2)	K EH R IY ER Z
CARROTIER	K AE R AH T IY ER
CARRYOVER	K EH R Y OW V ER
CARRYOVERS	K AE R IY OW V ER Z
CARTER	K AA R T ER
CARTERS	K AA R T ER Z
CARTOGRAPHER	K AA R T AA G R AH F AH R
CARTOGRAPHERS	K AA R T AA G R AH F AH R Z
CARTOPPER	K AA R T AA P ER
CARTOPPERS	K AA R T AA P ER Z
CARTWHEELER	K AA R T W IY L ER
CARTWHEELERS	K AA R T W IY L ER Z
CARVER	K AA R V ER
CARVERS	K AA R V ER Z
CASEBEARER	K EY S B AE ER ER
CASEBEARERS	K EY S B AE ER ER Z
CASERN	K AE S AH R N
CASERNE	K AE S AH R N
CASERNES	K AE S AH R N Z
CASERNS	K AE S AH R N Z
CASEWORKER	K EY S W ER K ER
CASEWORKERS	K EY S W ER K ER Z
CASHIER	K AE SH IH R
CASHIERED	K AE SH IH R D
CASHIERING	K AE SH IY ER IH NG
CASHIERS	K AE SH IH R Z
CASHMERE	K AE ZH M IH R
CASHMERES	K AE ZH M IH R Z
CASIMERE	K AE S AH M AH R
CASIMERES	K AE S AH M IY R Z
CASSEROLE	K AE S ER OW L
CASSEROLES	K AE S AH R OW L Z
CASSIMERE	K AE S AH M AH R
CASSIMERES	K AE S AH M IY R Z
CASSITERITE	K AE S IH T AH R AY T
CASSITERITES	K AE S IH T AH R AY T S
CASTER	K AE S T ER
CASTERS	K AE S T ER Z
CATALOGER	K AE T AH L AO G ER
CATALOGERS	K AE T AH L AO G ER Z
CATALOGUER	K AE T AH L AO G ER
CATALOGUERS	K AE T AH L AO G ER Z
CATALYZER	K AE T AH L AY Z AH R
CATALYZERS	K AH T AE L AH Z AH R Z
CATBRIER	K AE T B R AY AH R
CATBRIERS	K AE T B R IY R Z
CATCHER	K AE CH ER
CATCHERS	K AE CH ER Z
CATCHIER	K AE CH IY ER
CATECHIZER	K AE T AH K AY Z ER
CATECHIZERS	K AE T AH K AY Z ER Z
CATECHOLAMINERGIC	K AE T AH K AH L AE M AH N AH R JH AH K
CATER	K EY T ER
CATERAN	K EY T R AE N
CATERANS	K EY T R AE N Z
CATERCORNER	K EY T ER K AO R N ER
CATERCORNERED	K EY T ER K AO R N ER D
CATERED	K EY T ER D
CATERER	K EY T ER ER
CATERERS	K EY T ER ER Z
CATERESS	K EY T ER AH S
CATERESSES	K EY T ER AH S IH Z
CATERING	K EY T ER IH NG
CATERPILLAR	K AE T AH P IH L ER
CATERPILLAR(2)	K AE T ER P IH L ER
CATERPILLARS	K AE T AH P IH L ER Z
CATERS	K EY T ER Z
CATERWAUL	K AE T ER W AA L
CATERWAULED	K AH T AH R W EY AH L D
CATERWAULING	K AH T AH R W EY AH L AH NG
CATERWAULS	K AH T AH R W EY AH L Z
CATHETER	K AE TH AH T ER
CATHETERIZATION	K AE TH AH T ER AH Z EY SH AH N
CATHETERIZATIONS	K AE TH AH T ER AH Z EY SH AH N Z
CATHETERIZE	K AE TH AH T ER AY Z
CATHETERIZED	K AE TH AH T ER AY Z D
CATHETERIZES	K AE TH AH T ER AY Z IH Z
CATHETERIZING	K AE TH AH T ER AY Z IH NG
CATHETERS	K AE TH AH T ER Z
CATNAPER	K AE T N AE P ER
CATNAPERS	K AE T N AE P ER Z
CATNAPPER	K AE T N AE P ER
CATNAPPERS	K AE T N AE P ER Z
CATTERIES	K AE T AH R IY Z
CATTERY	K AE T AH R IY
CATTIER	K AE T IY ER
CAULIFLOWER	K AA L AH F L AW ER
CAULIFLOWERET	K AO L AH F L OW AH R AH T
CAULIFLOWERETS	K AO L AH F L OW AH R AH T S
CAULIFLOWERS	K AO L IH F L AW ER Z
CAULKER	K AO K AH R
CAULKERS	K AO L K AH R Z
CAUSER	K AO Z ER
CAUSERIE	K AO Z ER IY
CAUSERIES	K AO Z AH R IY Z
CAUSERS	K AO Z ER Z
CAUTERIES	K AO T AH R AY Z
CAUTERIZATION	K AO T ER IH Z EY SH AH N
CAUTERIZATIONS	K AO T AH R AY Z EY SH AH N Z
CAUTERIZE	K AO T ER AY Z
CAUTERIZED	K AO T ER AY Z D
CAUTERIZES	K AO T ER AY Z IH Z
CAUTERIZING	K AO T ER AY Z IH NG
CAUTERY	K EY Y AH T EH R IY
CAVALERO	K AH V AE L AH R OW
CAVALEROS	K EY V AH L ER AA S
CAVALIER	K AE V AH L IH R
CAVALIER(2)	K AE V AH L IY R
CAVALIERED	K EY V AH L IY ER D
CAVALIERING	K EY V AH L IY ER IH NG
CAVALIERISM	K EY V AH L IY ER IH Z AH M
CAVALIERISMS	K EY V AH L IY ER IH Z AH M Z
CAVALIERLY	K AE V AH L IH R L IY
CAVALIERS	K AE V AH L IH R Z
CAVER	K EY V ER
CAVERN	K AE V ER N
CAVERNED	K AE V ER N D
CAVERNICOLOUS	K AH V AH R N IH K AH L AH S
CAVERNING	K AE V ER N IH NG
CAVERNOUS	K AE V ER N AH S
CAVERNOUSLY	K AE V ER N AH S L IY
CAVERNS	K AE V ER N Z
CAVERS	K EY V ER Z
CAVILER	K EY V AH L AH R
CAVILERS	K AE V AH L AH R Z
CAVILLER	K AH V IH L AH R
CAVILLERS	K AH V IH L AH R Z
CAVORTER	K AH V AO R T ER
CAVORTERS	K AH V AO R T ER Z
CEDER	S IY D ER
CEDERS	S EH D AH R Z
CEILER	S IY AH L AH R
CEILERS	S IY L AH R Z
CEILOMETER	S IY AH L AA M AH T AH R
CEILOMETERS	S IY L AA M AH T AH R Z
CELERIAC	S AH L IY R IY AH K
CELERIACS	S AH L IY R IY AH S
CELERIES	S EH L R IY Z
CELERITIES	S AH L EH R AH T IY Z
CELERITY	S AH L EH R AH T IY
CELERY	S EH L ER IY
CELLARER	S EH L ER ER
CELLARERS	S EH L ER ER Z
CEMENTER	S IH M EH N T ER
CEMENTERS	S IH M EH N T ER Z
CEMETERIES	S EH M AH T EH R IY Z
CEMETERY	S EH M AH T EH R IY
CEMETERY(2)	S EH M IH T EH R IY
CENSER	S EH N S ER
CENSERS	S EH N S AH R Z
CENSURER	S EH N CH ER ER
CENSURERS	S EH N CH ER ER Z
CENTER	S EH N T ER
CENTER(2)	S EH N ER
CENTERBOARD	S EH N T ER B OW R D
CENTERBOARDS	S EH N T ER B OW R D Z
CENTERED	S EH N T ER D
CENTEREDNESS	S EH N T ER AH D N AH S
CENTEREDNESSES	S EH N T ER AH D N AH S IH Z
CENTERFOLD	S EH N T ER F OW L D
CENTERFOLDS	S EH N T ER F OW L D Z
CENTERING	S EH N T ER IH NG
CENTERLESS	S EH N T ER L AH S
CENTERLINE	S EH N T ER L AY N
CENTERLINES	S EH N T ER L AY N Z
CENTERPIECE	S EH N T ER P IY S
CENTERPIECES	S EH N T ER P IY S IH Z
CENTERS	S EH N T ER Z
CENTERS(2)	S EH N ER Z
CENTILITER	S EH N T AH L AY T AH R
CENTILITERS	S EH N T IH L AH T AH R Z
CENTIMETER	S EH N T AH M IY T ER
CENTIMETERS	S EH N T AH M IY T ER Z
CENTNER	S EH N T N ER
CENTNERS	S EH N T N AH R Z
CENTRALER	S EH N T R AH L ER
CENTRALIZER	S EH N T R AH L AY Z ER
CENTRALIZERS	S EH N T R AH L AY Z ER Z
CENTROMERE	S EH N T R OW M AH R
CENTROMERES	S EH N T R AH M IY R Z
CENTROMERIC	S EH N T R AH M AH R AH K
CERAMAL	S EH R AH M AH L
CERAMALS	S EH R AH M AH L Z
CERAMIC	S ER AE M IH K
CERAMICIST	S AH R AE M IH K IH S T
CERAMICISTS	S AH R AE M IH K IH S T S
CERAMICS	S ER AE M IH K S
CERAMIST	S EH R AH M AH S T
CERAMISTS	S EH R AH M AH S T S
CERASTES	S EH R AH S T S
CERATE	S IY R EY T
CERATED	S IY R EY T AH D
CERATES	S IY R EY T S
CERATIN	S EH R AH T AH N
CERATINS	S EH R AH T AH N Z
CERATOID	S IY R AH T OY D
CERATOPSIAN	S EH R AH T AA P S IY AH N
CERATOPSIANS	S EH R AH T AA P S IY AH N Z
CERCARIA	S AH R K AE R IY AH
CERCARIAE	S AH R K AE R IY IY
CERCARIAL	S AH R K AE R IY AH L
CERCARIAS	S AH R K AE R IY AH Z
CERCI	S AH R S IY
CERCIS	S AH R S AH S
CERCISES	S AH R S AY Z AH Z
CERCUS	S AH R K AH S
CERE	S IH R
CEREAL	S IH R IY AH L
CEREALS	S IH R IY AH L Z
CEREBELLA	S EH R AH B EH L AH
CEREBELLAR	S EH R AH B EH L AH R
CEREBELLUM	S EH R AH B EH L AH M
CEREBELLUMS	S EH R AH B EH L AH M Z
CEREBRA	S AH R EH B R AH
CEREBRAL	S EH R AH B R AH L
CEREBRAL(2)	S ER IY B R AH L
CEREBRALLY	S ER IY B R AH L IY
CEREBRALS	S EH R AH B R AH L Z
CEREBRATE	S EH R AH B R AH T
CEREBRATED	S EH R AH B R EY T IH D
CEREBRATES	S EH R AH B R AH T S
CEREBRATING	S EH R AH B R EY T IH NG
CEREBRATION	S EH R AH B R EY SH AH N
CEREBRATIONS	S EH R AH B R EY SH AH N Z
CEREBRIC	S EH R AH B R IH K
CEREBROSIDE	S AH R EH B R AH S AY D
CEREBROSIDES	S AH R EH B R AH S AY D Z
CEREBROSPINAL	S EH R AH B R AA S AH N AH L
CEREBROVASCULAR	S AH R EH B R AH V AE S Y AH L AH R
CEREBRUM	S AH R EH B R AH M
CEREBRUMS	S AH R EH B R AH M Z
CERECLOTH	S AH R EH K L AH TH
CERECLOTHS	S AH R EH K L AH TH S
CERED	S IY R D
CEREMENT	S IH R M AH N T
CEREMENTS	S EH R AH M AH N T S
CEREMONIAL	S EH R AH M OW N IY AH L
CEREMONIALISM	S EH R AH M OW N IY AH L IH Z AH M
CEREMONIALISMS	S EH R AH M OW N IY AH L IH Z AH M Z
CEREMONIALIST	S EH R AH M OW N IY AH L IH S T
CEREMONIALISTS	S EH R AH M OW N IY AH L IH S T S
CEREMONIALLY	S EH R AH M OW N IY AH L IY
CEREMONIALS	S EH R AH M OW N IY AH L Z
CEREMONIES	S EH R AH M OW N IY Z
CEREMONIOUS	S EH R AH M OW N IY AH S
CEREMONIOUSLY	S EH R AH M OW N IY AH S L IY
CEREMONIOUSNESS	S EH R AH M OW N IY AH S N AH S
CEREMONIOUSNESSES	S EH R AH M OW N IY AH S N AH S IH Z
CEREMONY	S EH R AH M OW N IY
CERES	S IH R IY Z
CEREUS	S IH R IY AH S
CEREUSES	S IY R IY AH Z AH Z
CERIA	S IY R IY AH
CERIAS	S IY R IY AH Z
CERIC	S IY R AH K
CERING	S IY R AH NG
CERIPH	S EH R AH F
CERIPHS	S EH R AH F S
CERISE	S ER IY S
CERISES	S AH R IY S IH Z
CERITE	S AH R AY T
CERITES	S AH R AY T S
CERIUM	S IY R IY AH M
CERIUMS	S IY R IY AH M Z
CERMET	S AH R M AH T
CERMETS	S AH R M AH T S
CERNUOUS	S AH R N Y AH W AH S
CERO	S EH R OW
CEROS	S EH R AH Z
CEROTIC	S EH R AH T AH K
CEROTYPE	S EH R AH T AY P
CEROTYPES	S EH R AH T AY P S
CEROUS	S IY R AH S
CERTAIN	S ER T AH N
CERTAINER	S ER T AH N ER
CERTAINEST	S ER T AH N AH S T
CERTAINLY	S ER T AH N L IY
CERTAINTIES	S ER T AH N T IY Z
CERTAINTY	S ER T AH N T IY
CERTES	S AH R T S
CERTIFIABLE	S ER T AH F AY AH B AH L
CERTIFIABLY	S ER T AH F AY AH B L IY
CERTIFICATE	S ER T IH F IH K AH T
CERTIFICATED	S ER T IH F IH K AH T IH D
CERTIFICATES	S ER T IH F IH K AH T S
CERTIFICATING	S ER T IH F IH K AH T IH NG
CERTIFICATION	S ER T AH F AH K EY SH AH N
CERTIFICATIONS	S ER T AH F AH K EY SH AH N Z
CERTIFICATORY	S ER T IH F IH K AH T ER IY
CERTIFIED	S ER T AH F AY D
CERTIFIER	S ER T AH F AY ER
CERTIFIERS	S ER T AH F AY ER Z
CERTIFIES	S ER T AH F AY Z
CERTIFY	S ER T AH F AY
CERTIFYING	S ER T AH F AY IH NG
CERTIORARI	S ER SH IY AH R AA R IY
CERTIORARIS	S ER SH IY AH R AA R IY Z
CERTITUDE	S ER T AH T UW D
CERTITUDES	S ER T AH T UW D Z
CERULEAN	S AH R UW L IY AH N
CERULEANS	S AH R UW L IY AH N Z
CERULOPLASMIN	S AH R UW L AH P L AE Z M AH N
CERULOPLASMINS	S AH R UW L AH P L AE Z M AH N Z
CERUMEN	S AH R UW M AH N
CERUMENS	S AH R UW M AH N Z
CERUMINOUS	S AH R UW M AH N AH S
CERUSE	S AH R UW Z
CERUSES	S AH R UW Z AH Z
CERUSITE	S EH R AH S AY T
CERUSITES	S EH R AH S AY T S
CERUSSITE	S EH R AH S AY T
CERUSSITES	S EH R AH S AY T S
CERVELAS	S AH R V AH L AH Z
CERVELASES	S AH R V AH L EY Z AH Z
CERVELAT	S ER V AH L AE T
CERVELATS	S ER V AH L AE T S
CERVICAL	S ER V AH K AH L
CERVICAL(2)	S ER V IH K AH L
CERVICES	S AH R V AH S
CERVICITIS	S AH R V AH S AY T AH S
CERVICITISES	S AH R V IH S AH T AY Z AH Z
CERVID	S AH R V AH D
CERVINE	S AH R V AY N
CERVIX	S ER V IH K S
CERVIXES	S AH R V AH K S
CHAFER	CH EY F ER
CHAFERS	CH EY F ER Z
CHAFFER	CH AE F ER
CHAFFERED	CH AE F ER D
CHAFFERER	CH AE F ER ER
CHAFFERERS	CH AE F ER ER Z
CHAFFERING	CH AE F ER IH NG
CHAFFERS	CH AE F ER Z
CHAFFIER	CH AE F IY ER
CHAIRPERSON	CH EH R P ER S AH N
CHAIRPERSONS	CH EH ER P ER S AH N Z
CHALKIER	CH AO K IY ER
CHALLENGER	CH AE L AH N JH ER
CHALLENGER(2)	CH AE L IH N JH ER
CHALLENGERS	CH AE L AH N JH ER Z
CHAMBER	CH EY M B ER
CHAMBERED	CH EY M B ER D
CHAMBERING	CH EY M B ER IH NG
CHAMBERLAIN	CH EY M B ER L AH N
CHAMBERLAIN(2)	CH EY M B ER L IH N
CHAMBERLAINS	CH EY M B ER L AH N Z
CHAMBERMAID	CH EY M B ER M EY D
CHAMBERMAIDS	CH EY M B ER M EY D Z
CHAMBERS	CH EY M B ER Z
CHAMFER	CH AE M F EH R
CHAMFERED	CH AE M F EH R D
CHAMFERING	CH AE M F EH R IH NG
CHAMFERS	CH AE M F EH R Z
CHAMPER	CH AE M P ER
CHAMPERS	CH AE M P ER Z
CHAMPERTIES	CH AE M P ER T AY Z
CHAMPERTOUS	CH AE M P AH R T AH S
CHAMPERTY	CH AE M P EH R T IY
CHANCELLERIES	CH AE N S AH L AH R IY Z
CHANCELLERY	CH AE N S AH L AH R IY
CHANCERIES	CH AE N S AH R IY Z
CHANCERY	CH AE N S ER IY
CHANCIER	CH AE N S IY ER
CHANDELIER	SH AE N D AH L IH R
CHANDELIERED	SH AE N D AH L IH ER D
CHANDELIERS	SH AE N D AH L IH Z
CHANDLER	CH AE N D L ER
CHANDLERIES	CH AE N D L ER IY Z
CHANDLERS	CH AE N D L ER Z
CHANDLERY	CH AE N D L ER IY
CHANGEOVER	CH EY N JH OW V ER
CHANGEOVERS	CH EY N JH OW V ER Z
CHANGER	CH EY N JH ER
CHANGERS	CH EY N JH ER Z
CHANNELER	CH AE N AH L ER
CHANNELERS	CH AE N AH L ER Z
CHANSONNIER	SH AA N S OW N IY ER
CHANSONNIERS	SH AA N S OW N IY ER Z
CHANTER	CH AE N T ER
CHANTERELLE	CH AE N T AH R AH L
CHANTERELLES	CH AE N T AH R AH L Z
CHANTERS	CH AE N T ER Z
CHANTICLEER	CH AE N T IH K L IH ER
CHANTICLEERS	CH AE N T IH K L IH ER Z
CHAPERON	SH AE P AH R OW N
CHAPERONAGE	SH AE P AH R OW N IH JH
CHAPERONAGES	SH AE P AH R OW N IH JH IH Z
CHAPERONE	SH AE P ER OW N
CHAPERONED	SH AE P AH R OW N D
CHAPERONES	SH AE P ER OW N Z
CHAPERONING	SH AE P ER OW N IH NG
CHAPERONS	SH AE P AH R OW N Z
CHAPITER	CH AH P AY T AH R
CHAPITERS	CH AE P AH T AH R Z
CHAPTER	CH AE P T ER
CHAPTERED	CH AE P T ER D
CHAPTERING	CH AE P T ER IH NG
CHAPTERS	CH AE P T ER Z
CHARACTER	K EH R IH K T ER
CHARACTERED	K AE R IH K T ER D
CHARACTERFUL	K AE R IH K T ER F AH L
CHARACTERIES	K AE R IH K T ER IY Z
CHARACTERING	K AE R IH K T ER IH NG
CHARACTERISTIC	K EH R IH K T ER IH S T IH K
CHARACTERISTICALLY	K EH R IH K T ER IH S T IH K L IY
CHARACTERISTICS	K EH R IH K T ER IH S T IH K S
CHARACTERIZATION	K EH R IH K T ER IH Z EY SH AH N
CHARACTERIZATIONS	K EH R IH K T ER IH Z EY SH AH N Z
CHARACTERIZE	K EH R IH K T ER AY Z
CHARACTERIZED	K EH R IH K T ER AY Z D
CHARACTERIZES	K EH R IH K T ER AY Z AH Z
CHARACTERIZING	K EH R IH K T ER AY Z IH NG
CHARACTERLESS	K AE R IH K T ER L AH S
CHARACTEROLOGICAL	CH AH R AE K T AH R AA L AH JH IH S AH L
CHARACTEROLOGICALLY	CH AH R AE K T AH R AH L AA JH AH K AE L IY
CHARACTERS	K AE R IH K T ER Z
CHARACTERS(2)	K EH R IH K T ER Z
CHARACTERY	K AE R IH K T ER IY
CHARBROILER	CH AA R B R OY L ER
CHARBROILERS	CH AA R B R OY L ER Z
CHARCUTERIE	CH AA R K Y UW T ER IY
CHARCUTERIES	CH AA R K Y UW T AH R IY Z
CHARGER	CH AA R JH ER
CHARGERS	CH AA R JH ER Z
CHARIER	CH AA R IY ER
CHARIOTEER	CH AE R IY AH T IH R
CHARIOTEERS	CH AE R IY AH T IH R Z
CHARMER	CH AA R M ER
CHARMERS	CH AA R M ER Z
CHARMINGER	CH AA R M IH NG ER
CHARRIER	CH AE R IY ER
CHARTER	CH AA R T ER
CHARTERED	CH AA R T ER D
CHARTERER	CH AA R T ER ER
CHARTERERS	CH AA R T ER ER Z
CHARTERING	CH AA R T ER IH NG
CHARTERS	CH AA R T ER Z
CHASER	CH EY S ER
CHASERS	CH EY S ER Z
CHASTENER	CH AE S T IY N AH R
CHASTENERS	CH AE S T AH N AH R Z
CHASTER	CH AE S T AH R
CHASTISER	CH AE S T AY Z ER
CHASTISERS	CH AE S T AY Z ER Z
CHATTER	CH AE T ER
CHATTERBOX	CH AE T ER B AA K S
CHATTERBOXES	CH AE T ER B AA K S IH Z
CHATTERED	CH AE T ER D
CHATTERER	CH AE T ER ER
CHATTERERS	CH AE T ER ER Z
CHATTERING	CH AE T ER IH NG
CHATTERS	CH AE T ER Z
CHATTERY	CH AE T AH R IY
CHATTIER	CH AE T IY ER
CHAUFER	CH AO F AH R
CHAUFERS	CH AO F AH R Z
CHAUFFER	CH AO F AH R
CHAUFFERS	CH AO F AH R Z
CHAUNTER	CH AO N T AH R
CHAUNTERS	CH AO N T AH R Z
CHAWER	CH AO ER
CHAWERS	CH AO ER Z
CHEAPER	CH IY P ER
CHEATER	CH IY T ER
CHEATERS	CH IY T ER Z
CHECKER	CH EH K ER
CHECKERBERRIES	CH EH K ER B EH R IY Z
CHECKERBERRY	CH EH K ER B EH R IY
CHECKERBOARD	CH EH K ER B AO R D
CHECKERBOARDS	CH EH K ER B AO R D Z
CHECKERED	CH EH K ER D
CHECKERING	CH EH K ER IH NG
CHECKERS	CH EH K ER Z
CHEDER	CH IY D AH R
CHEDERS	CH EH D AH R Z
CHEEKIER	CH IY K IY ER
CHEEPER	CH IY P AH R
CHEEPERS	CH IY P AH R Z
CHEER	CH IH R
CHEERED	CH IH R D
CHEERER	CH IH ER ER
CHEERERS	CH IH ER ER Z
CHEERFUL	CH IH R F AH L
CHEERFULLER	CH IH ER F AH L ER
CHEERFULLEST	CH IH ER F AH L AH S T
CHEERFULLY	CH IH R F AH L IY
CHEERFULLY(2)	CH IH R F L IY
CHEERFULNESS	CH IH R F AH L N AH S
CHEERFULNESSES	CH IH ER F AH L N AH S IH Z
CHEERIER	CH IH R IY ER
CHEERIEST	CH IH R IY AH S T
CHEERILY	CH IH ER IY L IY
CHEERINESS	CH IH ER IY N AH S
CHEERINESSES	CH IH ER IY N AH S IH Z
CHEERING	CH IH R IH NG
CHEERIO	CH IH R IY OW
CHEERIOS	CH IH R IY OW S
CHEERLEAD	CH IH ER L IY D
CHEERLEADER	CH IH R L IY D ER
CHEERLEADERS	CH IH R L IY D ER Z
CHEERLEADING	CH IH R L IY D IH NG
CHEERLEADS	CH IH ER L IY D Z
CHEERLED	CH IH ER L EH D
CHEERLESS	CH IH ER L AH S
CHEERLESSLY	CH IH ER L AH S L IY
CHEERLESSNESS	CH IH ER L AH S N AH S
CHEERLESSNESSES	CH IH ER L AH S N AH S IH Z
CHEERLY	CH IH ER L IY
CHEERO	CH IH R OW
CHEEROS	CH IH ER AA S
CHEERS	CH IH R Z
CHEERY	CH IH R IY
CHEESEBURGER	CH IY Z B ER G ER
CHEESEBURGERS	CH IY Z B ER G ER Z
CHEESIER	CH IY Z IY ER
CHELICERA	CH AH L IH S AH R AH
CHELICERAE	CH AH L IH S AH R IY
CHELICERAL	CH AH L IH S AH R AH L
CHEMOSURGERIES	K EH M AH S AH R JH AH R AY Z
CHEMOSURGERY	K EH M AH S AH R JH EH R IY
CHEMOTHERAPEUTIC	K EH M AH TH AH R EY P AH Y UW T AH K
CHEMOTHERAPEUTICALLY	K AH M AA TH AH R EY P Y UW T AH K AE L IY
CHEMOTHERAPEUTICS	K EH M AH TH AH R EY P AH Y UW T AH S Z
CHEMOTHERAPIES	K EH M AH TH EH R AH P AY Z
CHEMOTHERAPIST	K EH M AH TH EH R AH P AH S T
CHEMOTHERAPISTS	K EH M AH TH EH R AH P AH S T S
CHEMOTHERAPY	K IY M OW TH EH R AH P IY
CHEQUER	CH EH K AH R
CHEQUERED	CH EH K W IY R D
CHEQUERING	CH EH K W IY R AH NG
CHEQUERS	CH EH K W AH R Z
CHERIMOYA	CH AH R IH M OY AH
CHERIMOYAS	CH AH R IH M OY AH Z
CHERISH	CH EH R IH SH
CHERISHABLE	CH EH R IH SH AH B AH L
CHERISHED	CH EH R IH SH T
CHERISHER	CH EH R IH SH ER
CHERISHERS	CH EH R IH SH ER Z
CHERISHES	CH EH R IH SH IH Z
CHERISHING	CH EH R IH SH IH NG
CHERNOZEM	CH AH R N AH Z AH M
CHERNOZEMIC	CH AH R N AH Z AH M AH K
CHERNOZEMS	CH AH R N AH Z AH M Z
CHEROOT	CH AH R UW T
CHEROOTS	CH AH R UW T S
CHERRIES	CH EH R IY Z
CHERRY	CH EH R IY
CHERRYLIKE	CH EH R IY L AY K
CHERRYSTONE	CH EH R IY S T OW N
CHERRYSTONES	CH EH R IY S T OW N Z
CHERT	CH ER T
CHERTIER	CH AH R T AY AH R
CHERTIEST	CH AH R T AY AH S T
CHERTS	CH ER T S
CHERTY	CH EH R T IY
CHERUB	CH EH R AH B
CHERUBIC	CH ER UW B IH K
CHERUBICALLY	CH AH R UW B AH K AE L IY
CHERUBIM	CH EH R AH B IH M
CHERUBIMS	CH EH R AH B IH M Z
CHERUBLIKE	CH EH R AH B L AY K
CHERUBS	CH EH R AH B Z
CHERVIL	CH AH R V AH L
CHERVILS	CH AH R V AH L Z
CHESTERFIELD	CH EH S T ER F IY L D
CHESTERFIELDS	CH EH S T ER F IY L D Z
CHESTIER	CH EH S T IY ER
CHEVALIER	SH EH V AH L IH R
CHEVALIERS	SH EH V AH L IH ER Z
CHEVERON	CH EH V AH R AH N
CHEVERONS	CH EH V AH R AH N Z
CHEWER	CH UW ER
CHEWERS	CH UW ER Z
CHEWIER	CH UW IY ER
CHICANER	CH AH K EY N AH R
CHICANERIES	SH IH K EY N AH R IY Z
CHICANERS	CH IH K AH N AH R Z
CHICANERY	SH IH K EY N ER IY
CHICER	SH IY K ER
CHIDER	CH AY D ER
CHIDERS	CH AY D ER Z
CHIEFER	CH IY F ER
CHIFFONIER	CH IH F AA N AY AH R
CHIFFONIERS	CH IH F AH N IY R Z
CHIGGER	CH IH G ER
CHIGGERS	CH IH G ER Z
CHILDLIER	CH AY L D L IY ER
CHILLER	CH IH L ER
CHILLERS	CH IH L ER Z
CHILLIER	CH IH L IY ER
CHIMAERA	CH AH M IY R AH
CHIMAERAS	CH AH M IY R AH Z
CHIMAERIC	CH AH M IY R AH K
CHIMAERISM	CH IH M AH R IH Z AH M
CHIMAERISMS	CH AH M IY R AH Z AH M Z
CHIMER	CH AY M ER
CHIMERA	CH IH M EH R AH
CHIMERAS	CH IH M AH R AH Z
CHIMERE	CH IH M AH R
CHIMERES	CH AH M IY R Z
CHIMERIC	CH AY M ER IH K
CHIMERICAL	K IH M EH R AH K AH L
CHIMERICALLY	CH AY M ER IH K AH L IY
CHIMERISM	CH AY M ER IH Z AH M
CHIMERISMS	CH AY M ER IH Z AH M Z
CHIMERS	CH AY M ER Z
CHINABERRIES	CH AY N AH B EH R IY Z
CHINABERRY	CH AY N AH B EH R IY
CHINCHERINCHEE	CH IH NG K AH R AH N CH IY IY
CHINCHERINCHEES	CH IH NG K AH R IH NG K IY Z
CHINCHIER	CH IH NG K AY AH R
CHINKIER	CH IH NG K IY ER
CHINOISERIE	CH IH N OY S IY R AY
CHINOISERIES	CH AH N OY S AH R AY Z
CHINTZIER	CH IH N T S AY AH R
CHIPPER	CH IH P ER
CHIPPERED	CH IH P ER D
CHIPPERING	CH IH P ER IH NG
CHIPPERS	CH IH P ER Z
CHIPPIER	CH IH P IY ER
CHIRKER	CH AH R K AH R
CHIROGRAPHER	CH AH R AA G R AH F AH R
CHIROGRAPHERS	CH AH R AA G R AH F AH R Z
CHIROMANCER	CH IH R AH M AE N S AH R
CHIROMANCERS	CH IH R AH M AE N S AH R Z
CHIROPTERAN	CH AH R AA P T AH R AH N
CHIROPTERANS	CH AH R AA P T AH R AH N Z
CHIRPER	CH ER P ER
CHIRPERS	CH ER P ER Z
CHIRPIER	CH ER P IY ER
CHISELER	CH IH Z AH L ER
CHISELERS	CH IH Z AH L ER Z
CHISELLER	CH IH Z AH L ER
CHISELLERS	CH IH Z AH L ER Z
CHITTER	CH IH T ER
CHITTERED	CH IH T IY R D
CHITTERING	CH IH T IY R AH NG
CHITTERLINGS	CH IH T ER L IH NG Z
CHITTERS	CH IH T AH R Z
CHOCOLATIER	CH AA K L AH T IY ER
CHOCOLATIERS	CH AA K L AH T IY ER Z
CHOICER	CH OY S ER
CHOIRMASTER	K W AY ER M AE S T ER
CHOIRMASTERS	K W AY ER M AE S T ER Z
CHOKEBERRIES	CH OW K B EH R IY Z
CHOKEBERRY	CH OW K B EH R IY
CHOKECHERRIES	CH OW K CH EH R IY Z
CHOKECHERRY	CH OW K CH EH R IY
CHOKER	CH OW K ER
CHOKERS	CH OW K ER Z
CHOKIER	CH OW K IY ER
CHOLECALCIFEROL	CH AA L AH K AH L S IH F AH R AH L
CHOLECALCIFEROLS	CH AA L AH K AH L S IH F AH R AH L Z
CHOLER	CH OW L AH R
CHOLERA	K AA L ER AH
CHOLERAS	K AA L AH R AH Z
CHOLERIC	K AA L ER IH K
CHOLERICALLY	CH AH L EH R AH K AE L IY
CHOLERS	CH AA L AH R Z
CHOLESTERIC	CH AH L EH S T AH R AH K
CHOLESTEROL	K AH L EH S T ER AO L
CHOLESTEROL(2)	K AH L EH S T ER AH L
CHOLESTEROLS	K AH L EH S T AH R AO L Z
CHOLINERGIC	CH AA L AH N AH R JH AH K
CHOLINERGICALLY	CH AA L AH N AH R JH AH K AE L IY
CHOLINESTERASE	K OW L AH N EH S T AH R EY Z
CHOLINESTERASES	K OW L AH N EH S T AH R EY Z IH Z
CHOMPER	CH AA M P AH R
CHOMPERS	CH AA M P AH R Z
CHOOSER	CH UW Z ER
CHOOSERS	CH UW Z ER Z
CHOOSIER	CH UW Z IY ER
CHOPPER	CH AA P ER
CHOPPERED	CH AA P ER D
CHOPPERING	CH AA P ER IH NG
CHOPPERS	CH AA P ER Z
CHOPPIER	CH AA P IY ER
CHORDAMESODERM	CH AO R D AH M EH S AH D AH R M
CHORDAMESODERMAL	CH AO R D AH M EH S AH D AH R M AH L
CHORDAMESODERMS	CH AO R D AH M EH S AH D AH R M Z
CHOREOGRAPHER	K AO R IY AA G R AH F ER
CHOREOGRAPHERS	K AO R IY AA G R AH F ER Z
CHORISTER	CH OW R IY S T ER
CHORISTERS	CH OW R IY S T ER Z
CHOROGRAPHER	CH AH R AA G R AH F AH R
CHOROGRAPHERS	CH AH R AA G R AH F AH R Z
CHORTLER	CH AO R T AH L ER
CHORTLERS	CH AO R T AH L ER Z
CHOUSER	CH OW AH S AH R
CHOUSERS	CH AW S AH R Z
CHOWDER	CH AW D ER
CHOWDERED	CH AW D ER D
CHOWDERHEAD	CH AW D ER HH EH D
CHOWDERHEADED	CH AW D ER HH EH D IH D
CHOWDERHEADS	CH AW D ER HH EH D Z
CHOWDERING	CH AW D ER IH NG
CHOWDERS	CH AW D ER Z
CHROMATOGRAPHER	K R AA M AH T AA G R AH F AH R
CHROMATOGRAPHERS	K R AA M AH T AA G R AH F AH R Z
CHROMOCENTER	K R AA M AH S EH N T AH R
CHROMOCENTERS	K R AA M AH S EH N T AH R Z
CHROMOLITHOGRAPHER	K R AA M AH L AH TH AA G R AH F AH R
CHROMOLITHOGRAPHERS	K R AA M AH L AH TH AA G R AH F AH R Z
CHROMOMERE	K R AH M OW M AH R
CHROMOMERES	K R AA M AH M IY R Z
CHROMOMERIC	K R AA M AH M AH R AH K
CHROMOSPHERE	K R AH M AA S AH R
CHROMOSPHERES	K R AA M AH S IY R Z
CHROMOSPHERIC	K R AH M AA S AH R AH K
CHRONICLER	K R AA N IH K L ER
CHRONICLERS	K R AA N IH K L ER Z
CHRONOLOGER	K R AA N AH L OW JH AH R
CHRONOLOGERS	K R AH N AA L AH JH AH R Z
CHRONOMETER	K R OW N AA M AH T AH R
CHRONOMETERS	K R AH N AA M AH T AH R Z
CHRONOTHERAPIES	K R AA N AH TH EH R AH P AY Z
CHRONOTHERAPY	K R AA N AH TH EH R AH P IY
CHRYSOBERYL	K R AH S AA B AH R AH L
CHRYSOBERYLS	K R AH S AA B AH R AH L Z
CHUBBIER	CH AH B IY ER
CHUCKLER	CH AH K AH L ER
CHUCKLERS	CH AH K AH L ER Z
CHUDDER	CH AH D AH R
CHUDDERS	CH AH D AH R Z
CHUFFER	CH AH F AH R
CHUFFIER	CH AH F AY AH R
CHUGGER	CH AH G ER
CHUGGERS	CH AH G ER Z
CHUKKER	CH AH K AH R
CHUKKERS	CH AH K AH R Z
CHUMMIER	CH AH M IY ER
CHUNKIER	CH AH NG K IY ER
CHUNTER	CH AH N T AH R
CHUNTERED	CH AH N T IY R D
CHUNTERING	CH AH N T IY R AH NG
CHUNTERS	CH AH N T AH R Z
CHURCHGOER	CH ER CH G OW ER
CHURCHGOERS	CH ER CH G OW ER Z
CHURCHIER	CH ER CH IY ER
CHURCHLIER	CH ER CH L IY ER
CHURNER	CH ER N ER
CHURNERS	CH ER N ER Z
CHURRIGUERESQUE	CH AH R AH G W AH R EH S
CICERO	S IH S ER OW
CICERONE	S IH S ER OW N
CICERONES	S IH S AH R OW N Z
CICERONI	S AH S EH R AH N IY
CICEROS	S IH S AH R AH Z
CIDER	S AY D ER
CIDERS	S AY D ER Z
CIGUATERA	S IH G W AA T AH R AH
CIGUATERAS	S IH G W AA T AH R AH Z
CINDER	S IH N D ER
CINDERBLOCK	S IH N D ER B L AA K
CINDERBLOCKS	S IH N D ER B L AA K S
CINDERED	S IH N D ER D
CINDERING	S IH N D ER IH NG
CINDERS	S IH N D ER Z
CINDERY	S IH N D ER IY
CINEMAGOER	S IH N AH M AH G OW ER
CINEMAGOERS	S IH N AH M AH G OW ER Z
CINEMATOGRAPHER	S IH N IH M AH T AA G R AH F ER
CINEMATOGRAPHERS	S IH N AH M AH T AA G R AH F AH R Z
CINERARIA	S IH N AH R AE R IY AH
CINERARIAS	S IH N AH R AE R IY AH Z
CINERARIUM	S IH N AH R AE R IY AH M
CINERARY	S IH N AH R EH R IY
CINEREOUS	S AH N IY R IY AH S
CINERIN	S IH N AH R AH N
CINERINS	S IH N AH R AH N Z
CIPHER	S AY F ER
CIPHERED	S AY F ER D
CIPHERING	S AY F ER IH NG
CIPHERS	S AY F ER Z
CIPHERTEXT	S AY F ER T EH K S T
CIPHERTEXTS	S AY F ER T EH K S T S
CIRCLER	S ER K AH L ER
CIRCLERS	S ER K AH L ER Z
CIRCUMCENTER	S ER K AH M S EH N T ER
CIRCUMCENTERS	S ER K AH M S EH N T ER Z
CIRCUMCISER	S AH R K AH M S AH S AH R
CIRCUMCISERS	S AH R K AH M S IH S AH R Z
CIRCUMFERENCE	S ER K AH M F R AH N S
CIRCUMFERENCES	S ER K AH M F R AH N S IH Z
CIRCUMFERENTIAL	S ER K AH M F ER AH N T IY AH L
CISTERN	S IH S T ER N
CISTERNA	S IH S T AH R N AH
CISTERNAE	S IH S T AH R N IY
CISTERNAL	S IH S T ER N AH L
CISTERNS	S IH S T ER N Z
CITER	S AY T ER
CITERS	S AY T ER Z
CITHER	S IH DH AH R
CITHERN	S IH TH AH R N
CITHERNS	S IH TH AH R N Z
CITHERS	S IH TH AH R Z
CITTERN	S IH T AH R N
CITTERNS	S IH T AH R N Z
CIVILIZER	S IH V AH L AY Z ER
CIVILIZERS	S IH V AH L AY Z ER Z
CLABBER	K L AE B AH R
CLABBERED	K L AE B IY R D
CLABBERING	K L AE B IY R AH NG
CLABBERS	K L AE B AH R Z
CLACKER	K L AE K AH R
CLACKERS	K L AE K AH R Z
CLADOCERAN	K L AH D AA S AH R AH N
CLADOCERANS	K L AH D AA S AH R AH N Z
CLAIMER	K L EY M ER
CLAIMERS	K L EY M ER Z
CLAMBER	K L AE M B ER
CLAMBERED	K L AE M B ER D
CLAMBERER	K L AE M B ER ER
CLAMBERERS	K L AE M B ER ER Z
CLAMBERING	K L AE M B ER IH NG
CLAMBERS	K L AE M B ER Z
CLAMMER	K L AE M ER
CLAMMERS	K L AE M ER Z
CLAMMIER	K L AE M IY ER
CLAMORER	K L AE M ER ER
CLAMORERS	K L AE M ER ER Z
CLAMPER	K L AE M P ER
CLAMPERS	K L AE M P ER Z
CLANGER	K L AE NG ER
CLANGERS	K L AE NG ER Z
CLAPPER	K L AE P ER
CLAPPERCLAW	K L AE P ER K L AO
CLAPPERCLAWED	K L AE P ER K L AO D
CLAPPERCLAWING	K L AE P ER K L AO IH NG
CLAPPERCLAWS	K L AE P ER K L AO Z
CLAPPERS	K L AE P ER Z
CLAQUER	K L AE K AH R
CLAQUERS	K L AE K W AH R Z
CLARIFIER	K L AE R AH F AY ER
CLARIFIERS	K L AE R AH F AY ER Z
CLASHER	K L AE SH ER
CLASHERS	K L AE SH ER Z
CLASPER	K L AE S P ER
CLASPERS	K L AE S P ER Z
CLASSER	K L AE S ER
CLASSERS	K L AE S ER Z
CLASSIER	K L AE S IY ER
CLASSIFIER	K L AE S AH F AY ER
CLASSIFIERS	K L AE S AH F AY ER Z
CLATTER	K L AE T ER
CLATTERED	K L AE T ER D
CLATTERER	K L AE T ER ER
CLATTERERS	K L AE T ER ER Z
CLATTERING	K L AE T ER IH NG
CLATTERINGLY	K L AE T ER IH NG L IY
CLATTERS	K L AE T ER Z
CLATTERY	K L AE T ER IY
CLAVER	K L EY V AH R
CLAVERED	K L AH V IY R D
CLAVERING	K L AH V IY R AH NG
CLAVERS	K L AE V AH R Z
CLAVIER	K L AE V AY AH R
CLAVIERIST	K L EY V IY R AH S T
CLAVIERISTIC	K L EY V IY R AH S T AH K
CLAVIERISTS	K L EY V IY R AH S T S
CLAVIERS	K L EY V IY R Z
CLAWER	K L AO ER
CLAWERS	K L AO ER Z
CLAWHAMMER	K L AO HH AE M ER
CLAYIER	K L EY IY ER
CLEANER	K L IY N ER
CLEANERS	K L IY N ER Z
CLEANLIER	K L IY N L IY ER
CLEANSER	K L EH N Z ER
CLEANSERS	K L EH N Z ER Z
CLEARER	K L IH R ER
CLEARERS	K L IH ER ER Z
CLEAVER	K L IY V ER
CLEAVERS	K L IY V ER Z
CLENCHER	K L EH N CH ER
CLENCHERS	K L EH N CH ER Z
CLERESTORIES	K L AH R EH S T AH R AY Z
CLERESTORY	K L IY R AH S T AO R IY
CLERGIES	K L ER JH IY Z
CLERGY	K L ER JH IY
CLERGYMAN	K L ER JH IY M AH N
CLERGYMAN(2)	K L ER JH IY M AE N
CLERGYMEN	K L ER JH IY M IH N
CLERGYMEN(2)	K L ER JH IY M EH N
CLERGYWOMAN	K L ER JH IY W UH M AH N
CLERGYWOMEN	K L ER JH IY W IH M AH N
CLERIC	K L EH R IH K
CLERICAL	K L EH R AH K AH L
CLERICAL(2)	K L EH R IH K AH L
CLERICALISM	K L EH R IH K AH L IH Z AH M
CLERICALISMS	K L EH R IH K AH L IH Z AH M Z
CLERICALIST	K L EH R IH K AH L IH S T
CLERICALISTS	K L EH R IH K AH L IH S T S
CLERICALLY	K L EH R IH K AH L IY
CLERICALS	K L EH R IH K AH L Z
CLERICS	K L EH R IH K S
CLERID	K L EH R AH D
CLERIDS	K L EH R AH D Z
CLERIHEW	K L AH R IH HH Y UW
CLERIHEWS	K L AH R IH HH Y UW Z
CLERISIES	K L EH R AH S AY Z
CLERISY	K L IY R AH S IY
CLERK	K L ER K
CLERKDOM	K L ER K D AH M
CLERKDOMS	K L ER K D AH M Z
CLERKED	K L ER K T
CLERKING	K L ER K IH NG
CLERKISH	K L ER K IH SH
CLERKLIER	K L ER K L IY ER
CLERKLIEST	K L ER K L IY AH S T
CLERKLY	K L ER K L IY
CLERKS	K L ER K S
CLERKSHIP	K L ER K SH IH P
CLERKSHIPS	K L ER K SH IH P S
CLEVER	K L EH V ER
CLEVERER	K L EH V ER ER
CLEVEREST	K L EH V ER AH S T
CLEVERISH	K L EH V ER IH SH
CLEVERLY	K L EH V ER L IY
CLEVERNESS	K L EH V ER N AH S
CLEVERNESSES	K L EH V ER N AH S IH Z
CLICKER	K L IH K ER
CLICKERS	K L IH K ER Z
CLIFFHANGER	K L IH F HH AE NG ER
CLIFFHANGERS	K L IH F HH AE NG ER Z
CLIFFIER	K L IH F IY ER
CLIMACTERIC	K L AH M AE K T AH R AH K
CLIMACTERICS	K L AH M AE K T AH R AH S Z
CLIMBER	K L AY M ER
CLIMBERS	K L AY M ER Z
CLINCHER	K L IH N CH ER
CLINCHERS	K L IH N CH ER Z
CLINGER	K L IH NG ER
CLINGERS	K L IH NG ER Z
CLINGIER	K L IH NG IY ER
CLINKER	K L IH NG K ER
CLINKERED	K L IH NG K ER D
CLINKERING	K L IH NG K ER IH NG
CLINKERS	K L IH NG K ER Z
CLINOMETER	K L AY N AA M AH T AH R
CLINOMETERS	K L AH N AA M AH T AH R Z
CLIPPER	K L IH P ER
CLIPPERS	K L IH P ER Z
CLIQUIER	K L IY K IY ER
CLIVERS	K L IH V AH R Z
CLOBBER	K L AA B ER
CLOBBERED	K L AA B ER D
CLOBBERING	K L AA B ER IH NG
CLOBBERS	K L AA B ER Z
CLOCKER	K L AA K ER
CLOCKERS	K L AA K ER Z
CLODDIER	K L AA D IY ER
CLODHOPPER	K L AA D HH AA P ER
CLODHOPPERS	K L AA D HH AA P ER Z
CLOGGER	K L AA G ER
CLOGGERS	K L AA G ER Z
CLOGGIER	K L AA G IY ER
CLOISTER	K L OY S T ER
CLOISTERED	K L OY S T ER D
CLOISTERING	K L OY S T ER IH NG
CLOISTERS	K L OY S T ER Z
CLONER	K L OW N AH R
CLONERS	K L AA N AH R Z
CLOSER	K L OW S ER
CLOSER(2)	K L OW Z ER
CLOSERS	K L OW Z ER Z
CLOTHIER	K L OW DH Y ER
CLOTHIERS	K L OW DH Y ER Z
CLOUDBERRIES	K L AW D B EH R IY Z
CLOUDBERRY	K L AW D B EH R IY
CLOUDIER	K L AW D IY ER
CLOUTER	K L AW T ER
CLOUTERS	K L AW T ER Z
CLOVER	K L OW V ER
CLOVERLEAF	K L OW V ER L IY F
CLOVERLEAFS	K L OW V ER L IY F S
CLOVERLEAVES	K L OW V ER L IY V Z
CLOVERS	K L OW V ER Z
CLOWDER	K L OW D AH R
CLOWDERS	K L OW D AH R Z
CLOWNERIES	K L AW N AH R IY Z
CLOWNERY	K L AW N AH R IY
CLUBBER	K L AH B ER
CLUBBERS	K L AH B ER Z
CLUBBIER	K L AH B IY ER
CLUMBER	K L AH M AH R
CLUMBERS	K L AH M B AH R Z
CLUMPIER	K L AH M P IY ER
CLUMSIER	K L AH M Z IY ER
CLUNKER	K L AH NG K ER
CLUNKERS	K L AH NG K ER Z
CLUNKIER	K L AH NG K AY AH R
CLUSTER	K L AH S T ER
CLUSTERED	K L AH S T ER D
CLUSTERING	K L AH S T ER IH NG
CLUSTERS	K L AH S T ER Z
CLUSTERY	K L AH S T ER IY
CLUTTER	K L AH T ER
CLUTTERED	K L AH T ER D
CLUTTERING	K L AH T ER IH NG
CLUTTERS	K L AH T ER Z
CLUTTERY	K L AH T ER IY
CLYSTER	K L IH S T AH R
CLYSTERS	K L IH S T AH R Z
COACERVATE	K OW AE S AH R V EY T
COACERVATES	K OW AE S AH R V EY T S
COACERVATION	K OW AE S AH R V EY SH AH N
COACERVATIONS	K OW AE S AH R V EY T IY AH N Z
COACHER	K OW CH ER
COACHERS	K OW CH ER Z
COALER	K OW L ER
COALERS	K OW L ER Z
COALIER	K OW L IY ER
COARSER	K AO R S ER
COASTER	K OW S T ER
COASTERS	K OW S T ER Z
COATER	K OW T ER
COATERS	K OW T ER Z
COAXER	K OW K S ER
COAXERS	K OW K S ER Z
COBBER	K AA B AH R
COBBERS	K AA B EH R Z
COBBIER	K AA B AY AH R
COBBLER	K AA B L ER
COBBLERS	K AA B L ER Z
COBELLIGERENT	K OW B AH L IH JH ER AH N T
COBELLIGERENTS	K OW B AH L IH JH ER AH N T S
COBWEBBIER	K AA B W EH B IY ER
COCHAIRPERSON	K OW CH EH ER P ER S AH N
COCHAIRPERSONS	K OW CH EH ER P ER S AH N Z
COCINERA	K OW S IH N AH R AH
COCINERAS	K OW S IH N AH R AH Z
COCKCHAFER	K AA K CH EY F ER
COCKCHAFERS	K AA K CH EY F ER Z
COCKER	K AA K ER
COCKERED	K AA K ER D
COCKEREL	K AA K EH R AH L
COCKERELS	K AA K EH R AH L Z
COCKERING	K AA K ER IH NG
OIL	OY L
ANELASTIC	AE N AH L AH S T AH K
MUZHIK	M AH Z HH AH K
BY	B AY
NITPICK	N IH T P IH K
OFT	AO F T
HEUCH	HH Y UW CH
