EW	Y UW
AGUEWEED	EY G Y UW W IY D
AGUEWEEDS	EY G Y UW W IY D Z
AIRCREW	EH R K R UW
AIRCREWS	AH IH R K R UW Z
AIRSCREW	AH IH R S K R UW
AIRSCREWS	AH IH R S K R UW Z
AISLEWAY	AY L W EY
AISLEWAYS	AY L W EY Z
ALEWIFE	EY L W AY F
ALEWIVES	EY L W AY V Z
ANEW	AH N UW
ANEW(2)	AH N Y UW
ANGLEWORM	AE NG G AH L W ER M
ANGLEWORMS	AE NG G AH L W ER M Z
ASKEW	AH S K Y UW
ASKEWNESS	AH S K Y UW N AH S
ASKEWNESSES	AH S K Y UW N AH S IH Z
BATTLEWAGON	B AE T AH L W AE G AH N
BATTLEWAGONS	B AE T AH L W AE G AH N Z
BEDEW	B IH D UW
BEDEWED	B IH D IY W EH D
BEDEWING	B IH D IY W IH NG
BEDEWS	B IH D UW Z
BEJEWEL	B IH JH UW AH L
BEJEWELED	B IH JH UW AH L D
BEJEWELING	B IH JH UW AH L IH NG
BEJEWELLED	B IH JH UW AH L D
BEJEWELLING	B IH JH UW AH L IH NG
BEJEWELS	B IH JH UW AH L Z
BESHREW	B IH SH R UW
BESHREWED	B IH SH R UW D
BESHREWING	B IH SH R UW IH NG
BESHREWS	B IH SH R UW Z
BESTREW	B IH S T R UW
BESTREWED	B EH S T R IY W EH D
BESTREWING	B EH S T R IY W IH NG
BESTREWN	B IH S T R UW N
BESTREWS	B IH S T R UW Z
BEWAIL	B IH W EY L
BEWAILED	B IH W EY L D
BEWAILER	B IH W EY L ER
BEWAILERS	B IH W EY L ER Z
BEWAILING	B IH W EY L IH NG
BEWAILS	B IH W EY L Z
BEWARE	B IH W EH R
BEWARED	B IH W EH R D
BEWARES	B IH W EH R Z
BEWARING	B IH W EH R IH NG
BEWEARIED	B IH W IH R IY D
BEWEARIES	B IH W IH R IY Z
BEWEARY	B IH W IH R IY
BEWEARYING	B IH W IH R IY IH NG
BEWEEP	B IH W IY P
BEWEEPING	B IH W IY P IH NG
BEWEEPS	B IH W IY P S
BEWEPT	B IH W EH P T
BEWHISKERED	B IH W IH S K ER D
BEWIG	B IH W IH G
BEWIGGED	B IH W IH G D
BEWIGGING	B IH W IH G IH NG
BEWIGS	B IH W IH G Z
BEWILDER	B IH W IH L D ER
BEWILDERED	B IH W IH L D ER D
BEWILDEREDLY	B IH W IH L D ER AH D L IY
BEWILDEREDNESS	B IH W IH L D ER AH D N AH S
BEWILDEREDNESSES	B IH W IH L D ER AH D N AH S IH Z
BEWILDERING	B IH W IH L D ER IH NG
BEWILDERINGLY	B IH W IH L D ER IH NG L IY
BEWILDERMENT	B IH W IH L D ER M AH N T
BEWILDERMENTS	B IH W IH L D ER M AH N T S
BEWILDERS	B IH W IH L D ER Z
BEWINGED	B IH W IH NG D
BEWITCH	B IH W IH CH
BEWITCHED	B IH W IH CH T
BEWITCHERIES	B IH W IH CH AH R IY Z
BEWITCHERY	B IH W IH CH AH R IY
BEWITCHES	B IH W IH CH IH Z
BEWITCHING	B IH W IH CH IH NG
BEWITCHINGLY	B IH W IH CH IH NG L IY
BEWITCHMENT	B IH W IH CH M AH N T
BEWITCHMENTS	B IH W IH CH M AH N T S
BEWORM	B IH W ER M
BEWORMED	B IH W ER M D
BEWORMING	B IH W ER M IH NG
BEWORMS	B IH W ER M Z
BEWORRIED	B IH W ER IY D
BEWORRIES	B IH W ER IY Z
BEWORRY	B IH W ER IY
BEWORRYING	B IH W ER IY IH NG
BEWRAP	B IH R AE P
BEWRAPPED	B IH R AE P T
BEWRAPPING	B IH R AE P IH NG
BEWRAPS	B IH R AE P S
BEWRAPT	B AH R AE P T
BEWRAY	B AH R EY IY
BEWRAYED	B AH R EY D
BEWRAYER	B AH R EY AH R
BEWRAYERS	B AH R EY AH R Z
BEWRAYING	B AH R EY AH NG
BEWRAYS	B AH R EY Z
BIKEWAY	B AY K Y UW EY IY
BIKEWAYS	B AY K Y UW EY Z
BILGEWATER	B IH L JH W AO T ER
BILGEWATERS	B IH L JH W AO T ER Z
BITEWING	B AY T W IH NG
BITEWINGS	B AY T W IH NG Z
BLAMEWORTHINESS	B L EY M W ER DH IY N AH S
BLAMEWORTHINESSES	B L EY M W ER DH IY N AH S IH Z
BLAMEWORTHY	B L EY M W ER DH IY
BLEW	B L UW
BLUEWEED	B L UW W IY D
BLUEWEEDS	B L UW W IY D Z
BLUEWOOD	B L UW W UH D
BLUEWOODS	B L UW W UH D Z
BRAILLEWRITER	B R EY L R AY T ER
BRAILLEWRITERS	B R EY L R AY T ER Z
BREEZEWAY	B R IY Z W EY
BREEZEWAYS	B R IY Z W EY Z
BREW	B R UW
BREWAGE	B R UW IH JH
BREWAGES	B R UW IH JH IH Z
BREWED	B R UW D
BREWER	B R UW ER
BREWERIES	B R UW ER IY Z
BREWERIES(2)	B R UW R IY Z
BREWERS	B R UW ER Z
BREWERY	B R UW ER IY
BREWING	B R UW IH NG
BREWINGS	B R UW IH NG Z
BREWIS	B R UW IY Z
BREWISES	B R UW IY Z IH Z
BREWPUB	B R UW P AH B
BREWPUBS	B R UW P AH B Z
BREWS	B R UW Z
BRIDEWELL	B R AY D W EH L
BRIDEWELLS	B R AY D W EH L Z
BRIDGEWORK	B R IH JH W ER K
BRIDGEWORKS	B R IH JH W ER K S
BUGLEWEED	B Y UW G AH L W IY D
BUGLEWEEDS	B Y UW G AH L W IY D Z
CABBAGEWORM	K AE B IH JH W ER M
CABBAGEWORMS	K AE B IH JH W ER M Z
CABLEWAY	K EY B AH L W EY
CABLEWAYS	K EY B AH L W EY Z
CAKEWALK	K EY K W AO K
CAKEWALKED	K EY K W AO K T
CAKEWALKER	K EY K W AO K ER
CAKEWALKERS	K EY K W AO K ER Z
CAKEWALKING	K EY K W AO K IH NG
CAKEWALKS	K EY K W AO K S
CANDLEWICK	K AE N D AH L W IH K
CANDLEWICKS	K AE N D AH L W IH K S
CANDLEWOOD	K AE N D AH L W UH D
CANDLEWOODS	K AE N D AH L W UH D Z
CANEWARE	K EY N W EH R
CANEWARES	K EY N W EH R Z
CAPEWORK	K EY P W ER K
CAPEWORKS	K EY P W ER K S
CAREWORN	K EH R W OW R N
CARRIAGEWAY	K AE R IH JH W EY
CARRIAGEWAYS	K AE R IH JH W EY Z
CASEWORK	K EY S W ER K
CASEWORKER	K EY S W ER K ER
CASEWORKERS	K EY S W ER K ER Z
CASEWORKS	K EY S W ER K S
CASEWORM	K EY S W ER M
CASEWORMS	K EY S W ER M Z
CASHEW	K AE SH UW
CASHEWS	K AE SH UW Z
CAUSEWAY	K AA Z W EY
CAUSEWAY(2)	K AO Z W EY
CAUSEWAYED	K AO Z W EY D
CAUSEWAYING	K AO Z W EY IH NG
CAUSEWAYS	K AO Z W EY Z
CHEW	CH UW
CHEWABLE	CH UW AH B AH L
CHEWED	CH UW D
CHEWER	CH UW ER
CHEWERS	CH UW ER Z
CHEWIER	CH UW IY ER
CHEWIEST	CH UW IY AH S T
CHEWING	CH UW IH NG
CHEWINK	CH UW IH NG K
CHEWINKS	CH UW IH NG K S
CHEWS	CH UW Z
CHEWY	CH UW IY
CLERIHEW	K L AH R IH HH Y UW
CLERIHEWS	K L AH R IH HH Y UW Z
CLEW	K L UW
CLEWED	K L UW D
CLEWING	K L UW AH NG
CLEWS	K L UW Z
COLEWORT	K OW L UW AH R T
COLEWORTS	K OW L UW AH R T S
COMMITTEEWOMAN	K AH M IH T IY W UH M AH N
COMMITTEEWOMEN	K AH M IH T IY W IH M AH N
CORKSCREW	K AO R K S K R UW
CORKSCREWED	K AO R K S K R UW D
CORKSCREWING	K AO R K S K R UW IH NG
CORKSCREWS	K AO R K S K R UW Z
COUNTERVIEW	K AW N T ER V Y UW
COUNTERVIEWS	K AW N T ER V Y UW Z
COURSEWARE	K OW R S W EH R
COURSEWARES	K OW R S W EH R Z
CRACKLEWARE	K R AE K AH L W EH R
CRACKLEWARES	K R AE K AH L W EH R Z
CREW	K R UW
CREWCUT	K R UW K AH T
CREWCUTS	K R UW K AH T S
CREWED	K R UW D
CREWEL	K R UW AH L
CREWELS	K R UW AH L Z
CREWELWORK	K R UW AH L W ER K
CREWELWORKS	K R UW AH L W ER K S
CREWING	K R UW IH NG
CREWLESS	K R UW L AH S
CREWMAN	K R UW M AH N
CREWMATE	K R UW M EY T
CREWMATES	K R UW M EY T S
CREWMEN	K R UW M IH N
CREWNECK	K R UW N EH K
CREWNECKS	K R UW N EH K S
CREWS	K R UW Z
CURFEW	K ER F Y UW
CURFEWS	K ER F Y UW Z
CURLEW	K AH R L UW
CURLEWS	K AH R L UW Z
DAMEWORT	D AE M Y UW AH R T
DAMEWORTS	D AE M Y UW AH R T S
DANEWEED	D AE N Y UW IY D
DANEWEEDS	D AE N Y UW IY D Z
DANEWORT	D AE N Y UW AH R T
DANEWORTS	D AE N Y UW AH R T S
DEEWAN	D IY Y UW AH N
DEEWANS	D IY Y UW AH N Z
DEW	D UW
DEWAN	D UW AH N
DEWANS	D IY W AA N Z
DEWAR	D UW ER
DEWARS	D IY W AO R Z
DEWATER	D IY W AO T ER
DEWATERED	D IY W AO T ER D
DEWATERER	D IY W AO T ER ER
DEWATERERS	D IY W AO T ER ER Z
DEWATERING	D IY W AO T ER IH NG
DEWATERS	D IY W AO T ER Z
DEWAX	D IY W AE K S
DEWAXED	D IY W AE K S T
DEWAXES	D IY W AE K S IH Z
DEWAXING	D IY W AE K S IH NG
DEWBERRIES	D UW B EH R IY Z
DEWBERRY	D UW B EH R IY
DEWCLAW	D UW K L AO
DEWCLAWS	D UW K L AO Z
DEWDROP	D UW D R AA P
DEWDROPS	D UW D R AA P S
DEWED	D IY W EH D
DEWFALL	D UW F AO L
DEWFALLS	D UW F AO L Z
DEWIER	D UW IY ER
DEWIEST	D UW IY AH S T
DEWILY	D IY W AY L IY
DEWINESS	D IY W AY N AH S
DEWINESSES	D IY W AY N AH S IH Z
DEWING	D UW IH NG
DEWLAP	D UW L AE P
DEWLAPPED	D UW L AE P T
DEWLAPS	D UW L AE P S
DEWLESS	D UW L AH S
DEWOOL	D IY W UH L
DEWOOLED	D IY W UH L D
DEWOOLING	D IY W UW L IH NG
DEWOOLS	D IY W UH L Z
DEWORM	D IY W ER M
DEWORMED	D IY W ER M D
DEWORMER	D IY W ER M ER
DEWORMERS	D IY W ER M ER Z
DEWORMING	D IY W ER M IH NG
DEWORMS	D IY W ER M Z
DEWS	D UW Z
DEWY	D UW IY
DREW	D R UW
DRIVEWAY	D R AY V W EY
DRIVEWAYS	D R AY V W EY Z
DYEWEED	D AY W IY D
DYEWEEDS	D AY W IY D Z
DYEWOOD	D AY W UH D
DYEWOODS	D AY W UH D Z
EDGEWAYS	EH JH W EY Z
EDGEWISE	EH JH W AY Z
ELSEWHERE	EH L S W EH R
ENTRANCEWAY	EH N T R AH N S W EY
ENTRANCEWAYS	EH N T R AH N S W EY Z
EREWHILE	EH R UW AH L
EREWHILES	EH R UW AH L Z
ESCHEW	EH S CH UW
ESCHEWAL	IH S CH UW AH L
ESCHEWALS	IH S CH UW AH L Z
ESCHEWED	EH SH UW D
ESCHEWED(2)	EH S K Y UW D
ESCHEWING	EH SH UW IH NG
ESCHEWING(2)	EH S K Y UW IH NG
ESCHEWS	EH S CH UW Z
EWE	Y UW
EWER	Y UW ER
EWERS	Y UW ER Z
EWES	Y UW Z
EYEWASH	AY W AA SH
EYEWASHES	AY W AA SH IH Z
EYEWATER	AY W AO T ER
EYEWATERS	AY W AO T ER Z
EYEWEAR	AY W EH R
EYEWINK	AY W IH NG K
EYEWINKS	AY W IH NG K S
EYEWITNESS	AY W IH T N AH S
EYEWITNESSES	AY W IH T N AH S IH Z
FALSEWORK	F AO L S W ER K
FALSEWORKS	F AO L S W ER K S
FAREWELL	F EH R W EH L
FAREWELLED	F AE ER W EH L D
FAREWELLING	F AE ER W EH L IH NG
FAREWELLS	F EH R W EH L Z
FEVERFEW	F IY V ER F Y UW
FEVERFEWS	F IY V ER F Y UW Z
FEW	F Y UW
FEWER	F Y UW ER
FEWEST	F Y UW AH S T
FEWNESS	F Y UW N AH S
FEWNESSES	F Y UW N AH S IH Z
FEWTRILS	F Y UW T R AH L Z
FIREWALL	F AY R W AA L
FIREWALLED	F AY ER W AO L D
FIREWALLING	F AY ER W AO L IH NG
FIREWALLS	F AY ER W AO L Z
FIREWATER	F AY ER W AO T ER
FIREWATERS	F AY ER W AO T ER Z
FIREWEED	F AY ER W IY D
FIREWEEDS	F AY ER W IY D Z
FIREWOOD	F AY ER W UH D
FIREWOOD(2)	F AY R W UH D
FIREWOODS	F AY ER W UH D Z
FIREWORK	F AY R W ER K
FIREWORKS	F AY R W ER K S
FIREWORM	F AY ER W ER M
FIREWORMS	F AY ER W ER M Z
FITCHEW	F IH T CH UW
FITCHEWS	F IH T CH UW Z
FLEW	F L UW
FLEWS	F L UW Z
FLYBLEW	F L AY B L UW
FOREKNEW	F OW R N UW
FOREWARN	F AO R W AO R N
FOREWARNED	F AO R W AO R N D
FOREWARNING	F AO R W AO R N IH NG
FOREWARNS	F AO R W AO R N Z
FOREWENT	F AO R Y UW AH N T
FOREWING	F AO R W IH NG
FOREWINGS	F AO R W IH NG Z
FOREWOMAN	F AO R W UW M AH N
FOREWOMEN	F AO R W IH M EH N
FOREWORD	F AO R W ER D
FOREWORDS	F OW R W ER D Z
FOREWORN	F OW R W OW R N
FRAMEWORK	F R EY M W ER K
FRAMEWORKS	F R EY M W ER K S
FREEWARE	F R IY W EH R
FREEWARES	F R IY W EH R Z
FREEWAY	F R IY W EY
FREEWAYS	F R IY W EY Z
FREEWHEEL	F R IY W IY L
FREEWHEELED	F R IY W IY L D
FREEWHEELER	F R IY W IY L ER
FREEWHEELERS	F R IY W IY L ER Z
FREEWHEELING	F R IY W IY L IH NG
FREEWHEELING(2)	F R IY HH W IY L IH NG
FREEWHEELINGLY	F R IY W IY L IH NG L IY
FREEWHEELS	F R IY W IY L Z
FREEWILL	F R IY W IH L
FREEWRITING	F R IY R AY T IH NG
FREEWRITINGS	F R IY R AY T IH NG Z
GAPEWORM	G EY P W ER M
GAPEWORMS	G EY P W ER M Z
GATEWAY	G EY T W EY
GATEWAYS	G EY T W EY Z
GENTLEWOMAN	JH EH N T AH L W UH M AH N
GENTLEWOMAN(2)	JH EH N AH L W UH M AH N
GENTLEWOMEN	JH EH N T AH L W IH M AH N
GENTLEWOMEN(2)	JH EH N AH L W IH M AH N
GEWGAW	G Y UW G AA
GEWGAWS	JH UW G AH Z
GEWURZTRAMINER	JH UW AH R Z T R AH M AY N AH R
GEWURZTRAMINERS	JH UW AH R Z T R AE M AH N AH R Z
GRANDNEPHEW	G R AE N D N EH F Y UW
GRANDNEPHEWS	G R AE N D N EH F Y UW Z
GRANITEWARE	G R AE N AH T W EH R
GRANITEWARES	G R AE N AH T W EH R Z
GREASEWOOD	G R IY S W UH D
GREASEWOODS	G R IY S W UH D Z
GREW	G R UW
GREWSOME	G R UW S AH M
GREWSOMER	G R UW S AH M ER
GREWSOMEST	G R UW S AH M AH S T
GUIDEWAY	G AY D W EY
GUIDEWAYS	G AY D W EY Z
HANDSEWN	HH AE N D S OW N
HEREWITH	HH IH R W IH TH
HEW	HH Y UW
HEWABLE	HH Y UW AH B AH L
HEWED	HH Y UW D
HEWER	HH Y UW ER
HEWERS	HH Y UW ER Z
HEWING	HH Y UW IH NG
HEWN	HH Y UW N
HEWS	HH Y UW Z
HOMEBREW	HH OW M B R UW
HOMEBREWS	HH OW M B R UW Z
HOMEWARD	HH OW M W ER D
HOMEWARDS	HH OW M W ER D Z
HOMEWORK	HH OW M W ER K
HOMEWORKS	HH OW M W ER K S
HONEWORT	HH AA N Y UW AH R T
HONEWORTS	HH AA N Y UW AH R T S
HONEYDEW	HH AH N IY D UW
HONEYDEWS	HH AH N IY D UW Z
HORSEWEED	HH AO R S W IY D
HORSEWEEDS	HH AO R S W IY D Z
HORSEWHIP	HH AO R S W IH P
HORSEWHIPPED	HH AO R S W IH P T
HORSEWHIPPER	HH AO R S W IH P ER
HORSEWHIPPERS	HH AO R S W IH P ER Z
HORSEWHIPPING	HH AO R S W IH P IH NG
HORSEWHIPS	HH AO R S W IH P S
HORSEWOMAN	HH AO R S W UH M AH N
HORSEWOMEN	HH AO R S W IH M AH N
HOUSEWARES	HH AW S W EH R Z
HOUSEWARMING	HH AW S W AA M IH NG
HOUSEWARMINGS	HH AW S W AO R M IH NG Z
HOUSEWIFE	HH AW S W AY F
HOUSEWIFELINESS	HH AW S W AY F L IY N AH S
HOUSEWIFELINESSES	HH AW S W AY F L IY N AH S IH Z
HOUSEWIFELY	HH AW S W AY F L IY
HOUSEWIFERIES	HH AW S W AY F AH R IY Z
HOUSEWIFERY	HH AW S W AY F AH R IY
HOUSEWIFEY	HH AW S W AY F IY
HOUSEWIVES	HH AW S W AY V Z
HOUSEWORK	HH AW S W ER K
HOUSEWORKS	HH AW S W ER K S
INTERVIEW	IH N T ER V Y UW
INTERVIEWED	IH N T ER V Y UW D
INTERVIEWEE	IH N T ER V Y UW IY
INTERVIEWEES	IH N T ER V Y UW IY Z
INTERVIEWER	IH N T ER V Y UW ER
INTERVIEWERS	IH N T ER V Y UW ER Z
INTERVIEWING	IH N T ER V Y UW IH NG
INTERVIEWS	IH N T ER V Y UW Z
JACKSCREW	JH AE K S K R UW
JACKSCREWS	JH AE K S K R UW Z
JEW	JH UW
JEWED	JH UW D
JEWEL	JH UW AH L
JEWEL(2)	JH UW L
JEWELED	JH UW AH L D
JEWELER	JH UW AH L ER
JEWELER(2)	JH UW L ER
JEWELERS	JH UW AH L ER Z
JEWELERS(2)	JH UW L ER Z
JEWELING	JH UW AH L IH NG
JEWELLED	JH UW AH L D
JEWELLER	JH UW AH L ER
JEWELLERIES	JH UW AH L AH R IY Z
JEWELLERS	JH UW AH L ER Z
JEWELLERS(2)	JH UW L ER Z
JEWELLERY	JH UW AH L AH R IY
JEWELLIKE	JH UW AH L AY K
JEWELLING	JH UW AH L IH NG
JEWELRIES	JH UW AH L R IY Z
JEWELRY	JH UW AH L R IY
JEWELRY(2)	JH UW L R IY
JEWELRY(3)	JH UW L ER IY
JEWELS	JH UW AH L Z
JEWELS(2)	JH UW L Z
JEWELWEED	JH UW AH L W IY D
JEWELWEEDS	JH UW AH L W IY D Z
JEWFISH	JH UW F IH SH
JEWFISHES	JH UW F IH SH IH Z
JEWING	JH UW IH NG
JEWS	JH UW Z
KALEWIFE	K EY L W AY F
KALEWIVES	K EY L W AY V Z
KNEW	N UW
KNEW(2)	N Y UW
LACEWING	L EY S W IH NG
LACEWINGS	L EY S W IH NG Z
LACEWOOD	L EY S W UH D
LACEWOODS	L EY S W UH D Z
LACEWORK	L EY S W ER K
LACEWORKS	L EY S W ER K S
LANCEWOOD	L AE N S W UH D
LANCEWOODS	L AE N S W UH D Z
LANEWAY	L EY N W EY
LANEWAYS	L EY N W EY Z
LATEWOOD	L EY T W UH D
LATEWOODS	L EY T W UH D Z
LATTICEWORK	L AE T AH S W ER K
LATTICEWORKS	L AE T AH S W ER K S
LEADSCREW	L IY D S K R UW
LEADSCREWS	L IY D S K R UW Z
LEEWARD	L IY W ER D
LEEWARDS	L IY W ER D Z
LEEWAY	L IY W EY
LEEWAYS	L IY W EY Z
LEISUREWEAR	L EH ZH ER W AE ER
LEWD	L UW D
LEWDER	L UW D ER
LEWDEST	L UW D AH S T
LEWDLY	L UW D L IY
LEWDNESS	L UW D N AH S
LEWDNESSES	L UW D N AH S IH Z
LEWIS	L UW IH S
LEWISES	L UW AH S IH Z
LEWISITE	L UW AH S AY T
LEWISITES	L UW AH S AY T S
LEWISSON	L UW AH S AH N
LEWISSONS	L UW AH S AH N Z
LIFEWAY	L AY F W EY
LIFEWAYS	L AY F W EY Z
LIFEWORK	L AY F W ER K
LIFEWORKS	L AY F W ER K S
LIKEWISE	L AY K W AY Z
LIMEWATER	L AY M W AO T ER
LIMEWATERS	L AY M W AO T ER Z
LOUNGEWEAR	L AW N JH W AE ER
LOUSEWORT	L AW S UW AH R T
LOUSEWORTS	L AW S UW AH R T S
LUKEWARM	L UW K W AO R M
LUKEWARMLY	L UW K W AO R M L IY
LUKEWARMNESS	L UW K W AO R M N AH S
LUKEWARMNESSES	L UW K W AO R M N AH S IH Z
MAKEWEIGHT	M EY K W EY T
MAKEWEIGHTS	M EY K W EY T S
MEW	M Y UW
MEWED	M Y UW D
MEWING	M Y UW IH NG
MEWL	M Y UW L
MEWLED	M Y UW L EH D
MEWLER	M Y UW L AH R
MEWLERS	M Y UW L AH R Z
MEWLING	M Y UW L IH NG
MEWLS	M Y UW L Z
MEWS	M Y UW Z
MICROBREW	M AY K R OW B R UW
MICROBREWER	M AY K R OW B R UW ER
MICROBREWERIES	M AY K R OW B R UW ER IY Z
MICROBREWERS	M AY K R OW B R UW ER Z
MICROBREWERY	M AY K R OW B R UW ER IY
MICROBREWING	M AY K R OW B R UW IH NG
MICROBREWINGS	M AY K R OW B R UW IH NG Z
MICROBREWS	M AY K R OW B R UW Z
MIDDLEWEIGHT	M IH D AH L W EY T
MIDDLEWEIGHTS	M IH D AH L W EY T S
MILDEW	M IH L D UW
MILDEWED	M IH L D UW D
MILDEWING	M IH L D UW IH NG
MILDEWS	M IH L D UW Z
MILDEWY	M IH L D UW IY
MISDREW	M IH S D R UW
MISGREW	M IH S G R UW
MISKNEW	M IH S N UW
MISTHREW	M IH S TH R UW
MITREWORT	M IH T R UW AH R T
MITREWORTS	M IH T R UW AH R T S
NEEDLEWOMAN	N IY D AH L W UH M AH N
NEEDLEWOMEN	N IY D AH L W IH M AH N
NEEDLEWORK	N IY D AH L W ER K
NEEDLEWORKER	N IY D AH L W ER K ER
NEEDLEWORKERS	N IY D AH L W ER K ER Z
NEEDLEWORKS	N IY D AH L W ER K S
NEPHEW	N EH F Y UW
NEPHEWS	N EH F Y UW Z
NEW	N UW
NEW(2)	N Y UW
NEWBIE	N UW B IY
NEWBIES	N UW B AY Z
NEWBORN	N UW B AO R N
NEWBORNS	N UW B AO R N Z
NEWCOMER	N UW K AH M ER
NEWCOMERS	N UW K AH M ER Z
NEWEL	N UW AH L
NEWELS	N UW AH L Z
NEWER	N UW ER
NEWEST	N UW AH S T
NEWFANGLED	N UW F AE NG G AH L D
NEWFANGLEDNESS	N UW F AE NG L EH D N AH S
NEWFANGLEDNESSES	N UW F AE NG L EH D N AH S IH Z
NEWFOUND	N UW F AW N D
NEWIE	N UW IY
NEWIES	N UW IY Z
NEWISH	N UW IH SH
NEWLY	N UW L IY
NEWLYWED	N UW L IY W EH D
NEWLYWEDS	N UW L IY W EH D Z
NEWMARKET	N UW M AA R K AH T
NEWMARKETS	N UW M AA R K AH T S
NEWMOWN	N Y UW M OW N
NEWNESS	N UW N AH S
NEWNESSES	N UW N AH S IH Z
NEWS	N UW Z
NEWS(2)	N Y UW Z
NEWSAGENT	N UW Z IH JH AH N T
NEWSAGENTS	N UW Z IH JH AH N T S
NEWSBOY	N UW Z B OY
NEWSBOYS	N UW Z B OY Z
NEWSBREAK	N UW Z B R EY K
NEWSBREAKS	N UW Z B R EY K S
NEWSCAST	N UW Z K AE S T
NEWSCASTER	N UW Z K AE S T ER
NEWSCASTERS	N UW Z K AE S T ER Z
NEWSCASTS	N UW Z K AE S T S
NEWSDEALER	N UW Z D IY L ER
NEWSDEALERS	N UW Z D IY L ER Z
NEWSGROUP	N UW Z G R UW P
NEWSGROUPS	N UW Z G R UW P S
NEWSHAWK	N UW Z HH AO K
NEWSHAWKS	N UW Z HH AO K S
NEWSHOUND	N UW Z HH AW N D
NEWSHOUNDS	N UW Z HH AW N D Z
NEWSIE	N UW Z IY
NEWSIER	N UW Z IY ER
NEWSIES	N UW Z IY Z
NEWSIEST	N UW Z IY AH S T
NEWSINESS	N UW Z IY N AH S
NEWSINESSES	N UW Z IY N AH S IH Z
NEWSLESS	N UW Z L AH S
NEWSLETTER	N UW Z L EH T ER
NEWSLETTERS	N UW Z L EH T ER Z
NEWSMAGAZINE	N UW Z M AE G AH Z IY N
NEWSMAGAZINES	N UW Z M AE G AH Z IY N Z
NEWSMAKER	N UW Z M EY K ER
NEWSMAKERS	N UW Z M EY K ER Z
NEWSMAN	N UW Z M AE N
NEWSMAN(2)	N UW Z M AH N
NEWSMEN	N UW Z M IH N
NEWSMONGER	N UW Z M AH NG G ER
NEWSMONGERS	N UW Z M AH NG G ER Z
NEWSPAPER	N UW Z P EY P ER
NEWSPAPERED	N UW Z P EY P ER D
NEWSPAPERING	N UW Z P EY P ER IH NG
NEWSPAPERMAN	N UW Z P EY P ER M AE N
NEWSPAPERMEN	N UW Z P AE P ER M AH N
NEWSPAPERS	N UW Z P EY P ER Z
NEWSPAPERWOMAN	N UW Z P EY P ER W UH M AH N
NEWSPAPERWOMEN	N UW Z P EY P ER W IH M AH N
NEWSPEAK	N UW S P IY K
NEWSPEAKS	N UW S P IY K S
NEWSPEOPLE	N UW Z P IY P AH L
NEWSPERSON	N UW Z P ER S AH N
NEWSPERSONS	N UW Z P ER S AH N Z
NEWSPRINT	N UW Z P R IH N T
NEWSPRINTS	N UW S P R IH N T S
NEWSREADER	N UW Z R IY D ER
NEWSREADERS	N UW Z R IY D ER Z
NEWSREEL	N UW Z R IY L
NEWSREELS	N UW Z R IY L Z
NEWSROOM	N UW Z R UW M
NEWSROOMS	N UW Z R UW M Z
NEWSSTAND	N UW Z S T AE N D
NEWSSTANDS	N UW Z S T AE N D Z
NEWSWEEKLIES	N UW Z W IY K L IY Z
NEWSWEEKLY	N UW Z W IY K L IY
NEWSWOMAN	N UW Z W UH M AH N
NEWSWOMEN	N UW Z W IH M AH N
NEWSWORTHINESS	N UW Z W ER DH IY N AH S
NEWSWORTHINESSES	N UW Z W ER DH IY N AH S IH Z
NEWSWORTHY	N UW Z W ER DH IY
NEWSWRITING	N UW Z R AY T IH NG
NEWSWRITINGS	N UW Z R AY T IH NG Z
NEWSY	N UW Z IY
NEWT	N UW T
NEWTON	N UW T AH N
NEWTONS	N UW T AH N Z
NEWTS	N UW T S
NOBLEWOMAN	N OW B AH L W UH M AH N
NOBLEWOMEN	N OW B AH L W IH M AH N
NONNEWS	N AA N UW Z
NONRENEWABLE	N AA N R IY N UW AH B AH L
NONRENEWAL	N AA N R IY N UW AH L
NONRENEWALS	N AA N R IY N UW AH L Z
NONVIEWER	N AA N V Y UW ER
NONVIEWERS	N AA N V Y UW ER Z
NOSEWHEEL	N OW Z W IY L
NOSEWHEELS	N OW Z W IY L Z
NOTEWORTHILY	N OW T W ER DH IY L IY
NOTEWORTHINESS	N OW T W ER DH IY N AH S
NOTEWORTHINESSES	N OW T W ER DH IY N AH S IH Z
NOTEWORTHY	N OW T W ER DH IY
ORANGEWOOD	AO R IH N JH W UH D
ORANGEWOODS	AO R IH N JH W UH D Z
OUTDREW	AW T D R UW
OUTFLEW	AW T F L UW
OUTGREW	AW T G R UW
OUTTHREW	AW T TH R UW
OVERBEJEWELED	OW V ER B IY JH UW AH L D
OVERBLEW	OW V ER B L UW
OVERDREW	OW V ER D R UW
OVERFLEW	OW V ER F L UW
OVERGREW	OW V ER G R UW
OVERLEWD	OW V ER L UW D
OVERNEW	OW V ER N UW
OVERSEW	OW V ER S OW
OVERSEWED	OW V ER S OW D
OVERSEWING	OW V ER S OW IH NG
OVERSEWN	OW V ER S OW N
OVERSEWS	OW V ER S OW Z
OVERSTREW	AH V AH R S T R UW
OVERSTREWED	AH V AH R S T R UW D
OVERSTREWING	AH V AH R S T R UW AH NG
OVERSTREWN	OW V ER S T R UW N
OVERSTREWS	AH V AH R S T R UW Z
OVERTHREW	OW V ER TH R UW
OVERVIEW	OW V ER V Y UW
OVERVIEWS	OW V ER V Y UW Z
PALEWAYS	P EY L W EY Z
PALEWISE	P EY L W AY Z
PASSAGEWAY	P AE S AH JH W EY
PASSAGEWAY(2)	P AE S IH JH W EY
PASSAGEWAYS	P AE S IH JH W EY Z
PASSAGEWORK	P AE S IH JH W ER K
PASSAGEWORKS	P AE S IH JH W ER K S
PEEWEE	P IY W IY
PEEWEES	P IY W IY Z
PEEWIT	P IY W IH T
PEEWITS	P IY W IH T S
PESEWA	P EH S UW AH
PESEWAS	P EH S UW AH Z
PEW	P Y UW
PEWEE	P Y UW IY
PEWEES	P Y UW IY Z
PEWHOLDER	P Y UW HH OW L D ER
PEWHOLDERS	P Y UW HH OW L D ER Z
PEWIT	P Y UW AH T
PEWITS	P Y UW AH T S
PEWS	P Y UW Z
PEWTER	P Y UW T ER
PEWTERER	P Y UW T IY R AH R
PEWTERERS	P Y UW T AH R AH R Z
PEWTERS	P Y UW T AH R Z
PHEW	F Y UW
PIECEWISE	P IY S W AY Z
PIECEWORK	P IY S W ER K
PIECEWORKER	P IY S W ER K ER
PIECEWORKERS	P IY S W ER K ER Z
PIECEWORKS	P IY S W ER K S
PILEWORT	P IH L UW AH R T
PILEWORTS	P IH L UW AH R T S
PINEWOOD	P AY N W UH D
PINEWOODS	P AY N W UH D Z
PIPSISSEWA	P IH P S IH S UW AH
PIPSISSEWAS	P IH P S IH S UW AH Z
PLEW	P L UW
PLEWS	P L UW Z
POKEWEED	P OW K W IY D
POKEWEEDS	P OW K W IY D Z
POLEWARD	P OW L W ER D
POLICEWOMAN	P AH L IY S W UH M AH N
POLICEWOMEN	P AH L IY S W IH M EH N
PRAISEWORTHILY	P R EY Z W ER DH IY L IY
PRAISEWORTHINESS	P R EY Z W ER DH IY N AH S
PRAISEWORTHINESSES	P R EY Z W ER DH IY N AH S IH Z
PRAISEWORTHY	P R EY Z W ER DH IY
PREINTERVIEW	P R IY IH N T ER V Y UW
PREINTERVIEWED	P R IY IH N T ER V Y UW D
PREINTERVIEWING	P R IY IH N T ER V Y UW IH NG
PREINTERVIEWS	P R IY IH N T ER V Y UW Z
PREREVIEW	P R IY R IY V Y UW
PREVIEW	P R IY V Y UW
PREVIEWED	P R IY V Y UW D
PREVIEWER	P R IY V Y UW ER
PREVIEWERS	P R IY V Y UW ER Z
PREVIEWING	P R IY V Y UW IH NG
PREVIEWS	P R IY V Y UW Z
PREWAR	P R IY W AO R
PREWARM	P R IY W AO R M
PREWARMED	P R IY W AO R M D
PREWARMING	P R IY W AO R M IH NG
PREWARMS	P R IY W AO R M Z
PREWARN	P R IY W AO R N
PREWARNED	P R IY W AO R N D
PREWARNING	P R IY W AO R N IH NG
PREWARNS	P R IY W AO R N Z
PREWASH	P R IY W AA SH
PREWASHED	P R IY W AA SH T
PREWASHES	P R IY W AA SH IH Z
PREWASHING	P R IY W AA SH IH NG
PREWEANING	P R IY W IY N IH NG
PREWORK	P R IY W ER K
PREWRAP	P R IY R AE P
PREWRAPPED	P R IY R AE P T
PREWRAPPING	P R IY R AE P IH NG
PREWRAPS	P R IY R AE P S
PREWRITING	P R IY R AY T IH NG
PREWRITINGS	P R IY R AY T IH NG Z
PRIZEWINNER	P R AY Z W IH N ER
PRIZEWINNERS	P R AY Z W IH N ER Z
PRIZEWINNING	P R AY Z W IH N IH NG
PURVIEW	P ER V Y UW
PURVIEWS	P AH R V IY W Z
RACEWALKER	R EY S W AO K ER
RACEWALKERS	R EY S W AO K ER Z
RACEWALKING	R EY S W AO K IH NG
RACEWALKINGS	R EY S W AO K IH NG Z
RACEWAY	R EY S W EY
RACEWAYS	R EY S W EY Z
RECHEW	R IY CH UW
RECHEWED	R IY CH UW D
RECHEWING	R IY CH UW IH NG
RECHEWS	R IY CH UW Z
REDREW	R IY D R UW
REFLEW	R IY F L UW
REGREW	R IY G R UW
REINTERVIEW	R IY IH N T ER V Y UW
REINTERVIEWED	R IY IH N T ER V Y UW D
REINTERVIEWING	R IY IH N T ER V Y UW IH NG
REINTERVIEWS	R IY IH N T ER V Y UW Z
RENEW	R IH N UW
RENEWABILITIES	R IY N UW AH B IH L AH T EH Z
RENEWABILITY	R IY N UW AH B IH L AH T EH
RENEWABLE	R IY N UW AH B AH L
RENEWABLY	R IY N UW AH B L IY
RENEWAL	R IH N UW AH L
RENEWALS	R IH N UW AH L Z
RENEWED	R IH N UW D
RENEWED(2)	R IY N UW D
RENEWER	R IY N UW ER
RENEWERS	R IY N UW ER Z
RENEWING	R IH N UW IH NG
RENEWS	R IH N UW Z
REREVIEW	R IY R IY V Y UW
REREVIEWED	R IY R IY V Y UW D
REREVIEWING	R IY R IY V Y UW IH NG
REREVIEWS	R IY R IY V Y UW Z
REREWARD	R IY R IH W AO R D
REREWARDS	R IY R IH W AO R D Z
RESEW	R IY S OW
RESEWED	R IY S OW D
RESEWING	R IY S OW IH NG
RESEWN	R IY S OW N
RESEWS	R IY S OW Z
REVIEW	R IY V Y UW
REVIEWABLE	R IY V Y UW AH B AH L
REVIEWAL	R IY V Y UW AH L
REVIEWALS	R IY V Y UW AH L Z
REVIEWED	R IY V Y UW D
REVIEWER	R IY V Y UW ER
REVIEWERS	R IY V Y UW ER Z
REVIEWING	R IY V Y UW IH NG
REVIEWS	R IY V Y UW Z
REVIEWS(2)	R AH V Y UW Z
REWAKE	R IY W EY K
REWAKED	R IY W EY K T
REWAKEN	R IY W EY K AH N
REWAKENED	R IY W EY K AH N D
REWAKENING	R IY W EY K AH N IH NG
REWAKENS	R IY W EY K AH N Z
REWAKES	R IY W EY K S
REWAKING	R IY W EY K IH NG
REWAN	R IY W AA N
REWARD	R IH W AO R D
REWARD(2)	R IY W AO R D
REWARDABLE	R IH W AO R D AH B AH L
REWARDED	R IH W AO R D IH D
REWARDED(2)	R IY W AO R D AH D
REWARDED(3)	R IY W AO R D IH D
REWARDER	R IH W AO R D ER
REWARDERS	R IH W AO R D ER Z
REWARDING	R IH W AO R D IH NG
REWARDING(2)	R IY W AO R D IH NG
REWARDINGLY	R IH W AO R D IH NG L IY
REWARDS	R IH W AO R D Z
REWARDS(2)	R IY W AO R D Z
REWARM	R IY W AO R M
REWARMED	R IY W AO R M D
REWARMING	R IY W AO R M IH NG
REWARMS	R IY W AO R M Z
REWASH	R IY W AA SH
REWASHED	R IY W AA SH T
REWASHES	R IY W AA SH IH Z
REWASHING	R IY W AA SH IH NG
REWAX	R IY W AE K S
REWAXED	R IY W AE K S T
REWAXES	R IY W AE K S IH Z
REWAXING	R IY W AE K S IH NG
REWEAVE	R IY W IY V
REWEAVED	R IY W IY V D
REWEAVES	R IY W IY V Z
REWEAVING	R IY W IY V IH NG
REWED	R IY W EH D
REWEDDED	R IY W EH D IH D
REWEDDING	R IY W EH D IH NG
REWEDS	R IY W EH D Z
REWEIGH	R IY W EY
REWEIGHED	R IY W EY D
REWEIGHING	R IY W EY IH NG
REWEIGHS	R IY W EY Z
REWELD	R IY W EH L D
REWELDED	R IY W EH L D IH D
REWELDING	R IY W EH L D IH NG
REWELDS	R IY W EH L D Z
REWET	R IY W EH T
REWETS	R IY W EH T S
REWETTED	R IY W EH T IH D
REWETTING	R IY W EH T IH NG
REWIDEN	R IY W AY D AH N
REWIDENED	R IY W AY D AH N D
REWIDENING	R IY W AY D AH N IH NG
REWIDENS	R IY W AY D AH N Z
REWIN	R IY W IH N
REWIND	R IY W AY N D
REWINDED	R IY W IH N D AH D
REWINDER	R IY W IH N D ER
REWINDERS	R IY W IH N D ER Z
REWINDING	R IY W IH N D IH NG
REWINDS	R IY W IH N D Z
REWINNING	R IY W IH N IH NG
REWINS	R IY W IH N Z
REWIRE	R IY W AY ER
REWIRED	R IY W AY ER D
REWIRES	R IY W AY ER Z
REWIRING	R IY W AY ER IH NG
REWOKE	R IY W OW K
REWOKEN	R IY W OW K AH N
REWON	R IY W AH N
REWORD	R IY W ER D
REWORDED	R IY W ER D IH D
REWORDING	R IY W ER D IH NG
REWORDS	R IY W ER D Z
REWORK	R IY W ER K
REWORKED	R IY W ER K T
REWORKING	R IY W ER K IH NG
REWORKS	R IY W ER K S
REWOUND	R IY W UW N D
REWOVE	R IY W OW V
REWOVEN	R IY W OW V AH N
REWRAP	R IY R AE P
REWRAPPED	R IY R AE P T
REWRAPPING	R IY R AE P IH NG
REWRAPS	R IY R AE P S
REWRAPT	R AH R AE P T
REWRITE	R IY R AY T
REWRITER	R IY R AY T ER
REWRITERS	R IY R AY T ER Z
REWRITES	R IY R AY T S
REWRITING	R IY R AY T IH NG
REWRITTEN	R IY R IH T AH N
REWROTE	R IY R OW T
REWROUGHT	R IY R AO T
ROPEWALK	R OW P W AO K
ROPEWALKER	R OW P W AO K ER
ROPEWALKERS	R OW P W AO K ER Z
ROPEWALKS	R OW P W AO K S
ROPEWAY	R OW P W EY
ROPEWAYS	R OW P W EY Z
ROSEWATER	R OW Z W AO T ER
ROSEWOOD	R OW Z W UH D
ROSEWOODS	R OW Z W UH D Z
ROUGHHEW	R AH F HH Y UW
ROUGHHEWED	R AH F HH Y UW D
ROUGHHEWING	R AH F HH Y UW IH NG
ROUGHHEWN	R AH F HH Y UW N
ROUGHHEWS	R AH F HH Y UW Z
ROUTEWAY	R UW T W EY
ROUTEWAYS	R UW T W EY Z
SCREW	S K R UW
SCREWBALL	S K R UW B AO L
SCREWBALLS	S K R UW B AO L Z
SCREWBEAN	S K R UW B IY N
SCREWBEANS	S K R UW B IY N Z
SCREWDRIVER	S K R UW D R AY V ER
SCREWDRIVERS	S K R UW D R AY V ER Z
SCREWED	S K R UW D
SCREWER	S K R UW ER
SCREWERS	S K R UW ER Z
SCREWIER	S K R UW IY ER
SCREWIEST	S K R UW IY AH S T
SCREWINESS	S K R UW IY N AH S
SCREWINESSES	S K R UW IY N AH S IH Z
SCREWING	S K R UW IH NG
SCREWLIKE	S K R UW L AY K
SCREWS	S K R UW Z
SCREWUP	S K R UW AH P
SCREWUPS	S K R UW AH P S
SCREWWORM	S K R UW W ER M
SCREWWORMS	S K R UW W ER M Z
SCREWY	S K R UW IY
SERVICEWOMAN	S ER V AH S W UH M AH N
SERVICEWOMEN	S ER V AH S W IH M AH N
SETSCREW	S EH T S K R UW
SETSCREWS	S EH T S K R UW Z
SEW	S OW
SEWABILITIES	S OW AH B IH L AH T EH Z
SEWABILITY	S OW AH B IH L AH T EH
SEWABLE	S OW AH B AH L
SEWAGE	S UW AH JH
SEWAGE(2)	S UW IH JH
SEWAGES	S UW IH JH IH Z
SEWAN	S UW AH N
SEWANS	S UW AH N Z
SEWAR	S OW ER
SEWARS	S OW ER Z
SEWED	S OW D
SEWER	S UW ER
SEWERAGE	S UW ER IH JH
SEWERAGES	S UW ER IH JH IH Z
SEWERED	S UW ER D
SEWERING	S UW ER IH NG
SEWERS	S UW ER Z
SEWING	S OW IH NG
SEWINGS	S OW IH NG Z
SEWN	S OW N
SEWS	S OW Z
SHAREWARE	SH EH R W EH R
SHAREWARES	SH EH R W EH R Z
SHEW	SH UW
SHEWBREAD	SH UW B R IY D
SHEWBREADS	SH UW B R IY D Z
SHEWED	SH UW D
SHEWER	SH UW AH R
SHEWERS	SH UW AH R Z
SHEWING	SH UW AH NG
SHEWN	SH UW N
SHEWS	SH UW Z
SHOREWARD	SH AO R W ER D
SHOREWARDS	SH OW R W ER D Z
SHREW	SH R UW
SHREWD	SH R UW D
SHREWDER	SH R UW D ER
SHREWDEST	SH R UW D AH S T
SHREWDIE	SH R UW D IY
SHREWDIES	SH R UW D IY Z
SHREWDLY	SH R UW D L IY
SHREWDNESS	SH R UW D N AH S
SHREWDNESSES	SH R UW D N AH S IH Z
SHREWED	SH R UW D
SHREWING	SH R UW IH NG
SHREWISH	SH R UW IH SH
SHREWISHLY	SH R UW IH SH L IY
SHREWISHNESS	SH R UW IH SH N AH S
SHREWISHNESSES	SH R UW IH SH N AH S IH Z
SHREWLIKE	SH R UW L AY K
SHREWS	SH R UW Z
SIDEWALK	S AY D W AO K
SIDEWALKS	S AY D W AO K S
SIDEWALL	S AY D W AO L
SIDEWALLS	S AY D W AO L Z
SIDEWARD	S AY D W ER D
SIDEWARDS	S AY D W ER D Z
SIDEWAY	S AY D W EY
SIDEWAYS	S AY D W EY Z
SIDEWINDER	S AY D W AY N D ER
SIDEWINDERS	S AY D W IH N D ER Z
SIDEWISE	S AY D W AY Z
SINEW	S IH N Y UW
SINEWED	S IH N Y UW D
SINEWING	S IH N Y UW IH NG
SINEWS	S IH N Y UW Z
SINEWY	S IH N Y UW IY
SKEW	S K Y UW
SKEWBACK	S K Y UW B AH K
SKEWBACKS	S K Y UW B AH K S
SKEWBALD	S K Y UW B AH L D
SKEWBALDS	S K Y UW B AH L D Z
SKEWED	S K Y UW D
SKEWER	S K Y UW ER
SKEWERED	S K Y UW ER D
SKEWERING	S K Y UW ER IH NG
SKEWERS	S K Y UW ER Z
SKEWING	S K Y UW IH NG
SKEWNESS	S K Y UW N AH S
SKEWNESSES	S K Y UW N EH S AH Z
SKEWS	S K Y UW Z
SLEW	S L UW
SLEWED	S L UW D
SLEWING	S L UW AH NG
SLEWS	S L UW Z
SLIDEWAY	S L AY D W EY
SLIDEWAYS	S L AY D W EY Z
SLUICEWAY	S L UW S W EY
SLUICEWAYS	S L UW S W EY Z
SMEW	S M Y UW
SMEWS	S M Y UW Z
SNAKEWEED	S N EY K W IY D
SNAKEWEEDS	S N EY K W IY D Z
SNEEZEWEED	S N IY Z W IY D
SNEEZEWEEDS	S N IY Z W IY D Z
SOMEWAY	S AA M Y UW EY IY
SOMEWAYS	S AA M Y UW EY Z
SOMEWHAT	S AH M W AH T
SOMEWHAT(2)	S AH M HH W AH T
SOMEWHATS	S AH M W AH T S
SOMEWHEN	S AA M Y UW AH N
SOMEWHERE	S AH M W EH R
SOMEWHERES	S AH M W EH R Z
SOMEWHITHER	S AA M Y UW HH AH DH AH R
SOMEWISE	S OW M AH W AY Z
SPACEWALK	S P EY S W AA K
SPACEWALKED	S P EY S W AO K T
SPACEWALKER	S P EY S W AO K ER
SPACEWALKERS	S P EY S W AO K ER Z
SPACEWALKING	S P EY S W AA K IH NG
SPACEWALKS	S P EY S W AA K S
SPACEWARD	S P EY S W ER D
SPADEWORK	S P EY D W ER K
SPADEWORKS	S P EY D W ER K S
SPEW	S P Y UW
SPEWED	S P Y UW D
SPEWER	S P Y UW ER
SPEWERS	S P Y UW ER Z
SPEWING	S P Y UW IH NG
SPEWS	S P Y UW Z
SPONGEWARE	S P AH N JH W EH R
SPONGEWARES	S P AH N JH W EH R Z
STATEWIDE	S T EY T W AY D
STEERAGEWAY	S T IH ER EY JH W EY
STEERAGEWAYS	S T IH ER EY JH W EY Z
STEW	S T UW
STEWARD	S T UW ER D
STEWARDED	S T UW ER D IH D
STEWARDESS	S T UW ER D AH S
STEWARDESSES	S T UW ER D AH S IH Z
STEWARDING	S T UW ER D IH NG
STEWARDS	S T UW ER D Z
STEWARDSHIP	S T UW ER D SH IH P
STEWARDSHIPS	S T UW ER D SH IH P S
STEWBUM	S T UW B AH M
STEWBUMS	S T UW B AH M Z
STEWED	S T UW D
STEWING	S T UW IH NG
STEWPAN	S T UW P AE N
STEWPANS	S T UW P AE N Z
STEWS	S T UW Z
STONEWALL	S T OW N W AO L
STONEWALLED	S T OW N W AO L D
STONEWALLER	S T OW N W AO L ER
STONEWALLERS	S T OW N W AO L ER Z
STONEWALLING	S T OW N W AO L IH NG
STONEWALLS	S T OW N W AO L Z
STONEWARE	S T OW N W EH R
STONEWARES	S T OW N W EH R Z
STONEWASHED	S T OW N W AA SH T
STONEWORK	S T OW N W ER K
STONEWORKS	S T OW N W ER K S
STONEWORT	S T AA N Y UW AH R T
STONEWORTS	S T AA N Y UW AH R T S
STOREWIDE	S T OW R W AY D
STREW	S T R UW
STREWED	S T R UW D
STREWER	S T R UW AH R
STREWERS	S T R UW AH R Z
STREWING	S T R UW AH NG
STREWMENT	S T R UW M AH N T
STREWMENTS	S T R UW M AH N T S
STREWN	S T R UW N
STREWS	S T R UW Z
SUNDEW	S AH N D UW
SUNDEWS	S AH N D UW Z
TABLEWARE	T EY B AH L W EH R
TABLEWARES	T EY B AH L W EH R Z
TAPEWORM	T EY P W ER M
TAPEWORMS	T EY P W ER M Z
TELETYPEWRITER	T EH L AH T AY P R AY T ER
TELETYPEWRITERS	T EH L AH T AY P R AY T ER Z
TELEVIEW	T EH L AH V Y UW
TELEVIEWED	T EH L AH V Y UW D
TELEVIEWER	T EH L AH V Y UW ER
TELEVIEWERS	T EH L AH V Y UW ER Z
TELEVIEWING	T EH L AH V Y UW IH NG
TELEVIEWS	T EH L AH V Y UW Z
TEW	T UW
TEWED	T Y UW D
TEWING	T Y UW AH NG
TEWS	CH UW Z
THEREWITH	DH AE R W IH TH
THEREWITHAL	TH AH R UW AH TH AH L
THEW	TH UW
THEWIER	TH UW AY AH R
THEWIEST	TH UW AY AH S T
THEWLESS	TH UW L AH S
THEWS	TH UW Z
THEWY	TH UW IY
THIMBLEWEED	TH IH M B AH L W IY D
THIMBLEWEEDS	TH IH M B AH L W IY D Z
THREW	TH R UW
THUMBSCREW	TH AH M S K R UW
THUMBSCREWS	TH AH M S K R UW Z
TIDEWATER	T AY D W AO T ER
TIDEWATERS	T AY D W AO T ER Z
TIDEWAY	T AY D W EY
TIDEWAYS	T AY D W EY Z
TIMEWORK	T AY M W ER K
TIMEWORKER	T AY M W ER K ER
TIMEWORKERS	T AY M W ER K ER Z
TIMEWORKS	T AY M W ER K S
TIMEWORN	T AY M W OW R N
TRESTLEWORK	T R EH S AH L W ER K
TRESTLEWORKS	T R EH S AH L W ER K S
TREWS	T R UW Z
TUBEWORK	T UW B W ER K
TUBEWORKS	T UW B W ER K S
TUMBLEWEED	T AH M B AH L W IY D
TUMBLEWEEDS	T AH M B AH L W IY D Z
TYPEWRITE	T AY P R AY T
TYPEWRITER	T AY P R AY T ER
TYPEWRITERS	T AY P R AY T ER Z
TYPEWRITES	T AY P R AY T S
TYPEWRITING	T AY P R AY T IH NG
TYPEWRITINGS	T AY P R AY T IH NG Z
TYPEWRITTEN	T AY P R IH T AH N
TYPEWROTE	T AY P R OW T
UNCHEWABLE	AH N CH UW AH B AH L
UNCHEWED	AH N CH UW D
UNDREW	AH N D R UW
UNHEWN	AH N HH Y UW N
UNMEW	AH N M Y UW
UNMEWED	AH N M Y UW D
UNMEWING	AH N M Y UW IH NG
UNMEWS	AH N M Y UW Z
UNNEWSWORTHY	AH N UW Z W ER DH IY
UNREVIEWABLE	AH N R IY V Y UW AH B AH L
UNREVIEWED	AH N R IY V Y UW D
UNREWARDED	AH N R IH W AO R D IH D
UNREWARDING	AH N R IH W AO R D IH NG
UNSCREW	AH N S K R UW
UNSCREWED	AH N S K R UW D
UNSCREWING	AH N S K R UW IH NG
UNSCREWS	AH N S K R UW Z
UNSEW	AH N S OW
UNSEWED	AH N S OW D
UNSEWING	AH N S OW IH NG
UNSEWN	AH N S OW N
UNSEWS	AH N S OW Z
UPGREW	AH P G R UW
UPTHREW	AH P TH R UW
VIEW	V Y UW
VIEWABLE	V Y UW AH B AH L
VIEWDATA	V IY W D AH T AH
VIEWDATAS	V IY W D AH T AH Z
VIEWED	V Y UW D
VIEWER	V Y UW ER
VIEWERS	V Y UW ER Z
VIEWERSHIP	V Y UW ER SH IH P
VIEWERSHIPS	V Y UW ER SH IH P S
VIEWFINDER	V Y UW F AY N D ER
VIEWFINDERS	V Y UW F AY N D ER Z
VIEWIER	V Y UW IY ER
VIEWIEST	V Y UW IY AH S T
VIEWING	V Y UW IH NG
VIEWINGS	V Y UW IH NG Z
VIEWLESS	V Y UW L AH S
VIEWLESSLY	V Y UW L AH S L IY
VIEWPOINT	V Y UW P OY N T
VIEWPOINTS	V Y UW P OY N T S
VIEWS	V Y UW Z
VIEWY	V Y UW IY
WAGEWORKER	W EY JH W ER K ER
WAGEWORKERS	W EY JH W ER K ER Z
WASTEWATER	W EY S T W AO T ER
WASTEWATERS	W EY S T W AO T ER Z
WASTEWAY	W EY S T W EY
WASTEWAYS	W EY S T W EY Z
WEEWEE	W IY W IY
WEEWEED	W IY W IY D
WEEWEEING	W IY W IY IH NG
WEEWEES	W IY W IY Z
WEREWOLF	W EH R W UH L F
WEREWOLVES	W EH R W UH L V Z
WHEREWITH	W EH ER W IH TH
WHEREWITHAL	W EH R W IH DH AO L
WHEREWITHAL(2)	HH W EH R W IH DH AO L
WHEREWITHALS	W AH R UW AH TH AH L Z
WHEW	W UW
WHEW(2)	HH W UW
WHEW(3)	HH Y UW
WHEWS	W UW Z
WHITEWALL	W AY T W AO L
WHITEWALLS	W AY T W AO L Z
WHITEWASH	W AY T W AA SH
WHITEWASH(2)	HH W AY T W AA SH
WHITEWASHED	W AY T W AA SH T
WHITEWASHED(2)	HH W AY T W AA SH T
WHITEWASHER	W AY T W AA SH ER
WHITEWASHERS	W AY T W AA SH ER Z
WHITEWASHES	W AY T W AA SH IH Z
WHITEWASHING	W AY T W AA SH IH NG
WHITEWASHINGS	W AY T W AA SH IH NG Z
WHITEWING	W AY T W IH NG
WHITEWINGS	W AY T W IH NG Z
WHITEWOOD	W AY T W UH D
WHITEWOODS	W AY T W UH D Z
WIREDREW	W AY ER D R UW
WIREWAY	W AY ER W EY
WIREWAYS	W AY ER W EY Z
WIREWORK	W AY ER W ER K
WIREWORKS	W AY ER W ER K S
WIREWORM	W AY ER W ER M
WIREWORMS	W AY ER W ER M Z
WISEWOMAN	W AY Z W UH M AH N
WISEWOMEN	W AY Z W IH M AH N
WITHDREW	W IH TH D R UW
WITHDREW(2)	W IH DH D R UW
WORLDVIEW	W ER L D V Y UW
WORLDVIEWS	W ER L D V Y UW Z
YEW	Y UW
YEWS	Y UW Z
IGLOO	IH G L UW
CHABLIS	SH AH B L IY
AUBADE	AH B EY D
DEORBIT	D IY AO R B IH T
OBOE	OW B OW
ALIAS	EY L IY AH S
RAPESEED	R EY P S IY D
