GE	JH IY
AASVOGEL	AA Z AH JH AH L
AASVOGELS	AA Z AH JH AH L Z
ABIOGENESES	EY B IY AA JH AH N IY Z AH Z
ABIOGENESIS	EY B IY AH JH IY N AH S AH S
ABIOGENIC	EY B IY AH JH AH N AH K
ABIOGENICALLY	EY B IY AH JH EH N AH K AE L IY
ABIOGENIST	EY B IY AA JH AH N AH S T
ABIOGENISTS	EY B IY AA JH AH N AH S T S
ABRIDGE	AH B R IH JH
ABRIDGED	AH B R IH JH D
ABRIDGEMENT	AH B R IH JH M AH N T
ABRIDGEMENTS	AH B R IH JH M AH N T S
ABRIDGER	AH B R IH JH ER
ABRIDGERS	AH B R IH JH ER Z
ABRIDGES	AH B R IH JH AH Z
ABSTERGE	AE B S T AH R JH
ABSTERGED	AE B S T AH R JH D
ABSTERGES	AE B S T AH R JH AH Z
ACKNOWLEDGE	AE K N AA L IH JH
ACKNOWLEDGED	AE K N AA L IH JH D
ACKNOWLEDGEDLY	AE K N AA L IH JH AH D L IY
ACKNOWLEDGEMENT	AE K N AA L IH JH M AH N T
ACKNOWLEDGEMENTS	AE K N AA L IH JH M AH N T S
ACKNOWLEDGES	AE K N AA L IH JH IH Z
ACREAGE	EY K AH R IH JH
ACREAGE(2)	EY K R IH JH
ACREAGES	EY K ER IH JH IH Z
ACROGEN	AE K R AH JH AH N
ACROGENS	AE K R AH JH AH N Z
ADAGE	AE D AH JH
ADAGES	AE D IH JH IH Z
ADJUDGE	AH JH AH JH
ADJUDGED	AH JH AH JH D
ADJUDGES	AH JH AH JH IH Z
ADVANTAGE	AE D V AE N T IH JH
ADVANTAGED	AE D V AE N T IH JH D
ADVANTAGEOUS	AE D V AH N T EY JH AH S
ADVANTAGEOUSLY	AE D V AE N T EY JH AH S L IY
ADVANTAGEOUSNESS	AE D V AE N T EY JH AH S N AH S
ADVANTAGEOUSNESSES	AE D V AE N T EY JH AH S N AH S IH Z
ADVANTAGES	AE D V AE N T IH JH IH Z
AEROGEL	EH R AH JH AH L
AEROGELS	EH R AH JH AH L Z
AFTERIMAGE	AE F T ER IH M IH JH
AFTERIMAGES	AE F T ER IH M IH JH IH Z
AGE	EY JH
AGED	EY JH D
AGED(2)	EY JH IH D
AGEDLY	EY JH AH D L IY
AGEDNESS	EY JH AH D N AH S
AGEDNESSES	EY JH AH D N AH S IH Z
AGEE	EY JH IY
AGEING	EY JH IH NG
AGEINGS	EY JH IH NG Z
AGEISM	EY JH IH Z AH M
AGEISMS	EY JH IH Z AH M Z
AGEIST	EY JH IH S T
AGEISTS	EY JH IH S T S
AGELESS	EY JH L AH S
AGELESSLY	EY JH L AH S L IY
AGELESSNESS	EY JH L AH S N AH S
AGELESSNESSES	EY JH L AH S N AH S IH Z
AGELONG	EY JH L AO NG
AGENCIES	EY JH AH N S IY Z
AGENCY	EY JH AH N S IY
AGENDA	AH JH EH N D AH
AGENDALESS	AH JH EH N D AH L AH S
AGENDAS	AH JH EH N D AH Z
AGENDUM	AH JH EH N D AH M
AGENDUMS	AH JH EH N D AH M Z
AGENE	AH JH IY N
AGENES	AH JH IY N Z
AGENESES	AH JH IY N Z IH Z
AGENESIA	AE JH AH N IY ZH IY AH
AGENESIAS	AE JH AH N IY S IY AH Z
AGENESIS	AH JH EH N AH S AH S
AGENETIC	AH JH AH N EH T IH K
AGENIZE	EY JH AH N AY Z
AGENIZED	EY JH AH N AY Z D
AGENIZES	EY JH AH N AY Z IH Z
AGENIZING	EY JH AH N AY Z IH NG
AGENT	EY JH AH N T
AGENTIAL	EY JH AH N T IY AH L
AGENTING	EY JH AH N T IH NG
AGENTINGS	EY JH AH N T IH NG Z
AGENTIVE	EY JH AH N T IH V
AGENTIVES	EY JH AH N T IH V Z
AGENTRIES	EY JH AH N T R IY Z
AGENTRY	EY JH AH N T R IY
AGENTS	EY JH AH N T S
AGER	EY JH ER
AGERATUM	AH JH EH R AH T AH M
AGERATUMS	AH JH EH R AH T AH M Z
AGERS	EY JH ER Z
AGES	EY JH IH Z
AGGER	EY JH ER
AGGERS	EY JH ER Z
AGGLUTINOGEN	AE G L AH T IH N AH JH AH N
AGGLUTINOGENIC	AE G L AH T IH N AH JH AH N AH K
AGGLUTINOGENS	AE G L AH T IH N AH JH AH N Z
AGIOTAGE	EY JH IY AH T AH JH
AGIOTAGES	EY JH IY AA T AH JH AH Z
ALGEBRA	AE L JH AH B R AH
ALGEBRAIC	AE L JH AH B R EY IH K
ALGEBRAICALLY	AE L JH AH B R EY IH K L IY
ALGEBRAIST	AE L JH AH B R AH IH S T
ALGEBRAISTS	AE L JH AH B R AH IH S T S
ALGEBRAS	AE L JH AH B R AH Z
ALGERINE	AE L JH AH R AY N
ALGERINES	AE L JH AH R AY N Z
ALIENAGE	EY L IY AH N IH JH
ALIENAGES	EY L IY AH N IH JH IH Z
ALLEGE	AH L EH JH
ALLEGED	AH L EH JH D
ALLEGEDLY	AH L EH JH AH D L IY
ALLEGER	AH L EH JH ER
ALLEGERS	AH L EH JH ER Z
ALLEGES	AH L EH JH IH Z
ALLERGEN	AE L ER JH AH N
ALLERGENIC	AO L ER JH IY N IH K
ALLERGENICITIES	AO L ER JH IY N IH K S AH T IY Z
ALLERGENICITY	AO L ER JH IY N IH K S AH T IY
ALLERGENS	AE L ER JH AH N Z
ALLOANTIGEN	AE L OW N T AH JH AH N
ALLOANTIGENS	AE L OW N T AH JH AH N Z
ALLOGENEIC	AE L AH JH IY N IY AH K
ALLOGENIC	AE L AH JH AH N AH K
ALLONGE	AE L AH N JH
ALLONGES	AE L AA N JH AH Z
ALMAGEST	AE L M AH JH EH S T
ALMAGESTS	AE L M AH JH EH S T S
ALTOGETHER	AO L T AH G EH DH ER
ALTOGETHERS	AO L T AH G EH DH ER Z
AMBAGE	AE M B AH JH
AMBAGES	AE M B AH JH AH Z
AMIDOGEN	AH M IH D AH JH AH N
AMIDOGENS	AH M IH D AH JH AH N Z
AMPERAGE	AE M P ER IH JH
AMPERAGES	AE M P EH R AH JH AH Z
AMYLOGEN	AH M IH L AH JH AH N
AMYLOGENS	AH M IH L AH JH AH N Z
ANAGENESES	AH N AE JH AH N IY Z AH Z
ANAGENESIS	AE N AH JH IY N AH S AH S
ANAGOGE	AE N AH G OW JH
ANAGOGES	AE N AH G OW JH AH Z
ANALGESIA	AE N AH L JH IY ZH IY AH
ANALGESIAS	AE N AH L JH IY S IY AH Z
ANALGESIC	AE N AH L JH IY S IH K
ANALGESICS	AE N AH L JH IY Z IH K S
ANALGETIC	AH N AE L JH AH T AH K
ANALGETICS	AH N AE L JH AH T AH S Z
ANCHORAGE	AE NG K AH R IH JH
ANCHORAGES	AE NG K ER IH JH IH Z
ANDROGEN	AE N D R AH JH AH N
ANDROGENESES	AE N D R AA JH AH N IY Z AH Z
ANDROGENESIS	AE N D R AH JH IY N AH S AH S
ANDROGENETIC	AE N D R AA JH AH N AH T AH K
ANDROGENIC	AE N D R AH JH AH N AH K
ANDROGENS	AE N D R AH JH AH N Z
ANECDOTAGE	AE N IH K D OW T IH JH
ANECDOTAGES	AE N IH K D OW T IH JH IH Z
ANGEL	EY N JH AH L
ANGELED	EY N JH AH L D
ANGELFISH	EY N JH AH L F IH SH
ANGELFISHES	EY N JH AH L F IH SH IH Z
ANGELIC	AE N JH EH L IH K
ANGELICA	AE N JH EH L IH K AH
ANGELICA(2)	AE N JH AH L IY K AH
ANGELICAL	AE N JH EH L IH K AH L
ANGELICALLY	AE N JH EH L IH K L IY
ANGELICAS	AE N JH EH L IH K AH Z
ANGELING	EY N JH AH L IH NG
ANGELOLOGIES	EY N JH AH L AA L AH JH IY Z
ANGELOLOGIST	EY N JH AH L AA L AH JH AH S T
ANGELOLOGISTS	EY N JH AH L AA L AH JH AH S T S
ANGELOLOGY	EY N JH AH L AA L AH JH IY
ANGELS	EY N JH AH L Z
ANGELUS	AE N JH AH L AH S
ANGELUSES	EY N JH AH L Y UW S IH Z
ANGER	AE NG G ER
ANGERED	AE NG G ER D
ANGERING	AE NG G ER IH NG
ANGERLESS	AE NG G ER L AH S
ANGERLY	AE NG G ER L IY
ANGERS	AE NG G ER Z
ANGIOGENESES	AE N JH IY AA JH AH N IY Z AH Z
ANGIOGENESIS	AE N JH IY OW JH EH N IH S AH S
ANGIOGENIC	AE N JH IY AH JH AH N AH K
ANLAGE	AE N L AH JH
ANLAGEN	AE N L AH JH AH N
ANLAGES	AE N L AH JH AH Z
ANOREXIGENIC	AE N AH R EH K S AH JH AH N AH K
ANTHROPOGENIC	AE N TH R AH P AH JH EH N IH K
ANTIALLERGENIC	AE N T AY AO L ER JH IY N IH K
ANTIALLERGENICS	AE N T AY AO L ER JH IY N IH K S
ANTIBOURGEOIS	AE N T AY B UW R ZH W AA
ANTICARCINOGEN	AE N T AH K AA R S IH N AH JH AH N
ANTICARCINOGENIC	AE N T AH K AA R S IH N AH JH AH N AH K
ANTICARCINOGENS	AE N T AH K AA R S IH N AH JH AH N Z
ANTIESTROGEN	AE N T AY EH S T R AH JH AH N
ANTIESTROGENS	AE N T AY EH S T R AH JH AH N Z
ANTIGEN	AE N T AH JH AH N
ANTIGENE	AE N T AY JH IY N
ANTIGENES	AE N T AY JH IY N Z
ANTIGENIC	AE N T IH JH AH N IH K
ANTIGENICALLY	AE N T IH JH AH N IH K AH L IY
ANTIGENICITIES	AE N T IH JH AH N IH K S AH T IY Z
ANTIGENICITY	AE N T IH JH AH N IH K S AH T IY
ANTIGENS	AE N T IH JH AH N Z
ANTIMANAGEMENT	AE N T AY M AE N IH JH M AH N T
ANTIMANAGEMENTS	AE N T AY M AE N IH JH M AH N T S
ANTIMERGER	AE N T AY M ER JH ER
ANTIMISCEGENATION	AE N T AY M IH S EH JH AH N EY SH AH N
APAGOGE	AE P AH G OW JH
APAGOGES	AE P AH G OW JH AH Z
APANAGE	AH P EY N IH JH
APANAGES	AH P EY N IH JH IH Z
APOGEAL	AH P OW JH IY AH L
APOGEAN	AH P OW JH IY AH N
APOGEE	AE P AH JH IY
APOGEES	AE P AH JH IY Z
APOGEIC	AH P OW JH IY AH K
APOLOGETIC	AH P AA L AH JH EH T IH K
APOLOGETICALLY	AH P AA L AH JH EH T IH K L IY
APOLOGETICS	AH P AA L AH JH EH T IH K S
APOPHYGE	AE P AH F AY JH
APOPHYGES	AE P AH F AY JH AH Z
APPANAGE	AE P AH N IH JH
APPANAGES	AE P AH N IH JH IH Z
APPENDAGE	AH P EH N D IH JH
APPENDAGES	AH P EH N D IH JH IH Z
ARBITRAGE	AA R B IH T R AA ZH
ARBITRAGED	AA R B AH T R IH JH D
ARBITRAGER	AA R B IH T R AA ZH ER
ARBITRAGERS	AA R B IH T R AA ZH ER Z
ARBITRAGES	AA R B AH T R IH JH IH Z
ARBITRAGEUR	AA R B IH T R AA ZH ER
ARBITRAGEURS	AA R B AH T R AA ZH ER Z
ARCHANGEL	AA R K EY N JH AH L
ARCHANGELIC	AA R K EY N JH AH L IH K
ARCHANGELS	AA R K EY N JH AH L Z
ARCTANGENT	AA R K T AE N JH AH N T
ARCTANGENTS	AA R K T AE N JH AH N T S
ARGENT	AA R JH IH N T
ARGENTAL	AA R JH EH N T AH L
ARGENTIC	AA R JH AH N T AH K
ARGENTIFEROUS	AA R JH EH N T IH F AH R AH S
ARGENTINE	AA R JH AH N T IY N
ARGENTINES	AA R JH AH N T IY N Z
ARGENTITE	AA R JH AH N T AY T
ARGENTITES	AA R JH AH N T AY T S
ARGENTS	AA R JH AH N T S
ARGENTUM	AA R JH EH N T AH M
ARGENTUMS	AA R JH EH N T AH M Z
ARMIGER	AA R M IH G ER
ARMIGERAL	AA R M IH JH AH R AH L
ARMIGERO	AA R M IH JH AH R OW
ARMIGEROS	AA R M IH JH AH R AH Z
ARMIGEROUS	AA R M IH JH AH R AH S
ARMIGERS	AA R M AH JH AH R Z
ARRANGE	ER EY N JH
ARRANGED	ER EY N JH D
ARRANGEMENT	ER EY N JH M AH N T
ARRANGEMENTS	ER EY N JH M AH N T S
ARRANGER	ER EY N JH ER
ARRANGERS	AH R EY N JH ER Z
ARRANGES	ER EY N JH IH Z
ARREARAGE	ER IY R IH JH
ARREARAGES	ER IH R IH JH IH Z
ASPERGES	AE S AH R JH AH Z
ASSEMBLAGE	AH S EH M B L AH JH
ASSEMBLAGE(2)	AH S EH M B L IH JH
ASSEMBLAGES	AH S EH M B L IH JH IH Z
ASSUAGE	AH S W EY JH
ASSUAGED	AH S W EY JH D
ASSUAGEMENT	AH S W EY JH M AH N T
ASSUAGEMENTS	AH S W EY JH M AH N T S
ASSUAGES	AH S W EY JH IH Z
ASSURGENT	AE S ER JH AH N T
ASSWAGE	AE S W EY JH
ASSWAGED	AE S W EY JH D
ASSWAGES	AE S W EY JH IH Z
ASTRINGE	AE S T R AH N JH
ASTRINGED	AH S T R IH NG D
ASTRINGENCIES	AH S T R IH N JH AH N S IY Z
ASTRINGENCY	AH S T R IH N JH AH N S IY
ASTRINGENT	AH S T R IH N JH AH N T
ASTRINGENTLY	AH S T R IH N JH AH N T L IY
ASTRINGENTS	AH S T R IH N JH AH N T S
ASTRINGES	AH S T R IH NG Z
ASTROLOGER	AH S T R AA L AH JH ER
ASTROLOGERS	AH S T R AA L AH JH ER Z
ATHEROGENESES	AH TH AH R AA JH AH N IY Z AH Z
ATHEROGENESIS	AE TH AH R AH JH IY N AH S AH S
ATHEROGENIC	AH TH EH R AH JH AH N AH K
AUBERGE	AO B AH R JH
AUBERGES	AH B AH R JH AH Z
AUDIOGENIC	AO D IY OW JH IY N IH K
AUGEND	AO JH AH N D
AUGENDS	AO JH AH N D Z
AUGER	AO G ER
AUGERS	AO G ER Z
AUTOGENIC	AO T OW JH IY N IH K
AUTOGENIES	AO T OW JH IY N IY Z
AUTOGENOUS	AO T OW JH IY N AH S
AUTOGENOUSLY	AO T OW JH IY N AH S L IY
AUTOGENY	AO T OW JH IY N IY
AUTOSUGGEST	AO T OW S AH G JH EH S T
AUTOSUGGESTED	AO T OW S AH G JH EH S T IH D
AUTOSUGGESTING	AO T OW S AH G JH EH S T IH NG
AUTOSUGGESTION	AO T OW S AH G JH EH S SH AH N
AUTOSUGGESTIONS	AO T OW S AH G JH EH S SH AH N Z
AUTOSUGGESTS	AO T OW S AH G JH EH S T S
AVENGE	AH V EH N JH
AVENGED	AH V EH N JH D
AVENGER	AH V EH N JH ER
AVENGERS	AH V EH N JH ER Z
AVENGES	AH V EH N JH IH Z
AVERAGE	AE V ER IH JH
AVERAGE(2)	AE V R IH JH
AVERAGED	AE V R IH JH D
AVERAGELY	AE V R IH JH L IY
AVERAGENESS	AE V R IH JH N AH S
AVERAGENESSES	AE V R IH JH N AH S IH Z
AVERAGES	AE V R IH JH IH Z
AWNINGED	AO N IH NG D
BACKLOGGED	B AE K L AA G D
BACKSTAGE	B AE K S T EY JH
BACTERIOPHAGE	B AE K T AH R IY AH F AH JH
BACTERIOPHAGES	B AE K T AH R IY AA F AH JH AH Z
BADGE	B AE JH
BADGED	B AE JH D
BADGER	B AE JH ER
BADGERED	B AE JH ER D
BADGERING	B AE JH ER IH NG
BADGERLY	B AE JH ER L IY
BADGERS	B AE JH ER Z
BADGES	B AE JH IH Z
BADINAGE	B AE D AH N AA ZH
BADINAGED	B AE D AH N AA ZH D
BADINAGES	B AE D AH N AA ZH IH Z
BAGEL	B EY G AH L
BAGELS	B EY G AH L Z
BAGGAGE	B AE G IH JH
BAGGAGES	B AE G IH JH IH Z
BAGGED	B AE G D
BAGGER	B AE G ER
BAGGERS	B AE G ER Z
BALLYRAGGED	B AO L IY R AE G AH D
BANDAGE	B AE N D IH JH
BANDAGED	B AE N D AH JH D
BANDAGER	B AE N D IH JH ER
BANDAGERS	B AE N D IH JH ER Z
BANDAGES	B AE N D AH JH AH Z
BANDAGES(2)	B AE N D IH JH IH Z
BANGED	B AE NG D
BANGER	B AE NG ER
BANGERS	B AE NG ER Z
BAREGE	B AH R IY JH
BAREGES	B AH R IY JH AH Z
BARGE	B AA R JH
BARGEBOARD	B AA R JH B OW R D
BARGEBOARDS	B AA R JH B OW R D Z
BARGED	B AA R JH D
BARGEE	B AA R JH IY
BARGEES	B AA R JH IY Z
BARGELLO	B AA R JH EH L OW
BARGELLOS	B AA R JH EH L AH Z
BARGEMAN	B AA R JH M AE N
BARGEMEN	B AA R JH EH M AH N
BARGES	B AA R JH AH Z
BARGES(2)	B AA R JH IH Z
BARONAGE	B AE R AH N IH JH
BARONAGES	B AE R AH N IH JH IH Z
BARONETAGE	B AH R AA N AH T AH JH
BARONETAGES	B AE R AH N EH T AH JH AH Z
BARRAGE	B ER AA ZH
BARRAGED	B ER AA ZH D
BARRAGES	B ER AA ZH IH Z
BARRELAGE	B AE R AH L IH JH
BARRELAGES	B AE R AH L IH JH IH Z
BECLOGGED	B IH K L AA G D
BECUDGEL	B IH K AH JH AH L
BECUDGELED	B IH K AH JH AH L D
BECUDGELING	B IH K AH JH AH L IH NG
BECUDGELLED	B IH K AH JH AH L D
BECUDGELLING	B IH K AH JH AH L IH NG
BECUDGELS	B IH K AH JH AH L Z
BEDRUGGED	B IH D R AH G D
BEFINGER	B IH F IH NG G ER
BEFINGERED	B IH F IH NG G ER D
BEFINGERING	B IH F IH NG G ER IH NG
BEFINGERS	B IH F IH NG G ER Z
BEFLAGGED	B IH F L AE G D
BEFOGGED	B IH F AA G D
BEFRINGE	B IH F R IH N JH
BEFRINGED	B IH F R IH N JH D
BEFRINGES	B IH F R IH N JH IH Z
BEGET	B IH G EH T
BEGETS	B IH G EH T S
BEGETTER	B IH G EH T ER
BEGETTERS	B IH G EH T ER Z
BEGETTING	B IH G EH T IH NG
BEGGED	B EH G D
BEGRUDGE	B IH G R AH JH
BEGRUDGED	B IH G R AH JH D
BEGRUDGES	B IH G R AH JH IH Z
BEIGE	B EY ZH
BEIGES	B EY ZH AH Z
BELLIGERENCE	B AH L IH JH ER AH N S
BELLIGERENCES	B AH L IH JH ER AH N S IH Z
BELLIGERENCIES	B AH L IH JH ER AH N S IY Z
BELLIGERENCY	B AH L IH JH ER AH N S IY
BELLIGERENT	B AH L IH JH ER AH N T
BELLIGERENTLY	B AH L IH JH ER AH N T L IY
BELLIGERENTS	B AH L IH JH ER AH N T S
BELONGED	B IH L AO NG D
BERGERE	B IH R JH IH R
BERGERES	B IH R JH IY R Z
BERINGED	B IH R IH NG D
BEROUGED	B IH R UW ZH D
BESIEGE	B IH S IY JH
BESIEGED	B IH S IY JH D
BESIEGER	B IH S IY JH ER
BESIEGERS	B IH S IY JH ER Z
BESIEGES	B IH S IY JH IH Z
BESMUDGE	B IH S M AH JH
BESMUDGED	B IH S M AH JH D
BESMUDGES	B IH S M AH JH IH Z
BEVERAGE	B EH V ER IH JH
BEVERAGE(2)	B EH V R IH JH
BEVERAGES	B EH V R IH JH IH Z
BEWIGGED	B IH W IH G D
BEWINGED	B IH W IH NG D
BIFLAGELLATE	B AY F L AE JH AH L AH T
BIGEMINAL	B IH G EH M AH N AH L
BIGEMINIES	B IH G EH M AH N IY Z
BIGEMINY	B IH G EH M AH N IY
BIGENERIC	B AY JH EH N ER IH K
BIGEYE	B IH G AY
BIGEYES	B IH G AY Z
BIGGER	B IH G ER
BIGGEST	B IH G AH S T
BIGGETY	B IH G EH T IY
BILGE	B IH L JH
BILGED	B IH L JH D
BILGES	B IH L JH IH Z
BILGEWATER	B IH L JH W AO T ER
BILGEWATERS	B IH L JH W AO T ER Z
BINGE	B IH N JH
BINGED	B IH N JH D
BINGEING	B IH N JH IH NG
BINGER	B IH NG JH ER
BINGER(2)	B IH NG G ER
BINGERS	B IH N JH ER Z
BINGES	B IH N JH IH Z
BIOENERGETIC	B AY OW AH N AH R JH AH T AH K
BIOENERGETICS	B AY OW AH N AH R JH AH T AH S Z
BIOGEN	B AY OW JH EH N
BIOGENESES	B AY AA JH AH N IY Z AH Z
BIOGENESIS	B AY AH JH IY N AH S AH S
BIOGENETIC	B AY AA JH AH N AH T AH K
BIOGENETICALLY	B AY AH JH AH N EH T AH K AE L IY
BIOGENIC	B AY AA JH AH N AH K
BIOGENIES	B AY AA JH AH N AY Z
BIOGENOUS	B AY AA JH AH N AH S
BIOGENS	B AY AA JH AH N Z
BIOGENY	B AY AA JH AH N IY
BIOGEOCHEMICAL	B AY AH JH IY AA K AH M IH S AH L
BIOGEOCHEMICALS	B AY OW JH IY AH K EH M AH K AH L Z
BIOGEOCHEMISTRIES	B AY AH JH IY AH K AH M IH S T R AY Z
BIOGEOCHEMISTRY	B AY AH JH IY AA K AH M IH S T R IY
BIOGEOGRAPHER	B AY OW JH IY AA G R AH F AH R
BIOGEOGRAPHERS	B AY OW JH IY AA G R AH F AH R Z
BIOGEOGRAPHIC	B AY OW JH IY AA G R AH F AH K
BIOGEOGRAPHICAL	B AY OW JH IY AA G R AH F IH S AH L
BIOGEOGRAPHIES	B AY OW JH IY AA G R AH F AY Z
BIOGEOGRAPHY	B AY OW JH IY AA G R AH F IY
BIRDCAGE	B ER D K EY JH
BIRDCAGES	B ER D K EY JH IH Z
BIREFRINGENCE	B AY R IH F R IH N JH AH N S
BIREFRINGENCES	B AY R IH F R IH N JH AH N S IH Z
BIREFRINGENT	B AY R IY F R IH N JH AH N T
BLANCMANGE	B L AE NG K M AH N JH
BLANCMANGES	B L AE NG K M AE N JH AH Z
BLINDAGE	B L AY N D IH JH
BLINDAGES	B L AY N D IH JH IH Z
BLOCKAGE	B L AA K IH JH
BLOCKAGES	B L AA K IH JH IH Z
BLUDGEON	B L AH JH AH N
BLUDGEONED	B L AH JH AH N D
BLUDGEONING	B L AH JH AH N IH NG
BLUDGEONS	B L AH JH AH N Z
BLUDGER	B L AH JH AH R
BLUDGERS	B L AH JH AH R Z
BLUNGE	B L AH N JH
BLUNGED	B L AH NG D
BLUNGER	B L AH NG AH R
BLUNGERS	B L AH N JH AH R Z
BLUNGES	B L AH N JH AH Z
BOGEY	B OW G IY
BOGEYED	B OW G IY D
BOGEYING	B OW G IY IH NG
BOGEYMAN	B OW G IY M AE N
BOGEYMAN(2)	B UH G IY M AE N
BOGEYMEN	B OW G IY M IH N
BOGEYMEN(2)	B UH G IY M IH N
BOGEYS	B OW G IY Z
BOGGED	B AA G D
BOGGED(2)	B AO G D
BONDAGE	B AA N D IH JH
BONDAGES	B AA N D IH JH IH Z
BONGED	B AA NG D
BOOGER	B UW JH AH R
BOOGERMAN	B UW JH ER M AH N
BOOGERMEN	B UW JH ER M AH N
BOOGERS	B UW JH AH R Z
BOOGEY	B UW JH IY
BOOGEYED	B UW JH EY D
BOOGEYING	B UW JH EY AH NG
BOOGEYMAN	B UW JH EY M AH N
BOOGEYMEN	B UW JH EY M AH N
BOOGEYS	B UW JH EY Z
BOOMERANGED	B UW M ER AE NG D
BOOTLEGGED	B UW T L EH G D
BOOTLEGGER	B UW T L EH G ER
BOOTLEGGERS	B UW T L EH G ER Z
BORAGE	B AO R IH JH
BORAGES	B AO R IH JH IH Z
BOSCAGE	B AA S AH JH
BOSCAGES	B AA S AH JH AH Z
BOSKAGE	B AA S AH JH
BOSKAGES	B AA S AH JH AH Z
BOURGEOIS	B UH R ZH W AA
BOURGEOISE	B AH R JH IY OY Z
BOURGEOISES	B UW R ZH W AA Z
BOURGEOISIE	B UH R ZH W AA Z IY
BOURGEOISIES	B UW R ZH W AA IY Z
BOURGEOISIFICATION	B UW R ZH W AA AH F AH K EY SH AH N
BOURGEOISIFICATIONS	B UW R ZH W AA AH F AH K EY SH AH N Z
BOURGEOISIFIED	B UW R ZH W AA AH F AY D
BOURGEOISIFIES	B UW R ZH W AA AH F AY Z
BOURGEOISIFY	B UW R ZH W AA AH F AY
BOURGEOISIFYING	B UW R ZH W AA AH F AY IH NG
BOURGEON	B AH R JH AH N
BOURGEONED	B AH R JH IY OW N D
BOURGEONING	B AH R JH IY OW N AH NG
BOURGEONS	B AH R JH IY AH N Z
BOWLEGGED	B OW L EH G D
BRAGGED	B R AE G D
BRAGGER	B R AE G ER
BRAGGERS	B R AE G ER Z
BRAGGEST	B R AE G AH S T
BRAKEAGE	B R EY K IH JH
BRAKEAGES	B R EY K IH JH IH Z
BRASSAGE	B R AE S IH JH
BRASSAGES	B R AE S IH JH IH Z
BRAUNSCHWEIGER	B R AO N S W EY JH AH R
BRAUNSCHWEIGERS	B R AO N S W EY JH AH R Z
BREAKAGE	B R EY K IH JH
BREAKAGES	B R EY K IH JH IH Z
BREWAGE	B R UW IH JH
BREWAGES	B R UW IH JH IH Z
BRICOLAGE	B R IH K AH L AH JH
BRICOLAGES	B R AH K AA L AH JH AH Z
BRIDGE	B R IH JH
BRIDGEABLE	B R IH JH AH B AH L
BRIDGED	B R IH JH D
BRIDGEHEAD	B R IH JH HH EH D
BRIDGEHEADS	B R IH JH HH EH D Z
BRIDGELESS	B R IH JH L AH S
BRIDGES	B R IH JH AH Z
BRIDGES(2)	B R IH JH IH Z
BRIDGEWORK	B R IH JH W ER K
BRIDGEWORKS	B R IH JH W ER K S
BRIGANDAGE	B R AH G AE N D AH JH
BRIGANDAGES	B R AH G AE N D AH JH AH Z
BRINGER	B R IH NG ER
BRINGERS	B R IH NG ER Z
BROCKAGE	B R AA K AH JH
BROCKAGES	B R AA K AH JH AH Z
BROKAGE	B R OW K IH JH
BROKAGES	B R OW K IH JH IH Z
BROKERAGE	B R OW K ER IH JH
BROKERAGE(2)	B R OW K R IH JH
BROKERAGES	B R OW K ER IH JH IH Z
BROKERAGES(2)	B R OW K R IH JH IH Z
BRONCHOGENIC	B R AA NG K HH AA G AH N IH K
BROWRIDGE	B R AW R IH JH
BROWRIDGES	B R AW R IH JH IH Z
BRUMMAGEM	B R AH M AH JH AH M
BRUMMAGEMS	B R AH M AH JH AH M Z
BUDGE	B AH JH
BUDGED	B AH JH D
BUDGER	B AH JH ER
BUDGERIGAR	B AH JH R IH G ER
BUDGERIGARS	B AH JH R IH G ER Z
BUDGERS	B AH JH ER Z
BUDGES	B AH JH IH Z
BUDGET	B AH JH IH T
BUDGETARY	B AH JH IH T EH R IY
BUDGETED	B AH JH IH T AH D
BUDGETED(2)	B AH JH IH T IH D
BUDGETEER	B AH JH IH T IH R
BUDGETEERS	B AH JH IH T IH R Z
BUDGETER	B AH JH AH T ER
BUDGETERS	B AH JH AH T ER Z
BUDGETING	B AH JH IH T IH NG
BUDGETS	B AH JH IH T S
BUGEYE	B AH G AY
BUGEYES	B AH G AY Z
BUGGED	B AH G D
BUGGER	B AH G ER
BUGGERED	B UH G ER D
BUGGERIES	B AH G AH R IY Z
BUGGERING	B UH G ER IH NG
BUGGERS	B AH G ER Z
BUGGERY	B AH G AH R IY
BULGE	B AH L JH
BULGED	B AH L JH D
BULGER	B AH L G ER
BULGERS	B AH L JH ER Z
BULGES	B AH L JH IH Z
BULKAGE	B AH L K IH JH
BULKAGES	B AH L K IH JH IH Z
BULLDOGGED	B UH L D AO G AH D
BULLDOGGER	B UH L D AO G ER
BULLDOGGERS	B UH L D AO G ER Z
BULLYRAGGED	B UH L IY R AE G AH D
BUNGED	B AH NG D
BUNGEE	B AH N JH IY
BUNGEES	B AH NG IY Z
BUOYAGE	B OY IH JH
BUOYAGES	B OY IH JH IH Z
BURGAGE	B AH R G AH JH
BURGAGES	B AH R G AH JH AH Z
BURGEE	B ER G IY
BURGEES	B AH R JH IY Z
BURGEON	B ER JH AH N
BURGEONED	B ER JH AH N D
BURGEONING	B ER JH AH N IH NG
BURGEONS	B ER JH AH N Z
BURGER	B ER G ER
BURGERS	B ER G ER Z
BURGESS	B ER JH AH S
BURGESSES	B ER JH AH S IH Z
BUSHRANGER	B UH SH R EY N JH ER
BUSHRANGERS	B UH SH R EY N JH ER Z
BUTTERFINGERED	B AH T ER F IH NG G ER D
BUTTERFINGERS	B AH T ER F IH NG G ER Z
CABBAGE	K AE B AH JH
CABBAGE(2)	K AE B IH JH
CABBAGED	K AE B IH JH D
CABBAGES	K AE B IH JH IH Z
CABBAGEWORM	K AE B IH JH W ER M
CABBAGEWORMS	K AE B IH JH W ER M Z
CABOTAGE	K AE B AH T IH JH
CABOTAGES	K AH B AA T AH JH AH Z
CADGE	K AE JH
CADGED	K AE JH D
CADGER	K AE JH AH R
CADGERS	K AE JH AH R Z
CADGES	K AE JH AH Z
CAGE	K EY JH
CAGED	K EY JH D
CAGEFUL	K EY JH F AH L
CAGEFULS	K EY JH F AH L Z
CAGELING	K EY JH L IH NG
CAGELINGS	K EY JH L IH NG Z
CAGER	K EY JH ER
CAGERS	K EY JH ER Z
CAGES	K EY JH IH Z
CAGEY	K EY JH IY
CAGEYNESS	K EY JH IY N AH S
CAGEYNESSES	K EY JH IY N AH S IH Z
CALCIFUGE	K AE L S AH F Y UW JH
CALCIFUGES	K AE L S AH F Y UW JH AH Z
CAMOUFLAGE	K AE M AH F L AA ZH
CAMOUFLAGEABLE	K AE M AH F L AA ZH AH B AH L
CAMOUFLAGED	K AE M AH F L AA ZH D
CAMOUFLAGES	K AE M AH F L AA ZH IH Z
CARAGEEN	K EH R IH JH AH N
CARAGEENS	K EH R IH JH AH N Z
CARCINOGEN	K AA R S IH N AH JH AH N
CARCINOGENESES	K AA R S AH N AA JH AH N IY Z AH Z
CARCINOGENESIS	K AA R S AH N AH JH IY N AH S AH S
CARCINOGENIC	K AA R S AH N OW JH EH N IH K
CARCINOGENICITIES	K AA R S IH N AH JH AH N IH S AH T AY Z
CARCINOGENICITY	K AA R S AH N AA JH AH N IH S AH T IY
CARCINOGENS	K AA R S IH N AH JH AH N Z
CARDIOGENIC	K AA R D IY AH JH AH N AH K
CARIOGENIC	K AH R IY AH JH AH N AH K
CARNAGE	K AA R N IH JH
CARNAGES	K AA R N IH JH IH Z
CARPETBAGGER	K AA R P AH T B AE G ER
CARPETBAGGERIES	K AA R P AH T B AE G AH R IY Z
CARPETBAGGERS	K AA R P AH T B AE G ER Z
CARPETBAGGERY	K AA R P AH T B AE G AH R IY
CARRAGEEN	K AA R IH JH AH N
CARRAGEENAN	K AE R AH JH IY N AH N
CARRAGEENANS	K AE R AH JH IY N AH N Z
CARRAGEENIN	K AA R IH JH AH N IH N
CARRAGEENINS	K AA R IH JH AH N IH N Z
CARRAGEENS	K AA R IH JH AH N Z
CARRIAGE	K AE R IH JH
CARRIAGE(2)	K EH R AH JH
CARRIAGES	K AE R IH JH IH Z
CARRIAGES(2)	K EH R AH JH AH Z
CARRIAGEWAY	K AE R IH JH W EY
CARRIAGEWAYS	K AE R IH JH W EY Z
CARTAGE	K AA R T IH JH
CARTAGES	K AA R T IH JH IH Z
CARTILAGE	K AA R T AH L AH JH
CARTILAGE(2)	K AA R T AH L IH JH
CARTILAGES	K AA R T AH L IH JH IH Z
CARTRIDGE	K AA R T R AH JH
CARTRIDGE(2)	K AA R T R IH JH
CARTRIDGES	K AA R T R AH JH AH Z
CATALOGED	K AE T AH L AO G D
CATALOGER	K AE T AH L AO G ER
CATALOGERS	K AE T AH L AO G ER Z
CEILINGED	S EH L IH NG D
CELLARAGE	S EH L ER IH JH
CELLARAGES	S EH L ER IH JH IH Z
CENTRIFUGE	S EH N T R AH F Y UW JH
CENTRIFUGED	S EH N T R AH F Y UW JH D
CENTRIFUGES	S EH N T R AH F Y UW JH IH Z
CHALCOGEN	CH AE L K AH JH AH N
CHALCOGENIDE	CH AE L K AA JH AH N AY D
CHALCOGENIDES	CH AE L K AA JH AH N AY D Z
CHALCOGENS	CH AE L K AH JH AH N Z
CHALLENGE	CH AE L AH N JH
CHALLENGED	CH AE L AH N JH D
CHALLENGER	CH AE L AH N JH ER
CHALLENGER(2)	CH AE L IH N JH ER
CHALLENGERS	CH AE L AH N JH ER Z
CHALLENGES	CH AE L AH N JH IH Z
CHANGE	CH EY N JH
CHANGEABILITIES	CH EY N JH AH B IH L AH T EH Z
CHANGEABILITY	CH EY N JH AH B IH L AH T EH
CHANGEABLE	CH EY N JH AH B AH L
CHANGEABLENESS	CH EY N JH AH B AH L N AH S
CHANGEABLENESSES	CH EY N JH AH B AH L N AH S IH Z
CHANGEABLY	CH EY N JH AH B L IY
CHANGED	CH EY N JH D
CHANGEFUL	CH EY N JH F AH L
CHANGEFULLY	CH EY N JH F AH L IY
CHANGEFULNESS	CH EY N JH F AH L N AH S
CHANGEFULNESSES	CH EY N JH F AH L N AH S IH Z
CHANGELESS	CH EY N JH L AH S
CHANGELESSLY	CH EY N JH L AH S L IY
CHANGELESSNESS	CH EY N JH L AH S N AH S
CHANGELESSNESSES	CH EY N JH L AH S N AH S IH Z
CHANGELING	CH EY N JH L IH NG
CHANGELINGS	CH EY N JH L IH NG Z
CHANGEOVER	CH EY N JH OW V ER
CHANGEOVERS	CH EY N JH OW V ER Z
CHANGER	CH EY N JH ER
CHANGERS	CH EY N JH ER Z
CHANGES	CH EY N JH AH Z
CHANGES(2)	CH EY N JH IH Z
CHANTAGE	CH AE N T IH JH
CHANTAGES	CH AE N T IH JH IH Z
CHAPERONAGE	SH AE P AH R OW N IH JH
CHAPERONAGES	SH AE P AH R OW N IH JH IH Z
CHARGE	CH AA R JH
CHARGEABLE	CH AA R JH AH B AH L
CHARGED	CH AA R JH D
CHARGEHAND	CH AA R JH HH AE N D
CHARGEHANDS	CH AA R JH HH AE N D Z
CHARGER	CH AA R JH ER
CHARGERS	CH AA R JH ER Z
CHARGES	CH AA R JH IH Z
CHARMINGER	CH AA R M IH NG ER
CHARMINGEST	CH AA R M IH N JH EH S T
CHEESEBURGER	CH IY Z B ER G ER
CHEESEBURGERS	CH IY Z B ER G ER Z
CHEMOSURGERIES	K EH M AH S AH R JH AH R AY Z
CHEMOSURGERY	K EH M AH S AH R JH EH R IY
CHIGETAI	CH IH JH AH T EY
CHIGETAIS	CH AH JH EH T EY AH S
CHIGGER	CH IH G ER
CHIGGERS	CH IH G ER Z
CHIRURGEON	CH AH R AH R JH AH N
CHIRURGEONS	CH AH R AH R JH IY AH N Z
CHROMOGEN	K R AA M AH JH AH N
CHROMOGENIC	K R AA M AH JH AH N AH K
CHROMOGENS	K R AA M AH JH AH N Z
CHRONOLOGER	K R AA N AH L OW JH AH R
CHRONOLOGERS	K R AH N AA L AH JH AH R Z
CHUGALUGGED	CH AH G AH L AH G D
CHUGGED	CH AH G D
CHUGGER	CH AH G ER
CHUGGERS	CH AH G ER Z
CHYMOTRYPSINOGEN	CH AH M AA T R IH P S IH N AH JH AH N
CHYMOTRYPSINOGENS	CH AH M AA T R AH P S IH N AH JH AH N Z
CLADOGENESES	K L AH D AA JH AH N IY Z AH Z
CLADOGENESIS	K L AE D AH JH IY N AH S AH S
CLADOGENETIC	K L AH D AA JH AH N AH T AH K
CLADOGENETICALLY	K L AE D AH JH AH N EH T AH K AE L IY
CLAGGED	K L AE G D
CLANGED	K L AE NG D
CLANGER	K L AE NG ER
CLANGERS	K L AE NG ER Z
CLEAVAGE	K L IY V AH JH
CLEAVAGE(2)	K L IY V IH JH
CLEAVAGES	K L IY V IH JH IH Z
CLIENTAGE	K L AY AH N T IH JH
CLIENTAGES	K L AY AH N T IH JH IH Z
CLIFFHANGER	K L IH F HH AE NG ER
CLIFFHANGERS	K L IH F HH AE NG ER Z
CLINGED	K L IH NG D
CLINGER	K L IH NG ER
CLINGERS	K L IH NG ER Z
CLOGGED	K L AO G D
CLOGGER	K L AA G ER
CLOGGERS	K L AA G ER Z
COAGENCIES	K OW EY JH AH N S IY Z
COAGENCY	K OW EY JH AH N S IY
COAGENT	K OW EY JH AH N T
COAGENTS	K OW EY JH AH N T S
COBELLIGERENT	K OW B AH L IH JH ER AH N T
COBELLIGERENTS	K OW B AH L IH JH ER AH N T S
COCARCINOGEN	K OW K AA R S IH N AH JH AH N
COCARCINOGENIC	K OW K AA R S IH N AH JH AH N AH K
COCARCINOGENS	K OW K AA R S IH N AH JH AH N Z
COCCYGEAL	K AA K S AY JH IY AH L
COCCYGES	K AA K S AY JH AH Z
CODGER	K AA JH AH R
CODGERS	K AA JH EH R Z
COGENCIES	K OW JH AH N S IY Z
COGENCY	K OW JH AH N S IY
COGENERATION	K OW JH EH N ER EY SH AH N
COGENERATIONS	K OW JH EH N ER EY SH AH N Z
COGENERATOR	K OW JH EH N ER EY T ER
COGENERATORS	K OW JH EH N ER EY T ER Z
COGENT	K OW JH AH N T
COGENTLY	K OW JH AH N T L IY
COGGED	K AA G D
COINAGE	K OY N IH JH
COINAGES	K OY N IH JH IH Z
COLIPHAGE	K OW L IH F AH JH
COLIPHAGES	K OW L IH F AH JH AH Z
COLLAGE	K AH L AA ZH
COLLAGED	K AH L AA ZH D
COLLAGEN	K AA L AH G AH N
COLLAGENASE	K AA L AE JH AH N EY Z
COLLAGENASES	K AA L AE JH AH N EY Z AH Z
COLLAGENOUS	K AA L AH JH EH N AH S
COLLAGENS	K AA L AH JH EH N Z
COLLAGES	K AH L AA ZH IH Z
COLLEGE	K AA L IH JH
COLLEGER	K AA L IH JH ER
COLLEGERS	K AA L IH JH ER Z
COLLEGES	K AA L IH JH IH Z
COLPORTAGE	K AA L P AO R T AH JH
COLPORTAGES	K AA L P AO R T AH JH AH Z
COMANAGE	K OW M AE N IH JH
COMANAGED	K OW M AE N IH JH D
COMANAGEMENT	K OW M AE N IH JH M AH N T
COMANAGEMENTS	K OW M AE N IH JH M AH N T S
COMANAGER	K OW M AE N IH JH ER
COMANAGERS	K OW M AE N IH JH ER Z
COMANAGES	K OW M AE N IH JH IH Z
COMMONAGE	K AA M AH N IH JH
COMMONAGES	K AA M AH N IH JH IH Z
CONCIERGE	K AA N S IY EH R ZH
CONCIERGES	K OW N S Y EH R ZH IH Z
CONCUBINAGE	K AA N K Y UW B AH N AH JH
CONCUBINAGES	K AH N K AH B IH N IH JH IH Z
CONGE	K AA N JH IY
CONGEAL	K AH N JH IY L
CONGEALED	K AH N JH IY L D
CONGEALING	K AH N JH IY L IH NG
CONGEALMENT	K AH N JH IY L M AH N T
CONGEALMENTS	K AH N JH IY L M AH N T S
CONGEALS	K AH N JH IY L Z
CONGEE	K AA N JH IY IY
CONGEED	K AA N JH IY D
CONGEEING	K AA N JH IY AH NG
CONGEES	K AA N JH IY Z
CONGELATION	K AH N JH EH L EY SH AH N
CONGELATIONS	K AH N JH EH L EY SH AH N Z
CONGENER	K AH N JH IY N ER
CONGENERIC	K AH N JH EH N ER IH K
CONGENEROUS	K AH N JH EH N ER AH S
CONGENERS	K AH N JH IY N ER Z
CONGENIAL	K AH N JH IY N Y AH L
CONGENIALITIES	K AH N JH IY N IY AE L AH T IY Z
CONGENIALITY	K AH N JH IY N IY AE L AH T IY
CONGENIALLY	K AH N JH IY N Y AH L IY
CONGENITAL	K AH N JH EH N AH T AH L
CONGENITALLY	K AH N JH EH N AH T AH L IY
CONGER	K AO NG ER
CONGERIES	K AA N JH AH R AY Z
CONGERS	K AA N JH EH R Z
CONGES	K AA N JH AH Z
CONGEST	K AH N JH EH S T
CONGESTED	K AH N JH EH S T AH D
CONGESTED(2)	K AH N JH EH S T IH D
CONGESTING	K AH N JH EH S T IH NG
CONGESTION	K AH N JH EH S CH AH N
CONGESTIONS	K AH N JH EH S SH AH N Z
CONGESTIVE	K AH N JH EH S T IH V
CONGESTS	K AH N JH EH S T S
CONSTRINGE	K AA N S T R IH N JH
CONSTRINGED	K AH N S T R IH NG D
CONSTRINGENT	K AH N S T R IH N JH AH N T
CONSTRINGES	K AH N S T R IH NG Z
CONTINGENCE	K AH N T IH N JH AH N S
CONTINGENCES	K AH N T IH N JH AH N S IH Z
CONTINGENCIES	K AH N T IH N JH AH N S IY Z
CONTINGENCY	K AH N T IH N JH AH N S IY
CONTINGENT	K AH N T IH N JH AH N T
CONTINGENTLY	K AH N T IH N JH AH N T L IY
CONTINGENTS	K AH N T IH N JH AH N T S
CONVERGE	K AH N V ER JH
CONVERGED	K AH N V ER JH D
CONVERGENCE	K AH N V ER JH AH N S
CONVERGENCES	K AH N V ER JH AH N S IH Z
CONVERGENCIES	K AH N V ER JH AH N S IY Z
CONVERGENCY	K AH N V ER JH AH N S IY
CONVERGENT	K AH N V ER JH AH N T
CONVERGES	K AH N V ER JH IH Z
COOPERAGE	K UW P ER AH JH
COOPERAGES	K OW AA P ER IH JH IH Z
CORDAGE	K AO R D AH JH
CORDAGES	K AO R D IH JH IH Z
CORKAGE	K AO R K IH JH
CORKAGES	K AO R K IH JH IH Z
CORRIGENDA	K AA R AH JH EH N D AH
CORRIGENDUM	K AA R AH JH EH N D AH M
CORSAGE	K AO R S AA ZH
CORSAGES	K AO R S AA ZH IH Z
CORTEGE	K AO R T EH ZH
CORTEGES	K AO R T EH ZH IH Z
COSMOGENIC	K OW S M AA G AH N IH K
COSTERMONGER	K AO S T ER M AH NG G ER
COSTERMONGERS	K AO S T ER M AH NG G ER Z
COTANGENT	K OW T AE N JH AH N T
COTANGENTS	K OW T AE N JH AH N T S
COTTAGE	K AA T AH JH
COTTAGE(2)	K AA T IH JH
COTTAGER	K AA T IH JH ER
COTTAGERS	K AA T IH JH ER Z
COTTAGES	K AA T IH JH IH Z
COTTAGEY	K AA T IH JH IY
COUNTERAGENT	K AW N T ER IH JH AH N T
COUNTERAGENTS	K AW N T ER IH JH AH N T S
COUNTERCHANGE	K AW N T ER CH EY N JH
COUNTERCHANGED	K AW N T ER CH EY N JH D
COUNTERCHANGES	K AW N T ER CH EY N JH IH Z
COUNTERCHARGE	K AW N T ER CH AA R JH
COUNTERCHARGE(2)	K AW N ER CH AA R JH
COUNTERCHARGED	K AW N T ER CH AA R JH D
COUNTERCHARGES	K AW N T ER CH AA R JH IH Z
COUNTERCHARGES(2)	K AW N ER CH AA R JH IH Z
COUNTERESPIONAGE	K AW N T ER EH S P IY AH N AA JH
COUNTERESPIONAGE(2)	K AW N ER EH S P Y AH N AA JH
COUNTERESPIONAGES	K AW N T ER EH S P IY AH N AA ZH IH Z
COUNTERIMAGE	K AW N T ER IH M IH JH
COUNTERIMAGES	K AW N T ER IH M IH JH IH Z
COUNTERINSURGENCIES	K AW N T ER IH N S ER JH AH N S IY Z
COUNTERINSURGENCIES(2)	K AW N ER IH N S ER JH AH N S IY Z
COUNTERINSURGENCY	K AW N T ER IH N S ER JH AH N S IY
COUNTERINSURGENCY(2)	K AW N ER IH N S ER JH AH N S IY
COUNTERINSURGENT	K AW N T ER IH N S ER JH AH N T
COUNTERINSURGENTS	K AW N T ER IH N S ER JH AH N T S
COUNTERINTELLIGENCE	K AW N T ER IH N T EH L IH JH AH N S
COUNTERINTELLIGENCE(2)	K AW N ER IH N T EH L IH JH AH N S
COUNTERINTELLIGENCES	K AW N T ER IH N T EH L AH JH AH N S IH Z
COUNTERSUGGESTION	K AW N T ER S AH G JH EH S SH AH N
COUNTERSUGGESTIONS	K AW N T ER S AH G JH EH S SH AH N Z
COURAGE	K ER IH JH
COURAGEOUS	K ER EY JH AH S
COURAGEOUSLY	K ER EY JH AH S L IY
COURAGEOUSNESS	K AH R EY JH AH S N AH S
COURAGEOUSNESSES	K AH R EY JH AH S N AH S IH Z
COURAGES	K ER IH JH IH Z
COURGETTE	K OW ER JH EH T
COURGETTES	K OW ER JH EH T S
COUSINAGE	K AH Z AH N IH JH
COUSINAGES	K AH Z AH N IH JH IH Z
COVERAGE	K AH V ER AH JH
COVERAGE(2)	K AH V ER IH JH
COVERAGE(3)	K AH V R IH JH
COVERAGES	K AH V ER AH JH IH Z
COVERAGES(2)	K AH V ER IH JH IH Z
COVERAGES(3)	K AH V R IH JH IH Z
COWAGE	K OW W EY JH
COWAGES	K OW W EY JH IH Z
COWHAGE	K OW AH JH
COWHAGES	K OW AH JH AH Z
COZENAGE	K AH Z AH N IH JH
COZENAGES	K AH Z AH N IH JH IH Z
CRAGGED	K R AE G D
CRANNOGE	K R AE N OW JH
CRANNOGES	K R AE N OW JH AH Z
CREEPAGE	K R IY P IH JH
CREEPAGES	K R IY P IH JH IH Z
CRIBBAGE	K R IH B AH JH
CRIBBAGES	K R IH B IH JH IH Z
CRINGE	K R IH N JH
CRINGED	K R IH N JH D
CRINGER	K R IH N JH ER
CRINGERS	K R IH N JH ER Z
CRINGES	K R IH N JH IH Z
CRYOGEN	K R AY AH JH AH N
CRYOGENIC	K R AY AH JH EH N IH K
CRYOGENICALLY	K R AY AH JH EH N AH K AE L IY
CRYOGENICS	K R AY AH JH EH N IH K S
CRYOGENIES	K R AY AA JH AH N AY Z
CRYOGENS	K R AY AH JH AH N Z
CRYOGENY	K R AY AA JH AH N IY
CRYOSURGEON	K R AY AA S ER JH AO N
CRYOSURGEONS	K R AY AA S ER JH AO N Z
CRYOSURGERIES	K R AY AA S ER JH AH R IY Z
CRYOSURGERY	K R AY AA S ER JH AH R IY
CRYPTOGENIC	K R IH P T AH JH AH N AH K
CUBAGE	K Y UW B IH JH
CUBAGES	K Y UW B IH JH IH Z
CUDGEL	K AH JH AH L
CUDGELED	K AH JH AH L D
CUDGELER	K AH JH AH L ER
CUDGELERS	K AH JH AH L ER Z
CUDGELING	K AH JH AH L IH NG
CUDGELLED	K AH JH AH L D
CUDGELLING	K AH JH AH L IH NG
CUDGELS	K AH JH AH L Z
CULTIGEN	K AH L T AH JH AH N
CULTIGENS	K AH L T AH JH AH N Z
CUNNINGER	K AH N IH NG ER
CUNNINGEST	K AH N IH NG AH S T
CURETTAGE	K Y UH R EH T IH JH
CURETTAGES	K Y UH R EH T IH JH IH Z
CURMUDGEON	K ER M AH JH IH N
CURMUDGEONLINESS	K AH R M AH JH IY AA N L AH N AH S
CURMUDGEONLINESSES	K AH R M AH JH IY AA N L AH N EH S AH Z
CURMUDGEONLY	K AH R M AH JH IY AA N L IY
CURMUDGEONS	K ER M AH JH IH N Z
CURTILAGE	K ER T AY L IH JH
CURTILAGES	K ER T AY L IH JH IH Z
CUTTAGE	K AH T IH JH
CUTTAGES	K AH T IH JH IH Z
CYANOGEN	S AY AE N AH JH AH N
CYANOGENESES	S AY AH N AA JH AH N IY Z AH Z
CYANOGENESIS	S AY AH N AH JH IY N AH S AH S
CYANOGENETIC	S AY AH N AA JH AH N AH T AH K
CYANOGENIC	S AY AE N AH JH AH N AH K
CYANOGENS	S AY AE N AH JH AH N Z
CYCLOGENESES	S IH K L AA JH AH N IY Z AH Z
CYCLOGENESIS	S IH K L AH JH IY N AH S AH S
CYMOGENE	S IH M AH JH IY N
CYMOGENES	S IH M AH JH IY N Z
CYTOGENETIC	S AH T AA JH AH N AH T AH K
CYTOGENETICAL	S IH T AH JH EH N AH T IH S AH L
CYTOGENETICALLY	S IH T AH JH AH N EH T AH K AE L IY
CYTOGENETICIST	S IH T AH JH EH N AH T IH S AH S T
CYTOGENETICISTS	S IH T AH JH AH N EH T AH S AH S T S
CYTOGENETICS	S IH T AH JH EH N AH T AH S Z
CYTOGENIES	S AH T AA JH AH N AY Z
CYTOGENY	S AH T AA JH AH N IY
CYTOPATHOGENIC	S IH T AH P AE TH AH JH AH N AH K
CYTOPATHOGENICITIES	S AH T AH P AE TH AH JH AH N IH S AH T AY Z
CYTOPATHOGENICITY	S IH T AH P AH TH AA JH AH N IH S AH T IY
DAGGER	D AE G ER
DAGGERED	D AE G ER D
DAGGERING	D AE G ER IH NG
DAGGERLIKE	D AE G ER L AY K
DAGGERS	D AE G ER Z
DAMAGE	D AE M AH JH
DAMAGE(2)	D AE M IH JH
DAMAGEABILITIES	D AE M IH JH AH B IH L AH T EH Z
DAMAGEABILITY	D AE M IH JH AH B IH L AH T EH
DAMAGED	D AE M AH JH D
DAMAGED(2)	D AE M IH JH D
DAMAGER	D AE M IH JH ER
DAMAGERS	D AE M IH JH ER Z
DAMAGES	D AE M AH JH AH Z
DAMAGES(2)	D AE M IH JH IH Z
DANEGELD	D AE N AH JH AH L D
DANEGELDS	D AE N AH JH AH L D Z
DANGED	D AE NG D
DANGER	D EY N JH ER
DANGERED	D EY N JH ER D
DANGERING	D EY N JH ER IH NG
DANGEROUS	D EY N JH ER AH S
DANGEROUSLY	D EY N JH ER AH S L IY
DANGEROUSNESS	D EY N JH ER AH S N AH S
DANGEROUSNESSES	D EY N JH ER AH S N AH S IH Z
DANGERS	D EY N JH ER Z
DEBUGGED	D IY B AH G D
DEBUGGER	D IY B UH G ER
DEBUGGERS	D IY B UH G ER Z
DECOLLETAGE	D EY K AA L AH T AA ZH
DECOLLETAGES	D EY K AA L AH T AA ZH IH Z
DECONGEST	D IY K AH N JH EH S T
DECONGESTANT	D IH K AH N JH EH S T AH N T
DECONGESTANT(2)	D IY K AH N JH EH S T AH N T
DECONGESTANTS	D IH K AH N JH EH S T AH N T S
DECONGESTANTS(2)	D IY K AH N JH EH S T AH N T S
DECONGESTED	D IY K AH N JH EH S T IH D
DECONGESTING	D IY K AH N JH EH S T IH NG
DECONGESTION	D IY K AH N JH EH S SH AH N
DECONGESTIONS	D IY K AH N JH EH S SH AH N Z
DECONGESTIVE	D IY K AH N JH EH S T IH V
DECONGESTS	D IY K AH N JH EH S T S
DECOUPAGE	D IY K UW P EY IH JH
DECOUPAGED	D IY K UW P EY IH JH D
DECOUPAGES	D IY K UW P EY IH JH IH Z
DEFANGED	D IY F AE NG D
DEFOGGED	D IY F AA G D
DEFOGGER	D IY F AA G ER
DEFOGGERS	D IY F AA G ER Z
DEGAGE	D IY G EY JH
DEGENERACIES	D IY JH EH N ER AH S IY Z
DEGENERACY	D IH JH EH N ER AH S IY
DEGENERATE	D IH JH EH N ER AH T
DEGENERATE(2)	D IH JH EH N ER EY T
DEGENERATED	D IH JH EH N ER EY T IH D
DEGENERATELY	D IY JH EH N ER AH T L IY
DEGENERATENESS	D IY JH EH N ER AH T N AH S
DEGENERATENESSES	D IY JH EH N ER AH T N AH S IH Z
DEGENERATES	D IH JH EH N ER AH T S
DEGENERATING	D IH JH EH N ER EY T IH NG
DEGENERATION	D IH JH EH N ER EY SH AH N
DEGENERATIONS	D IY JH EH N ER EY SH AH N Z
DEGENERATIVE	D IH JH EH N ER AH T IH V
DEGERM	D IY JH ER M
DEGERMED	D IY JH ER M D
DEGERMING	D IY JH ER M IH NG
DEGERMS	D IY JH ER M Z
DEHYDROGENASE	D AH HH IH D R AA JH AH N EY Z
DEHYDROGENASES	D AH HH IH D R AA JH AH N EY Z AH Z
DEHYDROGENATE	D IY HH AY D R AH JH AH N AH T
DEHYDROGENATED	D IY HH AY D R AH JH AH N EY T IH D
DEHYDROGENATES	D IY HH AY D R AH JH AH N AH T S
DEHYDROGENATING	D IY HH AY D R AH JH AH N EY T IH NG
DEHYDROGENATION	D IY HH AY D R AH JH AH N EY SH AH N
DEHYDROGENATIONS	D IY HH AY D R AH JH AH N EY SH AH N Z
DELUGE	D EH L Y UW JH
DELUGED	D EH L Y UW JH D
DELUGES	D EH L Y UW JH IH Z
DEMAGOGED	D IH M AH G OW JH D
DEMERGE	D IY M ER JH
DEMERGED	D IY M ER JH D
DEMERGER	D IY M ER JH ER
DEMERGERED	D IY M ER JH ER D
DEMERGERING	D IY M ER JH ER IH NG
DEMERGERS	D IY M ER JH ER Z
DEMERGES	D IY M ER JH IH Z
DEMIURGE	D AH M AY AH R JH
DEMIURGES	D AH M AY AH R JH AH Z
DEMURRAGE	D IH M ER IH JH
DEMURRAGES	D IH M ER IH JH IH Z
DEOXYGENATE	D IY AA K S IH JH AH N AH T
DEOXYGENATED	D IY AA K S IH JH AH N EY T IH D
DEOXYGENATES	D IY AA K S IH JH AH N AH T S
DEOXYGENATING	D IY AA K S IH JH AH N EY T IH NG
DEOXYGENATION	D IY AA K S IH JH AH N EY SH AH N
DEOXYGENATIONS	D IY AA K S IH JH AH N EY SH AH N Z
DERANGE	D IH R EY N JH
DERANGED	D IH R EY N JH D
DERANGEMENT	D IY R EY N JH M AH N T
DERANGEMENTS	D IY R EY N JH M AH N T S
DERANGES	D IY R EY N JH IH Z
DERINGER	D EH R IH N JH ER
DERINGERS	D IY R IH NG ER Z
DERMATOGEN	D IH R M AE T AH JH AH N
DERMATOGENS	D IH R M AE T AH JH AH N Z
DERRINGER	D EH R AH N JH ER
DERRINGERS	D IH R IH N JH AH R Z
DETERGE	D IH T ER JH
DETERGED	D IH T ER JH D
DETERGENCIES	D IH T ER JH AH N S IY Z
DETERGENCY	D IH T ER JH AH N S IY
DETERGENT	D IH T ER JH AH N T
DETERGENTS	D IH T ER JH AH N T S
DETERGER	D IH T ER JH ER
DETERGERS	D IH T ER JH ER Z
DETERGES	D IH T ER JH IH Z
DIABETOGENIC	D AY AH B EH T AH JH AH N AH K
DIAGENESES	D AY AE JH AH N IY Z AH Z
DIAGENESIS	D AY AH JH IY N AH S AH S
DIAGENETIC	D AY IH JH N EH T IH K
DIAGENETICALLY	D AY IH JH N EH T IH K AH L IY
DIAGEOTROPIC	D AY AH JH IY AA T R AH P AH K
DIALLAGE	D AY AH L IH JH
DIALLAGES	D AY AH L IH JH IH Z
DIALOGED	D AY AH L OW JH D
DIALOGER	D AY AH L OW JH AH R
DIALOGERS	D AY AE L AH JH AH R Z
DIDGERIDOO	D IH JH EH R AH D UW
DIDGERIDOOS	D IH JH EH R AH D UW Z
DIGENETIC	D IH JH AH N AH T AH K
DIGEST	D AY JH EH S T
DIGESTED	D AY JH EH S T IH D
DIGESTER	D AY JH EH S T ER
DIGESTERS	D AY JH EH S T ER Z
DIGESTIBILITIES	D AY JH EH S T AH B IH L AH T IY Z
DIGESTIBILITY	D AY JH EH S T AH B IH L AH T IY
DIGESTIBLE	D AY JH EH S T AH B AH L
DIGESTING	D AY JH EH S T IH NG
DIGESTION	D AY JH EH S CH AH N
DIGESTIONS	D AY JH EH S SH AH N Z
DIGESTIVE	D AY JH EH S T IH V
DIGESTIVELY	D AY JH EH S T IH V L IY
DIGESTIVES	D AY JH EH S T IH V Z
DIGESTOR	D AY JH EH S T ER
DIGESTORS	D AY JH EH S T ER Z
DIGESTS	D AY JH EH S T S
DIGGED	D IH G D
DIGGER	D IH G ER
DIGGERS	D IH G ER Z
DIGITOXIGENIN	D IH JH AH T AH K S IH JH AH N AH N
DIGITOXIGENINS	D IH JH AH T AH K S IH JH AH N AH N Z
DILIGENCE	D IH L IH JH AH N S
DILIGENCES	D IH L AH JH AH N S IH Z
DILIGENT	D IH L IH JH AH N T
DILIGENTLY	D IH L AH JH AH N T L IY
DINGDONGED	D IH N G D AH NG D
DINGE	D IH N JH
DINGED	D IH NG D
DINGER	D IH NG ER
DINGERS	D IH N JH AH R Z
DINGES	D IH N JH IH Z
DINGEY	D IH N JH IY
DINGEYS	D IH N JH EY Z
DINOFLAGELLATE	D AH N AA F L AE JH AH L EY T
DINOFLAGELLATES	D AH N AA F L AE JH AH L EY T S
DIPHOSGENE	D IH F AH Z IY N
DIPHOSGENES	D IH F AH Z IY N Z
DIRGE	D ER JH
DIRGEFUL	D ER JH F AH L
DIRGELIKE	D ER JH L AY K
DIRGES	D ER JH IH Z
DISADVANTAGE	D IH S AH D V AE N T IH JH
DISADVANTAGE(2)	D IH S AH D V AE N IH JH
DISADVANTAGED	D IH S AH D V AE N T IH JH D
DISADVANTAGED(2)	D IH S AH D V AE N IH JH D
DISADVANTAGEDNESS	D IH S AH D V AE N T IH JH AH D N AH S
DISADVANTAGEDNESSES	D IH S AH D V AE N T IH JH AH D N AH S IH Z
DISADVANTAGEOUS	D IH S AE D V AE N T EY JH AH S
DISADVANTAGEOUSLY	D IH S AE D V AE N T EY JH AH S L IY
DISADVANTAGEOUSNESS	D IH S AE D V AE N T EY JH AH S N AH S
DISADVANTAGEOUSNESSES	D IH S AE D V AE N T EY JH AH S N AH S IH Z
DISADVANTAGES	D IH S AH D V AE N T IH JH IH Z
DISADVANTAGES(2)	D IH S AH D V AE N IH JH Z
DISARRANGE	D IH S AH R EY N JH
DISARRANGED	D IH S AH R EY N JH D
DISARRANGEMENT	D IH S AH R EY N JH M AH N T
DISARRANGEMENTS	D IH S AH R EY N JH M AH N T S
DISARRANGES	D IH S AH R EY N JH IH Z
DISCHARGE	D IH S CH AA R JH
DISCHARGEABLE	D IH S CH AA R JH AH B AH L
DISCHARGED	D IH S CH AA R JH D
DISCHARGEE	D IH S CH AA R JH IY
DISCHARGEES	D IH S CH AA R JH IY Z
DISCHARGER	D IH S CH AA R JH ER
DISCHARGERS	D IH S CH AA R JH ER Z
DISCHARGES	D IH S CH AA R JH AH Z
DISCOURAGE	D IH S K ER IH JH
DISCOURAGEABLE	D IH S K ER IH JH AH B AH L
DISCOURAGED	D IH S K ER IH JH D
DISCOURAGEMENT	D IH S K ER IH JH M AH N T
DISCOURAGEMENTS	D IH S K ER IH JH M AH N T S
DISCOURAGER	D IH S K ER IH JH ER
DISCOURAGERS	D IH S K ER IH JH ER Z
DISCOURAGES	D IH S K ER IH JH IH Z
DISENGAGE	D IH S IH N G EY JH
DISENGAGED	D IH S IH N G EY JH D
DISENGAGEMENT	D IH S IH N G EY JH M AH N T
DISENGAGEMENTS	D IH S EH N G EY JH M AH N T S
DISENGAGES	D IH S EH N G EY JH IH Z
DISGORGE	D IH S G AO R JH
DISGORGED	D IH S G AO R JH D
DISGORGES	D IH S G AO R JH IH Z
DISINGENUOUS	D IH S IH N JH EH N Y UW AH S
DISINGENUOUSLY	D AH S AH N JH EH N Y UW OW AH S L IY
DISINGENUOUSNESS	D IH S IH N JH EH N Y UW AH S N AH S
DISINGENUOUSNESSES	D AH S AH N JH EH N Y UW AW Z N EH S AH Z
DISLODGE	D IH S L AA JH
DISLODGED	D IH S L AA JH D
DISLODGEMENT	D IH S L AA JH M AH N T
DISLODGEMENTS	D IH S L AA JH M AH N T S
DISLODGES	D IH S L AA JH IH Z
DISOBLIGE	D IH S AH B L AY JH
DISOBLIGED	D IH S AH B L AY JH D
DISOBLIGES	D IH S AH B L AY JH IH Z
DISPARAGE	D IH S P EH R IH JH
DISPARAGED	D IH S P EH R IH JH D
DISPARAGEMENT	D IH S P AE R IH JH M AH N T
DISPARAGEMENTS	D IH S P AE R IH JH M AH N T S
DISPARAGER	D IH S P AE R IH JH ER
DISPARAGERS	D IH S P AE R IH JH ER Z
DISPARAGES	D IH S P EH R IH JH IH Z
DITCHDIGGER	D IH CH D IH G ER
DITCHDIGGERS	D IH CH D IH G ER Z
DIVERGE	D IH V ER JH
DIVERGED	D AY V ER JH D
DIVERGENCE	D AY V ER JH AH N S
DIVERGENCE(2)	D IH V ER JH AH N S
DIVERGENCES	D AY V ER JH AH N S IH Z
DIVERGENCIES	D AY V ER JH AH N S IY Z
DIVERGENCY	D AY V ER JH AH N S IY
DIVERGENT	D AY V ER JH AH N T
DIVERGENT(2)	D IH V ER JH AH N T
DIVERGENTLY	D AY V ER JH AH N T L IY
DIVERGES	D AY V ER JH IH Z
DIVULGE	D IH V AH L JH
DIVULGE(2)	D AY V AH L JH
DIVULGED	D IH V AH L JH D
DIVULGED(2)	D AY V AH L JH D
DIVULGENCE	D AH V AH L JH AH N S
DIVULGENCES	D AH V AH L JH AH N S IH Z
DIVULGER	D AH V AH L JH ER
DIVULGERS	D AH V AH L JH ER Z
DIVULGES	D AH V AH L JH IH Z
DOCKAGE	D AA K IH JH
DOCKAGES	D AA K IH JH IH Z
DODGE	D AA JH
DODGEBALL	D AA JH B AO L
DODGEBALLS	D AA JH B AO L Z
DODGED	D AA JH D
DODGEM	D AA JH AH M
DODGEMS	D AA JH AH M Z
DODGER	D AA JH ER
DODGERIES	D AA JH AH R IY Z
DODGERS	D AA JH ER Z
DODGERY	D AA JH AH R IY
DODGES	D AA JH IH Z
DOGE	D OW JH
DOGEAR	D AA G IY R
DOGEARED	D AA G IY R D
DOGEARING	D AA G IY R IH NG
DOGEARS	D AA G IY R Z
DOGEDOM	D OW JH
DOGEDOMS	D AA JH AH D AH M Z
DOGES	D AO G Z
DOGESHIP	D AO G Z HH IH P
DOGESHIPS	D AO G Z HH IH P S
DOGEY	D OW JH IY
DOGEYS	D OW JH EY Z
DOGGED	D AO G D
DOGGEDLY	D AO G AH D L IY
DOGGEDNESS	D AO G AH D N AH S
DOGGEDNESSES	D AO G AH D N AH S IH Z
DOGGER	D AO G ER
DOGGEREL	D AA G ER AH L
DOGGERELS	D AA JH AH R AH L Z
DOGGERIES	D AO G AH R IY Z
DOGGERS	D AO G ER Z
DOGGERY	D AO G AH R IY
DOGLEGGED	D AO G L EH G D
DOPPELGANGER	D AA P EH L G AH NG AH R
DOPPELGANGERS	D AA P AH L G AE N JH AH R Z
DOSAGE	D OW S AH JH
DOSAGE(2)	D OW S IH JH
DOSAGES	D OW S IH JH IH Z
DOTAGE	D OW T IH JH
DOTAGES	D OW T IH JH IH Z
DOWAGER	D AW AH JH ER
DOWAGERS	D AW IH JH ER Z
DOWNRANGE	D AW N R EY N JH
DOWNSTAGE	D AW N S T EY JH
DOWNSTAGES	D AW N S T EY JH IH Z
DRAGEE	D R AE G IY
DRAGEES	D R AE G IY Z
DRAGGED	D R AE G D
DRAGGER	D R AE G ER
DRAGGERS	D R AE G ER Z
DRAINAGE	D R EY N AH JH
DRAINAGE(2)	D R EY N IH JH
DRAINAGES	D R EY N IH JH IH Z
DRAMATURGE	D R AE M AH T AH R JH
DRAMATURGES	D R AE M AH T AH R JH AH Z
DRAWBRIDGE	D R AO B R IH JH
DRAWBRIDGES	D R AO B R IH JH IH Z
DRAYAGE	D R EY AH JH
DRAYAGES	D R EY AH JH AH Z
DREDGE	D R EH JH
DREDGED	D R EH JH D
DREDGER	D R EH JH AH R
DREDGERS	D R EH JH AH R Z
DREDGES	D R EH JH AH Z
DREDGES(2)	D R EH JH IH Z
DRESSAGE	D R EH S AA ZH
DRESSAGES	D R EH S IH JH IH Z
DRIFTAGE	D R IH F T IH JH
DRIFTAGES	D R IH F T IH JH IH Z
DRUDGE	D R AH JH
DRUDGED	D R AH JH D
DRUDGER	D R AH JH ER
DRUDGERIES	D R AH JH AH R IY Z
DRUDGERS	D R AH JH ER Z
DRUDGERY	D R AH JH ER IY
DRUDGES	D R AH JH IH Z
DRUGGED	D R AH G D
DRUGGET	D R AH G EH T
DRUGGETS	D R AH G EH T S
DUDGEON	D AH JH AH N
DUDGEONS	D AH JH IY AH N Z
DUNGED	D AH NG D
DUNGEON	D AH N JH AH N
DUNGEONED	D AH N JH AH N D
DUNGEONING	D AH N JH AH N IH NG
DUNGEONS	D AH N JH AH N Z
DUNNAGE	D AH N IH JH
DUNNAGES	D AH N IH JH IH Z
DYSGENESES	D IH Z AH N IY Z AH Z
DYSGENESIS	D IH Z IY N AH S AH S
DYSGENIC	D IH Z AH N AH K
EAGER	IY G ER
EAGERER	IY G ER ER
EAGEREST	IY G ER AH S T
EAGERLY	IY G ER L IY
EAGERNESS	IY G ER N AH S
EAGERNESSES	IY G ER N AH S IH Z
EAGERS	IY G ER Z
EARWIGGED	IH ER W IH G D
EDGE	EH JH
EDGED	EH JH D
EDGELESS	EH JH L AH S
EDGER	EH JH ER
EDGERS	EH JH ER Z
EDGES	EH JH AH Z
EDGES(2)	EH JH IH Z
EDGEWAYS	EH JH W EY Z
EDGEWISE	EH JH W AY Z
EFFULGE	EH F AH L JH
EFFULGED	EH F AH L JH D
EFFULGENCE	EH F UH L JH AH N S
EFFULGENCES	EH F UH L JH EH N S AH Z
EFFULGENT	EH F UH L JH AH N T
EFFULGES	EH F UH L JH AH Z
EGER	IY G ER
EGERS	EH JH AH R Z
EGEST	IY JH AH S T
EGESTA	AH JH EH S T AH
EGESTED	IY JH EH S T AH D
EGESTING	AH JH EH S T AH NG
EGESTION	IY JH EH S T IY AH N
EGESTIONS	AH JH EH S T IY AH N Z
EGESTIVE	IY JH EH S T AH V
EGESTS	EH JH AH S T S
EGGED	EH G D
EGGER	EH G ER
EGGERS	EH G ER Z
EIGENMODE	EY JH AH N M OW D
EIGENMODES	EY JH AH N M OW D Z
EIGENVALUE	AY G AH N V AE L Y UW
EIGENVALUES	AY G AH N V AE L Y UW Z
EIGENVECTOR	EY JH EH N V EH K T AH R
EIGENVECTORS	EY JH AH N V EH K T AH R Z
EISEGESES	IY S AH JH IY Z AH Z
EISEGESIS	IY S IY JH AH S AH S
ELECTROGENESES	AH L EH K T R AA JH AH N IY Z AH Z
ELECTROGENESIS	AH L EH K T R AH JH IY N AH S AH S
ELECTROGENIC	AH L EH K T R AH JH AH N AH K
ELECTROSURGERIES	AH L EH K T R AH S AH R JH AH R AY Z
ELECTROSURGERY	AH L EH K T R AH S AH R JH EH R IY
EMALANGENI	AH M AH L AE N JH AH N IY
EMBASSAGE	IH M B EY S IH JH
EMBASSAGES	IH M B EY S IH JH IH Z
EMBOURGEOISEMENT	IH M B AH R JH IY OY Z M AH N T
EMBOURGEOISEMENTS	IH M B AH R JH IY OY S AH M AH N T S
EMBRYOGENESES	EH M B R IY OW JH IY N Z IH Z
EMBRYOGENESIS	EH M B R IY OW JH EH N AH S AH S
EMBRYOGENETIC	EH M B R IY OW JH AH N EH T IH K
EMBRYOGENIC	EH M B R IY OW JH IY N IH K
EMBRYOGENIES	EH M B R IY OW JH IY N IY Z
EMBRYOGENY	EH M B R IY OW JH IY N IY
EMERGE	IH M ER JH
EMERGE(2)	IY M ER JH
EMERGED	IH M ER JH D
EMERGED(2)	IY M ER JH D
EMERGENCE	IH M ER JH AH N S
EMERGENCE(2)	IY M ER JH AH N S
EMERGENCES	IH M ER JH AH N S IH Z
EMERGENCIES	IH M ER JH AH N S IY Z
EMERGENCIES(2)	IY M ER JH AH N S IY Z
EMERGENCY	IH M ER JH AH N S IY
EMERGENCY(2)	IY M ER JH AH N S IY
EMERGENT	IH M ER JH AH N T
EMERGENT(2)	IY M ER JH AH N T
EMERGENTS	IH M ER JH AH N T S
EMERGES	IH M ER JH IH Z
EMERGES(2)	IY M ER JH IH Z
EMPENNAGE	IH M P EH N IH JH
EMPENNAGES	IH M P EH N IH JH IH Z
ENCAGE	EH N K EY JH
ENCAGED	EH N K EY JH D
ENCAGES	EH N K EY JH IH Z
ENCEPHALITOGEN	IH N S AH F AH L IH T AH JH AH N
ENCEPHALITOGENIC	IH N S EH F AH L IH T AH JH AH N AH K
ENCEPHALITOGENS	IH N S EH F AH L IH T AH JH AH N Z
ENCOURAGE	EH N K ER IH JH
ENCOURAGE(2)	IH N K ER AH JH
ENCOURAGED	EH N K ER IH JH D
ENCOURAGED(2)	IH N K ER AH JH D
ENCOURAGEMENT	EH N K ER IH JH M AH N T
ENCOURAGEMENTS	EH N K ER IH JH M AH N T S
ENCOURAGER	EH N K ER IH JH ER
ENCOURAGERS	EH N K ER IH JH ER Z
ENCOURAGES	EH N K ER IH JH IH Z
ENCOURAGES(2)	IH N K ER AH JH AH Z
ENDAMAGE	EH N D AE M IH JH
ENDAMAGED	EH N D AE M IH JH D
ENDAMAGES	EH N D AE M IH JH IH Z
ENDANGER	EH N D EY N JH ER
ENDANGERED	EH N D EY N JH ER D
ENDANGERED(2)	IH N D EY N JH ER D
ENDANGERING	EH N D EY N JH ER IH NG
ENDANGERMENT	EH N D EY N JH ER M AH N T
ENDANGERMENTS	EH N D EY N JH ER M AH N T S
ENDANGERS	EH N D EY N JH ER Z
ENDOGEN	EH N D AO G AH N
ENDOGENIC	EH N D AO G AH N IH K
ENDOGENIES	EH N D AO G AH N IY Z
ENDOGENOUS	EH N D AO JH EH N AH S
ENDOGENOUSLY	EH N D AA JH AH N AH S L IY
ENDOGENS	EH N D AO G AH N Z
ENDOGENY	EH N D AO G AH N IY
ENERGETIC	EH N ER JH EH T IH K
ENERGETICALLY	EH N ER JH EH T IH K L IY
ENERGETICS	EH N ER JH EH T IH K S
ENFLEURAGE	IH N F L IY Y AH R AH JH
ENFLEURAGES	IH N F L AH Y UH R AH JH AH Z
ENGAGE	IH N G EY JH
ENGAGED	IH N G EY JH D
ENGAGEMENT	EH N G EY JH M AH N T
ENGAGEMENTS	IH N G EY JH M AH N T S
ENGAGER	EH N G EY JH ER
ENGAGERS	EH N G EY JH ER Z
ENGAGES	IH N G EY JH IH Z
ENGENDER	EH N JH EH N D ER
ENGENDER(2)	IH N JH EH N D ER
ENGENDERED	EH N JH EH N D ER D
ENGENDERING	EH N JH EH N D ER IH NG
ENGENDERS	EH NG G AH N D ER Z
ENGORGE	EH N G AO R JH
ENGORGED	EH N G AO R JH D
ENGORGEMENT	EH N G AO R JH M AH N T
ENGORGEMENTS	EH N G AO R JH M AH N T S
ENGORGES	EH N G AO R JH IH Z
ENLARGE	EH N L AA R JH
ENLARGEABLE	EH N L AA R JH AH B AH L
ENLARGED	EH N L AA R JH D
ENLARGEMENT	EH N L AA R JH M AH N T
ENLARGEMENTS	EH N L AA R JH M AH N T S
ENLARGER	EH N L AA R G ER
ENLARGERS	EH N L AA R JH ER Z
ENLARGES	EH N L AA R JH IH Z
ENRAGE	EH N R EY JH
ENRAGED	EH N R EY JH D
ENRAGED(2)	IH N R EY JH D
ENRAGES	EH N R EY JH AH Z
ENSILAGE	EH N Z IH L EY JH
ENSILAGED	EH N Z IH L EY JH D
ENSILAGES	EH N Z IH L EY JH IH Z
ENTEROPATHOGENIC	IH N T EH R AH P AE TH AH JH AH N AH K
ENTOURAGE	AA N T UH R AA ZH
ENTOURAGE(2)	AA N T ER AA ZH
ENTOURAGES	AA N T UH R AA ZH AH Z
ENTOURAGES(2)	AA N T ER AA ZH AH Z
ENVISAGE	EH N V IH Z IH JH
ENVISAGED	EH N V IH Z IH JH D
ENVISAGES	EH N V IH Z IH JH IH Z
EPEIROGENIC	IY P IY R AH JH AH N AH K
EPEIROGENICALLY	IY P AH R AH JH EH N AH K AE L IY
EPEIROGENIES	IY P AH R AA JH AH N AY Z
EPEIROGENY	IY P AH R AA JH AH N IY
EPEXEGESES	AH P EH K S AH JH IY Z AH Z
EPEXEGESIS	EH P AH K S IY JH AH S AH S
EPEXEGETIC	AH P EH K S AH JH AH T AH K
EPEXEGETICAL	AH P EH K S EH JH AH T IH S AH L
EPEXEGETICALLY	AH P EH K S AH JH EH T AH K AE L IY
EPIGEAL	AH P IH JH IY AH L
EPIGEAN	AH P AY JH IY AH N
EPIGEIC	AH P AY JH IY AH K
EPIGENE	EH P AH JH IY N
EPIGENESES	AH P IH JH AH N IY Z AH Z
EPIGENESIS	EH P AH JH IY N AH S AH S
EPIGENETIC	EH P IH JH AH N EH T IH K
EPIGENETICALLY	EH P AH JH AH N EH T IH K AH L IY
EPIGENIC	EH P AH JH AH N AH K
EPIGEOUS	AH P IH JH IY AH S
EPILEPTOGENIC	EH P AH L EH P T AH JH AH N AH K
EQUIPAGE	IH K W IH P IH JH
EQUIPAGES	IH K W IH P IH JH IH Z
ERIGERON	AH R IH JH AH R AH N
ERIGERONS	AH R IH JH AH R AH N Z
EROGENIC	EH R AH JH AH N AH K
EROGENOUS	AH R AA JH AH N AH S
EROTOGENIC	AH R AA T AH JH AH N AH K
ESCUAGE	EH S Y UW AH JH
ESCUAGES	EH S Y UW AH JH AH Z
ESOPHAGEAL	EH S AH F IH JH IY AH L
ESPIONAGE	EH S P IY AH N AA JH
ESPIONAGES	EH S P IY AH N AA ZH IH Z
ESTRANGE	EH S T R EY N JH
ESTRANGED	EH S T R EY N JH D
ESTRANGEMENT	IH S T R EY N JH M AH N T
ESTRANGEMENTS	IH S T R EY N JH M AH N T S
ESTRANGER	IH S T R EY N JH ER
ESTRANGERS	IH S T R EY N JH ER Z
ESTRANGES	IH S T R EY N JH IH Z
ESTROGEN	EH S T R AH JH AH N
ESTROGENIC	EH S T R AH JH AH N AH K
ESTROGENICALLY	EH S T R AH JH EH N AH K AE L IY
ESTROGENS	EH S T R AH JH IH N Z
ETAGERE	AH T EY JH AH R
ETAGERES	EH T AH JH IY R Z
EUGENIA	Y UW JH IY N IY AH
EUGENIAS	Y UW JH IY N Y AH Z
EUGENIC	Y UW JH EH N IH K
EUGENICALLY	Y UH JH EH N IH K AH L IY
EUGENICIST	Y UH JH EH N IH K IH S T
EUGENICISTS	Y UH JH EH N IH K IH S T S
EUGENICS	Y UW JH EH N IH K S
EUGENIST	Y UW JH AH N AH S T
EUGENISTS	Y UW JH AH N AH S T S
EUGENOL	Y UW JH AH N AH L
EUGENOLS	Y UW JH AH N AH L Z
EUGEOSYNCLINAL	Y UW JH IY AH S IH NG K L AH N AH L
EUGEOSYNCLINE	Y UW JH IY AA S AH NG K L AY N
EUGEOSYNCLINES	Y UW JH IY AA S AH NG K L AY N Z
EVANGEL	IH V AE N JH AH L
EVANGELIC	IY V AE N JH EH L IH K
EVANGELICAL	IY V AE N JH EH L IH K AH L
EVANGELICALLY	IY V AE N JH EH L IH K AH L IY
EVANGELICALS	IY V AE N JH EH L IH K AH L Z
EVANGELISM	IH V AE N JH AH L IH Z AH M
EVANGELISM(2)	IY V AE N JH AH L IH Z AH M
EVANGELISMS	IH V AE N JH AH L IH Z AH M Z
EVANGELIST	IH V AE N JH AH L IH S T
EVANGELIST(2)	IY V AE N JH AH L IH S T
EVANGELISTIC	IY V AE N JH AH L IH S T IH K
EVANGELISTICALLY	IH V AE N JH AH L IH S T IH K AH L IY
EVANGELISTS	IH V AE N JH AH L IH S T S
EVANGELISTS(2)	IY V AE N JH AH L IH S T S
EVANGELISTS(3)	IH V AE N JH AH L IH S
EVANGELISTS(4)	IY V AE N JH AH L IH S
EVANGELIZATION	IH V AE N JH AH L AH Z EY SH AH N
EVANGELIZATIONS	IH V AE N JH AH L AH Z EY SH AH N Z
EVANGELIZE	IH V AE N JH AH L AY Z
EVANGELIZE(2)	IY V AE N JH AH L AY Z
EVANGELIZED	IH V AE N JH AH L AY Z D
EVANGELIZES	IH V AE N JH AH L AY Z IH Z
EVANGELIZING	IH V AE N JH AH L AY Z IH NG
EVANGELS	IH V AE N JH AH L Z
EXAGGERATE	IH G Z AE JH ER EY T
EXAGGERATED	IH G Z AE JH ER EY T AH D
EXAGGERATED(2)	IH G Z AE JH ER EY T IH D
EXAGGERATEDLY	IH G Z AE JH ER AH T AH D L IY
EXAGGERATEDNESS	IH G Z AE JH ER AH T AH D N AH S
EXAGGERATEDNESSES	IH G Z AE JH ER AH T AH D N AH S IH Z
EXAGGERATES	IH G Z AE JH ER EY T S
EXAGGERATING	IH G Z AE JH ER EY T IH NG
EXAGGERATION	IH G Z AE JH ER EY SH AH N
EXAGGERATIONS	IH G Z AE JH ER EY SH AH N Z
EXAGGERATIVE	IH G Z AE JH ER AH T IH V
EXAGGERATOR	IH G Z AE JH ER AH T ER
EXAGGERATORS	IH G Z AE JH ER AH T ER Z
EXAGGERATORY	IH G Z AE JH ER AH T OW R IY
EXCHANGE	IH K S CH EY N JH
EXCHANGEABILITIES	IH K S CH EY N JH AH B IH L AH T EH Z
EXCHANGEABILITY	IH K S CH EY N JH AH B IH L AH T EH
EXCHANGEABLE	IH K S CH EY N JH AH B AH L
EXCHANGED	IH K S CH EY N JH D
EXCHANGER	IH K S CH EY N JH ER
EXCHANGERS	IH K S CH EY N JH ER Z
EXCHANGES	IH K S CH EY N JH AH Z
EXCHANGES(2)	IH K S CH EY N JH IH Z
EXEGESES	IH G Z AH JH IY Z AH Z
EXEGESIS	IH G Z IY JH AH S AH S
EXEGETE	EH K S AH JH IY T
EXEGETES	EH K S AH JH IY T S
EXEGETIC	EH K S AH JH IY T IH K
EXEGETICAL	EH K S AH JH IY T IH K AH L
EXEGETIST	EH K S AH JH IY T IH S T
EXEGETISTS	EH K S AH JH IY T IH S T S
EXIGENCE	IH G Z IH JH AH N S
EXIGENCES	IH G Z IH JH AH N S IH Z
EXIGENCIES	EH K S IH JH AH N S IY Z
EXIGENCY	EH K S IH JH AH N S IY
EXIGENT	EH K S IH JH AH N T
EXIGENTLY	IH G Z IH JH AH N T L IY
EXOGEN	IH G Z AA JH AH N
EXOGENOUS	EH K S OW JH AH N AH S
EXOGENOUSLY	IH G Z AH JH EH N OW AH S L IY
EXOGENS	IH G Z AA JH AH N Z
EXPRESSAGE	IH K S P R EH S IH JH
EXPRESSAGES	IH K S P R EH S IH JH IH Z
EXPUNGE	IH K S P AH N JH
EXPUNGED	IH K S P AH N JH D
EXPUNGER	EH K S P AH N JH ER
EXPUNGERS	EH K S P AH N JH ER Z
EXPUNGES	IH K S P AH N JH IH Z
FACTORAGE	F AE K T ER IH JH
FACTORAGES	F AE K T ER IH JH IH Z
FADGE	F AE JH
FADGED	F AE JH D
FADGES	F AE JH AH Z
FAGGED	F AE G D
FANGED	F AE NG D
FASHIONMONGER	F AE SH AH N M AH NG G ER
FASHIONMONGERS	F AE SH AH N M AH NG G ER Z
FEATHEREDGE	F EH DH ER EH JH
FEATHEREDGED	F EH DH ER EH JH D
FEATHEREDGES	F EH DH ER EH JH IH Z
FEBRIFUGE	F EH B R AH F Y UW JH
FEBRIFUGES	F EH B R AH F Y UW JH AH Z
FELLMONGER	F EH L M AH NG G ER
FELLMONGERED	F EH L M AH NG G ER D
FELLMONGERIES	F EH L M AH NG G ER IY Z
FELLMONGERING	F EH L M AH NG G ER IH NG
FELLMONGERINGS	F EH L M AH NG G ER IH NG Z
FELLMONGERS	F EH L M AH NG G ER Z
FELLMONGERY	F EH L M AH NG G ER IY
FERRIAGE	F EH R IY IH JH
FERRIAGES	F EH R IY IH JH IH Z
FIBRINOGEN	F IH B R IH N AH JH AH N
FIBRINOGENS	F IH B R IH N AH JH AH N Z
FIDGE	F IH JH
FIDGED	F IH JH D
FIDGES	F IH JH AH Z
FIDGET	F IH JH IH T
FIDGETED	F IH JH IY T AH D
FIDGETER	F IH JH IY T AH R
FIDGETERS	F IH JH AH T AH R Z
FIDGETINESS	F IH JH EH T AH N AH S
FIDGETINESSES	F IH JH EH T AH N EH S AH Z
FIDGETING	F IH JH AH T IH NG
FIDGETS	F IH JH AH T S
FIDGETY	F IH JH AH T IY
FIGEATER	F IH G IY T ER
FIGEATERS	F IH G IY T ER Z
FIGGED	F IH G D
FINGER	F IH NG G ER
FINGERBOARD	F IH NG G ER B AO R D
FINGERBOARDS	F IH NG G ER B OW R D Z
FINGERED	F IH NG G ER D
FINGERER	F IH NG G ER ER
FINGERERS	F IH NG G ER ER Z
FINGERHOLD	F IH NG G ER HH OW L D
FINGERHOLDS	F IH NG G ER HH OW L D Z
FINGERING	F IH NG G ER IH NG
FINGERINGS	F IH NG G ER IH NG Z
FINGERLIKE	F IH NG G ER L AY K
FINGERLING	F IH NG G ER L IH NG
FINGERLINGS	F IH NG G ER L IH NG Z
FINGERNAIL	F IH NG G ER N EY L
FINGERNAILS	F IH NG G ER N EY L Z
FINGERPICK	F IH NG G ER P IH K
FINGERPICKED	F IH NG G ER P IH K T
FINGERPICKING	F IH NG G ER P IH K IH NG
FINGERPICKINGS	F IH NG G ER P IH K IH NG Z
FINGERPICKS	F IH NG G ER P IH K S
FINGERPOST	F IH NG G ER P OW S T
FINGERPOSTS	F IH NG G ER P OW S T S
FINGERPRINT	F IH NG G ER P R IH N T
FINGERPRINTED	F IH NG G ER P R IH N T IH D
FINGERPRINTING	F IH NG G ER P R IH N T IH NG
FINGERPRINTINGS	F IH NG G ER P R IH N T IH NG Z
FINGERPRINTS	F IH NG G ER P R IH N T S
FINGERS	F IH NG G ER Z
FINGERTIP	F IH NG G ER T IH P
FINGERTIPS	F IH NG G ER T IH P S
FIREFANGED	F AY ER F AE NG D
FISHMONGER	F IH SH M AA NG G ER
FISHMONGERS	F IH SH M AH NG G ER Z
FLAGELLA	F L AH JH EH L AH
FLAGELLANT	F L AE JH AH L AH N T
FLAGELLANTISM	F L AE JH AH L AH N T IH Z AH M
FLAGELLANTISMS	F L AE JH AH L AH N T IH Z AH M Z
FLAGELLANTS	F L AE JH AH L AH N T S
FLAGELLAR	F L AE JH AH L ER
FLAGELLATE	F L AE JH AH L EY T
FLAGELLATED	F L AE JH AH L EY T AH D
FLAGELLATES	F L AE JH AH L AH T S
FLAGELLATING	F L AE JH AH L EY T IH NG
FLAGELLATION	F L AE JH AH L EY SH AH N
FLAGELLATIONS	F L AE JH AH L EY SH AH N Z
FLAGELLIN	F L AH JH EH L AH N
FLAGELLINS	F L AH JH EH L AH N Z
FLAGELLUM	F L AH JH EH L AH M
FLAGELLUMS	F L AH JH EH L AH M Z
FLAGEOLET	F L AE JH AH L EH T
FLAGEOLETS	F L AE JH AH L EH T S
FLAGGED	F L AE G D
FLAGGER	F L AE G ER
FLAGGERS	F L AE G ER Z
FLANGE	F L AE N JH
FLANGED	F L AE N JH D
FLANGER	F L AE N JH ER
FLANGERS	F L AE N JH ER Z
FLANGES	F L AE N JH AH Z
FLEDGE	F L EH JH
FLEDGED	F L EH JH D
FLEDGES	F L EH JH AH Z
FLINGER	F L IH NG ER
FLINGERS	F L IH NG ER Z
FLOATAGE	F L OW T IH JH
FLOATAGES	F L OW T IH JH IH Z
FLOGGED	F L AA G D
FLOGGER	F L AA G ER
FLOGGERS	F L AA G ER Z
FLOORAGE	F L OW R IH JH
FLOORAGES	F L OW R IH JH IH Z
FLORIGEN	F L AO R AH JH AH N
FLORIGENIC	F L AO R AH JH AH N AH K
FLORIGENS	F L AO R AH JH AH N Z
FLOTAGE	F L OW T AH JH
FLOTAGES	F L OW T AH JH AH Z
FLOWAGE	F L OW IH JH
FLOWAGES	F L OW IH JH IH Z
FLOWERAGE	F L AW ER IH JH
FLOWERAGES	F L AW ER IH JH IH Z
FLUEGELHORN	F L UW AH JH EH L HH AH R N
FLUEGELHORNS	F L UW AH JH EH L HH AH R N Z
FLUGELHORN	F L UW JH EH L HH AO R N
FLUGELHORNIST	F L UW JH EH L HH AO R N IH S T
FLUGELHORNISTS	F L UW JH EH L HH AO R N IH S T S
FLUGELHORNS	F L UW JH EH L HH AO R N Z
FLYBRIDGE	F L AY B R IH JH
FLYBRIDGES	F L AY B R IH JH IH Z
FODGEL	F AA JH AH L
FOGEY	F OW JH IY
FOGEYS	F OW JH EY Z
FOGGAGE	F AA G IH JH
FOGGAGES	F AA G IH JH IH Z
FOGGED	F AA G D
FOGGER	F AA G ER
FOGGERS	F AA G ER Z
FOLIAGE	F OW L IH JH
FOLIAGE(2)	F OW L IY IH JH
FOLIAGED	F OW L IY IH JH D
FOLIAGES	F OW L IY IH JH IH Z
FOLKSINGER	F OW K S IH NG ER
FOLKSINGERS	F OW K S IH NG ER Z
FOOTAGE	F UH T IH JH
FOOTAGES	F UH T IH JH IH Z
FOOTBRIDGE	F UH T B R IH JH
FOOTBRIDGES	F UH T B R IH JH IH Z
FOOTDRAGGER	F UH T D R AE G ER
FOOTDRAGGERS	F UH T D R AE G ER Z
FOOTGEAR	F UH T G IH ER
FOOTGEARS	F UH T G IH ER Z
FOOTSLOGGED	F UH T S L AA G D
FOOTSLOGGER	F UH T S L AA G ER
FOOTSLOGGERS	F UH T S L AA G ER Z
FORAGE	F AO R IH JH
FORAGED	F AO R IH JH D
FORAGER	F AO R IH JH ER
FORAGERS	F AO R IH JH ER Z
FORAGES	F AO R AH JH AH Z
FOREFINGER	F AO R F IH NG G ER
FOREFINGERS	F AO R F IH NG G ER Z
FOREJUDGE	F OW R JH AH JH
FOREJUDGED	F OW R JH AH JH D
FOREJUDGES	F OW R JH AH JH IH Z
FOREKNOWLEDGE	F OW R N AA L IH JH
FOREKNOWLEDGES	F OW R N AA L IH JH IH Z
FORESTAGE	F AO R AH S T IH JH
FORESTAGES	F AO R AH S T IH JH IH Z
FORGE	F AO R JH
FORGEABILITIES	F OW R JH AH B IH L AH T EH Z
FORGEABILITY	F OW R JH AH B IH L AH T EH
FORGEABLE	F OW R JH AH B AH L
FORGED	F AO R JH D
FORGER	F AO R JH ER
FORGERIES	F AO R JH ER IY Z
FORGERS	F AO R JH ER Z
FORGERY	F AO R JH ER IY
FORGES	F AO R JH IH Z
FORGET	F ER G EH T
FORGET(2)	F AO R G EH T
FORGETFUL	F AO R G EH T F AH L
FORGETFUL(2)	F ER G EH T F AH L
FORGETFULLY	F AO R G EH T F AH L IY
FORGETFULNESS	F AO R G EH T F AH L N AH S
FORGETFULNESSES	F AO R G EH T F AH L N AH S IH Z
FORGETIVE	F AO R G EH T IH V
FORGETS	F ER G EH T S
FORGETS(2)	F AO R G EH T S
FORGETTABLE	F AO R G EH T AH B AH L
FORGETTABLE(2)	F ER G EH T AH B AH L
FORGETTER	F OW R JH EH T ER
FORGETTERS	F OW R JH EH T ER Z
FORGETTING	F ER G EH T IH NG
FORGETTING(2)	F AO R G EH T IH NG
FORJUDGE	F AO R JH AH JH
FORJUDGED	F AO R JH AH JH D
FORJUDGES	F AO R JH AH JH IH Z
FOSTERAGE	F AO S T ER IH JH
FOSTERAGES	F AO S T ER IH JH IH Z
FOURRAGERE	F AH R EY JH AH R
FOURRAGERES	F AH R AH JH IY R Z
FRAGGED	F R AE G D
FRANKPLEDGE	F R AE NG K P L EH JH
FRANKPLEDGES	F R AE NG K P L EH JH IH Z
FREIGHTAGE	F R EY T IH JH
FREIGHTAGES	F R EY T IH JH IH Z
FRIDGE	F R IH JH
FRIDGES	F R IH JH AH Z
FRIGGED	F R IH G D
FRINGE	F R IH N JH
FRINGED	F R IH N JH D
FRINGES	F R IH N JH IH Z
FROGEYE	F R AA G AY
FROGEYED	F R AA G AY D
FROGEYES	F R AA G AY Z
FROGGED	F R AA G D
FROMAGE	F R OW M AH JH
FROMAGES	F R OW M AH JH AH Z
FRONTAGE	F R AH N T IH JH
FRONTAGES	F R AH N T IH JH IH Z
FRONTOGENESES	F R AA N T AA JH AH N IY Z AH Z
FRONTOGENESIS	F R AA N T AH JH IY N AH S AH S
FROTTAGE	F R AA T AH JH
FROTTAGES	F R AA T AH JH AH Z
FRUGGED	F R AH G D
FRUITAGE	F R UW T IH JH
FRUITAGES	F R UW T IH JH IH Z
FUDGE	F AH JH
FUDGED	F AH JH D
FUDGES	F AH JH AH Z
FUGGED	F AH G D
FULGENT	F UH L JH AH N T
FULGENTLY	F UH L JH EH N T L IY
FUSELAGE	F Y UW S AH L AA JH
FUSELAGE(2)	F Y UW S AH L IH JH
FUSELAGES	F Y UW S AH L AA JH IH Z
FUSELAGES(2)	F Y UW S AH L IH JH IH Z
FUSSBUDGET	F AH S B AH JH AH T
FUSSBUDGETS	F AH S B AH JH AH T S
FUSSBUDGETY	F AH S B AH JH AH T IY
GADGET	G AE JH AH T
GADGETEER	G AE JH AH T IH R
GADGETEERS	G AE JH AH T IH R Z
GADGETRIES	G AE JH AH T R IY Z
GADGETRY	G AE JH AH T R IY
GADGETS	G AE JH AH T S
GADGETY	G AE JH AH T IY
GAGE	G EY JH
GAGED	G EY JH D
GAGER	G EY G ER
GAGERS	G EY JH ER Z
GAGES	G EY JH IH Z
GAGGED	G AE G D
GAGGER	G AE G ER
GAGGERS	G AE G ER Z
GALLONAGE	G AE L AH N IH JH
GALLONAGES	G AE L AH N IH JH IH Z
GAMBOGE	G AE M B OW JH
GAMBOGES	G AE M B OW JH AH Z
GAMETOGENESES	G AH M AH T AA JH AH N IY Z AH Z
GAMETOGENESIS	G AE M AH T AH JH IY N AH S AH S
GAMETOGENIC	G EY M T AA G AH N IH K
GAMETOGENOUS	G EY M T AA G AH N AH S
GANGBANGER	G AE NG B AE NG G ER
GANGBANGERS	G AE NG B AE NG G ER Z
GANGED	G AE NG D
GANGER	G AE NG ER
GANGERS	G AE NG ER Z
GARAGE	G ER AA ZH
GARAGED	G AH R AA ZH D
GARAGEMAN	G AH R AA ZH M AE N
GARAGEMEN	G AH R AA ZH M EH N
GARAGES	G ER AA ZH IH Z
GARBAGE	G AA R B IH JH
GARBAGEMAN	G AA R B IH JH M AE N
GARBAGEMEN	G AA R B IH JH M EH N
GARBAGES	G AA R B IH JH IH Z
GARGET	G AA R JH AH T
GARGETS	G AA R JH AH T S
GARGETY	G AA R JH AH T IY
GASOGENE	G AE S AH JH IY N
GASOGENES	G AE S AH JH IY N Z
GASTROESOPHAGEAL	G AE S T R OW EH S AH F IH JH IY AH L
GAUGE	G EY JH
GAUGED	G EY JH D
GAUGER	G EY JH ER
GAUGERS	G EY JH ER Z
GAUGES	G EY JH AH Z
GAUGES(2)	G EY JH IH Z
GAVAGE	G EY V IH JH
GAVAGES	G EY V IH JH IH Z
GAZOGENE	G AE Z AH JH IY N
GAZOGENES	G AE Z AH JH IY N Z
GEANTICLINE	JH IY N T AH K L AY N
GEANTICLINES	JH IY N T AH K L AY N Z
GEAR	G IH R
GEARBOX	G IH R B AA K S
GEARBOXES	G IH R B AA K S IH Z
GEARCASE	G IH ER K EY S
GEARCASES	G IH ER K EY S IH Z
GEARCHANGE	G IH ER CH EY N JH
GEARCHANGES	G IH ER CH EY N JH IH Z
GEARED	G IH R D
GEARING	G IH R IH NG
GEARINGS	G IH ER IH NG Z
GEARLESS	G IH ER L AH S
GEARS	G IH R Z
GEARSHIFT	G IH ER SH IH F T
GEARSHIFTS	G IH ER SH IH F T S
GEARWHEEL	G IH ER W IY L
GEARWHEELS	G IH ER W IY L Z
GECK	JH EH K
GECKED	JH EH K T
GECKING	JH EH K AH NG
GECKO	G EH K OW
GECKOES	JH EH K OW Z
GECKOS	G EH K OW Z
GECKS	JH EH K S
GED	G EH D
GED(2)	JH IY IY D IY
GEDANKENEXPERIMENT	JH AH D AE NG K AH N EH K S EH R AH M AH N T
GEDANKENEXPERIMENTS	JH AH D AE NG K AH N AH K S EH R AH M AH N T S
GEDS	JH EH D Z
GEE	JH IY
GEED	JH IY D
GEEGAW	JH IY G AH
GEEGAWS	JH IY G AH Z
GEEING	JH IY IH NG
GEEK	G IY K
GEEKIER	JH IY K AY AH R
GEEKIEST	JH IY K AY AH S T
GEEKS	G IY K S
GEEKY	G IY K IY
GEEPOUND	JH IY P AW N D
GEEPOUNDS	JH IY P AW N D Z
GEES	JH IY S
GEESE	G IY S
GEEST	JH IY AH S T
GEESTS	JH IY S T S
GEEZ	JH IY Z
GEEZER	JH IY Z AH R
GEEZERS	JH IY Z AH R Z
GEGENSCHEIN	G EY G AH N SH AY N
GEGENSCHEINS	G EY G AH N SH AY N Z
GEISHA	G EY SH AH
GEISHAS	G IY SH AH Z
GEL	JH EH L
GELABLE	JH EH L AH B AH L
GELADA	JH EH L AH D AH
GELADAS	JH EH L AH D AH Z
GELANDESPRUNG	JH EH L AH N D EH S R AH NG
GELANDESPRUNGS	JH EH L AH N D EH S R AH NG Z
GELANT	JH EH L AH N T
GELANTS	JH EH L AH N T S
GELATE	JH EH L AH T
GELATED	JH EH L EY T IH D
GELATES	JH EH L AH T S
GELATI	JH EH L AH T IY
GELATIN	JH EH L AH T AH N
GELATINE	JH EH L AH T IY N
GELATINES	JH EH L AH T AY N Z
GELATING	JH EH L EY T IH NG
GELATINIZATION	JH EH L AH T AY N AH Z EY SH AH N
GELATINIZATIONS	JH EH L AH T AY N AH Z EY SH AH N Z
GELATINIZE	JH EH L AH T AY N AY Z
GELATINIZED	JH EH L AH T AY N AY Z D
GELATINIZES	JH EH L AH T AY N AY Z IH Z
GELATINIZING	JH EH L AH T AY N AY Z IH NG
GELATINOUS	JH AH L AE T AH N AH S
GELATINOUSLY	JH EH L AH T AY N AH S L IY
GELATINOUSNESS	JH EH L AH T AY N AH S N AH S
GELATINOUSNESSES	JH EH L AH T AY N AH S N AH S IH Z
GELATINS	JH EH L AH T IH N Z
GELATION	JH EH L EY SH AH N
GELATIONS	JH EH L EY SH AH N Z
GELATO	JH EH L AH T OW
GELATOS	JH EH L AH T AH Z
GELD	G EH L D
GELDED	G EH L D IH D
GELDER	G EH L D ER
GELDERS	G EH L D ER Z
GELDING	G EH L D IH NG
GELDINGS	G EH L D IH NG Z
GELDS	G EH L D Z
GELEE	JH EH L IY
GELEES	JH EH L IY Z
GELID	JH EH L AH D
GELIDITIES	JH EH L AH D AH T IY Z
GELIDITY	JH EH L AH D AH T IY
GELIDLY	JH EH L AH D L IY
GELIGNITE	JH EH L IH G N AY T
GELIGNITES	JH EH L IH G N AY T S
GELLANT	JH EH L AH N T
GELLANTS	JH EH L AH N T S
GELLED	JH EH L D
GELLING	JH EH L IH NG
GELS	JH EH L Z
GELSEMIA	JH EH L S IY M IY AH
GELSEMIUM	JH EH L S IY M IY AH M
GELSEMIUMS	JH EH L S IY M IY AH M Z
GELT	JH EH L T
GELTS	JH EH L T S
GEM	JH EH M
GEMEINSCHAFT	JH IY M IY N S AH F T
GEMEINSCHAFTEN	JH IY M IY N S AE F T AH N
GEMEINSCHAFTS	JH IY M IY N S AH F T S
GEMINAL	JH EH M IH N AH L
GEMINALLY	JH EH M IH N AH L IY
GEMINATE	JH EH M AH N AH T
GEMINATE(2)	JH EH M AH N EY T
GEMINATED	JH EH M IH N EY T IH D
GEMINATES	JH EH M IH N AH T S
GEMINATING	JH EH M IH N EY T IH NG
GEMINATION	JH EH M IH N EY SH AH N
GEMINATIONS	JH EH M IH N EY SH AH N Z
GEMLIKE	JH EH M L AY K
GEMMA	JH EH M AH
GEMMAE	JH EH M IY
GEMMATE	JH EH M AH T
GEMMATED	JH EH M EY T IH D
GEMMATES	JH EH M AH T S
GEMMATING	JH EH M EY T IH NG
GEMMATION	JH EH M EY SH AH N
GEMMATIONS	JH EH M EY SH AH N Z
GEMMED	JH EH M D
GEMMIER	JH EH M IY ER
GEMMIEST	JH EH M IY AH S T
GEMMILY	JH EH M IY L IY
GEMMING	JH EH M IH NG
GEMMOLOGIES	JH EH M AA L AH JH IY Z
GEMMOLOGIST	JH EH M AA L AH JH AH S T
GEMMOLOGISTS	JH EH M AA L AH JH AH S T S
GEMMOLOGY	JH EH M AA L AH JH IY
GEMMULE	JH EH M Y UW L
GEMMULES	JH EH M Y UW L Z
GEMMY	JH EH M IY
GEMOLOGICAL	JH AH M AA L AH JH IH S AH L
GEMOLOGIES	JH EH M AA L AH JH IY Z
GEMOLOGIST	JH EH M AA L AH JH AH S T
GEMOLOGISTS	JH EH M AA L AH JH AH S T S
GEMOLOGY	JH EH M AA L AH JH IY
GEMOT	JH EH M AH T
GEMOTE	JH AH M OW T
GEMOTES	JH AH M OW T S
GEMOTS	JH EH M AH T S
GEMS	JH EH M Z
GEMSBOK	G EH M Z B AA K
GEMSBOKS	JH EH M Z AH K S
GEMSBUCK	JH EH M Z B AH K
GEMSBUCKS	JH EH M Z B AH K S
GEMSTONE	JH EH M S T OW N
GEMSTONES	JH EH M S T OW N Z
GEMUTLICH	JH AH M AH T L AH CH
GEMUTLICHKEIT	JH AH M AH T L AH CH IY T
GEMUTLICHKEITS	JH AH M AH T L AH CH IY T S
GEN	JH EH N
GENDARME	ZH AA N D AA R M
GENDARMERIE	JH EH N D AH R M IY R AY
GENDARMERIES	JH EH N D AA R M AH R AY Z
GENDARMERY	JH EH N D AH R M EH R IY
GENDARMES	JH EH N D AH R M Z
GENDER	JH EH N D ER
GENDERED	JH EH N D ER D
GENDERING	JH EH N D ER IH NG
GENDERS	JH EH N D ER Z
GENE	JH IY N
GENEALOGICAL	JH IY N AH L AA JH IH K AH L
GENEALOGICALLY	JH IY N AH L AA JH IH K AH L IY
GENEALOGIES	JH IY N IY AA L AH JH IY Z
GENEALOGIST	JH IY N AH L AA G IH S T
GENEALOGISTS	JH IY N AH L AA G IH S T S
GENEALOGY	JH IY N IY AA L AH JH IY
GENERA	JH EH N ER AH
GENERABLE	JH EH N ER AH B AH L
GENERAL	JH EH N ER AH L
GENERAL(2)	JH EH N R AH L
GENERALISATION	JH EH N ER AH L IY Z EY SH AH N
GENERALISATIONS	JH EH N ER AH L IY Z EY SH AH N Z
GENERALISE	JH AH N EH R AH L AY Z
GENERALISED	JH EH N ER AH L IY Z D
GENERALISES	JH EH N ER AH L IY Z IH Z
GENERALISING	JH EH N ER AH L IY Z IH NG
GENERALISSIMO	JH EH N EH R AH L IH S IH M OW
GENERALISSIMOS	JH EH N ER AH L IY Z IH M AA S
GENERALIST	JH EH N ER AH L IH S T
GENERALISTS	JH EH N ER AH L IH S T S
GENERALITIES	JH EH N ER AE L AH T IY Z
GENERALITY	JH EH N ER AE L AH T IY
GENERALIZABILITIES	JH EH N ER AH L AY Z AH B IH L AH T EH Z
GENERALIZABILITY	JH EH N ER AH L AY Z AH B IH L AH T EH
GENERALIZABLE	JH EH N ER AH L AY Z AH B AH L
GENERALIZATION	JH EH N ER AH L IH Z EY SH AH N
GENERALIZATION(2)	JH EH N R AH L IH Z EY SH AH N
GENERALIZATIONS	JH EH N ER AH L AH Z EY SH AH N Z
GENERALIZATIONS(2)	JH EH N R AH L AH Z EY SH AH N Z
GENERALIZE	JH EH N ER AH L AY Z
GENERALIZED	JH EH N ER AH L AY Z D
GENERALIZED(2)	JH EH N R AH L AY Z D
GENERALIZER	JH EH N ER AH L AY Z ER
GENERALIZERS	JH EH N ER AH L AY Z ER Z
GENERALIZES	JH EH N ER AH L AY Z IH Z
GENERALIZING	JH EH N ER AH L AY Z IH NG
GENERALIZING(2)	JH EH N R AH L AY Z IH NG
GENERALLY	JH EH N ER AH L IY
GENERALLY(2)	JH EH N R AH L IY
GENERALS	JH EH N ER AH L Z
GENERALS(2)	JH EH N R AH L Z
GENERALSHIP	JH EH N ER AH L SH IH P
GENERALSHIPS	JH EH N ER AH L SH IH P S
GENERATE	JH EH N ER EY T
GENERATED	JH EH N ER EY T AH D
GENERATED(2)	JH EH N ER EY T IH D
GENERATES	JH EH N ER EY T S
GENERATING	JH EH N ER EY T IH NG
GENERATION	JH EH N ER EY SH AH N
GENERATIONAL	JH EH N ER EY SH AH N AH L
GENERATIONALLY	JH EH N ER EY SH AH N AH L IY
GENERATIONS	JH EH N ER EY SH AH N Z
GENERATIVE	JH EH N ER AH T IH V
GENERATOR	JH EH N ER EY T ER
GENERATORS	JH EH N ER EY T ER Z
GENERATRICES	JH IY N R AE T R AY S IH Z
GENERATRIX	JH EH N AH R AE T R AH K S
GENERIC	JH AH N EH R IH K
GENERICALLY	JH AH N EH R IH K L IY
GENERICNESS	JH EH N ER IH K N AH S
GENERICNESSES	JH EH N ER IH K N AH S IH Z
GENERICS	JH AH N EH R IH K S
GENEROSITIES	JH EH N AH R AA S AH T IY Z
GENEROSITY	JH EH N ER AA S AH T IY
GENEROUS	JH EH N ER AH S
GENEROUSLY	JH EH N ER AH S L IY
GENEROUSNESS	JH EH N ER AH S N AH S
GENEROUSNESSES	JH EH N ER AH S N AH S IH Z
GENES	JH IY N Z
GENESES	JH IY N Z IH Z
GENESIS	JH EH N AH S AH S
GENET	JH EH N IH T
GENETIC	JH AH N EH T IH K
GENETICAL	JH AH N EH T IH K AH L
GENETICALLY	JH AH N EH T IH K L IY
GENETICIST	JH AH N EH T AH S AH S T
GENETICISTS	JH AH N EH T AH S IH S T S
GENETICS	JH AH N EH T IH K S
GENETS	JH EH N AH T S
GENETTE	JH IY N EH T
GENETTES	JH IY N EH T S
GENEVA	JH AH N IY V AH
GENEVAS	JH EH N AH V AH Z
GENIAL	JH IY N Y AH L
GENIALITIES	JH IY N Y AH L AH T IY Z
GENIALITY	JH IY N IY AE L AH T IY
GENIALLY	JH IY N Y AH L IY
GENIC	JH IY N IH K
GENICALLY	JH IY N IH K AH L IY
GENICULATE	JH IY N IH S AH L EY T
GENICULATED	JH IY N IH S AH L EY T AH D
GENIE	JH IY N IY
GENIES	JH IY N IY Z
GENII	JH IY N IY
GENIP	JH EH N AH P
GENIPAP	JH EH N AH P AH P
GENIPAPS	JH EH N AH P AH P S
GENIPS	JH EH N AH P S
GENITAL	JH EH N AH T AH L
GENITALIA	JH EH N AH T AA L Y AH
GENITALIC	JH EH N AH T AH L IH K
GENITALLY	JH EH N AH T AH L IY
GENITALS	JH EH N AH T AH L Z
GENITIVAL	JH AH N IH T AH V AH L
GENITIVALLY	JH AH N IH T AH V AE L IY
GENITIVE	JH EH N AH T AH V
GENITIVES	JH EH N AH T AH V Z
GENITOR	JH EH N AH T AH R
GENITORS	JH EH N AH T AH R Z
GENITOURINARY	JH AH N IH T AH R AH N EH R IY
GENITURE	JH AH N IH T Y AH R
GENITURES	JH AH N IH T Y AH R Z
GENIUS	JH IY N Y AH S
GENIUSES	JH IY N Y AH S IH Z
GENOA	JH EH N OW AH
GENOAS	JH AH N OW Z
GENOCIDAL	JH EH N AH S AY D AH L
GENOCIDE	JH EH N AH S AY D
GENOCIDES	JH EH N AH S AY D Z
GENOISE	JH AH N OY Z
GENOISES	JH AH N OY Z AH Z
GENOM	JH EH N AH M
GENOME	JH IY N OW M
GENOMES	JH AH N OW M Z
GENOMIC	JH EH N AH M AH K
GENOMS	JH EH N AH M Z
GENOTYPE	JH EH N AH T AY P
GENOTYPES	JH EH N AH T AY P S
GENOTYPIC	JH EH N AH T AH P AH K
GENOTYPICAL	JH AH N AA T AH P IH S AH L
GENOTYPICALLY	JH EH N AH T IH P AH K AE L IY
GENRE	ZH AA N R AH
GENRES	ZH AA N R AH Z
GENRO	JH EH N R OW
GENROS	JH EH N R AH Z
GENS	JH EH N Z
GENSENG	JH EH N S AH NG
GENSENGS	JH EH N S AH NG Z
GENT	JH EH N T
GENTAMICIN	JH EH N T AE M AH S AH N
GENTAMICINS	JH EH N T AE M AH S AH N Z
GENTEEL	JH EH N T IY L
GENTEELER	JH EH N T IY L ER
GENTEELEST	JH EH N T IY L AH S T
GENTEELISM	JH EH N T IY L IH Z AH M
GENTEELISMS	JH EH N T IY L IH Z AH M Z
GENTEELLY	JH EH N T IY L IY
GENTEELNESS	JH EH N T IY L N AH S
GENTEELNESSES	JH EH N T IY L N AH S IH Z
GENTES	JH EH N T S
GENTIAN	JH EH N SH AH N
GENTIANS	JH EH N CH AH N Z
GENTIL	JH EH N T AH L
GENTILE	JH EH N T AY L
GENTILES	JH EH N T AY L Z
GENTILESSE	JH EH N T AH L AH S
GENTILESSES	JH EH N T AY L AH S IH Z
GENTILITIES	JH EH N T IH L AH T IY Z
GENTILITY	JH EH N T IH L IH T IY
GENTLE	JH EH N T AH L
GENTLE(2)	JH EH N AH L
GENTLED	JH EH N T AH L D
GENTLEFOLK	JH EH N T AH L F OW K
GENTLEFOLKS	JH EH N T AH L F OW K S
GENTLEMAN	JH EH N T AH L M AH N
GENTLEMAN(2)	JH EH N AH L M AH N
GENTLEMANLIKE	JH EH N T AH L M AE N L AY K
GENTLEMANLIKENESS	JH EH N T AH L M AE N L AY K N AH S
GENTLEMANLIKENESSES	JH EH N T AH L M AE N L AY K N AH S IH Z
GENTLEMANLINESS	JH EH N T AH L M AE N L IY N AH S
GENTLEMANLINESSES	JH EH N T AH L M AE N L IY N AH S IH Z
GENTLEMANLY	JH EH N T AH L M AH N L IY
GENTLEMANLY(2)	JH EH N AH L M AH N L IY
GENTLEMEN	JH EH N T AH L M IH N
GENTLEMEN(2)	JH EH N AH L M IH N
GENTLENESS	JH EH N T AH L N AH S
GENTLENESS(2)	JH EH N AH L N AH S
GENTLENESSES	JH EH N T AH L N AH S IH Z
GENTLEPERSON	JH EH N T AH L P ER S AH N
GENTLEPERSONS	JH EH N T AH L P ER S AH N Z
GENTLER	JH EH N T L ER
GENTLES	JH EH N T AH L Z
GENTLES(2)	JH EH N AH L Z
GENTLEST	JH EH N T AH L AH S T
GENTLEWOMAN	JH EH N T AH L W UH M AH N
GENTLEWOMAN(2)	JH EH N AH L W UH M AH N
GENTLEWOMEN	JH EH N T AH L W IH M AH N
GENTLEWOMEN(2)	JH EH N AH L W IH M AH N
GENTLING	JH EH N T L IH NG
GENTLY	JH EH N T L IY
GENTOO	JH EH N T UW
GENTOOS	JH EH N T UW Z
GENTRICE	JH EH N T R AY S
GENTRICES	JH EH N T R AY S IH Z
GENTRIES	JH EH N T R IY Z
GENTRIFICATION	JH EH N T R IH F IH K EY SH AH N
GENTRIFICATIONS	JH EH N T R AH F AH K EY T IY AH N Z
GENTRIFIED	JH EH N T R IH F AY D
GENTRIFIER	JH EH N T R IH F AY AH R
GENTRIFIERS	JH EH N T R AH F IY R Z
GENTRIFIES	JH EH N T R AH F AY Z
GENTRIFY	JH EH N T R IH F AY
GENTRIFYING	JH EH N T R IH F AY IH NG
GENTRY	JH EH N T R IY
GENTS	JH EH N T S
GENU	JH EH N UW
GENUA	JH EH N Y UW AH
GENUFLECT	JH AH N AH F L AH K T
GENUFLECTED	JH AH N AH F L EH K T AH D
GENUFLECTING	JH AH N AH F L EH K T AH NG
GENUFLECTION	JH AH N AH F L EH K AH N
GENUFLECTIONS	JH EH N AH F L EH K T IY AH N Z
GENUFLECTS	JH AH N AH F L AH K T S
GENUINE	JH EH N Y UW AH N
GENUINE(2)	JH EH N Y UW AY N
GENUINELY	JH EH N Y UW AH N L IY
GENUINELY(2)	JH EH N Y UW AY N L IY
GENUINENESS	JH EH N Y UW AH N IH S
GENUINENESSES	JH EH N Y AH W AH N AH S IH Z
GENUS	JH IY N AH S
GENUSES	JH IY N AH S IH Z
GEOBOTANIC	JH IY AA B AH T AH N AH K
GEOBOTANICAL	JH IY AH B AA T AH N IH S AH L
GEOBOTANIES	JH IY AH B AA T AH N AY Z
GEOBOTANIST	JH IY AH B AA T AH N AH S T
GEOBOTANISTS	JH IY AH B AA T AH N AH S T S
GEOBOTANY	JH IY AH B AA T AH N IY
GEOCENTRIC	JH IY OW S EH N T R IH K
GEOCENTRICALLY	JH IY OW S EH N T R IH K AH L IY
GEOCHEMICAL	JH IY AA K AH M IH S AH L
GEOCHEMICALLY	JH IY AH K EH M AH K AE L IY
GEOCHEMIST	JH IY AA K AH M AH S T
GEOCHEMISTRIES	JH IY OW K EH M AH S T R IY Z
GEOCHEMISTRY	JH IY OW K EH M AH S T R IY
GEOCHEMISTS	JH IY AA K AH M AH S T S
GEOCHRONOLOGIC	JH IY AH K R AA N AH L AH JH AH K
GEOCHRONOLOGICAL	JH IY AA K R AH N AA L AH JH IH S AH L
GEOCHRONOLOGICALLY	JH IY AA K R AH N AH L AA JH AH K AE L IY
GEOCHRONOLOGIES	JH IY AA K R AH N AA L AH JH AY Z
GEOCHRONOLOGIST	JH IY AA K R AH N AA L AH JH AH S T
GEOCHRONOLOGISTS	JH IY AA K R AH N AA L AH JH AH S T S
GEOCHRONOLOGY	JH IY AA K R AH N AA L AH JH IY
GEODE	JH IY OW D
GEODES	JH IY OW D Z
GEODESIC	JH IY AH D EH S IH K
GEODESICS	JH IY AA D AH Z AH S Z
GEODESIES	JH IY AA D AH S AY Z
GEODESIST	JH IY OW D Z AH S T
GEODESISTS	JH IY AA D AH S AH S T S
GEODESY	JH IY AA D AH S IY
GEODETIC	JH IY AH D EH T IH K
GEODETICAL	JH IY AH D EH T IH K AH L
GEODIC	JH IY AH D AH K
GEODUCK	JH IY AH D AH K
GEODUCKS	JH IY AH D AH K S
GEOGNOSIES	JH IY AA G N AH S AY Z
GEOGNOSY	JH IY AA G N AH Z IY
GEOGRAPHER	JH IY AA G R AH F ER
GEOGRAPHERS	JH IY AA G R AH F ER Z
GEOGRAPHIC	JH IY AH G R AE F IH K
GEOGRAPHICAL	JH IY AH G R AE F IH K AH L
GEOGRAPHICALLY	JH IY AH G R AE F IH K AH L IY
GEOGRAPHICALLY(2)	JH IY AH G R AE F IH K L IY
GEOGRAPHIES	JH IY AA G R AH F IY Z
GEOGRAPHY	JH IY AA G R AH F IY
GEOHYDROLOGIC	JH IY AH HH IH D R AH L AH JH AH K
GEOHYDROLOGIES	JH IY AH HH IH D R AA L AH JH AY Z
GEOHYDROLOGIST	JH IY AH HH IH D R AA L AH JH AH S T
GEOHYDROLOGISTS	JH IY AH HH AH D R AA L AH JH AH S T S
GEOHYDROLOGY	JH IY AH HH IH D R AA L AH JH IY
GEOID	JH IY OY D
GEOIDAL	JH IY OY D AH L
GEOIDS	JH IY OY D Z
GEOLOGER	JH IY AH L OW JH AH R
GEOLOGERS	JH IY AA L AH JH AH R Z
GEOLOGIC	JH IY AH L AA JH IH K
GEOLOGICAL	JH IY AH L AA JH IH K AH L
GEOLOGICALLY	JH IY AH L AA JH IH K AH L IY
GEOLOGIES	JH IY AA L AH JH IY Z
GEOLOGIST	JH IY AA L AH JH AH S T
GEOLOGISTS	JH IY AA L AH JH IH S T S
GEOLOGIZE	JH IY AA L AH JH AY Z
GEOLOGIZED	JH IY AA L AH JH AY Z D
GEOLOGIZES	JH IY AA L AH JH AY Z AH Z
GEOLOGIZING	JH IY AA L AH JH AY Z AH NG
GEOLOGY	JH IY AA L AH JH IY
GEOMAGNETIC	JH IY OW M AE G N EH T IH K
GEOMAGNETICALLY	JH IY AH M AE G N EH T AH K AE L IY
GEOMAGNETISM	JH IY AH M AE G N AH T IH Z AH M
GEOMAGNETISMS	JH IY AH M AE G N AH T AH Z AH M Z
GEOMANCER	JH IY AH M AE N S AH R
GEOMANCERS	JH IY AH M AE N S AH R Z
GEOMANCIES	JH IY AH M AE N S AY Z
GEOMANCY	JH IY AH M AE N S IY
GEOMANTIC	JH IY AH M AH N T AH K
GEOMETER	JH IY AA M AH T AH R
GEOMETERS	JH IY AA M AH T AH R Z
GEOMETRIC	JH IY AH M EH T R IH K
GEOMETRICAL	JH IY AH M EH T R IH K AH L
GEOMETRICALLY	JH IY AH M EH T R IH K L IY
GEOMETRICIAN	JH IY AH M EH T R IH S IY AH N
GEOMETRICIANS	JH IY AH M AH T R IH S IY AH N Z
GEOMETRICS	JH IY AH M EH T R IH K S
GEOMETRID	JH IY AH M EH T R AH D
GEOMETRIDS	JH IY AH M EH T R AH D Z
GEOMETRIES	JH IY AA M AH T R IY Z
GEOMETRISE	JH IY AA M AH T R AY Z
GEOMETRISED	JH IY AA M AH T R IY Z D
GEOMETRISES	JH IY AA M AH T R IY Z IH Z
GEOMETRISING	JH IY AA M AH T R IY Z IH NG
GEOMETRIZATION	JH IY AH M EH T R AH Z EY SH AH N
GEOMETRIZATIONS	JH IY AH M EH T R AH Z EY T IY AH N Z
GEOMETRIZE	JH IY AA M AH T R AY Z
GEOMETRIZED	JH IY AA M AH T R AY Z D
GEOMETRIZES	JH IY AA M AH T R AY Z AH Z
GEOMETRIZING	JH IY AA M AH T R AY Z AH NG
GEOMETRY	JH IY AA M AH T R IY
GEOMORPHIC	JH IY AH M AH R F AH K
GEOMORPHOLOGICAL	JH IY AH M AO R F AA L AH JH IH S AH L
GEOMORPHOLOGIES	JH IY AH M AO R F AA L AH JH AY Z
GEOMORPHOLOGIST	JH IY AH M AO R F AA L AH JH AH S T
GEOMORPHOLOGISTS	JH IY AH M AH R F AA L AH JH AH S T S
GEOMORPHOLOGY	JH IY AH M AO R F AA L AH JH IY
GEOPHAGIES	JH IY AA F AH JH AY Z
GEOPHAGY	JH IY AA F AH JH IY
GEOPHONE	JH IY AH F OW N
GEOPHONES	JH IY AH F OW N Z
GEOPHYSICAL	JH IY OW F IH Z AH K AH L
GEOPHYSICALLY	JH IY AH F IH S AH K AE L IY
GEOPHYSICIST	JH IY AA F AH Z IH S AH S T
GEOPHYSICISTS	JH IY AH F IH S AH S AH S T S
GEOPHYSICS	JH IY AA F AH Z AH S Z
GEOPHYTE	JH IY AH F AY T
GEOPHYTES	JH IY AH F AY T S
GEOPOLITICAL	JH IY OW P AH L IH T IH K AH L
GEOPOLITICALLY	JH IY OW P AH L IH T IH K L IY
GEOPOLITICIAN	JH IY AH P AA L AH T IH S IY AH N
GEOPOLITICIANS	JH IY AA P AH L AH T IH S IY AH N Z
GEOPOLITICS	JH IY OW P AA L AH T IH K S
GEOPONIC	JH IY AH P AH N AH K
GEOPRESSURED	JH IY AA P R EH SH Y AH R D
GEOPROBE	JH IY AH P R OW B
GEOPROBES	JH IY AH P R OW B Z
GEORGETTE	JH AO R JH EH T
GEORGETTES	JH IY AO R JH EH T S
GEORGIC	JH IY AH R JH AH K
GEORGICS	JH IY AO R JH AH S Z
GEOSCIENCE	JH IY AH SH AH N S
GEOSCIENCES	JH IY AH SH AH N S AH Z
GEOSCIENTIST	JH IY AH S IY N T AH S T
GEOSCIENTISTS	JH IY AH S IY N T AH S T S
GEOSTATIONARY	JH IY AH S T EY T IY AH N EH R IY
GEOSTRATEGIC	JH IY AA S T R AH T AH JH AH K
GEOSTRATEGIES	JH IY AA S T R AE T AH JH AY Z
GEOSTRATEGIST	JH IY AA S T R AE T AH JH AH S T
GEOSTRATEGISTS	JH IY AH S T R AE T AH JH AH S T S
GEOSTRATEGY	JH IY AA S T R AE T AH JH IY
GEOSTROPHIC	JH IY OW S T R AA F IH K
GEOSTROPHICALLY	JH IY AA S T R AA F AH K AE L IY
GEOSYNCHRONOUS	JH IY AH S IH NG K R AH N AH S
GEOSYNCLINAL	JH IY AH S IH NG K L AH N AH L
GEOSYNCLINE	JH IY OW S IH N K L AY N
GEOSYNCLINES	JH IY AA S AH NG K L AY N Z
GEOTACTIC	JH IY AH T AH K T AH K
GEOTAXES	JH IY AH T AH K S
GEOTAXIS	JH IY OW T AE K S AH S
GEOTECHNICAL	JH IY AH T EH K N IH S AH L
GEOTECTONIC	JH IY AH T EH K T AH N AH K
GEOTECTONICALLY	JH IY AH T EH K T AA N AH K AE L IY
GEOTHERMAL	JH IY OW TH ER M AH L
GEOTHERMALLY	JH IY AH TH AH R M AE L IY
GEOTROPIC	JH IY AH T R AA P IH K
GEOTROPICALLY	JH IY AA T R AA P AH K AE L IY
GEOTROPISM	JH IY AA T R AH P IH Z AH M
GEOTROPISMS	JH IY AA T R AH P AH Z AH M Z
GERAH	JH EH R AH
GERAHS	JH EH R AH Z
GERANIAL	JH AH R EY N IY AH L
GERANIALS	JH AH R EY N IY AH L Z
GERANIOL	JH AH R EY N IY AH L
GERANIOLS	JH AH R EY N IY AH L Z
GERANIUM	JH ER EY N IY AH M
GERANIUMS	JH ER EY N IY AH M Z
GERARDIA	JH AH R AA R D IY AH
GERARDIAS	JH AH R AA R D IY AH Z
GERBERA	JH AH R B AH R AH
GERBERAS	JH AH R B AH R AH Z
GERBIL	JH AH R B AH L
GERBILLE	JH AH R B AH L
GERBILLES	JH AH R B AH L Z
GERBILS	JH AH R B AH L Z
GERENT	JH IY R AH N T
GERENTS	JH EH R AH N T S
GERENUK	JH EH R AH N AH K
GERENUKS	JH EH R AH N AH K S
GERFALCON	JH AH R F AE L K AH N
GERFALCONS	JH AH R F AE L K AH N Z
GERIATRIC	JH EH R IY AE T R IH K
GERIATRICIAN	JH EH R IY AH T R IH SH AH N
GERIATRICIANS	JH EH R IY AH T R IH SH AH N Z
GERIATRICS	JH EH R IY AE T R IH K S
GERM	JH ER M
GERMAN	JH ER M AH N
GERMANDER	JH AH R M AE N D AH R
GERMANDERS	JH AH R M AE N D AH R Z
GERMANE	JH ER M EY N
GERMANELY	JH ER M EY N L IY
GERMANIC	JH ER M AE N IH K
GERMANIUM	JH ER M EY N IY AH M
GERMANIUMS	JH ER M EY N IY AH M Z
GERMANIZATION	JH ER M EY N AH Z EY SH AH N
GERMANIZATIONS	JH ER M EY N AH Z EY SH AH N Z
GERMANIZE	JH ER M EY N AY Z
GERMANIZED	JH ER M EY N AY Z D
GERMANIZES	JH ER M EY N AY Z IH Z
GERMANIZING	JH ER M EY N AY Z IH NG
GERMANS	JH ER M AH N Z
GERMEN	JH ER M AH N
GERMENS	JH ER M AH N Z
GERMFREE	JH ER M F R IY
GERMICIDAL	JH ER M IH K S AH D AH L
GERMICIDE	JH ER M AH S AY D
GERMICIDES	JH AH R M AH S AY D Z
GERMIER	JH ER M IY ER
GERMIEST	JH ER M IY AH S T
GERMINA	JH AH R M AH N AH
GERMINABILITIES	JH ER M AH N AH B IH L AH T EH Z
GERMINABILITY	JH ER M AH N AH B IH L AH T EH
GERMINAL	JH ER M AH N AH L
GERMINALLY	JH ER M AH N AH L IY
GERMINATE	JH ER M AH N EY T
GERMINATED	JH ER M AH N EY T IH D
GERMINATES	JH ER M AH N AH T S
GERMINATING	JH ER M AH N EY T IH NG
GERMINATION	JH ER M AH N EY SH AH N
GERMINATIONS	JH ER M AH N EY SH AH N Z
GERMINATIVE	JH ER M AH N AH T IH V
GERMPROOF	JH ER M P R UW F
GERMS	JH ER M Z
GERMY	JH ER M IY
GERONTIC	JH EH R AH N T AH K
GERONTOCRACIES	JH AH R AA N T AA K R AH S IY Z
GERONTOCRACY	JH AH R AA N T AA K R AH S IY
GERONTOCRAT	JH EH R AH N T AA K R AH T
GERONTOCRATIC	JH AH R AA N T AA K R AH T AH K
GERONTOCRATS	JH AH R AA N T AH K R EY T S
GERONTOLOGIC	JH AH R AA N T AH L AH JH AH K
GERONTOLOGICAL	JH AH R AA N T AA L AH JH IH S AH L
GERONTOLOGIES	JH AH R AA N T AA L AH JH AY Z
GERONTOLOGIST	JH EH R AH N T AA L AH JH IH S T
GERONTOLOGISTS	JH EH R AH N T AA L AH JH AH S T S
GERONTOLOGY	JH EH R AH N T AA L AH JH IY
GERONTOMORPHIC	JH AH R AA N T AH M AH R F AH K
GERRYMANDER	JH EH R IY M AE N D ER
GERRYMANDERED	JH EH R IY M AE N D ER D
GERRYMANDERING	JH EH R IY M AE N D ER IH NG
GERRYMANDERS	JH EH R IY M AE N D ER Z
GERUND	JH EH R AH N D
GERUNDIVE	JH AH R AH N D AH V
GERUNDIVES	JH AH R AH N D AH V Z
GERUNDS	JH EH R AH N D Z
GESELLSCHAFT	G AH S EH L SH AE F T
GESELLSCHAFTEN	JH AH S EH L S AE F T AH N
GESELLSCHAFTS	JH AH S EH L S AH F T S
GESNERIA	JH EH Z N IY R IY AH
GESNERIAD	JH EH Z N IY R IY AH D
GESNERIADS	JH EH Z N IY R IY AH D Z
GESSO	JH EH S OW
GESSOED	JH EH S OW D
GESSOES	JH EH S OW Z
GEST	JH EH S T
GESTALT	JH EH S T AH L T
GESTALTEN	JH EH S T AE L T AH N
GESTALTIST	JH EH S T AE L T AH S T
GESTALTISTS	JH EH S T AE L T AH S T S
GESTALTS	JH EH S T AH L T S
GESTAPO	G AH S T AA P OW
GESTAPOS	G AH S T AA P OW Z
GESTATE	JH EH S T EY T
GESTATED	JH EH S T EY T AH D
GESTATES	JH EH S T EY T S
GESTATING	JH EH S T EY T AH NG
GESTATION	JH EH S T EY SH AH N
GESTATIONAL	JH EH S T AH T IY AH N AH L
GESTATIONS	JH EH S T EY T IY AH N Z
GESTE	JH EH S T
GESTES	JH EH S T S
GESTIC	JH EH S T AH K
GESTICAL	JH EH S T IH S AH L
GESTICULANT	JH EH S T IH K Y AH L AH N T
GESTICULATE	JH EH S T IH K Y AH L AH T
GESTICULATED	JH EH S T IH K Y AH L EY T IH D
GESTICULATES	JH EH S T IH K Y AH L AH T S
GESTICULATING	JH EH S T IH K Y AH L EY T IH NG
GESTICULATION	JH EH S T IH K Y AH L EY SH AH N
GESTICULATIONS	JH EH S T IH K Y AH L EY SH AH N Z
GESTICULATIVE	JH EH S T IH K Y AH L AH T IH V
GESTICULATOR	JH EH S T IH K Y AH L AH T ER
GESTICULATORS	JH EH S T IH K Y AH L AH T ER Z
GESTICULATORY	JH EH S T IH K Y AH L AH T OW R IY
GESTS	JH EH S T S
GESTURAL	JH EH S CH ER AH L
GESTURALLY	JH EH S CH ER AH L IY
GESTURE	JH EH S CH ER
GESTURED	JH EH S CH ER D
GESTURER	JH EH S CH ER ER
GESTURERS	JH EH S CH ER ER Z
GESTURES	JH EH S CH ER Z
GESTURING	JH EH S CH ER IH NG
GESUNDHEIT	G AH Z UH N D HH AY T
GET	G EH T
GET(2)	G IH T
GETA	JH EH T AH
GETABLE	G EH T AH B AH L
GETAS	JH EH T AH Z
GETATABLE	G EH T AH T AH B AH L
GETAWAY	G EH T AH W EY
GETAWAYS	G EH T AH W EY Z
GETS	G EH T S
GETS(2)	G IH T S
GETTABLE	G EH T AH B AH L
GETTER	G EH T ER
GETTERED	G EH T ER D
GETTERING	G EH T ER IH NG
GETTERS	G EH T ER Z
GETTING	G EH T IH NG
GETTING(2)	G IH T IH NG
GETUP	G EH T AH P
GETUPS	G EH T AH P S
GEUM	JH UW M
GEUMS	JH UW M Z
GEWGAW	G Y UW G AA
GEWGAWS	JH UW G AH Z
GEWURZTRAMINER	JH UW AH R Z T R AH M AY N AH R
GEWURZTRAMINERS	JH UW AH R Z T R AE M AH N AH R Z
GEY	JH IY IY
GEYSER	G AY Z ER
GEYSERITE	JH EY S AH R AY T
GEYSERITES	JH EY S AH R AY T S
GEYSERS	G AY Z ER Z
GIGGED	G IH G D
GINGELEY	JH IH N JH IY L IY
GINGELEYS	JH IH N JH AH L EY Z
GINGELI	JH IH N JH AH L IY
GINGELIES	JH IH N JH EH L IY Z
GINGELIS	JH IH N JH EH L IY Z
GINGELLI	JH IH N JH EH L IY
GINGELLIES	JH IH N JH EH L IY Z
GINGELLIS	JH IH N JH EH L IY Z
GINGELLY	JH IH N JH EH L IY
GINGELY	JH IH N JH EH L IY
GINGER	JH IH N JH ER
GINGERBREAD	JH IH N JH ER B R EH D
GINGERBREADED	JH IH N JH ER B R EH D IH D
GINGERBREADS	JH IH N JH ER B R EH D Z
GINGERBREADY	JH IH N JH ER B R EH D IY
GINGERED	JH IH N JH ER D
GINGERING	JH IH N JH ER IH NG
GINGERLINESS	JH IH N JH ER L IY N AH S
GINGERLINESSES	JH IH N JH ER L IY N AH S IH Z
GINGERLY	JH IH N JH ER L IY
GINGERROOT	JH IH N JH ER R UW T
GINGERROOTS	JH IH N JH ER R UW T S
GINGERS	JH IH N JH ER Z
GINGERSNAP	JH IH N JH ER S N AE P
GINGERSNAPS	JH IH N JH ER S N AE P S
GINGERY	JH IH N JH ER IY
GLOSSOPHARYNGEAL	G L AA S AA F AH R IH N JH IY AH L
GLOSSOPHARYNGEALS	G L AA S AH F AE R AH N JH IY L Z
GLUCONEOGENESES	G L UW K AH N IY AA JH AH N IY Z AH Z
GLUCONEOGENESIS	G L UW K OW N IY AH JH IY N AH S AH S
GLUGGED	G L AH G D
GLYCOGEN	G L AY K AH JH IH N
GLYCOGENESES	G L AH K AA JH AH N IY Z AH Z
GLYCOGENESIS	G L IH K AH JH IY N AH S AH S
GLYCOGENOLYSES	G L AH K AH JH EH N AH L AY Z AH Z
GLYCOGENOLYSIS	G L IH K AH JH AH N AA L AH S AH S
GLYCOGENOLYTIC	G L IH K AH JH EH N AH L AH T AH K
GLYCOGENS	G L IH K AH JH AH N Z
GOITROGEN	G OY T R AH JH AH N
GOITROGENIC	G OY T R AH JH AH N AH K
GOITROGENICITIES	G OY T R AH JH AH N IH S AH T AY Z
GOITROGENICITY	G OY T R AA JH AH N IH S AH T IY
GOITROGENS	G OY T R AH JH AH N Z
GONGED	G AO NG D
GORGE	G AO R JH
GORGED	G AO R JH D
GORGEDLY	G AO R JH AH D L IY
GORGEOUS	G AO R JH AH S
GORGEOUSLY	G AO R JH AH S L IY
GORGEOUSNESS	G AO R JH AH S N AH S
GORGEOUSNESSES	G AO R JH AH S N AH S IH Z
GORGER	G AO R JH ER
GORGERIN	G AO R JH ER IH N
GORGERINS	G AO R JH ER IH N Z
GORGERS	G AO R JH ER Z
GORGES	G AO R JH AH Z
GORGES(2)	G AO R JH IH Z
GORGET	G AO R JH AH T
GORGETED	G AO R JH T EH D
GORGETS	G AO R G AH T S
GOSSIPMONGER	G AA S AH P M AH NG G ER
GOSSIPMONGERS	G AA S AH P M AH NG G ER Z
GOUGE	G AW JH
GOUGED	G AW JH D
GOUGER	G AW JH ER
GOUGERS	G AW JH ER Z
GOUGES	G AW JH IH Z
GRAFTAGE	G R AE F T IH JH
GRAFTAGES	G R AE F T IH JH IH Z
GRANGE	G R EY N JH
GRANGER	G R EY N JH ER
GRANGERISM	G R AE N JH AH R IH Z AH M
GRANGERISMS	G R AE N JH AH R AH Z AH M Z
GRANGERS	G R EY N JH ER Z
GRANGES	G R EY N JH IH Z
GREENGAGE	G R IY N G EY JH
GREENGAGES	G R IY N G EY JH IH Z
GREIGE	G R EY JH
GREIGES	G R EY JH AH Z
GRILLAGE	G R IH L IH JH
GRILLAGES	G R IH L IH JH IH Z
GROGGERIES	G R AA G AH R IY Z
GROGGERY	G R AA G AH R IY
GRUDGE	G R AH JH
GRUDGED	G R AH JH D
GRUDGER	G R AH JH ER
GRUDGERS	G R AH JH ER Z
GRUDGES	G R AH JH IH Z
GRUNGE	G R AH N JH
GRUNGES	G R AH N JH AH Z
GUDGEON	G AH JH AH N
GUDGEONED	G AH JH IY OW N D
GUDGEONING	G AH JH IY OW N AH NG
GUDGEONS	G AH JH IY AH N Z
GUNSLINGER	G AH N S L IH NG ER
GUNSLINGERS	G AH N S L IH NG ER Z
GURGE	G AH R JH
GURGED	G AH R JH D
GURGES	G AH R JH AH Z
GYNOGENESES	JH AH N AA JH AH N IY Z AH Z
GYNOGENESIS	JH IH N AH JH IY N AH S AH S
GYNOGENETIC	JH AH N AA JH AH N AH T AH K
HABERGEON	HH AH B AH R JH AH N
HABERGEONS	HH AH B AH R JH IY AH N Z
HAGGED	HH AE G D
HALLUCINOGEN	HH AE L AH S IH N AH JH AH N
HALLUCINOGENIC	HH AH L UW S AH N AH JH EH N IH K
HALLUCINOGENICS	HH AE L AH S AH N AA JH AH N AH S Z
HALLUCINOGENS	HH AE L AH S IH N AH JH AH N Z
HALOGEN	HH AE L AH JH AH N
HALOGENATE	HH AE L AH JH AH N EY T
HALOGENATED	HH AE L AH JH AH N EY T IH D
HALOGENATES	HH AE L AH JH AH N AH T S
HALOGENATING	HH AE L AH JH AH N EY T IH NG
HALOGENATION	HH AE L AH JH AH N EY SH AH N
HALOGENATIONS	HH AE L AH JH AH N EY SH AH N Z
HALOGENOUS	HH AE L AH JH AH N AH S
HALOGENS	HH AE L AH JH AH N Z
HALOGETON	HH EY L OW G EH T AO N
HALOGETONS	HH EY L OW G EH T AO N Z
HAMBURGER	HH AE M B ER G ER
HAMBURGERS	HH AE M B ER G ER Z
HANDWRINGER	HH AE N D R IH NG ER
HANDWRINGERS	HH AE N D R IH NG ER Z
HANGED	HH AE NG D
HANGER	HH AE NG ER
HANGERS	HH AE NG ER Z
HARBINGER	HH AA R B IH N JH ER
HARBINGERED	HH AA R B AH N JH IY R D
HARBINGERING	HH AA R B AH N JH IY R AH NG
HARBINGERS	HH AA R B IH NG ER Z
HARBORAGE	HH AA R B ER IH JH
HARBORAGES	HH AA R B ER IH JH IH Z
HARDEDGE	HH AA R D EH JH
HARDEDGES	HH AA R D EH JH IH Z
HATEMONGER	HH EY T M AH NG G ER
HATEMONGERS	HH EY T M AH NG G ER Z
HAULAGE	HH AO L IH JH
HAULAGES	HH AO L IH JH IH Z
HAYLAGE	HH EY L AH JH
HAYLAGES	HH EY L AE G Z
HEADGEAR	HH EH D G IH R
HEADGEARS	HH EH D G IH ER Z
HEDGE	HH EH JH
HEDGED	HH EH JH D
HEDGEHOG	HH EH JH HH AA G
HEDGEHOGS	HH EH JH HH AA G Z
HEDGEHOP	HH EH JH HH AA P
HEDGEHOPPED	HH EH JH HH AA P T
HEDGEHOPPER	HH EH JH HH AA P ER
HEDGEHOPPERS	HH EH JH HH AA P ER Z
HEDGEHOPPING	HH EH JH HH AA P IH NG
HEDGEHOPS	HH EH JH HH AA P S
HEDGEPIG	HH EH JH P IH G
HEDGEPIGS	HH EH JH P IH G Z
HEDGER	HH EH JH ER
HEDGEROW	HH EH JH R OW
HEDGEROWS	HH EH JH R OW Z
HEDGERS	HH EH JH ER Z
HEDGES	HH EH JH IH Z
HEGEMONIC	HH EH G AH M AA N IH K
HEGEMONIES	HH IH JH EH M AH N IY Z
HEGEMONY	HH IY JH EH M AH N IY
HELOTAGE	HH EH L AH T AH JH
HELOTAGES	HH AH L AA T AH JH AH Z
HEMATOGENOUS	HH EH M AH T AA G AH N AH S
HEMOFLAGELLATE	HH AH M AA F L AE JH AH L EY T
HEMOFLAGELLATES	HH AH M AA F L AE JH AH L EY T S
HEMORRHAGE	HH EH M ER IH JH
HEMORRHAGE(2)	HH EH M R AH JH
HEMORRHAGED	HH EH M ER IH JH D
HEMORRHAGES	HH EH M AH R IH JH IH Z
HERBAGE	ER B IH JH
HERBAGES	ER B IH JH IH Z
HERITAGE	HH EH R AH T AH JH
HERITAGE(2)	HH EH R IH T IH JH
HERITAGES	HH EH R IH T IH JH AH Z
HERMITAGE	HH ER M AH T AH JH
HERMITAGES	HH AH R M IH T AH JH AH Z
HETEROGENEITIES	HH AH T EH R AH JH AH N AH T AY Z
HETEROGENEITY	HH EH T ER AH JH IH N IY AH T IY
HETEROGENEITY(2)	HH EH T ER AH JH IH N EY AH T IY
HETEROGENEOUS	HH EH T ER AH JH IY N Y AH S
HETEROGENEOUSLY	HH EH T AH R AH JH IY N IY AH S L IY
HETEROGENEOUSNESS	HH EH T AH R AH JH IY N IY AH S N AH S
HETEROGENEOUSNESSES	HH EH T AH R AH JH IY N IY AH S N AH S IH Z
HETEROGENIES	HH EH T AH R AA JH AH N AY Z
HETEROGENOUS	HH EH T AH R AA JH AH N AH S
HETEROGENY	HH EH T AH R AA JH AH N IY
HINGE	HH IH N JH
HINGED	HH IH N JH D
HINGER	HH IH N JH ER
HINGERS	HH IH N JH ER Z
HINGES	HH IH N JH IH Z
HISTOGEN	HH AY Z T AA G AH N
HISTOGENESES	HH IH S T AA JH AH N IY Z AH Z
HISTOGENESIS	HH IH S T AH JH IY N AH S AH S
HISTOGENETIC	HH IH S T AA JH AH N AH T AH K
HISTOGENS	HH AY Z T AA G AH N Z
HODGEPODGE	HH AA JH P AA JH
HODGEPODGES	HH AA JH P AA JH IH Z
HOGGED	HH AA G D
HOGGER	HH AA G ER
HOGGERS	HH AA G ER Z
HOGGET	HH AA G EH T
HOGGETS	HH AA G EH T S
HOMAGE	AA M AH JH
HOMAGE(2)	HH AA M AH JH
HOMAGED	AA M IH JH D
HOMAGER	AA M IH JH ER
HOMAGERS	AA M IH JH ER Z
HOMAGES	AA M AH JH AH Z
HOMAGES(2)	HH AA M AH JH AH Z
HOMOGENATE	HH AH M AA JH AH N EY T
HOMOGENATES	HH AH M AA JH AH N EY T S
HOMOGENEITIES	HH OW M AH JH AH N IY AH T IY Z
HOMOGENEITY	HH AA M AH JH AH N IY AH T IY
HOMOGENEOUS	HH OW M AH JH IY N IY AH S
HOMOGENEOUSLY	HH OW M AH JH IY N IY AH S L IY
HOMOGENEOUSNESS	HH OW M AH JH IY N IY AH S N AH S
HOMOGENEOUSNESSES	HH OW M AH JH IY N IY AH S N AH S IH Z
HOMOGENIES	HH OW M AA JH AH N IY Z
HOMOGENISATION	HH OW M AA JH AH N IY Z EY SH AH N
HOMOGENISATIONS	HH OW M AA JH AH N IY Z EY SH AH N Z
HOMOGENISE	HH AH M AA JH AH N AY Z
HOMOGENISED	HH OW M AA JH AH N IY Z D
HOMOGENISES	HH OW M AA JH AH N IY Z IH Z
HOMOGENISING	HH OW M AA JH AH N IY Z IH NG
HOMOGENIZATION	HH OW M AA JH AH N IH Z EY SH AH N
HOMOGENIZATIONS	HH OW M AA JH AH N AH Z EY SH AH N Z
HOMOGENIZE	HH OW M AA JH AH N AY Z
HOMOGENIZED	HH OW M AA JH AH N AY Z D
HOMOGENIZER	HH OW M AA JH AH N AY Z ER
HOMOGENIZERS	HH OW M AA JH AH N AY Z ER Z
HOMOGENIZES	HH OW M AA JH AH N AY Z IH Z
HOMOGENIZING	HH OW M AA JH AH N AY Z IH NG
HOMOGENOUS	HH AH M AA JH AH N AH S
HOMOGENY	HH OW M AA JH AH N IY
HOROLOGE	HH AO R AH L OW JH
HOROLOGES	HH AO R AH L OW JH AH Z
HOSTAGE	HH AA S T IH JH
HOSTAGES	HH AA S T AH JH AH Z
HOTDOGGED	HH AA T D AO G AH D
HOTDOGGER	HH AA T D AO G ER
HOTDOGGERS	HH AA T D AO G ER Z
HUGE	HH Y UW JH
HUGE(2)	Y UW JH
HUGELY	HH Y UW JH L IY
HUGENESS	HH Y UW JH N AH S
HUGENESSES	HH Y UW JH N AH S IH Z
HUGEOUS	HH Y UW JH AH S
HUGEOUSLY	HH Y UW JH AH S L IY
HUGER	HH Y UW JH ER
HUGEST	HH Y UW JH AH S T
HUGGED	HH AH G D
HUGGER	HH AH G ER
HUGGERS	HH AH G ER Z
HUMBUGGED	HH AH M B AH G D
HUMBUGGERIES	HH AH M B AH G AH R IY Z
HUMBUGGERY	HH AH M B AH G AH R IY
HUMDINGER	HH AH M D IH NG ER
HUMDINGERS	HH AH M D IH N JH AH R Z
HUNGER	HH AH NG G ER
HUNGERED	HH AH NG G ER D
HUNGERING	HH AH NG G ER IH NG
HUNGERS	HH AH NG G ER Z
HYALOGEN	HH AY AE L AH JH AH N
HYALOGENS	HH AY AE L AH JH AH N Z
HYDRANGEA	HH IH D R AE N JH IY AH
HYDRANGEAS	HH IH D R AE N JH IY Z
HYDROGEL	HH IH D R AH JH AH L
HYDROGELS	HH IH D R AH JH AH L Z
HYDROGEN	HH AY D R AH JH AH N
HYDROGENASE	HH IH D R AA JH AH N EY Z
HYDROGENASES	HH IH D R AA JH AH N EY Z AH Z
HYDROGENATE	HH AY D R AH JH AH N EY T
HYDROGENATED	HH AY D R AH JH AH N EY T IH D
HYDROGENATED(2)	HH AY D R AA JH AH N EY T IH D
HYDROGENATES	HH AY D R AH JH AH N EY T S
HYDROGENATING	HH AY D R AH JH AH N EY T IH NG
HYDROGENATION	HH AY D R AA JH AH N EY SH AH N
HYDROGENATIONS	HH AY D R AH JH AH N EY SH AH N Z
HYDROGENOUS	HH AY D R AH JH AH N AH S
HYDROGENS	HH AY D R AH JH AH N Z
HYGEIST	HH AY JH IY AH S T
HYGEISTS	HH AH JH IY S T S
HYPALLAGE	HH AH P AE L AH JH
HYPALLAGES	HH AH P AE L AH JH AH Z
HYPERCHARGE	HH AY P ER CH AA R JH
HYPERCHARGED	HH AY P ER CH AA R JH D
HYPERCHARGES	HH AY P ER CH AA R JH IH Z
HYPERENERGETIC	HH AY P ER EH N ER JH EH T IH K
HYPERINTELLIGENT	HH AY P ER IH N T EH L AH JH AH N T
HYPOALLERGENIC	HH IH P OW L AH R JH AH N AH K
HYPOGEA	HH AH P OW JH IY AH
HYPOGEAL	HH AH P OW JH IY AH L
HYPOGEAN	HH AH P OW JH IY AH N
HYPOGENE	HH IH P AH JH IY N
HYPOGEOUS	HH AH P OW JH IY AH S
HYPOGEUM	HH AH P OW JH IY AH M
HYPOPHARYNGES	HH AH P AA F AH R IH N JH AH Z
IATROGENIC	AY AE T R AH JH AH N AH K
IATROGENICALLY	AY AE T R AH JH EH N AH K AE L IY
IMAGE	IH M AH JH
IMAGE(2)	IH M IH JH
IMAGED	IH M IH JH D
IMAGER	IH M EY JH ER
IMAGERIES	IH M IH JH R IY Z
IMAGERS	IH M EY JH ER Z
IMAGERY	IH M AH JH R IY
IMAGERY(2)	IH M IH JH R IY
IMAGES	IH M AH JH AH Z
IMAGES(2)	IH M IH JH IH Z
IMMERGE	IH M ER JH
IMMERGED	IH M ER JH D
IMMERGES	IH M ER JH IH Z
IMMUNOGEN	IH M Y UW N AH JH AH N
IMMUNOGENESES	IH M Y AH N AA JH AH N IY Z AH Z
IMMUNOGENESIS	IH M Y UW N AH JH IY N AH S AH S
IMMUNOGENETIC	IH M Y AH N AA JH AH N AH T AH K
IMMUNOGENETICALLY	IH M Y UW N AH JH AH N EH T AH K AE L IY
IMMUNOGENETICIST	IH M Y AH N AH JH EH N AH T IH S AH S T
IMMUNOGENETICISTS	IH M Y UW N AH JH AH N EH T AH S AH S T S
IMMUNOGENETICS	IH M Y AH N AH JH EH N AH T AH S Z
IMMUNOGENIC	IH M Y UW N AH JH AH N AH K
IMMUNOGENICITIES	IH M Y UW N AH JH AH N IH S AH T AY Z
IMMUNOGENICITY	IH M Y AH N AA JH AH N IH S AH T IY
IMMUNOGENS	IH M Y UW N AH JH AH N Z
IMPINGE	IH M P IH N JH
IMPINGED	IH M P IH N JH D
IMPINGEMENT	IH M P IH N JH M AH N T
IMPINGEMENTS	IH M P IH N JH M AH N T S
IMPINGER	IH M P IH N JH ER
IMPINGERS	IH M P IH N JH ER Z
IMPINGES	IH M P IH N JH IH Z
IMPLEDGE	IH M P L EH JH
IMPLEDGED	IH M P L EH JH D
IMPLEDGES	IH M P L EH JH IH Z
INCAGE	IH N K EY JH
INCAGED	IH N K EY JH D
INCAGES	IH N K EY JH IH Z
INDIGEN	IH N D IH JH AH N
INDIGENCE	IH N D IH JH AH N S
INDIGENCES	IH N D IH JH AH N S IH Z
INDIGENE	IH N D AH JH IY N
INDIGENES	IH N D AH JH IY N Z
INDIGENIZATION	IH N D AH JH IY N AH Z EY SH AH N
INDIGENIZATIONS	IH N D AH JH IY N AH Z EY SH AH N Z
INDIGENIZE	IH N D AH JH IY N AY Z
INDIGENIZED	IH N D AH JH IY N AY Z D
INDIGENIZES	IH N D AH JH IY N AY Z IH Z
INDIGENIZING	IH N D AH JH IY N AY Z IH NG
INDIGENOUS	IH N D IH JH AH N AH S
INDIGENOUSLY	IH N D IH JH AH N AH S L IY
INDIGENOUSNESS	IH N D IH JH AH N AH S N AH S
INDIGENOUSNESSES	IH N D IH JH AH N AH S N AH S IH Z
INDIGENS	IH N D IH JH AH N Z
INDIGENT	IH N D IH JH AH N T
INDIGENTS	IH N D IH JH AH N T S
INDIGESTED	IH N D IH JH AH S T IH D
INDIGESTIBILITIES	IH N D IH JH AH S T AH B IH L AH T IY Z
INDIGESTIBILITY	IH N D IH JH AH S T AH B IH L AH T IY
INDIGESTIBLE	IH N D IH JH AH S T AH B AH L
INDIGESTIBLES	IH N D IH JH AH S T AH B AH L Z
INDIGESTION	IH N D AY JH EH S CH AH N
INDIGESTIONS	IH N D IH JH AH S SH AH N Z
INDULGE	IH N D AH L JH
INDULGED	IH N D AH L JH D
INDULGENCE	IH N D AH L JH AH N S
INDULGENCES	IH N D AH L JH AH N S IH Z
INDULGENT	IH N D AH L JH AH N T
INDULGENTLY	IH N D AH L JH AH N T L IY
INDULGER	IH N D AH L JH ER
INDULGERS	IH N D AH L JH ER Z
INDULGES	IH N D AH L JH IH Z
INFRINGE	IH N F R IH N JH
INFRINGED	IH N F R IH N JH D
INFRINGEMENT	IH N F R IH N JH M AH N T
INFRINGEMENTS	IH N F R IH N JH M AH N T S
INFRINGER	IH N F R IH N JH ER
INFRINGERS	IH N F R IH N JH ER Z
INFRINGES	IH N F R IH N JH IH Z
INGENIOUS	IH N JH IY N Y AH S
INGENIOUSLY	IH N JH IY N Y AH S L IY
INGENIOUSNESS	IH N JH IY N Y AH S N AH S
INGENIOUSNESSES	IH N JH IY N Y AH S N AH S IH Z
INGENUE	IH N JH EH N Y UW
INGENUES	IH N JH EH N Y UW S
INGENUITIES	IH N JH AH N UW AH T IY Z
INGENUITY	IH N JH AH N UW AH T IY
INGENUOUS	IH N JH EH N Y UW AH S
INGENUOUSLY	IH N JH EH N Y UW OW AH S L IY
INGENUOUSNESS	IH N JH EH N Y UW AW Z N AH S
INGENUOUSNESSES	IH N JH EH N Y UW AW Z N EH S AH Z
INGEST	IH N JH EH S T
INGESTA	IH N JH EH S T AH
INGESTED	IH N JH EH S T AH D
INGESTIBLE	IH N JH EH S T AH B AH L
INGESTING	IH N JH EH S T IH NG
INGESTION	IH N JH EH S CH AH N
INGESTIONS	IH N JH EH S SH AH N Z
INGESTIVE	IH N JH EH S T IH V
INGESTS	IH N JH EH S T S
INHOMOGENEITIES	IH N HH OW M AH JH AH N IY AH T IY Z
INHOMOGENEITY	IH N HH OW M AH JH AH N IY AH T IY
INHOMOGENEOUS	IH N HH OW M AH JH IY N IY AH S
INSELBERGE	IH N S EH L B AH R JH
INSURGENCE	IH N S ER JH AH N S
INSURGENCES	IH N S ER JH AH N S IH Z
INSURGENCIES	IH N S ER JH AH N S IY Z
INSURGENCY	IH N S ER JH AH N S IY
INSURGENT	IH N S ER JH AH N T
INSURGENTLY	IH N S ER JH AH N T L IY
INSURGENTS	IH N S ER JH AH N T S
INTEGER	IH N T AH JH ER
INTEGERS	IH N T AH JH ER Z
INTELLIGENCE	IH N T EH L AH JH AH N S
INTELLIGENCER	IH N T EH L AH JH AH N S ER
INTELLIGENCERS	IH N T EH L AH JH AH N S ER Z
INTELLIGENCES	IH N T EH L AH JH AH N S IH Z
INTELLIGENT	IH N T EH L AH JH AH N T
INTELLIGENTIAL	IH N T EH L AH JH AH N T IY AH L
INTELLIGENTLY	IH N T EH L IH JH AH N T L IY
INTELLIGENTSIA	IH N T EH L AH JH EH N T S IY AH
INTELLIGENTSIAS	IH N T EH L AH JH EH N T S IY AH Z
INTERAGE	IH N T ER EY JH
INTERAGENCY	IH N T ER EY JH AH N S IY
INTERCHANGE	IH N T ER CH EY N JH
INTERCHANGE(2)	IH N ER CH EY N JH
INTERCHANGEABILITIES	IH N T ER CH EY N JH AH B IH L AH T EH Z
INTERCHANGEABILITY	IH N T ER CH EY N JH AH B IH L AH T EH
INTERCHANGEABLE	IH N T ER CH EY N JH AH B AH L
INTERCHANGEABLE(2)	IH N ER CH EY N JH AH B AH L
INTERCHANGEABLENESS	IH N T ER CH EY N JH AH B AH L N AH S
INTERCHANGEABLENESSES	IH N T ER CH EY N JH AH B AH L N AH S IH Z
INTERCHANGEABLY	IH N T ER CH EY N JH AH B L IY
INTERCHANGEABLY(2)	IH N ER CH EY N JH AH B L IY
INTERCHANGED	IH N T ER CH EY N JH D
INTERCHANGER	IH N T ER CH EY N JH ER
INTERCHANGERS	IH N T ER CH EY N JH ER Z
INTERCHANGES	IH N T ER CH EY N JH IH Z
INTERCHANGES(2)	IH N ER CH EY N JH IH Z
INTERGENERATION	IH N T ER JH EH N ER EY SH AH N
INTERGENERATIONAL	IH N T ER JH EH N ER EY SH AH N AH L
INTERGENERATIONS	IH N T ER JH EH N ER EY SH AH N Z
INTERGENERIC	IH N T ER JH EH N ER IH K
INTERMARRIAGE	IH N T ER M EH R IH JH
INTERMARRIAGES	IH N T ER M AE R IH JH IH Z
INTERPHALANGEAL	IH N T AH R F AH L AE N JH IY AH L
INTERREGES	IH N T AH R IY JH AH Z
INTERROGEE	IH N T AH R AH JH IY IY
INTERROGEES	IH N T AH R AH JH IY Z
INTERSTAGE	IH N T ER S T EY JH
INTERTILLAGE	IH N T ER T IH L IH JH
INTERTILLAGES	IH N T ER T IH L IH JH IH Z
INTERVILLAGE	IH N T ER V IH L IH JH
INTRAGENIC	IH N T R AH JH IY N IH K
INTRANSIGEANCE	IH N T R AH N S AY JH IY AH N S
INTRANSIGEANCES	IH N T R AH N S AY JH IY AE N S AH Z
INTRANSIGEANT	IH N T R AH N S AY JH IY AH N T
INTRANSIGEANTLY	IH N T R AH N S AH JH IY N T L IY
INTRANSIGEANTS	IH N T R AH N S AH JH IY N T S
INTRANSIGENCE	IH N T R AE N S AH JH AH N S
INTRANSIGENCE(2)	IH N T R AE N S IH JH AH N S
INTRANSIGENCES	IH N T R AE N S AH JH AH N S IH Z
INTRANSIGENT	IH N T R AE N S AH JH AH N T
INTRANSIGENT(2)	IH N T R AE N Z AH JH AH N T
INTRANSIGENTLY	IH N T R AE N S AH JH AH N T L IY
INTRANSIGENTS	IH N T R AE N S AH JH AH N T S
IONOGEN	AY AA N AH JH AH N
IONOGENS	AY AA N AH JH AH N Z
IRONMONGER	AY ER N M AH NG G ER
IRONMONGERIES	AY ER N M AH NG G ER IY Z
IRONMONGERS	AY ER N M AH NG G ER Z
IRONMONGERY	AY ER N M AH NG G ER IY
ISAGOGE	IH S AH G OW JH
ISAGOGES	IH S AH G OW JH AH Z
ISOANTIGEN	AH S OW N T AH JH AH N
ISOANTIGENIC	AH S OW N T AH JH AH N AH K
ISOANTIGENS	AH S OW N T AH JH AH N Z
ISOGENEIC	IH S AH JH IY N IY AH K
ISOGENIC	AY S OW JH EH N AH K
ISOGENIES	AH S AA JH AH N AY Z
ISOGENY	AH S AA JH AH N IY
JAEGER	JH EH G ER
JAEGER(2)	Y AE G ER
JAEGERS	JH EH G ER Z
JAEGERS(2)	Y AE G ER Z
JAGER	JH EY G ER
JAGERS	JH AE G ER Z
JAGGED	JH AE G D
JAGGEDER	JH AE G AH D ER
JAGGEDEST	JH AE G AH D AH S T
JAGGEDLY	JH AE G AH D L IY
JAGGEDNESS	JH AE G AH D N AH S
JAGGEDNESSES	JH AE G AH D N AH S IH Z
JAGGER	JH AE G ER
JAGGERIES	JH AE G AH R IY Z
JAGGERS	JH AE G ER Z
JAGGERY	JH AE G AH R IY
JAYGEE	JH EY JH IY IY
JAYGEES	JH EY JH IY Z
JIGGED	JH IH G D
JIGGER	JH IH G ER
JIGGERED	JH IH G ER D
JIGGERING	JH IH G ER IH NG
JIGGERS	JH IH G ER Z
JITTERBUGGED	JH IH T ER B AH G D
JOGGED	JH AA G D
JOGGER	JH AA G ER
JOGGERS	JH AA G ER Z
JUDGE	JH AH JH
JUDGED	JH AH JH D
JUDGEMENT	JH AH JH M AH N T
JUDGEMENTS	JH AH JH M AH N T S
JUDGER	JH AH JH ER
JUDGERS	JH AH JH ER Z
JUDGES	JH AH JH IH Z
JUDGESHIP	JH AH JH SH IH P
JUDGESHIPS	JH AH JH SH IH P S
JUGGED	JH AH G D
JUGGERNAUT	JH AH G ER N AO T
JUGGERNAUTS	JH AH JH AH R N AH Y UW T S
KEDGE	K EH JH
KEDGED	K EH JH D
KEDGEREE	K EH JH AH R IY IY
KEDGEREES	K EH JH AH R IY Z
KEDGES	K EH JH AH Z
KEELAGE	K IY L IH JH
KEELAGES	K IY L IH JH IH Z
KEGELER	K AH JH IY L AH R
KEGELERS	K EH JH AH L AH R Z
KENTLEDGE	K EH N T L AH JH
KENTLEDGES	K EH N T L EH JH AH Z
KEROGEN	K EH R AH JH AH N
KEROGENS	K EH R AH JH AH N Z
KETOGENESES	K AH T AA JH AH N IY Z AH Z
KETOGENESIS	K EH T AH JH IY N AH S AH S
KETOGENIC	K EH T AH JH AH N AH K
KINGED	K IH NG D
KLUDGE	K L AH JH
KLUDGES	K L AH JH AH Z
KLUGE	K L UW JH
KLUGES	K L UW JH AH Z
KNOWINGER	N OW IH NG ER
KNOWINGEST	N OW IH N JH EH S T
KNOWLEDGE	N AA L AH JH
KNOWLEDGE(2)	N AA L IH JH
KNOWLEDGEABILITIES	N AA L IH JH AH B IH L AH T EH Z
KNOWLEDGEABILITY	N AA L IH JH AH B IH L AH T EH
KNOWLEDGEABLE	N AA L AH JH AH B AH L
KNOWLEDGEABLENESS	N AA L IH JH AH B AH L N AH S
KNOWLEDGEABLENESSES	N AA L IH JH AH B AH L N AH S IH Z
KNOWLEDGEABLY	N AA L IH JH AH B L IY
KNOWLEDGES	N AA L IH JH IH Z
KRUGERRAND	K R UW G EH R AE N D
KRUGERRANDS	K R UW JH EH R AH N D Z
KUGEL	K UW G AH L
KUGELS	K Y UW JH AH L Z
LAAGER	L EY AH JH AH R
LAAGERED	L AH JH IY R D
LAAGERING	L AH JH IY R AH NG
LAAGERS	L AA JH AH R Z
LACTOGENIC	L AE K T AH JH AH N AH K
LADYFINGER	L EY D IY F IH NG G ER
LADYFINGERS	L EY D IY F IH NG G ER Z
LAGEND	L AE G EH N D
LAGENDS	L AE G EH N D Z
LAGER	L AA G ER
LAGERED	L AA G ER D
LAGERING	L AA G ER IH NG
LAGERS	L AA G ER Z
LAGGED	L AE G D
LAGGER	L AE G ER
LAGGERS	L AE G ER Z
LALLYGAGGED	L AE L AH G AH G D
LAMMERGEIER	L AE M ER JH IY ER
LAMMERGEIERS	L AE M ER JH IY ER Z
LAMMERGEYER	L AE M ER JH IY ER
LAMMERGEYERS	L AE M ER JH IY ER Z
LANGRAGE	L AE N G R AH JH
LANGRAGES	L AE N G R AH JH AH Z
LANGUAGE	L AE NG G W AH JH
LANGUAGE(2)	L AE NG G W IH JH
LANGUAGES	L AE NG G W AH JH AH Z
LANGUAGES(2)	L AE NG G W IH JH IH Z
LARGE	L AA R JH
LARGEHEARTED	L AA R JH HH AA R T IH D
LARGEHEARTEDNESS	L AA R JH HH AA R T AH D N AH S
LARGEHEARTEDNESSES	L AA R JH HH AA R T AH D N AH S IH Z
LARGELY	L AA R JH L IY
LARGEMOUTH	L AA R JH M AW TH
LARGEMOUTHS	L AA R JH M AW TH S
LARGENESS	L AA R JH N IH S
LARGENESSES	L AA R JH N AH S IH Z
LARGER	L AA R JH ER
LARGES	L AA R JH IH Z
LARGESS	L AA R JH AH S
LARGESSE	L AA R G EH S
LARGESSES	L AA R JH EH S IH Z
LARGEST	L AA R JH AH S T
LARYNGEAL	L AA R IH N JH IY AH L
LARYNGEALS	L AE R AH N JH IY L Z
LARYNGECTOMEE	L AH R IH N JH AH K T AH M IY IY
LARYNGECTOMEES	L AH R IH N JH EH K T AH M IY Z
LARYNGECTOMIES	L AE R AH N JH EH K T AH M AY Z
LARYNGECTOMIZED	L AH R IH N JH EH K T AH M AY Z D
LARYNGECTOMY	L AE R AH N JH EH K T AH M IY
LARYNGES	L AH R IH N JH AH Z
LAVAGE	L EY V AH JH
LAVAGES	L EY V AH JH AH Z
LAYERAGE	L EY ER IH JH
LAYERAGES	L EY ER IH JH IH Z
LEAFAGE	L IY F IH JH
LEAFAGES	L IY F IH JH IH Z
LEAKAGE	L IY K AH JH
LEAKAGE(2)	L IY K IH JH
LEAKAGES	L IY K IH JH IH Z
LEAPFROGGED	L IY P F R AO G D
LEDGE	L EH JH
LEDGER	L EH JH ER
LEDGERS	L EH JH ER Z
LEDGES	L EH JH IH Z
LEGEND	L EH JH AH N D
LEGENDARILY	L EH JH AH N D EH R IY L IY
LEGENDARY	L EH JH AH N D EH R IY
LEGENDRIES	L EH JH AH N D R IY Z
LEGENDRY	L EH JH AH N D R IY
LEGENDS	L EH JH AH N D Z
LEGER	L EH JH ER
LEGERDEMAIN	L EH JH ER D AH M EY N
LEGERDEMAINS	L EH G ER D IY M EY N Z
LEGERITIES	L EH G ER AH T IY Z
LEGERITY	L EH G ER AH T IY
LEGERS	L EH G ER Z
LEGES	L EH G Z
LEGGED	L EH G AH D
LEGGED(2)	L EH G D
LEUKAEMOGENESES	L UW K AH M AA JH AH N IY Z AH Z
LEUKAEMOGENESIS	L UW K IY M AH JH IY N AH S AH S
LEUKEMOGENESES	L UW K AH M AA JH AH N IY Z AH Z
LEUKEMOGENESIS	L UW K AH M AH JH IY N AH S AH S
LEUKEMOGENIC	L UW K EH M AH JH AH N AH K
LEVERAGE	L EH V ER IH JH
LEVERAGE(2)	L EH V R AH JH
LEVERAGE(3)	L IY V ER IH JH
LEVERAGED	L IY V ER IH JH D
LEVERAGED(2)	L EH V ER IH JH D
LEVERAGED(3)	L EH V R IH JH D
LEVERAGES	L IY V ER IH JH IH Z
LIBERTINAGE	L IH B ER T IY N IH JH
LIBERTINAGES	L IH B ER T IY N IH JH IH Z
LIEGE	L IY JH
LIEGEMAN	L IY JH AH M AH N
LIEGEMEN	L AY JH EH M AH N
LIEGES	L IY JH AH Z
LIGER	L AY JH AH R
LIGERS	L IH JH AH R Z
LIGHTERAGE	L AY T ER IH JH
LIGHTERAGES	L AY T ER IH JH IH Z
LIGHTNINGED	L AY T N IH NG D
LILANGENI	L AH L AE N JH AH N IY
LINAGE	L AY N IH JH
LINAGES	L AY N IH JH IH Z
LINEAGE	L IH N IY AH JH
LINEAGES	L IH N IY IH JH IH Z
LINGER	L IH NG G ER
LINGER(2)	L IH NG ER
LINGERED	L IH NG G ER D
LINGERER	L IH NG G ER ER
LINGERERS	L IH NG G ER ER Z
LINGERIE	L AA N ZH ER EY
LINGERIES	L AA N JH AH R EY Z
LINGERING	L IH NG G ER IH NG
LINGERING(2)	L IH NG G R IH NG
LINGERINGLY	L IH NG G ER IH NG L IY
LINGERS	L IH NG G ER Z
LINKAGE	L IH NG K AH JH
LINKAGE(2)	L IH NG K IH JH
LINKAGES	L IH NG K IH JH IH Z
LIPOGENESES	L AH P AA JH AH N IY Z AH Z
LIPOGENESIS	L IH P AH JH IY N AH S AH S
LITHARGE	L IH TH AH R JH
LITHARGES	L AH TH AA R JH AH Z
LOCKAGE	L OW K IH JH
LOCKAGES	L OW K IH JH IH Z
LODGE	L AA JH
LODGED	L AA JH D
LODGEMENT	L AA JH M AH N T
LODGEMENTS	L AA JH M AH N T S
LODGER	L AA JH ER
LODGERS	L AA JH ER Z
LODGES	L AA JH AH Z
LODGES(2)	L AA JH IH Z
LOGE	L OW JH
LOGES	L OW JH IH Z
LOGGED	L AO G D
LOGGER	L AA G ER
LOGGERHEAD	L AA G ER HH EH D
LOGGERHEADS	L AA G ER HH EH D Z
LOGGERS	L AA G ER Z
LOGGETS	L AA G EH T S
LOLLYGAGGED	L AA L IY G AE G D
LONGE	L AA N JH
LONGED	L AO NG D
LONGEING	L AO NG IY AH NG
LONGER	L AO NG G ER
LONGERON	L AO NG G ER AO N
LONGERONS	L AO NG G ER AO N Z
LONGERS	L AO NG G ER Z
LONGES	L AO NG Z
LONGEST	L AO NG G AH S T
LONGEST(2)	L AO NG G IH S T
LONGEVITIES	L AA N JH EH V AH T IY Z
LONGEVITY	L AO N JH EH V AH T IY
LONGEVOUS	L AO NG IY V AH S
LOUNGE	L AW N JH
LOUNGED	L AW N JH D
LOUNGER	L AW N JH ER
LOUNGERS	L AW N JH ER Z
LOUNGES	L AW N JH IH Z
LOUNGEWEAR	L AW N JH W AE ER
LOVAGE	L AH V AH JH
LOVAGES	L AH V IH JH IH Z
LOZENGE	L AO Z AH N JH
LOZENGES	L AO Z AH N JH AH Z
LUGE	L UW JH
LUGED	L AH G D
LUGEING	L UW JH IY AH NG
LUGER	L UW G ER
LUGERS	L UW G ER Z
LUGES	L AH G Z
LUGGAGE	L AH G AH JH
LUGGAGE(2)	L AH G IH JH
LUGGAGES	L AH G IH JH IH Z
LUGGED	L AH G D
LUGGER	L AH G ER
LUGGERS	L AH G ER Z
LUNGE	L AH N JH
LUNGED	L AH N JH D
LUNGEE	L AH N JH IY
LUNGEES	L AH N JH IY Z
LUNGER	L AH NG ER
LUNGERS	L AH N JH ER Z
LUNGES	L AH N JH IH Z
LYSOGEN	L IH S AH JH AH N
LYSOGENIC	L IH S AH JH AH N AH K
LYSOGENICITIES	L IH S AH JH AH N IH S AH T AY Z
LYSOGENICITY	L AH S AA JH AH N IH S AH T IY
LYSOGENIES	L AH S AA JH AH N AY Z
LYSOGENISE	L AH S AA JH AH N AY Z
LYSOGENISED	L AH S AA JH AH N AH S T
LYSOGENISES	L AH S AA JH AH N AY Z AH Z
LYSOGENISING	L AH S AA JH AH N AY Z AH NG
LYSOGENIZATION	L IH S AH JH AH N AH Z EY SH AH N
LYSOGENIZATIONS	L AH S AA JH AH N AH Z EY T IY AH N Z
LYSOGENIZE	L AH S AA JH AH N AY Z
LYSOGENIZED	L AH S AA JH AH N AY Z D
LYSOGENIZES	L AH S AA JH AH N AY Z AH Z
LYSOGENIZING	L AH S AA JH AH N AY Z AH NG
LYSOGENS	L IH S AH JH AH N Z
LYSOGENY	L AH S AA JH AH N IY
MACROPHAGE	M AE K R OW F EY JH
MACROPHAGES	M AE K R OW F EY JH IH Z
MAGE	M EY JH
MAGENTA	M AH JH EH N T AH
MAGENTAS	M AH JH EH N T AH Z
MAGES	M EY JH IH Z
MALINGER	M AH L IH NG G ER
MALINGERED	M AH L IH NG G ER D
MALINGERER	M AH L IH NG G ER ER
MALINGERERS	M AH L IH NG G ER ER Z
MALINGERING	M AH L IH NG G ER IH NG
MALINGERS	M AH L IH NG G ER Z
MANAGE	M AE N AH JH
MANAGE(2)	M AE N IH JH
MANAGEABILITIES	M AE N IH JH AH B IH L AH T EH Z
MANAGEABILITY	M AE N IH JH AH B IH L AH T EH
MANAGEABLE	M AE N IH JH AH B AH L
MANAGEABLENESS	M AE N IH JH AH B AH L N AH S
MANAGEABLENESSES	M AE N IH JH AH B AH L N AH S IH Z
MANAGEABLY	M AE N IH JH AH B L IY
MANAGED	M AE N AH JH D
MANAGED(2)	M AE N IH JH D
MANAGEMENT	M AE N AH JH M AH N T
MANAGEMENT(2)	M AE N IH JH M AH N T
MANAGEMENTAL	M AE N IH JH M AH N T AH L
MANAGEMENTS	M AE N IH JH M AH N T S
MANAGER	M AE N AH JH ER
MANAGER(2)	M AE N IH JH ER
MANAGERESS	M AE N IH JH ER AH S
MANAGERESSES	M AE N IH JH ER AH S IH Z
MANAGERIAL	M AE N IH JH IH R IY AH L
MANAGERIALLY	M AE N AH JH IH R IY AH L IY
MANAGERS	M AE N AH JH ER Z
MANAGERS(2)	M AE N IH JH ER Z
MANAGERSHIP	M AE N IH JH ER SH IH P
MANAGERSHIPS	M AE N IH JH ER SH IH P S
MANAGES	M AE N IH JH IH Z
MANEGE	M AH N IY JH
MANEGES	M AH N IY JH AH Z
MANGE	M EY N JH
MANGEL	M EY NG G AH L
MANGELS	M EY NG G AH L Z
MANGER	M EY N JH ER
MANGERS	M AE N JH AH R Z
MANGES	M EY N JH IH Z
MANGEY	M AE N JH IY
MAQUILLAGE	M AE K W IH L AH JH
MAQUILLAGES	M AE K W IH L AH JH AH Z
MARGE	M AA R JH
MARGENT	M AA R JH EH N T
MARGENTED	M AA R JH EH N T IH D
MARGENTING	M AA R JH EH N T IH NG
MARGENTS	M AA R JH EH N T S
MARGES	M AA R JH AH Z
MARRIAGE	M EH R IH JH
MARRIAGEABILITIES	M AE R IH JH AH B IH L AH T EH Z
MARRIAGEABILITY	M AE R IH JH AH B IH L AH T EH
MARRIAGEABLE	M AE R IH JH AH B AH L
MARRIAGES	M EH R IH JH IH Z
MASSAGE	M AH S AA ZH
MASSAGED	M AH S AA ZH D
MASSAGER	M AH S AA ZH ER
MASSAGERS	M AH S AA ZH ER Z
MASSAGES	M AH S AA ZH IH Z
MASTERSINGER	M AE S T ER S IH NG ER
MASTERSINGERS	M AE S T ER S IH NG ER Z
MAUGER	M AO G ER
MEAGER	M IY G ER
MEAGERLY	M IY G ER L IY
MEAGERNESS	M IY G ER N AH S
MEAGERNESSES	M IY G ER N AH S IH Z
MEDIAGENIC	M IY D IY IH JH AH N IH K
MEGASPOROGENESES	M AH G AH S AH R AA JH AH N IY Z AH Z
MEGASPOROGENESIS	M AH G AE S AH R AH JH IY N AH S AH S
MEGATONNAGE	M EH G AH T AH N IH JH
MEGATONNAGES	M EH G AH T AH N IH JH IH Z
MELANGE	M EH L AE NG
MELANGES	M EY L AA N ZH IH Z
MELANOGENESES	M AH L AH N AA JH AH N IY Z AH Z
MELANOGENESIS	M EH L AH N AH JH IY N AH S AH S
MELTAGE	M EH L T IH JH
MELTAGES	M EH L T IH JH IH Z
MENAGE	M EH N IH JH
MENAGERIE	M AH N AE JH ER IY
MENAGERIES	M AH N AE JH AH R IY Z
MENAGES	M EH N IH JH IH Z
MENINGEAL	M AH N IH N JH IY AH L
MENINGES	M EH N IH NG Z
MERGE	M ER JH
MERGED	M ER JH D
MERGENCE	M ER JH AH N S
MERGENCES	M ER JH AH N S IH Z
MERGER	M ER JH ER
MERGERS	M ER JH ER Z
MERGES	M ER JH IH Z
MESHUGGE	M EH SH AH JH
MESHUGGENER	M IY Z HH AH G AH N ER
MESHUGGENERS	M IY Z HH AH G AH N ER Z
MESSAGE	M EH S AH JH
MESSAGE(2)	M EH S IH JH
MESSAGED	M EH S IH JH D
MESSAGES	M EH S AH JH AH Z
MESSAGES(2)	M EH S IH JH IH Z
MESSENGER	M EH S AH N JH ER
MESSENGER(2)	M EH S IH N JH ER
MESSENGERS	M EH S AH N JH ER Z
MESSUAGE	M IY Z S UW IH JH
MESSUAGES	M IY Z S UW IH JH IH Z
METAGE	M IY T IH JH
METAGENESES	M EH T AH JH IY N Z IH Z
METAGENESIS	M EH T AH JH EH N AH S AH S
METAGENETIC	M IY T IH JH N EH T IH K
METAGES	M IY T IH JH IH Z
METALANGUAGE	M EH T AH L AE NG G W IH JH
METALANGUAGES	M EH T AH L AE NG G W IH JH IH Z
METERAGE	M IY T ER IH JH
METERAGES	M IY T ER IH JH IH Z
MICROIMAGE	M AY K R OW IH M IH JH
MICROIMAGES	M AY K R OW IH M IH JH IH Z
MICROMANAGE	M AY K R OW M AE N IH JH
MICROMANAGED	M AY K R OW M AE N IH JH D
MICROMANAGEMENT	M AY K R OW M AE N IH JH M AH N T
MICROMANAGEMENTS	M AY K R OW M AE N IH JH M AH N T S
MICROMANAGER	M AY K R OW M AE N IH JH ER
MICROMANAGERS	M AY K R OW M AE N IH JH ER Z
MICROMANAGES	M AY K R OW M AE N IH JH AH Z
MICROPHAGE	M IH K R AH F AH JH
MICROPHAGES	M IH K R AA F AH JH AH Z
MICROSPOROGENESES	M AY K R OW S AH R AA JH AH N IY Z AH Z
MICROSPOROGENESIS	M AY K R OW S AO R AH JH IY N AH S AH S
MICROSURGERIES	M AY K R OW S ER JH AH R IY Z
MICROSURGERY	M AY K R OW S ER JH AH R IY
MIDGE	M IH JH
MIDGES	M IH JH AH Z
MIDGES(2)	M IH JH IH Z
MIDGET	M IH JH AH T
MIDGETS	M IH JH AH T S
MIDRANGE	M IH D R EY N JH
MIDRANGES	M IH D R EY N JH IH Z
MILAGE	M AY L IH JH
MILAGES	M AY L IH JH IH Z
MILEAGE	M AY L AH JH
MILEAGE(2)	M AY L IH JH
MILEAGES	M AY L IH JH IH Z
MILLAGE	M IH L IH JH
MILLAGES	M IH L IH JH IH Z
MILLIROENTGEN	M IH L IH R OW EH N T JH AH N
MILLIROENTGENS	M IH L AH R OW EH N T JH AH N Z
MINNESINGER	M IH N EH S AH NG AH R
MINNESINGERS	M IH N AH S IH N JH AH R Z
MINTAGE	M IH N T AH JH
MINTAGE(2)	M IH N T IH JH
MINTAGES	M IH N T IH JH IH Z
MIRAGE	M ER AA ZH
MIRAGES	M ER AA ZH AH Z
MISAGENT	M IH S EY JH AH N T
MISAGENTS	M IH S EY JH AH N T S
MISCARRIAGE	M IH S K EH R AH JH
MISCARRIAGES	M IH S K EH R IH JH IH Z
MISCATALOGED	M IH S K AE T AH L AO G D
MISCEGENATION	M IH S EH JH AH N EY SH AH N
MISCEGENATIONAL	M IH S EH JH AH N EY SH AH N AH L
MISCEGENATIONS	M IH S EH JH AH N EY SH AH N Z
MISCHARGE	M IH S CH AA R JH
MISCHARGED	M IH S CH AA R JH D
MISCHARGES	M IH S CH AA R JH IH Z
MISGAUGE	M IH S G EY JH
MISGAUGED	M IH S G EY JH D
MISGAUGES	M IH S G EY JH IH Z
MISJUDGE	M IH S JH AH JH
MISJUDGED	M IH S JH AH JH D
MISJUDGES	M IH S JH AH JH IH Z
MISKNOWLEDGE	M IH S N AA L IH JH
MISKNOWLEDGES	M IH S N AA L IH JH IH Z
MISLODGE	M IH S L AA JH
MISLODGED	M IH S L AA JH D
MISLODGES	M IH S L AA JH IH Z
MISMANAGE	M IH S M AE N IH JH
MISMANAGED	M IH S M AE N IH JH D
MISMANAGEMENT	M IH S M AE N IH JH M AH N T
MISMANAGEMENTS	M IH S M AE N IH JH M AH N T S
MISMANAGES	M IH S M AE N IH JH AH Z
MISMARRIAGE	M IH S M AE R IH JH
MISMARRIAGES	M IH S M AE R IH JH IH Z
MISPACKAGE	M IH S P AE S IH JH
MISPACKAGED	M IH S P AE S IH JH D
MISPACKAGES	M IH S P AE S IH JH IH Z
MISPAGE	M IH S P EY JH
MISPAGED	M IH S P EY JH D
MISPAGES	M IH S P EY JH IH Z
MISUSAGE	M IH S Y UW S IH JH
MISUSAGES	M IH S Y UW S IH JH IH Z
MITOGEN	M IH T AH JH AH N
MITOGENIC	M IH T AH JH AH N AH K
MITOGENICITIES	M IH T AH JH AH N IH S AH T AY Z
MITOGENICITY	M AH T AA JH AH N IH S AH T IY
MITOGENS	M IH T AH JH AH N Z
MOGGED	M AA G D
MONGEESE	M AA N JH IY Z
MONGER	M AH NG G ER
MONGERED	M AH NG G ER D
MONGERING	M AH NG G ER IH NG
MONGERS	M AH NG G ER Z
MONOGENEAN	M AA N AH JH IY N IY AH N
MONOGENEANS	M AH N AA JH AH N IY N Z
MONOGENESES	M AA N OW JH IY N Z IH Z
MONOGENESIS	M AA N OW JH EH N AH S AH S
MONOGENETIC	M AA N OW JH AH N EH T IH K
MONOGENIC	M AA N OW JH IY N IH K
MONOGENICALLY	M AA N OW JH IY N IH K AH L IY
MONOGENIES	M AA N OW JH IY N IY Z
MONOGENY	M AA N OW JH IY N IY
MONOGERM	M AA N OW JH ER M
MONTAGE	M AA N T AA ZH
MONTAGED	M AA N T IY IH JH D
MONTAGES	M AA N T IY IH JH IH Z
MOORAGE	M UH R IH JH
MOORAGES	M UH R IH JH IH Z
MORGEN	M AO R G AH N
MORGENS	M AO R G AH N Z
MORPHOGEN	M AO R F AH JH AH N
MORPHOGENESES	M AO R F AA JH AH N IY Z AH Z
MORPHOGENESIS	M AO R F AH JH EH N AH S AH S
MORPHOGENETIC	M AO R F AA JH AH N AH T AH K
MORPHOGENETICALLY	M AO R F AH JH AH N EH T AH K AE L IY
MORPHOGENIC	M AO R F AH JH AH N AH K
MORPHOGENS	M AO R F AH JH AH N Z
MORTGAGE	M AO R G AH JH
MORTGAGE(2)	M AO R G IH JH
MORTGAGED	M AO R G IH JH D
MORTGAGEE	M AO R G IH JH IY
MORTGAGEES	M AO R G IH JH IY Z
MORTGAGER	M AO R G IH JH ER
MORTGAGERS	M AO R G IH JH ER Z
MORTGAGES	M AO R G AH JH AH Z
MORTGAGES(2)	M AO R G IH JH IH Z
MOULAGE	M OW AH L AH JH
MOULAGES	M OW UH L AH JH AH Z
MUCILAGE	M Y UW S AH L IH JH
MUCILAGES	M Y UW S AH L IH JH IH Z
MUDSLINGER	M AH D S L IH NG ER
MUDSLINGERS	M AH D S L IH NG ER Z
MUGGED	M AH G D
MUGGEE	M AH G IY
MUGGEES	M AH G IY Z
MUGGER	M AH G ER
MUGGERS	M AH G ER Z
MULTIAGE	M AH L T AY EY JH
MULTIAGENCY	M AH L T AY EY JH AH N S IY
MULTIGENERATIONAL	M AH L T AY JH EH N ER EY SH AH N AH L
MULTIGENIC	M AH L T AY JH IY N IH K
MULTIGERM	M AH L T AY JH ER M
MULTIPAGE	M AH L T AY P EY JH
MULTIPRONGED	M AH L T AH P R AO NG D
MULTIRANGE	M AH L T AY R EY N JH
MULTISTAGE	M AH L T AY S T EY JH
MUSKELLUNGE	M AH S EH L AH N JH
MUSKELLUNGES	M AH S EH L AH N JH AH Z
MUTAGEN	M Y UW T AH JH EH N
MUTAGENESES	M Y UW T AE JH AH N IY Z AH Z
MUTAGENESIS	M Y UW T AH JH IY N AH S AH S
MUTAGENIC	M Y UW T IH JH AH N IH K
MUTAGENICALLY	M Y UW T IH JH AH N IH K AH L IY
MUTAGENICITIES	M Y UW T IH JH AH N IH K S AH T IY Z
MUTAGENICITY	M Y UW T IH JH AH N IH K S AH T IY
MUTAGENS	M Y UW T AH JH EH N Z
MYELOGENOUS	M AY AH L AA JH AH N AH S
MYOGENIC	M AY AH JH AH N AH K
MYTHOLOGER	M IH TH AH L OW JH AH R
MYTHOLOGERS	M AH TH AA L AH JH AH R Z
NAGGED	N AE G D
NAGGER	N AE G ER
NAGGERS	N AE G ER Z
NASOPHARYNGEAL	N AH S AA F AH R IH N JH IY AH L
NASOPHARYNGES	N AH S AA F AH R IH N JH AH Z
NEGLIGE	N EH G L AY JH
NEGLIGEE	N EH G L IH JH IY
NEGLIGEES	N EH G L IH JH IY Z
NEGLIGENCE	N EH G L AH JH AH N S
NEGLIGENCE(2)	N EH G L IH JH AH N S
NEGLIGENCES	N EH G L IH JH AH N S IH Z
NEGLIGENT	N EH G L AH JH AH N T
NEGLIGENT(2)	N EH G L IH JH AH N T
NEGLIGENTLY	N EH G L IH JH AH N T L IY
NEGLIGES	N EH G L AY JH AH Z
NEURODEGENERATIVE	N Y UH R AH D EH JH AH N AH R EY T AH V
NEUROGENIC	N Y UH R AH JH AH N AH K
NEUROGENICALLY	N Y UH R AH JH EH N AH K AE L IY
NEUROSURGEON	N UH R OW S ER JH AH N
NEUROSURGEONS	N UH R OW S ER JH AH N Z
NEUROSURGERIES	N Y UH R AH S AH R JH AH R AY Z
NEUROSURGERY	N UH R OW S ER JH ER IY
NEWSAGENT	N UW Z IH JH AH N T
NEWSAGENTS	N UW Z IH JH AH N T S
NEWSMONGER	N UW Z M AH NG G ER
NEWSMONGERS	N UW Z M AH NG G ER Z
NIDGET	N IH JH AH T
NIDGETS	N IH JH AH T S
NIGGER	N IH G ER
NIGGERS	N IH G ER Z
NITROGEN	N AY T R AH JH AH N
NITROGENASE	N IH T R AA JH AH N EY Z
NITROGENASES	N IH T R AA JH AH N EY Z AH Z
NITROGENOUS	N AY T R AA JH AH N AH S
NITROGENS	N AY T R AH JH AH N Z
NOGGED	N AA G D
NONAGE	N AA N EY JH
NONAGENARIAN	N AH N AE JH AH N EH R IY AH N
NONAGENARIANS	N AH N AE JH AH N AE R IY AH N Z
NONAGES	N AA N EY JH IH Z
NONALLERGENIC	N AA N AO L ER JH IY N IH K
NONANTIGENIC	N AA N AE N T IH JH AH N IH K
NONBELLIGERENCIES	N AA N B AH L IH JH ER AH N S IY Z
NONBELLIGERENCY	N AA N B AH L IH JH ER AH N S IY
NONBELLIGERENT	N AA N B AH L IH JH ER AH N T
NONBELLIGERENTS	N AA N B AH L IH JH ER AH N T S
NONCARCINOGEN	N AA N K AA R S IH N AH JH AH N
NONCARCINOGENIC	N AA N K AA R S IH N AH JH AH N AH K
NONCARCINOGENS	N AA N K AA R S IH N AH JH AH N Z
NONCOLLEGE	N AA N K AA L IH JH
NONCOLLEGES	N AA N K AA L IH JH IH Z
NONCONTINGENT	N AA N K AH N T IH N JH AH N T
NONCOVERAGE	N AA N K OW V EH R IH JH
NONCOVERAGES	N AA N K OW V EH R IH JH IH Z
NONDEGENERATE	N AA N D IY JH EH N ER AH T
NONDEGENERATES	N AA N D IY JH EH N ER AH T S
NONEMERGENCIES	N AA N IH M ER JH AH N S IY Z
NONEMERGENCY	N AA N IH M ER JH AH N S IY
NONENGAGEMENT	N AA N EH N G EY JH M AH N T
NONENGAGEMENTS	N AA N EH N G EY JH M AH N T S
NONGENETIC	N AA N JH AH N EH T IH K
NONGENITAL	N AA N JH EH N AH T AH L
NONGEOMETRICAL	N AA N JH IY AH M EH T R IH K AH L
NONHALOGENATED	N AA N HH AE L AH JH AH N EY T IH D
NONHOMOGENEOUS	N AA N HH OW M AH JH IY N IY AH S
NONIMAGE	N AA N IH M IH JH
NONINDIGENOUS	N AA N IH N D IH JH AH N AH S
NONINTERCHANGEABLE	N AA N IH N T ER CH EY N JH AH B AH L
NONLANGUAGE	N AA N L AE NG G W IH JH
NONLANGUAGES	N AA N L AE NG G W IH JH IH Z
NONMANAGEMENT	N AA N M AE N IH JH M AH N T
NONMANAGEMENTS	N AA N M AE N IH JH M AH N T S
NONMANAGERIAL	N AA N M AE N AH JH IH R IY AH L
NONNEGLIGENT	N AA N EH G L IH JH AH N T
NONNITROGENOUS	N AA N AY T R AH JH AH N AH S
NONPATHOGENIC	N AA N P AE TH AH JH EH N IH K
NONTARGET	N AA N T AA R G AH T
NONURGENT	N AA N ER JH AH N T
NONVEGETARIAN	N AA N V EH JH AH T EH R IY AH N
NONVEGETARIANS	N AA N V EH JH AH T EH R IY AH N Z
NONVINTAGE	N AA N V IH N T IH JH
NOODGE	N UW JH
NOODGED	N UW JH D
NOODGES	N UW JH AH Z
NUDGE	N AH JH
NUDGED	N AH JH D
NUDGER	N AH JH ER
NUDGERS	N AH JH ER Z
NUDGES	N AH JH IH Z
NUGGET	N AH G IH T
NUGGETS	N AH G AH T S
NUGGETY	N AH G AH T IY
NUTSEDGE	N AH T S EH JH
NUTSEDGES	N AH T S EH JH IH Z
OBLIGE	AH B L AY JH
OBLIGED	AH B L AY JH D
OBLIGEE	AH B L AY JH IY
OBLIGEES	AH B L AY JH IY Z
OBLIGER	AH B L AY JH ER
OBLIGERS	AH B L AY JH ER Z
OBLIGES	AH B L AY JH IH Z
OCTOGENARIAN	AA K T AH JH IH N EH R IY AH N
OCTOGENARIANS	AA K T AH JH AH N AE R IY AH N Z
OFFSTAGE	AO F S T EY JH
OFFSTAGES	AO F S T EY JH IH Z
OGEE	OW JH IY IY
OGEES	OW JH IY Z
OHMAGE	AA M AH JH
OHMAGES	AA M AH JH AH Z
OMNIRANGE	AA M N AH R AH N JH
OMNIRANGES	AA M N AH R AE N JH AH Z
ONAGER	AO N IH JH ER
ONAGERS	AA N AH JH ER Z
ONCOGENE	AA NG K OW JH IY N
ONCOGENES	AA NG K AA JH EH N IY S
ONCOGENESES	AO N K OW JH IY N Z IH Z
ONCOGENESIS	AO N K OW JH EH N AH S AH S
ONCOGENIC	AO N K OW JH AH N IH K
ONCOGENICITIES	AO N K OW JH AH N IH K S AH T IY Z
ONCOGENICITY	AO N K OW JH AH N IH K S AH T IY
ONSTAGE	AA N S T EY JH
ONTOGENESES	AA N T AA JH AH N IY Z AH Z
ONTOGENESIS	AA N T AH JH IY N AH S AH S
ONTOGENETIC	AA N T AA JH AH N AH T AH K
ONTOGENETICALLY	AA N T AH JH AH N EH T AH K AE L IY
ONTOGENIES	AO N T AA G AH N IY Z
ONTOGENY	AA N T AA JH AH N IY
OOGENESES	UW JH AH N IY Z AH Z
OOGENESIS	UW JH IY N AH S AH S
OOGENETIC	UW JH AH N AH T AH K
OOGENIES	UW JH AH N AY Z
OOGENY	UW JH AH N IY
ORANGE	AO R AH N JH
ORANGE(2)	AO R IH N JH
ORANGEADE	AO R IH N JH EY D
ORANGEADES	AO R IH N JH EY D Z
ORANGERIE	AO R IH N JH ER IY
ORANGERIES	AO R IH N JH AH R IY Z
ORANGERY	AO R IH N JH AH R IY
ORANGES	AO R AH N JH AH Z
ORANGES(2)	AO R IH N JH IH Z
ORANGEWOOD	AO R IH N JH W UH D
ORANGEWOODS	AO R IH N JH W UH D Z
ORANGEY	AO R IH N JH IY
ORGANOGENESES	AO R G AH N AA JH AH N IY Z AH Z
ORGANOGENESIS	AO R G AH N OW JH EH N AH S IH S
ORGANOGENETIC	AO R G AH N AA JH AH N AH T AH K
ORGEAT	AO R JH IY T
ORGEATS	AO R JH IY EY T S
OROGENESES	AH R AA JH AH N IY Z AH Z
OROGENESIS	AO R AH JH IY N AH S AH S
OROGENETIC	AH R AA JH AH N AH T AH K
OROGENIC	AO R AH JH EH N IH K
OROGENIES	AH R AA JH AH N AY Z
OROGENY	AH R AA JH AH N IY
OROPHARYNGEAL	AH R AA F AH R IH N JH IY AH L
OROPHARYNGES	AH R AA F AH R IH N JH AH Z
ORPHANAGE	AO R F AH N AH JH
ORPHANAGES	AO R F AH N IH JH IH Z
ORTHOGENESES	AO R TH AA JH AH N IY Z AH Z
ORTHOGENESIS	AO R TH AH JH IY N AH S AH S
ORTHOGENETIC	AO R TH AA JH AH N AH T AH K
ORTHOGENETICALLY	AO R TH AH JH AH N EH T AH K AE L IY
OSSIFRAGE	AA S IH F R AH JH
OSSIFRAGES	AA S IH F R AH JH AH Z
OSTEOGENESES	AA S T IY AA JH AH N IY Z AH Z
OSTEOGENESIS	AA S T IY AH JH IY N AH S AH S
OSTEOGENIC	AA S T IY AH JH AH N AH K
OUTAGE	AW T AH JH
OUTAGE(2)	AW T IH JH
OUTAGES	AW T IH JH IH Z
OUTBEGGED	AW T B EH G D
OUTBRAGGED	AW T B R AE G D
OUTCHARGE	AW T CH AA R JH
OUTCHARGED	AW T CH AA R JH D
OUTCHARGES	AW T CH AA R JH IH Z
OUTDODGE	AW T D AA JH
OUTDODGED	AW T D AA JH D
OUTDODGES	AW T D AA JH IH Z
OUTDRAGGED	AW T D R AE G D
OUTGENERAL	AW T JH EH N ER AH L
OUTGENERALED	AW T JH EH N ER AH L D
OUTGENERALING	AW T JH EH N ER AH L IH NG
OUTGENERALS	AW T JH EH N ER AH L Z
OUTRAGE	AW T R EY JH
OUTRAGED	AW T R EY JH D
OUTRAGEOUS	AW T R EY JH AH S
OUTRAGEOUSLY	AW T R EY JH AH S L IY
OUTRAGEOUSNESS	AW T R EY JH AH S N AH S
OUTRAGEOUSNESSES	AW T R EY JH AH S N AH S IH Z
OUTRAGES	AW T R EY JH IH Z
OUTRANGE	AW T R EY N JH
OUTRANGED	AW T R EY N JH D
OUTRANGES	AW T R EY N JH IH Z
OUTRIGGER	AW T R IH G ER
OUTRIGGERS	AW T R IH G ER Z
OVERAGE	OW V ER EY JH
OVERAGED	OW V ER EY JH D
OVERAGES	OW V ER EY JH IH Z
OVERARRANGE	OW V ER AH R EY N JH
OVERARRANGED	OW V ER AH R EY N JH D
OVERARRANGES	OW V ER AH R EY N JH IH Z
OVERCHARGE	OW V ER CH AA R JH
OVERCHARGED	OW V ER CH AA R JH D
OVERCHARGES	OW V ER CH AA R JH IH Z
OVERDOSAGE	OW V ER D OW S IH JH
OVERDOSAGES	OW V ER D OW S IH JH IH Z
OVEREAGER	OW V ER IY G ER
OVEREAGERNESS	OW V ER IY G ER N AH S
OVEREAGERNESSES	OW V ER IY G ER N AH S IH Z
OVERENCOURAGE	OW V ER AH N K ER IH JH
OVERENCOURAGED	OW V ER AH N K ER IH JH D
OVERENCOURAGES	OW V ER AH N K ER IH JH IH Z
OVERENERGETIC	OW V ER EH N ER JH EH T IH K
OVEREXAGGERATE	OW V ER IH G Z AE JH ER AH T
OVEREXAGGERATED	OW V ER IH G Z AE JH ER EY T IH D
OVEREXAGGERATES	OW V ER IH G Z AE JH ER AH T S
OVEREXAGGERATING	OW V ER IH G Z AE JH ER EY T IH NG
OVEREXAGGERATION	OW V ER IH G Z AE JH ER EY SH AH N
OVEREXAGGERATIONS	OW V ER IH G Z AE JH ER EY SH AH N Z
OVERGENERALIZATION	OW V ER JH EH N ER AH L AH Z EY SH AH N
OVERGENERALIZATIONS	OW V ER JH EH N ER AH L AH Z EY SH AH N Z
OVERGENERALIZE	OW V ER JH EH N ER AH L AY Z
OVERGENERALIZED	OW V ER JH EH N ER AH L AY Z D
OVERGENERALIZES	OW V ER JH EH N ER AH L AY Z IH Z
OVERGENERALIZING	OW V ER JH EH N ER AH L AY Z IH NG
OVERGENEROSITIES	OW V ER JH EH N AH R AA S AH T IY Z
OVERGENEROSITY	OW V ER JH EH N AH R AA S AH T IY
OVERGENEROUS	OW V ER JH EH N ER AH S
OVERGENEROUSLY	OW V ER JH EH N ER AH S L IY
OVERHOMOGENIZE	OW V ER HH OW M AA JH AH N AY Z
OVERHOMOGENIZED	OW V ER HH OW M AA JH AH N AY Z D
OVERHOMOGENIZES	OW V ER HH OW M AA JH AH N AY Z IH Z
OVERHOMOGENIZING	OW V ER HH OW M AA JH AH N AY Z IH NG
OVERINDULGE	OW V ER IH N D AH L JH
OVERINDULGED	OW V ER IH N D AH L JH D
OVERINDULGENCE	OW V ER IH N D AH L JH AH N S
OVERINDULGENCES	OW V ER IH N D AH L JH AH N S IH Z
OVERINDULGENT	OW V ER IH N D AH L JH AH N T
OVERINDULGES	OW V ER IH N D AH L JH IH Z
OVERINGENIOUS	OW V ER IH N JH IY N Y AH S
OVERINGENUITIES	OW V ER IH N JH AH N UW AH T IY Z
OVERINGENUITY	OW V ER IH N JH AH N UW AH T IY
OVERLARGE	OW V ER L AA R JH
OVERMANAGE	OW V ER M AE N IH JH
OVERMANAGED	OW V ER M AE N IH JH D
OVERMANAGES	OW V ER M AE N IH JH IH Z
OVERPACKAGE	OW V ER P AE S IH JH
OVERPACKAGED	OW V ER P AE S IH JH D
OVERPACKAGES	OW V ER P AE S IH JH IH Z
OVERPRIVILEGED	OW V ER P R IH V L IH JH D
OVERURGE	OW V ER ER JH
OVERURGED	OW V ER ER JH D
OVERURGES	OW V ER ER JH IH Z
OVERVOLTAGE	OW V ER V OW L T IH JH
OVERVOLTAGES	OW V ER V OW L T IH JH IH Z
OVOLACTOVEGETARIAN	AA V AH L AH K T AA V AH JH AH T EH R IY AH N
OVOLACTOVEGETARIANS	AH V AH L AH K T AA V AH JH AH T AE R IY AH N Z
OXYGEN	AA K S AH JH AH N
OXYGEN(2)	AA K S IH JH AH N
OXYGENATE	AA K S AH JH AH N EY T
OXYGENATED	AA K S AH JH AH N EY T AH D
OXYGENATES	AA K S IH JH AH N AH T S
OXYGENATING	AA K S IH JH AH N EY T IH NG
OXYGENATION	AA K S IH JH AH N EY SH AH N
OXYGENATIONS	AA K S IH JH AH N EY SH AH N Z
OXYGENATOR	AA K S IH JH AH N AH T ER
OXYGENATORS	AA K S IH JH AH N AH T ER Z
OXYGENIC	AA K S IH JH AH N IH K
OXYGENLESS	AA K S IH JH AH N L AH S
OXYGENS	AA K S IH JH AH N Z
OXYHYDROGEN	AA K S IY HH AY D R AH JH AH N
PACKAGE	P AE K AH JH
PACKAGE(2)	P AE K IH JH
PACKAGED	P AE K IH JH D
PACKAGER	P AE K IH JH ER
PACKAGERS	P AE K IH JH ER Z
PACKAGES	P AE K AH JH AH Z
PACKAGES(2)	P AE K IH JH IH Z
PAEDOGENESES	P IY D AA JH AH N IY Z AH Z
PAEDOGENESIS	P IY D AH JH IY N AH S AH S
PAEDOGENETIC	P IY D AA JH AH N AH T AH K
PAEDOGENETICALLY	P IY D AH JH AH N EH T AH K AE L IY
PAEDOGENIC	P IY D AH JH AH N AH K
PAGE	P EY JH
PAGEANT	P AE JH AH N T
PAGEANTRIES	P AE JH AH N T R IY Z
PAGEANTRY	P AE JH AH N T R IY
PAGEANTS	P AE JH AH N T S
PAGEBOY	P EY JH B OY
PAGEBOYS	P EY JH B OY Z
PAGED	P EY JH D
PAGER	P EY JH ER
PAGERS	P EY JH ER Z
PAGES	P EY JH AH Z
PAGES(2)	P EY JH IH Z
PALEOGEOGRAPHIC	P EY L IY OW JH IY AA G R AH F AH K
PALEOGEOGRAPHICAL	P EY L IY OW JH IY AA G R AH F IH S AH L
PALEOGEOGRAPHICALLY	P EY L IY OW JH IY AA G R AE F AH K AE L IY
PALEOGEOGRAPHIES	P EY L IY OW JH IY AA G R AH F AY Z
PALEOGEOGRAPHY	P EY L IY OW JH IY AA G R AH F IY
PALINGENESES	P AE L IH N JH IY N Z IH Z
PALINGENESIS	P AE L IH N JH EH N AH S AH S
PALINGENETIC	P AE L IH N JH AH N EH T IH K
PANGED	P AE NG D
PANGEN	P AE NG AH N
PANGENE	P AE N JH IY N
PANGENES	P AE N JH IY N Z
PANGENESES	P AE N JH IY N Z IH Z
PANGENESIS	P AE N JH EH N AH S AH S
PANGENETIC	P AE N JH AH N EH T IH K
PANGENS	P AE NG AH N Z
PAPERHANGER	P EY P ER HH AE NG ER
PAPERHANGERS	P EY P ER HH AE NG ER Z
PARAGENESES	P AA R AH JH IY N Z IH Z
PARAGENESIS	P AA R AH JH EH N AH S AH S
PARAGENETIC	P AA R EY JH N EH T IH K
PARAGENETICALLY	P AA R EY JH N EH T IH K AH L IY
PARAGOGE	P AE R AH G OW JH
PARAGOGES	P AE R AH G OW JH AH Z
PARALANGUAGE	P AA R AH L AE NG G W IH JH
PARALANGUAGES	P AA R AH L AE NG G W IH JH IH Z
PARENTAGE	P EH R AH N T AH JH
PARENTAGES	P AE R AH N T IH JH IH Z
PARGE	P AA R JH
PARGED	P AA R JH D
PARGES	P AA R JH AH Z
PARGET	P AA R G EH T
PARGETED	P AA R G EH T IH D
PARGETING	P AA R G EH T IH NG
PARGETS	P AA R G EH T S
PARGETTED	P AA R G EH T IH D
PARGETTING	P AA R G EH T IH NG
PARRIDGE	P AA R IH JH
PARRIDGES	P AA R IH JH IH Z
PARSONAGE	P AA R S AH N IH JH
PARSONAGES	P AA R S AH N IH JH AH Z
PARTHENOGENESES	P AA R TH AH N AA JH AH N IY Z AH Z
PARTHENOGENESIS	P AA R TH AH N AH JH IY N AH S AH S
PARTHENOGENETIC	P AA R TH AH N OW JH AH N EH T IH K
PARTHENOGENETICALLY	P AA R TH EH N AH JH AH N EH T AH K AE L IY
PARTRIDGE	P AA R T R AH JH
PARTRIDGE(2)	P AA R T R IH JH
PARTRIDGEBERRIES	P AA R T R IH JH B EH R IY Z
PARTRIDGEBERRY	P AA R T R IH JH B EH R IY
PARTRIDGES	P AA R T R IH JH IH Z
PASSAGE	P AE S AH JH
PASSAGE(2)	P AE S IH JH
PASSAGED	P AE S IH JH D
PASSAGES	P AE S AH JH AH Z
PASSAGES(2)	P AE S IH JH IH Z
PASSAGEWAY	P AE S AH JH W EY
PASSAGEWAY(2)	P AE S IH JH W EY
PASSAGEWAYS	P AE S IH JH W EY Z
PASSAGEWORK	P AE S IH JH W ER K
PASSAGEWORKS	P AE S IH JH W ER K S
PASSENGER	P AE S AH N JH ER
PASSENGERS	P AE S AH N JH ER Z
PASTURAGE	P AE S CH ER IH JH
PASTURAGES	P AE S CH ER IH JH IH Z
PATHOGEN	P AE TH AH JH AH N
PATHOGENESES	P AH TH AA JH AH N IY Z AH Z
PATHOGENESIS	P AE TH AH JH EH N AH S AH S
PATHOGENETIC	P AH TH AA JH AH N AH T AH K
PATHOGENIC	P AE TH AH JH EH N IH K
PATHOGENICITIES	P AE TH AH JH EH N IH K AH T IY Z
PATHOGENICITY	P AE TH AH JH EH N IH K AH T IY
PATHOGENS	P AE TH AH JH AH N Z
PATRONAGE	P AE T R AH N IH JH
PATRONAGE(2)	P EY T R AH N AH JH
PATRONAGE(3)	P EY T R AH N IH JH
PATRONAGES	P EY T R AH N IH JH IH Z
PAWNAGE	P AO N IH JH
PAWNAGES	P AO N IH JH IH Z
PEAGE	P IY AH JH
PEAGES	P IY AH JH AH Z
PEDOGENESES	P AH D AA JH AH N IY Z AH Z
PEDOGENESIS	P EH D AH JH IY N AH S AH S
PEDOGENETIC	P AH D AA JH AH N AH T AH K
PEDOGENIC	P EH D AH JH AH N AH K
PEERAGE	P IH R AH JH
PEERAGES	P IH ER IH JH IH Z
PEGGED	P EH G D
PELAGE	P IY L AH JH
PELAGES	P IY L AH JH AH Z
PEONAGE	P IY AH N AH JH
PEONAGES	P IY AA N AH JH AH Z
PEPSINOGEN	P EH P S IH N AH JH AH N
PEPSINOGENS	P EH P S IH N AH JH AH N Z
PERCENTAGE	P ER S EH N T AH JH
PERCENTAGE(2)	P ER S EH N AH JH
PERCENTAGE(3)	P ER S EH N T IH JH
PERCENTAGE(4)	P ER S EH N IH JH
PERCENTAGES	P ER S EH N T IH JH IH Z
PERCENTAGES(2)	P ER S EH N IH JH IH Z
PERIGEAL	P AH R IH JH IY AH L
PERIGEAN	P AH R AY JH IY AH N
PERIGEE	P AH R AH JH IY IY
PERIGEES	P AH R AH JH IY Z
PERIWIGGED	P AH R IH W AH G D
PERMILLAGE	P ER M IH L IH JH
PERMILLAGES	P ER M IH L IH JH IH Z
PERSIFLAGE	P ER S IH F L AA ZH
PERSIFLAGES	P ER S IH F L AA ZH IH Z
PERSONAGE	P ER S AH N IH JH
PERSONAGES	P ER S AH N IH JH IH Z
PETROGENESES	P EH T R AA JH AH N IY Z AH Z
PETROGENESIS	P EH T R AH JH IY N AH S AH S
PETROGENETIC	P EH T R AA JH AH N AH T AH K
PETTIFOGGED	P EH T AH F AH G D
PETTIFOGGER	P EH T AH F AA G AH R
PETTIFOGGERIES	P EH T AH F AA JH AH R AY Z
PETTIFOGGERS	P EH T AH F AA JH AH R Z
PETTIFOGGERY	P EH T AH F AH G EH R IY
PFENNIGE	F EH N AY JH
PHAGE	F EY JH
PHAGES	F EY JH AH Z
PHALANGE	F AH L AE N JH
PHALANGE(2)	F AH L EY N JH
PHALANGEAL	F AH L AE N JH IY AH L
PHALANGER	F AE L AH NG AH R
PHALANGERS	F AH L AE N JH AH R Z
PHALANGES	F AH L AE N JH IY Z
PHALANGES(2)	F AH L EY N JH IH Z
PHARYNGEAL	F AH R IH N JH IY AH L
PHARYNGES	F AH R IH N JH AH Z
PHELLOGEN	F EH L AH JH AH N
PHELLOGENS	F EH L AH JH AH N Z
PHILOPROGENITIVE	F AH L AA P R AH JH EH N AH T AH V
PHILOPROGENITIVENESS	F AH L AH P R AH JH EH N AH T AY V N AH S
PHILOPROGENITIVENESSES	F AH L AH P R AA JH AH N AH T IH V AH N EH S AH Z
PHOSGENE	F AA Z JH IY N
PHOSGENES	F AA Z JH IY N Z
PHOTOGENIC	F OW T AH JH EH N IH K
PHOTOGENICALLY	F OW T AH JH EH N IH K AH L IY
PHOTOGEOLOGIC	F OW T OW JH IY AH L AA JH IH K
PHOTOGEOLOGICAL	F OW T OW JH IY AH L AA JH IH K AH L
PHOTOGEOLOGIES	F OW T OW JH IY AA L AH JH IY Z
PHOTOGEOLOGIST	F AA T AH JH IY AA L AH JH AH S T
PHOTOGEOLOGISTS	F AH T OW JH IY AA L AH JH AH S T S
OBCONIC	AA B K AH N AH K
TEKTITE	T EH K T AY T
AUBADE	AH B EY D
FRABJOUS	F R AE B AH S
EACH	IY CH
ROACH	R OW CH
LETHAL	L IY TH AH L
