KE	K EH
ACKEE	AE K IY IY
ACKEES	AE K IY Z
ADOBELIKE	AH D OW B IY L AY K
ADULTLIKE	AH D AH L T L AY K
AEROBRAKE	EH R AH B R EY K
AEROBRAKED	EH R AH B R EY K T
AEROBRAKES	EH R AH B R EY K S
AFTERMARKET	AE F T ER M AA R K IH T
AFTERMARKETS	AE F T ER M AA R K IH T S
AGUELIKE	EY G Y UW L AY K
AIRLIKE	EH R L AY K
AIRSTRIKE	EH R S T R AY K
AIRSTRIKES	EH R S T R AY K S
AKEE	EY K IY IY
AKEES	EY K IY Z
AKELA	AE K AH L AH
AKELAS	AE K AH L AH Z
AKENE	AH K IY N
AKENES	AH K IY N Z
ALIKE	AH L AY K
ALIKENESS	AH L AY K N AH S
ALIKENESSES	AH L AY K N AH S IH Z
ALKENE	AE L K IY N
ALKENES	AE L K IY N Z
ALSIKE	AE L S AY K
ALSIKES	AE L S AY K S
ANANKE	AE N AH NG K
ANANKES	AE N AH NG K S
ANIMALLIKE	AE N AH M AH L AY K
ANKERITE	AE NG K AH R AY T
ANKERITES	AE NG K AH R AY T S
ANTICKED	AE N T IH K T
ANTILEUKEMIC	AE N T AH L UW K AH M AH K
ANTIMARKET	AE N T AY M AA R K AH T
ANTINUKE	AE N T AY N Y UW K
ANTIRACKETEERING	AE N T AY R AE K AH T IH R IH NG
ANTISMOKE	AE N T AY S M OW K
ANTISMOKER	AE N T AY S M OW K ER
ANTISMOKERS	AE N T AY S M OW K ER Z
ANTISTRIKE	AE N T AY S T R AY K
ANTITAKEOVER	AE N T IY T EY K OW V ER
ANTLIKE	AE N T L AY K
APELIKE	EY P L AY K
ARCHDUKE	AA R CH D UW K
ARCHDUKEDOM	AA R CH D UW K D AH M
ARCHDUKEDOMS	AA R CH D UW K D AH M Z
ARCHDUKES	AA R CH D UW K S
ARCKED	AA R K T
ARMLIKE	AA R M L AY K
ARTICHOKE	AA R T IH CH OW K
ARTICHOKES	AA R T IH CH OW K S
ASKED	AE S K T
ASKED(2)	AE S T
ASKER	AE S K ER
ASKERS	AE S K ER Z
ASKESES	AE S IY Z AH Z
ASKESIS	AE S AH S AH S
ASKEW	AH S K Y UW
ASKEWNESS	AH S K Y UW N AH S
ASKEWNESSES	AH S K Y UW N AH S IH Z
ASSLIKE	AE S L AY K
ASTERISKED	AE S T AH R IH S K T
ATTACKED	AH T AE K T
ATTACKER	AH T AE K ER
ATTACKERS	AH T AE K ER Z
AUNTLIKE	AE N T L AY K
AUTOMAKER	AO T OW M EY K ER
AUTOMAKERS	AO T OW M EY K ER Z
AUTOWORKER	AO T OW W ER K ER
AUTOWORKERS	AO T OW W ER K ER Z
AWAKE	AH W EY K
AWAKED	AH W EY K T
AWAKEN	AH W EY K AH N
AWAKENED	AH W EY K AH N D
AWAKENER	AH W EY K AH N ER
AWAKENERS	AH W EY K AH N ER Z
AWAKENING	AH W EY K AH N IH NG
AWAKENS	AH W EY K AH N Z
AWAKES	AH W EY K S
AWESTRICKEN	AO S T R IH K AH N
AWOKE	AH W OW K
AWOKEN	AH W OW K AH N
AXLIKE	AE K S L AY K
BACKBREAKER	B AE K B R EY K ER
BACKBREAKERS	B AE K B R EY K ER Z
BACKED	B AE K T
BACKER	B AE K ER
BACKERS	B AE K ER Z
BACKPACKED	B AE K P AE K T
BACKPACKER	B AE K P AE K ER
BACKPACKERS	B AE K P AE S ER Z
BACKSTROKE	B AE K S T R OW K
BACKSTROKES	B AE K S T R OW K S
BACKTRACKED	B AE K T R AE K T
BAKE	B EY K
BAKED	B EY K T
BAKEMEAT	B EY K M IY T
BAKEMEATS	B EY K M IY T S
BAKER	B EY K ER
BAKERIES	B EY K ER IY Z
BAKERS	B EY K ER Z
BAKERY	B EY K ER IY
BAKES	B EY K S
BAKESHOP	B EY K SH AA P
BAKESHOPS	B EY K SH AA P S
BALKED	B AO K T
BALKER	B AO K ER
BALKERS	B AO K ER Z
BALMLIKE	B AA M L AY K
BANKED	B AE NG K T
BANKER	B AE NG K ER
BANKERLY	B AE NG K ER L IY
BANKERS	B AE NG K ER Z
BAREBACKED	B EH R B AE K T
BARKED	B AA R K T
BARKEEP	B AA R K IY P
BARKEEPER	B AA R K IY P ER
BARKEEPERS	B AA R K IY P ER Z
BARKEEPS	B AA R K IY P S
BARKENTINE	B AA R K EH N T AY N
BARKENTINES	B AA R K EH N T AY N Z
BARKER	B AA R K ER
BARKERS	B AA R K ER Z
BARNLIKE	B AA R N L AY K
BARRACKED	B AE R AH K T
BARRACKER	B AE R AH K ER
BARRACKERS	B AE R AH K ER Z
BASKED	B AE S K T
BASKET	B AE S K AH T
BASKETBALL	B AE S K AH T B AO L
BASKETBALLS	B AE S K AH T B AO L Z
BASKETFUL	B AE S K AH T F AH L
BASKETFULS	B AE S K AH T F AH L Z
BASKETLIKE	B AE S K AH T L AY K
BASKETRIES	B AE S K AH T R IY Z
BASKETRY	B AE S K AH T R IY
BASKETS	B AE S K AH T S
BASKETSFUL	B AE S K AH T S F AH L
BASKETWORK	B AE S K AH T W ER K
BASKETWORKS	B AE S K AH T W ER K S
BATLIKE	B AE T L AY K
BAULKED	B AO K T
BEADLIKE	B IY D L AY K
BEAKED	B AH EY K T
BEAKER	B IY K ER
BEAKERS	B IY K ER Z
BEAKLIKE	B IY K L AY K
BEAMLIKE	B IY M L AY K
BEANLIKE	B IY N L AY K
BEARLIKE	B AE ER L AY K
BECHALKED	B IH CH AO K T
BECKED	B EH K T
BECKET	B EH K AH T
BECKETS	B EH K AH T S
BECLOAKED	B IH K L OW K T
BEDARKEN	B IH D AA R K AH N
BEDARKENED	B IH D AA R K AH N D
BEDARKENING	B IH D AA R K AH N IH NG
BEDARKENS	B IH D AA R K AH N Z
BEDECKED	B IH D EH K T
BEDLIKE	B EH D L AY K
BEDMAKER	B EH D M EY K ER
BEDMAKERS	B EH D M EY K ER Z
BEEFCAKE	B IY F K EY K
BEEFCAKES	B IY F K EY K S
BEEKEEPER	B IY K IY P ER
BEEKEEPERS	B IY K IY P ER Z
BEEKEEPING	B IY K IY P IH NG
BEEKEEPINGS	B IY K IY P IH NG Z
BEELIKE	B IY L AY K
BEFLECKED	B IH F L EH K T
BELIKE	B IH L AY K
BEMOCKED	B IH M AA K T
BERAKE	B IH R EY K
BERAKED	B IH R EY K T
BERAKES	B IH R EY K S
BERKELIUM	B IH R K IY L IY AH M
BERKELIUMS	B IH R K IY L IY AH M Z
BERRYLIKE	B EH R IY L AY K
BERSERKER	B IH R S AH R K AH R
BERSERKERS	B IH R S AH R K AH R Z
BESMOKE	B IH S M OW K
BESMOKED	B IH S M OW K T
BESMOKES	B IH S M OW K S
BESPAKE	B IH S EY K
BESPOKE	B IH S P OW K
BESPOKEN	B IH S P OW K AH N
BETAKE	B IY T EY K
BETAKEN	B IH T EY K AH N
BETAKES	B IH T EY K S
BETHANKED	B IH TH AE NG K T
BETOKEN	B IH T OW K AH N
BETOKENED	B IH T OW K AH N D
BETOKENING	B IH T OW K AH N IH NG
BETOKENS	B IH T OW K AH N Z
BEWHISKERED	B IH W IH S K ER D
BIBLIKE	B IH B L AY K
BICKER	B IH K ER
BICKERED	B IH K ER D
BICKERER	B IH K ER ER
BICKERERS	B IH K ER ER Z
BICKERING	B IH K ER IH NG
BICKERS	B IH K ER Z
BIDARKEE	B AY D AA R K IY
BIDARKEES	B AY D AA R K IY Z
BIFORKED	B AY F AO R K T
BIKE	B AY K
BIKED	B AY K T
BIKER	B AY K ER
BIKERS	B AY K ER Z
BIKES	B AY K S
BIKEWAY	B AY K Y UW EY IY
BIKEWAYS	B AY K Y UW EY Z
BILKED	B IH L K T
BILKER	B IH L K ER
BILKERS	B IH L K ER Z
BIOMARKER	B AY AH M AA R K AH R
BIOMARKERS	B AY AH M AA R K AH R Z
BIRDLIKE	B ER D L AY K
BIVOUACKED	B IH V AH W AE K T
BLACKED	B L AE K T
BLACKEN	B L AE K AH N
BLACKENED	B L AE K AH N D
BLACKENER	B L AE K AH N ER
BLACKENERS	B L AE K AH N ER Z
BLACKENING	B L AE K AH N IH NG
BLACKENING(2)	B L AE K N IH NG
BLACKENINGS	B L AE K AH N IH NG Z
BLACKENS	B L AE K AH N Z
BLACKER	B L AE K ER
BLACKEST	B L AE K AH S T
BLACKJACKED	B L AE K JH AE K T
BLACKSNAKE	B L AE K S N EY K
BLACKSNAKES	B L AE K S N EY K S
BLADDERLIKE	B L AE D ER L AY K
BLADELIKE	B L EY D L AY K
BLANKED	B L AE NG K T
BLANKER	B L AE NG K ER
BLANKEST	B L AE NG K AH S T
BLANKET	B L AE NG K AH T
BLANKET(2)	B L AE NG K IH T
BLANKETED	B L AE NG K AH T IH D
BLANKETFLOWER	B L AE NG K AH T F L AW ER
BLANKETFLOWERS	B L AE NG K AH T F L AW ER Z
BLANKETING	B L AE NG K AH T IH NG
BLANKETLIKE	B L AE NG K AH T L AY K
BLANKETS	B L AE NG K AH T S
BLEAKER	B L IY K ER
BLEAKEST	B L IY K AH S T
BLINKED	B L IH NG K T
BLINKER	B L IH NG K ER
BLINKERED	B L IH NG K ER D
BLINKERING	B L IH NG K ER IH NG
BLINKERS	B L IH NG K ER Z
BLOCKED	B L AA K T
BLOCKER	B L AA K ER
BLOCKERS	B L AA K ER Z
BLOKE	B L OW K
BLOKES	B L OW K S
BLOODSUCKER	B L AH D S AH K ER
BLOODSUCKERS	B L AH D S AH K ER Z
BLUEJACKET	B L UW JH AE K AH T
BLUEJACKETS	B L UW JH AE K AH T S
BOARDLIKE	B OW R D L AY K
BOATLIKE	B OW T L AY K
BODYCHECKED	B AA D IY CH EH K T
BOILERMAKER	B OY L ER M EY K ER
BOILERMAKERS	B OY L ER M EY K ER Z
BONKED	B AO NG K T
BONKERS	B AA NG K ER Z
BOOKED	B UH K T
BOOKEND	B UH K EH N D
BOOKENDS	B UH K EH N D Z
BOOKER	B UH K ER
BOOKERS	B UH K ER Z
BOOKKEEPER	B UH K K IY P ER
BOOKKEEPERS	B UH K K IY P ER Z
BOOKKEEPING	B UH K K IY P IH NG
BOOKKEEPINGS	B UH K IY P IH NG Z
BOOKMAKER	B UH K M EY K ER
BOOKMAKERS	B UH K M EY K ER Z
BOOKMARKED	B UH K M AA R K T
BOOKMARKER	B UH K M AA R K ER
BOOKMARKERS	B UH K M AA R K ER Z
BOOTLICKED	B UW T L IH K T
BOOTLICKER	B UW T L IH K ER
BOOTLICKERS	B UW T L IH K ER Z
BOSKER	B AA S AH R
BOSKET	B AA S AH T
BOSKETS	B AA S AH T S
BOTTLENECKED	B AA T AH L N EH K T
BOWLIKE	B AW L AY K
BOWLLIKE	B OW L AY K
BOXLIKE	B AA K S L AY K
BRACKEN	B R AE K AH N
BRACKENS	B R AE K AH N Z
BRACKET	B R AE K IH T
BRACKETED	B R AE K AH T IH D
BRACKETING	B R AE K AH T IH NG
BRACKETS	B R AE K AH T S
BRACKETS(2)	B R AE K IH T S
BRAKE	B R EY K
BRAKEAGE	B R EY K IH JH
BRAKEAGES	B R EY K IH JH IH Z
BRAKED	B R EY K T
BRAKELESS	B R EY K L AH S
BRAKEMAN	B R EY K M AH N
BRAKEMEN	B R EY K M EH N
BRAKES	B R EY K S
BREADBASKET	B R EH D B AE S K AH T
BREADBASKETS	B R EH D B AE S K AH T S
BREAKER	B R EY K ER
BREAKERS	B R EY K ER Z
BREAKEVEN	B R EY K IY V AH N
BREAKEVENS	B R EY K IY V AH N Z
BREASTSTROKE	B R EH S T S T R OW K
BREASTSTROKER	B R EH S T S T R OW K ER
BREASTSTROKERS	B R EH S T S T R OW K ER Z
BREASTSTROKES	B R EH S T S T R OW K S
BRICKED	B R IH K T
BRISKED	B R IH S K T
BRISKER	B R IH S K ER
BRISKEST	B R IH S K AH S T
BRISKET	B R IH S K AH T
BRISKETS	B R IH S AH T S
BRISTLELIKE	B R IH S AH L AY K
BROCKET	B R AA K AH T
BROCKETS	B R AA K AH T S
BROKE	B R OW K
BROKEN	B R OW K AH N
BROKENHEARTED	B R OW K AH N HH AA R T IH D
BROKENLY	B R OW K AH N L IY
BROKENNESS	B R OW K AH N AH S
BROKENNESSES	B R OW K AH N AH S IH Z
BROKER	B R OW K ER
BROKERAGE	B R OW K ER IH JH
BROKERAGE(2)	B R OW K R IH JH
BROKERAGES	B R OW K ER IH JH IH Z
BROKERAGES(2)	B R OW K R IH JH IH Z
BROKERED	B R OW K ER D
BROKERING	B R OW K ER IH NG
BROKERINGS	B R OW K ER IH NG Z
BROKERS	B R OW K ER Z
BROOKED	B R UH K T
BRUSKER	B R AH S AH R
BRUSKEST	B R AH S AH S T
BUCKED	B AH K T
BUCKEEN	B AH K IY AH N
BUCKEENS	B AH K IY N Z
BUCKER	B AH K ER
BUCKEROO	B AH K AH R UW
BUCKEROOS	B AH K AH R UW Z
BUCKERS	B AH K ER Z
BUCKET	B AH K IH T
BUCKETED	B AH K AH T IH D
BUCKETFUL	B AH K AH T F AH L
BUCKETFULS	B AH K AH T F AH L Z
BUCKETING	B AH K AH T IH NG
BUCKETS	B AH K AH T S
BUCKETSFUL	B AH K AH T S F AH L
BUCKEYE	B AH K AY
BUCKEYES	B AH K AY Z
BUDLIKE	B AH D L AY K
BULKED	B AH L K T
BULLNECKED	B UH L N EH K T
BULWARKED	B UH L W ER K T
BUNKED	B AH NG K T
BUNKER	B AH NG K ER
BUNKERED	B AH NG K ER D
BUNKERING	B AH NG K ER IH NG
BUNKERS	B AH NG K ER Z
BURKE	B ER K
BURKED	B ER K T
BURKER	B ER K ER
BURKERS	B ER K ER Z
BURKES	B ER K S
BUSHLIKE	B UH SH L AY K
BUSHWHACKED	B UH SH W AE K T
BUSHWHACKER	B UH SH W AE K ER
BUSHWHACKERS	B UH SH W AE K ER Z
BUSINESSLIKE	B IH Z N IH S L AY K
BUSKED	B AH S T
BUSKER	B AH S K ER
BUSKERS	B AH S AH R Z
BUTTONHOOKED	B AH T AH N HH UH K T
CABINETMAKER	K AE B N AH T M EY K ER
CABINETMAKERS	K AE B N AH T M EY K ER Z
CAKE	K EY K
CAKED	K EY K T
CAKES	K EY K S
CAKEWALK	K EY K W AO K
CAKEWALKED	K EY K W AO K T
CAKEWALKER	K EY K W AO K ER
CAKEWALKERS	K EY K W AO K ER Z
CAKEWALKING	K EY K W AO K IH NG
CAKEWALKS	K EY K W AO K S
CAKEY	K EY K IY
CALFLIKE	K AE F L AY K
CALKED	K AE K T
CALKER	K AE K AH R
CALKERS	K AE L K AH R Z
CANEBRAKE	K EY N B R EY K
CANEBRAKES	K EY N B R EY K S
CANKER	K AE NG K ER
CANKERED	K AE NG K ER D
CANKERING	K AE NG K ER IH NG
CANKEROUS	K AE NG K ER AH S
CANKERS	K AE NG K ER Z
CANKERWORM	K AE NG K ER W ER M
CANKERWORMS	K AE NG K ER W ER M Z
CANTANKEROUS	K AE N T AE NG K ER AH S
CANTANKEROUSLY	K AE N T AE NG K ER AH S L IY
CANTANKEROUSNESS	K AE N T AE NG K ER AH S N AH S
CANTANKEROUSNESSES	K AE N T AE NG K ER AH S N AH S IH Z
CANVASLIKE	K AE N V AH S L AY K
CAPMAKER	K AE P M EY K ER
CAPMAKERS	K AE P M EY K ER Z
CARETAKE	K EH R T EY K
CARETAKEN	K EH R T EY K AH N
CARETAKER	K EH R T EY K ER
CARETAKERS	K EH R T EY K ER Z
CARETAKES	K EH R T EY K S
CARJACKER	K AA R JH AE K ER
CARJACKERS	K AA R JH AE K ER Z
CARKED	K AA R K T
CARMAKER	K AA R M EY K ER
CARMAKERS	K AA R M EY K ER Z
CARTOONLIKE	K AA R T UW N L AY K
CASEWORKER	K EY S W ER K ER
CASEWORKERS	K EY S W ER K ER Z
CASKED	K AE S K T
CASKET	K AE S K AH T
CASKETED	K AE S K AH T IH D
CASKETING	K AE S K AH T IH NG
CASKETS	K AE S K AH T S
CATLIKE	K AE T L AY K
CAULKED	K AO K T
CAULKER	K AO K AH R
CAULKERS	K AO L K AH R Z
CAVELIKE	K EY V L AY K
CHALKED	CH AO K T
CHAMELEONLIKE	CH AH M IY L IY AH N L AY K
CHARKED	CH AA R K T
CHATCHKE	CH AE CH
CHATCHKES	CH AE CH S
CHECKED	CH EH K T
CHECKER	CH EH K ER
CHECKERBERRIES	CH EH K ER B EH R IY Z
CHECKERBERRY	CH EH K ER B EH R IY
CHECKERBOARD	CH EH K ER B AO R D
CHECKERBOARDS	CH EH K ER B AO R D Z
CHECKERED	CH EH K ER D
CHECKERING	CH EH K ER IH NG
CHECKERS	CH EH K ER Z
CHECKMARKED	CH EH K M AA R K T
CHEEKED	CH IY K T
CHEESECAKE	CH IY Z K EY K
CHEESECAKES	CH IY Z K EY K S
CHERRYLIKE	CH EH R IY L AY K
CHERUBLIKE	CH EH R AH B L AY K
CHICKEE	CH IH K IY
CHICKEES	CH IH K IY Z
CHICKEN	CH IH K AH N
CHICKENED	CH IH K AH N D
CHICKENHEARTED	CH IH K AH N HH AA R T IH D
CHICKENING	CH IH K AH N IH NG
CHICKENPOX	CH IH K AH N P AA K S
CHICKENPOXES	CH IH K AH N P AA K S IH Z
CHICKENS	CH IH K AH N Z
CHICKENSHIT	CH IH K AH N SH IH T
CHICKENSHITS	CH IH K AH N SH IH T S
CHILDLIKE	CH AY L D L AY K
CHILDLIKENESS	CH AY L D L AY K N AH S
CHILDLIKENESSES	CH AY L D L AY K N AH S IH Z
CHIMNEYLIKE	CH IH M N IY L AY K
CHINKED	CH IH NG K T
CHIRKED	CH AH R K T
CHIRKER	CH AH R K AH R
CHIRKEST	CH AH R K AH S T
CHOCKED	CH AA K T
CHOKE	CH OW K
CHOKEBERRIES	CH OW K B EH R IY Z
CHOKEBERRY	CH OW K B EH R IY
CHOKECHERRIES	CH OW K CH EH R IY Z
CHOKECHERRY	CH OW K CH EH R IY
CHOKED	CH OW K T
CHOKEHOLD	CH OW K HH OW L D
CHOKEHOLDS	CH OW K HH OW L D Z
CHOKER	CH OW K ER
CHOKERS	CH OW K ER Z
CHOKES	CH OW K S
CHOKEY	CH OW K IY
CHUCKED	CH AH K T
CHUKKER	CH AH K AH R
CHUKKERS	CH AH K AH R Z
CHUNKED	CH AH NG K T
CLACKED	K L AE K T
CLACKER	K L AE K AH R
CLACKERS	K L AE K AH R Z
CLAMBAKE	K L AE M B EY K
CLAMBAKES	K L AE M B EY K S
CLANKED	K L AE NG K T
CLAWLIKE	K L AO L AY K
CLAYLIKE	K L EY L AY K
CLEEKED	K L IY K T
CLERKED	K L ER K T
CLICKED	K L IH K T
CLICKER	K L IH K ER
CLICKERS	K L IH K ER Z
CLINKED	K L IH NG K T
CLINKER	K L IH NG K ER
CLINKERED	K L IH NG K ER D
CLINKERING	K L IH NG K ER IH NG
CLINKERS	K L IH NG K ER Z
CLOAKED	K L OW K T
CLOCKED	K L AA K T
CLOCKER	K L AA K ER
CLOCKERS	K L AA K ER Z
CLOCKLIKE	K L AA K L AY K
CLONKED	K L AO NG K T
CLUCKED	K L AH K T
CLUNKED	K L AH NG K T
CLUNKER	K L AH NG K ER
CLUNKERS	K L AH NG K ER Z
COCKED	K AA K T
COCKED(2)	K AO K T
COCKER	K AA K ER
COCKERED	K AA K ER D
COCKEREL	K AA K EH R AH L
COCKERELS	K AA K EH R AH L Z
COCKERING	K AA K ER IH NG
COCKERS	K AA K ER Z
COCKEYE	K AA K AY
COCKEYED	K AA K AY D
COCKEYEDLY	K AA K AY AH D L IY
COCKEYEDNESS	K AA K AY AH D N AH S
COCKEYEDNESSES	K AA K AY AH D N AH S IH Z
COCKEYES	K AA K AY Z
COCKLIKE	K AA K L AY K
COCKSUCKER	K AA K S AH K ER
COCKSUCKER(2)	K AA K S AH K ER Z
COCKSUCKERS	K AA K S AH K ER Z
COFFEECAKE	K AO F IY K EY K
COFFEECAKES	K AO F IY K EY K S
COFFEEMAKER	K AO F IY M EY K ER
COFFEEMAKERS	K AO F IY M EY K ER Z
COKE	K OW K
COKED	K OW K T
COKEHEAD	K OW K HH EH D
COKEHEADS	K OW K HH EH D Z
COKES	K OW K S
COLDCOCKED	K OW L D K AA K T
COMAKE	K OW M EY K
COMAKER	K OW M EY K ER
COMAKERS	K OW M EY K ER Z
COMAKES	K OW M EY K S
COMBLIKE	K OW M L AY K
COMPUTERLIKE	K AH M P Y UW T ER L AY K
CONKED	K AO NG K T
CONKER	K AO NG K AH R
CONKERS	K AA N K EH R Z
CONVOKE	K AA N V OW K
CONVOKED	K AA N V OW K T
CONVOKER	K AA N V OW K AH R
CONVOKERS	K AA N V AA K AH R Z
CONVOKES	K AA N V OW K S
COOKED	K UH K T
COOKER	K UH K ER
COOKERIES	K UH K AH R IY Z
COOKERS	K UH K ER Z
COOKERY	K UH K AH R IY
COOKEY	K UW K IY
COOKEYS	K UW K IY Z
CORDLIKE	K AO R D L AY K
CORKED	K AO R K T
CORKER	K AO R K ER
CORKERS	K AO R K ER Z
CORKLIKE	K AO R K L AY K
CORMLIKE	K AO R M L AY K
CORNCAKE	K AO R N K EY K
CORNCAKES	K AO R N K EY K S
CORNCRAKE	K AA R NG K R EY K
CORNCRAKES	K AA R NG K R EY K S
CORNFLAKES	K AO R N F L EY K S
CORNHUSKER	K AO R N HH AH S K ER
CORNHUSKERS	K AO R N HH AH S K ER Z
COUNTERATTACKED	K AW N T ER AH T AE K T
COUNTERATTACKED(2)	K AW N ER AH T AE K T
COUNTERATTACKER	K AW N T ER AH T AE K ER
COUNTERATTACKERS	K AW N T ER AH T AE K ER Z
COUNTERCHECKED	K AW N T ER CH EH K T
COUNTERPICKET	K AW N T ER P IH K AH T
COUNTERPICKETED	K AW N T ER P IH K AH T IH D
COUNTERPICKETING	K AW N T ER P IH K AH T IH NG
COUNTERPICKETS	K AW N T ER P IH K AH T S
COUNTERSTRIKE	K AW N T ER S T R AY K
COUNTERSTRIKES	K AW N T ER S T R AY K S
COUNTERSTROKE	K AW N T ER S T R OW K
COUNTERSTROKES	K AW N T ER S T R OW K S
COWORKER	K OW W ER K ER
COWORKERS	K OW W ER K ER Z
COWPOKE	K AW P OW K
COWPOKES	K AW P OW K S
CRACKED	K R AE K T
CRACKER	K R AE K ER
CRACKERJACK	K R AE K ER JH AE K
CRACKERJACKS	K R AE K ER JH AE K S
CRACKERS	K R AE K ER Z
CRAFTSMANLIKE	K R AE F T S M AE N L AY K
CRAKE	K R EY K
CRAKES	K R EY K S
CRANKED	K R AE NG K T
CRANKER	K R AE NG K ER
CRANKEST	K R AE NG K AH S T
CRATERLIKE	K R EY T ER L AY K
CREAKED	K R IY K T
CRICKED	K R IH K T
CRICKET	K R IH K IH T
CRICKETED	K R IH K AH T IH D
CRICKETER	K R IH K AH T ER
CRICKETERS	K R IH K AH T ER Z
CRICKETING	K R IH K AH T IH NG
CRICKETS	K R IH K IH T S
CRICKEY	K R IH K IY
CRIKEY	K R IH K IY
CROAKED	K R OW K T
CROAKER	K R OW K ER
CROAKERS	K R OW K ER Z
CROCKED	K R AA K T
CROCKERIES	K R AA K AH R IY Z
CROCKERY	K R AA K ER IY
CROCKET	K R AA K AH T
CROCKETED	K R AA K AH T IH D
CROCKETS	K R AA K AH T S
CROOKBACKED	K R UH K B AE K T
CROOKED	K R UH K AH D
CROOKEDER	K R UH K AH D ER
CROOKEDEST	K R UH K AH D AH S T
CROOKEDLY	K R UH K AH D L IY
CROOKEDNESS	K R UH K AH D N AH S
CROOKEDNESSES	K R UH K AH D N AH S IH Z
CROOKERIES	K R UH K AH R IY Z
CROOKERY	K R UH K AH R IY
CROSSCHECKED	K R AO S CH EH K T
CROWKEEPER	K R OW K IY P ER
CROWKEEPERS	K R OW K IY P ER Z
CUKE	K Y UW K
CUKES	K Y UW K S
CULTLIKE	K AH L T L AY K
CUPCAKE	K AH P K EY K
CUPCAKES	K AH P K EY K S
CUPLIKE	K AH P L AY K
CUPRONICKEL	K AH P R AH N IH K AH L
CUPRONICKELS	K AH P R AH N IH K AH L Z
CYTOSKELETAL	S AH T AA S EH L AH T AH L
CYTOSKELETON	S IH T AH S EH L AH T AH N
CYTOSKELETONS	S IH T AH S EH L AH T AH N Z
DACKER	D AE K AH R
DACKERED	D AE K IY R D
DACKERING	D AE K IY R AH NG
DACKERS	D AE K AH R Z
DAGGERLIKE	D AE G ER L AY K
DAIKER	D EY K AH R
DAIKERED	D EY K IY R D
DAIKERING	D EY K IY R AH NG
DAIKERS	D EY K AH R Z
DAKERHEN	D AE K AH R AH N
DAKERHENS	D AE K AH R AH N Z
DAMASKED	D AE M AE S K T
DANKER	D AE NG K ER
DANKEST	D AE NG K AH S T
DARKED	D AA R K T
DARKEN	D AA R K AH N
DARKENED	D AA R K AH N D
DARKENER	D AA R K AH N ER
DARKENERS	D AA R K AH N ER Z
DARKENING	D AA R K AH N IH NG
DARKENING(2)	D AA R K N IH NG
DARKENS	D AA R K AH N Z
DARKER	D AA R K ER
DARKEST	D AA R K AH S T
DARKEY	D AA R K IY
DARKEYS	D AA R K EY Z
DAWNLIKE	D AO N L AY K
DAYDREAMLIKE	D EY D R IY M L AY K
DEADLOCKED	D EH D L AA K T
DEATHLIKE	D EH TH L AY K
DEBARKED	D IY B AA R K T
DEBEAKED	D IH B AH EY K T
DEBUNKED	D IH B AH NG K T
DEBUNKER	D IY B AH NG K ER
DEBUNKERS	D IY B AH NG K ER Z
DECKED	D EH K T
DECKEL	D IH K EH L
DECKELS	D IH K EH L Z
DECKER	D EH K ER
DECKERS	D IY S ER Z
DEERLIKE	D IH ER L AY K
DEERSTALKER	D IH ER S T AO K ER
DEERSTALKERS	D IH ER S T AO K ER Z
DEFROCKED	D IY F R AA K T
DEKE	D AH K IY
DEKED	D IY K T
DEKES	D IY K S
DEMARKED	D IY M AA R K T
DETECTIVELIKE	D IH T EH K T IH V L AY K
DETICKED	D IY T IH K T
DETICKER	D IY T IH K ER
DETICKERS	D IY T IH K ER Z
DEZINCKED	D IY Z IH NG K T
DICKED	D IH K T
DICKENS	D IH K AH N Z
DICKENSES	D IH K AH N Z IH Z
DICKER	D IH K ER
DICKERED	D IH K ER D
DICKERING	D IH K ER IH NG
DICKERS	D IH K ER Z
DICKEY	D IH K IY
DICKEYS	D IH K IY Z
DIEMAKER	D AY M EY K ER
DIEMAKERS	D AY M EY K ER Z
DIKE	D AY K
DIKED	D AY K T
DIKER	D AY K AH R
DIKERS	D IH K AH R Z
DIKES	D AY K S
DIKEY	D IH K IY
DINKED	D IH NG K T
DINKEY	D IH N K IY
DINKEYS	D IH N K IY Z
DIRGELIKE	D ER JH L AY K
DIRKED	D AH R K T
DISCLIKE	D IH S K L AY K
DISEMBARKED	D IH S IH M B AA R K T
DISFROCKED	D IH S F R AA K T
DISHLIKE	D IH SH L AY K
DISKED	D IH S K T
DISKETTE	D IH S K EH T
DISKETTES	D IH S K EH T S
DISKLIKE	D IH S K L AY K
DISLIKE	D IH S L AY K
DISLIKEABLE	D IH S L AY K AH B AH L
DISLIKED	D IH S L AY K T
DISLIKER	D IH S L AY K ER
DISLIKERS	D IH S L AY K ER Z
DISLIKES	D IH S L AY K S
DISYOKE	D IH S Y OW K
DISYOKED	D IH S Y OW K T
DISYOKES	D IH S Y OW K S
DOCKED	D AA K T
DOCKER	D AA K ER
DOCKERS	D AA K ER Z
DOCKET	D AA K AH T
DOCKETED	D AA K AH T IH D
DOCKETING	D AA K AH T IH NG
DOCKETS	D AA K AH T S
DOCKWORKER	D AA K W ER K ER
DOCKWORKERS	D AA K W ER K ER Z
DOGLIKE	D AO G L AY K
DOMELIKE	D OW M L AY K
DOMINICKER	D AA M AH N IH K S ER
DOMINICKERS	D AA M AH N IH K S ER Z
DONKEY	D AA NG K IY
DONKEY(2)	D AO NG K IY
DONKEYS	D AA NG K IY Z
DONKEYWORK	D AA NG K IY W ER K
DONKEYWORKS	D AA NG K IY W ER K S
DONNICKER	D AA N IH K S ER
DONNICKERS	D AA N IH K S ER Z
DONNIKER	D AA N AY K AH R
DONNIKERS	D AA N AH K AH R Z
DOOHICKEY	D UW HH IH K IY
DOOHICKEYS	D UW HH IH K EY Z
DOORKEEPER	D AO R K IY P ER
DOORKEEPERS	D OW R K IY P ER Z
DOUBLESPEAKER	D AH B AH L S P IY K ER
DOUBLESPEAKERS	D AH B AH L S P IY K ER Z
DOUGHLIKE	D OW L AY K
DOUGHNUTLIKE	D OW N AH T L AY K
DOVEKEY	D AH V K IY
DOVEKEYS	D AH V K IY Z
DOVELIKE	D AH V L AY K
DOWNSTROKE	D AW N S T R OW K
DOWNSTROKES	D AW N S T R OW K S
DRAKE	D R EY K
DRAKES	D R EY K S
DREAMLIKE	D R IY M L AY K
DRESSMAKER	D R EH S M EY K ER
DRESSMAKERS	D R EH S M EY K ER Z
DRINKER	D R IH NG K ER
DRINKERS	D R IH NG K ER Z
DROPKICKER	D R AA P K IH K ER
DROPKICKERS	D R AA P K IH K ER Z
DROUKED	D R AW K T
DRUGMAKER	D R AH G M EY K ER
DRUGMAKERS	D R AH G M EY K ER Z
DRUMLIKE	D R AH M L AY K
DRUNKEN	D R AH NG K AH N
DRUNKENLY	D R AH NG K AH N L IY
DRUNKENNESS	D R AH NG K AH N N AH S
DRUNKENNESSES	D R AH NG K AH N AH S IH Z
DRUNKER	D R AH NG K ER
DRUNKEST	D R AH NG K AH S T
DUCKED	D AH K T
DUCKER	D AH K ER
DUCKERS	D AH K ER Z
DUCKWALKED	D AH K W AO K T
DUIKER	D UW K AH R
DUIKERS	D UW K AH R Z
DUKE	D UW K
DUKED	D UW K T
DUKEDOM	D UW K D AH M
DUKEDOMS	D UW K D AH M Z
DUKES	D UW K S
DUNELIKE	D UW N L AY K
DUNKED	D AH NG K T
DUNKER	D AH NG K ER
DUNKERS	D AH NG K ER Z
DUSKED	D AH S K T
DUSTLIKE	D AH S T L AY K
DWARFLIKE	D W AO R F L AY K
DYKE	D AY K
DYKED	D AY K T
DYKES	D AY K S
DYKEY	D AY K IY
EARMARKED	IH R M AA R K T
EARMARKED(2)	IY R M AA R K T
EARTHLIKE	ER TH L AY K
EARTHQUAKE	ER TH K W EY K
EARTHQUAKES	ER TH K W EY K S
EARTHSHAKER	ER TH SH EY K ER
EARTHSHAKERS	ER TH SH EY K ER Z
EELLIKE	IY L L AY K
EKE	IY K
EKED	IY K T
EKES	IY K S
ELFLIKE	EH L F L AY K
EMBANKED	IH M B AE NG K T
EMBARKED	EH M B AA R K T
EMBOSKED	IH M B AA S T
ENDOSKELETAL	EH N D UW S K EH L AH T AH L
ENDOSKELETON	EH N D UW S K EH L AH T AH N
ENDOSKELETONS	EH N D UW S K EH L AH T AH N Z
ENKEPHALIN	IH N K EH F AH L AH N
ENKEPHALINS	IH N K EH F AH L AH N Z
ENOKIDAKE	AH N AA K AH D EY K
ENOKIDAKES	AH N AA K AH D EY K S
EPICLIKE	EH P IH K L AY K
EQUIVOKE	EH K W AH V OW K
EQUIVOKES	EH K W AH V OW K S
ESKER	EH S K ER
ESKERS	EH S AH R Z
EVOKE	IH V OW K
EVOKE(2)	IY V OW K
EVOKED	IH V OW K T
EVOKED(2)	IY V OW K T
EVOKER	IH V OW K ER
EVOKERS	IH V OW K ER Z
EVOKES	IH V OW K S
EVOKES(2)	IY V OW K S
EXOSKELETAL	IH G Z AA S EH L AH T AH L
EXOSKELETON	EH K S OW S K EH L AH T AH N
EXOSKELETONS	IH G Z AA S EH L AH T AH N Z
EYELIKE	AY L AY K
FACTORYLIKE	F AE K T AH R IY L AY K
FAIRYLIKE	F AE ER IY L AY K
FAKE	F EY K
FAKED	F EY K T
FAKEER	F EY K IH R
FAKEERS	F EY K IH R Z
FAKER	F EY K ER
FAKERIES	F EY K AH R IY Z
FAKERS	F EY K ER Z
FAKERY	F EY K AH R IY
FAKES	F EY K S
FAKEY	F EY K IY
FANGLIKE	F AE NG L AY K
FANLIKE	F AE N L AY K
FARMWORKER	F AA R M W ER K ER
FARMWORKERS	F AA R M W ER K ER Z
FATHERLIKE	F AA DH ER L AY K
FATLIKE	F AE T L AY K
FAUNLIKE	F AO N L AY K
FAWNLIKE	F AO N L AY K
FELTLIKE	F EH L T L AY K
FERNLIKE	F ER N L AY K
FILMMAKER	F IH L M EY K ER
FILMMAKERS	F IH L M EY K ER Z
FINGERLIKE	F IH NG G ER L AY K
FINGERPICKED	F IH NG G ER P IH K T
FINKED	F IH NG K T
FINLIKE	F IH N L AY K
FIRECRACKER	F AY ER K R AE K ER
FIRECRACKERS	F AY ER K R AE K ER Z
FIREDRAKE	F AY ER D R EY K
FIREDRAKES	F AY ER D R EY K S
FISHLIKE	F IH SH L AY K
FLACKED	F L AE K T
FLACKERIES	F L AE K AH R AY Z
FLACKERY	F L AE K AH R IY
FLAKE	F L EY K
FLAKED	F L EY K T
FLAKER	F L EY K ER
FLAKERS	F L EY K ER Z
FLAKES	F L EY K S
FLAKEY	F L EY K IY
FLANKED	F L AE NG K T
FLANKEN	F L AE NG K AH N
FLANKENS	F L AE NG K AH N Z
FLANKER	F L AE NG K ER
FLANKERS	F L AE NG K ER Z
FLASKET	F L AE S AH T
FLASKETS	F L AE S AH T S
FLECKED	F L EH K T
FLICKED	F L IH K T
FLICKER	F L IH K ER
FLICKERED	F L IH K ER D
FLICKERING	F L IH K ER IH NG
FLICKERINGLY	F L IH K ER IH NG L IY
FLICKERS	F L IH K ER Z
FLICKERY	F L IH K AH R IY
FLINTLIKE	F L IH N T L AY K
FLOCKED	F L AA K T
FLOORWALKER	F L OW R W AO K ER
FLOORWALKERS	F L OW R W AO K ER Z
FLOWERLIKE	F L AW ER L AY K
FLUKE	F L UW K
FLUKED	F L UW K T
FLUKES	F L UW K S
FLUKEY	F L UW K IY
FLUNKED	F L AH NG K T
FLUNKER	F L AH NG K AH R
FLUNKERS	F L AH NG K AH R Z
FLUNKEY	F L AH NG K IY
FLUNKEYS	F L AH NG K EY Z
FLUTELIKE	F L UW T L AY K
FLYSPECKED	F L AY S P EH K T
FOAMLIKE	F OW M L AY K
FOLKLIKE	F OW K L AY K
FOOTLIKE	F UH T L AY K
FOOTLOCKER	F UH T L OW K ER
FOOTLOCKERS	F UH T L OW K ER Z
FORCEPSLIKE	F AO R S AH P S L AY K
FORECHECKED	F OW R CH EH K T
FORECHECKER	F OW R CH EH K ER
FORECHECKERS	F OW R CH EH K ER Z
FORELOCKED	F OW R L AA K T
FORESPOKE	F OW R S P OW K
FORESPOKEN	F OW R S P OW K AH N
FORETOKEN	F OW R T OW K AH N
FORETOKENED	F OW R T OW K AH N D
FORETOKENING	F OW R T OW K AH N IH NG
FORETOKENS	F OW R T OW K AH N Z
FORKED	F AO R K T
FORKEDLY	F AO R K AH D L IY
FORKER	F AO R K ER
FORKERS	F AO R K ER Z
FORKLIKE	F AO R K L AY K
FORSAKE	F AO R S EY K
FORSAKEN	F AO R S EY K AH N
FORSAKER	F AO R S EY K ER
FORSAKERS	F AO R S EY K ER Z
FORSAKES	F AO R S EY K S
FORTRESSLIKE	F AO R T R AH S L AY K
FOSSICKED	F AA S AH K T
FOSSICKER	F AA S IH K AH R
FOSSICKERS	F AA S IH K AH R Z
FOXLIKE	F AA K S L AY K
FRANKED	F R AE NG K T
FRANKER	F R AE NG K ER
FRANKERS	F R AE NG K ER Z
FRANKEST	F R AE NG K AH S T
FREAKED	F R IY K T
FREETHINKER	F R IY TH IH NG K ER
FREETHINKERS	F R IY TH IH NG K ER Z
FRIEDCAKE	F R AY D K EY K
FRIEDCAKES	F R AY D K EY K S
FRIEZELIKE	F R IY Z L AY K
FRISKED	F R IH S K T
FRISKER	F R IH S AH R
FRISKERS	F R IH S AH R Z
FRISKET	F R IH S AH T
FRISKETS	F R IH S AH T S
FROCKED	F R AA K T
FROGLIKE	F R AA G L AY K
FROLICKED	F R AA L IH K T
FRUITCAKE	F R UW T K EY K
FRUITCAKES	F R UW T K EY K S
FUCKED	F AH K T
FUCKER	F AH K ER
FUCKERS	F AH K ER Z
FUMELIKE	F Y UW M L AY K
FUNKED	F AH NG K T
FUNKER	F AH NG K ER
FUNKERS	F AH NG K ER Z
FYKE	F AY K
FYKES	F AY K S
GADZOOKERIES	G AE D Z UH K AH R AY Z
GADZOOKERY	G AE D Z AH K EH R IY
GAMEKEEPER	G EY M K IY P ER
GAMEKEEPERS	G EY M K IY P ER S
GAMELIKE	G EY M L AY K
GARLICKED	G AA R L IH K T
GARPIKE	G AA R P AY K
GARPIKES	G AA R P AY K S
GASKET	G AE S K AH T
GASKETS	G AE S K AH T S
GATEKEEPER	G EY T K IY P ER
GATEKEEPERS	G EY T K IY P ER Z
GATEKEEPING	G EY T K IY P IH NG
GATELIKE	G EY T L AY K
GAUZELIKE	G AO Z L AY K
GAWKED	G AO K T
GAWKER	G AA K ER
GAWKERS	G AA K ER Z
GECKED	JH EH K T
GEDANKENEXPERIMENT	JH AH D AE NG K AH N EH K S EH R AH M AH N T
GEDANKENEXPERIMENTS	JH AH D AE NG K AH N AH K S EH R AH M AH N T S
GEMLIKE	JH EH M L AY K
GEMUTLICHKEIT	JH AH M AH T L AH CH IY T
GEMUTLICHKEITS	JH AH M AH T L AH CH IY T S
GENTLEMANLIKE	JH EH N T AH L M AE N L AY K
GENTLEMANLIKENESS	JH EH N T AH L M AE N L AY K N AH S
GENTLEMANLIKENESSES	JH EH N T AH L M AE N L AY K N AH S IH Z
GHOSTLIKE	G OW S T L AY K
GIANTLIKE	JH AY AH N T L AY K
GIMCRACKERIES	JH IH M K R AE K AH R AY Z
GIMCRACKERY	JH IH M K R AH K EH R IY
GIMMICKED	JH IH M AH K T
GLAIKET	G L EY K AH T
GLASSMAKER	G L AE S M EY K ER
GLASSMAKERS	G L AE S M EY K ER Z
GLASSWORKER	G L AE S W ER K ER
GLASSWORKERS	G L AE S W ER K ER Z
GLEEKED	G L IY K T
GLENLIKE	G L EH N L AY K
GLOCKENSPIEL	G L AA K AH N S P IY L
GLOCKENSPIELS	G L AA K AH N S IY L Z
GLUELIKE	G L UW L AY K
GNATLIKE	N AE T L AY K
GNOMELIKE	N OW M L AY K
GOADLIKE	G OW D L AY K
GOALKEEPER	G OW L K IY P ER
GOALKEEPERS	G OW L K IY P ER Z
GOATLIKE	G OW T L AY K
GOATSUCKER	G OW T S AH K ER
GOATSUCKERS	G OW T S AH K ER Z
GODFORSAKEN	G AA D F AO R S EY K AH N
GODLIKE	G AA D L AY K
GODLIKENESS	G AA D L AY K N AH S
GODLIKENESSES	G AA D L AY K N AH S IH Z
GOLDBRICKED	G OW L D B R IH K T
GONGLIKE	G AO NG L AY K
GOOSENECKED	G UW S N EH K T
GRANITELIKE	G R AE N AH T L AY K
GRAPELIKE	G R EY P L AY K
GRASSLIKE	G R AE S L AY K
GRAYWACKE	G R EY W AH K
GRAYWACKES	G R EY W AH K S
GREENBACKER	G R IY N B AE K ER
GREENBACKERS	G R IY N B AE K ER Z
GREENKEEPER	G R IY N K IY P ER
GREENKEEPERS	G R IY N K IY P ER Z
GREENSKEEPER	G R IY N Z K IY P ER
GREENSKEEPERS	G R IY N Z K IY P ER Z
GRIDDLECAKE	G R IH D L AH K EY K
GRIDDLECAKES	G R IH D L AH K EY K S
GRIDLOCKED	G R IH D L AA K T
GROUNDBREAKER	G R AW N D B R EY K ER
GROUNDBREAKERS	G R AW N D B R EY K ER Z
GROUNDSKEEPER	G R AW N D S K IY P ER
GROUNDSKEEPERS	G R AW N D S K IY P ER Z
GRUBSTAKE	G R AH B S T EY K
GRUBSTAKED	G R AH B S T EY K T
GRUBSTAKER	G R AH B S T EY K ER
GRUBSTAKERS	G R AH B S T EY K ER Z
GRUBSTAKES	G R AH B S T EY K S
GULFLIKE	G AH L F L AY K
GUMLIKE	G AH M L AY K
GUTBUCKET	G AH T B AH K AH T
GUTBUCKETS	G AH T B AH K AH T S
GUTLIKE	G AH T L AY K
HACKED	HH AE K T
HACKEE	HH AE K IY
HACKEES	HH AE K IY Z
HACKER	HH AE K ER
HACKERS	HH AE K ER Z
HAIRLIKE	HH EH R L AY K
HAKE	HH EY K
HAKEEM	HH AA K IY M
HAKEEMS	HH EY K IY M Z
HAKES	HH EY K S
HALLMARKED	HH AO L M AA R K T
HALOLIKE	HH EY L OW L AY K
HALTERBROKE	HH AO L T ER B R OW K
HALTERBROKEN	HH AO L T ER B R OW K AH N
HANDBASKET	HH AE N D B AE S K AH T
HANDBASKETS	HH AE N D B AE S K AH T S
HANDKERCHIEF	HH AE NG K ER CH IH F
HANDKERCHIEF(2)	HH AE NG K ER CH IY F
HANDKERCHIEFS	HH AE NG K ER CH AH F S
HANDKERCHIEFS(2)	HH AE NG K ER CH IY F S
HANDKERCHIEVES	HH AE N D K AH R CH IY V Z
HANDLIKE	HH AE N D L AY K
HANDPICKED	HH AE N D P IH K T
HANDSHAKE	HH AE N D SH EY K
HANDSHAKES	HH AE N D SH EY K S
HANDSPIKE	HH AE N D S P AY K
HANDSPIKES	HH AE N D S P AY K S
HANDWORKER	HH AE N D W ER K ER
HANDWORKERS	HH AE N D W ER K ER Z
HANKED	HH AE NG K T
HANKER	HH AE NG K ER
HANKERED	HH AE NG K ER D
HANKERER	HH AE NG K ER ER
HANKERERS	HH AE NG K ER ER Z
HANKERING	HH AE NG K ER IH NG
HANKERS	HH AE NG K ER Z
HARELIKE	HH EH R L AY K
HARKED	HH AA R K T
HARKEN	HH AA R K AH N
HARKENED	HH AA R K AH N D
HARKENER	HH AA R K AH N ER
HARKENERS	HH AA R K AH N ER Z
HARKENING	HH AA R K AH N IH NG
HARKENS	HH AA R K AH N Z
HATLIKE	HH AE T L AY K
HATMAKER	HH AE T M EY K ER
HATMAKERS	HH AE T M EY K ER Z
HAVOCKED	HH AE V AH K T
HAVOCKER	HH AE V AH K ER
HAVOCKERS	HH AE V AH K ER Z
HAWKED	HH AO K T
HAWKER	HH AO K ER
HAWKERS	HH AO K ER Z
HAWKEY	HH AO K IY
HAWKEYED	HH AO K AY D
HAWKEYS	HH AO K IY Z
HAWKLIKE	HH AO K L AY K
HAYMAKER	HH EY M EY K ER
HAYMAKERS	HH EY M EY K ER Z
HEADSHRINKER	HH EH D SH R IH NG K ER
HEADSHRINKERS	HH EH D SH R IH NG K ER Z
HEARKEN	HH IH ER K EH N
HEARKENED	HH IH ER K EH N D
HEARKENING	HH IH ER K EH N IH NG
HEARKENS	HH AA R K AH N Z
HEARTBREAKER	HH AA R T B R EY K ER
HEARTBREAKERS	HH AA R T B R EY K ER Z
HEARTBROKEN	HH AA R T B R OW K AH N
HEATHLIKE	HH IY TH L AY K
HEATSTROKE	HH IY T S T R OW K
HEATSTROKES	HH IY T S T R OW K S
HELMETLIKE	HH EH L M AH T L AY K
HEMPLIKE	HH EH M P L AY K
HENLIKE	HH EH N L AY K
HENPECKED	HH EH N P EH K T
HERBLIKE	ER B L AY K
HERDLIKE	HH ER D L AY K
HICKEY	HH IH K IY
HICKEYS	HH IH K EY Z
HIGHJACKED	HH AY JH AE K T
HIJACKED	HH AY JH AE K T
HIJACKER	HH AY JH AE K ER
HIJACKERS	HH AY JH AE K ER Z
HIKE	HH AY K
HIKED	HH AY K T
HIKER	HH AY K ER
HIKERS	HH AY K ER Z
HIKES	HH AY K S
HIPLIKE	HH IH P L AY K
HITCHHIKE	HH IH CH HH AY K
HITCHHIKED	HH IH CH HH AY K T
HITCHHIKER	HH IH CH HH AY K ER
HITCHHIKERS	HH IH CH HH AY K ER Z
HITCHHIKES	HH IH CH HH AY K S
HOBLIKE	HH AA B L AY K
HOCKED	HH AA K T
HOCKER	HH AA K ER
HOCKERS	HH AA K ER Z
HOCKEY	HH AA K IY
HOCKEYS	HH AA K IY Z
HOECAKE	HH OW K EY K
HOECAKES	HH OW K EY K S
HOELIKE	HH OW L AY K
HOGLIKE	HH AA G L AY K
HOICKED	HH OW IH K S T
HOKE	HH OW K
HOKED	HH OW K T
HOKES	HH OW K S
HOKEY	HH OW K IY
HOKEYNESS	HH OW K EY N AH S
HOKEYNESSES	HH OW K AH N EH S AH Z
HOKEYPOKEY	HH OW K AH P OW K IY
HOKEYPOKEYS	HH OW K AH P AH K EY Z
HOLIDAYMAKER	HH AA L AH D EY M EY K ER
HOLIDAYMAKERS	HH AA L AH D EY M EY K ER Z
HOLKED	HH AA K T
HOMELIKE	HH OW M L AY K
HOMEMAKER	HH OW M M EY K ER
HOMEMAKERS	HH OW M M EY K ER Z
HONKED	HH AO NG K T
HONKER	HH AO NG K AH R
HONKERS	HH AO NG K AH R Z
HONKEY	HH AO NG K IY
HONKEYS	HH AO NG K EY Z
HOODLIKE	HH UH D L AY K
HOODWINKED	HH UH D W IH NG K T
HOODWINKER	HH UH D W IH NG K ER
HOODWINKERS	HH UH D W IH NG K ER Z
HOOFLIKE	HH UW F L AY K
HOOKED	HH UH K T
HOOKER	HH UH K ER
HOOKERS	HH UH K ER Z
HOOKEY	HH UH K IY
HOOKEYS	HH AH K EY Z
HOOKLIKE	HH UH K L AY K
HOOPLIKE	HH UW P L AY K
HORMONELIKE	HH AO R M OW N L AY K
HORNLIKE	HH AO R N L AY K
HORSELIKE	HH AO R S L AY K
HOTCAKE	HH AA T K EY K
HOTCAKES	HH AA T K EY K S
HOUSEBREAKER	HH AW S B R EY K ER
HOUSEBREAKERS	HH AW S B R EY K ER Z
HOUSEBROKE	HH AW S B R OW K
HOUSEBROKEN	HH AW S B R OW K AH N
HOUSEKEEP	HH AW S K IY P
HOUSEKEEPER	HH AW S K IY P ER
HOUSEKEEPERS	HH AW S K IY P ER Z
HOUSEKEEPING	HH AW S K IY P IH NG
HOUSEKEEPINGS	HH AW S K IY P IH NG Z
HOUSEKEEPS	HH AW S K IY P S
HOUSEKEPT	HH AW S K EH P T
HOWKED	HH OW K T
HULKED	HH AH L K T
HUMANLIKE	HH Y UW M AH N L AY K
HUMMOCKED	HH AH M AH K T
HUMPBACKED	HH AH M P B AE K T
HUNCHBACKED	HH AH N CH B AE K T
HUNKER	HH AH NG K ER
HUNKERED	HH AH NG K ER D
HUNKERING	HH AH NG K ER IH NG
HUNKERS	HH AH NG K ER Z
HUSKED	HH AH S K T
HUSKER	HH AH S K ER
HUSKERS	HH AH S K ER Z
HUSKLIKE	HH AH S K L AY K
HUTLIKE	HH AH T L AY K
HYDROCRACKED	HH IH D R AA K R AH K T
HYDROCRACKER	HH IH D R AA K R AE K AH R
HYDROCRACKERS	HH IH D R AH K R AE K AH R Z
HYMNLIKE	HH IH M L AY K
HYPERKERATOSES	HH AY P AH R K EH R AH T OW Z AH Z
HYPERKERATOSIS	HH AY P AH R K AH R AH T OW S AH S
HYPERKERATOTIC	HH AY P AH R K EH R AH T AH T AH K
HYPERLINKED	HH AY P ER L IH NG K T
HYPERMARKET	HH AY P ER M AA R K IH T
HYPERMARKETS	HH AY P ER M AA R K IH T S
ICEBREAKER	AY S B R EY K ER
ICEBREAKERS	AY S B R EY K ER Z
ICELIKE	AY S L AY K
ICEMAKER	AY S M EY K ER
ICEMAKERS	AY S M EY K ER Z
ICKER	IH K AH R
ICKERS	IH K AH R Z
IKEBANA	AH K EH B AH N AH
IKEBANAS	AH K EH B AH N AH Z
IMBARKED	IH M B AA R K T
IMPARKED	IH M P AA R K T
INKED	IH NG K T
INKER	IH NG K ER
INKERS	IH NG K ER Z
INKLIKE	IH NG K L AY K
INNKEEPER	IH N K IY P ER
INNKEEPERS	IH N K IY P ER Z
INSTROKE	IH N S T R OW K
INSTROKES	IH N S T R OW K S
INTAKE	IH N T EY K
INTAKES	IH N T EY K S
INTERLINKED	IH N T ER L IH NG K T
INTERLOCKED	IH N T ER L AA K D
INTERWORKED	IH N T ER W ER K T
INVOKE	IH N V OW K
INVOKED	IH N V OW K T
INVOKER	IH N V OW K ER
INVOKERS	IH N V OW K ER Z
INVOKES	IH N V OW K S
IRKED	ER K T
IRONLIKE	AY ER N L AY K
IRONWORKER	AY ER N W ER K ER
IRONWORKERS	AY ER N W ER K ER Z
IVYLIKE	AY V IY L AY K
JACKED	JH AE K T
JACKER	JH AE K ER
JACKEROO	JH AE K AH R UW
JACKEROOS	JH AE K AH R UW Z
JACKERS	JH AE K ER Z
JACKET	JH AE K AH T
JACKET(2)	JH AE K IH T
JACKETED	JH AE K AH T IH D
JACKETING	JH AE K AH T IH NG
JACKETLESS	JH AE K AH T L AH S
JACKETS	JH AE K IH T S
JAKE	JH EY K
JAKES	JH EY K S
JAUKED	JH AO K T
JAWBREAKER	JH AO B R EY K ER
JAWBREAKERS	JH AO B R EY K ER Z
JAWLIKE	JH AO L AY K
JAYHAWKER	JH EY HH AO K ER
JAYHAWKERS	JH EY HH AO K ER Z
JAYWALKED	JH EY W AO K T
JAYWALKER	JH EY W AO K ER
JAYWALKERS	JH EY W AO K ER Z
JAZZLIKE	JH AE Z L AY K
JELLYLIKE	JH EH L IY L AY K
JERKED	JH ER K T
JERKER	JH ER K ER
JERKERS	JH ER K ER Z
JETLIKE	JH EH T L AY K
JEWELLIKE	JH UW AH L AY K
JINKED	JH IH NG K T
JINKER	JH IH NG K AH R
JINKERS	JH IH NG K AH R Z
JOCKETTE	JH AA K EH T
JOCKETTES	JH AA K EH T S
JOCKEY	JH AA K IY
JOCKEYED	JH AA K IY D
JOCKEYING	JH AA K IY IH NG
JOCKEYS	JH AA K IY Z
JOHNNYCAKE	JH AA N IY K EY K
JOHNNYCAKES	JH AA N IY K EY K S
JOKE	JH OW K
JOKED	JH OW K T
JOKER	JH OW K ER
JOKERS	JH OW K ER Z
JOKES	JH OW K S
JOKESTER	JH OW K S T ER
JOKESTERS	JH OW K S T ER Z
JOKEY	JH OW K IY
JOUKED	JH AW K T
JUKE	JH UW K
JUKEBOX	JH UW K B AA K S
JUKEBOXES	JH UW K B AA K S IH Z
JUKED	JH UW K T
JUKES	JH UW K S
JUNGLELIKE	JH AH NG G AH L AY K
JUNKED	JH AH NG K T
JUNKER	JH AH NG K ER
JUNKERS	JH AH NG K ER Z
JUNKET	JH AH NG K IH T
JUNKETED	JH AH NG K IY T AH D
JUNKETEER	JH AH NG K AH T IH R
JUNKETEERS	JH AH NG K IY T AH R Z
JUNKETER	JH AH NG K IY T AH R
JUNKETERS	JH AH NG K AH T AH R Z
JUNKETING	JH AH NG K IY T AH NG
JUNKETS	JH AH NG K IH T S
KAKEMONO	K AH K EH M AH N OW
KAKEMONOS	K AH K EH M AH N AH Z
KARAOKE	K EH R IY OW K IY
KARAOKES	K AE R EY OW K S
KAYAKED	K EY EY K T
KAYAKER	K AY AE K ER
KAYAKERS	K AY AE K ER Z
KEA	K IY
KEAS	K IY Z
KEBAB	K AH B AA B
KEBABS	K EH B AH B Z
KEBAR	K IY B AH R
KEBARS	K EH B AH R Z
KEBBIE	K EH B AY
KEBBIES	K EH B AY Z
KEBBOCK	K EH B AH K
KEBBOCKS	K EH B AH K S
KEBBUCK	K EH B AH K
KEBBUCKS	K EH B AH K S
KEBLAH	K EH B L AH
KEBLAHS	K EH B L AH Z
KEBOB	K AH B AA B
KEBOBS	K AH B AA B Z
KECK	K EH K
KECKED	K EH K T
KECKING	K EH K AH NG
KECKLE	K EH K AH L
KECKLED	K EH K AH L D
KECKLES	K EH K AH L Z
KECKLING	K EH K L AH NG
KECKS	K EH K S
KEDDAH	K EH D AH
KEDDAHS	K EH D AH Z
KEDGE	K EH JH
KEDGED	K EH JH D
KEDGEREE	K EH JH AH R IY IY
KEDGEREES	K EH JH AH R IY Z
KEDGES	K EH JH AH Z
KEDGING	K EH JH AH NG
KEEF	K IY F
KEEFS	K IY F S
KEEK	K IY K
KEEKED	K IY K T
KEEKING	K IY K AH NG
KEEKS	K IY K S
KEEL	K IY L
KEELAGE	K IY L IH JH
KEELAGES	K IY L IH JH IH Z
KEELBOAT	K IY L B OW T
KEELBOATS	K IY L B OW T S
KEELED	K IY L D
KEELHALE	K IY L HH EY L
KEELHALED	K IY L HH EY L D
KEELHALES	K IY L HH EY L Z
KEELHALING	K IY L HH EY L IH NG
KEELHAUL	K IY L HH AO L
KEELHAULED	K IY L HH AO L D
KEELHAULING	K IY L HH AO L IH NG
KEELHAULS	K IY L HH AO L Z
KEELING	K IY L IH NG
KEELLESS	K IY L AH S
KEELS	K IY L Z
KEELSON	K EH L S AH N
KEELSONS	K EH L S AH N Z
KEEN	K IY N
KEENED	K IY N D
KEENER	K IY N ER
KEENERS	K IY N ER Z
KEENEST	K IY N AH S T
KEENING	K IY N IH NG
KEENLY	K IY N L IY
KEENNESS	K IY N AH S
KEENNESSES	K IY N AH S IH Z
KEENS	K IY N Z
KEEP	K IY P
KEEPABLE	K IY P AH B AH L
KEEPER	K IY P ER
KEEPERS	K IY P ER Z
KEEPING	K IY P IH NG
KEEPINGS	K IY P IH NG Z
KEEPS	K IY P S
KEEPSAKE	K IY P S EY K
KEEPSAKES	K IY P S EY K S
KEESHOND	K IY SH AH N D
KEESHONDEN	K IY SH AA N D AH N
KEESHONDS	K IY SH AH N D Z
KEESTER	K IY EH S T AH R
KEESTERS	K IY S T AH R Z
KEET	K IY T
KEETS	K IY T S
KEEVE	K IY V
KEEVES	K IY V Z
KEF	K EH F
KEFFIYEH	K EH F IY AY
KEFFIYEHS	K EH F IY AY AH Z
KEFIR	K EH F AH R
KEFIRS	K EH F AH R Z
KEFS	K EH F S
KEG	K EH G
KEGELER	K AH JH IY L AH R
KEGELERS	K EH JH AH L AH R Z
KEGLER	K EH G L ER
KEGLERS	K EH G L AH R Z
KEGLING	K EH G L IH NG
KEGLINGS	K EH G L IH NG Z
KEGS	K EH G Z
KEIR	K IY R
KEIRS	K IY R Z
KEISTER	K IY IH S T ER
KEISTERS	K IY S T ER Z
KEITLOA	K IY T L OW AH
KEITLOAS	K IY T L OW Z
KELEP	K EH L AH P
KELEPS	K EH L AH P S
KELIM	K EH L AH M
KELIMS	K EH L AH M Z
KELLIES	K EH L AY Z
KELLY	K EH L IY
KELOID	K IY L OY D
KELOIDAL	K AH L OY D AH L
KELOIDS	K AH L OY D Z
KELP	K EH L P
KELPED	K EH L P T
KELPIE	K EH L P IY
KELPIES	K EH L P IY Z
KELPING	K EH L P IH NG
KELPS	K EH L P S
KELPY	K EH L P IY
KELSON	K EH L S AH N
KELSONS	K EH L S AH N Z
KELTER	K EH L T ER
KELTERS	K EH L T AH R Z
KELVIN	K EH L V AH N
KELVIN(2)	K EH L V IH N
KELVINS	K EH L V AH N Z
KEMP	K EH M P
KEMPS	K EH M P S
KEMPT	K EH M P T
KEN	K EH N
KENAF	K EH N AE F
KENAFS	K EH N AH F S
KENCH	K EH N CH
KENCHES	K EH N CH AH Z
KENDO	K EH N D UW
KENDOS	K EH N D UW Z
KENNED	K EH N D
KENNEL	K EH N AH L
KENNELED	K EH N AH L D
KENNELING	K EH N AH L IH NG
KENNELLED	K EH N AH L D
KENNELLING	K EH N AH L IH NG
KENNELS	K EH N AH L Z
KENNING	K EH N IH NG
KENNINGS	K EH N IH NG Z
KENO	K IY N OW
KENOS	K IY N OW Z
KENOSIS	K EH N AA S IY Z
KENOSISES	K EH N AA S IY Z IH Z
KENOTIC	K EH N AH T AH K
KENOTRON	K AH N AA T R AH N
KENOTRONS	K AH N AA T R AH N Z
KENS	K EH N Z
KENSPECKLE	K EH N S P EH K AH L
KENT	K EH N T
KENTLEDGE	K EH N T L AH JH
KENTLEDGES	K EH N T L EH JH AH Z
KEP	K EH P
KEPHALIN	K EH F AH L AH N
KEPHALINS	K EH F AH L AH N Z
KEPI	K EH P IY
KEPIS	K IY P AH S
KEPPED	K EH P T
KEPPEN	K EH P AH N
KEPPING	K EH P AH NG
KEPS	K EH P S
KEPT	K EH P T
KEPT(2)	K AE P T
KERAMIC	K EH R AH M AH K
KERAMICS	K EH R AH M AH S Z
KERATIN	K EH R AH T AH N
KERATIN(2)	K EH R AH T IH N
KERATINIZATION	K EH R AH T AH N AH Z EY SH AH N
KERATINIZATIONS	K AH R AE T AH N AH Z EY T IY AH N Z
KERATINIZE	K AH R AE T AH N AY Z
KERATINIZED	K AH R AE T AH N AY Z D
KERATINIZES	K AH R AE T AH N AY Z AH Z
KERATINIZING	K AH R AE T AH N AY Z AH NG
KERATINOPHILIC	K EH R AH T IH N AH F AY L AH K
KERATINOUS	K AH R AE T AH N AH S
KERATINS	K EH R AH T AH N Z
KERATITIDES	K AH R AE T AH T AY D Z
KERATITIS	K IY R AH T AY T AH S
KERATOCONJUNCTIVITIS	K AH R AE T AH K AA N JH AH NG K T AH V AY T AH S
KERATOCONJUNCTIVITISES	K AH R AH T AH K AH N JH AH NG K T IH V AH T AY Z AH Z
KERATOID	K IY R AH T OY D
KERATOMA	K AH R AE T AH M AH
KERATOMAS	K AH R AE T AH M AH Z
KERATOMATA	K EH R AH T AA M AH T AH
KERATOPLASTIES	K EH R AH T AA P L AE S T AY Z
KERATOPLASTY	K EH R AH T AH
KERATOSE	K EH R AH T OW Z
KERATOSES	K EH R AH T OW Z AH Z
KERATOSIS	K IY R AH T OW S AH S
KERATOTIC	K EH R AH T AH T AH K
KERATOTOMIES	K EH R AH T AA T AH M AY Z
KERATOTOMY	K EH R AH T AO T AH M IY
KERB	K ER B
KERBED	K AH R B D
KERBING	K AH R B AH NG
KERBS	K ER B Z
KERCHIEF	K ER CH AH F
KERCHIEFED	K ER CH AH F T
KERCHIEFS	K ER CH AH F S
KERCHIEVES	K AH R CH IY V Z
KERCHOO	K AH R CH UW
KERF	K AH R F
KERFED	K AH R F T
KERFING	K AH R F AH NG
KERFS	K AH R F S
KERFUFFLE	K ER F AH F AH L
KERFUFFLES	K AH R F AH F AH L Z
KERMES	K AH R M Z
KERMESES	K AH R M IY Z AH Z
KERMESS	K AH R M AH S
KERMESSE	K AH R M AH S
KERMESSES	K AH R M EH S AH Z
KERMIS	K AH R M AH S
KERMISES	K AH R M AY Z AH Z
KERN	K ER N
KERNE	K AH R N
KERNED	K ER N D
KERNEL	K ER N AH L
KERNELED	K ER N AH L D
KERNELING	K ER N AH L IH NG
KERNELLED	K ER N AH L D
KERNELLING	K ER N AH L IH NG
KERNELS	K ER N AH L Z
KERNES	K ER N Z
KERNING	K ER N IH NG
KERNITE	K ER N AY T
KERNITES	K AH R N AY T S
KERNS	K ER N Z
KEROGEN	K EH R AH JH AH N
KEROGENS	K EH R AH JH AH N Z
KEROSENE	K EH R AH S IY N
KEROSENES	K EH R AH S IY N Z
KEROSINE	K EH R AH S AY N
KEROSINES	K EH R AH S AY N Z
KERPLUNK	K AH R P L AH NG K
KERPLUNKED	K AH R P L AH NG K T
KERPLUNKING	K AH R P L AH NG K AH NG
KERPLUNKS	K AH R P L AH NG K S
KERRIA	K EH R IY AH
KERRIAS	K EH R IY AH Z
KERRIES	K EH R IY Z
KERRY	K EH R IY
KERSEY	K ER S IY
KERSEYMERE	K AH R S EY M AH R
KERSEYMERES	K AH R S AH M IY R Z
KERSEYS	K AH R S EY Z
KERYGMA	K AH R IH G M AH
KERYGMAS	K AH R IH G M AH Z
KERYGMATA	K AH R IH G M AH T AH
KERYGMATIC	K EH R AH M AH T AH K
KESTREL	K EH S T R AH L
KESTRELS	K EH S T R AH L Z
KETCH	K EH CH
KETCHES	K EH CH IH Z
KETCHUP	K EH CH AH P
KETCHUPS	K EH CH AH P S
KETENE	K AH T IY N
KETENES	K AH T IY N Z
KETO	K EY T OW
KETOGENESES	K AH T AA JH AH N IY Z AH Z
KETOGENESIS	K EH T AH JH IY N AH S AH S
KETOGENIC	K EH T AH JH AH N AH K
KETOL	K EH T AH L
KETOLS	K EH T AH L Z
KETONE	K IY T OW N
KETONES	K AH T OW N Z
KETONIC	K EH T AH N AH K
KETOSE	K AH T OW Z
KETOSES	K AH T OW Z AH Z
KETOSIS	K IY T OW S AH S
KETOSTEROID	K AH T AA S T AH R OY D
KETOSTEROIDS	K AH T AA S T AH R OY D Z
KETOTIC	K EH T AH T AH K
KETTLE	K EH T AH L
KETTLEDRUM	K EH T AH L D R AH M
KETTLEDRUMS	K EH T AH L D R AH M Z
KETTLES	K EH T AH L Z
KEVEL	K EH V AH L
KEVELS	K EH V AH L Z
KEVIL	K EH V AH L
KEVILS	K IY V AH L Z
KEX	K EH K S
KEXES	K EH K S
KEY	K IY
KEYBOARD	K IY B AO R D
KEYBOARDED	K IY B OW R D IH D
KEYBOARDER	K IY B OW R D ER
KEYBOARDERS	K IY B OW R D ER Z
KEYBOARDING	K IY B OW R D IH NG
KEYBOARDIST	K IY B OW R D IH S T
KEYBOARDISTS	K IY B OW R D IH S T S
KEYBOARDS	K IY B AO R D Z
KEYBUTTON	K IY B AH T AH N
KEYBUTTONS	K IY B AH T AH N Z
KEYCARD	K IY K AA R D
KEYCARDS	K IY K AA R D Z
KEYED	K IY D
KEYHOLE	K IY HH OW L
KEYHOLES	K IY HH OW L Z
KEYING	K IY IH NG
KEYLESS	K IY L AH S
KEYNOTE	K IY N OW T
KEYNOTED	K IY N OW T IH D
KEYNOTER	K IY N OW T ER
KEYNOTERS	K IY N OW T ER Z
KEYNOTES	K IY N OW T S
KEYNOTING	K IY N OW T IH NG
KEYPAD	K IY P AE D
KEYPADS	K IY P AE D Z
KEYPUNCH	K IY P AH N CH
KEYPUNCHED	K IY P AH N CH T
KEYPUNCHER	K IY P AH N CH ER
KEYPUNCHERS	K IY P AH N CH ER Z
KEYPUNCHES	K IY P AH N CH IH Z
KEYPUNCHING	K IY P AH N CH IH NG
KEYS	K IY Z
KEYSET	K IY S EH T
KEYSETS	K IY S EH T S
KEYSTER	K IY S T ER
KEYSTERS	K IY S T ER Z
KEYSTONE	K IY S T OW N
KEYSTONES	K IY S T OW N Z
KEYSTROKE	K IY S T R OW K
KEYSTROKED	K IY S T R OW K T
KEYSTROKES	K IY S T R OW K S
KEYSTROKING	K IY S T R OW K IH NG
KEYWAY	K IY W EY
KEYWAYS	K IY W EY Z
KEYWORD	K IY W ER D
KEYWORDS	K IY W ER D Z
KICKED	K IH K T
KICKER	K IH K ER
KICKERS	K IH K ER Z
KIDLIKE	K IH D L AY K
KIKE	K AY K
KIKES	K AY K S
KINGLIKE	K IH NG L AY K
KINGMAKER	K IH NG M EY K ER
KINGMAKERS	K IH NG M EY K ER Z
KINKED	K IH NG K T
KISHKE	K IH SH
KISHKES	K IH SH S
KITELIKE	K AY T L AY K
KITTIWAKE	K IH T IH W EY K
KITTIWAKES	K IH T AH W EY K S
KNACKED	N AE K T
KNACKER	N AE K ER
KNACKERED	N AE K ER D
KNACKERIES	N AE K AH R IY Z
KNACKERS	N AE K ER Z
KNACKERY	N AE K AH R IY
KNAPSACKED	N AE P S AH K T
KNICKERBOCKER	N IH K ER B AA K ER
KNICKERBOCKERS	N IH K ER B AA K ER Z
KNICKERS	N IH K ER Z
KNIFELIKE	N AY F L AY K
KNOBKERRIE	N AA B K EH R AY
KNOBKERRIES	N AA B K EH R IY Z
KNOBLIKE	N AA B L AY K
KNOCKED	N AA K T
KNOCKER	N AA K ER
KNOCKERS	N AA K ER Z
KNOTLIKE	N AA T L AY K
KONKED	K AO NG K T
KRAKEN	K R EY K AH N
KRAKENS	K R AE K AH N Z
KYLIKES	K AH L AY K S
LACELIKE	L EY S L AY K
LACKED	L AE K T
LACKER	L AE K ER
LACKERED	L AE K ER D
LACKERING	L AE K ER IH NG
LACKERS	L AE K ER Z
LACKEY	L AE K IY
LACKEYED	L AE K IY D
LACKEYING	L AE K IY IH NG
LACKEYS	L AE K IY Z
LADDERLIKE	L AE D ER L AY K
LADYLIKE	L EY D IY L AY K
LAKE	L EY K
LAKED	L EY K T
LAKEFRONT	L EY K F R AH N T
LAKEFRONTS	L EY K F R AH N T S
LAKELIKE	L EY K L AY K
LAKEPORT	L EY K P OW R T
LAKEPORTS	L EY K P OW R T S
LAKER	L EY K ER
LAKERS	L EY K ER Z
LAKES	L EY K S
LAKESHORE	L EY K SH AO R
LAKESHORES	L EY K SH OW R Z
LAKESIDE	L EY K S AY D
LAKESIDES	L EY K S AY D Z
LAMBLIKE	L AE M L AY K
LANDLOCKED	L AE N D L AA K T
LANKER	L AE NG K ER
LANKEST	L AE NG K AH S T
LAPSTRAKE	L AE P S T R EY K
LARDLIKE	L AA R D L AY K
LARKED	L AA R K T
LARKER	L AA R K ER
LARKERS	L AA R K ER Z
LATCHKEY	L AE CH K IY
LATCHKEYS	L AE CH K IY Z
LATKE	L AE T
LATKES	L AE T S
LAVALIKE	L AA V AH L AY K
LAWBREAKER	L AO B R EY K ER
LAWBREAKERS	L AO B R EY K ER Z
LAWLIKE	L AO L AY K
LAWMAKER	L AO M EY K ER
LAWMAKERS	L AO M EY K ER Z
LAWYERLIKE	L AO Y ER L AY K
LEAFLIKE	L IY F L AY K
LEAKED	L IY K T
LEAKER	L IY K ER
LEAKERS	L IY K ER Z
LEATHERLIKE	L EH DH ER L AY K
LEECHLIKE	L IY CH L AY K
LEGLIKE	L EH G L AY K
LEKE	L IY K
LEMMINGLIKE	L EH M AH NG L AY K
LEUKEMIA	L UW K IY M IY AH
LEUKEMIAS	L UW K IY M IY AH Z
LEUKEMIC	L UW K AH M AH K
LEUKEMICS	L UW K AH M AH S Z
LEUKEMOGENESES	L UW K AH M AA JH AH N IY Z AH Z
LEUKEMOGENESIS	L UW K AH M AH JH IY N AH S AH S
LEUKEMOGENIC	L UW K EH M AH JH AH N AH K
LEUKEMOID	L UW K AH M OY D
LICKED	L IH K T
LICKER	L IH K ER
LICKERISH	L IH K ER IH SH
LICKERISHLY	L IH K ER IH SH L IY
LICKERISHNESS	L IH K ER IH SH N AH S
LICKERISHNESSES	L IH K ER IH SH N AH S IH Z
LICKERS	L IH K ER Z
LIFELIKE	L AY F L AY K
LIFELIKENESS	L AY F L AY K N AH S
LIFELIKENESSES	L AY F L AY K N AH S IH Z
LIKE	L AY K
LIKEABLE	L AY K AH B AH L
LIKED	L AY K T
LIKELIER	L AY K L IY ER
LIKELIEST	L AY K L IY AH S T
LIKELIHOOD	L AY K L IY HH UH D
LIKELIHOODS	L AY K L IY HH UH D Z
LIKELY	L AY K L IY
LIKEN	L AY K AH N
LIKENED	L AY K AH N D
LIKENESS	L AY K N AH S
LIKENESSES	L AY K N AH S IH Z
LIKENING	L AY K AH N IH NG
LIKENS	L AY K AH N Z
LIKER	L AY K ER
LIKERS	L AY K ER Z
LIKES	L AY K S
LIKEST	L AY K AH S T
LIKEWISE	L AY K W AY Z
LILYLIKE	L IH L IY L AY K
LINEBACKER	L AY N B AE K ER
LINEBACKERS	L AY N B AE K ER Z
LINELIKE	L AY N L AY K
LINKED	L IH NG K T
LINKER	L IH NG K ER
LINKERS	L IH NG K ER Z
LIONLIKE	L AY AH N L AY K
LIPLIKE	L IH P L AY K
LIPSTICKED	L IH P S T IH K T
LOBSTERLIKE	L AA B S T ER L AY K
LOCKED	L AA K T
LOCKER	L AA K ER
LOCKERS	L AA K ER Z
LOCKET	L AA K IH T
LOCKETS	L AA K IH T S
LOCKKEEPER	L AA K IY P ER
LOCKKEEPERS	L AA K IY P ER Z
LOFTLIKE	L AO F T L AY K
LOOKALIKE	L UH K AH L AY K
LOOKALIKES	L UH K AH L AY K S
LOOKED	L UH K T
LOOKER	L UH K ER
LOOKERS	L UH K ER Z
LORDLIKE	L AO R D L AY K
LORIKEET	L AO R AH K IY T
LORIKEETS	L AO R AH K IY T S
LOUDSPEAKER	L AW D S P IY K ER
LOUDSPEAKERS	L AW D S P IY K ER Z
LUCKED	L AH K T
LUKEWARM	L UW K W AO R M
LUKEWARMLY	L UW K W AO R M L IY
LUKEWARMNESS	L UW K W AO R M N AH S
LUKEWARMNESSES	L UW K W AO R M N AH S IH Z
LUNKER	L AH NG K AH R
LUNKERS	L AH NG K AH R Z
LURKED	L ER K T
LURKER	L ER K ER
LURKERS	L ER K ER Z
MACHINELIKE	M AH SH IY N L AY K
MACKEREL	M AE K ER AH L
MACKERELS	M AE K AH R AH L Z
MAFFICKED	M AE F AH K T
MAGICKED	M AE JH IH K T
MAKE	M EY K
MAKEABLE	M EY K AH B AH L
MAKEBATE	M EY K B EY T
MAKEBATES	M EY K B EY T S
MAKEFAST	M EY K F AE S T
MAKEFASTS	M EY K F AE S T S
MAKEOVER	M AE K OW V ER
MAKEOVERS	M AE K OW V ER Z
MAKER	M EY K ER
MAKEREADIES	M EY K R EH D IY Z
MAKEREADY	M EY K R EH D IY
MAKERS	M EY K ER Z
MAKES	M EY K S
MAKESHIFT	M EY K SH IH F T
MAKESHIFTS	M EY K SH IH F T S
MAKEUP	M EY K AH P
MAKEUPS	M EY K AH P S
MAKEWEIGHT	M EY K W EY T
MAKEWEIGHTS	M EY K W EY T S
MALARKEY	M AH L AA R K IY
MALARKEYS	M EY L ER K IY Z
MAMELUKE	M AE M AH L UW K
MAMELUKES	M AE M AH L UW K S
MAMMOCKED	M AE M AH K T
MANDRAKE	M AE N D R EY K
MANDRAKES	M AE N D R EY K S
MANLIKE	M AE N L AY K
MAPLIKE	M AE P L AY K
MAPMAKER	M AE P M EY K ER
MAPMAKERS	M AE P M EY K ER Z
MARCHLIKE	M AA R CH L AY K
MARKED	M AA R K T
MARKEDLY	M AA R K IH D L IY
MARKEDNESS	M AA R K AH D N AH S
MARKEDNESSES	M AA R K AH D N AH S IH Z
MARKER	M AA R K ER
MARKERS	M AA R K ER Z
MARKET	M AA R K AH T
MARKET(2)	M AA R K IH T
MARKETABILITIES	M AA R K AH T AH B IH L AH T EH Z
MARKETABILITY	M AA R K IH T AH B IH L IH T IY
MARKETABLE	M AA R K AH T AH B AH L
MARKETED	M AA R K AH T AH D
MARKETED(2)	M AA R K AH T IH D
MARKETEER	M AA R K AH T IH R
MARKETEERS	M AA R K AH T IH R Z
MARKETER	M AA R K AH T ER
MARKETERS	M AA R K AH T ER Z
MARKETING	M AA R K AH T IH NG
MARKETINGS	M AA R K AH T IH NG Z
MARKETPLACE	M AA R K AH T P L EY S
MARKETPLACE(2)	M AA R K IH T P L EY S
MARKETPLACES	M AA R K AH T P L EY S IH Z
MARKETS	M AA R K AH T S
MARKETS(2)	M AA R K IH T S
MARLINESPIKE	M AA R L AY N S P AY K
MARLINESPIKES	M AA R L AY N S P AY K S
MARLINSPIKE	M AA R L AH N S P AY K
MARLINSPIKES	M AA R L AH N S P AY K S
MASKED	M AE S K T
MASKEG	M AA Z K EH G
MASKEGS	M AA Z K EH G Z
MASKER	M AE S K ER
MASKERS	M AE S K ER Z
MASKLIKE	M AE S K L AY K
MASTERSTROKE	M AE S T ER S T R OW K
MASTERSTROKES	M AE S T ER S T R OW K S
MASTLIKE	M AE S T L AY K
MATCHMAKER	M AE CH M EY K ER
MATCHMAKERS	M AE CH M EY K ER Z
MAZELIKE	M EY Z L AY K
MEDEVACKED	M EH D AH V AH K T
MEEKER	M IY K ER
MEEKEST	M IY K AH S T
MERRYMAKER	M EH R IY M EY K ER
MERRYMAKERS	M EH R IY M EY K ER Z
METALWORKER	M EH T AH L W ER K ER
METALWORKERS	M EH T AH L W ER K ER Z
MICKEY	M IH K IY
MICKEYS	M IH K EY Z
MICROEARTHQUAKE	M AY K R OW ER TH K W EY K
MICROEARTHQUAKES	M AY K R OW ER TH K W EY K S
MICROQUAKE	M AY K R OW K W EY K
MICROQUAKES	M AY K R OW K W EY K S
MIKE	M AY K
MIKED	M AY K T
MIKES	M AY K S
MILKED	M IH L K T
MILKER	M IH L K ER
MILKERS	M IH L K ER Z
MILKSHAKE	M IH L K SH EY K
MILKSHAKES	M IH L K SH EY K S
MILLCAKE	M IH L K EY K
MILLCAKES	M IH L K EY K S
MIMICKED	M IH M IH K T
MIMICKER	M AH M IH K AH R
MIMICKERS	M AH M IH K AH R Z
MINIBIKE	M AH N IY B AH K IY
MINIBIKER	M IH N AH B AY K AH R
MINIBIKERS	M AH N IY B AH K EH R Z
MINIBIKES	M IH N AH B AY K S
MINISTROKE	M IH N IY S T R OW K
MINISTROKES	M IH N IY S T R OW K S
MINKE	M IH NG K
MINKES	M IH NG K S
MIRKER	M AH R K AH R
MIRKEST	M AH R K AH S T
MIRRORLIKE	M IH R ER L AY K
MISCOOKED	M IH S K UH K T
MISKEEP	M IH S K IY P
MISKEEPING	M IH S K IY P IH NG
MISKEEPS	M IH S K IY P S
MISKEPT	M IH S K EH P T
MISKICKED	M IH S K IH K T
MISLIKE	M IH S L AY K
MISLIKED	M IH S L AY K T
MISLIKER	M IH S L AY K ER
MISLIKERS	M IH S L AY K ER Z
MISLIKES	M IH S L AY K S
MISMAKE	M IH S M EY K
MISMAKES	M IH S M EY K S
MISMARKED	M IH S M AA R K T
MISSPOKE	M IH S S P OW K
MISSPOKE(2)	M IH S P OW K
MISSPOKEN	M IH S S P OW K AH N
MISSPOKEN(2)	M IH S P OW K AH N
MISSTRICKEN	M IH S T R IH K AH N
MISSTRIKE	M IH S T R AY K
MISSTRIKES	M IH S T R AY K S
MISTAKE	M IH S T EY K
MISTAKEN	M IH S T EY K AH N
MISTAKENLY	M IH S T EY K AH N L IY
MISTAKER	M IH S T EY K ER
MISTAKERS	M IH S T EY K ER Z
MISTAKES	M IH S T EY K S
MISYOKE	M IH S Y OW K
MISYOKED	M IH S Y OW K T
MISYOKES	M IH S Y OW K S
MOATLIKE	M OW EY T L AY K
MOCKED	M AA K T
MOCKER	M AA K ER
MOCKERIES	M AA K AH R IY Z
MOCKERS	M AA K ER Z
MOCKERY	M AA K ER IY
MOKE	M OW K
MOKES	M OW K S
MONEYMAKER	M AH N IY M EY K ER
MONEYMAKERS	M AH N IY M EY K ER Z
MONICKER	M AH N IH K AH R
MONICKERS	M AH N IH K AH R Z
MONIKER	M AA N IH K ER
MONIKERS	M AA N IH K ER Z
MONKERIES	M AH NG K AH R IY Z
MONKERY	M AH NG K AH R IY
MONKEY	M AH NG K IY
MONKEYED	M AH NG K IY D
MONKEYING	M AH NG K IY IH NG
MONKEYPOD	M AH NG K IY P AA D
MONKEYPODS	M AH NG K IY P AA D Z
MONKEYS	M AH NG K IY Z
MONKEYSHINE	M AH NG K IY SH AY N
MONKEYSHINES	M AH NG K IY SH AY N Z
MOONLIKE	M UW N L AY K
MOONQUAKE	M UW N K W EY K
MOONQUAKES	M UW N K W EY K S
MOPOKE	M AH P OW K
MOPOKES	M AH P OW K S
MOSAICKED	M OW Z EY IH K T
MOSAICLIKE	M OW Z EY IH K L AY K
MOSSBACKED	M AO S B AE K T
MOSSLIKE	M AO S L AY K
MOTHERFUCKER	M AH DH ER F AH K ER
MOTHERFUCKERS	M AH DH ER F AH K ER Z
MOTHLIKE	M AO TH L AY K
MOTORBIKE	M OW T ER B AY K
MOTORBIKED	M AA T AH R B AY K T
MOTORBIKES	M OW T ER B AY K S
MOUNTEBANKED	M AW N T AH B AH NG K T
MOUNTEBANKERIES	M AW N T AH B AE NG K AH R AY Z
MOUNTEBANKERY	M AW N T AH B AH NG K EH R IY
MOUTHLIKE	M AW TH L AY K
MOVIEMAKER	M UW V IY M EY K ER
MOVIEMAKERS	M UW V IY M EY K ER Z
MUCKED	M AH K T
MUCKER	M AH K ER
MUCKERS	M AH K ER Z
MUCKRAKE	M AH K R EY K
MUCKRAKED	M AH K R EY K T
MUCKRAKER	M AH K R EY K ER
MUCKRAKERS	M AH K R EY K ER Z
MUCKRAKES	M AH K R EY K S
MULTITASKED	M AH L T AY T AE S K T
MULTITRACKED	M AH L T AY T R AE K T
MURKER	M ER K ER
MURKEST	M ER K AH S T
MUSCULOSKELETAL	M AH S Y AH L AA S EH L AH T AH L
MUSKEG	M AH S AH G
MUSKEGS	M AH S AH G Z
MUSKELLUNGE	M AH S EH L AH N JH
MUSKELLUNGES	M AH S EH L AH N JH AH Z
MUSKET	M AH S K AH T
MUSKETEER	M AH S K AH T IY R
MUSKETEERS	M AH S K AH T IY R Z
MUSKETRIES	M AH S K AH T R IY Z
MUSKETRY	M AH S K AH T R IY
MUSKETS	M AH S K AH T S
MUSPIKE	M AH S AY K
MUSPIKES	M AH S AY K S
MYTHMAKER	M IH TH M EY K ER
MYTHMAKERS	M IH TH M EY K ER Z
NAKED	N EY K AH D
NAKEDER	N EY K AH D ER
NAKEDEST	N EY K AH D AH S T
NAKEDLY	N EY K AH D L IY
NAKEDNESS	N EY K AH D N AH S
NAKEDNESSES	N EY K AH D N AH S IH Z
NAMESAKE	N EY M S EY K
NAMESAKES	N EY M S EY K S
NANKEEN	N AE NG K IY AH N
NANKEENS	N AE NG K IY N Z
NARKED	N AA R K T
NEBENKERN	N AH B EH NG K AH R N
NEBENKERNS	N AH B EH NG K AH R N Z
NECKED	N EH K T
NECKER	N EH K ER
NECKERCHIEF	N EH K ER CH IY F
NECKERCHIEFS	N EH K ER CH IY F S
NECKERCHIEVES	N EH K AH R CH IY V Z
NECKERS	N EH K ER Z
NECKLIKE	N EH K L AY K
NEEDLELIKE	N IY D AH L L AY K
NEEDLEWORKER	N IY D AH L W ER K ER
NEEDLEWORKERS	N IY D AH L W ER K ER Z
NESTLIKE	N EH S T L AY K
NETLIKE	N EH T L AY K
NETSUKE	N EH T S UW K
NETSUKES	N EH T S UW K S
NETWORKED	N EH T W ER K T
NEWMARKET	N UW M AA R K AH T
NEWMARKETS	N UW M AA R K AH T S
NEWSMAKER	N UW Z M EY K ER
NEWSMAKERS	N UW Z M EY K ER Z
NIBLIKE	N IH B L AY K
NICKED	N IH K T
NICKEL	N IH K AH L
NICKELED	N IH K AH L D
NICKELIC	N IH K AH L IH K
NICKELIFEROUS	N IH K AH L IH F AH R AH S
NICKELING	N IH K AH L IH NG
NICKELLED	N IH K AH L D
NICKELLING	N IH K AH L IH NG
NICKELODEON	N IH K IH L OW D IY AH N
NICKELODEONS	N IH K AH L OW D IY AH N Z
NICKELS	N IH K AH L Z
NICKER	N IH K ER
NICKERED	N IH K ER D
NICKERING	N IH K ER IH NG
NICKERS	N IH K ER Z
NIGHTWALKER	N AY T W AO K ER
NIGHTWALKERS	N AY T W AO K ER Z
NITPICKED	N IH T AH K T
NITPICKER	N IH T IH K AH R
NITPICKERS	N IH T IH K AH R Z
NOCKED	N AA K T
NOISEMAKER	N OY Z M EY K ER
NOISEMAKERS	N OY Z M EY K ER Z
NONDRINKER	N AA N D R IH NG K ER
NONDRINKERS	N AA N D R IH NG K ER Z
NONMARKET	N AA N M AA R K AH T
NONSKED	N AA N S T
NONSKEDS	N AA N S EH D Z
NONSKELETAL	N AA N S K EH L AH T AH L
NONSMOKER	N AA N S M OW K ER
NONSMOKERS	N AA N S M OW K ER Z
NONSPEAKER	N AA N S P IY K ER
NONSPEAKERS	N AA N S P IY K ER Z
NONWORKER	N AA N W ER K ER
NONWORKERS	N AA N W ER K ER Z
NOOKLIKE	N UH K L AY K
NOSELIKE	N OW Z L AY K
NOVALIKE	N OW V AH L AY K
NUKE	N UW K
NUKED	N Y UW K T
NUKES	N UW K S
NUNLIKE	N AH N L AY K
NUTCRACKER	N AH T K R AE K ER
NUTCRACKERS	N AH T K R AE K ER Z
NUTLIKE	N AH T L AY K
OAKEN	OW K AH N
OAKLIKE	OW K L AY K
OARLIKE	OW R L AY K
OATCAKE	OW T K EY K
OATCAKES	OW T K EY K S
OATLIKE	OW T L AY K
OCKER	AA K ER
OCKERS	AA K AH R Z
ODDSMAKER	AA D Z M EY K ER
ODDSMAKERS	AA D Z M EY K ER Z
OFFKEY	AO F K IY
OINKED	OY NG K T
OKE	OW K
OKEH	AA K
OKEHS	AA K AH Z
OKES	OW K S
OKEYDOKE	OW K AH D OW K
OKEYDOKEY	OW K AH D OW K IY
OMPHALOSKEPSES	AA M F AH L AA S EH P S AH Z
OMPHALOSKEPSIS	AA M F AH L AA S EH P S AH S
ONLOOKER	AO N L UH K ER
ONLOOKERS	AO N L UH K ER Z
ORCHIDLIKE	AO R K AH D L AY K
OSTRICHLIKE	AA S T R AH CH L AY K
OUTASKED	AW T AE S K T
OUTBAKE	AW T B EY K
OUTBAKED	AW T B EY K T
OUTBAKES	AW T B EY K S
OUTBARKED	AW T B AA R K T
OUTBULKED	AW T B AH L K T
OUTCOOKED	AW T K UH K T
OUTFLANKED	AW T F L AE NG K T
OUTKEEP	AW T K IY P
OUTKEEPING	AW T K IY P IH NG
OUTKEEPS	AW T K IY P S
OUTKEPT	AW T K EH P T
OUTKICKED	AW T K IH K T
OUTPOLITICKED	AW T P AA L AH T IH K T
OUTRANKED	AW T R AE NG K T
OUTROCKED	AW T R AA K T
OUTSLICKED	AW T S L IH K T
OUTSMOKE	AW T S M OW K
OUTSMOKED	AW T S M OW K T
OUTSMOKES	AW T S M OW K S
OUTSPOKE	AW T S P OW K
OUTSPOKEN	AW T S P OW K AH N
OUTSPOKENLY	AW T S P OW K AH N L IY
OUTSPOKENNESS	AW T S P OW K AH N AH S
OUTSPOKENNESSES	AW T S P OW K AH N AH S IH Z
OUTSULKED	AW T S AH L K T
OUTTAKE	AW T T EY K
OUTTAKE(2)	AW T EY K
OUTTAKES	AW T T EY K S
OUTTAKES(2)	AW T EY K S
OUTTALKED	AW T AO K T
OUTTASKED	AW T AE S K T
OUTTHANKED	AW T TH AE NG K T
OUTTRICKED	AW T R IH K T
OUTWALKED	AW T W AO K T
OUTWORKED	AW T W ER K T
OUTWORKER	AW T W ER K ER
OUTWORKERS	AW T W ER K ER Z
OVENLIKE	AH V AH N L AY K
OVERBAKE	OW V ER B EY K
OVERBAKED	OW V ER B EY K T
OVERBAKES	OW V ER B EY K S
OVERBOOKED	OW V ER B UH K T
OVERCOOKED	OW V ER K UH K T
OVERDECKED	OW V ER D EH K T
OVERKEEN	OW V ER K IY N
OVERLOOKED	OW V ER L UH K T
OVERMILKED	OW V ER M IH L K T
OVERSMOKE	OW V ER S M OW K
OVERSMOKED	OW V ER S M OW K T
OVERSMOKES	OW V ER S M OW K S
OVERSOAKED	OW V ER S OW K T
OVERSTOCKED	OW V ER S T AA K T
OVERSTRIKE	OW V ER S T R AY K
OVERSTRIKES	OW V ER S T R AY K S
OVERTAKE	OW V ER T EY K
OVERTAKEN	OW V ER T EY K AH N
OVERTAKES	OW V ER T EY K S
OVERTALKED	OW V ER T AO K T
OVERTASKED	OW V ER T AE S K T
OVERWORKED	OW V ER W ER K T
OWLLIKE	AW L AY K
OXPECKER	AA K S P EH K ER
OXPECKERS	AA K S P EH K ER Z
OZOKERITE	AH Z AA K AH R AY T
OZOKERITES	AH Z AA K AH R AY T S
PACEMAKER	P EY S M EY K ER
PACEMAKERS	P EY S M EY K ER Z
PACKED	P AE K T
PACKER	P AE K ER
PACKERS	P AE K ER Z
PACKET	P AE K AH T
PACKET(2)	P AE K IH T
PACKETED	P AE K AH T IH D
PACKETING	P AE K AH T IH NG
PACKETS	P AE K IH T S
PADDOCKED	P AE D AH K T
PADLOCKED	P AE D L AA K T
PAIKED	P EY K T
PAKEHA	P AH K EY HH AA
PAKEHAS	P AE K AH HH AH Z
PALMLIKE	P AA M L AY K
PANCAKE	P AE N K EY K
PANCAKED	P AE N K EY K T
PANCAKES	P AE N K EY K S
PANICKED	P AE N IH K T
PAPERBACKED	P EY P ER B AE K T
PAPERMAKER	P EY P ER M EY K ER
PAPERMAKERS	P EY P ER M EY K ER Z
PARAKEET	P EH R AH K IY T
PARAKEETS	P EH R AH K IY T S
PARKED	P AA R K T
PARKER	P AA R K ER
PARKERS	P AA R K ER Z
PARKLIKE	P AA R K L AY K
PARRAKEET	P AE R AH K IY T
PARRAKEETS	P AE R AH K IY T S
PARROKET	P AE R AH K AH T
PARROKETS	P AE R AH K AH T S
PARTAKE	P AA R T EY K
PARTAKEN	P AA R T EY K AH N
PARTAKER	P AA R T EY K ER
PARTAKERS	P AA R T EY K ER Z
PARTAKES	P AA R T EY K S
PASSKEY	P AE S K IY
PASSKEYS	P AE S K IY Z
PAWNBROKER	P AO N B R OW K ER
PAWNBROKERS	P AO N B R OW K ER Z
PEACEKEEPER	P IY S K IY P ER
PEACEKEEPERS	P IY S K IY P ER Z
PEACEKEEPING	P IY S K IY P IH NG
PEACEKEEPINGS	P IY S K IY P IH NG Z
PEACEMAKER	P IY S M EY K ER
PEACEMAKERS	P IY S M EY K ER Z
PEACOCKED	P IY K AA K T
PEAKED	P IY K T
PEAKEDNESS	P IY K AH D N AH S
PEAKEDNESSES	P IY K AH D N AH S IH Z
PEAKLIKE	P IY K L AY K
PEALIKE	P IY L AY K
PECKED	P EH K T
PECKER	P EH K ER
PECKERS	P EH K ER Z
PECKERWOOD	P EH K ER W UH D
PECKERWOODS	P EH K ER W UH D Z
PEEKED	P IY K T
PEGLIKE	P EH G L AY K
PEKE	P IY K
PEKES	P IY K S
PERKED	P ER K T
PERNICKETY	P AH R N IH K AH T IY
PERSNICKETINESS	P AH R S N IH K EH T AH N AH S
PERSNICKETINESSES	P AH R S N IH K EH T AH N EH S AH Z
PERSNICKETY	P AH R S N IH K AH T IY
PERUKE	P AH R Y UW K IY
PERUKED	P AH R Y UW K T
PERUKES	P AH R Y UW K S
PETALLIKE	P EH T AH L AY K
PHANTOMLIKE	F AE N T AH M L AY K
PHENYLKETONURIA	F AH N IH L K AH T AH N Y UH R IY AH
PHENYLKETONURIAS	F AH N IH L K AH T AH N Y UH R IY AH Z
PHENYLKETONURIC	F AH N IH L K AH T AA N Y AH R AH K
PHENYLKETONURICS	F AH N IH L K AH T AA N Y AH R AH S Z
PHOENIXLIKE	F IY N IH K S L AY K
PHRASEMAKER	F R EY Z M EY K ER
PHRASEMAKERS	F R EY Z M EY K ER Z
PHYSICKED	F IH S AH K T
PICKABACKED	P IH K AH B AE K T
PICKED	P IH K T
PICKEER	P IH K IH R
PICKEERED	P IH K IH R D
PICKEERING	P IH K IH R IH NG
PICKEERS	P IH K IH R Z
PICKER	P IH K ER
PICKEREL	P IH K ER AH L
PICKERELS	P IH K AH R AH L Z
PICKERELWEED	P IH K AH R EH L W IY D
PICKERELWEEDS	P IH K EH R AH L W IY D Z
PICKERS	P IH K ER Z
PICKET	P IH K IH T
PICKETBOAT	P IH K AH T B OW T
PICKETBOATS	P IH K AH T B OW T S
PICKETED	P IH K AH T IH D
PICKETER	P IH K AH T ER
PICKETERS	P IH K AH T ER Z
PICKETING	P IH K AH T IH NG
PICKETS	P IH K AH T S
PICKPOCKET	P IH K P AA K AH T
PICKPOCKETS	P IH K P AA K AH T S
PICNICKED	P IH K N IH K T
PICNICKER	P IH K N IH K ER
PICNICKERS	P IH K N IH K ER Z
PIECEWORKER	P IY S W ER K ER
PIECEWORKERS	P IY S W ER K ER Z
PIGGYBACKED	P IH G IY B AE K T
PIGLIKE	P IH G L AY K
PIGSTICKED	P IH G S T IH K T
PIGSTICKER	P IH G S T IH K ER
PIGSTICKERS	P IH G S T IH K ER Z
PIKAKE	P AH K EY K
PIKAKES	P AH K EY K S
PIKE	P AY K
PIKED	P AY K T
PIKEMAN	P AY K M AE N
PIKEMEN	P AY K M EH N
PIKER	P AY K ER
PIKERS	P AY K ER Z
PIKES	P AY K S
PIKESTAFF	P AY K S T AE F
PIKESTAFFS	P AY K S T AE F S
PIKESTAVES	P AY K S T EY V Z
PINCERLIKE	P IH N S ER L AY K
PINELIKE	P AY N L AY K
PINKED	P IH NG K T
PINKEN	P IH NG K AH N
PINKENED	P IH NG K AH N D
PINKENING	P IH NG K AH N IH NG
PINKENS	P IH NG K AH N Z
PINKER	P IH NG K ER
PINKERS	P IH NG K ER Z
PINKEST	P IH NG K IH S T
PINKEY	P IH N K IY
PINKEYE	P IH NG K AY
PINKEYES	P IH NG K AY Z
PINKEYS	P IH N K IY Z
PINPRICKED	P IH N P R IH K T
PIPELIKE	P AY P L AY K
PITCHFORKED	P IH CH F AO R K T
PIZZALIKE	P IY T S AH L AY K
PLACEKICKED	P L EY S K IH K T
PLACEKICKER	P L EY S K IH K ER
PLACEKICKERS	P L EY S K IH K ER Z
PLACKET	P L AE K AH T
PLACKETS	P L AE K AH T S
PLAINSPOKEN	P L EY N S P OW K AH N
PLAINSPOKENNESS	P L EY N S P OW K AH N AH S
PLAINSPOKENNESSES	P L EY N S P OW K AH N AH S IH Z
PLANETLIKE	P L AE N AH T L AY K
PLANKED	P L AE NG K T
PLANTLIKE	P L AE N T L AY K
PLATELIKE	P L EY T L AY K
PLATEMAKER	P L EY T M EY K ER
PLATEMAKERS	P L EY T M EY K ER Z
PLAYLIKE	P L EY L AY K
PLAYMAKER	P L EY M EY K ER
PLAYMAKERS	P L EY M EY K ER Z
PLINKED	P L IH NG K T
PLINKER	P L IH NG K ER
PLINKERS	P L IH NG K ER Z
PLONKED	P L AO NG K T
PLUCKED	P L AH K T
PLUCKER	P L AH K ER
PLUCKERS	P L AH K ER Z
PLUMLIKE	P L AH M L AY K
PLUNKED	P L AH NG K T
PLUNKER	P L AH NG K ER
PLUNKERS	P L AH NG K ER Z
POCKED	P AA K T
POCKET	P AA K AH T
POCKETABLE	P AA K AH T AH B AH L
POCKETBOOK	P AA K AH T B UH K
POCKETBOOKS	P AA K AH T B UH K S
POCKETED	P AA K AH T IH D
POCKETER	P AA K AH T ER
POCKETERS	P AA K AH T ER Z
POCKETFUL	P AA K AH T F UH L
POCKETFULS	P AA K AH T F UH L Z
POCKETING	P AA K AH T IH NG
POCKETKNIFE	P AA K AH T N AY F
POCKETKNIVES	P AA K AH T N AY V Z
POCKETS	P AA K AH T S
POCKETSFUL	P AA K AH T S F AH L
POCKMARKED	P AA K M AA R K T
PODLIKE	P AA D L AY K
POETLIKE	P OW AH T L AY K
POKE	P OW K
POKEBERRIES	P OW K B EH R IY Z
POKEBERRY	P OW K B EH R IY
POKED	P OW K T
POKER	P OW K ER
POKEROOT	P OW K R UW T
POKEROOTS	P OW K R UW T S
POKERS	P OW K ER Z
POKES	P OW K S
POKEWEED	P OW K W IY D
POKEWEEDS	P OW K W IY D Z
POKEY	P OW K IY
POKEYS	P OW K IY Z
POLITICKED	P AA L AH T IH K T
POLITICKER	P AA L AH T IH K ER
POLITICKERS	P AA L AH T IH K ER Z
POPELIKE	P OW P L AY K
PORCELAINLIKE	P OW R S AH L AH N L AY K
PORKER	P AO R K ER
PORKERS	P AO R K ER Z
POSTCARDLIKE	P OW S T K AA R D L AY K
POSTMARKED	P OW S T M AA R K T
POSTSTRIKE	P OW S T S T R AY K
POTLIKE	P OW T L AY K
POWDERLIKE	P AW D ER L AY K
POWERBROKER	P AW ER B R OW K ER
POWERBROKERS	P AW ER B R OW K ER Z
PRANKED	P R AE NG K T
PREBAKE	P R IY B EY K
PREBAKED	P R IY B EY K T
PREBAKES	P R IY B EY K S
PREBOOKED	P R IY B UH K T
PRECHECKED	P R IY CH EH K T
PRECOOKED	P R IY K UH K T
PREFRANKED	P R IY F R AE NG K T
PREMARKET	P R IY M AA R K AH T
PREMARKETING	P R IY M AA R K AH T IH NG
PREMARKETINGS	P R IY M AA R K AH T IH NG Z
PREPACKED	P R IY P AE K T
PRESHRUNKEN	P R IY SH R AH NG K AH N
PRESOAKED	P R IY S OW K T
PRESTRIKE	P R IY S T R AY K
PRICKED	P R IH K T
PRICKER	P R IH K ER
PRICKERS	P R IH K ER Z
PRICKET	P R IH K AH T
PRICKETS	P R IH K AH T S
PRINKED	P R IH NG K T
PRINKER	P R IH NG K AH R
PRINKERS	P R IH NG K AH R Z
PRINTMAKER	P R IH N T M EY K ER
PRINTMAKERS	P R IH N T M EY K ER Z
PROVOKE	P R AH V OW K
PROVOKED	P R AH V OW K T
PROVOKER	P R AH V OW K ER
PROVOKERS	P R AH V OW K ER Z
PROVOKES	P R AH V OW K S
PUCKER	P AH K ER
PUCKERED	P AH K ER D
PUCKERER	P AH K ER ER
PUCKERERS	P AH K ER ER Z
PUCKERIER	P AH K AH R IY ER
PUCKERIEST	P AH K AH R IY AH S T
PUCKERING	P AH K ER IH NG
PUCKERS	P AH K ER Z
PUCKERY	P AH K AH R IY
PUKE	P Y UW K
PUKED	P Y UW K T
PUKES	P Y UW K S
PUMPERNICKEL	P AH M P ER N IH K AH L
PUMPERNICKELS	P AH M P ER N IH K AH L Z
PUMPLIKE	P AH M P L AY K
PUNKER	P AH NG K ER
PUNKERS	P AH NG K ER Z
PUNKEST	P AH NG K AH S T
PUNKEY	P AH N K IY
PUNKEYS	P AH N K IY Z
PUPPETLIKE	P AH P AH T L AY K
PUPPYLIKE	P AH P IY L AY K
PURSELIKE	P ER S L AY K
PUSLIKE	P AH Z L AY K
PUSSLIKE	P AH S L AY K
PUTTYLIKE	P AH T IY L AY K
QUACKED	K W AE K T
QUACKERIES	K W AE K AH R IY Z
QUACKERY	K W AE K ER IY
QUAKE	K W EY K
QUAKED	K W EY K T
QUAKER	K W EY K ER
QUAKERS	K W EY K ER Z
QUAKES	K W EY K S
QUARTERBACKED	K W AO R T ER B AE K T
QUAYLIKE	K W EY L AY K
QUICKEN	K W IH K AH N
QUICKENED	K W IH K AH N D
QUICKENER	K W IH K AH N ER
QUICKENERS	K W IH K AH N ER Z
QUICKENING	K W IH K AH N IH NG
QUICKENS	K W IH K AH N Z
QUICKER	K W IH K ER
QUICKEST	K W IH K IH S T
QUIRKED	K W ER K T
RACETRACKER	R EY S T R AE K ER
RACETRACKERS	R EY S T R AE K ER Z
RACEWALKER	R EY S W AO K ER
RACEWALKERS	R EY S W AO K ER Z
RACKED	R AE K T
RACKER	R AE K ER
RACKERS	R AE K ER Z
RACKET	R AE K IH T
RACKETED	R AE K AH T IH D
RACKETEER	R AE K IH T IH R
RACKETEERED	R AE K AH T IH R D
RACKETEERING	R AE K IH T IH R IH NG
RACKETEERS	R AE K AH T IH R Z
RACKETIER	R AE K AH T IY ER
RACKETIEST	R AE K AH T IY AH S T
RACKETING	R AE K AH T IH NG
RACKETS	R AE K AH T S
RACKETY	R AE K AH T IY
RAGPICKER	R AE G P IH K ER
RAGPICKERS	R AE G P IH K ER Z
RAINBOWLIKE	R EY N B AW L AY K
RAINMAKER	R EY N M EY K ER
RAINMAKERS	R EY N M EY K ER Z
RAKE	R EY K
RAKED	R EY K T
RAKEE	R EY K IY
RAKEES	R EY K IY Z
RAKEHELL	R EY K HH EH L
RAKEHELLS	R EY K HH EH L Z
RAKEHELLY	R EY K HH EH L IY
RAKEOFF	R EY K AO F
RAKEOFFS	R EY K AO F S
RAKER	R EY K ER
RAKERS	R EY K ER Z
RAKES	R EY K S
RAMPIKE	R AE M P AY K
RAMPIKES	R AE M P AY K S
RANKED	R AE NG K T
RANKER	R AE NG K ER
RANKERS	R AE NG K ER Z
RANKEST	R AE NG K AH S T
RANPIKE	R AE N P AY K
RANPIKES	R AE N P AY K S
RANSACKED	R AE N S AE K T
RANSACKER	R AE N S AE K ER
RANSACKERS	R AE N S AE K ER Z
RASHLIKE	R AE SH L AY K
RATHSKELLER	R AE TH S K EH L ER
RATHSKELLERS	R AE TH S EH L AH R Z
RATLIKE	R AE T L AY K
RATTLESNAKE	R AE T AH L S N EY K
RATTLESNAKES	R AE T AH L S N EY K S
RAYLIKE	R EY L AY K
REATTACKED	R IY AH T AE K T
REAWAKE	R IY AH W EY K
REAWAKED	R IY AH W EY K T
REAWAKEN	R IY AH W EY K AH N
REAWAKENED	R IY AH W EY K AH N D
REAWAKENING	R IY AH W EY K AH N IH NG
REAWAKENS	R IY AH W EY K AH N Z
REAWAKES	R IY AH W EY K S
REAWOKE	R IY AH W OW K
REAWOKEN	R IY AH W OW K AH N
REBOOKED	R IY B UH K T
REBUKE	R IY B Y UW K
REBUKE(2)	R IH B Y UW K
REBUKED	R IH B Y UW K T
REBUKED(2)	R IY B Y UW K T
REBUKER	R IH B Y UW K ER
REBUKERS	R IH B Y UW K ER Z
REBUKES	R IY B Y UW K S
RECHECKED	R IY CH EH K T
RECKED	R EH K T
RECOCKED	R IY K AA K T
RECOOKED	R IY K UH K T
RECORKED	R IY K AO R K T
REDNECKED	R EH D N EH K T
REDOCKED	R IY D AA K T
REEDLIKE	R IY D L AY K
REEKED	R IY K T
REEKER	R IY K ER
REEKERS	R IY K ER Z
REEMBARKED	R IY IH M B AA R K T
REEVOKE	R IY IH V OW K
REEVOKED	R IY IH V OW K T
REEVOKES	R IY IH V OW K S
REINKED	R IY IH NG K T
REINVOKE	R IY IH N V OW K
REINVOKED	R IY IH N V OW K T
REINVOKES	R IY IH N V OW K S
REJACKET	R IY JH AE K AH T
REJACKETED	R IY JH AE K AH T IH D
REJACKETING	R IY JH AE K AH T IH NG
REJACKETS	R IY JH AE K AH T S
REKEY	R IY K IY
REKEYBOARD	R IY K IY B OW R D
REKEYBOARDED	R IY K IY B OW R D IH D
REKEYBOARDING	R IY K IY B OW R D IH NG
REKEYBOARDS	R IY K IY B OW R D Z
REKEYED	R IY K IY D
REKEYING	R IY K IY IH NG
REKEYS	R IY K IY Z
RELINKED	R IY L IH NG K T
RELOCKED	R IY L AA K T
RELOOKED	R IY L UH K T
REMAKE	R IY M EY K
REMAKER	R IY M EY K ER
REMAKERS	R IY M EY K ER Z
REMAKES	R IY M EY K S
REMARKED	R IH M AA R K T
REMARKED(2)	R IY M AA R K T
REMARKER	R IH M AA R K ER
REMARKERS	R IH M AA R K ER Z
REMARKET	R IY M AA R K AH T
REMARKETED	R IY M AA R K AH T IH D
REMARKETING	R IY M AA R K AH T IH NG
REMARKETS	R IY M AA R K AH T S
REPACKED	R IY P AE K T
REPARKED	R IY P AA R K T
REPERKED	R IY P ER K T
RERACKED	R IY R AE K T
RESKETCH	R IY S K EH CH
RESKETCHED	R IY S K EH CH T
RESKETCHES	R IY S K EH CH IH Z
RESKETCHING	R IY S K EH CH IH NG
RESOAKED	R IY S OW K T
RESPOKE	R IY S P OW K
RESPOKEN	R IY S P OW K AH N
RESTACKED	R IY S T AE K T
RESTOCKED	R IY S T AA K T
RESTOKE	R IY S T OW K
RESTOKED	R IY S T OW K T
RESTOKES	R IY S T OW K S
RESTRICKEN	R IY S T R IH K AH N
RESTRIKE	R IY S T R AY K
RESTRIKES	R IY S T R AY K S
RETACKED	R IY T AE K T
RETAKE	R IY T EY K
RETAKEN	R IY T EY K AH N
RETAKER	R IY T EY K ER
RETAKERS	R IY T EY K ER Z
RETAKES	R IY T EY K S
RETHINKER	R IY TH IH NG K ER
RETHINKERS	R IY TH IH NG K ER Z
RETRACKED	R IY T R AE K T
RETROROCKET	R IH T R AH R AA K AH T
RETROROCKETS	R IH T R AH R AA K AH T S
REVOKE	R IH V OW K
REVOKE(2)	R IY V OW K
REVOKED	R IH V OW K T
REVOKED(2)	R IY V OW K T
REVOKER	R IH V OW K ER
REVOKERS	R IH V OW K ER Z
REVOKES	R IH V OW K S
REWAKE	R IY W EY K
REWAKED	R IY W EY K T
REWAKEN	R IY W EY K AH N
REWAKENED	R IY W EY K AH N D
REWAKENING	R IY W EY K AH N IH NG
REWAKENS	R IY W EY K AH N Z
REWAKES	R IY W EY K S
REWOKE	R IY W OW K
REWOKEN	R IY W OW K AH N
REWORKED	R IY W ER K T
RIBBONLIKE	R IH B AH N L AY K
RIBLIKE	R IH B L AY K
RICKED	R IH K T
RICKETIER	R IH K AH T IY ER
RICKETIEST	R IH K AH T IY AH S T
RICKETS	R IH K IH T S
RICKETTSIA	R IH K EH T S IY AH
RICKETTSIAE	R IH K EH T S IY IY
RICKETTSIAL	R IH K EH T S IY AH L
RICKETTSIAS	R IH K EH T S IY AH Z
RICKETY	R IH K AH T IY
RICKEY	R IH K IY
RICKEYS	R IH K IY Z
RINGBARKED	R IH NG B AA R K T
RINGLIKE	R IH NG L AY K
RINGSTRAKED	R IH N G S T R EY K T
RISKED	R IH S K T
RISKER	R IH S K ER
RISKERS	R IH S K ER Z
ROADBLOCKED	R OW D B L AA K T
ROCKED	R AA K T
ROCKER	R AA K ER
ROCKERIES	R AA K AH R IY Z
ROCKERS	R AA K ER Z
ROCKERY	R AA K AH R IY
ROCKET	R AA K AH T
ROCKETED	R AA K AH T IH D
ROCKETEER	R AA K AH T IH R
ROCKETEERS	R AA K AH T IH R Z
ROCKETER	R AA K AH T ER
ROCKETERS	R AA K AH T ER Z
ROCKETING	R AA K AH T IH NG
ROCKETRIES	R AA K AH T R IY Z
ROCKETRY	R AA K AH T R IY
ROCKETS	R AA K AH T S
ROCKLIKE	R AA K L AY K
RODLIKE	R AA D L AY K
ROLLICKED	R AA L IH K T
ROOFLIKE	R UW F L AY K
ROOKED	R UH K T
ROOKERIES	R UH K AH R AY Z
ROOKERY	R AH K EH R IY
ROOTLIKE	R UW T L AY K
ROPELIKE	R OW P L AY K
ROPEWALKER	R OW P W AO K ER
ROPEWALKERS	R OW P W AO K ER Z
ROSELIKE	R OW Z L AY K
RUBBERLIKE	R AH B ER L AY K
RUBBERNECKED	R AH B ER N EH K T
RUBBERNECKER	R AH B ER N EH K ER
RUBBERNECKERS	R AH B ER N EH K ER Z
RUBYLIKE	R UW B IY L AY K
RUCKED	R AH K T
RUFFLIKE	R AH F L AY K
RUGLIKE	R AH G L AY K
RUNELIKE	R UW N L AY K
RUSHLIKE	R AH SH L AY K
RYKE	R AY K
RYKED	R AY K T
RYKES	R AY K S
SACKED	S AE K T
SACKER	S AE K ER
SACKERS	S AE K ER Z
SACKLIKE	S AE K L AY K
SACLIKE	S AE K L AY K
SAFECRACKER	S EY F K R AE K ER
SAFECRACKERS	S EY F K R AE K ER Z
SAFEKEEPING	S EY F K IY P IH NG
SAFEKEEPINGS	S EY F K IY P IH NG Z
SAINTLIKE	S EY N T L AY K
SAKE	S EY K
SAKER	S EY K ER
SAKERS	S EY K ER Z
SAKES	S EY K S
SALTLIKE	S AO L T L AY K
SALTSHAKER	S AO L T SH EY K ER
SALTSHAKERS	S AO L T SH EY K ER Z
SAMBUKE	S AE M B Y UW K
SAMBUKES	S AE M B Y UW K S
SANDLIKE	S AE N D L AY K
SAPSUCKER	S AE P S AH K ER
SAPSUCKERS	S AE P S AH K ER Z
SAUCERLIKE	S AO S ER L AY K
SAWLIKE	S AO L AY K
SCABLIKE	S K AE B L AY K
SCALELIKE	S K EY L AY K
SCHIPPERKE	S K IH P AH R K
SCHIPPERKES	S K IH P AH R K S
SCHNECKE	S K N EH K
SCHNECKEN	S K N EH K AH N
SCHNORKEL	S K N AO R K AH L
SCHNORKELED	S K N AO R K IY L D
SCHNORKELING	S K N AO R K IY L AH NG
SCHNORKELS	S K N AO R K AH L Z
SCOREKEEPER	S K AO R K IY P ER
SCOREKEEPERS	S K AO R K IY P ER Z
SCREAKED	S K R IY K T
SCREWLIKE	S K R UW L AY K
SCULKED	S K AH K T
SCULKER	S K AH K AH R
SCULKERS	S K AH L K AH R Z
SCUMLIKE	S K AH M L AY K
SEALLIKE	S IY L AY K
SEAMANLIKE	S IY M AE N L AY K
SEAMLIKE	S IY M L AY K
SEAQUAKE	S IY K W EY K
SEAQUAKES	S IY K W EY K S
SEEDCAKE	S IY D K EY K
SEEDCAKES	S IY D K EY K S
SEEDLIKE	S IY D L AY K
SEEKER	S IY K ER
SEEKERS	S IY K ER Z
SEERSUCKER	S IH ER S AH K ER
SEERSUCKERS	S IH ER S AH K ER Z
SERFLIKE	S ER F L AY K
SHADOWLIKE	SH AE D OW L AY K
SHAKE	SH EY K
SHAKEABLE	SH EY K AH B AH L
SHAKEDOWN	SH EY K D AW N
SHAKEDOWNS	SH EY K D AW N Z
SHAKEN	SH EY K AH N
SHAKEOUT	SH EY K AW T
SHAKEOUTS	SH EY K AW T S
SHAKER	SH EY K ER
SHAKERS	SH EY K ER Z
SHAKES	SH EY K S
SHAKEUP	SH EY K AH P
SHAKEUPS	SH EY K AH P S
SHANKED	SH AE NG K T
SHARKED	SH AA R K T
SHARKER	SH AA R K ER
SHARKERS	SH AA R K ER Z
SHARKLIKE	SH AA R K L AY K
SHEAFLIKE	SH IY F L AY K
SHEDLIKE	SH EH D L AY K
SHEEPLIKE	SH IY P L AY K
SHEETLIKE	SH IY T L AY K
SHEKEL	SH EH K AH L
SHEKELS	SH EH K AH L Z
SHELDRAKE	SH EH L D R EY K
SHELDRAKES	SH EH L D R EY K S
SHELFLIKE	SH EH L F L AY K
SHELLACKED	SH EH L AE K D
SHELLCRACKER	SH EH L K R AE K ER
SHELLCRACKERS	SH EH L K R AE K ER Z
SHELLSHOCKED	SH EH L SH AA K T
SHICKER	SH IH K AH R
SHICKERS	SH IH K AH R Z
SHIITAKE	SH IY T EY K
SHIITAKES	SH IY T EY K S
SHIKKER	SH IH K AH R
SHIKKERS	SH IH K AH R Z
SHIPWRECKED	SH IH P R EH K T
SHIRKED	SH ER K T
SHIRKER	SH ER K ER
SHIRKERS	SH ER K ER Z
SHIRTMAKER	SH ER T M EY K ER
SHIRTMAKERS	SH ER T M EY K ER Z
SHITAKE	SH AH T EY K
SHITAKES	SH AH T EY K S
SHOCKED	SH AA K T
SHOCKER	SH AA K ER
SHOCKERS	SH AA K ER Z
SHOEMAKER	SH UW M EY K ER
SHOEMAKERS	SH UW M EY K ER Z
SHOPKEEPER	SH AA P K IY P ER
SHOPKEEPERS	SH AA P K IY P ER Z
SHORTCAKE	SH AO R T K EY K
SHORTCAKES	SH AO R T K EY K S
SHREWLIKE	SH R UW L AY K
SHRIEKED	SH R IY K T
SHRIEKER	SH R IY K ER
SHRIEKERS	SH R IY K ER Z
SHRIKE	SH R AY K
SHRIKES	SH R AY K S
SHRIMPLIKE	SH R IH M P L AY K
SHRINKER	SH R IH NG K ER
SHRINKERS	SH R IH NG K ER Z
SHRUNKEN	SH R AH NG K AH N
SHUCKED	SH AH K T
SHUCKER	SH AH K ER
SHUCKERS	SH AH K ER Z
SHUNPIKE	SH AH N P AY K
SHUNPIKED	SH AH N P AY K T
SHUNPIKER	SH AH N P AY K ER
SHUNPIKERS	SH AH N P AY K ER Z
SHUNPIKES	SH AH N P AY K S
SHUTTLECOCKED	SH AH T AH L K AA K T
SHYLOCKED	SH AY L AA K T
SICKED	S IH K T
SICKEE	S IH K IY
SICKEES	S IH K IY Z
SICKEN	S IH K AH N
SICKENED	S IH K AH N D
SICKENER	S IH K AH N ER
SICKENERS	S IH K AH N ER Z
SICKENING	S IH K AH N IH NG
SICKENING(2)	S IH K N IH NG
SICKENINGLY	S IH K AH N IH NG L IY
SICKENS	S IH K AH N Z
SICKER	S IH K ER
SICKERLY	S IH K ER L IY
SICKEST	S IH K AH S T
SIDESTROKE	S AY D S T R OW K
SIDESTROKES	S AY D S T R OW K S
SIDETRACKED	S AY D T R AE K T
SIGHLIKE	S AY L AY K
SIKE	S AY K
SIKER	S AY K AH R
SIKES	S AY K S
SILKED	S IH L K T
SILKEN	S IH L K AH N
SILKLIKE	S IH L K L AY K
SINKER	S IH NG K ER
SINKERS	S IH NG K ER Z
SJAMBOKED	S JH AE M B OW K T
SKEAN	S K AE N
SKEANE	S K IY N
SKEANES	S K IY N Z
SKEANS	S K IY N Z
SKEDADDLE	S K EH D AH D AH L
SKEDADDLED	S K EH D AH D AH L D
SKEDADDLER	S K AH D AE D L AH R
SKEDADDLERS	S K AH D AE D L AH R Z
SKEDADDLES	S K EH D AH D AH L Z
SKEDADDLING	S K AH D AE D L AH NG
SKEE	S K IY
SKEED	S K IY D
SKEEING	S K IY AH NG
SKEEN	S K IY N
SKEENS	S K IY N Z
SKEES	S K IY Z
SKEET	S K IY T
SKEETER	S K IY T ER
SKEETERS	S K IY T ER Z
SKEETS	S K IY T S
SKEG	S K EH G
SKEGS	S K EH G Z
SKEIGH	S K EY
SKEIN	S K EY N
SKEINED	S K IY N D
SKEINING	S K IY N AH NG
SKEINS	S K EY N Z
SKELETAL	S K EH L AH T AH L
SKELETALLY	S K EH L AH T AH L IY
SKELETON	S K EH L AH T AH N
SKELETONIC	S K EH L AH T AH N IH K
SKELETONISE	S K AH L EH T AH N AY Z
SKELETONISED	S K EH L AH T AH N IY Z D
SKELETONISES	S K EH L AH T AH N IY Z IH Z
SKELETONISING	S K EH L AH T AH N IY Z IH NG
SKELETONIZE	S K EH L AH T AH N AY Z
SKELETONIZED	S K EH L AH T AH N AY Z D
SKELETONIZER	S K EH L AH T AH N AY Z ER
SKELETONIZERS	S K EH L AH T AH N AY Z ER Z
SKELETONIZES	S K EH L AH T AH N AY Z IH Z
SKELETONIZING	S K EH L AH T AH N AY Z IH NG
SKELETONS	S K EH L AH T AH N Z
SKELLUM	S K EH L AH M
SKELLUMS	S K EH L AH M Z
SKELM	S K EH L M
SKELMS	S K EH L M Z
SKELP	S K EH L P
SKELPED	S K EH L P T
SKELPING	S K EH L P AH NG
SKELPIT	S K EH L P AH T
SKELPS	S K EH L P S
SKELTER	S K EH L T ER
SKELTERED	S K EH L T IY R D
SKELTERING	S K EH L T IY R AH NG
SKELTERS	S K EH L T AH R Z
SKENE	S K IY N
SKENES	S K IY N Z
SKEP	S K EH P
SKEPS	S K EH P S
SKEPSIS	S K EH P S AH S
SKEPSISES	S K EH P S AY Z AH Z
SKEPTIC	S K EH P T IH K
SKEPTICAL	S K EH P T AH K AH L
SKEPTICAL(2)	S K EH P T IH K AH L
SKEPTICALLY	S K EH P T IH K AH L IY
SKEPTICALLY(2)	S K EH P T IH K L IY
SKEPTICISM	S K EH P T IH S IH Z AH M
SKEPTICISMS	S K EH P T AH S IH Z AH M Z
SKEPTICS	S K EH P T IH K S
SKERRIES	S K EH R AY Z
SKERRY	S K EH R IY
SKETCH	S K EH CH
SKETCHBOOK	S K EH CH B UH K
SKETCHBOOKS	S K EH CH B UH K S
SKETCHED	S K EH CH T
SKETCHER	S K EH CH ER
SKETCHERS	S K EH CH ER Z
SKETCHES	S K EH CH AH Z
SKETCHES(2)	S K EH CH IH Z
SKETCHIER	S K EH CH IY ER
SKETCHIEST	S K EH CH IY AH S T
SKETCHILY	S K EH CH IY L IY
SKETCHINESS	S K EH CH IY N AH S
SKETCHINESSES	S K EH CH IY N AH S IH Z
SKETCHING	S K EH CH IH NG
SKETCHY	S K EH CH IY
SKEW	S K Y UW
SKEWBACK	S K Y UW B AH K
SKEWBACKS	S K Y UW B AH K S
SKEWBALD	S K Y UW B AH L D
SKEWBALDS	S K Y UW B AH L D Z
SKEWED	S K Y UW D
SKEWER	S K Y UW ER
SKEWERED	S K Y UW ER D
SKEWERING	S K Y UW ER IH NG
SKEWERS	S K Y UW ER Z
SKEWING	S K Y UW IH NG
SKEWNESS	S K Y UW N AH S
SKEWNESSES	S K Y UW N EH S AH Z
SKEWS	S K Y UW Z
SKINKED	S K IH NG K T
SKINKER	S K IH NG K AH R
SKINKERS	S K IH NG K AH R Z
SKINLIKE	S K IH N L AY K
SKULKED	S K AH L K T
SKULKER	S K AH L K ER
SKULKERS	S K AH L K ER Z
SKUNKED	S K AH NG K T
SKYJACKED	S K AY JH AE K T
SKYJACKER	S K AY JH AE K ER
SKYJACKERS	S K AY JH AE K ER Z
SKYLARKED	S K AY L AA R K T
SKYLARKER	S K AY L AA R K ER
SKYLARKERS	S K AY L AA R K ER Z
SKYROCKET	S K AY R AA K AH T
SKYROCKETED	S K AY R AA K AH T IH D
SKYROCKETING	S K AY R AA K AH T IH NG
SKYROCKETS	S K AY R AA K AH T S
SLABLIKE	S L AE B L AY K
SLACKED	S L AE K T
SLACKEN	S L AE K AH N
SLACKENED	S L AE K AH N D
SLACKENING	S L AE K AH N IH NG
SLACKENS	S L AE K AH N Z
SLACKER	S L AE K ER
SLACKERS	S L AE K ER Z
SLACKEST	S L AE K AH S T
SLAKE	S L EY K
SLAKED	S L EY K T
SLAKER	S L EY K ER
SLAKERS	S L EY K ER Z
SLAKES	S L EY K S
SLATELIKE	S L EY T L AY K
SLEEKED	S L IY K T
SLEEKEN	S L IY K AH N
SLEEKENED	S L IY K AH N D
SLEEKENING	S L IY K AH N IH NG
SLEEKENS	S L IY K AH N Z
SLEEKER	S L IY K ER
SLEEKEST	S L IY K AH S T
SLEEPLIKE	S L IY P L AY K
SLEEPWALKED	S L IY P W AO K T
SLEEPWALKER	S L IY P W AO K ER
SLEEPWALKERS	S L IY P W AO K ER Z
SLICKED	S L IH K T
SLICKENSIDE	S L IH K AH N S AY D
SLICKENSIDES	S L IH K AH N S AY D Z
SLICKER	S L IH K ER
SLICKERS	S L IH K ER Z
SLICKEST	S L IH K AH S T
SLINKED	S L IH NG K T
SLOWPOKE	S L OW P OW K
SLOWPOKES	S L OW P OW K S
SMACKED	S M AE K T
SMACKER	S M AE K ER
SMACKERS	S M AE K ER Z
SMEEKED	S M IY K T
SMERKED	S M AH R K T
SMIRKED	S M ER K T
SMIRKER	S M ER K ER
SMIRKERS	S M ER K ER Z
SMOCKED	S M AA K T
SMOKE	S M OW K
SMOKEABLE	S M OW K AH B AH L
SMOKED	S M OW K T
SMOKEHOUSE	S M OW K HH AW S
SMOKEHOUSES	S M OW K HH AW S IH Z
SMOKEJACK	S M OW K JH AE K
SMOKEJACKS	S M OW K JH AE K S
SMOKELESS	S M OW K L AH S
SMOKELIKE	S M OW K L AY K
SMOKEPOT	S M OW K P AA T
SMOKEPOTS	S M OW K P AA T S
SMOKER	S M OW K ER
SMOKERS	S M OW K ER Z
SMOKES	S M OW K S
SMOKESCREEN	S M OW K S K R IY N
SMOKESCREENS	S M OW K S K R IY N Z
SMOKESTACK	S M OW K S T AE K
SMOKESTACKS	S M OW K S T AE K S
SMOKEY	S M OW K IY
SNACKED	S N AE K T
SNAGLIKE	S N AE G L AY K
SNAILLIKE	S N EY L AY K
SNAKE	S N EY K
SNAKEBIRD	S N EY K B ER D
SNAKEBIRDS	S N EY K B ER D Z
SNAKEBIT	S N EY K B IH T
SNAKEBITE	S N EY K B AY T
SNAKEBITES	S N EY K B AY T S
SNAKEBITTEN	S N EY K B IH T AH N
SNAKED	S N EY K T
SNAKELIKE	S N EY K L AY K
SNAKEROOT	S N EY K R UW T
SNAKEROOTS	S N EY K R UW T S
SNAKES	S N EY K S
SNAKESKIN	S N EY K S K IH N
SNAKESKINS	S N EY K S K IH N Z
SNAKEWEED	S N EY K W IY D
SNAKEWEEDS	S N EY K W IY D Z
SNAKEY	S N EY K IY
SNEAKED	S N IY K T
SNEAKER	S N IY K ER
SNEAKERED	S N IY K ER D
SNEAKERS	S N IY K ER Z
SNICKED	S N IH K T
SNICKER	S N IH K ER
SNICKERED	S N IH K ER D
SNICKERER	S N IH K ER ER
SNICKERERS	S N IH K ER ER Z
SNICKERING	S N IH K ER IH NG
SNICKERS	S N IH K ER Z
SNICKERSNEE	S N IH K AH R S N IY IY
SNICKERSNEES	S N IH K AH R S N IY Z
SNICKERY	S N IH K AH R IY
SNOOKED	S N UH K T
SNOOKER	S N UH K ER
SNOOKERED	S N UH K ER D
SNOOKERING	S N UH K ER IH NG
SNOOKERS	S N UH K ER Z
SNORKEL	S N AO R K AH L
SNORKELED	S N AO R K IY L D
SNORKELER	S N AO R K IY L AH R
SNORKELERS	S N AO R K AH L AH R Z
SNORKELING	S N AO R K AH L IH NG
SNORKELS	S N AO R K AH L Z
SNOWFLAKE	S N OW F L EY K
SNOWFLAKES	S N OW F L EY K S
SNOWLIKE	S N OW L AY K
SNOWMAKER	S N OW M EY K ER
SNOWMAKERS	S N OW M EY K ER Z
SOAKED	S OW K T
SOAKER	S OW K ER
SOAKERS	S OW K ER Z
SOAPLIKE	S OW P L AY K
SOCKED	S AA K T
SOCKET	S AA K AH T
SOCKETED	S AA K AH T IH D
SOCKETING	S AA K AH T IH NG
SOCKETS	S AA K AH T S
SOCKEYE	S AA K AY
SOCKEYES	S AA K AY Z
SOKE	S OW K
SOKEMAN	S AA K AH M AH N
SOKEMEN	S AA K AH M AH N
SOKES	S OW K S
SONGLIKE	S AO NG L AY K
SONLIKE	S AH N L AY K
SOULLIKE	S OW L AY K
SOUNDALIKE	S AW N D AH L AY K
SOUNDALIKES	S AW N D AH L AY K S
SPACEWALKED	S P EY S W AO K T
SPACEWALKER	S P EY S W AO K ER
SPACEWALKERS	S P EY S W AO K ER Z
SPAGHETTILIKE	S P AH G EH T IY L AY K
SPAKE	S P EY K
SPANKED	S P AE NG K T
SPANKER	S P AE NG K AH R
SPANKERS	S P AE NG K AH R Z
SPARKED	S P AA R K T
SPARKER	S P AA R K ER
SPARKERS	S P AA R K ER Z
SPARLIKE	S P AA R L AY K
SPARROWLIKE	S P AE R OW L AY K
SPEAKEASIES	S P IY K IY Z IY Z
SPEAKEASY	S P IY K IY Z IY
SPEAKER	S P IY K ER
SPEAKERPHONE	S P IY K ER F OW N
SPEAKERPHONES	S P IY K ER F OW N Z
SPEAKERS	S P IY K ER Z
SPEAKERSHIP	S P IY K ER SH IH P
SPEAKERSHIPS	S P IY K ER SH IH P S
SPECKED	S P EH K T
SPELUNKED	S P AH L AH NG K T
SPELUNKER	S P AH L AH NG K ER
SPELUNKERS	S P AH L AH NG K ER Z
SPHINXLIKE	S F IH NG K S L AY K
SPIDERLIKE	S P AY D ER L AY K
SPIKE	S P AY K
SPIKED	S P AY K T
SPIKELET	S P AY K L AH T
SPIKELETS	S P AY K L AH T S
SPIKELIKE	S P AY K L AY K
SPIKENARD	S P IH K AH N AH R D
SPIKENARDS	S P IH K AH N AH R D Z
SPIKER	S P AY K ER
SPIKERS	S P AY K ER Z
SPIKES	S P AY K S
SPIKEY	S P AY K IY
SPINACHLIKE	S P IH N IH CH L AY K
SPINELIKE	S P AY N L AY K
SPINNAKER	S P IH N EY K AH R
SPINNAKERS	S P IH N AH K AH R Z
SPLAKE	S P L EY K
SPLAKES	S P L EY K S
SPOKE	S P OW K
SPOKED	S P OW K T
SPOKEN	S P OW K AH N
SPOKES	S P OW K S
SPOKESHAVE	S P OW K SH EY V
SPOKESHAVES	S P OW K SH EY V Z
SPOKESMAN	S P OW K S M AH N
SPOKESMANSHIP	S P OW K S M AE N SH IH P
SPOKESMANSHIPS	S P OW K S M AE N SH IH P S
SPOKESMEN	S P OW K S M IH N
SPOKESPEOPLE	S P OW K S P IY P AH L
SPOKESPERSON	S P OW K S P ER S AH N
SPOKESPERSONS	S P OW K S P ER S AH N Z
SPOKESWOMAN	S P OW K S W UH M AH N
SPOKESWOMEN	S P OW K S W IH M AH N
SPOOKED	S P UW K T
SPOOKERIES	S P UW K AH R IY Z
SPOOKERY	S P UW K AH R IY
SPORTSMANLIKE	S P OW R T S M AE N L AY K
SPRINGLIKE	S P R IH NG L AY K
SPROCKET	S P R AA K AH T
SPROCKETS	S P R AA K AH T S
SPUNKED	S P AH NG K T
SQUAWKED	S K W AO K T
SQUAWKER	S K W AO K ER
SQUAWKERS	S K W AO K ER Z
SQUEAKED	S K W IY K T
SQUEAKER	S K W IY K ER
SQUEAKERS	S K W IY K ER Z
STACKED	S T AE K T
STACKER	S T AE K ER
STACKERS	S T AE K ER Z
STAGELIKE	S T EY JH L AY K
STAKE	S T EY K
STAKED	S T EY K T
STAKEHOLDER	S T EY K HH OW L D ER
STAKEHOLDERS	S T EY K HH OW L D ER Z
STAKEOUT	S T EY K AW T
STAKEOUTS	S T EY K AW T S
STAKES	S T EY K S
STALKED	S T AO K T
STALKER	S T AO K ER
STALKERS	S T AO K ER Z
STARKER	S T AA R K ER
STARKERS	S T AA R K ER Z
STARKEST	S T AA R K AH S T
STARLIKE	S T AA R L AY K
STATESMANLIKE	S T AH T EH S M AH N L AY K
STEEKED	S T IY K T
STEELMAKER	S T IY L M EY K ER
STEELMAKERS	S T IY L M EY K ER Z
STEELWORKER	S T IY L W ER K ER
STEELWORKERS	S T IY L W ER K ER Z
STEMLIKE	S T EH M L AY K
STEPLIKE	S T EH P L AY K
STICKED	S T IH K T
STICKER	S T IH K ER
STICKERS	S T IH K ER Z
STICKLIKE	S T IH K L AY K
STINKER	S T IH NG K ER
STINKERS	S T IH NG K ER Z
STOCKBROKER	S T AA K B R OW K ER
STOCKBROKERAGE	S T AA K B R OW K ER IH JH
STOCKBROKERAGES	S T AA K B R OW K ER IH JH IH Z
STOCKBROKERS	S T AA K B R OW K ER Z
STOCKED	S T AA K T
STOCKER	S T AA K ER
STOCKERS	S T AA K ER Z
STOCKKEEPER	S T AA K IY P ER
STOCKKEEPERS	S T AA K IY P ER Z
STOKE	S T OW K
STOKED	S T OW K T
STOKEHOLD	S T OW K HH OW L D
STOKEHOLDS	S T OW K HH OW L D Z
STOKER	S T OW K ER
STOKERS	S T OW K ER Z
STOKES	S T OW K S
STOKESIA	S T AH K IY ZH IY AH
STOKESIAS	S T AH K IY S IY AH Z
STOOKED	S T UW K T
STOOKER	S T UW K AH R
STOOKERS	S T UW K AH R Z
STOREKEEPER	S T AO R K IY P ER
STOREKEEPERS	S T AO R K IY P ER Z
STRAIGHTJACKET	S T R EY T JH AE K AH T
STRAIGHTJACKETED	S T R EY T JH AE K AH T IH D
STRAIGHTJACKETING	S T R EY T JH AE K AH T IH NG
STRAIGHTJACKETS	S T R EY T JH AE K AH T S
STRAITJACKET	S T R EY T JH AE K AH T
STRAITJACKETED	S T R EY T JH AE K AH T IH D
STRAITJACKETING	S T R EY T JH AE K AH T IH NG
STRAITJACKETS	S T R EY T JH AE K AH T S
STRAKE	S T R EY K
STRAKED	S T R EY K T
STRAKES	S T R EY K S
STREAKED	S T R IY K T
STREAKER	S T R IY K ER
STREAKERS	S T R IY K ER Z
STREEKED	S T R IY K T
STREEKER	S T R IY K AH R
STREEKERS	S T R IY K AH R Z
STREETWALKER	S T R IY T W AO K ER
STREETWALKERS	S T R IY T W AO K ER Z
STRICKEN	S T R IH K AH N
STRIKE	S T R AY K
STRIKEBOUND	S T R AY K B AW N D
STRIKEBREAKER	S T R AY K B R EY K ER
STRIKEBREAKERS	S T R AY K B R EY K ER Z
STRIKEBREAKING	S T R AY K B R EY K IH NG
STRIKEBREAKINGS	S T R AY K B R EY K IH NG Z
STRIKEOUT	S T R AY K AW T
STRIKEOUTS	S T R AY K AW T S
STRIKEOVER	S T R AY K OW V ER
STRIKEOVERS	S T R AY K OW V ER Z
STRIKER	S T R AY K ER
STRIKERS	S T R AY K ER Z
STRIKES	S T R AY K S
STROKE	S T R OW K
STROKED	S T R OW K T
STROKER	S T R OW K ER
STROKERS	S T R OW K ER Z
STROKES	S T R OW K S
STRUCKEN	S T R AH K AH N
SUBMARKET	S AH B M AA R K AH T
SUBMARKETS	S AH B M AA R K AH T S
SUCHLIKE	S AH CH L AY K
SUCKED	S AH K T
SUCKER	S AH K ER
SUCKERED	S AH K ER D
SUCKERING	S AH K ER IH NG
SUCKERS	S AH K ER Z
SUITLIKE	S UW T L AY K
SULKED	S AH L K T
SULKER	S AH L K ER
SULKERS	S AH L K ER Z
SUMMERLIKE	S AH M ER L AY K
SUNBAKED	S AH N B EY K T
SUNCHOKE	S AH N CH OW K
SUNCHOKES	S AH N CH OW K S
SUNKEN	S AH NG K AH N
SUNKET	S AH NG K AH T
SUNKETS	S AH NG K AH T S
SUNLIKE	S AH N L AY K
SUNSEEKER	S AH N S IY K ER
SUNSEEKERS	S AH N S IY K ER Z
SUNSTROKE	S AH N S T R OW K
SUNSTROKES	S AH N S T R OW K S
SUPERMARKET	S UW P ER M AA R K IH T
SUPERMARKETS	S UW P ER M AA R K IH T S
SUPERSTRIKE	S UW P ER S T R AY K
SUPERSTRIKES	S UW P ER S T R AY K S
SUPERTANKER	S UW P ER T AE NG K ER
SUPERTANKERS	S UW P ER T AE NG K ER Z
SURFLIKE	S ER F L AY K
SWACKED	S W AE K T
SWANKED	S W AE NG K T
SWANKER	S W AE NG K ER
SWANKEST	S W AE NG K AH S T
SWANLIKE	S W AA N L AY K
SWAYBACKED	S W EY B AE K T
SWEEPSTAKE	S W IY P S T EY K
SWEEPSTAKES	S W IY P S T EY K S
SWINKED	S W IH NG K T
SWITCHBACKED	S W IH CH B AE K T
SWOOPSTAKE	S W UW P S T EY K
SWORDLIKE	S AO R D L AY K
SYKE	S AY K
SYKES	S AY K S
SYLPHLIKE	S IH L F L AY K
TACKED	T AE K T
TACKER	T AE K ER
TACKERS	T AE K ER Z
TACKET	T AE K AH T
TACKETS	T AE K AH T S
TACKEY	T AE K IY
TAGLIKE	T AE G L AY K
TAILLIKE	T EY L AY K
TAKE	T EY K
TAKEABLE	T EY K AH B AH L
TAKEAWAY	T EY K AH W EY
TAKEDOWN	T EY K D AW N
TAKEDOWNS	T EY K D AW N Z
TAKEN	T EY K AH N
TAKEOFF	T EY K AO F
TAKEOFFS	T EY K AO F S
TAKEOUT	T EY K AW T
TAKEOUTS	T EY K AW T S
TAKEOVER	T EY K OW V ER
TAKEOVERS	T EY K OW V ER Z
TAKER	T EY K ER
TAKERS	T EY K ER Z
TAKES	T EY K S
TAKEUP	T EY K AH P
TAKEUPS	T EY K AH P S
TALCKED	T AE L K T
TALKED	T AO K T
TALKER	T AO K ER
TALKERS	T AO K ER Z
TANKED	T AE NG K T
TANKER	T AE NG K ER
TANKERS	T AE NG K ER Z
TANKLIKE	T AE NG K L AY K
TAPELIKE	T EY P L AY K
TASKED	T AE S K T
TASTEMAKER	T EY S T M EY K ER
TASTEMAKERS	T EY S T M EY K ER Z
TCHOTCHKE	CH AA CH
TCHOTCHKES	CH AA CH S
TEACAKE	T IY K EY K
TEACAKES	T IY K EY K S
TEAKETTLE	T IY K EH T AH L
TEAKETTLES	T IY K EH T AH L Z
TEALIKE	T IY L AY K
TEAMAKER	T IY M EY K ER
TEAMAKERS	T IY M EY K ER Z
TEARJERKER	T IH ER JH ER K ER
TEARJERKERS	T IH ER JH ER K ER Z
TELEMARKETER	T EH L AH M AA R K IH T ER
TELEMARKETERS	T EH L AH M AA R K IH T ER Z
TELEMARKETING	T EH L AH M AA R K AH T IH NG
TELEMARKETINGS	T EH L AH M AA R K AH T IH NG Z
TENTLIKE	T EH N T L AY K
THACKED	TH AE K T
THANKED	TH AE NG K T
THANKER	TH AE NG K ER
THANKERS	TH AE NG K ER Z
THICKEN	TH IH K AH N
THICKENED	TH IH K AH N D
THICKENER	TH IH K AH N ER
THICKENERS	TH IH K AH N ER Z
THICKENING	TH IH K AH N IH NG
THICKENING(2)	TH IH K N IH NG
THICKENINGS	TH IH K AH N IH NG Z
THICKENS	TH IH K AH N Z
THICKER	TH IH K ER
THICKEST	TH IH K IH S T
THICKET	TH IH K IH T
THICKETED	TH IH K AH T IH D
THICKETS	TH IH K AH T S
THICKETY	TH IH K AH T IY
THINKER	TH IH NG K ER
THINKERS	TH IH NG K ER Z
THORNLIKE	TH AO R N L AY K
THREADLIKE	TH R EH D L AY K
THUMBSUCKER	TH AH M S AH K ER
THUMBSUCKERS	TH AH M S AH K ER Z
THUMBTACKED	TH AH M T AE K T
THUNDERSTRICKEN	TH AH N D ER S T R IH K AH N
THUNDERSTRIKE	TH AH N D ER S T R AY K
THUNDERSTRIKES	TH AH N D ER S T R AY K S
THUNDERSTROKE	TH AH N D ER S T R OW K
THUNDERSTROKES	TH AH N D ER S T R OW K S
THUNKED	TH AH NG K T
THWACKED	TH W AE K T
THWACKER	TH W AE K ER
THWACKERS	TH W AE K ER Z
TICKED	T IH K T
TICKER	T IH K ER
TICKERS	T IH K ER Z
TICKET	T IH K AH T
TICKET(2)	T IH K IH T
TICKETED	T IH K AH T IH D
TICKETING	T IH K AH T IH NG
TICKETLESS	T IH K AH T L AH S
TICKETS	T IH K AH T S
TICKETS(2)	T IH K IH T S
TICKTACKED	T IH K T AE K T
TICKTOCKED	T IH K T AH K T
TICTACKED	T IH K T AH K T
TICTOCKED	T IH K T AH K T
TIDELIKE	T AY D L AY K
TIEBREAKER	T AY B R EY K ER
TIEBREAKERS	T AY B R EY K ER Z
TIGERLIKE	T AY G ER L AY K
TIKE	T AY K
TIKES	T AY K S
TILELIKE	T AY L AY K
TIMEKEEPER	T AY M K IY P ER
TIMEKEEPERS	T AY M K IY P ER Z
TIMEKEEPING	T AY M K IY P IH NG
TIMEKEEPINGS	T AY M K IY P IH NG Z
TIMEWORKER	T AY M W ER K ER
TIMEWORKERS	T AY M W ER K ER Z
TINKER	T IH NG K ER
TINKERED	T IH NG K ER D
TINKERER	T IH NG K ER ER
TINKERERS	T IH NG K ER ER Z
TINKERING	T IH NG K ER IH NG
TINKERING(2)	T IH NG K R IH NG
TINKERS	T IH NG ER Z
TINLIKE	T IH N L AY K
TOADLIKE	T OW D L AY K
TOELIKE	T OW L AY K
TOKE	T OW K
TOKED	T OW K T
TOKEN	T OW K AH N
TOKENED	T OW K AH N D
TOKENING	T OW K AH N IH NG
TOKENISM	T OW K AH N IH Z AH M
TOKENISMS	T OW K AH N IH Z AH M Z
TOKENS	T OW K AH N Z
TOKER	T OW K AH R
TOKERS	T AA K AH R Z
TOKES	T OW K S
TOMAHAWKED	T AA M AH HH AO K T
TOMBLIKE	T UW M L AY K
TONGUELIKE	T AH NG L AY K
TOOLMAKER	T UW L M EY K ER
TOOLMAKERS	T UW L M EY K ER Z
TOOTHLIKE	T UW TH L AY K
TOPWORKED	T AA P W ER K T
TOWERLIKE	T AW ER L AY K
TOYLIKE	T OY L AY K
TRACKED	T R AE K T
TRACKER	T R AE K ER
TRACKERS	T R AE K ER Z
TRACKWALKER	T R AE K W AO K ER
TRACKWALKERS	T R AE K W AO K ER Z
TRADEMARKED	T R EY D M AA R K T
TRAFFICKED	T R AE F IH K T
TRAFFICKER	T R AE F IH K ER
TRAFFICKERS	T R AE F IH K ER Z
TRAIKED	T R EY K T
TRAILBREAKER	T R EY L B R EY K ER
TRAILBREAKERS	T R EY L B R EY K ER Z
TRANCELIKE	T R AE N S L AY K
TRAPLIKE	T R AE P L AY K
TREBUCKET	T R AH B AH K AH T
TREBUCKETS	T R AH B AH K AH T S
TREELIKE	T R IY L AY K
TREKKED	T R EH K T
TREKKER	T R EH K ER
TREKKERS	T R EH K ER Z
TRICKED	T R IH K T
TRICKER	T R IH K ER
TRICKERIES	T R IH K AH R IY Z
TRICKERS	T R IH K ER Z
TRICKERY	T R IH K ER IY
TRIKE	T R AY K
TRIKES	T R AY K S
TRINKET	T R IH NG K AH T
TRINKETED	T R IH NG K AH T IH D
TRINKETER	T R IH NG K AH T ER
TRINKETERS	T R IH NG K AH T ER Z
TRINKETING	T R IH NG K AH T IH NG
TRINKETRIES	T R IH NG K AH T R IY Z
TRINKETRY	T R IH NG K AH T R IY
TRINKETS	T R IH NG K AH T S
TRISKELE	T R IH S IY L
TRISKELES	T R IH S IY L Z
TRISKELIA	T R IH S IY L Y AH
TRISKELION	T R IH S IY L IY AH N
TRISKELIONS	T R IH S IY L IY AH N Z
TROAKED	T R OW K T
TROCKED	T R AA K T
TROKE	T R OW K
TROKED	T R OW K T
TROKES	T R OW K S
TROUBLEMAKER	T R AH B AH L M EY K ER
TROUBLEMAKERS	T R AH B AH L M EY K ER Z
TRUCKED	T R AH K T
TRUCKER	T R AH K ER
TRUCKERS	T R AH K ER Z
TRUMPETLIKE	T R AH M P AH T L AY K
TRUNKED	T R AH NG K T
TSATSKE	T S AE T S
TSATSKES	T S AE T S
TSKED	T S K EH D
TSKTSKED	T S K T S K EH D
TUBELIKE	T UW B L AY K
TUBLIKE	T AH B L AY K
TUCKED	T AH K T
TUCKER	T AH K ER
TUCKERED	T AH K ER D
TUCKERING	T AH K ER IH NG
TUCKERS	T AH K ER Z
TUCKET	T AH K AH T
TUCKETS	T AH K AH T S
TUMORLIKE	T UW M ER L AY K
TUNNELLIKE	T AH N AH L AY K
TURFLIKE	T ER F L AY K
TURKEY	T ER K IY
TURKEYS	T ER K IY Z
TURNKEY	T ER N K IY
TURNKEYS	T ER N K IY Z
TURNPIKE	T ER N P AY K
TURNPIKES	T ER N P AY K S
TURTLENECKED	T ER T AH L N EH K T
TUSKED	T AH S K T
TUSKER	T AH S K ER
TUSKERS	T AH S K ER Z
TUSKLIKE	T AH S K L AY K
TWEAKED	T W IY K T
TWIGLIKE	T W IH G L AY K
TYKE	T AY K
TYKES	T AY K S
UKE	Y UW K IY
UKELELE	Y UW K AH L IY L
UKELELES	Y UW K AH L IY L Z
UKES	Y UW K S
UNALIKE	AH N AH L AY K
UNASKED	AH N AE S K T
UNAWAKED	AH N AH W EY K T
UNAWAKENED	AH N AH W EY K AH N D
UNBACKED	AH N B AE K T
UNBAKED	AH N B EY K T
UNBLOCKED	AH N B L AA K T
UNBRACKETED	AH N B R AE K AH T IH D
UNBRAKE	AH N B R EY K
UNBRAKED	AH N B R EY K T
UNBRAKES	AH N B R EY K S
UNBROKE	AH N B R OW K
UNBROKEN	AH N B R OW K AH N
UNBUSINESSLIKE	AH N B IH Z N AH S L AY K
UNCAKE	AH N K EY K
UNCAKED	AH N K EY K T
UNCAKES	AH N K EY K S
UNCASKED	AH N K AE S K T
UNCHECKED	AH N CH EH K T
UNCHILDLIKE	AH N CH AY L D L AY K
UNCHOKE	AH N CH OW K
UNCHOKED	AH N CH OW K T
UNCHOKES	AH N CH OW K S
UNCLOAKED	AH N K L OW K T
UNCOCKED	AH N K AA K T
UNCOOKED	AH N K UH K T
UNCORKED	AH N K AO R K T
UNCRACKED	AH N K R AE K T
UNDECKED	AH N D EH K T
UNDERTAKE	AH N D ER T EY K
UNDERTAKEN	AH N D ER T EY K AH N
UNDERTAKER	AH N D ER T EY K ER
UNDERTAKERS	AH N D ER T EY K ER Z
UNDERTAKES	AH N D ER T EY K S
UNDOCKED	AH N D AA K T
UNEARMARKED	AH N IH ER M AA R K T
UNFAKED	AH N F EY K T
UNFORKED	AH N F AO R K T
UNFROCKED	AH N F R AA K T
UNHOOKED	AH N HH UH K T
UNHUSKED	AH N HH AH S K T
UNKEMPT	AH N K EH M P T
UNKEND	AH N K EH N D
UNKENNED	AH N K EH N D
UNKENNEL	AH N K EH N AH L
UNKENNELED	AH N K EH N AH L D
UNKENNELING	AH N K EH N AH L IH NG
UNKENNELLED	AH N K EH N AH L D
UNKENNELLING	AH N K EH N AH L IH NG
UNKENNELS	AH N K EH N AH L Z
UNKENT	AH NG K AH N T
UNKEPT	AH N K EH P T
UNKINKED	AH N K IH NG K T
UNLADYLIKE	AH N L EY D IY L AY K
UNLICKED	AH N L IH K T
UNLIKE	AH N L AY K
UNLIKELIER	AH N L AY K L IY ER
UNLIKELIEST	AH N L AY K L IY AH S T
UNLIKELIHOOD	AH N L AY K L IY HH UH D
UNLIKELIHOODS	AH N L AY K L IY HH UH D Z
UNLIKELINESS	AH N L AY K L IY N AH S
UNLIKELINESSES	AH N L AY K L IY N AH S IH Z
UNLIKELY	AH N L AY K L IY
UNLIKENESS	AH N L AY K N AH S
UNLIKENESSES	AH N L AY K N AH S IH Z
UNLINKED	AH N L IH NG K T
UNLOCKED	AH N L AA K T
UNMAKE	AH N M EY K
UNMAKER	AH N M EY K ER
UNMAKERS	AH N M EY K ER Z
UNMAKES	AH N M EY K S
UNMARKED	AH N M AA R K T
UNMARKETABLE	AH N M AA R K AH T AH B AH L
UNMASKED	AH N M AE S K T
UNMASKER	AH N M AE S K ER
UNMASKERS	AH N M AE S K ER Z
UNPACKED	AH N P AE K T
UNPACKER	AH N P AE S ER
UNPACKERS	AH N P AE S ER Z
UNPICKED	AH N P IH K T
UNPROVOKED	AH N P R AH V OW K T
UNPUCKER	AH N P AH K ER
UNPUCKERED	AH N P AH K ER D
UNPUCKERING	AH N P AH K ER IH NG
UNPUCKERS	AH N P AH K ER Z
UNRAKED	AH N R EY K T
UNRANKED	AH N R AE NG K T
UNREMARKED	AH N R IH M AA R K T
UNSHAKEN	AH N SH EY K AH N
UNSICKER	AH N S IH K ER
UNSLAKED	AH N S L EY K T
UNSMOKED	AH N S M OW K T
UNSOAKED	AH N S OW K T
UNSPOKE	AH N S P OW K
UNSPOKEN	AH N S P OW K AH N
UNSPORTSMANLIKE	AH N S P AO R T S M AH N L AY K
UNSTACKED	AH N S T AE K T
UNTACKED	AH N T AE K T
UNTAKEN	AH N T EY K AH N
UNTUCKED	AH N T AH K T
UNWARLIKE	AH N W AO R L AY K
UNWORKED	AH N W ER K T
UNYOKE	AH N Y OW K
UNYOKED	AH N Y OW K T
UNYOKES	AH N Y OW K S
UPCHUCKED	AH P CH AH K T
UPKEEP	AH P K IY P
UPKEEPS	AH P K IY P S
UPMARKET	AH P M AA R K AH T
UPSTROKE	AH P S T R OW K
UPSTROKES	AH P S T R OW K S
UPTAKE	AH P T EY K
UPTAKES	AH P T EY K S
URNLIKE	ER N L AY K
VAKEEL	V EY K IY L
VAKEELS	V EY K IY L Z
VANDYKE	V AE N D AY K
VANDYKED	V AE N D AY K T
VANDYKES	V AE N D AY K S
VASELIKE	V EY Z L AY K
VEILLIKE	V EY L AY K
VEINLIKE	V EY N L AY K
VELVETLIKE	V EH L V AH T L AY K
VESTLIKE	V EH S T L AY K
VISELIKE	V AY S L AY K
WACKE	W AE K
WACKES	W AE K S
WAGEWORKER	W EY JH W ER K ER
WAGEWORKERS	W EY JH W ER K ER Z
WAIFLIKE	W EY F L AY K
WAKE	W EY K
WAKED	W EY K T
WAKEFUL	W EY K F AH L
WAKEFULLY	W EY K F AH L IY
WAKEFULNESS	W EY K F AH L N AH S
WAKEFULNESSES	W EY K F AH L N AH S IH Z
WAKELESS	W EY K L AH S
WAKEN	W EY K AH N
WAKENED	W EY K AH N D
WAKENER	W EY K AH N ER
WAKENERS	W EY K AH N ER Z
WAKENING	W EY K AH N IH NG
WAKENINGS	W EY K AH N IH NG Z
WAKENS	W EY K AH N Z
WAKER	W EY K ER
WAKERIFE	W AE K AH R AY F
WAKERS	W EY K ER Z
WAKES	W EY K S
WALKED	W AO K T
WALKER	W AO K ER
WALKERS	W AO K ER Z
WAPENTAKE	W AA P AH N T EY K
WAPENTAKES	W AA P AH N T EY K S
WARKED	W AO R K T
WARLIKE	W AO R L AY K
WARMAKER	W AO R M EY K ER
WARMAKERS	W AO R M EY K ER Z
WARTLIKE	W AO R T L AY K
WASPLIKE	W AA S P L AY K
WASTEBASKET	W EY S T B AE S K AH T
WASTEBASKETS	W EY S T B AE S K AH T S
WATCHMAKER	W AA CH M EY K ER
WATCHMAKERS	W AA CH M EY K ER Z
WATERMARKED	W AO T ER M AA R K T
WAUKED	W AO K T
WAVELIKE	W EY V L AY K
WAXLIKE	W AE K S L AY K
WEAKEN	W IY K AH N
WEAKENED	W IY K AH N D
WEAKENER	W IY K AH N ER
WEAKENERS	W IY K AH N ER Z
WEAKENING	W IY K AH N IH NG
WEAKENS	W IY K AH N Z
WEAKER	W IY K ER
WEAKEST	W IY K AH S T
WEBLIKE	W EH B L AY K
WEEDLIKE	W IY D L AY K
WEEKEND	W IY K EH N D
WEEKEND(2)	W IY K IH N D
WEEKENDED	W IY K EH N D IH D
WEEKENDER	W IY K EH N D ER
WEEKENDERS	W IY K EH N D ER Z
WEEKENDING	W IY K EH N D IH NG
WEEKENDS	W IY K EH N D Z
WHACKED	W AE K T
WHACKED(2)	HH W AE K T
WHACKER	W AE K ER
WHACKER(2)	HH W AE K ER
WHACKERS	W AE K ER Z
WHALELIKE	W EY L AY K
WHEYLIKE	W EY L AY K
WHICKER	W IH K ER
WHICKER(2)	HH W IH K ER
WHICKERED	W IH K IY R D
WHICKERING	W IH K IY R AH NG
WHICKERS	W IH K AH R Z
WHIPLIKE	W IH P L AY K
WHISKED	W IH S K T
WHISKED(2)	HH W IH S K T
WHISKER	W IH S K ER
WHISKER(2)	HH W IH S K ER
WHISKERED	W IH S K ER D
WHISKERS	W IH S K ER Z
WHISKERS(2)	HH W IH S K ER Z
WHISKERY	W IH S K AH R IY
WHISKEY	W IH S K IY
WHISKEY(2)	HH W IH S K IY
WHISKEYS	W IH S K IY Z
WHISKEYS(2)	HH W IH S K IY Z
WICKED	W IH K AH D
WICKEDER	W IH K AH D ER
WICKEDEST	W IH K AH D AH S T
WICKEDLY	W IH K IH D L IY
WICKEDNESS	W IH K AH D N AH S
WICKEDNESSES	W IH K AH D N AH S IH Z
WICKER	W IH K ER
WICKERS	W IH K ER Z
WICKERWORK	W IH K ER W ER K
WICKERWORKS	W IH K ER W ER K S
WICKET	W IH K AH T
WICKET(2)	HH W IH K AH T
WICKETS	W IH K AH T S
WICKETS(2)	HH W IH K AH T S
WIDEAWAKE	W AY D AH W EY K
WIDEAWAKES	W AY D AH W EY K S
WIFELIKE	W AY F L AY K
WIGLIKE	W IH G L AY K
WIGMAKER	W IH G M EY K ER
WIGMAKERS	W IH G M EY K ER Z
WILLOWLIKE	W IH L OW L AY K
WINDBREAKER	W IH N D B R EY K ER
WINDBREAKERS	W IH N D B R EY K ER Z
WINEMAKER	W AY N M EY K ER
WINEMAKERS	W AY N M EY K ER Z
WINGLIKE	W IH NG L AY K
WINKED	W IH NG K T
WINKER	W IH NG K ER
WINKERS	W IH NG K ER Z
WIRELIKE	W AY ER L AY K
WISECRACKED	W AY Z K R AE K T
WISECRACKER	W AY Z K R AE K ER
WISECRACKERS	W AY Z K R AE K ER Z
WISPLIKE	W IH S P L AY K
WITCHLIKE	W IH CH L AY K
WOKE	W OW K
WOKEN	W OW K AH N
WOLFLIKE	W UH L F L AY K
WOMANLIKE	W UH M AH N L AY K
WOMBLIKE	W UW M L AY K
WOODPECKER	W UH D P EH K ER
WOODPECKERS	W UH D P EH K ER Z
WOODWORKER	W UH D W ER K ER
WOODWORKERS	W UH D W ER K ER Z
WOOLLIKE	W UH L AY K
WORKBASKET	W ER K B AE S K AH T
WORKBASKETS	W ER K B AE S K AH T S
WORKED	W ER K T
WORKER	W ER K ER
WORKERS	W ER K ER Z
WORKMANLIKE	W ER K M AE N L AY K
WORMLIKE	W ER M L AY K
WRACKED	R AE K T
WRAITHLIKE	R EY TH L AY K
WREAKED	R IY K T
WREAKER	R IY K ER
WREAKERS	R IY K ER Z
WRECKED	R EH K T
WRECKER	R EH K ER
WRECKERS	R EH K ER Z
WRICKED	R IH K T
YACKED	Y AE K T
YAKKED	Y AE K T
YAKKER	Y AE K ER
YAKKERS	Y AE K ER Z
YANKED	Y AE NG K T
YARMELKE	Y AA R M AH K
YARMELKES	Y AA R M AH K S
YARMULKE	Y AA R M AH L K AH
YARMULKE(2)	Y AA R M AH K AH
YARMULKES	Y AA R M AH L K AH S
YARMULKES(2)	Y AA R M AH K AH S
YERKED	Y AH R K T
YEUKED	Y UW K T
YIKES	Y AY K S
YOCKED	Y AA K T
YOKE	Y OW K
YOKED	Y OW K T
YOKEFELLOW	Y OW K F EH L OW
YOKEFELLOWS	Y OW K F EH L OW Z
YOKEL	Y OW K EH L
YOKELESS	Y OW K L AH S
YOKELISH	Y OW K AH L IH SH
YOKELS	Y OW K AH L Z
YOKEMATE	Y OW K M EY T
YOKEMATES	Y OW K M EY T S
YOKES	Y OW K S
YOLKED	Y OW K T
YONKER	Y AA NG K ER
YONKERS	Y AA NG K ER Z
YOUNKER	Y AH NG K ER
YOUNKERS	Y AH NG K ER Z
YOUTHQUAKE	Y UW TH K W EY K
YOUTHQUAKES	Y UW TH K W EY K S
YUCKED	Y AH K T
YUKKED	Y AH K T
ZINCKED	Z IH NG K T
ZOMBIELIKE	Z AA M B IY L AY K
ZONKED	Z AO NG K T
ZOOKEEPER	Z UW K IY P ER
ZOOKEEPERS	Z UW K IY P ER Z
CHABLIS	SH AH B L IY
CILANTRO	S IH L AE N T R OW
FYCE	F AY S
WO	W OW
WO(2)	HH W OW
LUAU	L UW AW
KEEK	K IY K
NOGG	N AA G
