KA	K AA
ABAKA	AE B AH K AH
ABAKAS	AE B AH K AH Z
ALASKA	AH L AE S K AH
ALASKAS	AH L AE S AH Z
ALKAHEST	AE L K AH HH EH S T
ALKAHESTIC	AE L K AH AH S T AH K
ALKAHESTS	AE L K AH HH AH S T S
ALKALI	AE L K AH L AY
ALKALIC	AE L K AH L AH K
ALKALIES	AE L K AH L AY Z
ALKALIFIED	AE L K AE L AH F AY D
ALKALIFIES	AE L K AE L AH F AY Z
ALKALIFY	AE L K AE L AH F AY
ALKALIFYING	AE L K AH L IH F AY AH NG
ALKALIMETER	AE L K AH L AY M IY T ER
ALKALIMETERS	AE L K AH L AY M IY T ER Z
ALKALIMETRIES	AE L K AH L AY M IY T ER IY Z
ALKALIMETRY	AE L K AH L AY M IY T ER IY
ALKALIN	AE L K AH L AH N
ALKALINE	AE L K AH L AY N
ALKALINITIES	AE L K AH L AY N AH T IY Z
ALKALINITY	AE L K AH L IH N AH T IY
ALKALINIZATION	AE L K AH L AY N AH Z EY SH AH N
ALKALINIZATIONS	AE L K AH L AY N AH Z EY SH AH N Z
ALKALINIZE	AE L K AH L AY N AY Z
ALKALINIZED	AE L K AH L AY N AY Z D
ALKALINIZES	AE L K AH L AY N AY Z IH Z
ALKALINIZING	AE L K AH L AY N AY Z IH NG
ALKALIS	AE L K AH L AY Z
ALKALISE	AE L K AH L AY Z
ALKALISED	AE L K AH L AY Z D
ALKALISES	AE L K AH L AY Z IH Z
ALKALISING	AE L K AH L AY Z IH NG
ALKALIZE	AE L K AH L AY Z
ALKALIZED	AE L K AH L AY Z D
ALKALIZES	AE L K AH L AY Z AH Z
ALKALIZING	AE L K AH L AY Z IH NG
ALKALOID	AE L K AH L OY D
ALKALOIDAL	AE L K AH L OY D AH L
ALKALOIDS	AE L K AH L OY D Z
ALKALOSES	AE L K AH L OW Z AH Z
ALKALOSIS	AE L K AH L OW S AH S
ALKALOTIC	AE L K AH L AH T AH K
ALKANE	AE L K EY N
ALKANES	AE L K EY N Z
ALKANET	AE L K AH N AH T
ALKANETS	AE L K AH N AH T S
ASKANCE	AH S K AE N S
ASKANT	AE S K AH N T
BAASKAAP	B AA S AH P
BAASKAAPS	B AA S AH P S
BABKA	B AE B K AH
BABKAS	B AE B K AH Z
BABUSHKA	B AH B UH SH K AH
BABUSHKAS	B AH B UH SH K AH Z
BACKACHE	B AE K EY K
BACKACHES	B AE K EY K S
BAIDARKA	B EY D AA R K AH
BAIDARKAS	B EY D AA R K AH Z
BALALAIKA	B AE L AH L EY K AH
BALALAIKAS	B AE L AH L EY K AH Z
BALKANIZATION	B AO L K AH N IH Z EY SH AH N
BALKANIZATIONS	B AO L K AH N AH Z EY SH AH N Z
BALKANIZE	B AO L K AH N AY Z
BALKANIZED	B AO L K AH N AY Z D
BALKANIZES	B AO L K AH N AY Z IH Z
BALKANIZING	B AO L K AH N AY Z IH NG
BANKABILITIES	B AE NG K AH B IH L AH T EH Z
BANKABILITY	B AE NG K AH B IH L AH T EH
BANKABLE	B AE NG K AH B AH L
BAZOOKA	B AH Z UW K AH
BAZOOKAS	B AH Z UW K AH Z
BIDARKA	B AY D AA R K AH
BIDARKAS	B AY D AA R K AH Z
BLACKAMOOR	B L AE K AH M UH R
BLACKAMOORS	B L AE K AH M UH R Z
BLINKARD	B L IH NG K AH R D
BLINKARDS	B L IH NG K AH R D Z
BLOCKADE	B L AA K EY D
BLOCKADED	B L AA K EY D IH D
BLOCKADER	B L AA K EY D ER
BLOCKADERS	B L AA K EY D ER Z
BLOCKADES	B L AA K EY D Z
BLOCKADING	B L AA K EY D IH NG
BLOCKAGE	B L AA K IH JH
BLOCKAGES	B L AA K IH JH IH Z
BOOKABLE	B UH K AH B AH L
BOSKAGE	B AA S AH JH
BOSKAGES	B AA S AH JH AH Z
BREAKABLE	B R EY K AH B AH L
BREAKABLES	B R EY K AH B AH L Z
BREAKAGE	B R EY K IH JH
BREAKAGES	B R EY K IH JH IH Z
BREAKAWAY	B R EY K AH W EY
BREAKAWAYS	B R EY K AH W EY Z
BRITSKA	B R IH T S AH
BRITSKAS	B R IH T S AH Z
BRITZKA	B R IH T S AH
BRITZKAS	B R IH T S AH Z
BRITZSKA	B R IH T S AH
BRITZSKAS	B R IH T S AH Z
BROCKAGE	B R AA K AH JH
BROCKAGES	B R AA K AH JH AH Z
BROKAGE	B R OW K IH JH
BROKAGES	B R OW K IH JH IH Z
BUCKAROO	B AH K AH R UW
BUCKAROOS	B AH K AH R UW Z
BUCKAYRO	B AH K EY R OW
BUCKAYROS	B AH K EY R AH Z
BULKAGE	B AH L K IH JH
BULKAGES	B AH L K IH JH IH Z
CHARKA	CH AA R K AH
CHARKAS	CH AA R K AH Z
CHATCHKA	CH AE CH AH
CHATCHKAS	CH AE CH AH Z
CHEAPSKATE	CH IY P S K EY T
CHEAPSKATES	CH IY P S K EY T S
CHECKABLE	CH EH K AH B AH L
CHICKADEE	CH IH K EY D IY
CHICKADEES	CH IH K EY D IY Z
CHICKAREE	CH IH K ER IY
CHICKAREES	CH IH K ER IY Z
CHINKAPIN	CH IH NG K AH P IH N
CHINKAPINS	CH IH NG K AH P IH N Z
CHOCKABLOCK	CH AA K AH B L AA K
CHUCKAWALLA	CH AH K AH AE L AH
CHUCKAWALLAS	CH AH K AH AE L AH Z
CHUKAR	CH UW K AH R
CHUKARS	CH UW K AH R Z
CHUKKA	CH AH K AH
CHUKKAR	CH AH K AH R
CHUKKARS	CH AH K AH R Z
CHUKKAS	CH AH K AH Z
COCKADE	K AA K EY D
COCKADED	K AA K EY D IH D
COCKADES	K AA K EY D Z
COCKALORUM	K AA K AE L AH R AH M
COCKALORUMS	K AA K AE L AH R AH M Z
COCKAMAMIE	K AO K AH M EY M IY
COCKAMAMY	K AA K AE M AH M IY
COCKAPOO	K AA K AE P UW
COCKAPOOS	K AA K AH P UW Z
COCKATIEL	K AA K AH T IY L
COCKATIELS	K AA K AH T IY L Z
COCKATOO	K AA K AH T UW
COCKATOOS	K AA K AH T UW Z
COCKATRICE	K AA K AE T R AH S
COCKATRICES	K AA K AE T R AH S
COOKABLE	K UH K AH B AH L
CORKAGE	K AO R K IH JH
CORKAGES	K AO R K IH JH IH Z
COUNTERBLOCKADE	K AW N T ER B L AA K EY D
COUNTERBLOCKADED	K AW N T ER B L AA K EY D IH D
COUNTERBLOCKADES	K AW N T ER B L AA K EY D Z
COUNTERBLOCKADING	K AW N T ER B L AA K EY D IH NG
CRACKAJACK	K R AE K AH JH AE K
CRACKAJACKS	K R AE K AH JH AE K S
DEBARKATION	D IY B AA R K EY SH AH N
DEBARKATIONS	D IY B AA R K EY SH AH N Z
DEKAGRAM	D AH K AE G R AH M
DEKAGRAMS	D AH K AE G R AH M Z
DEKALITER	D IH K AH L AY T AH R
DEKALITERS	D AH K AE L AH T AH R Z
DEKAMETER	D AH K AE M AH T AH R
DEKAMETERS	D AH K AE M AH T AH R Z
DEKAMETRIC	D AH K AE M AH T R AH K
DEKARE	D AH K AE R
DEKARES	D AH K AE R Z
DISEMBARKATION	D IH S EH M B AA R K EY SH AH N
DISEMBARKATIONS	D IH S IH M B AA R K EY SH AH N Z
DISLIKABLE	D IH S L AY K AH B AH L
DOCKAGE	D AA K IH JH
DOCKAGES	D AA K IH JH IH Z
DRINKABILITIES	D R IH NG K AH B IH L AH T EH Z
DRINKABILITY	D R IH NG K AH B IH L AH T EH
DRINKABLE	D R IH N K AH B AH L
DRINKABLES	D R IH NG K AH B AH L Z
DRUNKARD	D R AH NG K ER D
DRUNKARDS	D R AH NG K ER D Z
DUMKA	D AH M K AH
EMBARKATION	EH M B AA R K EY SH AH N
EMBARKATIONS	IH M B AA R K EY SH AH N Z
ESKAR	EH S AH R
ESKARS	EH S AH R Z
EUKARYOTE	Y UW K AE R AY OW T
EUKARYOTES	Y UW K AE R AY OW T S
EUKARYOTIC	Y UW K AE R AY AH T AH K
EUREKA	Y UH R IY K AH
FLOKATI	F L AA K AH T IY
FLOKATIS	F L OW K EY T AH S
FRANKABLE	F R AE NG K AH B AH L
HACKAMORE	HH AE K AH M AH R
HACKAMORES	HH AE K AH M AO R EY Z
HAIKA	HH EY K AH
HALAKAH	HH AE L AH K AH
HALAKAHS	HH AE L AH K AH Z
HETEROKARYA	HH EH T AH R AH K AE R AY AH
HETEROKARYON	HH EH T AH R AH K AE R AY AH N
HETEROKARYONS	HH EH T AH R AH K AE R AY AH N Z
HETEROKARYOSES	HH AH T AH R AH K AE R AY OW Z AH Z
HETEROKARYOSIS	HH EH T AH R AA K AH R AY OW S AH S
HETEROKARYOTIC	HH EH T AH R AH K AE R AY AH T AH K
HOOKA	HH UH K AH
HOOKAH	HH UH K AH
HOOKAHS	HH UH K AH Z
HOOKAS	HH UH K AH Z
HUCKABACK	HH AH K AH B AH K
HUCKABACKS	HH AH K AH B AH K S
HYPOKALEMIA	HH IH P AH K AH L IY M IY AH
HYPOKALEMIAS	HH IH P AH K AH L IY M IY AH Z
HYPOKALEMIC	HH AH P AA K AH L AH M AH K
IKAT	IH K AH T
IKATS	AY K EY T S
ILKA	IH L K AH
JACKAL	JH AE K AH L
JACKALS	JH AE K AH L Z
JACKANAPES	JH AE K AH N EY P S
JACKANAPESES	JH AE K AE N AH P IY Z AH Z
JACKAROO	JH AE K AH R UW
JACKAROOS	JH AE K AH R UW Z
JACKASS	JH AE K AE S
JACKASSERIES	JH AE K AE S AH R IY Z
JACKASSERY	JH AE K AE S AH R IY
JACKASSES	JH AE K AE S IH Z
JUDOKA	JH UW D AH K AH
JUDOKAS	JH UW D AH K AH Z
KA	K AA
KAAS	K AA S
KAB	K AE B
KABAB	K AE B AH B
KABABS	K AE B AH B Z
KABAKA	K AE B AH K AH
KABAKAS	K AE B AH K AH Z
KABALA	K AE B AH L AH
KABALAS	K AE B AH L AH Z
KABAR	K EY B AH R
KABARS	K AE B AH R Z
KABAYA	K AE B EY AH
KABAYAS	K AE B EY AH Z
KABBALA	K AE B AH L AH
KABBALAH	K AH B AA L AH
KABBALAHS	K AE B AH L AH Z
KABBALAS	K AE B AH L AH Z
KABELJOU	K AH B EH L JH UW
KABELJOUS	K AH B EH L JH AH S
KABIKI	K AE B AH K IY
KABIKIS	K AE B AH K AH S
KABOB	K AE B AH B
KABOBS	K AE B AH B Z
KABS	K AE B Z
KABUKI	K AH B UW K IY
KABUKIS	K AE B Y UW K AH S
KACHINA	K AE CH AH N AH
KACHINAS	K AE CH AH N AH Z
KADDISH	K AA D IH SH
KADDISHES	K AA D IH SH IH Z
KADDISHIM	K AE D AH SH AH M
KADI	K AE D IY
KADIS	K EY D AH S
KAE	K IY
KAES	K EY Z
KAF	K AE F
KAFFEEKLATSCH	K AE F IY K L AH T S
KAFFEEKLATSCHES	K AE F IY K L AH T S
KAFFIR	K AE F AH R
KAFFIRS	K AE F AH R Z
KAFFIYEH	K AE F IY AY
KAFFIYEHS	K AE F IY AY AH Z
KAFIR	K AE F AH R
KAFIRS	K AE F AH R Z
KAFS	K AE F S
KAFTAN	K AE F T AH N
KAFTANS	K AE F T AH N Z
KAGU	K AE G Y UW
KAGUS	K EY G AH S
KAHUNA	K AH HH UW N AH
KAHUNAS	K AE HH Y UW N AH Z
KAIAK	K EY AH K
KAIAKS	K EY AH K S
KAIF	K EY F
KAIFS	K EY F S
KAIL	K EY L
KAILS	K EY AH L Z
KAILYARD	K EY L AY AH R D
KAILYARDS	K EY L AY AH R D Z
KAIN	K EY N
KAINIT	K EY N AH T
KAINITE	K EY N AY T
KAINITES	K EY N AY T S
KAINITS	K EY N AH T S
KAINS	K EY N Z
KAISER	K AY Z ER
KAISERDOM	K AY Z ER D AH M
KAISERDOMS	K AY Z ER D AH M Z
KAISERIN	K AY Z ER IH N
KAISERINS	K AY Z ER IH N Z
KAISERISM	K AY Z ER IH Z AH M
KAISERISMS	K AY Z ER IH Z AH M Z
KAISERS	K AY Z ER Z
KAJEPUT	K AE JH AH P AH T
KAJEPUTS	K AE JH AH P Y UW T S
KAKA	K AE K AH
KAKAPO	K AE K AH P OW
KAKAPOS	K AE K AH P AH Z
KAKAS	K AE K AH Z
KAKEMONO	K AH K EH M AH N OW
KAKEMONOS	K AH K EH M AH N AH Z
KAKI	K AE K IY
KAKIEMON	K EY K IY M AH N
KAKIEMONS	K EY K IY M AH N Z
KAKIS	K EY K AH S
KALAM	K AE L AH M
KALAMS	K AE L AH M Z
KALANCHOE	K AH L AE NG K OW
KALANCHOES	K AH L AE NG K OW Z
KALE	K EY L
KALEIDOSCOPE	K AH L AY D AH S K OW P
KALEIDOSCOPES	K AH L AY D AH S K OW P S
KALEIDOSCOPIC	K AH L AY D AH S K OW P IH K
KALEIDOSCOPICALLY	K AH L AY D AH S K OW P IH K AH L IY
KALENDS	K AE L AH N D Z
KALES	K EY L Z
KALEWIFE	K EY L W AY F
KALEWIVES	K EY L W AY V Z
KALEYARD	K EY L Y AA R D
KALEYARDS	K EY L Y AA R D Z
KALIAN	K EY L IY AH N
KALIANS	K EY L IY AH N Z
KALIF	K AE L AH F
KALIFATE	K AE L AH F EY T
KALIFATES	K AE L AH F EY T S
KALIFS	K AE L AH F S
KALIMBA	K AH L IH M B AH
KALIMBAS	K AH L IH M B AH Z
KALIPH	K AE L AH F
KALIPHS	K AE L AH F S
KALIUM	K EY L IY AH M
KALIUMS	K EY L IY AH M Z
KALLIDIN	K AE L AH D AH N
KALLIDINS	K AE L AH D AH N Z
KALLIKREIN	K AE L AH K R IY N
KALLIKREINS	K AE L AH K R IY N Z
KALMIA	K AE L M IY AH
KALMIAS	K AE L M IY AH Z
KALONG	K AE L AH NG
KALONGS	K AE L AH NG Z
KALPA	K AE L P AH
KALPAK	K AE L P AH K
KALPAKS	K AE L P AH K S
KALPAS	K AE L P AH Z
KALYPTRA	K AH L IH P T R AH
KALYPTRAS	K AH L IH P T R AH Z
KAMAAINA	K AH M AA AH N AH
KAMAAINAS	K AH M AA AH N AH Z
KAMACITE	K AE M AH S AY T
KAMACITES	K AE M AH S AY T S
KAMALA	K AE M AH L AH
KAMALAS	K AE M AH L AH Z
KAME	K EY M
KAMES	K EY M Z
KAMI	K AE M IY
KAMIK	K AE M AH K
KAMIKAZE	K AA M AH K AA Z IY
KAMIKAZES	K AA M IH K AA Z IY Z
KAMIKS	K AE M AH K S
KAMPONG	K AE M P AH NG
KAMPONGS	K AE M P AH NG Z
KAMSEEN	K AE M Z IY AH N
KAMSEENS	K AE M Z IY N Z
KAMSIN	K AE M Z AH N
KAMSINS	K AE M Z AH N Z
KANA	K AE N AH
KANAMYCIN	K AH N AE M AH S AH N
KANAMYCINS	K AH N AE M AH S AH N Z
KANAS	K AE N AH Z
KANBAN	K AE N B AH N
KANBANS	K AE N B AH N Z
KANE	K EY N
KANES	K EY N Z
KANGAROO	K AE NG G ER UW
KANGAROOS	K AE NG G ER UW Z
KANJI	K AE N JH IY
KANJIS	K AE N JH AH S
KANTAR	K AE N T AH R
KANTARS	K AE N T AH R Z
KANTELE	K AE N T IY L
KANTELES	K AE N T IY L Z
KAOLIANG	K EY OW L IY AH NG
KAOLIANGS	K EY OW L IY AH NG Z
KAOLIN	K AW L IH N
KAOLIN(2)	K EY OW L IH N
KAOLINE	K EY AH L AY N
KAOLINES	K EY AH L AY N Z
KAOLINIC	K EY AH L AH N AH K
KAOLINITE	K EY AA L AH N AY T
KAOLINITES	K EY AA L AH N AY T S
KAOLINITIC	K EY AA L AH N AH T AH K
KAOLINS	K EY AH L AH N Z
KAON	K EY AH N
KAONS	K EY AH N Z
KAPA	K AE P AH
KAPAS	K AE P AH Z
KAPELLMEISTER	K AE P AH L M IY S T AH R
KAPELLMEISTERS	K AE P AH L M IY S T AH R Z
KAPH	K AE F
KAPHS	K AE F S
KAPOK	K AE P AH K
KAPOKS	K AE P AH K S
KAPPA	K AE P AH
KAPPAS	K AE P AH Z
KAPUT	K AE P AH T
KAPUTT	K AE P AH T
KARABINER	K AE R AH B AY N AH R
KARABINERS	K AH R AE B AH N AH R Z
KARAKUL	K AE R AH K AH L
KARAKULS	K AH R AE K Y AH L Z
KARAOKE	K EH R IY OW K IY
KARAOKES	K AE R EY OW K S
KARAT	K EH R AH T
KARATE	K ER AA T IY
KARATEIST	K AH R EY T IY AH S T
KARATEISTS	K AE R AH T IY S T S
KARATES	K AH R EY T S
KARATS	K AH R EY T S
KARMA	K AA R M AH
KARMAS	K AA R M AH Z
KARMIC	K AA R M AH K
KARN	K AA R N
KARNS	K AA R N Z
KAROO	K AE R UW
KAROOS	K AH R UW Z
KAROSS	K AE R AH S
KAROSSES	K AH R AA S AH Z
KARROO	K AE R UW
KARROOS	K AE R UW Z
KARST	K AA R S T
KARSTIC	K AA R S T AH K
KARSTS	K AA R S T S
KART	K AA R T
KARTING	K AA R T AH NG
KARTINGS	K AA R T AH NG Z
KARTS	K AA R T S
KARYOGAMIES	K AH R AY AA G AH M AY Z
KARYOGAMY	K AH R AY AA G AH M IY
KARYOKINESES	K AH R AY AA K AH N IY Z AH Z
KARYOKINESIS	K AE R AY AH K AY N AH S AH S
KARYOKINETIC	K AE R AY AA K AH N AH T AH K
KARYOLOGIC	K AH R AY AH L AH JH AH K
KARYOLOGICAL	K AH R AY AA L AH JH IH S AH L
KARYOLOGIES	K AH R AY AA L AH JH AY Z
KARYOLOGY	K AH R AY AA L AH JH IY
KARYOLYMPH	K AH R AY AH L AH M F
KARYOLYMPHS	K AH R AY AH L AH M F S
KARYOSOME	K AH R AY AH S AH M
KARYOSOMES	K AH R AY AH S AH M Z
KARYOTIN	K AH R AY AH T AH N
KARYOTINS	K AH R AY AH T AH N Z
KARYOTYPE	K AE R AY AH T AY P
KARYOTYPED	K AE R AY AH T AY P T
KARYOTYPES	K AE R AY AH T AY P S
KARYOTYPIC	K AH R AY AH T AH P AH K
KARYOTYPICALLY	K AE R AY AH T IH P AH K AE L IY
KARYOTYPING	K AE R AY AH T AY P AH NG
KAS	K AE Z
KASBAH	K AE Z AH
KASBAHS	K AE Z AH Z
KASHA	K AA SH AH
KASHAS	K AE SH AH Z
KASHER	K AE SH AH R
KASHERED	K AH SH IY R D
KASHERING	K AH SH IY R AH NG
KASHERS	K AE SH AH R Z
KASHMIR	K AE SH M IH R
KASHMIR(2)	K AE SH M IY R
KASHMIRS	K AE SH M AH R Z
KASHRUT	K AE SH R AH T
KASHRUTH	K AE SH R AH TH
KASHRUTHS	K AE SH R AH TH S
KASHRUTS	K AE SH R Y UW T S
KAT	K AE T
KATA	K AE T AH
KATABATIC	K AE T AH B AH T AH K
KATAKANA	K AH T AE K AH N AH
KATAKANAS	K AH T AE K AH N AH Z
KATAS	K AE T AH Z
KATCHINA	K AE CH AH N AH
KATCHINAS	K AE CH AH N AH Z
KATCINA	K AE T S AH N AH
KATCINAS	K AE T S AH N AH Z
KATHARSES	K AH TH AA R S AH Z
KATHARSIS	K AH TH AA R S AH S
KATHODAL	K AE TH AH D AH L
KATHODE	K AH TH OW D
KATHODES	K AH TH OW D Z
KATHODIC	K AE TH AH D AH K
KATION	K EY SH AH N
KATIONS	K EY T IY AH N Z
KATS	K AE T S
KATYDID	K EY T IY D IH D
KATYDIDS	K AE T AH D AH D Z
KATZENJAMMER	K AE T S EH N JH AE M AH R
KATZENJAMMERS	K AE T S AH N JH AE M AH R Z
KAURI	K AO R IY
KAURIES	K AH R AY Z
KAURIS	K EY Y AH R AH S
KAURY	K AO R IY
KAVA	K AA V AH
KAVAKAVA	K AA V AH K AA V AH
KAVAKAVAS	K AA V AH K AA V AH Z
KAVAS	K AA V AH Z
KAVASS	K AA V AH Z
KAVASSES	K AA V AH Z IH Z
KAY	K EY
KAYAK	K AY AE K
KAYAKED	K EY EY K T
KAYAKER	K AY AE K ER
KAYAKERS	K AY AE K ER Z
KAYAKING	K AY AE K IH NG
KAYAKINGS	K EY AH K AH NG Z
KAYAKS	K AY AE K S
KAYLES	K EY L Z
KAYO	K EY OW
KAYOED	K EY OW D
KAYOES	K EY OW Z
KAYOING	K EY OW IH NG
KAYOS	K EY OW Z
KAYS	K EY Z
KAZACHKI	K AH Z AE CH IY
KAZACHOK	K AE Z AH CH AH K
KAZATSKI	K AH Z AE T S IY
KAZATSKIES	K AH Z AE T S AY Z
KAZATSKY	K AH Z AE T S IY
KAZOO	K AH Z UW
KAZOOS	K AH Z UW Z
KHIRKAH	K HH AH R K AH
KHIRKAHS	K HH AH R K AH Z
KICKABLE	K IH K AH B AH L
KINKAJOU	K IH NG K AH JH UW
KINKAJOUS	K IH NG K AH JH AH S
KISHKA	K IH SH AH
KISHKAS	K IH SH AH Z
KNOCKABOUT	N AA K AH B AW T
KNOCKABOUTS	N AA K AH B AW T S
KOKANEE	K AA K AH N IY IY
KOKANEES	K AA K AH N IY Z
KOOKABURRA	K UH K AH B AH R AH
KOOKABURRAS	K UH K AH B AH R AH Z
LACKADAISICAL	L AE K AH D EY Z IH K AH L
LACKADAISICALLY	L AE K AH D EY Z IH K AH L IY
LACKADAY	L AE K AH D EY
LASHKAR	L AE SH AH R
LASHKARS	L AE SH AH R Z
LEAKAGE	L IY K AH JH
LEAKAGE(2)	L IY K IH JH
LEAKAGES	L IY K IH JH IH Z
LEUKAEMIA	L UW K IY M IY AH
LEUKAEMIAS	L UW K IY M IY AH Z
LEUKAEMOGENESES	L UW K AH M AA JH AH N IY Z AH Z
LEUKAEMOGENESIS	L UW K IY M AH JH IY N AH S AH S
LIKABILITIES	L AY K AH B IH L AH T EH Z
LIKABILITY	L AY K AH B IH L AH T EH
LIKABLE	L AY K AH B AH L
LIKABLENESS	L AY K AH B AH L N AH S
LIKABLENESSES	L AY K AH B AH L N AH S IH Z
LINKABLE	L IH NG K AH B AH L
LINKAGE	L IH NG K AH JH
LINKAGE(2)	L IH NG K IH JH
LINKAGES	L IH NG K IH JH IH Z
LOCKABLE	L OW K AH B AH L
LOCKAGE	L OW K IH JH
LOCKAGES	L OW K IH JH IH Z
LOOKALIKE	L UH K AH L AY K
LOOKALIKES	L UH K AH L AY K S
MAKABLE	M EY K AH B AH L
MAKAR	M AE K ER
MAKARS	M EY K ER Z
MARKKA	M AA R K AH
MARKKAA	M AA R K AA
MARKKAS	M AA R K AH S
MASKABLE	M AE S K AH B AH L
MAZOURKA	M AH Z AH R K AH
MAZOURKAS	M AH Z AH R K AH Z
MAZURKA	M AH Z ER K AH
MAZURKAS	M AH Z ER K AH Z
MEDAKA	M EH D AH K AH
MEDAKAS	M EH D AH K AH Z
MEERKAT	M IH R K AH T
MEERKATS	M IH R K EY T S
MEGAKARYOCYTE	M AH G AH K AE R AY AH S AY T
MEGAKARYOCYTES	M AH G AH K AE R AY AH S AY T S
MEGAKARYOCYTIC	M EH G AH K AH R AY AH S AH T AH K
MIKADO	M IH K AA D OW
MIKADOS	M IH K AH D AH Z
MISKAL	M IH S AH L
MISKALS	M IH S AE L Z
MISPACKAGE	M IH S P AE S IH JH
MISPACKAGED	M IH S P AE S IH JH D
MISPACKAGES	M IH S P AE S IH JH IH Z
MISPACKAGING	M IH S P AE S IH JH IH NG
MISTAKABLE	M IH S T EY K AH B AH L
MOCKABLE	M AA K AH B AH L
MOLLUSKAN	M AA L AH S AH N
MOUSSAKA	M AW S AH K AH
MOUSSAKAS	M AW S AH K AH Z
MUCKAMUCK	M AH K AH M AH K
MUCKAMUCKS	M AH K AH M AH K S
NONBREAKABLE	N AA N B R EY K AH B AH L
NONSHRINKABLE	N AA N SH R IH NG K AH B AH L
NONSINKABLE	N AA N S IH NG K AH B AH L
NONSKATER	N AA N S K EY T ER
NONSKATERS	N AA N S K EY T ER Z
OKA	OW K AH
OKAPI	AA K AH P IY
OKAPIS	AA K AH P AH S
OKAS	AA K AH Z
OKAY	OW K EY
OKAYED	OW K EY D
OKAYING	OW K EY IH NG
OKAYS	OW K EY Z
OUTSKATE	AW T S K EY T
OUTSKATED	AW T S K EY T IH D
OUTSKATES	AW T S K EY T S
OUTSKATING	AW T S K EY T IH NG
OVERPACKAGE	OW V ER P AE S IH JH
OVERPACKAGED	OW V ER P AE S IH JH D
OVERPACKAGES	OW V ER P AE S IH JH IH Z
OVERPACKAGING	OW V ER P AE S IH JH IH NG
OVERTALKATIVE	OW V ER T AO K AH T IH V
PACKABILITIES	P AE S AH B IH L AH T EH Z
PACKABILITY	P AE S AH B IH L AH T EH
PACKABLE	P AE S AH B AH L
PACKAGE	P AE K AH JH
PACKAGE(2)	P AE K IH JH
PACKAGED	P AE K IH JH D
PACKAGER	P AE K IH JH ER
PACKAGERS	P AE K IH JH ER Z
PACKAGES	P AE K AH JH AH Z
PACKAGES(2)	P AE K IH JH IH Z
PACKAGING	P AE K IH JH IH NG
PALIKAR	P AH L AY K AH R
PALIKARS	P AE L AH K AH R Z
PALOOKA	P AE L AH K AH
PALOOKAS	P AE L AH K AH Z
PAPRIKA	P AE P R IY K AH
PAPRIKA(2)	P AH P R IY K AH
PAPRIKAS	P AH P R IY K AH Z
PARKA	P AA R K AH
PARKAS	P AA R K AH Z
PEEKABOO	P IY K AH B UW
PEEKABOOS	P IY K AH B UW Z
PEKAN	P IY K AH N
PEKANS	P EH K AH N Z
PERESTROIKA	P EH R AH S T R OY K AH
PERESTROIKAS	P AH R EH S T R OY K AH Z
PERIKARYA	P AH R AH K AE R AY AH
PERIKARYAL	P AH R AH K AE R AY AH L
PERIKARYON	P AH R AH K AE R AY AH N
PICKABACK	P IH K AH B AE K
PICKABACKED	P IH K AH B AE K T
PICKABACKING	P IH K AH B AE K IH NG
PICKABACKS	P IH K AH B AE K S
PICKADIL	P IH K AH D AH L
PICKADILS	P IH K AH D AH L Z
PICKANINNIES	P IH K AH N IH N AY Z
PICKANINNY	P IH K AH N IH N IY
PICKAROON	P IH K AH R UW N
PICKAROONS	P IH K AH R UW N Z
PICKAX	P IH K AE K S
PICKAXE	P IH K AE K S
PICKAXED	P IH K AE K S T
PICKAXES	P IH K AE K S IH Z
PICKAXING	P IH K AE K S IH NG
PIKA	P IH K AH
PIKAKE	P AH K EY K
PIKAKES	P AH K EY K S
PIKAS	P IH K AH Z
POLKA	P OW L K AA
POLKA(2)	P OW K AA
POLKAED	P OW L K AH D
POLKAING	P OW L K AH IH NG
POLKAS	P OW L K AA Z
POOKA	P UH K AH
POOKAS	P UH K AH Z
PREPACKAGE	P R IY P AE K AH JH
PREPACKAGED	P R IY P AE K AH JH D
PREPACKAGES	P R IY P AE S IH JH IH Z
PREPACKAGING	P R IY P AE S IH JH IH NG
PROKARYOTE	P R OW K AE R AY OW T
PROKARYOTES	P R OW K AE R AY OW T S
PROKARYOTIC	P R OW K AE R AY AH T AH K
PUCKA	P AH K AH
PUKKA	P AH K AH
PUNKA	P AH NG K AH
PUNKAH	P AH NG K AH
PUNKAHS	P AH NG K AH Z
PUNKAS	P AH NG K AH Z
QINDARKA	K IH N D AA R K AH
QINDARKAS	K IH N D AA R K AH Z
QUOKKA	K W AA K AH
QUOKKAS	K W AA K AH Z
REMARKABLE	R IH M AA R K AH B AH L
REMARKABLE(2)	R IY M AA R K AH B AH L
REMARKABLENESS	R IH M AA R K AH B AH L N AH S
REMARKABLENESSES	R IH M AA R K AH B AH L N AH S IH Z
REMARKABLY	R IH M AA R K AH B L IY
REMARKABLY(2)	R IY M AA R K AH B L IY
REPACKAGE	R IY P AE K IH JH
REPACKAGED	R IY P AE K IH JH D
REPACKAGER	R IY P AE S IH JH ER
REPACKAGERS	R IY P AE S IH JH ER Z
REPACKAGES	R IY P AE K IH JH IH Z
REPACKAGING	R IY P AE K IH JH IH NG
REVOKABLE	R IH V OW K AH B AH L
ROCKABIES	R AA K AH B AY Z
ROCKABILLIES	R AA K AH B IH L IY Z
ROCKABILLY	R AA K AH B IH L IY
ROCKABY	R AA K AH B AY
ROCKABYE	R AA K AH B AY
ROCKABYES	R AA K AH B AY Z
ROCKAWAY	R AA K AH W EY
ROCKAWAYS	R AA K AH W EY Z
RYOKAN	R AY AH K AH N
RYOKANS	R AY AH K AH N Z
SASKATOON	S AE S K AH T UW N
SASKATOONS	S AE S AH T UW N Z
SHAKABLE	SH EY K AH B AH L
SHIKAR	SH AY K AH R
SHIKAREE	SH IH K AH R IY IY
SHIKAREES	SH IH K AH R IY Z
SHIKARI	SH IH K AH R IY
SHIKARIS	SH IH K AH R AH S
SHIKARRED	SH IH K AH R D
SHIKARRING	SH AH K AA R AH NG
SHIKARS	SH IH K AH R Z
SHOCKABLE	SH AA K AH B AH L
SHRINKABLE	SH R IH NG K AH B AH L
SHRINKAGE	SH R IH NG K IH JH
SHRINKAGES	SH R IH NG K IH JH IH Z
SIFAKA	S IH F AH K AH
SIFAKAS	S IH F AH K AH Z
SILKALINE	S IH L K AH L AY N
SILKALINES	S IH L K AH L AY N Z
SINKABLE	S IH NG K AH B AH L
SINKAGE	S IH NG K IH JH
SINKAGES	S IH NG K IH JH IH Z
SKA	S K AA
SKAG	S K AE G
SKAGS	S K AE G Z
SKALD	S K AE L D
SKALDIC	S K AE L D AH K
SKALDS	S K AE L D Z
SKAS	S K AE Z
SKAT	S K AE T
SKATE	S K EY T
SKATEBOARD	S K EY T B AO R D
SKATEBOARDER	S K EY T B OW R D ER
SKATEBOARDERS	S K EY T B OW R D ER Z
SKATEBOARDING	S K EY T B AO R D IH NG
SKATEBOARDINGS	S K EY T B OW R D IH NG Z
SKATEBOARDS	S K EY T B OW R D Z
SKATED	S K EY T IH D
SKATER	S K EY T ER
SKATERS	S K EY T ER Z
SKATES	S K EY T S
SKATING	S K EY T IH NG
SKATINGS	S K EY T IH NG Z
SKATOL	S K AE T AH L
SKATOLE	S K AH T OW L
SKATOLES	S K AH T OW L Z
SKATOLS	S K AE T AH L Z
SKATS	S K AE T S
SLAKABLE	S L EY K AH B AH L
SMOKABLE	S M OW K AH B AH L
SOAKAGE	S OW K IH JH
SOAKAGES	S OW K IH JH IH Z
SPEAKABLE	S P IY K AH B AH L
STACKABLE	S T AE K AH B AH L
STINKARD	S T IH NG K AH R D
STINKARDS	S T IH NG K AH R D Z
STOCKADE	S T AA K EY D
STOCKADED	S T AA K EY D IH D
STOCKADES	S T AA K EY D Z
STOCKADING	S T AA K EY D IH NG
STOTINKA	S T AH T IH NG K AH
SUKKAH	S AH K AH
SUKKAHS	S AH K AH Z
SWASTIKA	S W AA S T IH K AH
SWASTIKAS	S W AA S T IH K AH Z
SYNKARYA	S IH NG K AE R AY AH
SYNKARYON	S IH NG K AE R AY AH N
SYNKARYONS	S IH NG K AE R AY AH N Z
TAKA	T AE K AH
TAKABLE	T EY K AH B AH L
TAKAHE	T AE K AH HH
TAKAHES	T AE K AH Z
TAKAS	T AE K AH Z
TALKABLE	T AO K AH B AH L
TALKATHON	T AE L K AH TH AH N
TALKATHONS	T AE L K AH TH AH N Z
TALKATIVE	T AO K AH T IH V
TALKATIVELY	T AO K AH T IH V L IY
TALKATIVENESS	T AO K AH T IH V N AH S
TALKATIVENESSES	T AO K AH T IH V N AH S IH Z
TALOOKA	T AE L AH K AH
TALOOKAS	T AE L AH K AH Z
TALUKA	T AH L UW K AH
TALUKAS	T AH L UW K AH Z
TANKA	T AE NG K AH
TANKAGE	T AE NG K IH JH
TANKAGES	T AE NG K IH JH IH Z
TANKARD	T AE NG K ER D
TANKARDS	T AE NG K AH R D Z
TANKAS	T AE NG K AH Z
THINKABLE	TH IH NG K AH B AH L
THINKABLENESS	TH IH NG K AH B AH L N AH S
THINKABLENESSES	TH IH NG K AH B AH L N AH S IH Z
THINKABLY	TH IH NG K AH B L IY
TOKAMAK	T AA K AH M AH K
TOKAMAKS	T AA K AH M AH K S
TOKAY	T AA K EY IY
TOKAYS	T AH K EY Z
TRACKAGE	T R AE K IH JH
TRACKAGES	T R AE K IH JH IH Z
TRISKAIDEKAPHOBIA	T R IH S EY D AH K AH F OW B IY AH
TRISKAIDEKAPHOBIAS	T R IH S EY D AH K AH F OW B IY AH Z
TROIKA	T R OY K AH
TROIKAS	T R OY K AH Z
TRUCKAGE	T R AH K IH JH
TRUCKAGES	T R AH K IH JH IH Z
TUCKAHOE	T AH K AH HH OW
TUCKAHOES	T AH K AH HH OW Z
UKASE	Y UW K EY Z
UKASES	Y UW K EY Z AH Z
UNBREAKABLE	AH N B R EY K AH B AH L
UNCHECKABLE	AH N CH EH K AH B AH L
UNDRINKABLE	AH N D R IH NG K AH B AH L
UNLIKABLE	AH N L AY K AH B AH L
UNMISTAKABLE	AH N M IH S T EY K AH B AH L
UNMISTAKABLY	AH N M IH S T EY K AH B L IY
UNREMARKABLE	AH N R IH M AA R K AH B AH L
UNREMARKABLY	AH N R IH M AA R K AH B L IY
UNSHAKABLE	AH N SH EY K AH B AH L
UNSHAKABLY	AH N SH EY K AH B L IY
UNSHOCKABLE	AH N SH AA K AH B AH L
UNSINKABLE	AH N S IH NG K AH B AH L
UNSLAKABLE	AH N S L EY K AH B AH L
UNSPEAKABLE	AH N S P IY K AH B AH L
UNSPEAKABLY	AH N S P IY K AH B L IY
UNTHINKABILITIES	AH N TH IH NG K AH B IH L AH T EH Z
UNTHINKABILITY	AH N TH IH NG K AH B IH L AH T EH
UNTHINKABLE	AH N TH IH NG K AH B AH L
UNTHINKABLY	AH N TH IH NG K AH B L IY
UNWORKABILITIES	AH N W ER K AH B IH L AH T EH Z
UNWORKABILITY	AH N W ER K AH B IH L AH T EH
UNWORKABLE	AH N W ER K AH B AH L
UNWORKABLES	AH N W ER K AH B AH L Z
VODKA	V AA D K AH
VODKAS	V AA D K AH Z
WAKANDA	W AH K AE N D AH
WAKANDAS	W AH K AE N D AH Z
WALKABLE	W AO K AH B AH L
WALKABOUT	W AO K AH B AW T
WALKABOUTS	W AO K AH B AW T S
WALKATHON	W AA L K AH TH AH N
WALKATHONS	W AA L K AH TH AH N Z
WALKAWAY	W AO K AH W EY
WALKAWAYS	W AO K AH W EY Z
WEKA	W EH K AH
WEKAS	W EH K AH Z
WICKAPE	W IH K EY P
WICKAPES	W IH K EY P S
WORKABILITIES	W ER K AH B IH L AH T EH Z
WORKABILITY	W ER K AH B IH L AH T EH
WORKABLE	W ER K AH B AH L
WORKABLENESS	W ER K AH B AH L N AH S
WORKABLENESSES	W ER K AH B AH L N AH S IH Z
WORKADAY	W ER K AH D EY
WORKAHOLIC	W ER K AH HH AA L IH K
WORKAHOLICS	W ER K AH HH AA L IH K S
WORKAHOLISM	W ER K AH HH OW L IH Z AH M
WORKAHOLISMS	W ER K AH HH OW L IH Z AH M Z
WORKAROUND	W ER K AH R AW N D
WORKAROUNDS	W ER K AH R AW N D Z
WRECKAGE	R EH K AH JH
WRECKAGE(2)	R EH K IH JH
WRECKAGES	R EH K IH JH IH Z
YAMALKA	Y AH M AE L K AH
YAMALKAS	Y AH M AE L K AH Z
YAMULKA	Y AH M UH L K AH
YAMULKAS	Y AH M UH L K AH Z
ZAIKAI	Z EY K EY
ZAIKAIS	Z EY K EY AH S
RIJSTTAFEL	R IH JH S T AH F AH L
KEEVE	K IY V
MHO	M HH OW
LO	L OW
NINHYDRIN	N IH N HH IH D R AH N
ELUANT	AH L UW W AH N T
DRAB	D R AE B
