KI	K IY
ADZUKI	AE D Z AH K IY
ADZUKIS	AE D Z UW K AH S
AEROBRAKING	EH R AH B R EY K AH NG
AIKIDO	EY K AH D OW
AIKIDOS	EY K AH D AH Z
AKIMBO	AH K IH M B OW
AKIN	AH K IH N
AKIN(2)	EY K IH N
ALFAKI	AE L F AH K IY
ALFAKIS	AE L F AH K AH S
ALKIES	AE L K AY Z
ALKINE	AE L K AY N
ALKINES	AE L K AY N Z
ANTIBLACKISM	AE N T AY B L AE K IH Z AH M
ANTIBLACKISMS	AE N T AY B L AE K IH Z AH M Z
ANTICAKING	AE N T AY K EY K IH NG
ANTICKING	AE N T IH K IH NG
ANTIKICKBACK	AE N T AY K IH K B AE K
ANTIKING	AE N T AY K IH NG
ANTIKINGS	AE N T AY K IH NG Z
ANTISKID	AE N T AY S K IH D
ANTISMOKING	AE N T IY S M OW K IH NG
ANTISMOKING(2)	AE N T AY S M OW K IH NG
APPARATCHIKI	AE P AH R AE CH AH K IY
ARCKING	AA R K IH NG
ASKING	AE S K IH NG
ASKINGS	AE S K IH NG Z
ASTERISKING	AE S T AH R IH S K IH NG
ATTACKING	AH T AE K IH NG
AUTARKIC	AO T AH R K AH K
AUTARKICAL	AH T AA R K IH S AH L
AUTARKIES	AH T AA R K AY Z
AWAKING	AH W EY K IH NG
BACKBREAKING	B AE K B R EY K IH NG
BACKING	B AE K IH NG
BACKINGS	B AE K IH NG Z
BACKPACKING	B AE K P AE K IH NG
BACKTRACKING	B AE K T R AE K IH NG
BAKING	B EY K IH NG
BAKINGS	B EY K IH NG Z
BALKIER	B AO K IY ER
BALKIEST	B AO K IY AH S T
BALKILY	B AO K IY L IY
BALKINESS	B AO K IY N AH S
BALKINESSES	B AO K IY N AH S IH Z
BALKING	B AO K IH NG
BANKING	B AE NG K IH NG
BANKINGS	B AE NG K IH NG Z
BARKIER	B AA R K IY ER
BARKIEST	B AA R K IY AH S T
BARKING	B AA R K IH NG
BARRACKING	B AE R AH K IH NG
BASKING	B AE S K IH NG
BAUDEKIN	B AO D AH K AH N
BAUDEKINS	B AO D AH K AH N Z
BAULKIER	B AO L K AY AH R
BAULKIEST	B AO L K AY AH S T
BAULKING	B AO K AH NG
BEAKIER	B AH AE K AY AH R
BEAKIEST	B AH AE K AY AH S T
BEARSKIN	B AE ER S K IH N
BEARSKINS	B AE ER S K IH N Z
BECHALKING	B IH CH AO K IH NG
BECKING	B EH K IH NG
BECLOAKING	B IH K L OW K IH NG
BEDECKING	B IH D EH K IH NG
BEFLECKING	B IH F L EH K IH NG
BEKISS	B IH K IH S
BEKISSED	B IH K IH S T
BEKISSES	B IH K IH S IH Z
BEKISSING	B IH K IH S IH NG
BEMOCKING	B IH M AA K IH NG
BENCHMARKING	B EH N CH M AA R K IH NG
BENCHMARKINGS	B EH N CH M AA R K IH NG Z
BERAKING	B IH R EY K IH NG
BESMOKING	B IH S M OW K IH NG
BESPEAKING	B IH S P IY K IH NG
BETAKING	B IH T EY K IH NG
BETHANKING	B IH TH AE NG K IH NG
BETHINKING	B IH TH IH NG K IH NG
BIKIE	B AY K AY
BIKIES	B AY K AY Z
BIKING	B AY K IH NG
BIKINI	B IH K IY N IY
BIKINIED	B AH K IY N IY D
BIKINIS	B AH K IY N IY Z
BILKING	B IH L K IH NG
BIRKIE	B AY R K AY
BIRKIES	B AY R K AY Z
BIVOUACKING	B IH V AH W AE K IH NG
BLACKING	B L AE K IH NG
BLACKINGS	B L AE K IH NG Z
BLACKISH	B L AE K IH SH
BLACKJACKING	B L AE K JH AE K IH NG
BLANKING	B L AE NG K IH NG
BLATHERSKITE	B L AE TH AH R S AY T
BLATHERSKITES	B L AE TH AH R S AY T S
BLEAKISH	B L IY K IH SH
BLINKING	B L IH NG K IH NG
BLOCKIER	B L AA K IY ER
BLOCKIEST	B L AA K IY AH S T
BLOCKING	B L AA K IH NG
BLOCKISH	B L AA K IH SH
BLOODSUCKING	B L AH D S AH K IH NG
BLUESTOCKING	B L UW S T AA K IH NG
BLUESTOCKINGS	B L UW S T AA K IH NG Z
BODKIN	B AA D K IH N
BODKINS	B AA D K IH N Z
BODYCHECKING	B AA D IY CH EH K IH NG
BONKING	B AO NG K AH NG
BOOKIE	B UH K IY
BOOKIES	B UH K IY Z
BOOKING	B UH K IH NG
BOOKINGS	B UH K IH NG Z
BOOKISH	B UH K IH SH
BOOKISHLY	B UH K IH SH L IY
BOOKISHNESS	B UH K IH SH N AH S
BOOKISHNESSES	B UH K IH SH N AH S IH Z
BOOKMAKING	B UH K M EY K IH NG
BOOKMAKINGS	B UH K M EY K IH NG Z
BOOKMARKING	B UH K M AA R K IH NG
BOOMKIN	B UW M K IH N
BOOMKINS	B UW M K IH N Z
BOOTLICKING	B UW T L IH K IH NG
BOSKIER	B AA S AY AH R
BOSKIEST	B AA S AY AH S T
BOTTLENECKING	B AA T AH L N EH K IH NG
BOUSOUKI	B AW S AW K IY
BOUSOUKIA	B AW S AW K IY AH
BOUSOUKIS	B AW S AW K AH S
BOUZOUKI	B AW Z AW K IY
BOUZOUKIA	B AW Z AW K IY AH
BOUZOUKIS	B AW Z AW K AH S
BRACKISH	B R AE K IH SH
BRACKISHNESS	B R AE K IH SH N AH S
BRACKISHNESSES	B R AE K IH SH N AH S IH Z
BRADYKININ	B R AH D IH K IH N IH N
BRADYKININS	B R AE D IY K IH N IH N Z
BRAKIER	B R EY K IY ER
BRAKIEST	B R EY K IY AH S T
BRAKING	B R EY K IH NG
BREAKING	B R EY K IH NG
BREAKINGS	B R EY K IH NG Z
BREATHTAKING	B R EH TH T EY K IH NG
BREATHTAKINGLY	B R EH TH T EY K IH NG L IY
BRICKIER	B R IH K IY ER
BRICKIEST	B R IH K IY AH S T
BRICKING	B R IH K IH NG
BRISKING	B R IH S K IH NG
BROKING	B R OW K IH NG
BROKINGS	B R OW K IH NG Z
BROOKIE	B R UH K IY
BROOKIES	B R UH K IY Z
BROOKING	B R UH K IH NG
BROOKITE	B R AH K AY T
BROOKITES	B R AH K AY T S
BUCKING	B AH K IH NG
BUCKISH	B AH K IH SH
BUCKSKIN	B AH K S K IH N
BUCKSKINNED	B AH K S K IH N D
BUCKSKINS	B AH K S K IH N Z
BULKIER	B AH L K IY ER
BULKIEST	B AH L K IY AH S T
BULKILY	B AH L K IY L IY
BULKINESS	B AH L K IY N AH S
BULKINESSES	B AH L K IY N AH S IH Z
BULKING	B AH L K IH NG
BULWARKING	B UH L W ER K IH NG
BUMKIN	B AH M K IH N
BUMKINS	B AH M K IH N Z
BUMPKIN	B AH M P K IH N
BUMPKINISH	B AH M P K IH N IH SH
BUMPKINLY	B AH M P K IH N L IY
BUMPKINS	B AH M P K IH N Z
BUNKING	B AH NG K IH NG
BURKING	B ER K IH NG
BURKITE	B AH R K AY T
BURKITES	B AH R K AY T S
BUSHWHACKING	B UH SH W AE K IH NG
BUSKIN	B AH S K IH N
BUSKINED	B AH S K IH N D
BUSKING	B AH S K IH NG
BUSKINS	B AH S K IH N Z
BUTTINSKI	B AH T IH N S K IY
BUTTINSKIES	B AH T IH N S K AY Z
BUTTONHOOKING	B AH T AH N HH UH K IH NG
BUZUKI	B Y UW Z AH K IY
BUZUKIA	B Y UW Z UW K IY AH
BUZUKIS	B Y UW Z UW K AH S
CABINETMAKING	K AE B N AH T M EY K IH NG
CABINETMAKINGS	K AE B N AH T M EY K IH NG Z
CAKEWALKING	K EY K W AO K IH NG
CAKIER	K EY K IY ER
CAKIEST	K EY K IY AH S T
CAKING	K EY K IH NG
CALFSKIN	K AE F S K IH N
CALFSKINS	K AE F S K IH N Z
CALKIN	K AE L K IH N
CALKING	K AE K AH NG
CALKINS	K AE L K IH N Z
CANAKIN	K AE N AH K IH N
CANAKINS	K AE N AH K IH N Z
CANIKIN	K AE N AH K AH N
CANIKINS	K AE N AH K AH N Z
CANNIKIN	K AE N AH K AH N
CANNIKINS	K AE N AH K AH N Z
CAPESKIN	K EY P S K IH N
CAPESKINS	K EY P S K IH N Z
CARETAKING	K EH R T EY K IH NG
CARETAKINGS	K EH R T EY K IH NG Z
CARJACKING	K AA R JH AE K IH NG
CARJACKINGS	K AA R JH AE K IH NG Z
CARKING	K AA R K IH NG
CASKING	K AE S K IH NG
CATKIN	K AE T K AH N
CATKINS	K AE T K AH N Z
CAULKING	K AO K IH NG
CAULKINGS	K AO L K AH NG Z
CHALKIER	CH AO K IY ER
CHALKIEST	CH AO K IY AH S T
CHALKING	CH AO K IH NG
CHARKING	CH AA R K IH NG
CHECKING	CH EH K IH NG
CHECKMARKING	CH EH K M AA R K IH NG
CHEEKIER	CH IY K IY ER
CHEEKIEST	CH IY K IY AH S T
CHEEKILY	CH IY K IY L IY
CHEEKINESS	CH IY K IY N AH S
CHEEKINESSES	CH IY K IY N AH S IH Z
CHEEKING	CH IY K IH NG
CHINKIER	CH IH NG K IY ER
CHINKIEST	CH IH NG K IY AH S T
CHINKING	CH IH NG K IH NG
CHIRKING	CH AH R K AH NG
CHOCKING	CH AA K IH NG
CHOKIER	CH OW K IY ER
CHOKIEST	CH OW K IY AH S T
CHOKING	CH OW K IH NG
CHOKINGLY	CH OW K IH NG L IY
CHOLECYSTOKININ	CH AA L AH S AH S T AA K AH N AH N
CHOLECYSTOKININS	CH AA L AH S AH S T AA K AH N AH N Z
CHUCKIES	CH AH K IY Z
CHUCKING	CH AH K IH NG
CHUNKIER	CH AH NG K IY ER
CHUNKIEST	CH AH NG K IY AH S T
CHUNKILY	CH AH NG K IY L IY
CHUNKING	CH AH NG K IH NG
CLACKING	K L AE K AH NG
CLANKING	K L AE NG K IH NG
CLANKINGLY	K L AE NG K IH NG L IY
CLARKIA	K L AA R K IY AH
CLARKIAS	K L AA R K IY AH Z
CLEEKING	K L IY K AH NG
CLERKING	K L ER K IH NG
CLERKISH	K L ER K IH SH
CLICKING	K L IH K IH NG
CLINKING	K L IH NG K IH NG
CLOAKING	K L OW K IH NG
CLOCKING	K L AA K IH NG
CLONKING	K L AO NG K AH NG
CLUCKING	K L AH K IH NG
CLUNKIER	K L AH NG K AY AH R
CLUNKIEST	K L AH NG K AY AH S T
CLUNKING	K L AH NG K AH NG
COCKIER	K AA K IY ER
COCKIEST	K AA K IY AH S T
COCKILY	K AA K IY L IY
COCKINESS	K AA K IY N AH S
COCKINESSES	K AA K IY N AH S IH Z
COCKING	K AA K IH NG
COCKISH	K AA K IH SH
COKING	K OW K IH NG
COLDCOCKING	K OW L D K AA K IH NG
COMAKING	K AH M AH K IH NG
CONKING	K AH N K IH NG
CONVOKING	K AA N V OW K AH NG
COOKIE	K UH K IY
COOKIES	K UH K IY Z
COOKING	K UH K IH NG
COOKINGS	K UH K IH NG Z
COONSKIN	K UW N S K IH N
COONSKINS	K UW N S K IH N Z
CORKIER	K AO R K IY ER
CORKIEST	K AO R K IY AH S T
CORKINESS	K AO R K IY N AH S
CORKINESSES	K AO R K IY N AH S IH Z
CORKING	K AO R K IH NG
CORNHUSKING	K AO R N HH AH S K IH NG
CORNHUSKINGS	K AO R N HH AH S K IH NG Z
COUNTERATTACKING	K AW N T ER AH T AE K IH NG
COUNTERATTACKING(2)	K AW N ER AH T AE K IH NG
COUNTERCHECKING	K AW N T ER CH EH K IH NG
COUNTERSINKING	K AW N T ER S IH NG K IH NG
COWSKIN	K AW S K IH N
COWSKINS	K AW S K IH N Z
CRACKING	K R AE K IH NG
CRACKINGS	K R AE K IH NG Z
CRANKIER	K R AE NG K IY ER
CRANKIEST	K R AE NG K IY AH S T
CRANKILY	K R AE NG K IY L IY
CRANKINESS	K R AE NG K IY N AH S
CRANKINESSES	K R AE NG K IY N AH S IH Z
CRANKING	K R AE NG K IH NG
CRANKISH	K R AE NG K IH SH
CREAKIER	K R IY K IY ER
CREAKIEST	K R IY K IY AH S T
CREAKILY	K R IY K IY L IY
CREAKINESS	K R IY K IY N AH S
CREAKINESSES	K R IY K IY N AH S IH Z
CREAKING	K R IY K IH NG
CRICKING	K R IH K AH NG
CROAKIER	K R OW K IY ER
CROAKIEST	K R OW K IY AH S T
CROAKILY	K R OW K IY L IY
CROAKING	K R OW K IH NG
CROCKING	K R AA K IH NG
CROOKING	K R UH K IH NG
CROSSCHECKING	K R AO S CH EH K IH NG
CYTOKINE	S IH T AH K AY N
CYTOKINES	S IH T AH K AY N Z
CYTOKINESES	S AH T AA K AH N IY Z AH Z
CYTOKINESIS	S IH T AH K AY N AH S AH S
CYTOKINETIC	S AH T AA K AH N AH T AH K
CYTOKININ	S AH T AA K AH N AH N
CYTOKININS	S AH T AA K AH N AH N Z
DAISHIKI	D EY SH AH K IY
DAISHIKIS	D EY AH S HH AY K IY Z
DAMASKING	D AE M AE S K IH NG
DARKIE	D AA R K IY
DARKIES	D AA R K IY Z
DARKING	D AA R K IH NG
DARKISH	D AA R K IH SH
DASHIKI	D AH SH IY K IY
DASHIKIS	D AE SH AH K AH S
DEADLOCKING	D EH D L AA K IH NG
DEBARKING	D IY B AA R K IH NG
DEBEAKING	D IY B IH AH K IH NG
DEBUNKING	D IH B AH NG K IH NG
DECKING	D EH K IH NG
DECKINGS	D EH K IH NG Z
DEERSKIN	D IH R S K IH N
DEERSKINS	D IH ER S K IH N Z
DEFROCKING	D IY F R AA K IH NG
DEKING	D IY K IH NG
DEMARKING	D IY M AA R K IH NG
DETICKING	D IY T IH K IH NG
DEVILKIN	D EH V AH L K IH N
DEVILKINS	D EH V AH L K IH N Z
DEZINCKING	D IY Z IH NG K IH NG
DIAKINESES	D AY AE K AH N IY Z AH Z
DIAKINESIS	D AY AH K AY N AH S AH S
DIBBUKIM	D IH B Y UW K AH M
DICKIE	D IH K IY
DICKIER	D IH K IY ER
DICKIES	D IH K IY Z
DICKIEST	D IH K IY AH S T
DICKING	D IH K IH NG
DIKING	D AY K AH NG
DINKIER	D IH NG K AY AH R
DINKIES	D IH NG K AY Z
DINKIEST	D IH NG K AY AH S T
DINKING	D IH N K IH NG
DIRKING	D AH R K AH NG
DISEMBARKING	D IH S IH M B AA R K IH NG
DISFROCKING	D IH S F R AA K IH NG
DISKING	D IH S K IH NG
DISLIKING	D IH S L AY K IH NG
DISYOKING	D IH S Y OW K IH NG
DOCKING	D AA K IH NG
DOESKIN	D OW S K IH N
DOESKINS	D OW S K IH N Z
DOOHICKIES	D UW HH IH K AY Z
DORKIER	D AO R K AY AH R
DORKIEST	D AO R K AY AH S T
DOVEKIE	D AH V IY K AY
DOVEKIES	D AA V AH K AY Z
DRESSMAKING	D R EH S M EY K IH NG
DRESSMAKINGS	D R EH S M EY K IH NG Z
DRINKING	D R IH NG K IH NG
DROPKICK	D R AA P K IH K
DROPKICKER	D R AA P K IH K ER
DROPKICKERS	D R AA P K IH K ER Z
DROPKICKS	D R AA P K IH K S
DROSHKIES	D R AA SH AY Z
DROSKIES	D R AA S AY Z
DROUKING	D R AW K AH NG
DUCKIE	D AH K IY
DUCKIER	D AH K IY ER
DUCKIES	D AH K IH Z
DUCKIEST	D AH K IY AH S T
DUCKING	D AH K IH NG
DUCKWALKING	D AH K W AO K IH NG
DUKING	D UW K IH NG
DUNKING	D AH NG K IH NG
DUSKIER	D AH S K IY ER
DUSKIEST	D AH S K IY AH S T
DUSKILY	D AH S K IY L IY
DUSKINESS	D AH S K IY N AH S
DUSKINESSES	D AH S K IY N AH S IH Z
DUSKING	D AH S K IH NG
DUSKISH	D AH S K IH SH
DYBBUKIM	D IH B Y UW K AH M
DYKING	D AY K IH NG
DYSKINESIA	D IH S AH N IY ZH IY AH
DYSKINESIAS	D IH S AH N IY S IY AH Z
DYSKINETIC	D IH S AH N AH T AH K
EARMARKING	IH R M AA R K IH NG
EARMARKING(2)	IY R M AA R K IH NG
EARTHSHAKING	ER TH SH EY K IH NG
EARTHSHAKINGLY	ER TH SH EY K IH NG L IY
EKING	IY K IH NG
EKISTIC	IY K IH S T IH K
EKISTICS	IY K IH S T IH K S
ELECTROKINETIC	EH L AH K T R AA K AH N AH T AH K
ELECTROKINETICS	AH L EH K T R AH K IH N AH T AH S Z
EMBANKING	IH M B AE NG K IH NG
EMBARKING	EH M B AA R K IH NG
EMBOSKING	IH M B AA S AH NG
ENKINDLE	EH N K IH N D AH L
ENKINDLED	EH N K IH N D AH L D
ENKINDLES	EH N K IH N D AH L Z
ENKINDLING	EH N K AY N D L IH NG
ENOKI	AH N AA K IY
ENOKIDAKE	AH N AA K AH D EY K
ENOKIDAKES	AH N AA K AH D EY K S
ENOKIS	AH N OW K AH S
ENSKIED	EH N S K AY D
ENSKIES	EH N S K AY Z
ENTEROKINASE	IH N T AH R AA K AH N EY Z
ENTEROKINASES	IH N T AH R AA K AH N EY Z AH Z
ERLKING	AH R K AH NG
ERLKINGS	AH R L K AH NG Z
EUROKIES	Y UW R AH K AY Z
EURYOKIES	Y UW R AY AH K AY Z
EVOKING	IH V OW K IH NG
EVOKING(2)	IY V OW K IH NG
FAKING	F EY K IH NG
FAKIR	F AE K AH R
FAKIRS	F AE K AH R Z
FILMMAKING	F IH L M EY K IH NG
FILMMAKINGS	F IH L M EY K IH NG Z
FINGERPICKING	F IH NG G ER P IH K IH NG
FINGERPICKINGS	F IH NG G ER P IH K IH NG Z
FINICKIER	F IH N IH K IY ER
FINICKIEST	F IH N IH K IY AH S T
FINICKIN	F AY N IH K IH N
FINICKINESS	F IH N IH K IY N AH S
FINICKINESSES	F IH N IH K IY N AH S IH Z
FINICKING	F AY N IH K S IH NG
FINIKIN	F IH N AH K AH N
FINIKING	F AH N AY K AH NG
FINKING	F IH NG K IH NG
FINNICKIER	F IH N IH K S IY ER
FINNICKIEST	F IH N IH K S IY AH S T
FIRKIN	F ER K IH N
FIRKINS	F ER K IH N Z
FLACKING	F L AE K AH NG
FLAKIER	F L EY K IY ER
FLAKIEST	F L EY K IY AH S T
FLAKILY	F L EY K IY L IY
FLAKINESS	F L EY K IY N AH S
FLAKINESSES	F L EY K IY N AH S IH Z
FLAKING	F L EY K IH NG
FLANKING	F L AE NG K IH NG
FLECKING	F L EH K IH NG
FLICKING	F L IH K IH NG
FLINKITE	F L IH NG K AY T
FLINKITES	F L IH NG K AY T S
FLOCKIER	F L AA K IY ER
FLOCKIEST	F L AA K IY AH S T
FLOCKING	F L AA K IH NG
FLOCKINGS	F L AA K IH NG Z
FLUKIER	F L UW K IY ER
FLUKIEST	F L UW K IY AH S T
FLUKING	F L UW K IH NG
FLUNKIES	F L AH NG K AY Z
FLUNKING	F L AH NG K IH NG
FLYSPECKING	F L AY S P EH K IH NG
FOLKIE	F OW K IY
FOLKIES	F OW K IY Z
FOLKISH	F OW K IH SH
FOLKISHNESS	F OW K IH SH N AH S
FOLKISHNESSES	F OW K IH SH N AH S IH Z
FORECHECKING	F OW R CH EH K IH NG
FORELOCKING	F OW R L AA K IH NG
FORESKIN	F OW R S K IH N
FORESKINS	F OW R S K IH N Z
FORESPEAKING	F OW R S P IY K IH NG
FORKIER	F AO R K IY ER
FORKIEST	F AO R K IY AH S T
FORKING	F AO R K IH NG
FORSAKING	F AO R S EY K IH NG
FOSSICKING	F AA S IH K AH NG
FOXSKIN	F AA K S K IH N
FOXSKINS	F AA K S K IH N Z
FRANKINCENSE	F R AE NG K AH N S EH N S
FRANKINCENSES	F R AE NG K IH N S EH N S IH Z
FRANKING	F R AE NG K IH NG
FREAKIER	F R IY K IY ER
FREAKIEST	F R IY K IY AH S T
FREAKILY	F R IY K IY L IY
FREAKINESS	F R IY K IY N AH S
FREAKINESSES	F R IY K IY N AH S IH Z
FREAKING	F R IY K IH NG
FREAKISH	F R IY K IH SH
FREAKISHLY	F R IY K IH SH L IY
FREAKISHNESS	F R IY K IH SH N AH S
FREAKISHNESSES	F R IY K IH SH N AH S IH Z
FREETHINKING	F R IY TH IH NG K IH NG
FREETHINKINGS	F R IY TH IH NG K IH NG Z
FRISKIER	F R IH S AY AH R
FRISKIEST	F R IH S AY AH S T
FRISKILY	F R IH S AH L IY
FRISKINESS	F R AY Z K IH N AH S
FRISKINESSES	F R AY Z K IH N AH S IH Z
FRISKING	F R AY Z K IH NG
FROCKING	F R AA K IH NG
FROLICKING	F R AA L IH K IH NG
FUCKING	F AH K IH NG
FUNKIA	F AH NG K IY AH
FUNKIAS	F AH NG K IY AH Z
FUNKIER	F AH NG K IY ER
FUNKIEST	F AH NG K IY AH S T
FUNKINESS	F AH NG K IY N AH S
FUNKINESSES	F AH NG K IY N AH S IH Z
FUNKING	F AH NG K IH NG
GALLIGASKINS	G AE L AH G AE S AH N Z
GASKIN	G AE S K IH N
GASKING	G AE S K IH NG
GASKINGS	G AE S K IH NG Z
GASKINS	G AE S K IH N Z
GAVELKIND	G AE V AH L K AY N D
GAVELKINDS	G AE V AH L K AY N D Z
GAWKIER	G AO K IY ER
GAWKIES	G AO K IY Z
GAWKIEST	G AO K IY AH S T
GAWKILY	G AO K IY L IY
GAWKINESS	G AO K IY N AH S
GAWKINESSES	G AO K IY N AH S IH Z
GAWKING	G AO K IH NG
GAWKISH	G AO K IH SH
GAWKISHLY	G AO K IH SH L IY
GAWKISHNESS	G AO K IH SH N AH S
GAWKISHNESSES	G AO K IH SH N AH S IH Z
GECKING	JH EH K AH NG
GEEKIER	JH IY K AY AH R
GEEKIEST	JH IY K AY AH S T
GHERKIN	G ER K AH N
GHERKINS	G ER K AH N Z
GIMMICKING	JH IH M IH K AH NG
GLAIKIT	G L EY K AH T
GLASSMAKING	G L AE S M EY K IH NG
GLASSMAKINGS	G L AE S M EY K IH NG Z
GLEEKING	G L IY K IH NG
GLUCOKINASE	G L UW K AA K AH N EY Z
GLUCOKINASES	G L UW K AA K AH N EY Z AH Z
GOATSKIN	G OW T S K IH N
GOATSKINS	G OW T S K IH N Z
GOLDBRICKING	G OW L D B R IH K IH NG
GRANDKID	G R AE N D K IH D
GRANDKID(2)	G R AE N K IH D
GRANDKIDS	G R AE N D K IH D Z
GRANDKIDS(2)	G R AE N K IH D Z
GREENBACKISM	G R IY N B AE K IH Z AH M
GREENBACKISMS	G R IY N B AE K IH Z AH M Z
GREENOCKITE	G R IY N AH K AY T
GREENOCKITES	G R IY N AH K AY T S
GRIDLOCKING	G R IH D L AA K AH NG
GRIMALKIN	G R AY M AH L K IH N
GRIMALKINS	G R AY M AH L K IH N Z
GRISKIN	G R IH S AH N
GRISKINS	G R IH S AH N Z
GROUNDBREAKING	G R AW N D B R EY K IH NG
GROUNDBREAKING(2)	G R AW N B R EY K IH NG
GRUBSTAKING	G R AH B S T EY K IH NG
HACKIE	HH AE K IY
HACKIES	HH AE K IY Z
HACKING	HH AE K IH NG
HAKIM	HH AA K IY M
HAKIM(2)	AA K IY M
HAKIMS	HH AE K AH M Z
HALAKIC	HH AE L AH K AH K
HALAKIST	HH AE L AH K AH S T
HALAKISTS	HH AE L AH K AH S T S
HALLMARKING	HH AO L M AA R K IH NG
HALTERBREAKING	HH AO L T ER B R EY K IH NG
HANDPICKING	HH AE N D P IH K IH NG
HANDSHAKING	HH AE N D SH EY K IH NG
HANDSHAKINGS	HH AE N D SH EY K IH NG Z
HANKIE	HH AE NG K IY
HANKIES	HH AE NG K IY Z
HANKING	HH AE NG K IH NG
HARDWORKING	HH AA R D W ER K IH NG
HARKING	HH AA R K IH NG
HAVOCKING	HH AE V AH K IH NG
HAWKIE	HH AO K IY
HAWKIES	HH AO K IY Z
HAWKING	HH AO K IH NG
HAWKINGS	HH AO K IH NG Z
HAWKISH	HH AO K IH SH
HAWKISHLY	HH AO K IH SH L IY
HAWKISHNESS	HH AO K IH SH N AH S
HAWKISHNESSES	HH AO K IH SH N AH S IH Z
HEARTBREAKING	HH AA R T B R EY K IH NG
HEARTBREAKINGLY	HH AA R T B R EY K IH NG L IY
HELLKITE	HH EH L K AY T
HELLKITES	HH EH L K AY T S
HENPECKING	HH EH N P EH K IH NG
HEXOKINASE	HH EH K S AA K AH N EY Z
HEXOKINASES	HH EH K S AA K AH N EY Z AH Z
HICKIES	HH IH K IY Z
HICKISH	HH IH K IH SH
HIGHJACKING	HH AY JH AE K IH NG
HIJACKING	HH AY JH AE K IH NG
HIJACKINGS	HH AY JH AE K IH NG Z
HIKING	HH AY K IH NG
HITCHHIKING	HH IH CH HH AY K IH NG
HOCKING	HH AA K IH NG
HOICKING	HH OW IH K S IH NG
HOKIER	HH AA K AY AH R
HOKIEST	HH AA K AY AH S T
HOKILY	HH AA K AH L IY
HOKINESS	HH AA K AH N AH S
HOKINESSES	HH AA K AH N EH S AH Z
HOKING	HH OW K AH NG
HOKYPOKIES	HH AH K IH P AH K AY Z
HOLKING	HH AA K AH NG
HOMEMAKING	HH OW M M EY K IH NG
HOMEMAKINGS	HH OW M EY K IH NG Z
HONKIE	HH AO NG K AY
HONKIES	HH AO NG K AY Z
HONKING	HH AO NG K IH NG
HOODWINKING	HH UH D W IH NG K IH NG
HOOKIER	HH UH K IY ER
HOOKIES	HH UH K IY Z
HOOKIEST	HH UH K IY AH S T
HOOKING	HH UH K IH NG
HOOPSKIRT	HH UW P S K ER T
HOOPSKIRTS	HH UW P S K ER T S
HOPSACKING	HH AA P S AE K IH NG
HOPSACKINGS	HH AA P S AE K IH NG Z
HOUSEBREAKING	HH AW S B R EY K IH NG
HOUSEBREAKINGS	HH AW S B R EY K IH NG Z
HOWKING	HH OW K AH NG
HULKIER	HH AH L K IY ER
HULKIEST	HH AH L K IY AH S T
HULKING	HH AH L K IH NG
HUMANKIND	HH Y UW M AH N K AY N D
HUMMOCKING	HH AH M AH K IH NG
HUNKIER	HH AH NG K IY ER
HUNKIES	HH AH NG K IY Z
HUNKIEST	HH AH NG K IY AH S T
HUSKIE	HH AH S K IY
HUSKIER	HH AH S K IY ER
HUSKIES	HH AH S K IY Z
HUSKIEST	HH AH S K IY AH S T
HUSKILY	HH AH S K IY L IY
HUSKINESS	HH AH S K IY N AH S
HUSKINESSES	HH AH S K IY N AH S IH Z
HUSKING	HH AH S K IH NG
HUSKINGS	HH AH S K IH NG Z
HYDROCRACKING	HH IH D R AA K R AE K AH NG
HYDROCRACKINGS	HH IH D R AH K R AE K AH NG Z
HYDROKINETIC	HH IH D R AA K AH N AH T AH K
HYDROSKI	HH IH D R AA S IY
HYDROSKIS	HH IH D R AA S AH S
HYPERKINESES	HH AY P AH R K AH N IY Z AH Z
HYPERKINESIA	HH AY P AH R K AH N IY ZH IY AH
HYPERKINESIAS	HH AY P AH R K AH N IY S IY AH Z
HYPERKINESIS	HH AY P AH R K AY N AH S AH S
HYPERKINETIC	HH AY P ER K IH N EH T IH K
HYPERLINKING	HH AY P ER L IH NG K IH NG
ICKIER	IH K AY AH R
ICKIEST	IH K AY AH S T
ICKILY	IH K AH L IY
ICKINESS	IH K AH N AH S
ICKINESSES	IH K AH N EH S AH Z
IMBARKING	IH M B AA R K IH NG
IMPARKING	IH M P AA R K IH NG
INKIER	IH NG K IY ER
INKIEST	IH NG K IY AH S T
INKINESS	IH N K IH N AH S
INKINESSES	IH N K IH N AH S IH Z
INKING	IH N K IH NG
INTERLEUKIN	IH N T ER L UW K IH N
INTERLEUKINS	IH N T AH R L UW K AH N Z
INTERLINKING	IH N T ER L IH NG K IH NG
INTERLOCKING	IH N T ER L AA K IH NG
INTERWORKING	IH N T ER W ER K IH NG
INTERWORKINGS	IH N T ER W ER K IH NG Z
INVOKING	IH N V OW K IH NG
IRKING	IH R K IH NG
JABBERWOCKIES	JH AE B AH R W AA K AY Z
JACKIES	JH AE K IY Z
JACKING	JH AE K IH NG
JAUKING	JH AO K AH NG
JAYWALKING	JH EY W AO K IH NG
JERKIER	JH ER K IY ER
JERKIES	JH ER K IY Z
JERKIEST	JH ER K IY AH S T
JERKILY	JH ER K IY L IY
JERKIN	JH ER K IH N
JERKINESS	JH ER K IY N AH S
JERKINESSES	JH ER K IY N AH S IH Z
JERKING	JH ER K IH NG
JERKINS	JH ER K IH N Z
JINKING	JH IH NG K AH NG
JINRIKISHA	JH IH N R IH K AH SH AH
JINRIKISHAS	JH IH N R IH K AH SH AH Z
JOKIER	JH OW K IY ER
JOKIEST	JH OW K IY AH S T
JOKILY	JH OW K IY L IY
JOKINESS	JH OW K IY N AH S
JOKINESSES	JH OW K IY N AH S IH Z
JOKING	JH OW K IH NG
JOKINGLY	JH OW K IH NG L IY
JOUKING	JH AW K AH NG
JUKING	JH UW K IH NG
JUNKIE	JH AH NG K IY
JUNKIER	JH AH NG K IY ER
JUNKIES	JH AH NG K IY Z
JUNKIEST	JH AH NG K IY AH S T
JUNKING	JH AH NG K IH NG
KABIKI	K AE B AH K IY
KABIKIS	K AE B AH K AH S
KABUKI	K AH B UW K IY
KABUKIS	K AE B Y UW K AH S
KAKI	K AE K IY
KAKIEMON	K EY K IY M AH N
KAKIEMONS	K EY K IY M AH N Z
KAKIS	K EY K AH S
KARYOKINESES	K AH R AY AA K AH N IY Z AH Z
KARYOKINESIS	K AE R AY AH K AY N AH S AH S
KARYOKINETIC	K AE R AY AA K AH N AH T AH K
KAYAKING	K AY AE K IH NG
KAYAKINGS	K EY AH K AH NG Z
KAZACHKI	K AH Z AE CH IY
KAZATSKI	K AH Z AE T S IY
KAZATSKIES	K AH Z AE T S AY Z
KECKING	K EH K AH NG
KEEKING	K IY K AH NG
KERPLUNKING	K AH R P L AH NG K AH NG
KEYSTROKING	K IY S T R OW K IH NG
KHAKI	K AA K IY
KHAKI(2)	K AE K IY
KHAKIS	K AE K IY Z
KIANG	K AY AH NG
KIANGS	K AY AH NG Z
KIAUGH	K AY AH UW
KIAUGHS	K AY AH AH Z
KIBBE	K IH B
KIBBEH	K IH B
KIBBEHS	K IH B AH Z
KIBBES	K IH B Z
KIBBI	K IH B IY
KIBBIS	K IH B AH S
KIBBITZ	K IH B AH T S
KIBBITZED	K IH B AH T S T
KIBBITZER	K IH B IH T S AH R
KIBBITZERS	K IH B IH T S AH R Z
KIBBITZES	K IH B IH T S AH Z
KIBBITZING	K IH B IH T S AH NG
KIBBLE	K IH B AH L
KIBBLED	K IH B AH L D
KIBBLES	K IH B AH L Z
KIBBLING	K IH B L AH NG
KIBBUTZ	K IH B UH T S
KIBBUTZIM	K IH B UH T S IH M
KIBBUTZNIK	K IH B AH T S N AH K
KIBBUTZNIKS	K IH B UH T S N IH K S
KIBE	K AY B
KIBEI	K IH B IY
KIBEIS	K AY B IY AH S
KIBES	K AY B Z
KIBITZ	K IH B AH T S
KIBITZED	K IH B AH T S T
KIBITZER	K AH B IH T S AH R
KIBITZERS	K AH B IH T S AH R Z
KIBITZES	K AH B IH T S AH Z
KIBITZING	K AH B IH T S AH NG
KIBLA	K IH B L AH
KIBLAH	K IH B L AH
KIBLAHS	K IH B L AH Z
KIBLAS	K IH B L AH Z
KIBOSH	K IH B AH SH
KIBOSHED	K IH B AH SH T
KIBOSHES	K IH B AH SH AH Z
KIBOSHING	K IH B AH SH AH NG
KICK	K IH K
KICKABLE	K IH K AH B AH L
KICKBACK	K IH K B AE K
KICKBACKS	K IH K B AE K S
KICKBALL	K IH K B AO L
KICKBALLS	K IH K B AO L Z
KICKBOARD	K IH K B OW R D
KICKBOARDS	K IH K B OW R D Z
KICKBOXER	K IH K B AA K S ER
KICKBOXERS	K IH K B AA K S ER Z
KICKBOXING	K IH K B AA K S IH NG
KICKBOXINGS	K IH K B AA K S IH NG Z
KICKED	K IH K T
KICKER	K IH K ER
KICKERS	K IH K ER Z
KICKIER	K IH K IY ER
KICKIEST	K IH K IY AH S T
KICKING	K IH K IH NG
KICKOFF	K IH K AO F
KICKOFFS	K IH K AO F S
KICKS	K IH K S
KICKSHAW	K IH K SH AO
KICKSHAWS	K IH K SH AO Z
KICKSTAND	K IH K S T AE N D
KICKSTANDS	K IH K S T AE N D Z
KICKSTART	K IH K S T AA R T
KICKSTARTED	K IH K S T AA R T IH D
KICKSTARTING	K IH K S T AA R T IH NG
KICKSTARTS	K IH K S T AA R T S
KICKUP	K IH K AH P
KICKUPS	K IH K AH P S
KICKY	K IH K IY
KID	K IH D
KIDDED	K IH D IH D
KIDDER	K IH D ER
KIDDERS	K IH D ER Z
KIDDIE	K IH D IY
KIDDIES	K IH D IY Z
KIDDING	K IH D IH NG
KIDDINGLY	K IH D IH NG L IY
KIDDISH	K IH D IH SH
KIDDO	K IH D UW
KIDDOES	K IH D OW Z
KIDDOS	K IH D UW Z
KIDDUSH	K IH D AH SH
KIDDUSHES	K IH D AH SH AH Z
KIDDUSHIM	K IH D AH SH AH M
KIDDY	K IH D IY
KIDLIKE	K IH D L AY K
KIDNAP	K IH D N AE P
KIDNAPED	K IH D N AE P T
KIDNAPEE	K IH D N AE P IY
KIDNAPEES	K IH D N AE P IY Z
KIDNAPER	K IH D N AE P ER
KIDNAPERS	K IH D N AE P ER Z
KIDNAPING	K IH D N AE P IH NG
KIDNAPPED	K IH D N AE P T
KIDNAPPEE	K IH D N AE P IY
KIDNAPPEES	K IH D N AE P IY Z
KIDNAPPER	K IH D N AE P ER
KIDNAPPERS	K IH D N AE P ER Z
KIDNAPPING	K IH D N AE P IH NG
KIDNAPS	K IH D N AE P S
KIDNEY	K IH D N IY
KIDNEYS	K IH D N IY Z
KIDS	K IH D Z
KIDSKIN	K IH D S K IH N
KIDSKINS	K IH D S K IH N Z
KIDVID	K IH D AH D
KIDVIDS	K IH D AH D Z
KIEF	K IY F
KIEFS	K IY F S
KIELBASA	K IY L B AA S AH
KIELBASAS	K IY L B AH S AH Z
KIELBASI	K IY L B AH S IY
KIELBASY	K IY L B AH Z IY
KIER	K IH R
KIERS	K IY R Z
KIESELGUHR	K IY S EH L G AH R
KIESELGUHRS	K IY S EH L G AH R Z
KIESERITE	K IY S AH R AY T
KIESERITES	K IY S AH R AY T S
KIESTER	K AY IH S T ER
KIESTERS	K IY S T AH R Z
KIF	K IH F
KIFS	K IH F S
KIKE	K AY K
KIKES	K AY K S
KILDERKIN	K IH L D AH R K AH N
KILDERKINS	K IH L D AH R K AH N Z
KILIM	K IH L AH M
KILIMS	K IH L AH M Z
KILL	K IH L
KILLDEE	K IH L D IY IY
KILLDEER	K IH L D IH ER
KILLDEERS	K IH L D IH ER Z
KILLDEES	K IH L D IY Z
KILLED	K IH L D
KILLER	K IH L ER
KILLERS	K IH L ER Z
KILLICK	K IH L AH K
KILLICKS	K IH L AH K S
KILLIE	K IH L IY
KILLIES	K IH L IY Z
KILLIFISH	K IH L IH F IH SH
KILLIFISHES	K IH L IH F AH SH AH Z
KILLING	K IH L IH NG
KILLINGLY	K IH L IH NG L IY
KILLINGS	K IH L IH NG Z
KILLJOY	K IH L JH OY
KILLJOYS	K IH L JH OY Z
KILLOCK	K IH L AH K
KILLOCKS	K IH L AH K S
KILLS	K IH L Z
KILN	K IH L N
KILNED	K IH L N D
KILNING	K IH L N AH NG
KILNS	K IH L N Z
KILO	K IH L OW
KILOBAR	K IH L AH B AA R
KILOBARS	K IH L AH B AA R Z
KILOBASE	K IH L AH B EY S
KILOBASES	K IH L AH B EY S IH Z
KILOBAUD	K IH L AH B AH D
KILOBAUDS	K IH L AH B AH D Z
KILOBIT	K IH L AH B IH T
KILOBITS	K IH L AH B IH T S
KILOBYTE	K IH L OW B AY T
KILOBYTES	K IH L OW B AY T S
KILOCALORIE	K IH L AH K AE L AH R IY
KILOCALORIES	K IH L AH K AE L AH R IY Z
KILOCYCLE	K IH L AH S AY K AH L
KILOCYCLES	K IH L AH S AY K AH L Z
KILOGAUSS	K IH L AH G AW S
KILOGAUSSES	K IH L AH G AW S IH Z
KILOGRAM	K IH L AH G R AE M
KILOGRAMS	K IH L AH G R AE M Z
KILOHERTZ	K IH L AH HH AH R T S
KILOJOULE	K AH L AA JH OW UW L
KILOJOULES	K AH L AA JH OW AH L Z
KILOLITER	K IH L AH L IY T ER
KILOLITERS	K IH L AH L IY T ER Z
KILOMETER	K AH L AA M AH T ER
KILOMETER(2)	K IH L AH M IY T ER
KILOMETERS	K AH L AA M AH T ER Z
KILOMETERS(2)	K IH L AH M IY T ER Z
KILOMOLE	K IH L AH M OW L
KILOMOLES	K IH L AH M OW L Z
KILOPARSEC	K IH L AH P AA R S AH K
KILOPARSECS	K IH L AH P AA R S AH K S
KILOPASCAL	K IH L AH P AE S AH L
KILOPASCALS	K IH L AH P AE S AH L Z
KILORAD	K IH L AH R AH D
KILORADS	K IH L AH R AH D Z
KILOS	K IY L OW Z
KILOTON	K IH L AH T AH N
KILOTONS	K IH L AH T AH N Z
KILOVOLT	K IH L AH V OW L T
KILOVOLTS	K IH L AH V OW L T S
KILOWATT	K IH L AH W AA T
KILOWATTS	K IH L AH W AA T S
KILT	K IH L T
KILTED	K IH L T IH D
KILTER	K IH L T ER
KILTERS	K IH L T ER Z
KILTIE	K IH L T IY
KILTIES	K IH L T IY Z
KILTING	K IH L T IH NG
KILTINGS	K IH L T IH NG Z
KILTS	K IH L T S
KILTY	K IH L T IY
KIMBERLITE	K IH M B AH R L AY T
KIMBERLITES	K IH M B AH R L AY T S
KIMCHEE	K IH M CH IY
KIMCHEES	K IH M CH IY Z
KIMCHI	K IH M CH IY
KIMCHIS	K IH M CH AH S
KIMONO	K AH M OW N AH
KIMONOED	K AH M OW N AH D
KIMONOS	K AH M OW N AH Z
KIN	K IH N
KINA	K IH N AH
KINAS	K IH N AH Z
KINASE	K AH N EY Z
KINASES	K AH N EY Z AH Z
KIND	K AY N D
KINDER	K AY N D ER
KINDERGARTEN	K IH N D ER G AA R T AH N
KINDERGARTENER	K IH N D ER G AA R T AH N ER
KINDERGARTENERS	K IH N D ER G AA R T AH N ER Z
KINDERGARTENS	K IH N D ER G AA R T AH N Z
KINDERGARTNER	K IH N D ER G AA R T N ER
KINDERGARTNERS	K IH N D ER G AA R T N ER Z
KINDEST	K AY N D AH S T
KINDHEARTED	K AY N D HH AA R T IH D
KINDHEARTEDLY	K AY N D HH AA R T AH D L IY
KINDHEARTEDNESS	K AY N D HH AA R T AH D N AH S
KINDHEARTEDNESSES	K AY N D HH AA R T AH D N AH S IH Z
KINDLE	K IH N D AH L
KINDLED	K IH N D AH L D
KINDLER	K IH N D AH L ER
KINDLER(2)	K IH N D L ER
KINDLERS	K IH N D AH L ER Z
KINDLES	K IH N D AH L Z
KINDLESS	K AY N D L AH S
KINDLESSLY	K AY N D L AH S L IY
KINDLIER	K AY N D L IY ER
KINDLIEST	K AY N D L IY AH S T
KINDLINESS	K AY N D L IY N AH S
KINDLINESSES	K AY N D L IY N AH S IH Z
KINDLING	K IH N D L IH NG
KINDLINGS	K AY N D L IH NG Z
KINDLY	K AY N D L IY
KINDNESS	K AY N D N AH S
KINDNESSES	K AY N D N AH S IH Z
KINDRED	K IH N D R IH D
KINDREDS	K IH N D R AH D Z
KINDS	K AY N D Z
KINDS(2)	K AY N Z
KINE	K AY N
KINEMA	K IH N AH M AH
KINEMAS	K IH N AH M AH Z
KINEMATIC	K IH N IH M EY T IH K
KINEMATICAL	K IH N IH M EY T IH K AH L
KINEMATICALLY	K IH N IH M EY T IH K AH L AY
KINEMATICS	K IH N IH M EY T IH K S
KINES	K AY N Z
KINESCOPE	K IH N AH S OW P
KINESCOPED	K IH N AH S OW P T
KINESCOPES	K IH N AH S OW P S
KINESCOPING	K IH N AH S OW P AH NG
KINESES	K AH N IY Z AH Z
KINESIC	K AY N Z AH K
KINESICS	K IH N AH Z AH S Z
KINESIOLOGIES	K AH N AH S IY AA L AH JH AY Z
KINESIOLOGY	K IH N IH S IY AA L AH JH IY
KINESIS	K AY N AH S AH S
KINESTHESES	K IH N AH S TH IY Z AH Z
KINESTHESIA	K IH N AH S TH IY ZH IY AH
KINESTHESIAS	K IH N AH S TH IY S IY AH Z
KINESTHESIS	K AH N EH S DH AH S AH S
KINESTHETIC	K IH N AH S TH EH T IH K
KINESTHETICALLY	K IH N AH S TH EH T IH K AH L IY
KINETIC	K AH N EH T IH K
KINETIC(2)	K IH N EH T IH K
KINETICALLY	K AH N EH T IH K AH L IY
KINETICIST	K AH N EH T IH K IH S T
KINETICISTS	K AH N EH T IH K IH S T S
KINETICS	K AH N EH T IH K S
KINETIN	K IH N AH T AH N
KINETINS	K IH N AH T AH N Z
KINETOCHORE	K AH N EH T AH CH AH R
KINETOCHORES	K AH N EH T AH CH AH R Z
KINETOPLAST	K IH N AH T AA P L AH S T
KINETOPLASTS	K IH N AH T AA P L AH S T S
KINETOSCOPE	K AH N EH T AH S OW P
KINETOSCOPES	K AH N EH T AH S OW P S
KINETOSOME	K AH N EH T AH S AH M
KINETOSOMES	K AH N EH T AH S AH M Z
KINFOLK	K IH N F OW K
KINFOLKS	K IH N F OW K S
KING	K IH NG
KINGBIRD	K IH NG B ER D
KINGBIRDS	K IH NG B ER D Z
KINGBOLT	K IH NG B OW L T
KINGBOLTS	K IH NG B OW L T S
KINGCRAFT	K IH NG K R AE F T
KINGCRAFTS	K IH NG K R AE F T S
KINGCUP	K IH NG K AH P
KINGCUPS	K IH NG K AH P S
KINGDOM	K IH NG D AH M
KINGDOMS	K IH NG D AH M Z
KINGED	K IH NG D
KINGFISH	K IH NG F IH SH
KINGFISHER	K IH NG F IH SH ER
KINGFISHERS	K IH NG F IH SH ER Z
KINGFISHES	K IH NG F IH SH IH Z
KINGHOOD	K IH NG HH UH D
KINGHOODS	K IH NG HH UH D Z
KINGING	K IH NG IH NG
KINGLESS	K IH NG L AH S
KINGLET	K IH NG L AH T
KINGLETS	K IH NG L AH T S
KINGLIER	K IH NG L IY ER
KINGLIEST	K IH NG L IY AH S T
KINGLIKE	K IH NG L AY K
KINGLINESS	K IH NG L IY N AH S
KINGLINESSES	K IH NG L IY N AH S IH Z
KINGLY	K IH NG L IY
KINGMAKER	K IH NG M EY K ER
KINGMAKERS	K IH NG M EY K ER Z
KINGPIN	K IH NG P IH N
KINGPINS	K IH NG P IH N Z
KINGPOST	K IH NG P OW S T
KINGPOSTS	K IH NG P OW S T S
KINGS	K IH NG Z
KINGSHIP	K IH NG SH IH P
KINGSHIPS	K IH NG SH IH P S
KINGSIDE	K IH NG S AY D
KINGSIDES	K IH NG S AY D Z
KINGWOOD	K IH NG W UH D
KINGWOODS	K IH NG W UH D Z
KININ	K IH N IH N
KININS	K IH N IH N Z
KINK	K IH NG K
KINKAJOU	K IH NG K AH JH UW
KINKAJOUS	K IH NG K AH JH AH S
KINKED	K IH NG K T
KINKIER	K IH NG K AY AH R
KINKIEST	K IH NG K AY AH S T
KINKILY	K IH NG K AH L IY
KINKINESS	K IH N K IH N AH S
KINKINESSES	K IH N K IH N AH S IH Z
KINKING	K IH N K IH NG
KINKS	K IH NG K S
KINKY	K IH NG K IY
KINNIKINNICK	K IH N AH K IH N AH K
KINNIKINNICKS	K IH N AH K IH N AH K S
KINO	K IH N OW
KINOS	K IH N AA S
KINS	K IH N Z
KINSFOLK	K IH N Z F OW K
KINSHIP	K IH N SH IH P
KINSHIPS	K IH N SH IH P S
KINSMAN	K IH N Z M AE N
KINSMEN	K IH N Z M EH N
KINSWOMAN	K IH N Z W UH M AH N
KINSWOMEN	K IH N Z W IH M AH N
KIOSK	K IY AO S K
KIOSKS	K IY AO S K S
KIP	K IH P
KIPPED	K IH P T
KIPPEN	K IH P AH N
KIPPER	K IH P ER
KIPPERED	K IH P IY R D
KIPPERER	K IH P IY R AH R
KIPPERERS	K IH P AH R AH R Z
KIPPERING	K IH P IY R AH NG
KIPPERS	K IH P ER Z
KIPPING	K IH P AH NG
KIPS	K IH P S
KIPSKIN	K IH P S AH N
KIPSKINS	K IH P S AH N Z
KIR	K IH R
KIRIGAMI	K AH R IH G AH M IY
KIRIGAMIS	K AH R IH G AH M AH S
KIRK	K ER K
KIRKMAN	K ER K M AH N
KIRKMEN	K AH R K M AH N
KIRKS	K ER K S
KIRMESS	K AH R M AH S
KIRMESSES	K AH R M EH S AH Z
KIRN	K ER N
KIRNED	K AH R N D
KIRNING	K AH R N AH NG
KIRNS	K AH R N Z
KIRS	K IH R Z
KIRSCH	K ER SH
KIRSCHES	K AH R S
KIRTLE	K AH R T AH L
KIRTLED	K AH R T AH L D
KIRTLES	K AH R T AH L Z
KISHKA	K IH SH AH
KISHKAS	K IH SH AH Z
KISHKE	K IH SH
KISHKES	K IH SH S
KISMAT	K IH Z M AH T
KISMATS	K IH Z M EY T S
KISMET	K IH Z M IH T
KISMETIC	K IH Z M AH T AH K
KISMETS	K IH Z M IH T S
KISS	K IH S
KISSABLE	K IH S AH B AH L
KISSABLY	K IH S AH B L IY
KISSED	K IH S T
KISSER	K IH S ER
KISSERS	K IH S ER Z
KISSES	K IH S AH Z
KISSES(2)	K IH S IH Z
KISSING	K IH S IH NG
KISSY	K IH S IY
KIST	K IH S T
KISTFUL	K IH S T AH L
KISTFULS	K IH S T Y AH L Z
KISTS	K IH S T S
KIT	K IH T
KITCHEN	K IH CH AH N
KITCHENETTE	K IH CH AH N EH T
KITCHENETTES	K IH CH AH N EH T S
KITCHENS	K IH CH AH N Z
KITCHENWARE	K IH CH AH N W EH R
KITCHENWARES	K IH CH AH N W EH R Z
KITE	K AY T
KITED	K AY T IH D
KITELIKE	K AY T L AY K
KITER	K AY T ER
KITERS	K AY T ER Z
KITES	K AY T S
KITH	K IH TH
KITHARA	K IH TH AH R AH
KITHARAS	K IH TH AH R AH Z
KITHE	K AY DH
KITHED	K IH DH D
KITHES	K IH DH Z
KITHING	K IH DH AH NG
KITHS	K IH TH S
KITING	K AY T IH NG
KITLING	K IH T L IH NG
KITLINGS	K IH T L IH NG Z
KITS	K IH T S
KITSCH	K IH CH
KITSCHES	K IH T S
KITSCHY	K IH T S IY
KITTED	K IH T IH D
KITTEL	K IH T AH L
KITTEN	K IH T AH N
KITTENED	K IH T AH N D
KITTENING	K IH T AH N IH NG
KITTENISH	K IH T AH N IH SH
KITTENISHLY	K IH T AH N IH SH L IY
KITTENISHNESS	K IH T AH N IH SH N AH S
KITTENISHNESSES	K IH T AH N IH SH N AH S IH Z
KITTENS	K IH T AH N Z
KITTIES	K IH T IY Z
KITTING	K IH T IH NG
KITTIWAKE	K IH T IH W EY K
KITTIWAKES	K IH T AH W EY K S
KITTLE	K IH T AH L
KITTLED	K IH T AH L D
KITTLER	K IH T AH L ER
KITTLES	K IH T AH L Z
KITTLEST	K IH T AH L AH S T
KITTLING	K IH T AH L IH NG
KITTY	K IH T IY
KIVA	K IH V AH
KIVAS	K IH V AH Z
KIWI	K IY W IY
KIWIFRUIT	K IH W AH F R UW T
KIWIFRUITS	K IH W AH F R UW T S
KIWIS	K IY W IY Z
KNACKING	N AE K IH NG
KNOCKING	N AA K IH NG
KOLINSKI	K AH L IH N S K IY
KOLINSKIES	K AH L IH N S AY Z
KOLKHOZNIKI	K OW L K AA Z N AH K IY
KONKING	K AO NG K AH NG
KOOKIE	K UH K AY
KOOKIER	K UH K AY AH R
KOOKIEST	K UH K AY AH S T
KOOKINESS	K UH K AH N AH S
KOOKINESSES	K UH K AH N EH S AH Z
KULAKI	K Y UW L AH K IY
LACKING	L AE K IH NG
LADYKIN	L EY D IY K IH N
LADYKINS	L EY D IY K IH N Z
LAKIER	L EY K IY ER
LAKIEST	L EY K IY AH S T
LAKING	L EY K IH NG
LAKINGS	L EY K IH NG Z
LAMBKILL	L AE M K IH L
LAMBKILLS	L AE M K IH L Z
LAMBKIN	L AE M K IH N
LAMBKINS	L AE M K IH N Z
LAMBSKIN	L AE M S K IH N
LAMBSKINS	L AE M S K IH N Z
LANDSKIP	L AE N D S K IH P
LANDSKIPS	L AE N D S K IH P S
LANKIER	L AE NG K IY ER
LANKIEST	L AE NG K IY AH S T
LANKILY	L AE NG K IY L IY
LANKINESS	L AE NG K IY N AH S
LANKINESSES	L AE NG K IY N AH S IH Z
LARKIER	L AA R K IY ER
LARKIEST	L AA R K IY AH S T
LARKINESS	L AA R K IY N AH S
LARKINESSES	L AA R K IY N AH S IH Z
LARKING	L AA R K IH NG
LARKISH	L AA R K IH SH
LARRIKIN	L AE R AH K AH N
LARRIKINS	L AE R AH K AH N Z
LATAKIA	L AH T EY K IY AH
LATAKIAS	L AH T EY K IY AH Z
LAWBREAKING	L AO B R EY K IH NG
LAWBREAKINGS	L AO B R EY K IH NG Z
LAWMAKING	L AO M EY K IH NG
LAWMAKINGS	L AO M EY K IH NG Z
LEAKIER	L IY K IY ER
LEAKIEST	L IY K IY AH S T
LEAKILY	L IY K IY L IY
LEAKINESS	L IY K IY N AH S
LEAKINESSES	L IY K IY N AH S IH Z
LEAKING	L IY K IH NG
LEUKOPLAKIA	L UW K AH P L EY K IY AH
LEUKOPLAKIAS	L UW K AH P L EY K IY AH Z
LEUKOPLAKIC	L UW K AA P L AH K AH K
LICKING	L IH K IH NG
LICKINGS	L IH K IH NG Z
LIKING	L AY K IH NG
LIKINGS	L AY K IH NG Z
LIMEKILN	L IH M AH K AH L N
LIMEKILNS	L IH M AH K AH L N Z
LIMPKIN	L IH M P K IH N
LIMPKINS	L IH M P K IH N Z
LINEBACKING	L AY N B AE K IH NG
LINEBACKINGS	L AY N B AE K IH NG Z
LINKING	L IH NG K IH NG
LOCKING	L AA K IH NG
LOOKING	L UH K IH NG
LOVEMAKING	L AH V M EY K IH NG
LOVEMAKINGS	L AH V M EY K IH NG Z
LUCKIE	L AH K IY
LUCKIER	L AH K IY ER
LUCKIES	L UW S IY Z
LUCKIEST	L AH K IY AH S T
LUCKILY	L AH K AH L IY
LUCKINESS	L UW S IY N AH S
LUCKINESSES	L UW S IY N AH S IH Z
LUCKING	L AH K IH NG
LURKING	L ER K IH NG
LYMPHOKINE	L IH M F AH K AY N
LYMPHOKINES	L IH M F AH K AY N Z
MACKINAW	M AE K AH N AO
MACKINAWS	M AE K AH N AO Z
MACKINTOSH	M AE K AH N T AA SH
MACKINTOSHES	M AE K AH N T AA SH IH Z
MAFFICKING	M AE F IH K AH NG
MAGICKING	M AE JH IH K IH NG
MAKIMONO	M AH K IH M AH N OW
MAKIMONOS	M AH K IH M AH N AH Z
MAKING	M EY K IH NG
MAKINGS	M EY K IH NG Z
MALARKIES	M AH L AA R K AY Z
MALKIN	M AE L K IH N
MALKINS	M AE L K IH N Z
MAMMOCKING	M AE M AA K AH NG
MANAKIN	M AA N AH K IH N
MANAKINS	M AA N AH K IH N Z
MANIKIN	M AE N IH K AH N
MANIKINS	M AE N IH K AH N Z
MANKIND	M AE N K AY N D
MANNIKIN	M AE N AH K AH N
MANNIKINS	M AE N AH K AH N Z
MAPMAKING	M AE P M EY K IH NG
MAPMAKINGS	M AE P M EY K IH NG Z
MARKING	M AA R K IH NG
MARKINGS	M AA R K IH NG Z
MASKING	M AE S K IH NG
MASKINGS	M AE S K IH NG Z
MATCHMAKING	M AE CH M EY K IH NG
MATCHMAKINGS	M AE CH M EY K IH NG Z
MAWKISH	M AO K IH SH
MAWKISHLY	M AO K IH SH L IY
MAWKISHNESS	M AO K IH SH N AH S
MAWKISHNESSES	M AO K IH SH N AH S IH Z
MEATPACKING	M IY T P AE K IH NG
MEATPACKINGS	M IY T P AE K IH NG Z
MEDEVACKING	M EH D AH V AE K AH NG
MERRYMAKING	M EH R IY M EY K IH NG
MERRYMAKINGS	M EH R IY M EY K IH NG Z
METALWORKING	M EH T AH L W ER K IH NG
METALWORKINGS	M EH T AH L W ER K IH NG Z
MIKING	M AY K IH NG
MILKIER	M IH L K IY ER
MILKIEST	M IH L K IY AH S T
MILKILY	M IH L K IY L IY
MILKINESS	M IH L K IY N AH S
MILKINESSES	M IH L K IY N AH S IH Z
MILKING	M IH L K IH NG
MIMICKING	M IH M IH K IH NG
MINIKIN	M IH N IY K IH N
MINIKINS	M IH N IY K IH N Z
MINISKI	M IH N IY S K IY
MINISKIRT	M IH N IY S K ER T
MINISKIRTED	M IH N IY S K ER T IH D
MINISKIRTS	M IH N IY S K ER T S
MINISKIS	M IH N IY S K AY Z
MIRKIER	M AH R K AY AH R
MIRKIEST	M AH R K AY AH S T
MIRKILY	M AH R K AH L IY
MISCOOKING	M IH S K UH K IH NG
MISKICK	M IH S K IH K
MISKICKED	M IH S K IH K T
MISKICKING	M IH S K IH K IH NG
MISKICKS	M IH S K IH K S
MISLIKING	M IH S L AY K IH NG
MISMAKING	M IH S M EY K IH NG
MISMARKING	M IH S M AA R K IH NG
MISSPEAKING	M IH S P IY K IH NG
MISSTRIKING	M IH S T R AY K IH NG
MISTAKING	M IH S T EY K IH NG
MISTHINKING	M IH S TH IH NG K IH NG
MISYOKING	M IH S Y OW K IH NG
MOCKING	M AA K IH NG
MOCKINGBIRD	M AA K IH NG B ER D
MOCKINGBIRDS	M AA K IH NG B ER D Z
MOCKINGLY	M AA K IH NG L IY
MOLESKIN	M OW L S K IH N
MOLESKINS	M OW L S K IH N Z
MONEYMAKING	M AH N IY M EY K IH NG
MONEYMAKINGS	M AH N IY M EY K IH NG Z
MONKISH	M AH NG K IH SH
MOSAICKING	M OW Z EY IH K IH NG
MOTHERFUCKING	M AH DH ER F AH K IH NG
MOTORBIKING	M OW T ER B AY K IH NG
MOUNTEBANKING	M AW N T AH B AE NG K AH NG
MOVIEMAKING	M UW V IY M EY K IH NG
MOVIEMAKINGS	M UW V IY M EY K IH NG Z
MUCKIER	M AH K IY ER
MUCKIEST	M AH K IY AH S T
MUCKILY	M AH K IY L IY
MUCKING	M AH K IH NG
MUCKRAKING	M AH K R EY K IH NG
MUDSKIPPER	M AH D S K IH P ER
MUDSKIPPERS	M AH D S K IH P ER Z
MULTISKILLED	M AH L T AY S K IH L D
MULTITASKING	M AH L T IY T AE S K IH NG
MULTITASKINGS	M AH L T AY T AE S K IH NG Z
MULTITRACKING	M AH L T AY T R AE K IH NG
MUNCHKIN	M AH N CH K IH N
MUNCHKINS	M AH N CH K IH N Z
MURKIER	M ER K IY ER
MURKIEST	M ER K IY AH S T
MURKILY	M ER K IY L IY
MURKINESS	M ER K IY N AH S
MURKINESSES	M ER K IY N AH S IH Z
MUSKIE	M AH S K IY
MUSKIER	M AH S AY AH R
MUSKIES	M AH S AY Z
MUSKIEST	M AH S AY AH S T
MUSKILY	M AH S AH L IY
MUSKINESS	M AH S AH N AH S
MUSKINESSES	M AH S AH N EH S AH Z
MUSKIT	M AH S AH T
MUSKITS	M AH S AH T S
MUTCHKIN	M AH CH AH N
MUTCHKINS	M AH CH AH N Z
MYTHMAKING	M IH TH M EY K IH NG
MYTHMAKINGS	M IH TH M EY K IH NG Z
NANKIN	N AE NG K AH N
NANKINS	N AE NG K AH N Z
NAPKIN	N AE P K IH N
NAPKINS	N AE P K IH N Z
NARKING	N AA R K AH NG
NECKING	N EH K IH NG
NECKINGS	N EH K IH NG Z
NETWORKING	N EH T W ER K IH NG
NETWORKINGS	N EH T W ER K IH NG Z
NICKING	N IH K IH NG
NITPICKIER	N IH T IH K AY AH R
NITPICKIEST	N IH T IH K AY AH S T
NITPICKING	N IH T P IH K IH NG
NOCKING	N AA K AH NG
NOISEMAKING	N OY Z M EY K IH NG
NOISEMAKINGS	N OY Z M EY K IH NG Z
NONBANKING	N AA N B AE NG K IH NG
NONCAKING	N AA N K EY K IH NG
NONCOKING	N AA N K OW K IH NG
NONDRINKING	N AA N D R IH NG K IH NG
NONSKID	N AA N S K IH D
NONSKIER	N AA N S K AY ER
NONSKIERS	N AA N S K AY ER Z
NONSMOKING	N AA N S M OW K IH NG
NONSPEAKING	N AA N S P IY K IH NG
NONTHINKING	N AA N TH IH NG K IH NG
NONTHINKINGS	N AA N TH IH NG K IH NG Z
NONWORKING	N AA N W ER K IH NG
NOOKIES	N UH K IY Z
NUKING	N Y UW K AH NG
OILSKIN	OY L S K IH N
OILSKINS	OY L S K IH N Z
OINKING	OY NG K AH NG
ONIONSKIN	AH N Y AH N S K IH N
ONIONSKINS	AH N Y AH N S K IH N Z
ONLOOKING	AO N L UH K IH NG
OPTOKINETIC	AA P T AA K AH N AH T AH K
OUTASKING	AW T AE S K IH NG
OUTBAKING	AW T B EY K IH NG
OUTBARKING	AW T B AA R K IH NG
OUTBULKING	AW T B AH L K IH NG
OUTCOOKING	AW T K UH K IH NG
OUTDRINKING	AW T D R IH NG K IH NG
OUTFLANKING	AW T F L AE NG K IH NG
OUTKICK	AW T K IH K
OUTKICKED	AW T K IH K T
OUTKICKING	AW T K IH K IH NG
OUTKICKS	AW T K IH K S
OUTKILL	AW T K IH L
OUTKILLED	AW T K IH L D
OUTKILLING	AW T K IH L IH NG
OUTKILLS	AW T K IH L Z
OUTKISS	AW T K IH S
OUTKISSED	AW T K IH S T
OUTKISSES	AW T K IH S IH Z
OUTKISSING	AW T K IH S IH NG
OUTPOLITICKING	AW T P AA L AH T IH K IH NG
OUTRANKING	AW T R AE NG K IH NG
OUTROCKING	AW T R AA K IH NG
OUTSKIRT	AW T S K ER T
OUTSKIRTS	AW T S K ER T S
OUTSLICKING	AW T S L IH K IH NG
OUTSMOKING	AW T S M OW K IH NG
OUTSPEAKING	AW T S P IY K IH NG
OUTSULKING	AW T S AH L K IH NG
OUTTALKING	AW T AO K IH NG
OUTTASKING	AW T AE S K IH NG
OUTTHANKING	AW T TH AE NG K IH NG
OUTTHINKING	AW T TH IH NG K IH NG
OUTTRICKING	AW T R IH K IH NG
OUTWALKING	AW T W AO K IH NG
OUTWORKING	AW T W ER K IH NG
OVERBAKING	OW V ER B EY K IH NG
OVERBOOKING	OW V ER B UH K IH NG
OVERCOOKING	OW V ER K UH K IH NG
OVERDECKING	OW V ER D EH K IH NG
OVERDRINKING	OW V ER D R IH NG K IH NG
OVERKILL	OW V ER K IH L
OVERKILLED	OW V ER K IH L D
OVERKILLING	OW V ER K IH L IH NG
OVERKILLS	OW V ER K IH L Z
OVERKIND	OW V ER K AY N D
OVERLOOKING	OW V ER L UH K IH NG
OVERMILKING	OW V ER M IH L K IH NG
OVERSKIRT	OW V ER S K ER T
OVERSKIRTS	OW V ER S K ER T S
OVERSMOKING	OW V ER S M OW K IH NG
OVERSOAKING	OW V ER S OW K IH NG
OVERSTOCKING	OW V ER S T AA K IH NG
OVERSTRIKING	OW V ER S T R AY K IH NG
OVERTAKING	OW V ER T EY K IH NG
OVERTALKING	OW V ER T AO K IH NG
OVERTASKING	OW V ER T AE S K IH NG
OVERTHINKING	OW V ER TH IH NG K IH NG
OVERWORKING	OW V ER W ER K IH NG
PACEMAKING	P EY S M EY K IH NG
PACEMAKINGS	P EY S M EY K IH NG Z
PACKING	P AE K IH NG
PACKINGHOUSE	P AE K IH NG HH AW S
PACKINGHOUSES	P AE K IH NG HH AW S IH Z
PACKINGS	P AE K IH NG Z
PADDOCKING	P AE D AH K IH NG
PADLOCKING	P AE D L AA K IH NG
PAIKING	P EY K AH NG
PAINKILLER	P EY N K IH L ER
PAINKILLERS	P EY N K IH L ER Z
PAINKILLING	P EY N K IH L IH NG
PAINSTAKING	P EY N S T EY K IH NG
PAINSTAKINGLY	P EY N S T EY K IH NG L IY
PAINSTAKINGS	P EY N S T EY K IH NG Z
PANCAKING	P AE N K EY K IH NG
PANICKIER	P AE N IH K IY ER
PANICKIEST	P AE N IH K IY AH S T
PANICKING	P AE N IH K IH NG
PANNIKIN	P AE N AH K AH N
PANNIKINS	P AE N AH K AH N Z
PAPERMAKING	P AE P ER M EY K IH NG
PAPERMAKINGS	P EY P ER M EY K IH NG Z
PARAKITE	P AA R AH K AY T
PARAKITES	P AA R AH K AY T S
PARKING	P AA R K IH NG
PARKINGS	P AA R K IH NG Z
PARKINSONIAN	P AA R K AH N S OW N IY AH N
PARKINSONISM	P AA R K IH N S AH N IH Z IH M
PARKINSONISMS	P AA R K IH N S AH N IH Z AH M Z
PARTAKING	P AA R T EY K IH NG
PATHBREAKING	P AE TH B R EY K IH NG
PAWKIER	P AO K AY AH R
PAWKIEST	P AO K AY AH S T
PAWKILY	P AO K AH L IY
PAWNBROKING	P AO N B R OW K IH NG
PAWNBROKINGS	P AO N B R OW K IH NG Z
PEACEMAKING	P IY S M EY K IH NG
PEACEMAKINGS	P IY S M EY K IH NG Z
PEACOCKIER	P IY K AA K IY ER
PEACOCKIEST	P IY K AA K IY AH S T
PEACOCKING	P IY K AA K IH NG
PEACOCKISH	P IY K AA K IH SH
PEAKIER	P IY K IY ER
PEAKIEST	P IY K IY AH S T
PEAKING	P IY K IH NG
PEAKISH	P IY K IH SH
PECKIER	P EH K IY ER
PECKIEST	P EH K IY AH S T
PECKING	P EH K IH NG
PECKISH	P EH K IH SH
PEEKING	P IY K IH NG
PEKIN	P IY K AH N
PEKINS	P EH K AH N Z
PERKIER	P ER K IY ER
PERKIEST	P ER K IY AH S T
PERKILY	P ER K IY L IY
PERKINESS	P ER K IH N AH S
PERKINESSES	P ER K IH N AH S IH Z
PERKING	P ER K IH NG
PERKISH	P ER K IH SH
PEROVSKITE	P AH R AA V S K AY T
PEROVSKITES	P AH R AA V S K AY T S
PESKIER	P EH S AY AH R
PESKIEST	P EH S AY AH S T
PESKILY	P EH S AH L IY
PHARMACOKINETIC	F AA R M AH K AA K AH N AH T AH K
PHARMACOKINETICS	F AA R M AH K AH K IH N AH T AH S Z
PHENAKITE	F EH N AH K AY T
PHENAKITES	F EH N AH K AY T S
PHOSPHOFRUCTOKINASE	F AA S AH F R AH K T AA K AH N EY Z
PHOSPHOFRUCTOKINASES	F AA S AH F R AH K T AA K AH N EY Z AH Z
PHOSPHOKINASE	F AA S AA K AH N EY Z
PHOSPHOKINASES	F AA S AA K AH N EY Z AH Z
PHOTOKINESES	F AH T AA K AH N IY Z AH Z
PHOTOKINESIS	F AA T AH K AY N AH S AH S
PHOTOKINETIC	F OW T OW K AH N EH T IH K
PHRASEMAKING	F R EY Z M EY K IH NG
PHRASEMAKINGS	F R EY Z M EY K IH NG Z
PHYSICKING	F AH S IH K AH NG
PICKABACKING	P IH K AH B AE K IH NG
PICKIER	P IH K IY ER
PICKIEST	P IH K IY AH S T
PICKING	P IH K IH NG
PICKINGS	P IH K IH NG Z
PICNICKING	P IH K N IH K IH NG
PIGGYBACKING	P IH G IY B AE K IH NG
PIGSKIN	P IH G S K IH N
PIGSKINS	P IH G S K IH N Z
PIGSTICKING	P IH G S T IH K IH NG
PIKI	P IH K IY
PIKING	P AY K IH NG
PIKIS	P AY K IY Z
PINKIE	P IH NG K IY
PINKIES	P IH NG K IY Z
PINKING	P IH NG K IH NG
PINKINGS	P IH NG K IH NG Z
PINKISH	P IH NG K IH SH
PINKISHNESS	P IH NG K IH SH N AH S
PINKISHNESSES	P IH NG K IH SH N AH S IH Z
PINPRICKING	P IH N P R IH K IH NG
PIPKIN	P IH P K IH N
PIPKINS	P IH P K IH N Z
PIROJKI	P AH R AA JH K IY
PIROSHKI	P AH R AA SH IY
PIROZHKI	P AH R AA Z HH K IY
PITCHFORKING	P IH CH F AO R K IH NG
PLACEKICK	P L EY S K IH K
PLACEKICKED	P L EY S K IH K T
PLACEKICKER	P L EY S K IH K ER
PLACEKICKERS	P L EY S K IH K ER Z
PLACEKICKING	P L EY S K IH K IH NG
PLACEKICKS	P L EY S K IH K S
PLANKING	P L AE NG K IH NG
PLANKINGS	P L AE NG K IH NG Z
PLATEMAKING	P L EY T M EY K IH NG
PLATEMAKINGS	P L EY T M EY K IH NG Z
PLAYMAKING	P L EY M EY K IH NG
PLAYMAKINGS	P L EY M EY K IH NG Z
PLINKING	P L IH NG K IH NG
PLISKIE	P L IH S AY
PLISKIES	P L IH S AY Z
PLONKING	P L AO NG K AH NG
PLUCKIER	P L AH K IY ER
PLUCKIEST	P L AH K IY AH S T
PLUCKILY	P L AH K IY L IY
PLUCKINESS	P L AH K IY N AH S
PLUCKINESSES	P L AH K IY N AH S IH Z
PLUCKING	P L AH K IH NG
PLUNKING	P L AH NG K IH NG
POCKIER	P AA K AY AH R
POCKIEST	P AA K AY AH S T
POCKILY	P AA K AH L IY
POCKING	P AA K AH NG
POCKMARKING	P AA K M AA R K AH NG
POIKILOTHERM	P OY K IH L AH TH AH R M
POIKILOTHERMIC	P OY K IH L AH TH AH R M AH K
POIKILOTHERMS	P OY K IH L AH TH AH R M Z
POKIER	P OW K IY ER
POKIES	P OW K IY Z
POKIEST	P OW K IY AH S T
POKILY	P OW K IY L IY
POKINESS	P OW K IY N AH S
POKINESSES	P OW K IY N AH S IH Z
POKING	P OW K IH NG
POLITICKING	P AA L AH T IH K IH NG
PORKIER	P OW R K IY ER
PORKIES	P OW R K IY Z
PORKIEST	P OW R K IY AH S T
POSTMARKING	P OW S T M AA R K IH NG
PRANKING	P R AE NG K IH NG
PRANKISH	P R AE NG K IH SH
PRANKISHLY	P R AE NG K IH SH L IY
PRANKISHNESS	P R AE NG K IH SH N AH S
PRANKISHNESSES	P R AE NG K IH SH N AH S IH Z
PREBAKING	P R IY B EY K IH NG
PREBOOKING	P R IY B UH K IH NG
PRECHECKING	P R IY CH EH K IH NG
PRECOOKING	P R IY K UH K IH NG
PREFRANKING	P R IY F R AE NG K IH NG
PREKINDERGARTEN	P R IY K IH N D ER G AA D AH N
PREKINDERGARTENS	P R IY K IH N D ER G AA R T AH N Z
PREPACKING	P R IY P AE K IH NG
PRESHRINKING	P R IY SH R IH NG K IH NG
PRESOAKING	P R IY S OW K IH NG
PRICKIER	P R IH K IY ER
PRICKIEST	P R IH K IY AH S T
PRICKING	P R IH K IH NG
PRICKINGS	P R IH K IH NG Z
PRINKING	P R IH NG K AH NG
PRINTMAKING	P R IH N T M EY K IH NG
PRINTMAKINGS	P R IH N T M EY K IH NG Z
PROVOKING	P R AH V OW K IH NG
PROVOKINGLY	P R AH V OW K IH NG L IY
PSYCHOKINESES	S AY K AH K AH N IY Z AH Z
PSYCHOKINESIS	S AY K OW K AH N IY S AH S
PSYCHOKINETIC	S AY K OW K AH N EH T IH K
PUCKISH	P AH K IH SH
PUCKISHLY	P AH K IH SH L IY
PUCKISHNESS	P AH K IH SH N AH S
PUCKISHNESSES	P AH K IH SH N AH S IH Z
PUKING	P Y UW K IH NG
PUMPKIN	P AH M P K IH N
PUMPKIN(2)	P AH M K IH N
PUMPKINS	P AH M P K AH N Z
PUMPKINS(2)	P AH M K AH N Z
PUMPKINSEED	P AH M P K AH N S IY D
PUMPKINSEEDS	P AH M P K AH N S IY D Z
PUNKIE	P AH NG K IY
PUNKIER	P AH NG K IY ER
PUNKIES	P AH NG K IY Z
PUNKIEST	P AH NG K IY AH S T
PUNKIN	P AH NG K IH N
PUNKINESS	P AH NG K IY N AH S
PUNKINESSES	P AH NG K IY N AH S IH Z
PUNKINS	P AH N K IH N Z
PUNKISH	P AH NG K IH SH
QUACKING	K W AE K IH NG
QUACKISH	K W AE K IH SH
QUACKISM	K W AE K IH Z AH M
QUACKISMS	K W AE K IH Z AH M Z
QUAKIER	K W EY K IY ER
QUAKIEST	K W EY K IY AH S T
QUAKILY	K W EY K IY L IY
QUAKING	K W EY K IH NG
QUARTERBACKING	K W AO R T ER B AE K IH NG
QUICKIE	K W IH K IY
QUICKIES	K W IH K IY Z
QUIRKIER	K W ER K IY ER
QUIRKIEST	K W ER K IY AH S T
QUIRKILY	K W ER K IY L IY
QUIRKINESS	K W ER K IY N AH S
QUIRKINESSES	K W ER K IY N AH S IH Z
QUIRKING	K W ER K IH NG
QUIRKISH	K W ER K IH SH
RACEWALKING	R EY S W AO K IH NG
RACEWALKINGS	R EY S W AO K IH NG Z
RACKING	R AE K IH NG
RACKINGLY	R AE K IH NG L IY
RAINMAKING	R EY N M EY K IH NG
RAINMAKINGS	R EY N M EY K IH NG Z
RAKI	R AE K IY
RAKING	R EY K IH NG
RAKIS	R EY K IY Z
RAKISH	R EY K IH SH
RAKISHLY	R EY K IH SH L IY
RAKISHNESS	R EY K IH SH N AH S
RAKISHNESSES	R EY K IH SH N AH S IH Z
RAMEKIN	R AE M AH K AH N
RAMEKINS	R AE M AH K AH N Z
RANKING	R AE NG K IH NG
RANKINGS	R AE NG K IH NG Z
RANKISH	R AE NG K IH SH
RANSACKING	R AE N S AE K IH NG
REATTACKING	R IY AH T AE K IH NG
REAWAKING	R IY AH W EY K IH NG
REBOOKING	R IY B UH K IH NG
REBUKING	R IY B Y UW K IH NG
RECHECKING	R IY CH EH K IH NG
RECKING	R EH K IH NG
RECOCKING	R IY K AA K IH NG
RECOOKING	R IY K UH K IH NG
RECORKING	R IY K AO R K IH NG
REDOCKING	R IY D AA K IH NG
REDSKIN	R EH D S K IH N
REDSKINS	R EH D S K IH N Z
REEKIER	R IY K IY ER
REEKIEST	R IY K IY AH S T
REEKING	R IY K IH NG
REEMBARKING	R IY IH M B AA R K IH NG
REEVOKING	R IY IH V OW K IH NG
REINKING	R AY NG K IH NG
REINVOKING	R IY IH N V OW K IH NG
REKINDLE	R IY K IH N D AH L
REKINDLED	R IY K IH N D AH L D
REKINDLES	R IY K IH N D AH L Z
REKINDLING	R IY K IH N D L IH NG
RELINKING	R IY L IH NG K IH NG
RELOCKING	R IY L AA K IH NG
RELOOKING	R IY L UH K IH NG
REMAKING	R IY M EY K IH NG
REMARKING	R IH M AA R K IH NG
REPACKING	R IY P AE K IH NG
REPARKING	R IY P AA R K IH NG
REPERKING	R IY P ER K IH NG
RERACKING	R IY R AE K IH NG
RESEEKING	R IY S IY K IH NG
RESOAKING	R IY S OW K IH NG
RESPEAKING	R IY S P IY K IH NG
RESTACKING	R IY S T AE K IH NG
RESTOCKING	R IY S T AA K IH NG
RESTOKING	R IY S T OW K IH NG
RESTRIKING	R IY S T R AY K IH NG
RETACKING	R IY T AE K IH NG
RETAKING	R IY T EY K IH NG
RETHINKING	R IY TH IH NG K IH NG
RETRACKING	R IY T R AE K IH NG
REVOKING	R IH V OW K IH NG
REVOKING(2)	R IY V OW K IH NG
REWAKING	R IY W EY K IH NG
REWORKING	R IY W ER K IH NG
RICKING	R IH K AH NG
RIKISHA	R IH K AH SH AH
RIKISHAS	R IH K AH SH AH Z
RINGBARKING	R IH NG B AA R K IH NG
RISKIER	R IH S K IY ER
RISKIEST	R IH S K IY AH S T
RISKILY	R IH S K IY L IY
RISKINESS	R IH S K IY N AH S
RISKINESSES	R IH S K IY N AH S IH Z
RISKING	R IH S K IH NG
ROADBLOCKING	R OW D B L AA K IH NG
ROADKILL	R OW D K IH L
ROADKILLS	R OW D K IH L Z
ROCKIER	R AA K IY ER
ROCKIEST	R AA K IY AH S T
ROCKINESS	R AA K IY N AH S
ROCKINESSES	R AA K IY N AH S IH Z
ROCKING	R AA K IH NG
ROLLICKING	R AA L IH K IH NG
ROOKIE	R UH K IY
ROOKIER	R UH K IY ER
ROOKIES	R UH K IY Z
ROOKIEST	R UH K IY AH S T
ROOKING	R UH K AH NG
RUBBERNECKING	R AH B ER N EH K IH NG
RUCKING	R AH K AH NG
RUDBECKIA	R AH D EH K IY AH
RUDBECKIAS	R AH D EH K IY AH Z
RUMAKI	R UW M AH K IY
RUMAKIS	R UW M AH K AH S
RYKING	R AY K AH NG
SACKING	S AE K IH NG
SACKINGS	S AE K IH NG Z
SAFECRACKING	S EY F K R AE K IH NG
SAFECRACKINGS	S EY F K R AE K IH NG Z
SAKI	S AA K IY
SAKIS	S EY K IY Z
SALUKI	S AH L UW K IY
SALUKIS	S AH L UW K AH S
SAMARSKITE	S EY M ER Z K AY T
SAMARSKITES	S EY M ER Z K AY T S
SARKIER	S AA R K AY AH R
SARKIEST	S AA R K AY AH S T
SCARFSKIN	S K AA R F S K IH N
SCARFSKINS	S K AA R F S K IH N Z
SCHOOLKID	S K UW L K IH D
SCHOOLKIDS	S K UW L K IH D Z
SCREAKING	S K R IY K AH NG
SCULKING	S K AH K AH NG
SEALSKIN	S IY L S K IH N
SEALSKINS	S IY L S K IH N Z
SEEKING	S IY K IH NG
SEMISKILLED	S EH M IY S K IH L D
SHAKIER	SH EY K IY ER
SHAKIEST	SH EY K IY IH S T
SHAKILY	SH EY K IY L IY
SHAKINESS	SH EY K IY N AH S
SHAKINESSES	SH EY K IY N AH S IH Z
SHAKING	SH EY K IH NG
SHANKING	SH AE NG K IH NG
SHARKING	SH AA R K IH NG
SHARKSKIN	SH AA R K S K IH N
SHARKSKINS	SH AA R K S K IH N Z
SHEEPSKIN	SH IY P S K IH N
SHEEPSKINS	SH IY P S K IH N Z
SHELLACKING	SH EH L AE K IH NG
SHELLACKINGS	SH EH L AE K AH NG Z
SHIPWRECKING	SH IH P R EH K IH NG
SHIRKING	SH ER K IH NG
SHOCKING	SH AA K IH NG
SHOCKINGLY	SH AA K IH NG L IY
SHRIEKIER	SH R IY K IY ER
SHRIEKIEST	SH R IY K IY AH S T
SHRIEKING	SH R IY K IH NG
SHRINKING	SH R IH NG K IH NG
SHUCKING	SH AH K IH NG
SHUCKINGS	SH AH K IH NG Z
SHUNPIKING	SH AH N P AY K IH NG
SHUNPIKINGS	SH AH N P AY K IH NG Z
SHUTTLECOCKING	SH AH T AH L K AA K IH NG
SHYLOCKING	SH AY L AA K IH NG
SICKIE	S IH K IY
SICKIES	S IH K IY Z
SICKING	S IH K IH NG
SICKISH	S IH K IH SH
SICKISHLY	S IH K IH SH L IY
SICKISHNESS	S IH K IH SH N AH S
SICKISHNESSES	S IH K IH SH N AH S IH Z
SIDEKICK	S AY D K IH K
SIDEKICKS	S AY D K IH K S
SIDETRACKING	S AY D T R AE K IH NG
SILKIER	S IH L K IY ER
SILKIES	S IH L K IY Z
SILKIEST	S IH L K IY AH S T
SILKILY	S IH L K IY L IY
SILKINESS	S IH L K IY N AH S
SILKINESSES	S IH L K IY N AH S IH Z
SILKING	S IH L K IH NG
SINKING	S IH NG K IH NG
SISKIN	S IH S K IH N
SISKINS	S IY Z K IH N Z
SJAMBOKING	S JH AE M B OW K AH NG
SKI	S K IY
SKIABLE	S K AY AH B AH L
SKIAGRAM	S K IY AH G R AE M
SKIAGRAMS	S K IY AH G R AE M Z
SKIBOB	S K IY B AA B
SKIBOBBER	S K IY B AA B ER
SKIBOBBERS	S K IY B AA B ER Z
SKIBOBBING	S K IY B AA B IH NG
SKIBOBBINGS	S K IY B AA B IH NG Z
SKIBOBS	S K IY B AA B Z
SKID	S K IH D
SKIDDED	S K IH D AH D
SKIDDED(2)	S K IH D IH D
SKIDDER	S K IH D ER
SKIDDERS	S K IH D ER Z
SKIDDIER	S K IH D IY ER
SKIDDIEST	S K IH D IY AH S T
SKIDDING	S K IH D IH NG
SKIDDOO	S K IH D UW
SKIDDOOED	S K IH D UW D
SKIDDOOING	S K IH D UW IH NG
SKIDDOOS	S K IH D UW AA S
SKIDDY	S K IH D IY
SKIDOO	S K IH D UW
SKIDOOED	S K IY D UW D
SKIDOOING	S K IY D UW IH NG
SKIDOOS	S K IY D UW AA S
SKIDPROOF	S K IH D P R UW F
SKIDS	S K IH D Z
SKIDWAY	S K IH D W EY
SKIDWAYS	S K IH D W EY Z
SKIED	S K IY D
SKIER	S K AY R
SKIER(2)	S K IY ER
SKIERS	S K IY ER Z
SKIES	S K AY Z
SKIEY	S K AY IY
SKIFF	S K IH F
SKIFFLE	S K IH F AH L
SKIFFLED	S K IH F L EH D
SKIFFLES	S K IH F AH L Z
SKIFFLING	S K IH F L IH NG
SKIFFS	S K IH F S
SKIING	S K IY IH NG
SKIINGS	S K AY IH NG Z
SKIJORER	S K IH JH AH R AH R
SKIJORERS	S K IH JH AH R AH R Z
SKIJORING	S K IH JH AH R AH NG
SKIJORINGS	S K IH JH AH R AH NG Z
SKILFUL	S K IH L F AH L
SKILL	S K IH L
SKILLED	S K IH L D
SKILLESS	S K IH L AH S
SKILLESSNESS	S K IH L AH S N AH S
SKILLESSNESSES	S K IH L AH S N AH S IH Z
SKILLET	S K IH L AH T
SKILLETS	S K IH L AH T S
SKILLFUL	S K IH L F AH L
SKILLFULLY	S K IH L F AH L IY
SKILLFULNESS	S K IH L F AH L N AH S
SKILLFULNESSES	S K IH L F AH L N AH S IH Z
SKILLING	S K IH L IH NG
SKILLINGS	S K IH L IH NG Z
SKILLS	S K IH L Z
SKIM	S K IH M
SKIMMED	S K IH M D
SKIMMER	S K IH M ER
SKIMMERS	S K IH M ER Z
SKIMMING	S K IH M IH NG
SKIMMINGS	S K IH M IH NG Z
SKIMO	S K IH M OW
SKIMOBILE	S K IY M OW B AH L
SKIMOBILES	S K IY M OW B AH L Z
SKIMOS	S K IH M AA S
SKIMP	S K IH M P
SKIMPED	S K IH M P T
SKIMPIER	S K IH M P IY ER
SKIMPIEST	S K IH M P IY AH S T
SKIMPILY	S K IH M P IY L IY
SKIMPINESS	S K IH M P IY N AH S
SKIMPINESSES	S K IH M P IY N AH S IH Z
SKIMPING	S K IH M P IH NG
SKIMPS	S K IH M P S
SKIMPY	S K IH M P IY
SKIMS	S K IH M Z
SKIN	S K IH N
SKINFLINT	S K IH N F L IH N T
SKINFLINTS	S K IH N F L IH N T S
SKINFUL	S K IH N F AH L
SKINFULS	S K IH N F AH L Z
SKINHEAD	S K IH N HH EH D
SKINHEADS	S K IH N HH EH D Z
SKINK	S K IH NG K
SKINKED	S K IH NG K T
SKINKER	S K IH NG K AH R
SKINKERS	S K IH NG K AH R Z
SKINKING	S K IH N K IH NG
SKINKS	S K IH NG K S
SKINLESS	S K IH N L AH S
SKINLIKE	S K IH N L AY K
SKINNED	S K IH N D
SKINNER	S K IH N ER
SKINNERS	S K IH N ER Z
SKINNIER	S K IH N IY ER
SKINNIEST	S K IH N IY AH S T
SKINNINESS	S K IH N IY N AH S
SKINNINESSES	S K IH N IY N AH S IH Z
SKINNING	S K IH N IH NG
SKINNY	S K IH N IY
SKINS	S K IH N Z
SKINT	S K IH N T
SKINTIGHT	S K IH N T AY T
SKIORING	S K AY ER IH NG
SKIORINGS	S K AY ER IH NG Z
SKIP	S K IH P
SKIPJACK	S K IH P JH AE K
SKIPJACKS	S K IH P JH AE K S
SKIPLANE	S K IY P L EY N
SKIPLANES	S K IY P L EY N Z
SKIPPABLE	S K IH P AH B AH L
SKIPPED	S K IH P T
SKIPPER	S K IH P ER
SKIPPERED	S K IH P ER D
SKIPPERING	S K IH P ER IH NG
SKIPPERS	S K IH P ER Z
SKIPPET	S K IH P EH T
SKIPPETS	S K IH P EH T S
SKIPPING	S K IH P IH NG
SKIPS	S K IH P S
SKIRL	S K AH R L
SKIRLED	S K AH R L D
SKIRLING	S K AH R L AH NG
SKIRLS	S K AH R L Z
SKIRMISH	S K ER M IH SH
SKIRMISHED	S K ER M IH SH T
SKIRMISHER	S K ER M IH SH ER
SKIRMISHERS	S K ER M IH SH ER Z
SKIRMISHES	S K ER M IH SH IH Z
SKIRMISHING	S K ER M IH SH IH NG
SKIRR	S K AH R
SKIRRED	S K AH R D
SKIRRET	S K AH R AH T
SKIRRETS	S K AH R AH T S
SKIRRING	S K AH R AH NG
SKIRRS	S K AH R Z
SKIRT	S K ER T
SKIRTED	S K ER T IH D
SKIRTER	S K ER T ER
SKIRTERS	S K ER T ER Z
SKIRTING	S K ER T IH NG
SKIRTINGS	S K ER T IH NG Z
SKIRTS	S K ER T S
SKIS	S K IY Z
SKIT	S K IH T
SKITE	S K AY T
SKITED	S K IH T IH D
SKITES	S K AY T S
SKITING	S K IH T IH NG
SKITS	S K IH T S
SKITTER	S K IH T ER
SKITTERED	S K IH T ER D
SKITTERIER	S K IH T AH R IY ER
SKITTERIEST	S K IH T AH R IY AH S T
SKITTERING	S K IH T ER IH NG
SKITTERS	S K IH T ER Z
SKITTERY	S K IH T AH R IY
SKITTISH	S K IH T IH SH
SKITTISHLY	S K IH T IH SH L IY
SKITTISHNESS	S K IH T IH SH N AH S
SKITTISHNESSES	S K IH T IH SH N AH S IH Z
SKITTLE	S K IH T AH L
SKITTLES	S K IH T AH L Z
SKIVE	S K AY V
SKIVED	S K AY V D
SKIVER	S K AY V ER
SKIVERS	S K IH V AH R Z
SKIVES	S K AY V Z
SKIVING	S K AY V AH NG
SKIVVIED	S K IH V AY D
SKIVVIES	S K IH V AY Z
SKIVVY	S K IH V IY
SKIVVYING	S K IH V AY AH NG
SKIWEAR	S K IY W AE ER
SKULKING	S K AH L K IH NG
SKUNKING	S K AH NG K IH NG
SKYJACKING	S K AY JH AE K IH NG
SKYJACKINGS	S K AY JH AE K IH NG Z
SKYLARKING	S K AY L AA R K IH NG
SLACKING	S L AE K IH NG
SLAKING	S L EY K IH NG
SLEEKIER	S L IY K IY ER
SLEEKIEST	S L IY K IY AH S T
SLEEKING	S L IY K IH NG
SLEEKIT	S L IY K AH T
SLEEPWALKING	S L IY P W AO K IH NG
SLICKING	S L IH K IH NG
SLINKIER	S L IH NG K AY AH R
SLINKIEST	S L IH NG K AY AH S T
SLINKILY	S L IH NG K AH L IY
SLINKINESS	S L IH NG K AH N AH S
SLINKINESSES	S L IH NG K AH N EH S AH Z
SLINKING	S L IH NG K AH NG
SMACKING	S M AE K IH NG
SMEEKING	S M IY K AH NG
SMERKING	S M AH R K AH NG
SMIRKIER	S M ER K IY ER
SMIRKIEST	S M ER K IY AH S T
SMIRKING	S M ER K IH NG
SMOCKING	S M AA K AH NG
SMOCKINGS	S M AA K AH NG Z
SMOKIER	S M OW K IY ER
SMOKIEST	S M OW K IY AH S T
SMOKILY	S M OW K IY L IY
SMOKINESS	S M OW K IY N AH S
SMOKINESSES	S M OW K IY N AH S IH Z
SMOKING	S M OW K IH NG
SNACKING	S N AE K IH NG
SNAKESKIN	S N EY K S K IH N
SNAKESKINS	S N EY K S K IH N Z
SNAKIER	S N EY K IY ER
SNAKIEST	S N EY K IY AH S T
SNAKILY	S N EY K IY L IY
SNAKING	S N EY K IH NG
SNARKIER	S N AA R K AY AH R
SNARKIEST	S N AA R K AY AH S T
SNEAKIER	S N IY K IY ER
SNEAKIEST	S N IY K IY AH S T
SNEAKILY	S N IY K IY L IY
SNEAKINESS	S N IY K IY N AH S
SNEAKINESSES	S N IY K IY N AH S IH Z
SNEAKING	S N IY K IH NG
SNEAKINGLY	S N IY K IH NG L IY
SNICKING	S N IH K IH NG
SNOOKING	S N UH K IH NG
SNOWMAKING	S N OW M EY K IH NG
SOAKING	S OW K IH NG
SOCKING	S AA K IH NG
SOUVLAKI	S AW V L AH K IY
SOUVLAKIA	S AW V L EY K IY AH
SOUVLAKIAS	S AW V L EY K IY AH Z
SOUVLAKIS	S AW V L AH K AH S
SPACEWALKING	S P EY S W AA K IH NG
SPANKING	S P AE NG K IH NG
SPANKINGS	S P AE N K IH NG Z
SPARKIER	S P AA R K IY ER
SPARKIEST	S P AA R K IY AH S T
SPARKILY	S P AA R K IY L IY
SPARKING	S P AA R K IH NG
SPARKISH	S P AA R K IH SH
SPEAKING	S P IY K IH NG
SPEAKINGS	S P IY K IH NG Z
SPECKING	S P EH K IH NG
SPELUNKING	S P AH L AH NG K IH NG
SPELUNKINGS	S P AH L AH NG K AH NG Z
SPIKIER	S P AY K IY ER
SPIKIEST	S P AY K IY AH S T
SPIKILY	S P AY K IY L IY
SPIKINESS	S P AY K IY N AH S
SPIKINESSES	S P AY K IY N AH S IH Z
SPIKING	S P AY K IH NG
SPILIKIN	S P IH L AH K AH N
SPILIKINS	S P IH L AH K AH N Z
SPILLIKIN	S P IH L AH K AH N
SPILLIKINS	S P IH L AH K AH N Z
SPOKING	S P OW K IH NG
SPOOKIER	S P UW K IY ER
SPOOKIEST	S P UW K IY AH S T
SPOOKILY	S P UW K IY L IY
SPOOKINESS	S P UW K IY N AH S
SPOOKINESSES	S P UW K IY N AH S IH Z
SPOOKING	S P UW K IH NG
SPOOKISH	S P UW K IH SH
SPUNKIE	S P AH NG K AY
SPUNKIER	S P AH NG K AY AH R
SPUNKIES	S P AH NG K AY Z
SPUNKIEST	S P AH NG K AY AH S T
SPUNKILY	S P AH NG K AH L IY
SPUNKINESS	S P AH N K IH N AH S
SPUNKINESSES	S P AH N K IH N AH S IH Z
SPUNKING	S P AH N K IH NG
SQUAWKING	S K W AO K IH NG
SQUEAKIER	S K W IY K IY ER
SQUEAKIEST	S K W IY K IY AH S T
SQUEAKING	S K W IY K IH NG
STACKING	S T AE K IH NG
STAKING	S T EY K IH NG
STALKIER	S T AO K IY ER
STALKIEST	S T AO K IY AH S T
STALKILY	S T AO K IY L IY
STALKING	S T AO K IH NG
STEEKING	S T IY K AH NG
STEELMAKING	S T IY L M EY K IH NG
STEELMAKINGS	S T IY L M EY K IH NG Z
STENOKIES	S T EH N AH K AY Z
STICKIER	S T IH K IY ER
STICKIEST	S T IH K IY AH S T
STICKILY	S T IH K IY L IY
STICKINESS	S T IH K IY N AH S
STICKINESSES	S T IH K IY N AH S IH Z
STICKING	S T IH K IH NG
STICKIT	S T IH K AH T
STINKIER	S T IH NG K IY ER
STINKIEST	S T IH NG K IY AH S T
STINKING	S T IH NG K IH NG
STINKINGLY	S T IH NG K IH NG L IY
STOCKBROKING	S T AA K B R OW K IH NG
STOCKBROKINGS	S T AA K B R OW K IH NG Z
STOCKIER	S T AA K IY ER
STOCKIEST	S T AA K IY AH S T
STOCKILY	S T AA K IY L IY
STOCKINESS	S T AA K IY N AH S
STOCKINESSES	S T AA K IY N AH S IH Z
STOCKINET	S T AA K AH N AH T
STOCKINETS	S T AA K AH N AH T S
STOCKINETTE	S T AA K IH N EH T
STOCKINETTES	S T AA K IH N EH T S
STOCKING	S T AA K IH NG
STOCKINGED	S T AA K IH NG D
STOCKINGS	S T AA K IH NG Z
STOCKISH	S T AA K IH SH
STOCKIST	S T AA K IH S T
STOCKISTS	S T AA K IH S T S
STOCKTAKING	S T AA K T EY K IH NG
STOCKTAKINGS	S T AA K T EY K IH NG Z
STOKING	S T OW K IH NG
STOOKING	S T UW K AH NG
STOTINKI	S T AH T IH NG K IY
STREAKIER	S T R IY K IY ER
STREAKIEST	S T R IY K IY AH S T
STREAKINESS	S T R IY K IY N AH S
STREAKINESSES	S T R IY K IY N AH S IH Z
STREAKING	S T R IY K IH NG
STREAKINGS	S T R IY K IH NG Z
STREEKING	S T R IY K AH NG
STREETWALKING	S T R IY T W AO K IH NG
STREETWALKINGS	S T R IY T W AO K IH NG Z
STREPTOKINASE	S T R EH P T AH K AY N EY S
STREPTOKINASE(2)	S T R EH P T OW K AY N EY Z
STREPTOKINASES	S T R EH P T AA K AH N EY Z AH Z
STRIKEBREAKING	S T R AY K B R EY K IH NG
STRIKEBREAKINGS	S T R AY K B R EY K IH NG Z
STRIKING	S T R AY K IH NG
STRIKINGLY	S T R AY K IH NG L IY
STROKING	S T R OW K IH NG
SUBKINGDOM	S AH B K IH NG D AH M
SUBKINGDOMS	S AH B K IH NG D AH M Z
SUBSKILL	S AH B S K IH L
SUBSKILLS	S AH B S K IH L Z
SUCKING	S AH K IH NG
SUKIYAKI	S UW K IY AA K IY
SUKIYAKIS	S UW K IY AY AH K AH S
SULKIER	S AH L K IY ER
SULKIES	S AH L K IY Z
SULKIEST	S AH L K IY AH S T
SULKILY	S AH L K IY L IY
SULKINESS	S AH L K IY N AH S
SULKINESSES	S AH L K IY N AH S IH Z
SULKING	S AH L K IH NG
SWANKIER	S W AE NG K IY ER
SWANKIEST	S W AE NG K IY AH S T
SWANKILY	S W AE NG K IY L IY
SWANKINESS	S W AE NG K IY N AH S
SWANKINESSES	S W AE NG K IY N AH S IH Z
SWANKING	S W AE NG K IH NG
SWANSKIN	S W AA N S K IH N
SWANSKINS	S W AA N S K IH N Z
SWINKING	S W IH NG K AH NG
SWITCHBACKING	S W IH CH B AE K IH NG
TACKIER	T AE K IY ER
TACKIEST	T AE K IY AH S T
TACKIFIED	T AE K AH F AY D
TACKIFIER	T AE K AH F AY ER
TACKIFIERS	T AE K AH F AY ER Z
TACKIFIES	T AE K AH F AY Z
TACKIFY	T AE K AH F AY
TACKIFYING	T AE K AH F AY IH NG
TACKILY	T AE K IY L IY
TACKINESS	T AE K IY N AH S
TACKINESSES	T AE K IY N AH S IH Z
TACKING	T AE K IH NG
TAILSKID	T EY L S K IH D
TAILSKIDS	T EY L S K IH D Z
TAKIN	T AE K AH N
TAKING	T EY K IH NG
TAKINGLY	T EY K IH NG L IY
TAKINGS	T EY K IH NG Z
TAKINS	T AE K AH N Z
TALCKING	T AE L K AH NG
TALKIE	T AO K IY
TALKIER	T AO K IY ER
TALKIES	T AO K IY Z
TALKIEST	T AO K IY AH S T
TALKINESS	T AO K IY N AH S
TALKINESSES	T AO K IY N AH S IH Z
TALKING	T AO K IH NG
TALKINGS	T AO K IH NG Z
TANKING	T AE NG K IH NG
TANUKI	T AE N Y AH K IY
TANUKIS	T AE N Y UW K AH S
TASKING	T AE S K IH NG
TELEKINESES	T AH L EH K AH N IY Z AH Z
TELEKINESIS	T EH L AH K AY N AH S AH S
TELEKINETIC	T EH L AH K AH N EH T IH K
TELEKINETICALLY	T EH L AH K AH N EH T IH K AH L IY
TERIYAKI	T EH R IH Y AA K IY
TERIYAKIS	T IY R IY AY AH K AH S
TEXTBOOKISH	T EH K S T B UH K IH SH
THACKING	TH AE K AH NG
THANKING	TH AE NG K IH NG
THICKISH	TH IH K IH SH
THINKING	TH IH NG K IH NG
THINKINGLY	TH IH NG K IH NG L IY
THINKINGNESS	TH IH N K IH NG N AH S
THINKINGNESSES	TH IH N K IH NG N AH S IH Z
THINKINGS	TH IH NG K IH NG Z
THROMBOKINASE	TH R AA M B AA K AH N EY Z
THROMBOKINASES	TH R AA M B AA K AH N EY Z AH Z
THUMBKIN	TH AH M K IH N
THUMBKINS	TH AH M K IH N Z
THUMBTACKING	TH AH M T AE K IH NG
THUNDERSTRIKING	TH AH N D ER S T R AY K IH NG
THUNKING	TH AH NG K AH NG
THWACKING	TH W AE K IH NG
TICKING	T IH K IH NG
TICKINGS	T IH K IH NG Z
TICKTACKING	T IH K T AE K IH NG
TICKTOCKING	T IH K T AA K AH NG
TICTACKING	T IH K T AE K AH NG
TICTOCKING	T IH K T AA K AH NG
TIEBREAKING	T AY B R EY K IH NG
TIKI	T IY K IY
TIKIS	T AY K AH S
TOKING	T OW K AH NG
TOMAHAWKING	T AA M AH HH AO K IH NG
TOOLMAKING	T UW L M EY K IH NG
TOOLMAKINGS	T UW L M EY K IH NG Z
TOPKICK	T AA P K IH K
TOPKICKS	T AA P K IH K S
TOPWORKING	T AA P W ER K IH NG
TRACKING	T R AE K IH NG
TRACKINGS	T R AE K IH NG Z
TRADEMARKING	T R EY D M AA R K IH NG
TRAFFICKING	T R AE F IH K IH NG
TRAIKING	T R EY K AH NG
TREKKING	T R EH K IH NG
TRICKIE	T R IH K IY
TRICKIER	T R IH K IY ER
TRICKIEST	T R IH K IY AH S T
TRICKILY	T R IH K IY L IY
TRICKINESS	T R IH K IY N AH S
TRICKINESSES	T R IH K IY N AH S IH Z
TRICKING	T R IH K IH NG
TRICKISH	T R IH K IH SH
TRICKISHLY	T R IH K IH SH L IY
TRICKISHNESS	T R IH K IH SH N AH S
TRICKISHNESSES	T R IH K IH SH N AH S IH Z
TROAKING	T R OW K AH NG
TROCKING	T R AA K AH NG
TROKING	T R OW K AH NG
TROUBLEMAKING	T R AH B AH L M EY K IH NG
TROUBLEMAKINGS	T R AH B AH L M EY K IH NG Z
TRUCKING	T R AH K IH NG
TRUCKINGS	T R AH K IH NG Z
TSKING	T S K IH NG
TSKTSKING	T S K T S K IH NG
TUCKING	T AH K IH NG
TURFSKI	T ER F S K IY
TURFSKIING	T ER F S K AY IH NG
TURFSKIINGS	T ER F S K AY IH NG Z
TURFSKIS	T ER F S K AY Z
TUSKING	T AH S K IH NG
TWANKIES	T W AA NG K AY Z
TWEAKIER	T W IY K AY AH R
TWEAKIEST	T W IY K AY AH S T
TWEAKING	T W IY K IH NG
TZADDIKIM	T S AE D AH K AH M
UNAKIN	AH N AH K IH N
UNAKITE	AH N AH K AY T
UNAKITES	AH N AH K AY T S
UNBLINKING	AH N B L IH NG K IH NG
UNBLINKINGLY	AH N B L IH NG K IH NG L IY
UNBLOCKING	AH N B L AA K IH NG
UNBOOKISH	AH N B UH K IH SH
UNBRAKING	AH N B R EY K IH NG
UNCAKING	AH N K EY K IH NG
UNCHOKING	AH N CH OW K IH NG
UNCLOAKING	AH N K L OW K IH NG
UNCOCKING	AH N K AA K IH NG
UNCORKING	AH N K AO R K IH NG
UNDERSKIRT	AH N D ER S K ER T
UNDERSKIRTS	AH N D ER S K ER T S
UNDERTAKING	AH N D ER T EY K IH NG
UNDERTAKINGS	AH N D ER T EY K IH NG Z
UNDOCKING	AH N D AA K IH NG
UNFROCKING	AH N F R AA K IH NG
UNHOOKING	AH N HH UH K IH NG
UNHUSKING	AH N HH AH S K IH NG
UNKIND	AH N K AY N D
UNKINDER	AH N K AY N D ER
UNKINDEST	AH N K AY N D IH S T
UNKINDLIER	AH N K AY N D L IY ER
UNKINDLIEST	AH N K AY N D L IY AH S T
UNKINDLINESS	AH N K AY N D L IY N AH S
UNKINDLINESSES	AH N K AY N D L IY N AH S IH Z
UNKINDLY	AH N K AY N D L IY
UNKINDNESS	AH N K AY N D N AH S
UNKINDNESSES	AH N K AY N D N AH S IH Z
UNKINGLY	AH N K IH NG L IY
UNKINK	AH N K IH NG K
UNKINKED	AH N K IH NG K T
UNKINKING	AH N K IH N K IH NG
UNKINKS	AH N K IH NG K S
UNKISSED	AH N K IH S T
UNLINKING	AH N L IH NG K IH NG
UNLOCKING	AH N L AA K IH NG
UNLUCKIER	AH N L UW S IY ER
UNLUCKIEST	AH N L UW S IY AH S T
UNLUCKILY	AH N L UW S IY L IY
UNLUCKINESS	AH N L UW S IY N AH S
UNLUCKINESSES	AH N L UW S IY N AH S IH Z
UNMAKING	AH N M EY K IH NG
UNMASKING	AH N M AE S K IH NG
UNPACKING	AH N P AE K IH NG
UNPICKING	AH N P IH K IH NG
UNSKILLED	AH N S K IH L D
UNSKILLFUL	AH N S K IH L F AH L
UNSKILLFULLY	AH N S K IH L F AH L IY
UNSKILLFULNESS	AH N S K IH L F AH L N AH S
UNSKILLFULNESSES	AH N S K IH L F AH L N AH S IH Z
UNSPEAKING	AH N S P IY K IH NG
UNSTACKING	AH N S T AE K IH NG
UNSTICKING	AH N S T IH K IH NG
UNTACKING	AH N T AE K IH NG
UNTHINKING	AH N TH IH NG K IH NG
UNTHINKINGLY	AH N TH IH NG K IH NG L IY
UNTUCKING	AH N T AH K IH NG
UNWORKING	AH N W ER K IH NG
UNYOKING	AH N Y OW K IH NG
UPCHUCKING	AH P CH AH K IH NG
UROKINASE	Y ER AH K AH N EY Z
UROKINASES	Y AH R AA K AH N EY Z AH Z
VAKIL	V AE K AH L
VAKILS	V EY K AH L Z
VIKING	V AY K IH NG
VIKINGS	V AY K IH NG Z
WACKIER	W AE K IY ER
WACKIEST	W AE K IY AH S T
WACKILY	W AE K IY L IY
WACKINESS	W AE K IY N AH S
WACKINESSES	W AE K IY N AH S IH Z
WAKIKI	W AE K AH K IY
WAKIKIS	W AE K AH K AH S
WAKING	W EY K IH NG
WALKING	W AO K IH NG
WALKINGS	W AO K IH NG Z
WALKINGSTICK	W AO K IH NG S T IH K
WALKINGSTICKS	W AO K IH NG S T IH K S
WARKING	W AO R K IH NG
WATCHMAKING	W AA CH M EY K IH NG
WATCHMAKINGS	W AA CH M EY K IH NG Z
WATERMARKING	W AO T ER M AA R K IH NG
WATERSKIING	W AO T ER S K AY IH NG
WATERSKIINGS	W AO T ER S K AY IH NG Z
WAUKING	W AO K AH NG
WEAKISH	W IY K IH SH
WELKIN	W EH L K AH N
WELKINS	W EH L K AH N Z
WESKIT	W IY Z K IH T
WESKITS	W IY Z K IH T S
WHACKIER	W AE K IY ER
WHACKIEST	W AE K IY AH S T
WHACKING	W AE K IH NG
WHACKING(2)	HH W AE K IH NG
WHELKIER	W EH L K AY AH R
WHELKIEST	W EH L K AY AH S T
WHISKIES	W IH S K IY Z
WHISKING	W IH S K IH NG
WICKING	W IH K IH NG
WICKINGS	W IH K IH NG Z
WICKIUP	W IH K IY AH P
WICKIUPS	W IH K IY AH P S
WIKIUP	W IH K IY AH P
WIKIUPS	W IH K IY AH P S
WINEMAKING	W AY N M EY K IH NG
WINEMAKINGS	W AY N M EY K IH NG Z
WINESKIN	W AY N S K IH N
WINESKINS	W AY N S K IH N Z
WINKING	W IH NG K IH NG
WINTERKILL	W IH N T ER K IH L
WINTERKILLS	W IH N T ER K IH L Z
WISECRACKING	W AY Z K R AE K IH NG
WOMANKIND	W UH M AH N K AY N D
WOMENKIND	W IH M AH N K AY N D
WONKIER	W AO NG K AY AH R
WONKIEST	W AO NG K AY AH S T
WOODWORKING	W UH D W ER K IH NG
WOODWORKINGS	W UH D W ER K IH NG Z
WOOLSKIN	W UH L S K IH N
WOOLSKINS	W UH L S K IH N Z
WORKING	W ER K IH NG
WORKINGMAN	W ER K IH NG M AE N
WORKINGMEN	W ER K IH NG M EH N
WORKINGS	W ER K IH NG Z
WORKINGWOMAN	W ER K IH NG W UH M AH N
WORKINGWOMEN	W ER K IH NG W IH M AH N
WRACKING	R AE K IH NG
WREAKING	R IY K IH NG
WRECKING	R EH K IH NG
WRECKINGS	R EH K IH NG Z
WRICKING	R IH K AH NG
WUNDERKIND	W AH N D ER K AY N D
WUNDERKIND(2)	W AH N D ER K IH N D
WUNDERKINDER	W AH N D AH R K AY N D AH R
WUNDERKINDS	W AH N D AH R K AY N D Z
YACKING	Y AE K AH NG
YAKITORI	Y AH K IH T AH R IY
YAKITORIS	Y AH K IH T AH R AH S
YAKKING	Y AE K IH NG
YANKING	Y AE NG K IH NG
YERKING	Y AH R K AH NG
YEUKING	Y UW K AH NG
YOCKING	Y AA K AH NG
YOKING	Y OW K IH NG
YOLKIER	Y OW K IY ER
YOLKIEST	Y OW K IY AH S T
YUCKIER	Y AH K AY AH R
YUCKIEST	Y AH K AY AH S T
YUCKING	Y AH K AH NG
YUKKING	Y AH K AH NG
ZADDIKIM	Z AE D AH K AH M
ZINCKING	Z IH NG K IH NG
ZINKIFIED	Z IH NG K AH F AY D
ZINKIFIES	Z IH NG K AH F AY Z
ZINKIFY	Z IH NG K AH F AY
ZINKIFYING	Z IH NG K IH F AY AH NG
ZONKING	Z AO NG K AH NG
SPEAK	S P IY K
VOTABLE	V OW T AH B AH L
FLAB	F L AE B
MRIDANGA	M R AH D AE N G AH
MU	M UW
GUSH	G AH SH
CUMULATE	K Y UW M Y AH L AH T
