KO	K OW
ALKOXIDE	AE L K AH K S AY D
ALKOXIDES	AE L K AH K S AY D Z
ALKOXY	AE L K AA K S IY
ANGAKOK	AE N G AH K AH K
ANGAKOKS	AE N G AH K AH K S
ANISEIKONIA	AE N AH S AH K OW N Y AH
ANISEIKONIAS	AE N AH S AH K OW N Y AH Z
ANISEIKONIC	AE N AY S AY K AA N IH K
ARKOSE	AA R K OW S
ARKOSES	AA R K OW Z AH Z
ARKOSIC	AA R K AH Z AH K
ASKOI	AE S OY
ASKOS	AE S K AA S
BACKOUT	B AE K AW T
BACKOUTS	B AE K AW T S
BANGKOK	B AE NG K AA K
BANGKOKS	B AE NG K AA K S
BECKON	B EH K AH N
BECKONED	B EH K AH N D
BECKONER	B EH K AH N ER
BECKONERS	B EH K AH N ER Z
BECKONING	B EH K AH N IH NG
BECKONS	B EH K AH N Z
BLACKOUT	B L AE K AW T
BLACKOUTS	B L AE K AW T S
BREAKOUT	B R EY K AW T
BREAKOUTS	B R EY K AW T S
BUCKO	B AH K OW
BUCKOES	B AH K OW Z
BUCKOS	B AH K AA S
BUNKO	B AH NG K OW
BUNKOED	B AH NG K OW D
BUNKOES	B AH NG K OW Z
BUNKOING	B AH NG K OW AH NG
BUNKOS	B AH NG K AA S
CHECHAKO	CH EH CH AH K OW
CHECHAKOS	CH EH CH AH K AH Z
CHECKOFF	CH EH K AO F
CHECKOFFS	CH EH K AO F S
CHECKOUT	CH EH K AW T
CHECKOUTS	CH EH K AW T S
CHEECHAKO	CH IY CH AH K OW
CHEECHAKOS	CH IY CH AH K AH Z
CHICKORIES	CH IH K ER IY Z
CHICKORY	CH IH K ER IY
COOKOFF	K UH K AO F
COOKOFFS	K UH K AO F S
COOKOUT	K UH K AW T
COOKOUTS	K UH K AW T S
CRANKOUS	K R AE NG K AH S
CUCKOLD	K AH K OW L D
CUCKOLDED	K AH K OW L D AH D
CUCKOLDING	K AH K OW L D AH NG
CUCKOLDRIES	K AH K OW L D R AY Z
CUCKOLDRY	K AH K OW L D R IY
CUCKOLDS	K AH K OW L D Z
CUCKOO	K AH K UW
CUCKOO(2)	K UW K UW
CUCKOOED	K AH K UW D
CUCKOOFLOWER	K AH K UW F L OW AH R
CUCKOOFLOWERS	K AH K UW F L OW AH R Z
CUCKOOING	K AH K UW AH NG
CUCKOOPINT	K AH K UW P AH N T
CUCKOOPINTS	K AH K UW P AH N T S
CUCKOOS	K UW K UW Z
DAIKON	D EY K AH N
DAIKONS	D EY K AH N Z
DAKOIT	D AH K OY T
DAKOITIES	D AE K OY T AY Z
DAKOITS	D AH K OY T S
DAKOITY	D AH K OW AH T IY
DEKKO	D IH K OW
DEKKOS	D IH K AA Z
DUMMKOPF	D AH M K AH P
DUMMKOPFS	D AH M K AH P S
EIKON	IY K AH N
EIKONES	IY K OW N Z
EIKONS	IY K AH N Z
EINKORN	IY NG K AH R N
EINKORNS	IY NG K AH R N Z
EUROKOUS	Y UW R AH K AH S
FREAKOUT	F R IY K AW T
FREAKOUTS	F R IY K AW T S
GECKO	G EH K OW
GECKOES	JH EH K OW Z
GECKOS	G EH K OW Z
GINGKO	G IH NG K OW
GINGKOES	JH IH N G K OW Z
HALAKOTH	HH AE L AH K AH TH
HICKORIES	HH IH K ER IY Z
HICKORY	HH IH K ER IY
HICKORY(2)	HH IH K R IY
IKON	AY K AA N
IKONS	IH K AH N Z
IROKO	IH R AH K OW
IROKOS	IH R AH K AH Z
JINGKO	JH IH N G K OW
JINGKOES	JH IH N G K OW Z
JOCKO	JH AA K OW
JOCKOS	JH AA K AA S
KICKOFF	K IH K AO F
KICKOFFS	K IH K AO F S
KNOCKOFF	N AA K AO F
KNOCKOFFS	N AA K AO F S
KNOCKOUT	N AA K AW T
KNOCKOUTS	N AA K AW T S
KOA	K OW AH
KOALA	K OW AA L AH
KOALAS	K OW AA L AH Z
KOAN	K OW AH N
KOANS	K OW N Z
KOAS	K OW Z
KOB	K AA B
KOBO	K OW B OW
KOBOLD	K AH B OW L D
KOBOLDS	K AH B OW L D Z
KOBOS	K AA B AH Z
KOBS	K AA B Z
KOEL	K OW AH L
KOELS	K OW AH L Z
KOHL	K OW L
KOHLRABI	K AO L R AA B IY
KOHLRABIES	K OW L R AH B AY Z
KOHLS	K OW L Z
KOI	K OY
KOINE	K OY N
KOINES	K OY N Z
KOIS	K OW AH S
KOKANEE	K AA K AH N IY IY
KOKANEES	K AA K AH N IY Z
KOLA	K OW L AH
KOLACHE	K AA L AH CH
KOLACKY	K AH L AE K IY
KOLAS	K AA L AH Z
KOLBASI	K OW L B AH S IY
KOLBASIS	K OW L B AH S AH S
KOLBASSI	K OW L B AE S IY
KOLBASSIS	K OW L B AE S AH S
KOLHOZ	K OW L HH AH Z
KOLHOZES	K OW L HH OW Z AH Z
KOLHOZY	K OW L HH AH Z IY
KOLINSKI	K AH L IH N S K IY
KOLINSKIES	K AH L IH N S AY Z
KOLINSKY	K AH L IH N S IY
KOLKHOS	K OW L K AH Z
KOLKHOSES	K OW L K OW Z AH Z
KOLKHOSY	K OW L K AH Z IY
KOLKHOZ	K AA L K AO Z
KOLKHOZES	K AA L K AO Z IH Z
KOLKHOZNIK	K OW L K AA Z N AH K
KOLKHOZNIKI	K OW L K AA Z N AH K IY
KOLKHOZNIKS	K OW L K AA Z N AH K S
KOLKHOZY	K AA L K AO Z IY
KOLKOZ	K OW L K AH Z
KOLKOZES	K OW L K OW Z AH Z
KOLKOZY	K OW L K AH Z IY
KOLO	K OW L OW
KOLOS	K AA L AH Z
KOMATIK	K AA M AH T AH K
KOMATIKS	K AA M AH T AH K S
KOMONDOR	K AH M AA N D AH R
KOMONDOROCK	K AH M AA N D AH R AH K
KOMONDOROK	K AH M AA N D AH R AH K
KOMONDORS	K AH M AA N D AH R Z
KONK	K AO NG K
KONKED	K AO NG K T
KONKING	K AO NG K AH NG
KONKS	K AO NG K S
KOODOO	K UW D UW
KOODOOS	K UW D UW Z
KOOK	K UW K
KOOKABURRA	K UH K AH B AH R AH
KOOKABURRAS	K UH K AH B AH R AH Z
KOOKIE	K UH K AY
KOOKIER	K UH K AY AH R
KOOKIEST	K UH K AY AH S T
KOOKINESS	K UH K AH N AH S
KOOKINESSES	K UH K AH N EH S AH Z
KOOKS	K UW K S
KOOKY	K UW K IY
KOP	K AA P
KOPECK	K AA P AH K
KOPECKS	K AA P AH K S
KOPEK	K OW P AH K
KOPEKS	K OW P AH K S
KOPH	K AA F
KOPHS	K AA F S
KOPJE	K AA P JH
KOPJES	K AA P JH AH Z
KOPPA	K AA P AH
KOPPAS	K AA P AH Z
KOPPIE	K AA P AY
KOPPIES	K AA P AY Z
KOPS	K AA P S
KOR	K AO R
KORAI	K AO R EY
KORAT	K AO R AH T
KORATS	K AH R EY T S
KORE	K AO R
KORS	K AO R Z
KORUN	K AO R AH N
KORUNA	K AO R UW N AA
KORUNAS	K AH R UW N AH Z
KORUNY	K AH R UW N IY
KOS	K AA S
KOSHER	K OW SH ER
KOSHERED	K OW SH ER D
KOSHERING	K OW SH ER IH NG
KOSHERS	K OW SH ER S
KOSS	K AO S
KOTO	K OW T OW
KOTOS	K AA T AH Z
KOTOW	K AA T OW
KOTOWED	K AH T OW D
KOTOWER	K AA T OW AH R
KOTOWERS	K AA T OW AH R Z
KOTOWING	K AA T OW AH NG
KOTOWS	K AH T OW Z
KOUMIS	K AW M AH S
KOUMISES	K AW M AY Z AH Z
KOUMISS	K AW M AH S
KOUMISSES	K AW M IH S AH Z
KOUMYS	K AW M AH Z
KOUMYSES	K AW M AY Z AH Z
KOUMYSS	K AW M AH S
KOUMYSSES	K AW M IH S AH Z
KOUPREY	K UW P R IY
KOUPREYS	K UW P R EY Z
KOUROI	K AH R OY
KOUROS	K AH R AH Z
KOUSSO	K AW S OW
KOUSSOS	K AW S AH Z
KOWTOW	K AW T AW
KOWTOW(2)	K OW T OW
KOWTOWED	K OW T OW D
KOWTOWER	K OW T OW AH R
KOWTOWERS	K OW T OW AH R Z
KOWTOWING	K OW T OW AH NG
KOWTOWS	K OW T OW Z
KWASHIORKOR	K W AA SH IY AO R K AH R
KWASHIORKORS	K W AA SH IY AO R K AH R Z
LEUKOCYTE	L UW K AH S AY T
LEUKOCYTES	L UW K AH S AY T S
LEUKOCYTIC	L UW K AH S AH T AH K
LEUKOCYTOSES	L UW K AA S AH T OW Z AH Z
LEUKOCYTOSIS	L UW K AH S AH T OW S AH S
LEUKODYSTROPHIES	L UW K AH D IH S T R AH F AY Z
LEUKODYSTROPHY	L UW K AH D IH S T R AH F IY
LEUKOMA	L UW K AH M AH
LEUKOMAS	L UW K AH M AH Z
LEUKON	L UW K AH N
LEUKONS	L UW K AH N Z
LEUKOPENIA	L UW K AH P IY N Y AH
LEUKOPENIAS	L UW K AH P IY N Y AH Z
LEUKOPENIC	L UW K AH P AH N AH K
LEUKOPLAKIA	L UW K AH P L EY K IY AH
LEUKOPLAKIAS	L UW K AH P L EY K IY AH Z
LEUKOPLAKIC	L UW K AA P L AH K AH K
LEUKOPOIESES	L UW K AA P OY IY Z AH Z
LEUKOPOIESIS	L UW K AH P OY AH S AH S
LEUKOPOIETIC	L UW K AA P OY AH T AH K
LEUKORRHEA	L UW K AO R IY AH
LEUKORRHEAL	L UW K AO R IY AH L
LEUKORRHEAS	L UW K AO R IY Z
LEUKOSES	L UW K OW Z AH Z
LEUKOSIS	L UW K OW S AH S
LEUKOTIC	L UW K AH T AH K
LEUKOTOMIES	L UW K AA T AH M AY Z
LEUKOTOMY	L UW K AA T AH M IY
LEUKOTRIENE	L UW K AH T R IY N
LEUKOTRIENES	L UW K AH T R IY N Z
LOCKOUT	L AA K AW T
LOCKOUTS	L AA K AW T S
LOOKOUT	L UH K AW T
LOOKOUTS	L UH K AW T S
MAKO	M AA K OW
MAKOS	M EY K OW Z
MISRECKON	M IH S R EH K AH N
MISRECKONED	M IH S R EH K AH N D
MISRECKONING	M IH S R EH K AH N IH NG
MISRECKONS	M IH S R EH K AH N Z
NONKOSHER	N AA N K OW SH ER
PACHINKO	P AH CH IH NG K OW
PACHINKOS	P AH CH IH NG K AH Z
PANLEUKOPENIA	P AE N L UW K AH P IY N Y AH
PANLEUKOPENIAS	P AE N L UW K AH P IY N Y AH Z
PEKOE	P EH K OW
PEKOES	P AH K OW Z
PICKOFF	P IH K AO F
PICKOFFS	P IH K AO F S
PINKO	P IH NG K OW
PINKOES	P IH NG K OW Z
PINKOS	P IH NG K OW Z
RECKON	R EH K AH N
RECKONED	R EH K AH N D
RECKONER	R EH K AH N ER
RECKONERS	R EH K AH N ER Z
RECKONING	R EH K AH N IH NG
RECKONING(2)	R EH K N IH NG
RECKONINGS	R EH K AH N IH NG Z
RECKONS	R EH K AH N Z
ROCKOON	R AA K UW N
ROCKOONS	R AA K UW N Z
SHACKO	SH AE K OW
SHACKOES	SH AE K OW Z
SHACKOS	SH AE K AA S
SHAKO	SH AE K OW
SHAKOES	SH AH K OW Z
SHAKOS	SH AE K AH Z
SHKOTZIM	SH K AA T S AH M
SICKO	S IH K OW
SICKOS	S IH K AA S
SICKOUT	S IH K AW T
SICKOUTS	S IH K AW T S
SILKOLINE	S IH L K AH L AY N
SILKOLINES	S IH L K AH L AY N Z
SKOAL	S K OW L
SKOALED	S K OW L D
SKOALING	S K OW L AH NG
SKOALS	S K OW L Z
SKOOKUM	S K UW K AH M
SKOSH	S K AA SH
SKOSHES	S K AA SH AH Z
SOCKO	S AA K OW
SOKOL	S OW K AH L
SOKOLS	S AA K AH L Z
SPANAKOPITA	S P AE N AH K AA P AH T AH
SPANAKOPITAS	S P AE N AH K AA P AH T AH Z
SPANOKOPITA	S P AE N AH K AA P AH T AH
SPANOKOPITAS	S P AE N AH K AA P AH T AH Z
STICKOUT	S T IH K AW T
STICKOUTS	S T IH K AW T S
STINKO	S T IH NG K OW
SUKKOT	S AH K AH T
SUKKOTH	S AH K AH TH
THYLAKOID	TH IH L AH K OY D
THYLAKOIDS	TH IH L AH K OY D Z
TOKOLOGIES	T AH K AA L AH JH AY Z
TOKOLOGY	T AH K AA L AH JH IY
TOKOMAK	T AA K AH M AH K
TOKOMAKS	T AA K AH M AH K S
TOKONOMA	T AH K AA N AH M AH
TOKONOMAS	T AH K AA N AH M AH Z
TURKOIS	T AH R K OW AH S
TURKOISES	T AH R K OY Z AH Z
UNKOSHER	AH N K OW SH ER
WACKO	W AE K OW
WACKOES	W AE K OW Z
WACKOS	W AE K OW Z
WALKOUT	W AO K AW T
WALKOUTS	W AO K AW T S
WALKOVER	W AO K OW V ER
WALKOVERS	W AO K OW V ER Z
WHACKO	W AE K OW
WHACKOS	W AE K OW Z
WORKOUT	W ER K AW T
WORKOUTS	W ER K AW T S
YOKOZUNA	Y AA K AH Z UW N AH
YOKOZUNAS	Y AA K AH Z UW N AH Z
ZELKOVA	Z EH L K AH V AH
ZELKOVAS	Z EH L K AH V AH Z
NGULTRUM	N G AH L T R AH M
NTH	EH N TH
OUISTITI	AW IH S T AH T IY
EGER	IY G ER
NU	N UW
EEL	IY L
ANAL	EY N AH L
