KU	K UW
ANKUS	AE NG K AH S
ANKUSES	AE NG K Y UW Z AH Z
ANKUSH	AE NG K AH SH
ANKUSHES	AE NG K AH SH AH Z
BACKUP	B AE K AH P
BACKUPS	B AE K AH P S
BREAKUP	B R EY K AH P
BREAKUPS	B R EY K AH P S
BUNKUM	B AH NG K AH M
BUNKUMS	B AH NG K AH M Z
BUNRAKU	B AH N R AH K UW
BUNRAKUS	B AH N R AH K AH S
CHECKUP	CH EH K AH P
CHECKUPS	CH EH K AH P S
COCKUP	K AA K AH P
COCKUPS	K AA K AH P S
CRACKUP	K R AE K AH P
CRACKUPS	K R AE K AH P S
DINKUM	D IH NG K AH M
DINKUMS	D IH NG K AH M Z
EKUELE	EH K Y UW AH L
FUCKUP	F AH K AH P
FUCKUPS	F AH K AH P S
GAGAKU	G AE G AH K UW
GAGAKUS	G AE G AH K AH S
HAIKU	HH AY K UW
HAIKUS	HH AY K UW Z
HIBAKUSHA	HH AH B AE K AH SH AH
HOKKU	HH AA K UW
HOKUM	HH OW K AH M
HOKUMS	HH AA K AH M Z
HOOKUP	HH UH K AH P
HOOKUPS	HH UH K AH P S
KARAKUL	K AE R AH K AH L
KARAKULS	K AH R AE K Y AH L Z
KICKUP	K IH K AH P
KICKUPS	K IH K AH P S
KUCHEN	K AH CH AH N
KUDO	K Y UW D OW
KUDOS	K UW D OW S
KUDU	K Y UW D UW
KUDUS	K Y UW D AH S
KUDZU	K AH D Z UW
KUDZUS	K AH D Z AH S
KUE	K UW
KUES	K Y UW S
KUGEL	K UW G AH L
KUGELS	K Y UW JH AH L Z
KUKRI	K AH K R IY
KUKRIS	K AH K R AH S
KULAK	K Y UW L AH K
KULAKI	K Y UW L AH K IY
KULAKS	K Y UW L AH K S
KULTUR	K AH L T AH R
KULTURS	K AH L T Y AH R Z
KUMISS	K Y UW M AH S
KUMISSES	K Y UW M IH S AH Z
KUMMEL	K AH M AH L
KUMMELS	K AH M AH L Z
KUMQUAT	K AH M K W AA T
KUMQUATS	K AH M K W EY T S
KUMYS	K Y UW M AH Z
KUMYSES	K Y UW M AY Z AH Z
KUNA	K Y UW N AH
KUNDALINI	K AH N D AE L AH N IY
KUNDALINIS	K AH N D AE L AH N AH S
KUNE	K Y UW N
KUNZITE	K AH N Z AY T
KUNZITES	K AH N Z AY T S
KURBASH	K AH R B AH SH
KURBASHED	K AH R B AH SH T
KURBASHES	K AH R B AH SH AH Z
KURBASHING	K AH R B AH SH AH NG
KURGAN	K AH R G AH N
KURGANS	K AH R G AH N Z
KURRAJONG	K AH R AH JH AH NG
KURRAJONGS	K AH R AH JH AH NG Z
KURTA	K AH R T AH
KURTAS	K AH R T AH Z
KURTOSES	K AH R T OW Z AH Z
KURTOSIS	K AH R T OW S AH S
KURTOSISES	K AH R T AH S AY Z AH Z
KURU	K Y UH R UW
KURUS	K Y UH R AH S
KUSSO	K AH S OW
KUSSOS	K AH S AH Z
KUVASZ	K Y UW V AH Z
KUVASZOK	K Y UW V AE Z AH K
LEKU	L EH K UW
LIKUTA	L IH K Y UW T AH
LINKUP	L IH NG K AH P
LINKUPS	L IH NG K AH P S
LOCKUP	L AA K AH P
LOCKUPS	L AA K AH P S
LOOKUP	L UH K AH P
LOOKUPS	L UH K AH P S
MAKUTA	M AE K Y UW T AH
MARKUP	M AA R K AH P
MARKUPS	M AA R K AH P S
MOCKUP	M AA K AH P
MOCKUPS	M AA K AH P S
NUMBSKULL	N AH M S K AH L
NUMBSKULLS	N AH M S K AH L Z
NUMSKULL	N AH M S AH L
NUMSKULLS	N AH M S AH L Z
NUNCHAKU	N AH NG K AH K UW
NUNCHAKUS	N AH NG K AH K AH S
OAKUM	OW K AH M
OAKUMS	OW K AH M Z
PICKUP	P IH K AH P
PICKUPS	P IH K AH P S
RUCKUS	R AH K AH S
RUCKUSES	R AH K AH S IH Z
SEPPUKU	S EH P Y UW K UW
SEPPUKUS	S EH P Y UW K AH S
SKOOKUM	S K UW K AH M
SKUA	S K Y UW AH
SKUAS	S K Y UW AH Z
SKULDUGGERIES	S K AH L D AH JH AH R AY Z
SKULDUGGERY	S K AH L D AH G ER IY
SKULK	S K AH L K
SKULKED	S K AH L K T
SKULKER	S K AH L K ER
SKULKERS	S K AH L K ER Z
SKULKING	S K AH L K IH NG
SKULKS	S K AH L K S
SKULL	S K AH L
SKULLCAP	S K AH L K AE P
SKULLCAPS	S K AH L K AE P S
SKULLDUGGERIES	S K AH L D AH G AH R IY Z
SKULLDUGGERY	S K AH L D AH G AH R IY
SKULLED	S K AH L D
SKULLS	S K AH L S
SKULLS(2)	S K AH L Z
SKUNK	S K AH NG K
SKUNKED	S K AH NG K T
SKUNKING	S K AH NG K IH NG
SKUNKS	S K AH NG K S
STACKUP	S T AE K AH P
STACKUPS	S T AE K AH P S
STICKUM	S T IH K AH M
STICKUMS	S T IH K AH M Z
STICKUP	S T IH K AH P
STICKUPS	S T IH K AH P S
TRINKUMS	T R IH NG K AH M Z
UKULELE	Y UW K AH L EY L IY
UKULELES	Y UW K Y AH L IY L Z
WALKUP	W AO K AH P
WALKUPS	W AO K AH P S
WORKUP	W ER K AH P
WORKUPS	W ER K AH P S
ZIKKURAT	Z IH K Y AH R AH T
ZIKKURATS	Z IH K Y AH R EY T S
ZIKURAT	Z IH K Y AH R AH T
ZIKURATS	Z IH K Y AH R EY T S
DHAK	D HH AE K
OKA	OW K AH
AJIVA	AE JH AH V AH
OMEGA	OW M EH G AH
OMEGA(2)	OW M EY G AH
GUY	G AY
FUJI	F UW JH IY
ARTS	AA R T S
