LL	EH L
ABDOMINALLY	AE B D AA M AH N AH L IY
ABIOGENICALLY	EY B IY AH JH EH N AH K AE L IY
ABIOTICALLY	AH B AY AA T IH K AH L IY
ABNORMALLY	AE B N AO R M AH L IY
ABOLLA	AH B AA L AH
ABOLLAE	AH B AA L IY
ABORALLY	AH B AO R AH L IY
ABORIGINALLY	AE B AH R IH JH AH N AH L IY
ABYSMALLY	AH B IH Z M AH L IY
ACADEMICALLY	AE K AH D EH M IH K L IY
ACCENTUALLY	AE K S EH N CH AH W AH L IY
ACCIDENTALLY	AE K S AH D EH N T AH L IY
ACCIDENTALLY(2)	AE K S AH D EH N AH L IY
ACELLULAR	AH S EH L Y AH L ER
ACERBICALLY	EY S ER B AY K AO L IY
ACHILLEA	AH CH IH L IY AH
ACHILLEAS	AH CH IH L IY Z
ACHROMATICALLY	AH K R OW M AE T IH K AH L IY
ACOUSTICALLY	AH K UW S T IH K L IY
ACROBATICALLY	AE K R AH B AE T IH K AH L IY
ACRONYMICALLY	AH K R OW N IY M AY S AH L IY
ACROPETALLY	AE K R AA P AH T AE L IY
ACROSTICALLY	AE K R AA S T AH K AE L IY
ACTINICALLY	AE K T IH N IH K AH L IY
ACTUALLY	AE K CH UW AH L IY
ACTUALLY(2)	AE K CH L IY
ACTUALLY(3)	AE K SH AH L IY
ACTUARIALLY	AE K CH AH W EH R IY AH L IY
ADAPTATIONALLY	AE D AE P T EY SH AH N AH L IY
ADDITIONALLY	AH D IH SH AH N AH L IY
ADIABATICALLY	EY D IY AH B AE T AH K AE L IY
ADJECTIVALLY	AE JH IH K T AY V AH L IY
ADRENERGICALLY	AE D R AH N AH R JH AH K AE L IY
ADVERBIALLY	AE D V ER B IY AH L IY
AERIALLY	AE ER IY AH L IY
AEROBICALLY	EH R OW B IH K L IY
AERODYNAMICALLY	EH R OW D AY N AE M IH K L IY
AERONAUTICALLY	AE R AH N AO T IH K AH L IY
AESTHETICALLY	EH S TH EH T IH K L IY
AFFECTIONALLY	AH F EH K SH AH N AH L IY
AGALLOCH	AH G AE L AH CH
AGALLOCHS	AH G AE L AH CH S
AGONISTICALLY	AH G AO N IH S T IH K AH L IY
AGRICULTURALLY	AE G R IH K AH L CH AH R AH L IY
AGRONOMICALLY	AE G R AH N AA M AH K AE L IY
AHULL	AH HH AH L
AIGUILLE	EY G W AH L
AIGUILLES	EY G W AH L Z
AIGUILLETTE	EY G W AH L EH T
AIGUILLETTES	EY G W IH L EH T S
AIMFULLY	AH IH M F UH L IY
AINSELL	AH IH N S EH L
AINSELLS	AH IH N S EH L Z
ALCHEMICALLY	AE L K EH M AH K L IY
ALCOHOLICALLY	AE L K AH HH AO L IH K AH L IY
ALGEBRAICALLY	AE L JH AH B R EY IH K L IY
ALGORITHMICALLY	AE L G AH R IH DH AH M IH K AH L IY
ALL	AO L
ALLANITE	AE L AH N AY T
ALLANITES	AE L AH N AY T S
ALLANTOIC	AE L AE N T OW AH K
ALLANTOIDES	AE L AH N T OY D Z
ALLANTOIN	AE L AH N T OY N
ALLANTOINS	AE L AH N T OY N Z
ALLANTOIS	AE L AE N T OW AH S
ALLARGANDO	AE L AH R G AE N D OW
ALLAY	AH L EY
ALLAYED	AH L EY D
ALLAYER	AH L EY ER
ALLAYERS	AH L EY ER Z
ALLAYING	AH L EY IH NG
ALLAYS	AH L EY Z
ALLEE	AH L IY
ALLEES	AO L IY Z
ALLEGATION	AE L AH G EY SH AH N
ALLEGATIONS	AE L AH G EY SH AH N Z
ALLEGE	AH L EH JH
ALLEGED	AH L EH JH D
ALLEGEDLY	AH L EH JH AH D L IY
ALLEGER	AH L EH JH ER
ALLEGERS	AH L EH JH ER Z
ALLEGES	AH L EH JH IH Z
ALLEGIANCE	AH L IY JH AH N S
ALLEGIANCES	AH L IY JH AH N S IH Z
ALLEGIANT	AH L IY JH AH N T
ALLEGING	AH L EH JH IH NG
ALLEGORICAL	AE L AH G AO R IH K AH L
ALLEGORICALLY	AH L EH JH ER IH K AH L IY
ALLEGORICALNESS	AH L EH JH ER IH K AH L N AH S
ALLEGORICALNESSES	AH L EH JH ER IH K AH L N AH S IH Z
ALLEGORIES	AE L AH G AO R IY Z
ALLEGORISE	AO L IY G OW R AY Z
ALLEGORISED	AE L AH G AO R IY Z D
ALLEGORISES	AE L AH G AO R IY Z IH Z
ALLEGORISING	AE L AH G AO R IY Z IH NG
ALLEGORIST	AH L EH JH ER IH S T
ALLEGORISTS	AH L EH JH ER IH S T S
ALLEGORIZATION	AH L EH JH ER AH Z EY SH AH N
ALLEGORIZATIONS	AH L EH JH ER AH Z EY SH AH N Z
ALLEGORIZE	AH L EH JH ER AY Z
ALLEGORIZED	AH L EH JH ER AY Z D
ALLEGORIZER	AH L EH JH ER AY Z ER
ALLEGORIZERS	AH L EH JH ER AY Z ER Z
ALLEGORIZES	AH L EH JH ER AY Z IH Z
ALLEGORIZING	AH L EH JH ER AY Z IH NG
ALLEGORY	AE L AH G AO R IY
ALLEGRETTO	AE L AH G R EH T OW
ALLEGRETTOS	AE L AH G R EH T AH Z
ALLEGRO	AH L EH G R OW
ALLEGROS	AH L EH G R OW Z
ALLELE	AH L EH L IY
ALLELES	AH L EH L IY Z
ALLELIC	AH L EH L IH K
ALLELISM	AE L AH L IH Z AH M
ALLELISMS	AE L AH L AH Z AH M Z
ALLELOMORPH	AE L EH L AH M AH R F
ALLELOMORPHIC	AE L EH L AH M AH R F AH K
ALLELOMORPHISM	AE L EH L AH M AH R F IH Z AH M
ALLELOMORPHISMS	AE L AH L AH M AO R F AH Z AH M Z
ALLELOMORPHS	AE L EH L AH M AH R F S
ALLELOPATHIC	AE L EH L AH P AH TH AH K
ALLELOPATHIES	AE L AH L AA P AH TH AY Z
ALLELOPATHY	AE L AH L AA P AH TH IY
ALLELUIA	AE L EH L UW Y AA
ALLELUIAS	AE L EH L UW AH Z
ALLEMANDE	AE L AH M AH N D
ALLEMANDES	AE L AH M AH N D Z
ALLERGEN	AE L ER JH AH N
ALLERGENIC	AO L ER JH IY N IH K
ALLERGENICITIES	AO L ER JH IY N IH K S AH T IY Z
ALLERGENICITY	AO L ER JH IY N IH K S AH T IY
ALLERGENS	AE L ER JH AH N Z
ALLERGIC	AH L ER JH IH K
ALLERGIES	AE L ER JH IY Z
ALLERGIN	AO L ER JH IH N
ALLERGINS	AO L ER JH IH N Z
ALLERGIST	AE L ER JH AH S T
ALLERGISTS	AE L ER JH AH S T S
ALLERGISTS(2)	AE L ER JH AH S
ALLERGY	AE L ER JH IY
ALLETHRIN	AE L EH TH R AH N
ALLETHRINS	AE L EH TH R AH N Z
ALLEVIATE	AH L IY V IY EY T
ALLEVIATED	AH L IY V IY EY T IH D
ALLEVIATES	AH L IY V IY EY T S
ALLEVIATING	AH L IY V IY EY T IH NG
ALLEVIATION	AH L IY V IY EY SH AH N
ALLEVIATIONS	AH L IY V IY EY SH AH N Z
ALLEVIATOR	AH L IY V IY AH T ER
ALLEVIATORS	AH L IY V IY AH T ER Z
ALLEY	AE L IY
ALLEYS	AE L IY Z
ALLEYWAY	AE L IY W EY
ALLEYWAYS	AE L IY W EY Z
ALLHEAL	AO L HH IY L
ALLHEALS	AO L HH IY L Z
ALLIABLE	AH L AY AH B AH L
ALLIACEOUS	AE L IY AH S IY AH S
ALLIANCE	AH L AY AH N S
ALLIANCES	AH L AY AH N S IH Z
ALLICIN	AO L IH K S IH N
ALLICINS	AO L IH K S IH N Z
ALLIED	AH L AY D
ALLIED(2)	AE L AY D
ALLIES	AE L AY Z
ALLIES(2)	AH L AY Z
ALLIGATOR	AE L AH G EY T ER
ALLIGATORS	AE L AH G EY T ER Z
ALLITERATE	AH L IH T AH R EY T
ALLITERATED	AH L IH T AH R EY T IH D
ALLITERATES	AH L IH T AH R EY T S
ALLITERATING	AH L IH T AH R EY T IH NG
ALLITERATION	AH L IH T ER EY SH AH N
ALLITERATIONS	AH L IH T AH R EY SH AH N Z
ALLITERATIVE	AH L IH T ER AH T IH V
ALLITERATIVE(2)	AH L IH T ER EY T IH V
ALLITERATIVELY	AH L IH T AH R EY T IH V L IY
ALLIUM	AE L IY AH M
ALLIUMS	AE L IY AH M Z
ALLOANTIBODIES	AE L OW N T IH B AH D AY Z
ALLOANTIBODY	AE L OW N T IH B AH D IY
ALLOANTIGEN	AE L OW N T AH JH AH N
ALLOANTIGENS	AE L OW N T AH JH AH N Z
ALLOBAR	AE L AH B AH R
ALLOBARS	AE L AH B AH R Z
ALLOCABLE	AE L AH K AH B AH L
ALLOCATABLE	AE L AH K AH T AH B AH L
ALLOCATE	AE L AH K EY T
ALLOCATED	AE L AH K EY T IH D
ALLOCATES	AE L AH K EY T S
ALLOCATING	AE L AH K EY T IH NG
ALLOCATION	AE L AH K EY SH AH N
ALLOCATIONS	AE L AH K EY SH AH N Z
ALLOCATOR	AE L AH K EY T ER
ALLOCATORS	AE L AH K EY T ER Z
ALLOCUTION	AE L AH K Y UW SH AH N
ALLOCUTIONS	AE L AH K Y UW T IY AH N Z
ALLOD	AE L AH D
ALLODIA	AE L OW D IY AH
ALLODIAL	AE L OW D IY AH L
ALLODIUM	AE L OW D IY AH M
ALLODS	AE L AH D Z
ALLOGAMIES	AE L AA G AH M AY Z
ALLOGAMOUS	AE L AA G AH M AH S
ALLOGAMY	AE L AA G AH M IY
ALLOGENEIC	AE L AH JH IY N IY AH K
ALLOGENIC	AE L AH JH AH N AH K
ALLOGRAFT	AE L AA G R AH F T
ALLOGRAFTED	AE L AA G R AE F T AH D
ALLOGRAFTING	AE L AA G R AE F T AH NG
ALLOGRAFTS	AE L AA G R AH F T S
ALLOGRAPH	AE L AH G R AE F
ALLOGRAPHIC	AE L AA G R AH F AH K
ALLOGRAPHS	AE L AH G R AE F S
ALLOMETRIC	AE L AH M AH T R AH K
ALLOMETRIES	AE L AH M EH T R AY Z
ALLOMETRY	AE L AH M EH T R IY
ALLOMORPH	AE L AH M AO R F
ALLOMORPHIC	AE L AH M AH R F AH K
ALLOMORPHISM	AE L AH M AH R F IH Z AH M
ALLOMORPHISMS	AE L AH M AO R F AH Z AH M Z
ALLOMORPHS	AE L AH M AO R F S
ALLONGE	AE L AH N JH
ALLONGES	AE L AA N JH AH Z
ALLONYM	AE L AH N AH M
ALLONYMS	AE L AH N AH M Z
ALLOPATH	AE L AH P AH TH
ALLOPATHS	AE L AH P AH TH S
ALLOPATRIC	AE L AH P AH T R AH K
ALLOPATRICALLY	AE L AH P AE T R AH K AE L IY
ALLOPATRIES	AE L AH P AE T R AY Z
ALLOPATRY	AE L AH P AE T R IY
ALLOPHANE	AE L AH F EY N
ALLOPHANES	AE L AH F EY N Z
ALLOPHONE	AE L AH F OW N
ALLOPHONES	AE L AH F OW N Z
ALLOPHONIC	AE L AH F AA N IH K
ALLOPOLYPLOID	AE L AH P AA L AH P L OY D
ALLOPOLYPLOIDIES	AE L AA P AH L IH P L OY D AY Z
ALLOPOLYPLOIDS	AE L AH P AA L AH P L OY D Z
ALLOPOLYPLOIDY	AE L AH P AA L AH P L OY D IY
ALLOPURINOL	AE L AH P Y UH R AH N AH L
ALLOPURINOLS	AE L AH P Y UH R AH N AH L Z
ALLOSAURUS	AE L AH S EY Y AH R AH S
ALLOSAURUSES	AE L AA S AH R UW Z AH Z
ALLOSTERIC	AE L AA S T AH R AH K
ALLOSTERICALLY	AE L AA S T EH R AH K AE L IY
ALLOSTERIES	AE L AA S T AH R AY Z
ALLOSTERY	AE L AH S T EH R IY
ALLOT	AH L AA T
ALLOTETRAPLOID	AE L AH T EH T R AH P L OY D
ALLOTETRAPLOIDIES	AE L AH T EH T R AE P L OY D AY Z
ALLOTETRAPLOIDS	AE L AH T EH T R AH P L OY D Z
ALLOTETRAPLOIDY	AE L AH T EH T R AH P L OY D IY
ALLOTMENT	AH L AA T M AH N T
ALLOTMENTS	AH L AA T M AH N T S
ALLOTROPE	AE L AH T R OW P
ALLOTROPES	AE L AH T R OW P S
ALLOTROPIC	AH L AA T R OW P IH K
ALLOTROPIES	AH L AA T R OW P IY Z
ALLOTROPY	AH L AA T R OW P IY
ALLOTS	AH L AA T S
ALLOTTED	AH L AA T IH D
ALLOTTEE	AH L AA T IY
ALLOTTEES	AH L AA T IY Z
ALLOTTER	AH L AA T ER
ALLOTTERS	AH L AA T ER Z
ALLOTTING	AH L AA T IH NG
ALLOTYPE	AE L AH T AY P
ALLOTYPES	AE L AH T AY P S
ALLOTYPIC	AE L AH T AH P AH K
ALLOTYPICALLY	AE L AH T IH P AH K AE L IY
ALLOTYPIES	AH L AA T IY P AY Z
ALLOTYPY	AE L AA T AH P IY
ALLOVER	AO L OW V ER
ALLOVERS	AO L OW V ER Z
ALLOW	AH L AW
ALLOWABLE	AH L AW AH B AH L
ALLOWABLY	AH L AW AH B L IY
ALLOWANCE	AH L AW AH N S
ALLOWANCED	AH L AW AH N S T
ALLOWANCES	AH L AW AH N S IH Z
ALLOWANCING	AH L AW AH N S IH NG
ALLOWED	AH L AW D
ALLOWEDLY	AH L AW AH D L IY
ALLOWING	AH L AW IH NG
ALLOWS	AH L AW Z
ALLOXAN	AE L AA K S AH N
ALLOXANS	AE L AA K S AH N Z
ALLOY	AE L OY
ALLOYED	AE L OY D
ALLOYING	AE L OY IH NG
ALLOYS	AE L OY Z
ALLS	AO L Z
ALLSEED	AO L S IY D
ALLSEEDS	AO L S IY D Z
ALLSPICE	AO L S P AY S
ALLSPICES	AO L S P AY S IH Z
ALLUDE	AH L UW D
ALLUDED	AH L UW D AH D
ALLUDES	AH L UW D Z
ALLUDING	AH L UW D IH NG
ALLURE	AH L UH R
ALLURED	AH L UH R D
ALLUREMENT	AH L UH R M AH N T
ALLUREMENTS	AH L UH R M AH N T S
ALLURER	AH L UH R ER
ALLURERS	AH L UH R ER Z
ALLURES	AH L UH R Z
ALLURING	AH L UH R IH NG
ALLURINGLY	AH L UH R IH NG L IY
ALLUSION	AH L UW ZH AH N
ALLUSIONS	AH L UW ZH AH N Z
ALLUSIVE	AH L UW S IH V
ALLUSIVELY	AH L UW S IH V L IY
ALLUSIVENESS	AH L UW S IH V N AH S
ALLUSIVENESSES	AH L UW S IH V N AH S IH Z
ALLUVIA	AE L UW V IY AH
ALLUVIAL	AE L UW V IY AH L
ALLUVIALS	AE L UW V IY AH L Z
ALLUVION	AE L UW V IY AH N
ALLUVIONS	AE L UW V IY AH N Z
ALLUVIUM	AE L UW V IY AH M
ALLUVIUMS	AE L UW V IY AH M Z
ALLY	AE L AY
ALLY(2)	AH L AY
ALLYING	AE L AY IH NG
ALLYING(2)	AH L AY IH NG
ALLYL	AE L AH L
ALLYLIC	AE L AH L AH K
ALLYLS	AE L AH L Z
ALOGICALLY	AH L AA JH IH K AH L IY
ALPHABETICALLY	AE L F AH B EH T IH K L IY
ALPHANUMERICALLY	AE L F AH N UH M EH R IH K AH L IY
ALTRUISTICALLY	AE L T R UH IH S T IH K AH L IY
AMARELLE	AE M AH R AH L
AMARELLES	AE M AH R AH L Z
AMARYLLIS	AE M ER IH L IH S
AMARYLLISES	AE M ER IH L IH S AH Z
AMBROSIALLY	AE M B R OW ZH IY AH L IY
AMINOPHYLLINE	AH M AH N AA F AH L AY N
AMINOPHYLLINES	AH M AH N AA F AH L AY N Z
AMITOTICALLY	AE M AH T AA T AH K AE L IY
AMONTILLADO	AE M AH N T IH L AH D OW
AMONTILLADOS	AE M AH N T IH L AH D AH Z
AMORALLY	EY M AO R AH L IY
AMOXICILLIN	AH M AO K S AH S IH L IH N
AMOXICILLINS	AH M AA K S AH S IH L AH N Z
AMOXYCILLIN	AH M AA K S AH S IH L AH N
AMOXYCILLINS	AH M AA K S AH S IH L AH N Z
AMPHITHEATRICALLY	AE M F AH TH IY T R AH K AE L IY
AMPICILLIN	AE M P AH S IH L AH N
AMPICILLINS	AE M P AH S IH L AH N Z
AMPULLA	AE M P UH L AH
AMPULLAE	AE M P UH L IY
AMPULLAR	AE M P UH L AH R
AMPULLARY	AE M P AH L EH R IY
ANACHRONISTICALLY	AH N AE K R AH N IH S T IH K AH L IY
ANACOLUTHICALLY	AE N AH K AH L AH TH AH K AE L IY
ANAEROBICALLY	AE N AH R OW B IH K AH L IY
ANAGOGICALLY	AE N AH G AA JH AH K AE L IY
ANAGRAMMATICALLY	AE N AH G R AE M AH T IH K AH L IY
ANALLY	AH N AE L IY
ANALOGICALLY	AE N AH L AA JH AH K AE L IY
ANALYTICALLY	AE N AH L IH T IH K L IY
ANAPHORICALLY	AE N AH F AO R AH K AE L IY
ANAPHYLACTICALLY	AE N AH F AH L AE K T AH K AE L IY
ANARCHICALLY	AE N AA R K IH K AH L IY
ANATOMICALLY	AE N AH T AA M AH K L IY
ANCESTRALLY	AE N S EH S T R AH L IY
ANCHORITICALLY	AE NG K AH R AY T IH K AH L IY
ANCILLA	AE N S IH L AH
ANCILLAE	AE N S IH L IY
ANCILLARIES	AE N S AH L EH R IY Z
ANCILLARY	AE N S AH L EH R IY
ANCILLAS	AE N S IH L AH Z
ANDOUILLE	AE N D AW AH L
ANDOUILLES	AE N D AW AH L Z
ANDOUILLETTE	AE N D AW AH L EH T
ANDOUILLETTES	AE N D AW IH L EH T S
ANECDOTALLY	AE N IH K D OW T AH L IY
ANECDOTICALLY	AE N IH K D OW T IH K AH L IY
ANEMICALLY	AH N IY M IH K AH L IY
ANESTHETICALLY	AE N AH S TH EH T IH K AH L IY
ANGELICALLY	AE N JH EH L IH K L IY
ANIMALLIKE	AE N AH M AH L AY K
ANIMALLY	AE N AH M AH L IY
ANISOTROPICALLY	AE N AH S AA T R AA P AH K AE L IY
ANNUALLY	AE N Y UW AH L IY
ANNULLED	AE N AH L D
ANNULLING	AE N AH L AH NG
ANODALLY	AE N OW D AH L IY
ANODICALLY	AE N OW D IH K AH L IY
ANTAGONISTICALLY	AE N T AE G AH N IH S T IH K AH L IY
ANTEBELLUM	AE N T IH B EH L AH M
ANTENATALLY	AE N T AH N AH T AH L IY
ANTHILL	AE N T HH IH L
ANTHILLS	AE N T HH IH L Z
ANTHOPHYLLITE	AE N TH AA F AH L AY T
ANTHOPHYLLITES	AE N TH AA F AH L AY T S
ANTHROPOCENTRICALLY	AE N TH R AH P AH S EH N T R AH K AE L IY
ANTHROPOLOGICALLY	AE N TH R AH P AH L AA JH IH K AH L IY
ANTHROPOMORPHICALLY	AE N TH R AH P AH M AO R F IH K AH L IY
ANTIALLERGENIC	AE N T AY AO L ER JH IY N IH K
ANTIALLERGENICS	AE N T AY AO L ER JH IY N IH K S
ANTIBILLBOARD	AE N T AY B IH L B OW R D
ANTIBIOTICALLY	AE N T AY B AY AA T IH K AH L IY
ANTICALLY	AE N T AY K AO L IY
ANTICELLULITE	AE N T AH S EH L AH L AY T
ANTICLIMACTICALLY	AE N T AY K L AY M AE K T IH K AH L IY
ANTICOLLISION	AE N T AY K AH L IH ZH AH N
ANTIDOTALLY	AE N T IH D OW T AH L IY
ANTIDROMICALLY	AE N T AY D R AA M AH K AE L IY
ANTIFERROMAGNETICALLY	AE N T AY F EH R OW M AE G N EH T IH K AH L IY
ANTIGENICALLY	AE N T IH JH AH N IH K AH L IY
ANTIGUERRILLA	AE N T AY G AH R IH L AH
ANTIGUERRILLAS	AE N T AY G AH R IH L AH Z
ANTIPARALLEL	AE N T AY P AE R AH L EH L
ANTIPATHETICALLY	AE N T AY P AH TH EH T IH K AH L IY
ANTIPHONALLY	AE N T IH F AH N AH L IY
ANTIPILL	AE N T AY P IH L
ANTIPOLLUTION	AE N T AY P AH L UW SH AH N
ANTIPOLLUTIONS	AE N T AY P AH L UW SH AH N Z
ANTIROLL	AE N T AY R OW L
ANTISATELLITE	AE N T AY S AE T AH L AY T
ANTISEPTICALLY	AE N T AH S EH P T IH K AH L IY
ANTISOCIALLY	AE N T AY S OW SH AH L IY
ANTISTROPHICALLY	AE N T AY S T R OW F IY IH K AH L IY
ANTITHETICALLY	AE N T AH TH EH T IH K AH L IY
ANVILLED	AE N V AH L D
ANVILLING	AE N V AH L IH NG
AORISTICALLY	AH OW R IH S T IH K AH L IY
APATHETICALLY	AE P AH TH EH T IH K AH L IY
APERIODICALLY	AH P IH R IY AA D IH K AH L IY
APHETICALLY	AH F EH T AH K AE L IY
APHORISTICALLY	AE F AH R IH S T AH K AE L IY
APHYLLIES	AH F IH L AY Z
APHYLLY	AH F IH L IY
APICALLY	EY P IH K AH L IY
APOCALYPTICALLY	AH P AA K AH L IH P T IH K AH L IY
APOCRYPHALLY	AH P AA K R AH F AH L IY
APODICTICALLY	AE P AH D IH K T AH K AE L IY
APOLITICALLY	AH P AH L IH T IH K AH L IY
APOLLO	AH P AA L OW
APOLLOS	AH P OW L AA S
APOLOGETICALLY	AH P AA L AH JH EH T IH K L IY
APOMICTICALLY	AE P AH M IH K T AH K AE L IY
APOPHYLLITE	AH P AA F AH L AY T
APOPHYLLITES	AH P AA F AH L AY T S
APOPLECTICALLY	AE P AH P L EH K T AH K AE L IY
APOSEMATICALLY	AH P OW Z M EY T IH K AH L IY
APOTROPAICALLY	AH P AA T R AH P AH K AE L IY
APPALL	AH P AO L
APPALLED	AH P AO L D
APPALLING	AH P AO L IH NG
APPALLINGLY	AH P AO L IH NG L IY
APPALLS	AH P AO L Z
APPARELLED	AH P AE R AH L D
APPARELLING	AH P AE R AH L IH NG
APPELLANT	AH P EH L AH N T
APPELLANTS	AH P EH L AH N T S
APPELLATE	AH P EH L IH T
APPELLATE(2)	AH P EH L EY T
APPELLATION	AE P AH L EY SH AH N
APPELLATIONS	AE P AH L EY SH AH N Z
APPELLATIVE	AH P EH L AH T IH V
APPELLATIVELY	AH P EH L AH T IH V L IY
APPELLATIVES	AH P EH L AH T IH V Z
APPELLEE	AH P EH L IY
APPELLEES	AH P EH L IY Z
APPELLOR	AH P EH L ER
APPELLORS	AH P EH L ER Z
APTITUDINALLY	AE P T AH T Y UW D AH N AE L IY
AQUARELLE	AE K W AH R AH L
AQUARELLES	AE K W AH R AH L Z
AQUARELLIST	AE K W AH R EH L AH S T
AQUARELLISTS	AE K W AH R EH L AH S T S
AQUATICALLY	AE K W AA T AH K AE L IY
ARBOREALLY	AA R B OW R IY AH L IY
ARCHAEOLOGICALLY	AA R K IY AH L AA JH IH K AH L IY
ARCHAICALLY	AA R K EY IH K AH L IY
ARCHEOLOGICALLY	AA R K IY AH L AA JH AH K AE L IY
ARCHETYPALLY	AA R K EH T AH P AE L IY
ARCHIEPISCOPALLY	AA R K AH P IH S AH P AE L IY
ARCHITECTONICALLY	AA R K AH T EH K T AA N IH K AH L IY
ARCHITECTURALLY	AA R K IH T EH K CH ER AH L IY
ARCHITECTURALLY(2)	AA R K IH T EH K CH R AH L IY
ARCTICALLY	AA R K T IH K AH L IY
AREALLY	AH R IY AH L AY
ARGILLACEOUS	AA R JH IH L AH S IY AH S
ARGILLITE	AA R JH AH L AY T
ARGILLITES	AA R JH AH L AY T S
ARGYLL	AA R G AY L
ARGYLLS	AA R JH AH L Z
ARILLATE	AE R AH L EY T
ARILLODE	AE R AH L OW D
ARILLODES	AE R AH L OW D Z
ARILLOID	AE R AH L OY D
ARISTOCRATICALLY	AH R IH S T AH K R AE T IH K AH L IY
ARITHMETICALLY	AE R IH TH M EH T IH K AH L IY
ARMADILLO	AA R M AH D IH L OW
ARMADILLOS	AA R M AH D IH L OW Z
ARMILLA	AA R M IH L AH
ARMILLAE	AA R M IH L IY
ARMILLAS	AA R M IH L AH Z
ARMORIALLY	AA R M AH R IY AH L IY
AROMATICALLY	AE R AH M AE T IH K AH L IY
ARTERIALLY	AA R T IH R IY AH L IY
ARTFULLY	AA R T F AH L IY
ARTHRITICALLY	AA R TH R IH T AH K AE L IY
ARTIFICIALLY	AA R T AH F IH SH AH L IY
ARTILLERIES	AA R T IH L AH R IY Z
ARTILLERIST	AA R T IH L ER IH S T
ARTILLERISTS	AA R T IH L ER IH S T S
ARTILLERY	AA R T IH L ER IY
ARTILLERYMAN	AA R T IH L AH R IY M AE N
ARTILLERYMEN	AA R T IH L AH R IY M EH N
ARTISTICALLY	AA R T IH S T IH K L IY
ASCETICALLY	AH S EH T IH K AH L IY
ASEPTICALLY	EY S EH P T IH K AH L IY
ASEXUALLY	AH S EH K SH AH W AH L IY
ASHFALL	AE SH F AO L
ASHFALLS	AE SH F AO L Z
ASPERGILLA	AE S AH R JH IH L AH
ASPERGILLI	AE S AH R JH IH L IY
ASPERGILLOSES	AH Z P ER G IH L AA S IH Z
ASPERGILLOSIS	AH Z P ER G IH L AA S IY Z
ASPERGILLUM	AE S AH R JH IH L AH M
ASPERGILLUMS	AE S AH R JH IH L AH M Z
ASPERGILLUS	AE S AH R JH IH L AH S
ASTHMATICALLY	AH Z TH M EY T IH K AH L IY
ASTRALLY	AE S T R AH L IY
ASTROLOGICALLY	AE S T R AH L AA JH AH K AE L IY
ASTRONAUTICALLY	AE S T R AH N AO T IH K AH L IY
ASTRONOMICALLY	AE S T R AH N AA M IH K L IY
ASTROPHYSICALLY	AH S T R OW F IY IY S IH K AH L IY
ASYMMETRICALLY	EY S AH M EH T R IH K AH L IY
ASYMPTOMATICALLY	AH S IH M P T AH M AE T IH K AH L IY
ASYMPTOTICALLY	AE S AH M T AA T IH K AH L IY
ASYNDETICALLY	AH S IH N D EH T AH K AE L IY
ATAVISTICALLY	AE T AH V IH S T IH K AH L IY
ATHEISTICALLY	EY TH IY IH S T IH K AH L IY
ATHLETICALLY	AE TH L EH T IH K L IY
ATMOSPHERICALLY	AE T M AH S F IH ER IH K AH L IY
ATOLL	AE T AA L
ATOLL(2)	AE T AO L
ATOLL(3)	AH T OW L
ATOLLS	AH T OW L Z
ATOMICALLY	AH T AA M IH K AH L IY
ATOMISTICALLY	AE T AH M IH S T IH K AH L IY
ATONALLY	EY T OW N AH L IY
ATTITUDINALLY	AE T AH T Y UW D AH N AE L IY
ATYPICALLY	EY T IH P IH K AH L IY
AURALLY	AO R AH L IY
AUTHENTICALLY	AO TH EH N T IH K L IY
AUTHENTICALLY(2)	AO TH EH N IH K L IY
AUTISTICALLY	AO T IH S T IH K AH L IY
AUTOBIOGRAPHICALLY	AO T AH B AY AH G R AE F IH K AH L IY
AUTOCATALYTICALLY	AO T OW K AE T AH L IH T IH K AH L IY
AUTOCRATICALLY	AO T AH K R AE T IH K AH L IY
AUTOGRAPHICALLY	AO T AH G R AE F IH K AH L IY
AUTOMATICALLY	AO T AH M AE T IH K L IY
AUTOMATICALLY(2)	AO T OW M AE T IH K L IY
AUTONOMICALLY	AO T AH N AA M IH K AH L IY
AUTOSOMALLY	AO T OW S AH M AH L IY
AUTOTROPHICALLY	AH T AA T R AA F AH K AE L IY
AUTUMNALLY	AO T AH M N AH L IY
AVELLAN	AH V EH L AH N
AVELLANE	AE V AH L EY N
AVOCATIONALLY	AE V AH K EY SH AH N AH L IY
AWFULLER	AO F AH L ER
AWFULLEST	AO F AH L AH S T
AWFULLY	AA F L IY
AWFULLY(2)	AO F AH L IY
AXENICALLY	AE K S AH N IH K AH L IY
AXIALLY	AE K S IY AH L IY
AXILLA	AE K S IH L AH
AXILLAE	AE K S IH L IY
AXILLAR	AE K S IH L ER
AXILLARIES	AE K S IH L EH R IY Z
AXILLARS	AE K S IH L ER Z
AXILLARY	AE K S IH L EH R IY
AXILLAS	AE K S IH L AH Z
AXIOLOGICALLY	AE K S IY AH L AA JH IH K AH L IY
AXIOMATICALLY	AE K S IY AH M AE T IH K AH L IY
AYATOLLAH	AY AH T OW L AH
AYATOLLAHS	AY AH T AA L AA Z
AZIMUTHALLY	AH Z IH M AH TH AE L IY
BACILLAR	B AH S IH L AH R
BACILLARY	B AE S AH L EH R IY
BACILLI	B AH S IH L IY
BACILLUS	B AH S IH L AH S
BACKFILL	B AE K F IH L
BACKFILLED	B AE K F IH L D
BACKFILLING	B AE K F IH L IH NG
BACKFILLS	B AE K F IH L Z
BACKPEDALLED	B AE K P EH D AH L D
BACKPEDALLING	B AE K P EH D AH L IH NG
BACTERIALLY	B AE K T IH R IY AH L IY
BACTERICIDALLY	B AE K T AH R IH S AH D AE L IY
BACTERIOCHLOROPHYLL	B AE K T IY R IY AH K L AO R AH F AH L
BACTERIOCHLOROPHYLLS	B AE K T IY R IY AH K L AO R AH F AH L Z
BACTERIOLOGICALLY	B AE K T IY R IY AH L AA JH AH K AE L IY
BAGATELLE	B AE G AH T EH L
BAGATELLES	B AE G AH T EH L Z
BALEFULLY	B EY L F AH L IY
BALL	B AO L
BALLAD	B AE L AH D
BALLADE	B AH L AA D
BALLADEER	B AE L AH D IH R
BALLADEERS	B AE L AH D IH R Z
BALLADES	B AO L EY D Z
BALLADIC	B AE L AH D IH K
BALLADIST	B AE L AH D IH S T
BALLADISTS	B AE L AH D IH S T S
BALLADRIES	B AE L AH D R IY Z
BALLADRY	B AE L AH D R IY
BALLADS	B AE L AH D Z
BALLAST	B AE L AH S T
BALLASTED	B AE L AH S T IH D
BALLASTING	B AE L AH S T IH NG
BALLASTS	B AE L AH S T S
BALLASTS(2)	B AE L AH S
BALLCARRIER	B AO L K AE R IY ER
BALLCARRIERS	B AO L K AE R IY ER Z
BALLED	B AO L D
BALLER	B AO L ER
BALLERINA	B AE L ER IY N AH
BALLERINAS	B AE L ER IY N AH Z
BALLERS	B AO L ER Z
BALLET	B AE L EY
BALLETIC	B AE L EY IH K
BALLETOMANE	B AE L EH T AH M EY N
BALLETOMANES	B AE L EH T AH M EY N Z
BALLETOMANIA	B AE L AH T AH M EY N Y AH
BALLETOMANIAS	B AE L AH T AH M EY N Y AH Z
BALLETS	B AE L EY Z
BALLGAME	B AO L G EY M
BALLGAMES	B AO L G EY M Z
BALLHANDLING	B AO L HH AE N D L IH NG
BALLHANDLINGS	B AO L HH AE N D L IH NG Z
BALLHAWK	B AO L HH AO K
BALLHAWKS	B AO L HH AO K S
BALLIES	B AO L IY Z
BALLING	B AO L IH NG
BALLISTA	B AE L IH S T AH
BALLISTAE	B AE L IH S T IY
BALLISTIC	B AH L IH S T IH K
BALLISTICALLY	B AH L IH S T IH K AH L IY
BALLISTICS	B AH L IH S T IH K S
BALLON	B AE L AH N
BALLONET	B AE L AH N AH T
BALLONETS	B AE L AH N AH T S
BALLONNE	B AE L AH N
BALLONNES	B AE L AH N Z
BALLONS	B AO L AO N Z
BALLOON	B AH L UW N
BALLOONED	B AH L UW N D
BALLOONING	B AH L UW N IH NG
BALLOONINGS	B AH L UW N IH NG Z
BALLOONIST	B AH L UW N IH S T
BALLOONISTS	B AH L UW N IH S T S
BALLOONS	B AH L UW N Z
BALLOT	B AE L AH T
BALLOTED	B AE L AH T IH D
BALLOTER	B AE L AH T ER
BALLOTERS	B AE L AH T ER Z
BALLOTING	B AE L AH T IH NG
BALLOTS	B AE L AH T S
BALLPARK	B AO L P AA R K
BALLPARKS	B AO L P AA R K S
BALLPLAYER	B AO L P L EY ER
BALLPLAYERS	B AO L P L EY ER Z
BALLPOINT	B AO L P OY N T
BALLPOINTS	B AO L P OY N T S
BALLROOM	B AO L R UW M
BALLROOMS	B AO L R UW M Z
BALLS	B AO L Z
BALLSIER	B AO L Z IY ER
BALLSIEST	B AO L Z IY AH S T
BALLSY	B AO L Z IY
BALLUTE	B IY AH L UW T
BALLUTES	B IY AH L UW T S
BALLY	B AE L IY
BALLY(2)	B EY L IY
BALLYHOO	B AE L IY HH UW
BALLYHOOED	B AE L IY HH UW D
BALLYHOOING	B AE L IY HH UW IH NG
BALLYHOOS	B AE L IY HH UW Z
BALLYRAG	B AO L IY R AE G
BALLYRAGGED	B AO L IY R AE G AH D
BALLYRAGGING	B AO L IY R AE G IH NG
BALLYRAGS	B AO L IY R AE G Z
BANALLY	B EY N AH L IY
BANDERILLA	B AE N D AH R IH L AH
BANDERILLAS	B AE N D AH R IH L AH Z
BANDERILLERO	B AE N D AH R IH L AH R OW
BANDERILLEROS	B AE N D ER IH L ER AA S
BANEFULLY	B EY N F AH L IY
BANKROLL	B AE NG K R OW L
BANKROLLED	B AE NG K R OW L D
BANKROLLER	B AE NG K R OW L ER
BANKROLLERS	B AE NG K R OW L ER Z
BANKROLLING	B AE NG K R OW L IH NG
BANKROLLS	B AE NG K R OW L Z
BAPTISMALLY	B AE P T IH Z M AH L IY
BARBARICALLY	B AA R B AE R IH K AH L IY
BARBELL	B AA R B EH L
BARBELLS	B AA R B EH L Z
BARCAROLLE	B AA R K AH R AH L
BARCAROLLES	B AA R K AH R AH L Z
BARGELLO	B AA R JH EH L OW
BARGELLOS	B AA R JH EH L AH Z
BARILLA	B AH R IH L AH
BARILLAS	B AH R IH L AH Z
BAROMETRICALLY	B AE R AH M EH T R IH K AH L IY
BARRELLED	B AE R AH L D
BARRELLING	B AE R AH L IH NG
BASALLY	B EY S AH L IY
BASEBALL	B EY S B AO L
BASEBALLS	B EY S B AO L Z
BASHFULLY	B AE SH F AH L IY
BASICALLY	B EY S IH K L IY
BASIPETALLY	B AH S IH P AH T AE L IY
BASKETBALL	B AE S K AH T B AO L
BASKETBALLS	B AE S K AH T B AO L Z
BASTILLE	B AE S T IH L
BASTILLES	B AE S T AH L Z
BATHETICALLY	B AH TH EH T AH K AE L IY
BATHYMETRICALLY	B EY DH IY M EH T R IH K AH L IY
BDELLIUM	B D EH L IY AH M
BDELLIUMS	B D EH L IY AH M Z
BEADROLL	B IY D R OW L
BEADROLLS	B IY D R OW L Z
BEANBALL	B IY N B AO L
BEANBALLS	B IY N B AO L Z
BEATIFICALLY	B IY AH T IH F IH K AH L IY
BEAUTIFULLY	B Y UW T AH F L IY
BECUDGELLED	B IH K AH JH AH L D
BECUDGELLING	B IH K AH JH AH L IH NG
BEDELL	B EH D AH L
BEDELLS	B IH D EH L Z
BEDEVILLED	B IH D EH V AH L D
BEDEVILLING	B IH D IY V IH L IH NG
BEDFELLOW	B EH D F EH L OW
BEDFELLOWS	B EH D F EH L OW Z
BEDRIVELLED	B IH D R IH V AH L D
BEDRIVELLING	B IH D R AH V EH L AH NG
BEDROLL	B EH D R OW L
BEDROLLS	B EH D R OW L Z
BEFALL	B IH F AO L
BEFALLEN	B AH F AA L AH N
BEFALLING	B IH F AO L IH NG
BEFALLS	B IH F AO L Z
BEFELL	B IH F EH L
BEGALL	B IH G AO L
BEGALLED	B IH G AO L D
BEGALLING	B IH G AE L IH NG
BEGALLS	B IH G AO L Z
BEHAVIORALLY	B IY HH EY V Y ER AH L IY
BEJEWELLED	B IH JH UW AH L D
BEJEWELLING	B IH JH UW AH L IH NG
BELL	B EH L
BELLADONNA	B EH L AH D AA N AH
BELLADONNAS	B EH L AH D AA N AH Z
BELLBIRD	B EH L B ER D
BELLBIRDS	B EH L B ER D Z
BELLBOY	B EH L B OY
BELLBOYS	B EH L B OY Z
BELLE	B EH L
BELLED	B EH L D
BELLEEK	B IH L IY K
BELLEEKS	B IH L IY K S
BELLES	B EH L Z
BELLETRIST	B IH L EH T R AH S T
BELLETRISTIC	B IH L EH T R AH S T AH K
BELLETRISTS	B IH L EH T R AH S T S
BELLFLOWER	B EH L F L AW ER
BELLFLOWERS	B EH L F L AW ER Z
BELLHOP	B EH L HH AA P
BELLHOPS	B EH L HH AA P S
BELLICOSE	B EH L AH K OW S
BELLICOSELY	B IH L AH K OW Z L IY
BELLICOSITIES	B EH L IH K AA S AH T IY Z
BELLICOSITY	B EH L IH K AA S AH T IY
BELLIED	B EH L IY D
BELLIES	B EH L IY Z
BELLIGERENCE	B AH L IH JH ER AH N S
BELLIGERENCES	B AH L IH JH ER AH N S IH Z
BELLIGERENCIES	B AH L IH JH ER AH N S IY Z
BELLIGERENCY	B AH L IH JH ER AH N S IY
BELLIGERENT	B AH L IH JH ER AH N T
BELLIGERENTLY	B AH L IH JH ER AH N T L IY
BELLIGERENTS	B AH L IH JH ER AH N T S
BELLING	B EH L IH NG
BELLMAN	B EH L M AH N
BELLMEN	B EH L M EH N
BELLOW	B EH L OW
BELLOWED	B EH L OW D
BELLOWER	B EH L OW ER
BELLOWERS	B EH L OW ER Z
BELLOWING	B EH L OW IH NG
BELLOWS	B EH L OW Z
BELLPULL	B EH L P UH L
BELLPULLS	B EH L P UH L Z
BELLS	B EH L Z
BELLWETHER	B EH L W EH DH ER
BELLWETHERS	B EH L W EH DH ER Z
BELLWORT	B IH L W AH R T
BELLWORTS	B IH L W AH R T S
BELLY	B EH L IY
BELLYACHE	B EH L IY EY K
BELLYACHED	B EH L IY EY K T
BELLYACHER	B EH L IY EY K ER
BELLYACHERS	B EH L IY EY K ER Z
BELLYACHES	B EH L IY EY K S
BELLYACHING	B EH L IY EY K IH NG
BELLYBAND	B EH L IY B AE N D
BELLYBANDS	B EH L IY B AE N D Z
BELLYBUTTON	B EH L IY B AH T AH N
BELLYBUTTONS	B EH L IY B AH T AH N Z
BELLYFUL	B EH L IY F AH L
BELLYFULS	B EH L IY F AH L Z
BELLYING	B EH L IY IH NG
BEMEDALLED	B IH M EH D AH L D
BENEFICIALLY	B EH N AH F IH SH AH L IY
BERYLLIUM	B ER IH L IY AH M
BERYLLIUMS	B AH R IH L IY AH M Z
BESTIALLY	B EH S CH AH L IY
BESTSELLER	B EH S T S EH L ER
BESTSELLER(2)	B EH S EH L ER
BESTSELLERDOM	B EH S T S EH L ER D AH M
BESTSELLERDOMS	B EH S T S EH L ER D AH M Z
BESTSELLERS	B EH S T S EH L ER Z
BESTSELLERS(2)	B EH S EH L ER Z
BEVELLED	B EH V AH L D
BEVELLER	B EH V AH L ER
BEVELLERS	B EH V AH L ER Z
BEVELLING	B EH V AH L IH NG
BIANNUALLY	B AY AE N Y AH W AH L IY
BIAXIALLY	B AY AE K S IY AH L IY
BIBLICALLY	B IH B L IH K AH L IY
BIBLIOGRAPHICALLY	B IH B L IY AH G R AE F IH K AH L IY
BIDIRECTIONALLY	B AY D AH R EH K SH AH N AH L IY
BIDONVILLE	B AY D AA N V AH L
BIDONVILLES	B AY D AA N V AH L Z
BIENNIALLY	B AY EH N IY AH L IY
BIFACIALLY	B AY F EY SH AH L IY
BIFLAGELLATE	B AY F L AE JH AH L AH T
BILATERALLY	B AY L AE T ER AH L IY
BILINGUALLY	B AY L IH NG G W AH L IY
BILL	B IH L
BILLABLE	B IH L AH B AH L
BILLABONG	B IH L AH B AA NG
BILLABONGS	B IH L AH B AA NG Z
BILLBOARD	B IH L B AO R D
BILLBOARDED	B IH L B OW R D IH D
BILLBOARDING	B IH L B OW R D IH NG
BILLBOARDS	B IH L B AO R D Z
BILLBUG	B IH L B AH G
BILLBUGS	B IH L B AH G Z
BILLED	B IH L D
BILLER	B IH L ER
BILLERS	B IH L ER Z
BILLET	B IH L AH T
BILLET(2)	B IH L IH T
BILLETED	B IH L AH T IH D
BILLETER	B IH L IY T ER
BILLETERS	B IH L AH T ER Z
BILLETING	B IH L AH T IH NG
BILLETS	B IH L AH T S
BILLFISH	B IH L F IH SH
BILLFISHES	B IH L F IH SH IH Z
BILLFOLD	B IH L F OW L D
BILLFOLDS	B IH L F OW L D Z
BILLHEAD	B IH L HH EH D
BILLHEADS	B IH L HH EH D Z
BILLHOOK	B IH L HH UH K
BILLHOOKS	B IH L HH UH K S
BILLIARD	B IH L Y ER D
BILLIARDS	B IH L Y ER D Z
BILLIE	B IH L IY
BILLIES	B IH L IY Z
BILLING	B IH L IH NG
BILLINGS	B IH L IH NG Z
BILLINGSGATE	B IH L IH NG Z G EY T
BILLINGSGATES	B IH L IH NG Z G EY T S
BILLION	B IH L Y AH N
BILLIONAIRE	B IH L Y AH N EH R
BILLIONAIRES	B IH L Y AH N EH R Z
BILLIONS	B IH L Y AH N Z
BILLIONTH	B IH L Y AH N TH
BILLIONTHS	B IH L Y AH N TH S
BILLON	B IH L AH N
BILLONS	B IH L AO N Z
BILLOW	B IH L OW
BILLOWED	B IH L OW D
BILLOWIER	B IH L OW IY ER
BILLOWIEST	B IH L OW IY AH S T
BILLOWING	B IH L OW IH NG
BILLOWS	B IH L OW Z
BILLOWY	B IH L OW IY
BILLS	B IH L Z
BILLY	B IH L IY
BILLYCAN	B IH L IY K AE N
BILLYCANS	B IH L IY K AE N Z
BILLYCOCK	B IH L IY K AA K
BILLYCOCKS	B IH L IY K AA K S
BIMANUALLY	B AY M AE N Y AH W AH L IY
BIMETALLIC	B AY M AH T AE L IH K
BIMETALLICS	B AY M AH T AE L IH K S
BIMETALLISM	B AY M EH T AH L IH Z AH M
BIMETALLISMS	B AY M EH T AH L IH Z AH M Z
BIMETALLIST	B AY M EH T AH L IH S T
BIMETALLISTIC	B AY M EH T AH L IH S T IH K
BIMETALLISTS	B AY M EH T AH L IH S T S
BIMILLENARIES	B AY M IH L AH N EH R IY Z
BIMILLENARY	B AY M IH L AH N EH R IY
BIMILLENNIAL	B AY M IH L AH N IY AH L
BIMILLENNIALS	B AY M IH L AH N IY AH L Z
BINAURALLY	B IH N AO R AH L IY
BINOMIALLY	B AY N OW M IY AH L IY
BIOCHEMICALLY	B AY OW K EH M IH K AH L IY
BIOGENETICALLY	B AY AH JH AH N EH T AH K AE L IY
BIOGRAPHICALLY	B AY AH G R AE F IH K AH L IY
BIOLOGICALLY	B AY AH L AA JH IH K L IY
BIOMECHANICALLY	B AY AH M AH CH AE N AH K AE L IY
BIOSOCIALLY	B AY AH S OW S IY AE L IY
BIOSYNTHETICALLY	B AY AH S IH N TH EH T AH K AE L IY
BIPARENTALLY	B AY P AH R EH N T AH L IY
BIPEDALLY	B AY P EH D AH L IY
BIPROPELLANT	B AY P R OW P EH L AH N T
BIPROPELLANTS	B AY P R OW P EH L AH N T S
BIRDCALL	B ER D K AO L
BIRDCALLS	B ER D K AO L Z
BISECTIONALLY	B AY S EH K SH AH N AH L IY
BISEXUALLY	B AY S EH K SH AH W AH L IY
BLACKBALL	B L AE K B AO L
BLACKBALLED	B L AE K B AO L D
BLACKBALLING	B L AE K B AO L IH NG
BLACKBALLS	B L AE K B AO L Z
BLACKPOLL	B L AE K P OW L
BLACKPOLLS	B L AE K P OW L Z
BLAMEFULLY	B L EY M F AH L IY
BLELLUM	B L EH L AH M
BLELLUMS	B L EH L AH M Z
BLISSFULLY	B L IH S F AH L IY
BLOWBALL	B L OW B AO L
BLOWBALLS	B L OW B AO L Z
BLUEBALL	B L UW B AO L
BLUEBALLS	B L UW B AO L Z
BLUEBELL	B L UW B EH L
BLUEBELLS	B L UW B EH L Z
BLUEBILL	B L UW B IH L
BLUEBILLS	B L UW B IH L Z
BLUEGILL	B L UW G IH L
BLUEGILLS	B L UW G IH L Z
BOASTFULLY	B OW S T F AH L IY
BOATBILL	B OW T B IH L
BOATBILLS	B OW T B IH L Z
BOLL	B OW L
BOLLARD	B AA L ER D
BOLLARDS	B AA L AH R D Z
BOLLED	B AA L D
BOLLING	B OW L IH NG
BOLLIX	B AA L AH K S
BOLLIXED	B AA L AH K S T
BOLLIXES	B AA L AH K S
BOLLIXING	B AA L IH K S AH NG
BOLLOCKS	B AA L AH K S
BOLLOX	B AA L AH K S
BOLLOXED	B AA L AH K S T
BOLLOXES	B AA L AH K S
BOLLOXING	B AA L AA K S AH NG
BOLLS	B OW L Z
BOLLWORM	B AA L W AH R M
BOLLWORMS	B AA L W AH R M Z
BOLOMETRICALLY	B OW L OW M EH T R IH K AH L IY
BOMBASTICALLY	B AA M B AE S T IH K AH L IY
BOMBSHELL	B AA M SH EH L
BOMBSHELLS	B AA M SH EH L Z
BONSPELL	B AA N S AH L
BONSPELLS	B AA N S AH L Z
BOOKSELLER	B UH K S EH L ER
BOOKSELLERS	B UH K S EH L ER Z
BOOKSELLING	B UH K S EH L IH NG
BOOKSELLINGS	B UH K S EH L IH NG Z
BOOKSTALL	B UH K S T AO L
BOOKSTALLS	B UH K S T AO L Z
BORDELLO	B AO R D EH L OW
BORDELLOS	B IY ER D EH L AA S
BOTANICALLY	B AH T AE N AH K AH L IY
BOTANICALLY(2)	B AH T AE N AH K L IY
BOUGAINVILLAEA	B AW G EY N V IH L IY AH
BOUGAINVILLAEAS	B AW G EY N V IH L IY AH Z
BOUGAINVILLEA	B UW G EY N V IH L IY AH
BOUGAINVILLEAS	B AW G EY N V IH L IY Z
BOUILLABAISSE	B AW IH L AH B EY S
BOUILLABAISSES	B AW IH L AH B EY S AH Z
BOUILLON	B UW W IH L AH N
BOUILLONS	B AW IH L AH N Z
BOULLE	B UW L
BOULLES	B UW L Z
BOUNTIFULLY	B AW N T IY F AH L IY
BOWELLED	B AW AH L D
BOWELLESS	B AW AH L AH S
BOWELLING	B AW AH L IH NG
BOWLLIKE	B OW L AY K
BRAILLE	B R EY L
BRAILLED	B R EY L D
BRAILLES	B R EY L Z
BRAILLEWRITER	B R EY L R AY T ER
BRAILLEWRITERS	B R EY L R AY T ER Z
BRAILLING	B R EY L IH NG
BRAILLIST	B R EY L IH S T
BRAILLISTS	B R EY L IH S T S
BRIDALLY	B R AY D AH L IY
BRIDEWELL	B R AY D W EH L
BRIDEWELLS	B R AY D W EH L Z
BRILL	B R IH L
BRILLIANCE	B R IH L Y AH N S
BRILLIANCES	B R IH L Y AH N S IH Z
BRILLIANCIES	B R IH L Y AH N S IY Z
BRILLIANCY	B R IH L Y AH N S IY
BRILLIANT	B R IH L Y AH N T
BRILLIANTINE	B R IH L IY AH N T AY N
BRILLIANTINES	B R IH L IY AH N T AY N Z
BRILLIANTLY	B R IH L Y AH N T L IY
BRILLIANTS	B R IH L Y AH N T S
BRILLS	B R IH L Z
BRIMFULL	B R IH M F UH L
BROCATELLE	B R AA K AH T AH L
BROCATELLES	B R AA K AH T AH L Z
BROLLIES	B R AA L AY Z
BROLLY	B R AA L IY
BRONCHIALLY	B R AA N K AY AH L IY
BROOMBALL	B R UW M B AO L
BROOMBALLER	B R UW M B AO L ER
BROOMBALLERS	B R UW M B AO L ER Z
BROOMBALLS	B R UW M B AO L Z
BRUCELLA	B R UW S EH L AH
BRUCELLAE	B R UW S EH L IY
BRUCELLAS	B R UW S EH L AH Z
BRUCELLOSES	B R UW S AH L OW Z AH Z
BRUCELLOSIS	B R UW S AH L OW S AH S
BRUTALLY	B R UW T AH L IY
BRYOPHYLLUM	B R AY AH F IH L AH M
BRYOPHYLLUMS	B R AY AH F IH L AH M Z
BUCCALLY	B AH K AE L IY
BUCKMINSTERFULLERENE	B AH K M AH N S T AH R F UH L AH R IY N
BUCKMINSTERFULLERENES	B AH K M AH N S T AH R F UH L AH R IY N Z
BUCKYBALL	B AH K IY B AO L
BUCKYBALLS	B AH K IY B AO L Z
BUCOLICALLY	B Y UW K AA L IH K AH L IY
BULL	B UH L
BULLA	B UH L AH
BULLACE	B UH L EY S
BULLACES	B UH L EY S IH Z
BULLAE	B UH L IY
BULLATE	B UH L AH T
BULLBAITING	B UH L B EY T IH NG
BULLBAITINGS	B UH L B EY T IH NG Z
BULLBAT	B UH L B AE T
BULLBATS	B UH L B AE T S
BULLDOG	B UH L D AO G
BULLDOGGED	B UH L D AO G AH D
BULLDOGGER	B UH L D AO G ER
BULLDOGGERS	B UH L D AO G ER Z
BULLDOGGING	B UH L D AO G IH NG
BULLDOGGINGS	B UH L D AO G IH NG Z
BULLDOGS	B UH L D AO G Z
BULLDOZE	B UH L D OW Z
BULLDOZED	B UH L D OW Z D
BULLDOZER	B UH L D OW Z ER
BULLDOZERS	B UH L D OW Z ER Z
BULLDOZES	B UH L D OW Z IH Z
BULLDOZING	B UH L D OW Z IH NG
BULLED	B UH L D
BULLET	B UH L AH T
BULLETED	B UH L AH T IH D
BULLETIN	B UH L IH T AH N
BULLETINED	B UH L AH T AH N D
BULLETING	B UH L AH T IH NG
BULLETINING	B UH L AH T AH N IH NG
BULLETINS	B UH L AH T AH N Z
BULLETPROOF	B UH L AH T P R UW F
BULLETS	B UH L AH T S
BULLFIGHT	B UH L F AY T
BULLFIGHTER	B UH L F AY T ER
BULLFIGHTERS	B UH L F AY T ER Z
BULLFIGHTING	B UH L F AY T IH NG
BULLFIGHTINGS	B UH L F AY T IH NG Z
BULLFIGHTS	B UH L F AY T Z
BULLFINCH	B UH L F IH N CH
BULLFINCHES	B UH L F IH N CH IH Z
BULLFROG	B UH L F R AO G
BULLFROGS	B UH L F R AO G Z
BULLHEAD	B UH L HH EH D
BULLHEADED	B UH L HH EH D IH D
BULLHEADEDLY	B UH L HH EH D AH D L IY
BULLHEADEDNESS	B UH L HH EH D AH D N AH S
BULLHEADEDNESSES	B UH L HH EH D AH D N AH S IH Z
BULLHEADS	B UH L HH EH D Z
BULLHORN	B UH L HH AO R N
BULLHORNS	B UH L HH AO R N Z
BULLIED	B UH L IY D
BULLIER	B UH L IY ER
BULLIES	B UH L IY Z
BULLIEST	B UH L IY AH S T
BULLING	B UH L IH NG
BULLION	B UH L Y AH N
BULLIONS	B UH L Y AH N Z
BULLISH	B UH L IH SH
BULLISHLY	B UH L IH SH L IY
BULLISHNESS	B UH L IH SH N AH S
BULLISHNESSES	B UH L IH SH N AH S IH Z
BULLMASTIFF	B UH L M AE S T AH F
BULLMASTIFFS	B UH L M AE S T AH F S
BULLNECK	B UH L N EH K
BULLNECKED	B UH L N EH K T
BULLNECKS	B UH L N EH K S
BULLNOSE	B UH L N OW Z
BULLNOSES	B UH L N OW Z IH Z
BULLOCK	B UH L AH K
BULLOCKS	B UH L AH K S
BULLOCKY	B UH L AA K IY
BULLOUS	B UH L AH S
BULLPEN	B UH L P EH N
BULLPENS	B UH L P EH N Z
BULLPOUT	B UH L P AW T
BULLPOUTS	B UH L P AW T S
BULLRING	B UH L R IH NG
BULLRINGS	B UH L R IH NG Z
BULLRUSH	B UH L R AH SH
BULLRUSHES	B UH L R AH SH IH Z
BULLS	B UH L Z
BULLSHIT	B UH L SH IH T
BULLSHITS	B UH L SH IH T S
BULLSHITTED	B UH L SH IH T IH D
BULLSHITTING	B UH L SH IH T IH NG
BULLSHOT	B UH L SH AA T
BULLSHOTS	B UH L SH AA T S
BULLTERRIER	B UH L T EH R IY ER
BULLTERRIERS	B UH L T EH R IY ER Z
BULLWEED	B UH L W IY D
BULLWEEDS	B UH L W IY D Z
BULLWHIP	B UH L W IH P
BULLWHIPPED	B UH L W IH P T
BULLWHIPPING	B UH L W IH P IH NG
BULLWHIPS	B UH L W IH P S
BULLY	B UH L IY
BULLYBOY	B UH L IY B OY
BULLYBOYS	B UH L IY B OY Z
BULLYING	B UH L IY IH NG
BULLYRAG	B UH L IY R AE G
BULLYRAGGED	B UH L IY R AE G AH D
BULLYRAGGING	B UH L IY R AE G IH NG
BULLYRAGS	B UH L IY R AE G Z
BUREAUCRATICALLY	B Y UH R AH K R AE T IH K AH L IY
BUSHELLED	B UH SH AH L D
BUSHELLING	B UH SH AH L IH NG
BUTTERBALL	B AH T ER B AO L
BUTTERBALLS	B AH T ER B AO L Z
BUTTONBALL	B AH T AH N B AO L
BUTTONBALLS	B AH T AH N B AO L Z
CABALLED	K AE B AH L D
CABALLERO	K AE B AH Y EH R OW
CABALLEROS	K AE B AH L ER AA S
CABALLING	K AE B AH L IH NG
CABRILLA	K AE B R IH L AH
CABRILLAS	K AE B R IH L AH Z
CADASTRALLY	K AH D AE S T R AE L IY
CADELLE	K AE D AH L
CADELLES	K AE D AH L Z
CAECALLY	K IY K AE L IY
CALL	K AO L
CALLA	K AE L AH
CALLABLE	K AO L AH B AH L
CALLALOO	K AE L AH L UW
CALLALOOS	K AE L AH L UW Z
CALLAN	K AE L AH N
CALLANS	K AE L AH N Z
CALLANT	K AO L AH N T
CALLANTS	K AO L AH N T S
CALLAS	K AE L AH Z
CALLBACK	K AO L B AE K
CALLBACKS	K AO L B AE K S
CALLBOY	K AO L B OY
CALLBOYS	K AO L B OY Z
CALLED	K AO L D
CALLER	K AO L ER
CALLERS	K AO L ER Z
CALLET	K AE L AH T
CALLETS	K AE L AH T S
CALLIGRAPHER	K AH L IH G R AH F ER
CALLIGRAPHERS	K AH L IH G R AH F ER Z
CALLIGRAPHIC	K AE L AH G R AE F IH K
CALLIGRAPHICALLY	K AE L IH G R AE F AH K AE L IY
CALLIGRAPHIES	K AH L IH G R AH F IY Z
CALLIGRAPHIST	K AE L IH G R AH F AH S T
CALLIGRAPHISTS	K AE L IH G R AH F AH S T S
CALLIGRAPHY	K AH L IH G R AH F IY
CALLING	K AO L IH NG
CALLINGS	K AO L IH NG Z
CALLIOPE	K AH L AY AH P IY
CALLIOPES	K AH L AY AH P IY Z
CALLIPEE	K AE L AH P IY IY
CALLIPEES	K AE L AH P IY Z
CALLIPER	K AE L AY P AH R
CALLIPERED	K AE L AH P IY R D
CALLIPERING	K AE L AH P IY R AH NG
CALLIPERS	K AE L AH P AH R Z
CALLIPYGIAN	K AE L IH P AH JH AH N
CALLIPYGOUS	K AE L IH P AH G AH S
CALLITHUMP	K AE L AH TH AH M P
CALLITHUMPIAN	K AE L AH TH AH M P IY AH N
CALLITHUMPS	K AE L AH TH AH M P S
CALLOSE	K AE L OW Z
CALLOSES	K AO L AA S IH Z
CALLOSITIES	K AO L AA S AH T IY Z
CALLOSITY	K AO L AA S AH T IY
CALLOUS	K AE L AH S
CALLOUSED	K AE L AH S T
CALLOUSES	K AE L AH S IH Z
CALLOUSING	K AE L AH S IH NG
CALLOUSLY	K AE L AH S L IY
CALLOUSNESS	K AE L AH S N AH S
CALLOUSNESSES	K AE L AH S N AH S IH Z
CALLOW	K AE L OW
CALLOWER	K AO L OW ER
CALLOWEST	K AO L OW AH S T
CALLOWNESS	K AO L OW N AH S
CALLOWNESSES	K AO L OW N AH S IH Z
CALLS	K AO L Z
CALLUS	K AE L AH S
CALLUSED	K AE L AH S T
CALLUSES	K AE L AH S IH Z
CALLUSING	K AE L AH S IH NG
CALORICALLY	K AH L AO R IH K AH L IY
CALORIMETRICALLY	K AH L AO R AH M EH T R IH K AH L IY
CAMARILLA	K AE M AH R IH L AH
CAMARILLAS	K AE M AH R IH L AH Z
CAMELLIA	K AH M IY L Y AH
CAMELLIAS	K AH M IY L Y AH Z
CANAILLE	K AH N EY L
CANAILLES	K AH N EY L Z
CANALLED	K AH N AE L D
CANALLER	K AH N AE L ER
CANALLERS	K AH N AE L ER Z
CANALLING	K AH N AE L IH NG
CANCELLABLE	K AE N S AH L AH B AH L
CANCELLATION	K AE N S AH L EY SH AH N
CANCELLATIONS	K AE N S AH L EY SH AH N Z
CANCELLED	K AE N S AH L D
CANCELLER	K AE N S AH L ER
CANCELLERS	K AE N S AH L ER Z
CANCELLING	K AE N S AH L IH NG
CANCELLING(2)	K AE N S L IH NG
CANCELLOUS	K AE N S AH L AH S
CANELLA	K AH N EH L AH
CANELLAS	K AH N EH L AH Z
CANNELLONI	K AE N EH L AH N IY
CANNONBALL	K AE N AH N B AO L
CANNONBALLED	K AE N AH N B AO L D
CANNONBALLING	K AE N AH N B AO L IH NG
CANNONBALLS	K AE N AH N B AO L Z
CANONICALLY	K AE N AH N IH K AH L IY
CANTILLATE	K AE N T IH L AH T
CANTILLATED	K AE N T IH L EY T IH D
CANTILLATES	K AE N T IH L AH T S
CANTILLATING	K AE N T IH L EY T IH NG
CANTILLATION	K AE N T IH L EY SH AH N
CANTILLATIONS	K AE N T IH L EY SH AH N Z
CAPERCAILLIE	K AE P AH R K EY L AY
CAPERCAILLIES	K AH P AH R K EY L AY Z
CAPILLARIES	K AE P AH L EH R IY Z
CAPILLARITIES	K AE P IH L ER AH T IY Z
CAPILLARITY	K AE P IH L ER AH T IY
CAPILLARY	K AE P AH L EH R IY
CAPITALISTICALLY	K AE P AH T AH L IH S T IH K AH L IY
CAPITALLY	K AE P AH T AH L IY
CAPPELLETTI	K AA P EH L EH T IY
CARACOLLED	K AE R AH K AH L D
CARACOLLING	K AE R AH K AA L AH NG
CARBOXYMETHYLCELLULOSE	K AA R B AA K S IY M EH TH AH L S EH L Y AH L OW S
CARBOXYMETHYLCELLULOSES	K AA R B AA K S IY M EH TH AH L S EH L Y AH L OW S IH
CARDINALLY	K AA R D AH N AH L IY
CAREFULLER	K EH R F AH L ER
CAREFULLEST	K EH R F AH L AH S T
CAREFULLY	K EH R F AH L IY
CARILLON	K EH R AH L AA N
CARILLONNED	K AA R IH L AO N D
CARILLONNEUR	K AE R AH L AA N AH R
CARILLONNEURS	K AH R IH L AA N IY Y AH R Z
CARILLONNING	K AA R IH L AO N IH NG
CARILLONS	K AA R IH L AO N Z
CARNALLITE	K AA R N AH L AY T
CARNALLITES	K AA R N AH L AY T S
CARNALLY	K AA R N AH L IY
CAROLLED	K AE R AH L D
CAROLLER	K AE R AH L ER
CAROLLERS	K AE R AH L ER Z
CAROLLING	K AE R AH L IH NG
CARPELLARY	K AA R P AH L EH R IY
CARPELLATE	K AA R P AH L EY T
CARRELL	K AA R EY L
CARRELLS	K AE R AH L Z
CARRYALL	K AE R IY AO L
CARRYALLS	K AE R IY AO L Z
CARTOGRAPHICALLY	K AA R T AA G R AE F AH K AE L IY
CASCARILLA	K AE S AH R IH L AH
CASCARILLAS	K AE S AH R IH L AH Z
CASTELLAN	K AE S T EH L AH N
CASTELLANS	K AE S T EH L AH N Z
CASTELLATED	K AE S T AH L EY T AH D
CASUALLY	K AE ZH AH W AH L IY
CATABOLICALLY	K AE T AH B AA L AH K AE L IY
CATACHRESTICALLY	K AE T AH K R EH S T AH K AE L IY
CATACLYSMICALLY	K AE T AH K L IH Z M IH K AH L IY
CATALEPTICALLY	K AE T AH L EH P T AH K AE L IY
CATALYTICALLY	K AE T AH L IH T IH K AH L IY
CATAPHORETICALLY	K AE T AH F AH R EH T AH K AE L IY
CATARRHALLY	K AH T AE R AE L IY
CATASTROPHICALLY	K AE T AH S T R AA F IH K AH L IY
CATATONICALLY	K AE T AH T OW N IH K AH L IY
CATCALL	K AE T K AO L
CATCALLED	K AE T K AO L D
CATCALLING	K AE T K AO L IH NG
CATCALLS	K AE T K AO L Z
CATCHALL	K AE CH AO L
CATCHALLS	K AE CH AO L Z
CATCHPOLL	K AE CH P OW L
CATCHPOLLS	K AE CH P OW L Z
CATEGORICALLY	K AE T AH G AA R IH K L IY
CATEGORICALLY(2)	K AE T AH G AO R IH K L IY
CATERPILLAR	K AE T AH P IH L ER
CATERPILLAR(2)	K AE T ER P IH L ER
CATERPILLARS	K AE T AH P IH L ER Z
CATFALL	K AE T F AO L
CATFALLS	K AE T F AO L Z
CATHODALLY	K AE TH OW D AH L IY
CATHODICALLY	K AE TH OW D IH K AH L IY
CATHOLICALLY	K AE TH L IH K AH L IY
CATIONICALLY	K EY SH AH N IH K AH L IY
CAUDALLY	K AH D AE L IY
CAUDILLISMO	K AO D AH L IH Z M OW
CAUDILLISMOS	K AO D AH L IH Z M AH Z
CAUDILLO	K AO D IH L OW
CAUDILLOS	K AH D IH L AH Z
CAUSALLY	K AO Z AH L IY
CAUSTICALLY	K AO S T AH K AE L IY
CAVALLA	K AH V AE L AH
CAVALLAS	K AH V AE L AH Z
CAVALLETTI	K AE V AH L EH T IY
CAVALLIES	K EY V AH L IY Z
CAVALLY	K EY V AH L IY
CAVILLED	K AE V AH L D
CAVILLER	K AH V IH L AH R
CAVILLERS	K AH V IH L AH R Z
CAVILLING	K AH V IH L AH NG
CECALLY	S AH K AE L IY
CEDILLA	S AH D IH L AH
CEDILLAS	S AH D IH L AH Z
CELESTIALLY	S AH L EH S CH AH L IY
CELL	S EH L
CELLA	S EH L AH
CELLAE	S EH L IY
CELLAR	S EH L ER
CELLARAGE	S EH L ER IH JH
CELLARAGES	S EH L ER IH JH IH Z
CELLARED	S EH L ER D
CELLARER	S EH L ER ER
CELLARERS	S EH L ER ER Z
CELLARET	S EH L AH R AH T
CELLARETS	S EH L AH R AH T S
CELLARETTE	S EH L ER EH T
CELLARETTES	S EH L ER EH T S
CELLARING	S EH L ER IH NG
CELLARS	S EH L ER Z
CELLBLOCK	S EH L B L AA K
CELLBLOCKS	S EH L B L AA K S
CELLED	S EH L D
CELLI	CH EH L IY
CELLING	S EH L IH NG
CELLIST	CH EH L AH S T
CELLISTS	CH EH L AH S T S
CELLMATE	S EH L M EY T
CELLMATES	S EH L M EY T S
CELLO	CH EH L OW
CELLOBIOSE	S EH L OW B IY OW Z
CELLOBIOSES	S EH L OW B IY OW Z AH Z
CELLOIDIN	S EH L OY D AH N
CELLOIDINS	S EH L OY D AH N Z
CELLOPHANE	S EH L AH F EY N
CELLOPHANES	S EH L AH F EY N Z
CELLOS	S EH L AA S
CELLPHONE	S EH L F OW N
CELLPHONES	S EH L F OW N Z
CELLS	S EH L Z
CELLULAR	S EH L Y AH L ER
CELLULARITIES	S EH L Y AH L ER AH T IY Z
CELLULARITY	S EH L Y AH L ER AH T IY
CELLULASE	S EH L AH L EY Z
CELLULASES	S EH L AH L EY Z AH Z
CELLULE	S EH L UW L
CELLULES	S EH L AH L Z
CELLULITE	S EH L AH L AY T
CELLULITES	S EH L AH L AY T S
CELLULITIS	S EH L AH L AY T AH S
CELLULITISES	S EH L UW L AH T AY Z AH Z
CELLULOID	S EH L AH L OY D
CELLULOIDS	S EH L AH L OY D Z
CELLULOLYTIC	S EH L UW L AH L AH T AH K
CELLULOSE	S EH L Y AH L OW S
CELLULOSES	S EH L Y AH L OW S IH Z
CELLULOSIC	S EH L Y AH L OW S IH K
CELLULOSICS	S EH L Y AH L OW S IH K S
CENTENNIALLY	S EH N T EH N IY AH L IY
CENTILLION	S EH N T IH L Y AH N
CENTILLIONS	S EH N T IH L Y AH N Z
CENTRALLY	S EH N T R AH L IY
CENTRICALLY	S EH N T R IH K AH L IY
CENTRIFUGALLY	S EH N T R IH F Y AH G AH L IY
CENTRIPETALLY	S EH N T R AY P T AE L IY
CEPHALICALLY	S AH F AE L AH K AE L IY
CEREBELLA	S EH R AH B EH L AH
CEREBELLAR	S EH R AH B EH L AH R
CEREBELLUM	S EH R AH B EH L AH M
CEREBELLUMS	S EH R AH B EH L AH M Z
CEREBRALLY	S ER IY B R AH L IY
CEREMONIALLY	S EH R AH M OW N IY AH L IY
CHALLA	CH AE L AH
CHALLAH	CH AE L AH
CHALLAHS	CH AE L AH Z
CHALLAS	CH AE L AH Z
CHALLENGE	CH AE L AH N JH
CHALLENGED	CH AE L AH N JH D
CHALLENGER	CH AE L AH N JH ER
CHALLENGER(2)	CH AE L IH N JH ER
CHALLENGERS	CH AE L AH N JH ER Z
CHALLENGES	CH AE L AH N JH IH Z
CHALLENGING	CH AE L AH N JH IH NG
CHALLENGINGLY	CH AE L AH N JH IH NG L IY
CHALLIE	CH AE L AY
CHALLIES	CH AE L AY Z
CHALLIS	SH AE L IY
CHALLISES	CH AE L AY Z AH Z
CHALLOT	CH AE L AH T
CHALLOTH	CH AE L AH TH
CHALLY	CH AE L IY
CHANCELLERIES	CH AE N S AH L AH R IY Z
CHANCELLERY	CH AE N S AH L AH R IY
CHANCELLOR	CH AE N S AH L ER
CHANCELLOR(2)	CH AE N S L ER
CHANCELLORIES	CH AE N S AH L ER IY Z
CHANCELLORS	CH AE N S AH L ER Z
CHANCELLORSHIP	CH AE N S AH L ER SH IH P
CHANCELLORSHIPS	CH AE N S AH L ER SH IH P S
CHANCELLORY	CH AE N S AH L ER IY
CHANDELLE	SH AE N D EH L
CHANDELLED	SH AE N D EH L D
CHANDELLES	SH AE N D EH L Z
CHANDELLING	SH AE N D EH L IH NG
CHANGEFULLY	CH EY N JH F AH L IY
CHANNELLED	CH AE N AH L D
CHANNELLING	CH AE N AH L IH NG
CHANTERELLE	CH AE N T AH R AH L
CHANTERELLES	CH AE N T AH R AH L Z
CHAOTICALLY	K EY AA T IH K AH L IY
CHAPFALLEN	CH AE P F AE L AH N
CHARACTERISTICALLY	K EH R IH K T ER IH S T IH K L IY
CHARACTEROLOGICALLY	CH AH R AE K T AH R AH L AA JH AH K AE L IY
CHAUVINISTICALLY	CH AO V AH N IH S T AH K AE L IY
CHEERFULLER	CH IH ER F AH L ER
CHEERFULLEST	CH IH ER F AH L AH S T
CHEERFULLY	CH IH R F AH L IY
CHEERFULLY(2)	CH IH R F L IY
CHEMICALLY	K EH M IH K L IY
CHEMOTACTICALLY	K EH M AH T AE K T AH K AE L IY
CHEMOTHERAPEUTICALLY	K AH M AA TH AH R EY P Y UW T AH K AE L IY
CHENILLE	CH EH N AH L
CHENILLES	CH EH N AH L Z
CHERUBICALLY	CH AH R UW B AH K AE L IY
CHILL	CH IH L
CHILLED	CH IH L D
CHILLER	CH IH L ER
CHILLERS	CH IH L ER Z
CHILLEST	CH IH L AH S T
CHILLI	CH IH L IY
CHILLIER	CH IH L IY ER
CHILLIES	CH IH L IY Z
CHILLIEST	CH IH L IY AH S T
CHILLILY	CH IH L IY L IY
CHILLINESS	CH IH L IY N AH S
CHILLINESSES	CH IH L IY N AH S IH Z
CHILLING	CH IH L IH NG
CHILLINGLY	CH IH L IH NG L IY
CHILLNESS	CH IH L N AH S
CHILLNESSES	CH IH L N AH S IH Z
CHILLS	CH IH L Z
CHILLUM	CH IH L AH M
CHILLUMS	CH IH L AH M Z
CHILLY	CH IH L IY
CHIMERICALLY	CH AY M ER IH K AH L IY
CHINCHILLA	CH IH N CH IH L AH
CHINCHILLAS	CH IH NG K IH L AH Z
CHISELLED	CH IH Z AH L D
CHISELLER	CH IH Z AH L ER
CHISELLERS	CH IH Z AH L ER Z
CHISELLING	CH IH Z AH L IH NG
CHLORELLA	K L AH R EH L AH
CHLORELLAS	K L AH R EH L AH Z
CHLOROPHYLL	K L AO R AH F IH L
CHLOROPHYLLOUS	K L AO R AH F IH L AH S
CHLOROPHYLLS	K L AO R AH F AH L Z
CHOLERICALLY	CH AH L EH R AH K AE L IY
CHOLINERGICALLY	CH AA L AH N AH R JH AH K AE L IY
CHOLLA	CH AA L AH
CHOLLAS	CH AA L AH Z
CHOPFALLEN	CH AA P F AE L AH N
CHORALLY	K OW R AH L IY
CHOREOGRAPHICALLY	K OW R IY AH G R AE F IH K AH L IY
CHORIOALLANTOIC	CH AO R IY OW L AE N T OW AH K
CHORIOALLANTOIDES	CH AH R IY OW L AH N T OY D Z
CHORIOALLANTOIS	CH AO R IY OW L AE N T OW AH S
CHROMATICALLY	K R OW M AE T IH K AH L IY
CHROMATOGRAPHICALLY	K R OW M AE T AH G R AE F IH K AH L IY
CHROMOSOMALLY	K R AH M AA S AH M AE L IY
CHRONICALLY	K R AA N IH K AH L IY
CHRONICALLY(2)	K R AA N IH K L IY
CHRONOLOGICALLY	K R AA N AH L AA JH IH K L IY
CHRONOMETRICALLY	K R AA N AH M EH T R AH K AE L IY
CHUCKAWALLA	CH AH K AH AE L AH
CHUCKAWALLAS	CH AH K AH AE L AH Z
CHUCKWALLA	CH AH K W AA L AH
CHUCKWALLAS	CH AH K W AA L AH Z
CIGARILLO	S IH G AH R IH L OW
CIGARILLOS	S IH G AA R IH L AA S
CINEMATICALLY	S IH N AH M AE T IH K AH L IY
CINEMATOGRAPHICALLY	S AH N EH M AH T AA G R AE F AH K AE L IY
CIRCUMSTANTIALLY	S ER K AH M S T AE N SH AH L IY
CIRCUMSTELLAR	S ER K AH M S T EH L ER
CIRCUMVALLATE	S AH R K AH M V AE L EY T
CIRCUMVALLATED	S AH R K AH M V AE L EY T AH D
CIRCUMVALLATES	S AH R K AH M V AE L EY T S
CIRCUMVALLATING	S AH R K AH M V AE L EY T AH NG
CIRCUMVALLATION	S AH R K AH M V AE L EY SH AH N
CIRCUMVALLATIONS	S AH R K AH M V AE L EY T IY AH N Z
CITRONELLA	S IH T R AA N EH L AH
CITRONELLAL	S IH T R AH N EH L AH L
CITRONELLALS	S IH T R AH N EH L AH L Z
CITRONELLAS	S IH T R AH N EH L AH Z
CITRONELLOL	S IH T R AH N EH L AH L
CITRONELLOLS	S IH T R AH N EH L AH L Z
CITRULLINE	S IH T R AH L AY N
CITRULLINES	S IH T R AH L AY N Z
CIVICALLY	S IH V IH K AH L IY
CIVILLY	S IH V IH L IY
CLADISTICALLY	K L AE D IH S T IH K AH L IY
CLADOGENETICALLY	K L AE D AH JH AH N EH T AH K AE L IY
CLADOPHYLL	K L AE D AH F AH L
CLADOPHYLLA	K L AE D AH F IH L AH
CLADOPHYLLS	K L AE D AH F AH L Z
CLADOPHYLLUM	K L AE D AH F IH L AH M
CLAMSHELL	K L AE M SH EH L
CLAMSHELLS	K L AE M SH EH L Z
CLASSICALLY	K L AE S IH K L IY
CLAUSTROPHOBICALLY	K L AO S T R AH F AA B AH K AE L IY
CLERICALLY	K L EH R IH K AH L IY
CLIMACTICALLY	K L AY M AE K T IH K AH L IY
CLIMATICALLY	K L AY M AH T IH K AH L IY
CLIMATOLOGICALLY	K L IH M AH T AH L AA JH AH K AE L IY
CLINALLY	K L AH N AE L IY
CLINICALLY	K L IH N IH K AH L IY
CLINICALLY(2)	K L IH N IH K L IY
CLINICOPATHOLOGICALLY	K L AH N AH K AA P AH TH AH L AA JH AH K AE L IY
CLITELLA	K L AH T EH L AH
CLITELLUM	K L AH T EH L AH M
CLODPOLL	K L AA D P OW L
CLODPOLLS	K L AA D P OW L Z
CLONALLY	K L AH N AE L IY
CLOXACILLIN	K L AA K S AH S IH L AH N
CLOXACILLINS	K L AA K S AH S IH L AH N Z
COALLESS	K OW L AH S
COAXIALLY	K OW AE K S IY AH L IY
COBELLIGERENT	K OW B AH L IH JH ER AH N T
COBELLIGERENTS	K OW B AH L IH JH ER AH N T S
COCKBILL	K AA K B IH L
COCKBILLED	K AA K B IH L D
COCKBILLING	K AA K B IH L IH NG
COCKBILLS	K AA K B IH L Z
COCKLESHELL	K AA K L EH SH AH L
COCKLESHELLS	K AA K L EH SH AH L Z
COCOUNSELLED	K OW K AW N S AH L D
COCOUNSELLING	K OW K AW N S AH L IH NG
CODICILLARY	K OW D IH K S IH L EH R IY
CODSWALLOP	K AA D Z W AA L IH P
CODSWALLOPS	K AA D Z W AA L IH P S
COEDUCATIONALLY	K OW EH JH AH K EY SH AH N AH L IY
COENZYMATICALLY	K OW EH N Z AH M AE T IH K AH L IY
COEQUALLY	K OW IY K W AH L IY
COEVALLY	K OW IY V AH L IY
COINCIDENTALLY	K OW IH N S IH D EH N T AH L IY
COITALLY	K OW AH T AE L IY
COLLABORATE	K AH L AE B ER EY T
COLLABORATED	K AH L AE B ER EY T AH D
COLLABORATED(2)	K AH L AE B ER EY T IH D
COLLABORATES	K AH L AE B AH R EY T S
COLLABORATING	K AH L AE B ER EY T IH NG
COLLABORATION	K AH L AE B ER EY SH AH N
COLLABORATIONISM	K AH L AE B AH R EY SH AH N IH Z AH M
COLLABORATIONISMS	K AH L AE B AH R EY SH AH N IH Z AH M Z
COLLABORATIONIST	K AH L AE B ER EY SH AH N IH S T
COLLABORATIONISTS	K AH L AE B AH R EY SH AH N IH S T S
COLLABORATIONS	K AA L AH B ER EY SH AH N Z
COLLABORATIVE	K AH L AE B ER EY T IH V
COLLABORATIVE(2)	K AH L AE B R AH T IH V
COLLABORATIVELY	K AH L AE B AH R EY T IH V L IY
COLLABORATIVES	K AH L AE B AH R EY T IH V Z
COLLABORATOR	K AH L AE B ER EY T ER
COLLABORATORS	K AH L AE B ER EY T ER Z
COLLAGE	K AH L AA ZH
COLLAGED	K AH L AA ZH D
COLLAGEN	K AA L AH G AH N
COLLAGENASE	K AA L AE JH AH N EY Z
COLLAGENASES	K AA L AE JH AH N EY Z AH Z
COLLAGENOUS	K AA L AH JH EH N AH S
COLLAGENS	K AA L AH JH EH N Z
COLLAGES	K AH L AA ZH IH Z
COLLAGING	K AH L AA ZH IH NG
COLLAGIST	K AH L AA ZH IH S T
COLLAGISTS	K AH L AA ZH IH S T S
COLLAPSE	K AH L AE P S
COLLAPSED	K AH L AE P S T
COLLAPSES	K AH L AE P S IH Z
COLLAPSIBILITIES	K AH L AE P S AH B IH L AH T IY Z
COLLAPSIBILITY	K AH L AE P S AH B IH L AH T IY
COLLAPSIBLE	K AH L AE P S AH B AH L
COLLAPSING	K AH L AE P S IH NG
COLLAR	K AA L ER
COLLARBONE	K AA L ER B OW N
COLLARBONES	K AA L ER B OW N Z
COLLARD	K AA L ER D
COLLARDS	K AA L ER D Z
COLLARED	K AA L ER D
COLLARET	K AA L AE R AH T
COLLARETS	K AA L AE R AH T S
COLLARING	K AA L ER IH NG
COLLARLESS	K AA L ER L AH S
COLLARS	K AA L ER Z
COLLATE	K AH L EY T
COLLATED	K AH L EY T IH D
COLLATERAL	K AH L AE T ER AH L
COLLATERALITIES	K AH L EY T ER AH L AH T IY Z
COLLATERALITY	K AH L EY T ER AH L AH T IY
COLLATERALIZE	K AH L AE T ER AH L AY Z
COLLATERALIZED	K AH L AE T ER AH L AY Z D
COLLATERALIZES	K AH L EY T ER AH L AY Z IH Z
COLLATERALIZING	K AH L EY T ER AH L AY Z IH NG
COLLATERALLY	K AH L EY T ER AH L IY
COLLATERALS	K AH L EY T ER AH L Z
COLLATES	K AH L EY T S
COLLATING	K AH L EY T IH NG
COLLATION	K AH L EY SH AH N
COLLATIONS	K AH L EY SH AH N Z
COLLATOR	K AH L EY T ER
COLLATORS	K AH L EY T ER Z
COLLEAGUE	K AA L IY G
COLLEAGUES	K AA L IY G Z
COLLEAGUESHIP	K AA L IY G SH IH P
COLLEAGUESHIPS	K AA L IY G SH IH P S
COLLECT	K AH L EH K T
COLLECTABLE	K AA L IH K T AH B AH L
COLLECTABLES	K AA L IH K T AH B AH L Z
COLLECTANEA	K AA L EH K T EY N IY AH
COLLECTED	K AH L EH K T AH D
COLLECTEDLY	K AA L IH K T AH D L IY
COLLECTEDNESS	K AA L IH K T AH D N AH S
COLLECTEDNESSES	K AA L IH K T AH D N AH S IH Z
COLLECTIBLE	K AH L EH K T AH B AH L
COLLECTIBLES	K AH L EH K T AH B AH L Z
COLLECTING	K AH L EH K T IH NG
COLLECTION	K AH L EH K SH AH N
COLLECTIONS	K AH L EH K SH AH N Z
COLLECTIVE	K AH L EH K T IH V
COLLECTIVELY	K AH L EH K T IH V L IY
COLLECTIVES	K AH L EH K T IH V Z
COLLECTIVISE	K AA L EH K T AH V AY Z
COLLECTIVISED	K AA L IH K T IH V IY Z D
COLLECTIVISES	K AA L IH K T IH V IY Z IH Z
COLLECTIVISING	K AA L IH K T IH V IY Z IH NG
COLLECTIVISM	K AH L EH K T IH V IH Z AH M
COLLECTIVISMS	K AA L IH K T IH V IH Z AH M Z
COLLECTIVIST	K AH L EH K T IH V IH S T
COLLECTIVISTIC	K AA L IH K T IH V IH S T IH K
COLLECTIVISTICALLY	K AA L IH K T IH V IH S T IH K AH L IY
COLLECTIVISTS	K AA L IH K T IH V IH S T S
COLLECTIVITIES	K AA L IH K T IH V AH T IY Z
COLLECTIVITY	K AA L IH K T IH V AH T IY
COLLECTIVIZATION	K AH L EH K T IH V IH Z EY SH AH N
COLLECTIVIZATIONS	K AA L IH K T IH V AH Z EY SH AH N Z
COLLECTIVIZE	K AH L EH K T IH V AY Z
COLLECTIVIZED	K AH L EH K T IH V AY Z D
COLLECTIVIZES	K AA L IH K T IH V AY Z IH Z
COLLECTIVIZING	K AA L IH K T IH V AY Z IH NG
COLLECTOR	K AH L EH K T ER
COLLECTORS	K AH L EH K T ER Z
COLLECTORSHIP	K AA L IH K T ER SH IH P
COLLECTORSHIPS	K AA L IH K T ER SH IH P S
COLLECTS	K AH L EH K T S
COLLEEN	K AA L IY N
COLLEENS	K AA L IY N Z
COLLEGE	K AA L IH JH
COLLEGER	K AA L IH JH ER
COLLEGERS	K AA L IH JH ER Z
COLLEGES	K AA L IH JH IH Z
COLLEGIA	K AA L IY JH IY AH
COLLEGIAL	K AH L IY JH IY AH L
COLLEGIALITIES	K AA L IH JH IY AH L AH T IY Z
COLLEGIALITY	K AH L IY JH IY AE L IH T IY
COLLEGIALLY	K AA L IH JH IY AH L IY
COLLEGIAN	K AH L IY JH AH N
COLLEGIANS	K AH L IY JH AH N Z
COLLEGIATE	K AH L IY JH IH T
COLLEGIATELY	K AH L IY JH AH T L IY
COLLEGIUM	K AA L IY JH IY AH M
COLLEGIUMS	K AA L IY JH IY AH M Z
COLLEMBOLAN	K AA L EH M B AH L AH N
COLLEMBOLANS	K AA L EH M B AH L AH N Z
COLLEMBOLOUS	K AA L EH M B AH L AH S
COLLENCHYMA	K AA L EH NG K AH M AH
COLLENCHYMAS	K AA L EH NG K AH M AH Z
COLLENCHYMATA	K AA L EH NG K IH M AH T AH
COLLENCHYMATOUS	K AA L EH NG K IH M AH T AH S
COLLET	K AA L IH T
COLLETED	K AA L IY T AH D
COLLETING	K AA L IY T AH NG
COLLETS	K AA L EH T S
COLLIDE	K AH L AY D
COLLIDED	K AH L AY D IH D
COLLIDER	K AH L AY D ER
COLLIDERS	K AH L AY D ER Z
COLLIDES	K AH L AY D Z
COLLIDING	K AH L AY D IH NG
COLLIE	K AA L IY
COLLIED	K AA L IY D
COLLIER	K AA L Y ER
COLLIERIES	K AA L IY AH R IY Z
COLLIERS	K AA L Y ER Z
COLLIERY	K AA L IY AH R IY
COLLIES	K AA L IY Z
COLLIESHANGIE	K AA L IY Z HH AE NG IY
COLLIESHANGIES	K AA L IY Z HH AE NG IY Z
COLLIGATE	K AA L AH G EY T
COLLIGATED	K AA L AH G EY T AH D
COLLIGATES	K AA L AH G EY T S
COLLIGATING	K AA L AH G EY T AH NG
COLLIGATION	K AA L AH G EY SH AH N
COLLIGATIONS	K AA L AH G EY T IY AH N Z
COLLIGATIVE	K AA L AH G EY T AH V
COLLIMATE	K AA L AH M EY T
COLLIMATED	K AA L AH M EY T IH D
COLLIMATES	K AA L AH M EY T S
COLLIMATING	K AA L AH M EY T IH NG
COLLIMATION	K AA L AH M EY SH AH N
COLLIMATIONS	K AA L AH M EY SH AH N Z
COLLIMATOR	K AA L AH M EY T ER
COLLIMATORS	K AA L AH M EY T ER Z
COLLINEAR	K AA L AY N IY AH R
COLLINEARITIES	K AA L AH N IY R AH T AY Z
COLLINEARITY	K AA L AH N IY R AH T IY
COLLINS	K AA L IH N Z
COLLINSES	K AA L IH N S AH Z
COLLISION	K AH L IH ZH AH N
COLLISIONAL	K AH L IH ZH AH N AH L
COLLISIONALLY	K AH L IH ZH AH N AH L IY
COLLISIONS	K AH L IH ZH AH N Z
COLLOCATE	K AA L AH K EY T
COLLOCATED	K AA L AH K EY T AH D
COLLOCATES	K AA L AH K EY T S
COLLOCATING	K AA L AH K EY T AH NG
COLLOCATION	K AA L AH K EY SH AH N
COLLOCATIONAL	K AA L AH K AH T IY AH N AH L
COLLOCATIONS	K AA L AH K EY T IY AH N Z
COLLODION	K AH L OW D IY AH N
COLLODIONS	K AA L OW D IY AH N Z
COLLOGUE	K AA L AA G
COLLOGUED	K AA L AA G D
COLLOGUES	K AA L AA G Z
COLLOGUING	K AA L AA G AH NG
COLLOID	K AA L OY D
COLLOIDAL	K AH L OY D AH L
COLLOIDALLY	K AH L OY D AH L IY
COLLOIDS	K AA L OY D Z
COLLOP	K AA L AA P
COLLOPS	K AA L AA P S
COLLOQUIA	K AA L AA K W IY AH
COLLOQUIAL	K AH L OW K W IY AH L
COLLOQUIALISM	K AH L OW K W IY AH L IH Z AH M
COLLOQUIALISMS	K AH L OW K W IY AH L IH Z AH M Z
COLLOQUIALITIES	K AH L OW K W IY AH L AH T IY Z
COLLOQUIALITY	K AH L OW K W IY AH L AH T IY
COLLOQUIALLY	K AH L OW K W IY AH L IY
COLLOQUIALS	K AH L OW K W IY AH L Z
COLLOQUIES	K AA L AH K W IY Z
COLLOQUIST	K AA L AA K W AH S T
COLLOQUISTS	K AA L AA K W AH S T S
COLLOQUIUM	K AH L OW K W IY AH M
COLLOQUIUMS	K AH L OW K W IY AH M Z
COLLOQUY	K AA L AH K W IY
COLLOTYPE	K AA L AH T AY P
COLLOTYPES	K AA L AH T AY P S
COLLUDE	K AH L UW D
COLLUDED	K AH L UW D IH D
COLLUDER	K AA L UW D AH R
COLLUDERS	K AA L UW D AH R Z
COLLUDES	K AA L UW D Z
COLLUDING	K AH L UW D IH NG
COLLUSION	K AH L UW ZH AH N
COLLUSIONS	K AH L UW ZH AH N Z
COLLUSIVE	K AH L UW S IH V
COLLUSIVELY	K AH L UW S IH V L IY
COLLUVIA	K AA L UW V IY AH
COLLUVIAL	K AA L UW V IY AH L
COLLUVIUM	K AA L UW V IY AH M
COLLUVIUMS	K AA L UW V IY AH M Z
COLLY	K AA L IY
COLLYING	K AA L AY AH NG
COLLYRIA	K AA L IH R IY AH
COLLYRIUM	K AA L IH R IY AH M
COLLYRIUMS	K AA L IH R IY AH M Z
COLLYWOBBLES	K AA L IH W AH B AH L Z
COLONIALLY	K AH L OW N IY AH L IY
COLORFULLY	K AH L ER F L IY
COLORIMETRICALLY	K OW L AO R AH M EH T R AH K AE L IY
COLORISTICALLY	K AH L ER IH S T IH K AH L IY
COLOSSALLY	K AH L AA S AH L IY
COLUMELLA	K OW L AH M EH L AH
COLUMELLAE	K OW L AH M EH L IY
COLUMELLAR	K OW L AH M EH L AH R
COMBINATORIALLY	K AH M B AY N AH T OW R IY AH L IY
COMEDICALLY	K OW M EH D IH K AH L IY
COMICALLY	K AA M IH K AH L IY
COMICALLY(2)	K AA M IH K L IY
COMMENSALLY	K AH M EH N S AE L IY
COMMERCIALLY	K AH M ER SH AH L IY
COMMONSENSICALLY	K AA M AH N S EH N S IH K AH L IY
COMMUNALLY	K AH M Y UW N AH L IY
COMMUNISTICALLY	K AA M Y AH N IH S T IH K AH L IY
COMPELLABLE	K AH M P EH L AH B AH L
COMPELLATION	K AH M P EH L EY SH AH N
COMPELLATIONS	K AH M P EH L EY SH AH N Z
COMPELLED	K AH M P EH L D
COMPELLING	K AH M P EH L IH NG
COMPELLINGLY	K AH M P EH L IH NG L IY
COMPOSITIONALLY	K AA M P AH Z IH SH AH N AH L IY
COMPTROLLER	K AH M T R OW L ER
COMPTROLLER(2)	K AA M T R OW L ER
COMPTROLLERS	K AA M P T R OW L ER Z
COMPTROLLERSHIP	K AA M P T R OW L ER SH IH P
COMPTROLLERSHIPS	K AA M P T R OW L ER SH IH P S
COMPUTATIONALLY	K AA M P Y UH T EY SH AH N AH L IY
CONCENTRICALLY	K AH N S EH N T R IH K AH L IY
CONCEPTUALISTICALLY	K AH N S EH P CH AH W AH L IH S T IH K AH L IY
CONCEPTUALLY	K AH N S EH P CH UW AH L IY
CONCHOIDALLY	K AA N CH OY D AE L IY
CONDITIONALLY	K AH N D IH SH AH N AH L IY
CONDITIONALLY(2)	K AH N D IH SH N AH L IY
CONFESSIONALLY	K AH N F EH SH AH N AH L IY
CONFIDENTIALLY	K AA N F AH D EH N SH AH L IY
CONFIGURATIONALLY	K AH N F IH G Y ER EY SH AH N AH L IY
CONFOCALLY	K AH N F OW K AH L IY
CONGENIALLY	K AH N JH IY N Y AH L IY
CONGENITALLY	K AH N JH EH N AH T AH L IY
CONGRESSIONALLY	K AH N G R EH SH AH N AH L IY
CONGRESSIONALLY(2)	K AH N G R EH SH N AH L IY
CONICALLY	K AA N IH K AH L IY
CONJECTURALLY	K AH N JH EH K CH ER AH L IY
CONJUGALLY	K AA N JH IH G AH L IY
CONJUGATIONALLY	K AA N JH IH G EY SH AH N AH L IY
CONJUNCTIONALLY	K AH N JH AH NG K SH AH N AH L IY
CONNATURALLY	K AH N AE CH AH R AH L IY
CONNUBIALLY	K AA N Y UW B IY AE L IY
CONSENSUALLY	K AH N S EH N CH AH W AH L IY
CONSEQUENTIALLY	K AA N S AH K W EH N CH AH L IY
CONSPIRATORIALLY	K AH N S P IH R AH T AO R IY AH L IY
CONSPIRATORIALLY(2)	K AH N S P IH R AH T AO R Y AH L IY
CONSTELLATE	K AA N Z T EH L AH T
CONSTELLATED	K AA N Z T EH L EY T IH D
CONSTELLATES	K AA N Z T EH L AH T S
CONSTELLATING	K AA N Z T EH L EY T IH NG
CONSTELLATION	K AA N S T AH L EY SH AH N
CONSTELLATIONS	K AA N S T AH L EY SH AH N Z
CONSTELLATORY	K AA N Z T EH L AH T OW R IY
CONSTITUTIONALLY	K AA N S T AH T UW SH AH N AH L IY
CONSTRUCTIONALLY	K AH N S T R AH K SH AH N AH L IY
CONTEXTUALLY	K AH N T EH K S CH AH W AH L IY
CONTINENTALLY	K AA N T AH N EH N T AH L IY
CONTINENTALLY(2)	K AA N T AH N EH N AH L IY
CONTINUALLY	K AH N T IH N Y UW AH L IY
CONTINUALLY(2)	K AH N T IH N Y UW L IY
CONTRACTUALLY	K AH N T R AE K CH UW AH L IY
CONTRAPUNTALLY	K AA N T R AH P AH N T AH L IY
CONTROLLABILITIES	K AH N T R OW L AH B IH L AH T EH Z
CONTROLLABILITY	K AH N T R OW L AH B IH L AH T EH
CONTROLLABLE	K AH N T R OW L AH B AH L
CONTROLLED	K AH N T R OW L D
CONTROLLER	K AH N T R OW L ER
CONTROLLERS	K AH N T R OW L ER Z
CONTROLLERSHIP	K AH N T R OW L ER SH IH P
CONTROLLERSHIPS	K AH N T R OW L ER SH IH P S
CONTROLLING	K AH N T R OW L IH NG
CONTROVERSIALLY	K AA N T R AH V ER SH AH L IY
CONVENTIONALLY	K AH N V EH N SH AH N AH L IY
CONVENTUALLY	K AA N V EH N T Y UW AE L IY
CONVERSATIONALLY	K AA N V ER S EY SH AH N AH L IY
CONVIVIALLY	K AH N V IH V Y AH L IY
COOLLY	K UW L IY
COQUILLE	K OW K W IH L
COQUILLES	K OW K W IH L Z
CORALBELLS	K AO R AH L B EH L Z
CORALLINE	K AO R AH L AY N
CORALLINES	K AO R AH L AY N Z
CORALLOID	K OW R AE L OY D
CORBEILLE	K AA R B IY L
CORBEILLES	K AA R B IY L Z
CORBELLED	K AO R B AH L D
CORBELLING	K AA R B EH L AH NG
CORDELLE	K AA R D EH L
CORDELLED	K AA R D EH L D
CORDELLES	K AA R D EH L Z
CORDELLING	K AA R D EH L AH NG
CORDIALLY	K AO R JH AH L IY
CORDILLERA	K AO R D IH L IH R AH
CORDILLERAN	K AA R D IH L AH R AH N
CORDILLERAS	K AO R D IH L IH R AH Z
CORNBALL	K AO R N B AO L
CORNBALLS	K AO R N B AO L Z
COROLLA	K ER AA L AH
COROLLARIES	K AO R AH L EH R IY Z
COROLLARY	K AO R AH L EH R IY
COROLLAS	K OW R AA L AH Z
COROLLATE	K OW R OW L AH T
CORPORALLY	K AO R P ER AH L IY
CORPOREALLY	K AO R P OW R IY AH L IY
CORRALLED	K ER AE L D
CORRALLING	K ER AE L IH NG
CORTICALLY	K AO R T IH K AH L IY
COSMETICALLY	K AO Z M EH T IH K L IY
COSMICALLY	K AA Z M IH K AH L IY
COSMOLOGICALLY	K AA Z M AH L AA JH IH K AH L IY
COTILLION	K OW T IH L Y AH N
COTILLIONS	K OW T IH L Y AH N Z
COTILLON	K OW T IH L AO N
COTILLONS	K OW T IH L AO N Z
COULOMETRICALLY	K OW Y UW L AH M EH T R AH K AE L IY
COUNCILLOR	K AW N S AH L ER
COUNCILLORS	K AW N S AH L ER Z
COUNCILLORSHIP	K AW N S AH L ER SH IH P
COUNCILLORSHIPS	K AW N S AH L ER SH IH P S
COUNSELLED	K AW N S AH L D
COUNSELLING	K AW N S AH L IH NG
COUNSELLINGS	K AW N S AH L IH NG Z
COUNSELLOR	K AW N S AH L ER
COUNSELLORS	K AW N S AH L ER Z
COUNTERCYCLICALLY	K AW N T ER S IH K L IH K AH L IY
COUNTERGUERILLA	K AW N T ER G AH R IH L AH
COUNTERGUERILLAS	K AW N T ER G AH R IH L AH Z
COUNTERGUERRILLA	K AW N T ER G AH R IH L AH
COUNTERGUERRILLAS	K AW N T ER G AH R IH L AH Z
COUNTERINTELLIGENCE	K AW N T ER IH N T EH L IH JH AH N S
COUNTERINTELLIGENCE(2)	K AW N ER IH N T EH L IH JH AH N S
COUNTERINTELLIGENCES	K AW N T ER IH N T EH L AH JH AH N S IH Z
COUNTERRALLIED	K AW N T ER AH L IY D
COUNTERRALLIES	K AW N T ER AH L IY Z
COUNTERRALLY	K AW N T ER AH L IY
COUNTERRALLYING	K AW N T ER AH L IY IH NG
COUNTERSPELL	K AW N T ER S P EH L
COUNTERSPELLS	K AW N T ER S P EH L Z
COUNTERSURVEILLANCE	K AW N T ER S ER V EY L AH N S
COUNTERSURVEILLANCES	K AW N T ER S ER V EY L AH N S IH Z
COVELLINE	K OW V EH L AY N
COVELLINES	K OW V EH L AY N Z
COVELLITE	K OW V EH L AY T
COVELLITES	K OW V EH L AY T S
COVERALL	K AH V ER AO L
COVERALLED	K OW V EH R AH L D
COVERALLS	K AH V ER AO L Z
COWBELL	K AW B EH L
COWBELLS	K AW B EH L Z
COYOTILLO	K OW Y AH T IH L OW
COYOTILLOS	K OW Y AH T IH L AH Z
CRANESBILL	K R EY N Z B IH L
CRANESBILLS	K R EY N Z B IH L Z
CRANIALLY	K R EY N IY AH L IY
CREDENTIALLED	K R IH D EH N CH AH L D
CREDENTIALLING	K R IH D EH N CH AH L IH NG
CRENELLATED	K R EH N AH L EY T AH D
CRENELLATION	K R EH N AH L EY SH AH N
CRENELLATIONS	K R EH N AH L EY T IY AH N Z
CRENELLE	K R EH N AH L
CRENELLED	K R EH N AH L D
CRENELLES	K R EH N AH L Z
CRENELLING	K R AH N EH L AH NG
CRESTFALLEN	K R EH S T F AO L AH N
CRESTFALLENLY	K R EH S T F AE L AH N L IY
CRESTFALLENNESS	K R EH S T F AE L AH N AH S
CRESTFALLENNESSES	K R EH S T F AE L AH N AH S IH Z
CREVALLE	K R EH V AH L
CREVALLES	K R EH V AH L Z
CRIMINALLY	K R IH M AH N AH L IY
CRIMINOLOGICALLY	K R IH M AH N AH L AA JH AH K AE L IY
CRIOLLO	K R AY AA L OW
CRIOLLOS	K R AY AA L AH Z
CRITICALLY	K R IH T IH K AH L IY
CRITICALLY(2)	K R IH T IH K L IY
CROSSBILL	K R AO S B IH L
CROSSBILLS	K R AO S B IH L Z
CROSSLINGUISTICALLY	K R AO S L IH NG G W IH S T IH K AH L IY
CRUCIALLY	K R UW SH AH L IY
CRUELLER	K R UW AH L ER
CRUELLEST	K R UW AH L AH S T
CRUELLY	K R UW L IY
CRULLER	K R AH L AH R
CRULLERS	K R AH L AH R Z
CRYOGENICALLY	K R AY AH JH EH N AH K AE L IY
CRYPTICALLY	K R IH P T IH K AH L IY
CRYPTOCRYSTALLINE	K R IH P T AH K R IH S T AH L AY N
CRYPTOGRAPHICALLY	K R IH P T AH G R AE F IH K AH L IY
CRYSTALLINE	K R IH S T AH L AY N
CRYSTALLINITIES	K R IH S T AH L AH N AH T IY Z
CRYSTALLINITY	K R IH S T AH L AH N AH T IY
CRYSTALLISE	K R IH S T AH L AY Z
CRYSTALLISED	K R IH S T AH L IY Z D
CRYSTALLISES	K R IH S T AH L IY Z IH Z
CRYSTALLISING	K R IH S T AH L IY Z IH NG
CRYSTALLITE	K R IH S T AH L AY T
CRYSTALLITES	K R IH S T AH L AY T S
CRYSTALLIZABLE	K R IH S T AH L AY Z AH B AH L
CRYSTALLIZATION	K R IH S T AH L AH Z EY SH AH N
CRYSTALLIZATIONS	K R IH S T AH L AH Z EY SH AH N Z
CRYSTALLIZE	K R IH S T AH L AY Z
CRYSTALLIZED	K R IH S T AH L AY Z D
CRYSTALLIZER	K R IH S T AH L AY Z ER
CRYSTALLIZERS	K R IH S T AH L AY Z ER Z
CRYSTALLIZES	K R IH S T AH L AY Z IH Z
CRYSTALLIZING	K R IH S T AH L AY Z IH NG
CRYSTALLOGRAPHER	K R IH S T AH L AA G R AH F ER
CRYSTALLOGRAPHERS	K R IH S T AH L AA G R AH F ER Z
CRYSTALLOGRAPHIC	K R IH S T AH L OW G R AE F IH K
CRYSTALLOGRAPHICALLY	K R IH S T AH L OW G R AE F IH K AH L IY
CRYSTALLOGRAPHIES	K R IH S T AH L AA G R AH F IY Z
CRYSTALLOGRAPHY	K R IH S T AH L AA G R AH F IY
CRYSTALLOID	K R IH S T AH L OY D
CRYSTALLOIDAL	K R IH S T AH L OY D AH L
CRYSTALLOIDS	K R IH S T AH L OY D Z
CUADRILLA	K Y UW AH D R IH L AH
CUADRILLAS	K Y UW AH D R IH L AH Z
CUBICALLY	K Y UW B IH K AH L IY
CUCULLATE	K Y UW K AH L EY T
CUDGELLED	K AH JH AH L D
CUDGELLING	K AH JH AH L IH NG
CULL	K AH L
CULLAY	K AH L EY IY
CULLAYS	K AH L EY Z
CULLED	K AH L D
CULLENDER	K AH L EH N D AH R
CULLENDERS	K AH L EH N D AH R Z
CULLER	K AH L ER
CULLERS	K AH L ER Z
CULLET	K AH L AH T
CULLETS	K AH L AH T S
CULLIED	K AH L AY D
CULLIES	K AH L AY Z
CULLING	K AH L IH NG
CULLION	K AH L IY AH N
CULLIONS	K AH L IY AH N Z
CULLIS	K AH L AH S
CULLISES	K AH L AY Z AH Z
CULLS	K AH L Z
CULLY	K AH L IY
CULLYING	K AH L AY AH NG
CULTURALLY	K AH L CH ER AH L IY
CUPELLATION	K Y UW P AH L EY SH AH N
CUPELLATIONS	K Y UW P AH L EY T IY AH N Z
CUPELLED	K Y UW P AH L D
CUPELLER	K Y UW P EH L AH R
CUPELLERS	K Y UW P EH L AH R Z
CUPELLING	K Y UW P EH L AH NG
CURVEBALL	K ER V B AO L
CURVEBALLED	K ER V B AO L D
CURVEBALLING	K ER V B AO L IH NG
CURVEBALLS	K ER V B AO L Z
CYBERNETICALLY	S AH B AH R N EH T AH K AE L IY
CYCLICALLY	S IH K L IH K AH L IY
CYCLONICALLY	S IH K L AA N AH K AE L IY
CYLINDRICALLY	S AH L IH N D R IH K AH L IY
CYNICALLY	S IH N IH K AH L IY
CYNICALLY(2)	S IH N IH K L IY
CYTOGENETICALLY	S IH T AH JH AH N EH T AH K AE L IY
CYTOLOGICALLY	S IH T AH L AA JH AH K AE L IY
CYTOPLASMICALLY	S AY T AH P L AE Z AH M IH K AH L IY
CYTOSTATICALLY	S AH T AA S T AE T AH K AE L IY
CYTOTAXONOMICALLY	S AH T AH T AE K S AH N AA M AH K AE L IY
DALLES	D AO L Z
DALLIANCE	D AE L IY AH N S
DALLIANCES	D AE L AY AE N S AH Z
DALLIED	D AE L IY D
DALLIER	D AE L AY AH R
DALLIERS	D AE L IY R Z
DALLIES	D AE L AY Z
DALLY	D AE L IY
DALLYING	D AE L AY AH NG
DEADFALL	D EH D F AO L
DEADFALLS	D EH D F AO L Z
DECASYLLABIC	D AH K AH S IH L AH B AH K
DECASYLLABICS	D AH K AH S IH L AH B AH S Z
DECASYLLABLE	D AH K AH S IH L AH B AH L
DECASYLLABLES	D AH K AH S IH L AH B AH L Z
DECEITFULLY	D AH S IY T F AH L IY
DECENNIALLY	D IY S AH N IY AH L IY
DECILLION	D AH S IH L IY AH N
DECILLIONS	D AH S IH L IY AH N Z
DECIMALLY	D EH S AH M AH L IY
DECOLLATE	D IY K AH L EY T
DECOLLATED	D IY K AH L EY T IH D
DECOLLATES	D IY K AH L EY T S
DECOLLATING	D IY K AH L EY T IH NG
DECOLLATION	D IY K AH L EY SH AH N
DECOLLATIONS	D IY K AH L EY SH AH N Z
DECOLLETAGE	D EY K AA L AH T AA ZH
DECOLLETAGES	D EY K AA L AH T AA ZH IH Z
DECOLLETE	D IH K AH L IY T
DECOLLETES	D IH K AH L IY T S
DECONTROLLED	D IY K AH N T R OW L D
DECONTROLLING	D IY K AH N T R OW L IH NG
DEFERENTIALLY	D EH F AH R AH N T IY AH L IY
DEFIBRILLATE	D AH F IH B R AH L EY T
DEFIBRILLATED	D AH F IH B R AH L EY T AH D
DEFIBRILLATES	D AH F IH B R AH L EY T S
DEFIBRILLATING	D AH F IH B R AH L EY T AH NG
DEFIBRILLATION	D AH F IH B R AH L EY SH AH N
DEFIBRILLATIONS	D AH F IH B R AH L EY T IY AH N Z
DEFIBRILLATOR	D IY F IH B R IH L EY T ER
DEFIBRILLATORS	D IY F IH B R IH L EY T ER Z
DEISTICALLY	D IY IH S T AH K AE L IY
DELIGHTFULLY	D IH L AY T F AH L IY
DELL	D EH L
DELLIES	D EH L IY Z
DELLS	D EH L Z
DELLY	D EH L IY
DELPHICALLY	D IH L F AH K AE L IY
DEMAGOGICALLY	D AH M AH G AA JH AH K AE L IY
DEMOCRATICALLY	D EH M AH K R AE T IH K L IY
DEMOGRAPHICALLY	D EH M AH G R AE F IH K L IY
DEMOISELLE	D AH M OY S AH L
DEMOISELLES	D AH M OY S AH L Z
DEMONIACALLY	D IH M OW N IY AE K AH L IY
DEMONICALLY	D IY M AH N IH K AH L IY
DENDROCHRONOLOGICALLY	D IH N D R AA K R AH N AH L AA JH AH K AE L IY
DENTALLY	D EH N T AH L IY
DEPARTMENTALLY	D IH P AA R T M EH N T AH L IY
DERAILLEUR	D AH R EY L AH R
DERAILLEURS	D AH R EY L IY Y AH R Z
DESHABILLE	D AH SH AE B AH L
DESHABILLES	D AH SH AE B AH L Z
DESPITEFULLY	D IH S P AY T F AH L IY
DESPOTICALLY	D EH S P AH T IH K AH L IY
DETASSELLED	D IY T AE S AH L D
DETASSELLING	D IY T AE S AH L IH NG
DETERMINISTICALLY	D IH T ER M AH N IH S T IH K AH L IY
DETRIMENTALLY	D EH T R AH M EH N T AH L IY
DEVELOPMENTALLY	D IH V EH L AH P M EH N AH L IY
DEVELOPMENTALLY(2)	D IH V EH L AH P M EH N T AH L IY
DEVILLED	D EH V AH L D
DEVILLING	D IY V IH L IH NG
DEVOTIONALLY	D IH V OW SH AH N AH L IY
DEWFALL	D UW F AO L
DEWFALLS	D UW F AO L Z
DIABOLICALLY	D AY AH B AA L IH K AH L IY
DIACHRONICALLY	D AY AH K R AA N IH K AH L IY
DIAGENETICALLY	D AY IH JH N EH T IH K AH L IY
DIAGNOSTICALLY	D AY IH G N AA S T IH K AH L IY
DIAGONALLY	D AY AE G AH N AH L IY
DIAGRAMMATICALLY	D AY AH G R AE M AH T IH K AH L IY
DIALECTALLY	D AY AH L EH K T AH L IY
DIALECTICALLY	D AY AH L EH K T IH K AH L IY
DIALECTOLOGICALLY	D AY AH L EH K T AH L AA JH AH K AE L IY
DIALLAGE	D AY AH L IH JH
DIALLAGES	D AY AH L IH JH IH Z
DIALLED	D AY AH L D
DIALLEL	D AY AE L AH L
DIALLER	D AY AH L ER
DIALLERS	D AY AH L ER Z
DIALLING	D AY AH L IH NG
DIALLINGS	D AY AH L IH NG Z
DIALLIST	D AY AH L IH S T
DIALLISTS	D AY AH L IH S T S
DIALOGICALLY	D AY AH L AA JH AH K AE L IY
DIAMETRICALLY	D AY AH M EH T R IH K AH L IY
DIAMETRICALLY(2)	D AY AH M EH T R IH K L IY
DIAPHRAGMATICALLY	D AY AH F R AE M AH T IH K AH L IY
DIASTROPHICALLY	D AY AE S T R AA F AH K AE L IY
DIATONICALLY	D AY AH T AA N AH K AE L IY
DICHOTICALLY	D AH CH AA T AH K AE L IY
DICTATORIALLY	D IH K T AH T OW R IY AH L IY
DICTIONALLY	D IH K SH AH N AH L IY
DIDACTICALLY	D IH D AE K T IH K AH L IY
DIETETICALLY	D AY AH T EH T IH K AH L IY
DIFFERENTIALLY	D IH F AH R EH N CH AH L IY
DIGITALLY	D IH JH AH T AH L IY
DIGRAPHICALLY	D IH G R AE F AH K AE L IY
DILL	D IH L
DILLED	D IH L D
DILLIES	D IH L IY Z
DILLS	D IH L Z
DILLY	D IH L IY
DILLYDALLIED	D IH L AH D AE L AY D
DILLYDALLIES	D IH L AH D AE L AY Z
DILLYDALLY	D IH L IY D AE L IY
DILLYDALLYING	D IH L AH D AE L AY AH NG
DIMENSIONALLY	D AH M EH N CH AH N AH L IY
DINOFLAGELLATE	D AH N AA F L AE JH AH L EY T
DINOFLAGELLATES	D AH N AA F L AE JH AH L EY T S
DIPLOMATICALLY	D IH P L AH M AE T IH K L IY
DIREFULLY	D AY ER F AH L IY
DISALLOW	D IH S AH L AW
DISALLOWANCE	D IH S AH L AW AH N S
DISALLOWANCES	D IH S AH L AW AH N S IH Z
DISALLOWED	D IH S AH L AW D
DISALLOWING	D IH S AH L AW IH NG
DISALLOWS	D IH S AH L AW Z
DISANNULLED	D AH S AE N AH L D
DISANNULLING	D AH S AE N AH L AH NG
DISBOWELLED	D IH S B AW AH L D
DISBOWELLING	D IH S B AW AH L IH NG
DISDAINFULLY	D IH S D EY N F AH L IY
DISEMBOWELLED	D IH S IH M B AW AH L D
DISEMBOWELLING	D IH S IH M B AW AH L IH NG
DISENTHRALL	D IH S AH N TH R AE L
DISENTHRALLED	D IH S IH N TH R AO L D
DISENTHRALLING	D IH S IH N TH R AO L IH NG
DISENTHRALLS	D IH S AH N TH R AE L Z
DISGRACEFULLY	D IH S G R EY S F AH L IY
DISGUSTFULLY	D IH S G AH S T F AH L IY
DISHABILLE	D IH S AE B AH L
DISHABILLES	D IH S AE B AH L Z
DISHEVELLED	D IH SH EH V AH L D
DISHEVELLING	D IH SH EH V AH L IH NG
DISILLUSION	D IH S IH L UW ZH AH N
DISILLUSIONED	D IH S IH L UW ZH AH N D
DISILLUSIONING	D IH S IH L UW ZH AH N IH NG
DISILLUSIONMENT	D IH S IH L UW ZH AH N M AH N T
DISILLUSIONMENTS	D IH S IH L UW ZH AH N M AH N T S
DISILLUSIONS	D IH S IH L UW ZH AH N Z
DISLOYALLY	D IH S L OY AH L IY
DISMALLY	D IH Z M AH L IY
DISPELLED	D IH S P EH L D
DISPELLING	D IH S P EH L IH NG
DISRESPECTFULLY	D IH S R IH S P EH K T F AH L IY
DISSYLLABLE	D IH S IH L AH B AH L
DISSYLLABLES	D IH S IH L AH B AH L Z
DISTALLY	D IH S T AH L IY
DISTASTEFULLY	D IH S T EY S T F AH L IY
DISTILL	D IH S T IH L
DISTILLATE	D IH S T AH L EY T
DISTILLATE(2)	D IH S T AH L AH T
DISTILLATES	D IH S T AH L EY T S
DISTILLATION	D IH S T AH L EY SH AH N
DISTILLATIONS	D IH S T IH L EY SH AH N Z
DISTILLED	D IH S T IH L D
DISTILLER	D IH S T IH L ER
DISTILLERIES	D IH S T IH L ER IY Z
DISTILLERS	D IH S T IH L ER Z
DISTILLERY	D IH S T IH L ER IY
DISTILLING	D IH S T IH L IH NG
DISTILLS	D IH S T IH L Z
DISTRESSFULLY	D IH S T R EH S F AH L IY
DISTRUSTFULLY	D IH S T R AH S T F AH L IY
DISYLLABIC	D IH S Y L AE B AH K
DISYLLABLE	D IH S Y L AH B AH L
DISYLLABLES	D IH S Y L AH B AH L Z
DITHYRAMBICALLY	D IH TH AH R AE M B AH K AE L IY
DIURETICALLY	D AY AH R EH T AH K AE L IY
DIURNALLY	D AY ER N AH L IY
DJELLABA	JH EH L AH B AH
DJELLABAH	JH EH L AH B AH
DJELLABAHS	JH EH L AH B AH Z
DJELLABAS	JH EH L AH B AH Z
DOCTRINALLY	D AA K T R AH N AH L IY
DODECAPHONICALLY	D UW D IY K AE P HH OW N IH K AH L IY
DODGEBALL	D AA JH B AO L
DODGEBALLS	D AA JH B AO L Z
DOGMATICALLY	D AA G M AE T IH K L IY
DOLEFULLER	D OW L F AH L ER
DOLEFULLEST	D OW L F AH L AH S T
DOLEFULLY	D OW L F AH L IY
DOLL	D AA L
DOLLAR	D AA L ER
DOLLAR(2)	D AO L ER
DOLLARS	D AA L ER Z
DOLLARS(2)	D AO L ER Z
DOLLED	D AA L D
DOLLHOUSE	D AA L HH AW S
DOLLHOUSES	D AA L HH AW S IH Z
DOLLIED	D AA L IY D
DOLLIES	D AA L IY Z
DOLLING	D AA L IH NG
DOLLISH	D AA L IH SH
DOLLISHLY	D AA L IH SH L IY
DOLLISHNESS	D AA L IH SH N AH S
DOLLISHNESSES	D AA L IH SH N AH S IH Z
DOLLOP	D AA L AH P
DOLLOPED	D AA L OW P T
DOLLOPING	D AA L OW P AH NG
DOLLOPS	D AA L AH P S
DOLLS	D AA L Z
DOLLY	D AA L IY
DOLLYING	D AA L IY IH NG
DOMESTICALLY	D AH M EH S T IH K L IY
DOOMFULLY	D UW M F AH L IY
DOORBELL	D AO R B EH L
DOORBELLS	D OW R B EH L Z
DOORSILL	D AO R S IH L
DOORSILLS	D OW R S IH L Z
DORSALLY	D AO R S AH L IY
DORSIVENTRALLY	D AO R S AH V EH N T R AE L IY
DORSOVENTRALLY	D AO R S AH V EH N T R AE L IY
DOUBTFULLY	D AW T F AH L IY
DOWELLED	D AW AH L D
DOWELLING	D AW AH L IH NG
DOWNFALL	D AW N F AO L
DOWNFALLEN	D AW N F AE L AH N
DOWNFALLS	D AW N F AO L Z
DOWNHILL	D AW N HH IH L
DOWNHILLER	D AW N HH IH L ER
DOWNHILLERS	D AW N HH IH L ER Z
DOWNHILLS	D AW N HH IH L Z
DRAMATICALLY	D R AH M AE T IH K L IY
DRAMATICALLY(2)	D R AH M AE T IH K AH L IY
DRAMATURGICALLY	D R AE M AH T AH R JH AH K AE L IY
DRASTICALLY	D R AE S T IH K L IY
DREADFULLY	D R EH D F AH L IY
DREAMFULLY	D R IY M F AH L IY
DRILL	D R IH L
DRILLABILITIES	D R IH L AH B IH L AH T EH Z
DRILLABILITY	D R IH L AH B IH L AH T EH
DRILLABLE	D R IH L AH B AH L
DRILLED	D R IH L D
DRILLER	D R IH L ER
DRILLERS	D R IH L ER Z
DRILLING	D R IH L IH NG
DRILLINGS	D R IH L IH NG Z
DRILLMASTER	D R IH L M AE S T ER
DRILLMASTERS	D R IH L M AE S T ER Z
DRILLS	D R IH L Z
DRIVELLED	D R IH V AH L D
DRIVELLING	D R AH V EH L AH NG
DROLL	D R OW L
DROLLED	D R AA L D
DROLLER	D R AA L AH R
DROLLERIES	D R AA L AH R AY Z
DROLLERY	D R AA L AH R IY
DROLLEST	D R AA L AH S T
DROLLING	D R AA L AH NG
DROLLNESS	D R AA L N AH S
DROLLNESSES	D R AA L N EH S AH Z
DROLLS	D R AA L Z
DROLLY	D R AA L IY
DRUMROLL	D R AH M R OW L
DRUMROLLS	D R AH M R OW L Z
DRYWALL	D R AY W AA L
DRYWALLS	D R AY W AO L Z
DUALISTICALLY	D UW AH L IH S T IH K AH L IY
DUALLY	D UW AH L IY
DUCALLY	D Y UW K AE L IY
DUCKBILL	D AH K B IH L
DUCKBILLS	D AH K B IH L Z
DUELLED	D UW AH L D
DUELLER	D UW AH L ER
DUELLERS	D UW AH L ER Z
DUELLI	D Y UW EH L IY
DUELLING	D UW AH L IH NG
DUELLIST	D UW AH L IH S T
DUELLISTS	D UW AH L IH S T S
DUELLO	D Y UW EH L OW
DUELLOS	D Y UW EH L AH Z
DULL	D AH L
DULLARD	D AH L AH R D
DULLARDS	D AH L AH R D Z
DULLED	D AH L D
DULLER	D AH L ER
DULLEST	D AH L AH S T
DULLING	D AH L IH NG
DULLISH	D AH L IH SH
DULLISHLY	D AH L IH SH L IY
DULLNESS	D AH L N AH S
DULLNESSES	D AH L N AH S IH Z
DULLS	D AH L Z
DULLSVILLE	D AH L S V AH L
DULLSVILLES	D AH L S V AH L Z
DULLY	D AH L IY
DUMBBELL	D AH M B EH L
DUMBBELLS	D AH M B EH L Z
DUNGHILL	D AH NG HH IH L
DUNGHILLS	D AH NG HH IH L Z
DUODECILLION	D Y UW AA D AH S IH L IY AH N
DUODECILLIONS	D Y UW AH D AH S IH L IY AH N Z
DUTIFULLY	D UW T IY F AH L IY
DUXELLES	D AH K S AH L Z
DWELL	D W EH L
DWELLED	D W EH L D
DWELLER	D W EH L ER
DWELLERS	D W EH L ER Z
DWELLING	D W EH L IH NG
DWELLINGS	D W EH L IH NG Z
DWELLS	D W EH L Z
DYADICALLY	D AY EY D IH K AH L IY
DYNAMICALLY	D AY N AE M IH K AH L IY
DYNASTICALLY	D AY N AE S T IH K AH L IY
DYSLOGISTICALLY	D IH Z L AH JH IH S T AH K AE L IY
DYSPEPTICALLY	D IH S P EH P T IH K AH L IY
EASEFULLY	IY Z F AH L IY
EBULLIENCE	IH B UH L Y AH N S
EBULLIENCES	IH B UH L Y AH N S IH Z
EBULLIENCIES	IH B UH L Y AH N S IY Z
EBULLIENCY	IH B UH L Y AH N S IY
EBULLIENT	IH B AH L Y AH N T
EBULLIENTLY	IH B UH L Y AH N T L IY
EBULLITION	EH B AH L IH SH AH N
EBULLITIONS	EH B AH L IH T IY AH N Z
ECCENTRICALLY	IH K S EH N T R IH K AH L IY
ECCLESIASTICALLY	IH K L IY Z IY AE S T IH K AH L IY
ECHELLE	EH CH AH L
ECHELLES	EH CH AH L Z
ECLECTICALLY	EH K L EH K T IH K AH L IY
ECOLOGICALLY	IY K AH L AA JH IH K L IY
ECOLOGICALLY(2)	EH K AH L AA JH IH K L IY
ECONOMETRICALLY	EH K AH N AH M EH T R AH K AE L IY
ECONOMICALLY	EH K AH N AA M IH K L IY
ECONOMICALLY(2)	IY K AH N AA M IH K L IY
ECSTATICALLY	EH K S T AE T IH K L IY
ECTOPICALLY	EH K T AA P AH K AE L IY
ECUMENICALLY	EH K Y AH M EH N IH K AH L IY
EDAPHICALLY	AH D AE F AH K AE L IY
EDITORIALLY	EH D AH T AO R IY AH L IY
EDUCATIONALLY	EH JH AH K EY SH AH N AH L IY
EDUCATIONALLY(2)	EH JH AH K EY SH N AH L IY
EDUCATIONALLY(3)	EH JH Y UW K EY SH AH N AH L IY
EDUCATIONALLY(4)	EH JH Y UW K EY SH N AH L IY
EELLIKE	IY L L AY K
EFFECTUALLY	IH F EH K CH AH W AH L IY
EFFORTFULLY	EH F ER T F AH L IY
EGGSHELL	EH G SH EH L
EGGSHELLS	EH G SH EH L Z
EGOCENTRICALLY	IY G OW S EH N T R IH K AH L IY
EGOISTICALLY	IY G OW IH S T IH K AH L IY
EGOMANIACALLY	IY G OW M AH N AY AH K AH L IY
EGOTISTICALLY	IY G AH T AH S T IH K AH L IY
EIDETICALLY	AY D EH T IH K AH L IY
EIGHTBALL	EY T B AO L
EIGHTBALLS	EY T B AO L Z
ELASTICALLY	IH L AE S T IH K AH L IY
ELECTORALLY	IH L EH K T ER AH L IY
ELECTRICALLY	IH L EH K T R IH K AH L IY
ELECTRICALLY(2)	IH L EH K T R IH K L IY
ELECTROCARDIOGRAPHICALLY	IH L EH K T R OW K AA R D IY AH G R AE F IH K AH L IY
ELECTROCHEMICALLY	AH L EH K T R AH K EH M AH K AE L IY
ELECTROENCEPHALOGRAPHICALLY	AH L AH K T R OW AH N S EH F AH L AA G R AE F AH K AE L IY
ELECTROLYTICALLY	AH L EH K T R AH L IH T AH K AE L IY
ELECTROMAGNETICALLY	IH L EH K T R OW M AE G N AH T IH K AH L IY
ELECTROMECHANICALLY	AH L EH K T R AH M AH CH AE N AH K AE L IY
ELECTROMETALLURGIES	AH L AH K T R AA M AH T AE L AH R JH AY Z
ELECTROMETALLURGY	AH L EH K T R AA M AH T AE L AH R JH IY
ELECTROMYOGRAPHICALLY	AH L AH K T R AA M AY AA G R AE F AH K AE L IY
ELECTRONICALLY	IH L EH K T R AA N IH K AH L IY
ELECTROPHORETICALLY	AH L EH K T R AH F AH R EH T AH K AE L IY
ELECTROPHYSIOLOGICALLY	AH L AH K T R AH F IH S IY AH L AA JH AH K AE L IY
ELECTROSTATICALLY	IH L EH K T R AH S T AE T IH K AH L IY
ELECTROTHERMALLY	AH L EH K T R AH TH AH R M AE L IY
ELECTROTONICALLY	IH L EH K T R AA T AO N IH K AH L IY
ELEGIACALLY	EH L AH JH AY AH K AH L IY
ELEMENTALLY	EH L AH M EH N T AH L IY
ELL	EH L
ELLIPSE	IH L IH P S
ELLIPSES	IH L IH P S IH Z
ELLIPSIS	IH L IH P S AH S
ELLIPSOID	IH L IH P S OY D
ELLIPSOIDAL	IH L IH P S OY D AH L
ELLIPSOIDS	IH L IH P S OY D Z
ELLIPTIC	IH L IH P T IH K
ELLIPTICAL	IH L IH P T IH K AH L
ELLIPTICALLY	IH L IH P T IH K AH L IY
ELLIPTICALS	IH L IH P T IH K AH L Z
ELLIPTICITIES	IH L IH P T IH K AH T IY Z
ELLIPTICITY	IH L IH P T IH K AH T IY
ELLS	EH L Z
EMBELLISH	IH M B EH L IH SH
EMBELLISHED	EH M B EH L IH SH T
EMBELLISHER	IH M B EH L IH SH ER
EMBELLISHERS	IH M B EH L IH SH ER Z
EMBELLISHES	EH M B EH L IH SH AH Z
EMBELLISHING	EH M B EH L IH SH IH NG
EMBELLISHMENT	EH M B EH L IH SH M AH N T
EMBELLISHMENTS	IH M B EH L IH SH M AH N T S
EMBLEMATICALLY	EH M B L AH M AE T IH K AH L IY
EMBOWELLED	IH M B AW AH L D
EMBOWELLING	IH M B AW AH L IH NG
EMBRYOLOGICALLY	EH M B R IY OW L AA JH IH K AH L IY
EMBRYONICALLY	EH M B R IY AA N IH K AH L IY
EMETICALLY	AH M EH T AH K AE L IY
EMOLLIENT	AH M AA L IY AH N T
EMOLLIENTS	AH M AA L IY N T S
EMOTIONALLY	IH M OW SH N AH L IY
EMOTIONALLY(2)	IY M OW SH N AH L IY
EMPANELLED	IH M P AE N AH L D
EMPANELLING	IH M P AE N AH L IH NG
EMPATHETICALLY	IH M P AH TH EH T IH K AH L IY
EMPATHICALLY	IH M P AE TH IH K AH L IY
EMPHATICALLY	EH M F AE T IH K AH L IY
EMPIRICALLY	EH M P IH R IH K AH L IY
EMPIRICALLY(2)	EH M P IH R IH K L IY
ENAMELLED	IH N AE M AH L D
ENAMELLING	IH N AE M AH L IH NG
ENCYCLOPEDICALLY	IH N S AY K L AH P IY D IH K AH L IY
ENDEMICALLY	EH N D IY M AY S AH L IY
ENDODONTICALLY	IH N D AH D AA N T AH K AE L IY
ENDOSCOPICALLY	EH N D UW S K OW P IH K AH L IY
ENDOSTEALLY	EH N D UW S T IY L IY
ENERGETICALLY	EH N ER JH EH T IH K L IY
ENHARMONICALLY	EH N HH AA R M AA N IH K AH L IY
ENIGMATICALLY	EH N IH G M AE T IH K AH L IY
ENROLL	EH N R OW L
ENROLL(2)	IH N R OW L
ENROLLED	EH N R OW L D
ENROLLEE	EH N R OW L IY
ENROLLEES	EH N R OW L IY Z
ENROLLER	EH N R OW L ER
ENROLLERS	EH N R OW L ER Z
ENROLLING	EH N R OW L IH NG
ENROLLMENT	EH N R OW L M AH N T
ENROLLMENTS	EH N R OW L M AH N T S
ENROLLS	EH N R OW L Z
ENSCROLL	IH N S R AO L
ENSCROLLED	IH N S R AA L D
ENSCROLLING	IH N S R AA L AH NG
ENSCROLLS	IH N S R AA L Z
ENSORCELL	EH N Z ER S EH L
ENSORCELLED	EH N Z ER S EH L D
ENSORCELLING	EH N Z ER S EH L IH NG
ENSORCELLMENT	EH N Z ER S EH L M AH N T
ENSORCELLMENTS	EH N Z ER S EH L M AH N T S
ENSORCELLS	EH N Z ER S EH L Z
ENTELLUS	IH N T EH L AH S
ENTELLUSES	EH N T EH L Y UW S IH Z
ENTERALLY	EH N T ER AH L IY
ENTHRALL	IH N TH R AE L
ENTHRALLED	EH N TH R AO L D
ENTHRALLING	IH N TH R AO L IH NG
ENTHRALLMENT	IH N TH R AE L M AH N T
ENTHRALLMENTS	IH N TH R AE L M AH N T S
ENTHRALLS	IH N TH R AE L Z
ENTHUSIASTICALLY	IH N TH UW Z IY AE S T IH K L IY
ENTOMOLOGICALLY	IH N T AH M AH L AA JH AH K AE L IY
ENTREPRENEURIALLY	AA N T R AH P R AH N ER IY AH L IY
ENTROPICALLY	EH N T R AA P IH K AH L IY
ENVIRONMENTALLY	IH N V AY R AH N M EH N T AH L IY
ENVIRONMENTALLY(2)	IH N V AY R AH N M EH N AH L IY
ENZYMATICALLY	EH N Z AH M AE T IH K AH L IY
ENZYMICALLY	EH N Z AY M IH K AH L IY
EPEIROGENICALLY	IY P AH R AH JH EH N AH K AE L IY
EPEXEGETICALLY	AH P EH K S AH JH EH T AH K AE L IY
EPHEMERALLY	IH F EH M AH R AH L IY
EPICALLY	EH P IH K AH L IY
EPIDEMICALLY	EH P AH D EH M IH K AH L IY
EPIDEMIOLOGICALLY	EH P AH D IY M IY AH L AA JH IH K L IY
EPIGENETICALLY	EH P AH JH AH N EH T IH K AH L IY
EPIGRAMMATICALLY	EH P IH G R AH M AE T IH K AH L IY
EPIGRAPHICALLY	EH P AH G R AE F IH K AH L IY
EPILEPTICALLY	EH P AH L EH P T IH K AH L IY
EPIPHENOMENALLY	EH P AH F AH N AA M AH N AE L IY
EPIPHYTICALLY	EH P AH F IH T AH K AE L IY
EPISCOPALLY	IH P IH S K AH P AH L IY
EPISODICALLY	EH P AH S OW D IH K AH L IY
EPISOMALLY	AH P IH S AH M AE L IY
EPISTEMICALLY	AH P IH S T EH M AH K AE L IY
EPISTEMOLOGICALLY	AH P IH S T AH M AH L AA JH AH K AE L IY
EPITAXIALLY	EH P AH T AE K S IY AE L IY
EPOCHALLY	EH P AH K AH L IY
EQUALLED	IY K W AH L D
EQUALLING	IY K W AH L IH NG
EQUALLY	IY K W AH L IY
EQUATIONALLY	IH K W EY SH AH N AH L IY
EQUIPOLLENCE	EH K W AH P AA L AH N S
EQUIPOLLENCES	EH K W AH P AA L EH N S AH Z
EQUIPOLLENT	EH K W AH P AA L AH N T
EQUIPOLLENTLY	EH K W AH P AA L EH N T L IY
EQUIPOLLENTS	EH K W AH P AA L AH N T S
EQUIVOCALLY	IH K W IH V AH K AH L IY
ERGONOMICALLY	ER G AH N AA M IH K L IY
ERISTICALLY	AH R IH S T AH K AE L IY
EROSIONALLY	IH R OW ZH AH N AH L IY
EROTICALLY	IH R AA T IH K AH L IY
ERRATICALLY	EH R AE T IH K L IY
ESCADRILLE	EH S K AH D R IH L
ESCADRILLES	EH S K AH D R IH L Z
ESCALLOP	EH S AE L AH P
ESCALLOPED	EH S AH L OW P T
ESCALLOPING	EH S AH L OW P AH NG
ESCALLOPS	EH S AE L AH P S
ESCHATOLOGICALLY	EH S AH T AH L AA JH AH K AE L IY
ESOTERICALLY	EH S AH T EH R IH K AH L IY
ESPADRILLE	EH S AE D R AH L
ESPADRILLES	EH S AE D R AH L Z
ESPECIALLY	AH S P EH SH L IY
ESPECIALLY(2)	AH S P EH SH AH L IY
ESSENTIALLY	EH S EH N SH AH L IY
ESSENTIALLY(2)	IY S EH N SH AH L IY
ESTROGENICALLY	EH S T R AH JH EH N AH K AE L IY
ETERNALLY	IH T ER N AH L IY
ETERNALLY(2)	IY T ER N AH L IY
ETHEREALLY	IH TH IH R IY AH L IY
ETHICALLY	EH TH IH K AH L IY
ETHNICALLY	EH TH N IH K L IY
ETHNOGRAPHICALLY	EH TH N AA G R AE F AH K AE L IY
ETIOLOGICALLY	IY T IY AH L AA JH AH K AE L IY
ETYMOLOGICALLY	EH T AH M AH L AA JH IH K AH L IY
EUDIOMETRICALLY	Y UW D IY AH M EH T R AH K AE L IY
EUGENICALLY	Y UH JH EH N IH K AH L IY
EULOGISTICALLY	Y UW L AH JH IH S T AH K AE L IY
EUPHEMISTICALLY	Y UW F AH M IH S T IH K L IY
EUPHONICALLY	Y UW F AA N AH K AE L IY
EUPHORICALLY	Y UH F AO R IH K AH L IY
EUPHUISTICALLY	Y UW F UW S T AH K AE L IY
EVANGELICALLY	IY V AE N JH EH L IH K AH L IY
EVANGELISTICALLY	IH V AE N JH AH L IH S T IH K AH L IY
EVENFALL	IY V AH N F AO L
EVENFALLS	IY V AH N F AO L Z
EVENTFULLY	IH V EH N T F AH L IY
EVENTUALLY	IH V EH N CH AH W AH L IY
EVENTUALLY(2)	IH V EH N SH AH L IY
EVENTUALLY(3)	IY V EH N CH AH W AH L IY
EVENTUALLY(4)	IY V EH N SH AH L IY
EVIDENTIALLY	EH V AH D EH N CH AH L IY
EVILLER	IY V AH L ER
EVILLEST	IY V AH L AH S T
EVILLY	IY V AH L IY
EXCELLED	IH K S EH L D
EXCELLENCE	EH K S AH L AH N S
EXCELLENCES	EH K S AH L AH N S IH Z
EXCELLENCIES	EH K S L EH N S IY Z
EXCELLENCY	EH K S L EH N S IY
EXCELLENT	EH K S AH L AH N T
EXCELLENTLY	EH K S AH L AH N T L IY
EXCELLING	EH K S EH L IH NG
EXCEPTIONALLY	IH K S EH P SH AH N AH L IY
EXCEPTIONALLY(2)	IH K S EH P SH N AH L IY
EXHIBITIONISTICALLY	EH K S AH B IH SH AH N IH S T IH K AH L IY
EXISTENTIALISTICALLY	EH G Z IH S T EH N CH AH L IH S T IH K AH L IY
EXISTENTIALLY	EH G Z IH S T EH N CH AH L IY
EXOTERICALLY	IH G Z AH T EH R AH K AE L IY
EXOTHERMALLY	EH K S AH DH ER M AE L IY IY
EXOTHERMICALLY	EH K S OW TH ER M IH K AH L IY
EXOTICALLY	IH G Z AA T IH K AH L IY
EXPELLABLE	IH K S P EH L AH B AH L
EXPELLED	IH K S P EH L D
EXPELLEE	IH K S P EH L IY
EXPELLEES	IH K S P EH L IY Z
EXPELLER	IH K S P EH L ER
EXPELLERS	IH K S P EH L ER Z
EXPELLING	IH K S P EH L IH NG
EXPERIENTIALLY	IH K S P IH R IY EH N CH AH L IY
EXPERIMENTALLY	IH K S P EH R AH M EH N T AH L IY
EXPONENTIALLY	EH K S P OW N EH N SH AH L IY
EXPRESSIONISTICALLY	IH K S P R EH SH AH N IH S T IH K AH L IY
EXTEMPORALLY	EH K S T EH M P AH R AH L IY
EXTENSIONALLY	IH K S T EH N CH AH N AH L IY
EXTERNALLY	IH K S T ER N AH L IY
EXTOLL	EH K S T OW L
EXTOLLED	IH K S T OW L D
EXTOLLER	EH K S T OW L ER
EXTOLLERS	EH K S T OW L ER Z
EXTOLLING	IH K S T OW L IH NG
EXTOLLS	EH K S T OW L Z
EXTRACELLULAR	EH K S T R AH S EH L Y AH L ER
EXTRACELLULARLY	EH K S T R AH S EH L Y AH L ER L IY
EXTRACORPOREALLY	EH K S T R AH K AO R P OW R IY AH L IY
EXTRAJUDICIALLY	EH K S T R AH JH UH D IH SH AH L IY
EXTRALEGALLY	EH K S T R AH L IY G AH L IY
EXTRALINGUISTICALLY	EH K S T R AH L IH NG G W IH S T IH K AH L IY
EXTRAMURALLY	EH K S T R AE M Y ER AH L IY
EXTRINSICALLY	IH K S T R IH N S AH K AE L IY
EYEBALL	AY B AO L
EYEBALLED	AY B AO L D
EYEBALLING	AY B AO L IH NG
EYEBALLS	AY B AO L Z
FACIALLY	F EY SH AH L IY
FACTIONALLY	F AE K SH AH N AH L IY
FACTUALLY	F AE K CH UW AH L IY
FAILLE	F EY L
FAILLES	F EY L Z
FAITHFULLY	F EY TH F AH L IY
FALL	F AO L
FALL(2)	F AA L
FALLACIES	F AE L AH S IY Z
FALLACIOUS	F AH L EY SH AH S
FALLACIOUSLY	F AH L EY SH AH S L IY
FALLACIOUSNESS	F AH L EY SH AH S N AH S
FALLACIOUSNESSES	F AH L EY SH AH S N AH S IH Z
FALLACY	F AE L AH S IY
FALLAL	F AE L AH L
FALLALERIES	F AE L AH L AH R IY Z
FALLALERY	F AE L AH L AH R IY
FALLALS	F AE L AH L Z
FALLAWAY	F AO L AH W EY
FALLAWAYS	F AO L AH W EY Z
FALLBACK	F AO L B AE K
FALLBACKS	F AO L B AE K S
FALLEN	F AA L AH N
FALLER	F AO L ER
FALLERS	F AE L ER Z
FALLFISH	F AO L F IH SH
FALLFISHES	F AO L F IH SH IH Z
FALLIBILITIES	F AE L AH B IH L AH T IY Z
FALLIBILITY	F AE L IH B IH L IH T IY
FALLIBLE	F AE L AH B AH L
FALLIBLY	F AE L AH B L IY
FALLING	F AA L IH NG
FALLOFF	F AO L AO F
FALLOFFS	F AO L AO F S
FALLOUT	F AO L AW T
FALLOUTS	F AO L AW T S
FALLOW	F AE L OW
FALLOWED	F AE L OW D
FALLOWING	F AE L OW IH NG
FALLOWNESS	F AE L OW N AH S
FALLOWNESSES	F AE L OW N AH S IH Z
FALLOWS	F AE L OW Z
FALLS	F AO L Z
FANATICALLY	F AH N AE T IH K AH L IY
FANATICALLY(2)	F AH N AE T IH K L IY
FANCIFULLY	F AE N S IY F AH L IY
FANTASTICALLY	F AE N T AE S T IH K L IY
FARCICALLY	F AA R S IH K AH L IY
FAREWELL	F EH R W EH L
FAREWELLED	F AE ER W EH L D
FAREWELLING	F AE ER W EH L IH NG
FAREWELLS	F EH R W EH L Z
FARFALLE	F AA R F AH L
FARFALLES	F AA R F AH L Z
FASCISTICALLY	F AE SH AH S T IH K AH L IY
FASTBALL	F AE S T B AO L
FASTBALLER	F AE S T B AO L ER
FASTBALLERS	F AE S T B AO L ER Z
FASTBALLS	F AE S T B AO L Z
FATALISTICALLY	F EY T AH L IH S T IH K AH L IY
FATALLY	F EY T AH L IY
FATEFULLY	F EY T F AH L IY
FAUNALLY	F AH N AE L IY
FAUNISTICALLY	F AH N IH S T AH K AE L IY
FAVELLA	F AH V EH L AH
FAVELLAS	F AH V EH L AH Z
FEARFULLER	F IH ER F AH L ER
FEARFULLEST	F IH ER F AH L AH S T
FEARFULLY	F IH ER F AH L IY
FEDERALLY	F EH D ER AH L IY
FEDERALLY(2)	F EH D R AH L IY
FELL	F EH L
FELLA	F EH L AH
FELLABLE	F EH L AH B AH L
FELLAH	F EH L AH
FELLAHEEN	F EH L AE HH IY AH N
FELLAHIN	F EH L AH HH AH N
FELLAHS	F EH L AH Z
FELLAS	F EH L AH S
FELLATE	F EH L AH T
FELLATED	F EH L EY T IH D
FELLATES	F EH L AH T S
FELLATING	F EH L EY T IH NG
FELLATIO	F AH L EY SH IY OW
FELLATION	F EH L EY SH AH N
FELLATIONS	F EH L EY SH AH N Z
FELLATIOS	F EH L EY T IY AH Z
FELLATOR	F EH L AH T ER
FELLATORS	F EH L AH T ER Z
FELLED	F EH L D
FELLER	F EH L ER
FELLERS	F EH L ER Z
FELLEST	F EH L AH S T
FELLIES	F EH L IY Z
FELLING	F EH L IH NG
FELLMONGER	F EH L M AH NG G ER
FELLMONGERED	F EH L M AH NG G ER D
FELLMONGERIES	F EH L M AH NG G ER IY Z
FELLMONGERING	F EH L M AH NG G ER IH NG
FELLMONGERINGS	F EH L M AH NG G ER IH NG Z
FELLMONGERS	F EH L M AH NG G ER Z
FELLMONGERY	F EH L M AH NG G ER IY
FELLNESS	F EH L N AH S
FELLNESSES	F EH L N AH S IH Z
FELLOE	F EH L OW
FELLOES	F EH L OW Z
FELLOW	F EH L OW
FELLOWED	F EH L OW D
FELLOWING	F EH L OW IH NG
FELLOWLY	F EH L OW L IY
FELLOWMAN	F EH L OW M AE N
FELLOWMEN	F EH L OW M EH N
FELLOWS	F EH L OW Z
FELLOWSHIP	F EH L OW SH IH P
FELLOWSHIPED	F EH L OW SH IH P T
FELLOWSHIPING	F EH L OW SH IH P IH NG
FELLOWSHIPPED	F EH L OW SH IH P T
FELLOWSHIPPING	F EH L OW SH IH P IH NG
FELLOWSHIPS	F EH L OW SH IH P S
FELLS	F EH L Z
FELLY	F EH L IY
FERRELLED	F EH R AH L D
FERRELLING	F EH R EH L AH NG
FERRIMAGNETICALLY	F EH R AH M AE G N EH T AH K AE L IY
FESTALLY	F EH S T AH L IY
FETISHISTICALLY	F EH T IH SH IH S T IH K AH L IY
FEUDALLY	F Y UW D AH L IY
FEUILLETON	F Y UW IH L AH T AH N
FEUILLETONISM	F Y UW IH L AH T AH N IH Z AH M
FEUILLETONISMS	F Y UW AH L EH T AH N AH Z AH M Z
FEUILLETONIST	F Y UW IH L EH T AH N AH S T
FEUILLETONISTS	F Y UW AH L EH T AH N AH S T S
FEUILLETONS	F Y UW IH L AH T AH N Z
FIBERFILL	F AY B ER F IH L
FIBERFILLS	F AY B ER F IH L Z
FIBREFILL	F IH B R AH F AH L
FIBREFILLS	F IH B R AH F AH L Z
FIBRILLA	F IH B R IH L AH
FIBRILLAE	F IH B R IH L IY
FIBRILLAR	F IH B R IH L AH R
FIBRILLATE	F IH B R AH L EY T
FIBRILLATED	F IH B R AH L EY T AH D
FIBRILLATES	F IH B R AH L EY T S
FIBRILLATING	F IH B R AH L EY T AH NG
FIBRILLATION	F IH B R IH L EY SH AH N
FIBRILLATIONS	F IH B R AH L EY T IY AH N Z
FICTIONALLY	F IH K SH AH N AH L IY
FIDUCIALLY	F IH D Y UW S IY AE L IY
FILIALLY	F IH L IY AH L IY
FILL	F IH L
FILLE	F IH L
FILLED	F IH L D
FILLER	F IH L ER
FILLERS	F IH L ER Z
FILLES	F IH L Z
FILLET	F AH L EY
FILLETED	F IH L AH T IH D
FILLETED(2)	F AH L EY D
FILLETING	F IH L IY T AH NG
FILLETS	F IH L IH T S
FILLIES	F IH L IY Z
FILLING	F IH L IH NG
FILLINGS	F IH L IH NG Z
FILLIP	F IH L AH P
FILLIPED	F IH L AH P T
FILLIPING	F IH L AH P IH NG
FILLIPS	F IH L AH P S
FILLO	F IH L OW
FILLOS	F IH L AA S
FILLS	F IH L Z
FILLY	F IH L IY
FILMICALLY	F IH L M IH K AH L IY
FINALLY	F AY N AH L IY
FINANCIALLY	F AH N AE N SH AH L IY
FINANCIALLY(2)	F IH N AE N SH AH L IY
FINANCIALLY(3)	F AY N AE N SH AH L IY
FINICALLY	F AY N IH K AH L IY
FIREBALL	F AY ER B AO L
FIREBALL(2)	F AY R B AO L
FIREBALLER	F AY ER B AO L ER
FIREBALLERS	F AY ER B AO L ER Z
FIREBALLING	F AY ER B AO L IH NG
FIREBALLS	F AY ER B AO L Z
FIREBALLS(2)	F AY R B AO L Z
FIREHALL	F AY ER HH AO L
FIREHALLS	F AY ER HH AO L Z
FIREWALL	F AY R W AA L
FIREWALLED	F AY ER W AO L D
FIREWALLING	F AY ER W AO L IH NG
FIREWALLS	F AY ER W AO L Z
FISCALLY	F IH S K AH L IY
FITFULLY	F IH T F AH L IY
FLABELLA	F L AH B EH L AH
FLABELLATE	F L AE B AH L EY T
FLABELLIFORM	F L AH B EH L AH F AH R M
FLABELLUM	F L AH B EH L AH M
FLAGELLA	F L AH JH EH L AH
FLAGELLANT	F L AE JH AH L AH N T
FLAGELLANTISM	F L AE JH AH L AH N T IH Z AH M
FLAGELLANTISMS	F L AE JH AH L AH N T IH Z AH M Z
FLAGELLANTS	F L AE JH AH L AH N T S
FLAGELLAR	F L AE JH AH L ER
FLAGELLATE	F L AE JH AH L EY T
FLAGELLATED	F L AE JH AH L EY T AH D
FLAGELLATES	F L AE JH AH L AH T S
FLAGELLATING	F L AE JH AH L EY T IH NG
FLAGELLATION	F L AE JH AH L EY SH AH N
FLAGELLATIONS	F L AE JH AH L EY SH AH N Z
FLAGELLIN	F L AH JH EH L AH N
FLAGELLINS	F L AH JH EH L AH N Z
FLAGELLUM	F L AH JH EH L AH M
FLAGELLUMS	F L AH JH EH L AH M Z
FLANNELLED	F L AE N AH L D
FLANNELLING	F L AE N AH L IH NG
FLANNELLY	F L AE N AH L IY
FLAVORFULLY	F L EY V ER F AH L IY
FLEXOGRAPHICALLY	F L EH K S AA G R AE F AH K AE L IY
FLORALLY	F L AO R AH L IY
FLORISTICALLY	F L OW R IH S T IH K AH L IY
FLOTILLA	F L OW T IH L AH
FLOTILLAS	F L OW T IH L AH Z
FLUIDALLY	F L UW AH D AH L IY
FLUOROSCOPICALLY	F L UW ER AA S K OW P IH K AH L IY
FOCALLY	F OW K AH L IY
FOLLES	F AA L Z
FOLLICLE	F AA L AH K AH L
FOLLICLE(2)	F AA L IH K AH L
FOLLICLES	F AA L IH K AH L Z
FOLLICULAR	F AH L IH K Y AH L ER
FOLLICULITIS	F AA L IH S AH L AY T AH S
FOLLICULITISES	F AA L AH K Y UW L AH T AY Z AH Z
FOLLIES	F AA L IY Z
FOLLIS	F AA L IH S
FOLLOW	F AA L OW
FOLLOWED	F AA L OW D
FOLLOWER	F AA L OW ER
FOLLOWERS	F AA L OW ER Z
FOLLOWERSHIP	F AA L OW ER SH IH P
FOLLOWERSHIPS	F AA L OW ER SH IH P S
FOLLOWING	F AA L OW IH NG
FOLLOWINGS	F AA L OW IH NG Z
FOLLOWS	F AA L OW Z
FOLLOWUP	F AA L OW AH P
FOLLOWUPS	F AA L OW AH P S
FOLLY	F AA L IY
FONTANELLE	F AA N T AH N AH L
FONTANELLES	F AA N T AH N AH L Z
FOOTBALL	F UH T B AO L
FOOTBALLER	F UH T B AO L ER
FOOTBALLERS	F UH T B AO L ER Z
FOOTBALLS	F UH T B AO L Z
FOOTFALL	F UH T F AO L
FOOTFALLS	F UH T F AO L Z
FOOTHILL	F UH T HH IH L
FOOTHILLS	F UH T HH IH L Z
FOOTWALL	F UH T W AO L
FOOTWALLS	F UH T W AO L Z
FORCEFULLY	F AO R S F AH L IY
FORENSICALLY	F ER EH N S IH K L IY
FORENSICALLY(2)	F ER EH N S IH K AH L IY
FORESTALL	F AO R S T AO L
FORESTALLED	F AO R S T AA L D
FORESTALLER	F AO R AH S T AH L ER
FORESTALLERS	F AO R AH S T AH L ER Z
FORESTALLING	F AO R S T AA L IH NG
FORESTALLMENT	F OW R S T AO L M AH N T
FORESTALLMENTS	F OW R S T AO L M AH N T S
FORESTALLS	F AO R S T AO L Z
FORETELL	F AO R T EH L
FORETELLER	F OW R T EH L ER
FORETELLERS	F OW R T EH L ER Z
FORETELLING	F AO R T EH L IH NG
FORETELLS	F OW R T EH L Z
FORETHOUGHTFULLY	F OW R TH AO T F AH L IY
FORGETFULLY	F AO R G EH T F AH L IY
FORKBALL	F AO R K B AO L
FORKBALLS	F AO R K B AO L Z
FORMALLY	F AO R M AH L IY
FORMULAICALLY	F AO R M Y AH L EY IH K AH L IY
FORTUNETELLER	F AO R CH AH N T EH L ER
FORTUNETELLERS	F AO R CH AH N T EH L ER Z
FORTUNETELLING	F AO R CH AH N T EH L IH NG
FORTUNETELLINGS	F AO R CH AH N T EH L IH NG Z
FOULLY	F AW L IY
FOUNDATIONALLY	F AW N D EY SH AH N AH L IY
FRACTIONALLY	F R AE K SH AH N AH L IY
FRACTIONALLY(2)	F R AE K SH N AH L IY
FRAGMENTALLY	F R AE G M AH N T AH L IY
FRAILLY	F R EY L IY
FRANTICALLY	F R AE N T AH K AH L IY
FRANTICALLY(2)	F R AE N T AH K L IY
FRANTICALLY(3)	F R AE N AH K AH L IY
FRANTICALLY(4)	F R AE N AH K L IY
FRATERNALLY	F R AH T AH R N AE L IY
FRAXINELLA	F R AE K S AH N EH L AH
FRAXINELLAS	F R AE K S AH N EH L AH Z
FREEWILL	F R IY W IH L
FRENETICALLY	F R IH N EH T IH K AH L IY
FRETFULLY	F R EH T F AH L IY
FRICTIONALLY	F R IH K SH AH N AH L IY
FRIGHTFULLY	F R AY T F AH L IY
FRILL	F R IH L
FRILLED	F R IH L D
FRILLER	F R IH L ER
FRILLERS	F R IH L ER Z
FRILLIER	F R IH L IY ER
FRILLIEST	F R IH L IY AH S T
FRILLING	F R IH L IH NG
FRILLINGS	F R IH L IH NG Z
FRILLS	F R IH L Z
FRILLY	F R IH L IY
FRITILLARIA	F R IH T AH L AE R IY AH
FRITILLARIAS	F R IH T AH L AE R IY AH Z
FRITILLARIES	F R AH T IH L AH R AY Z
FRITILLARY	F R IH T AH L EH R IY
FRIVOLLED	F R IH V AH L D
FRIVOLLER	F R IH V AH L ER
FRIVOLLERS	F R IH V AH L ER Z
FRIVOLLING	F R IH V AH L IH NG
FRONTALLY	F R AH N T AH L IY
FRUGALLY	F R UW G AH L IY
FRUITFULLER	F R UW T F AH L ER
FRUITFULLEST	F R UW T F AH L AH S T
FRUITFULLY	F R UW T F AH L IY
FUELLED	F Y UW AH L D
FUELLER	F Y UW AH L ER
FUELLERS	F Y UW AH L ER Z
FUELLING	F Y UW L IH NG
FUGALLY	F Y UW G AE L IY
FULFILL	F UH L F IH L
FULFILLED	F UH L F IH L D
FULFILLER	F UH L F IH L ER
FULFILLERS	F UH L F IH L ER Z
FULFILLING	F UH L F IH L IH NG
FULFILLMENT	F UH L F IH L M AH N T
FULFILLMENTS	F UH L F IH L M AH N T S
FULFILLS	F UH L F IH L Z
FULL	F UH L
FULLAM	F UH L AH M
FULLAMS	F UH L AH M Z
FULLBACK	F UH L B AE K
FULLBACKS	F UH L B AE K S
FULLED	F UH L D
FULLER	F UH L ER
FULLERED	F UH L ER D
FULLERENE	F UH L AH R IY N
FULLERENES	F UH L AH R IY N Z
FULLERIES	F UH L AH R IY Z
FULLERING	F UH L ER IH NG
FULLERS	F UH L ER Z
FULLERY	F UH L AH R IY
FULLEST	F UH L AH S T
FULLFACE	F UH L F EY S
FULLFACES	F UH L F EY S IH Z
FULLING	F UH L IH NG
FULLMOUTHED	F UH L M AW TH T
FULLNESS	F UH L N AH S
FULLNESSES	F UH L N AH S IH Z
FULLS	F UH L Z
FULLY	F UH L IY
FUNCTIONALLY	F AH NG K SH AH N AH L IY
FUNCTIONALLY(2)	F AH NG K SH N AH L IY
FUNDAMENTALLY	F AH N D AH M EH N T AH L IY
FUNDAMENTALLY(2)	F AH N D AH M EH N AH L IY
FUNEREALLY	F Y UW N AH R IY L IY
FUNGICIDALLY	F AH N JH AH S AY D AH L IY
FUNNELLED	F AH N AH L D
FUNNELLING	F AH N AH L IH NG
FUSILLADE	F Y UW S IH L EY D
FUSILLADES	F Y UW Z AH L EY D Z
FUSILLI	F Y UW S IH L IY
FUSILLIS	F Y UW Z AH L IY Z
FUTURISTICALLY	F Y UW CH ER IH S T IH K AH L IY
GABELLE	G AE B AH L
GABELLED	G AE B AH L D
GABELLES	G AE B AH L Z
GADWALL	G AE D W AO L
GADWALLS	G AE D W AO L Z
GAILLARDIA	G EY L AA R D IY AH
GAILLARDIAS	G EY L AA R D IY AH Z
GAINFULLY	G EY N F AH L IY
GALL	G AO L
GALLAMINE	G AO L AH M AY N
GALLAMINES	G AO L AH M AY N Z
GALLANT	G AE L AH N T
GALLANTED	G AE L AH N T IH D
GALLANTING	G AE L AH N T IH NG
GALLANTLY	G AE L AH N T L IY
GALLANTRIES	G AE L AH N T R IY Z
GALLANTRY	G AE L AH N T R IY
GALLANTS	G AE L AH N T S
GALLATE	G AO L AH T
GALLATES	G AO L AH T S
GALLBLADDER	G AO L B L AE D ER
GALLBLADDERS	G AO L B L AE D ER Z
GALLEASS	G AE L IY S
GALLEASSES	G AE L IY S AH Z
GALLED	G AO L D
GALLEIN	G AE L IY N
GALLEINS	G AE L IY N Z
GALLEON	G AE L IY AH N
GALLEONS	G AE L IY AH N Z
GALLERIA	G AE L ER IY AH
GALLERIAS	G AE L IY R IY AH Z
GALLERIED	G AE L AH R IY D
GALLERIES	G AE L ER IY Z
GALLERY	G AE L ER IY
GALLERYGOER	G AE L AH R IY G OW ER
GALLERYGOERS	G AE L AH R IY G OW ER Z
GALLERYING	G AE L AH R IY IH NG
GALLERYITE	G AE L EH R AY AY T
GALLERYITES	G AE L EH R AY AY T S
GALLET	G AE L IH T
GALLETA	G AE L AH T AH
GALLETAS	G AE L AH T AH Z
GALLETED	G AE L AH T IH D
GALLETING	G AE L AH T IH NG
GALLETS	G AE L AH T S
GALLEY	G AE L IY
GALLEYS	G AE L IY Z
GALLFLIES	G AO L F L AY Z
GALLFLY	G AO L F L AY
GALLIARD	G AE L IY AH R D
GALLIARDS	G AE L IY AH R D Z
GALLIASS	G AE L IY AH S
GALLIASSES	G AE L IY AE S AH Z
GALLIC	G AE L IH K
GALLICAN	G AE L IH S AH N
GALLICISM	G AO L IH K S IH Z AH M
GALLICISMS	G AO L IH K S IH Z AH M Z
GALLICIZATION	G AO L IH K S AH Z EY SH AH N
GALLICIZATIONS	G AO L IH K S AH Z EY SH AH N Z
GALLICIZE	G AO L IH K S AY Z
GALLICIZED	G AO L IH K S AY Z D
GALLICIZES	G AO L IH K S AY Z IH Z
GALLICIZING	G AO L IH K S AY Z IH NG
GALLIED	G AE L IY D
GALLIES	G AE L IY Z
GALLIGASKINS	G AE L AH G AE S AH N Z
GALLIMAUFRIES	G AE L AH M AO F R AY Z
GALLIMAUFRY	G AE L AH M AO F R IY
GALLINACEOUS	G AO L IH N EY S AH S
GALLING	G AO L IH NG
GALLINGLY	G AO L IH NG L IY
GALLINIPPER	G AE L AH N IH P AH R
GALLINIPPERS	G AE L AH N IH P AH R Z
GALLINULE	G AE L AH N Y UW L
GALLINULES	G AE L AH N Y UW L Z
GALLIOT	G AE L IY AH T
GALLIOTS	G AE L IY AH T S
GALLIPOT	G AE L AH P AH T
GALLIPOTS	G AE L AH P AH T S
GALLIUM	G AE L IY AH M
GALLIUMS	G AE L IY AH M Z
GALLIVANT	G AO L IH V AH N T
GALLIVANTED	G AO L IH V AH N T IH D
GALLIVANTING	G AO L IH V AH N T IH NG
GALLIVANTS	G AO L IH V AH N T S
GALLNUT	G AO L N AH T
GALLNUTS	G AO L N AH T S
GALLON	G AE L AH N
GALLONAGE	G AE L AH N IH JH
GALLONAGES	G AE L AH N IH JH IH Z
GALLONS	G AE L AH N Z
GALLOON	G AH L UW N
GALLOONS	G AE L UW N Z
GALLOOT	G AE L UW T
GALLOOTS	G AE L UW T S
GALLOP	G AE L AH P
GALLOPADE	G AE L AH P EY D
GALLOPADES	G AE L AH P EY D Z
GALLOPED	G AE L AH P T
GALLOPER	G AE L AH P ER
GALLOPERS	G AE L AH P ER Z
GALLOPING	G AE L AH P IH NG
GALLOPS	G AE L AH P S
GALLOUS	G AO L AH S
GALLOWGLASS	G AE L OW G L AE S
GALLOWGLASSES	G AE L OW G L AE S IH Z
GALLOWS	G AE L OW Z
GALLOWSES	G AE L OW Z IH Z
GALLS	G AO L Z
GALLSTONE	G AO L S T OW N
GALLSTONES	G AA L S T OW N Z
GALLSTONES(2)	G AO L S T OW N Z
GALLUS	G AE L AH S
GALLUSED	G AO L Y UW S T
GALLUSES	G AO L Y UW S IH Z
GALLY	G AE L IY
GALLYING	G AE L IY IH NG
GALVANICALLY	G AE L V AE N IH K AH L IY
GAMBOLLED	G AE M B AH L D
GAMBOLLING	G AE M B AA L AH NG
GAMETICALLY	G AH M EH T AH K AE L IY
GASTRONOMICALLY	G AE S T R AH N OW M IH K AH L IY
GAVELLED	G AE V AH L D
GAVELLING	G AH V EH L AH NG
GAZELLE	G AH Z EH L
GAZELLES	G AH Z EH L Z
GAZILLION	G AH Z IH L IY AH N
GAZILLIONS	G AH Z IH L IY AH N Z
GELLANT	JH EH L AH N T
GELLANTS	JH EH L AH N T S
GELLED	JH EH L D
GELLING	JH EH L IH NG
GEMINALLY	JH EH M IH N AH L IY
GENEALOGICALLY	JH IY N AH L AA JH IH K AH L IY
GENERALLY	JH EH N ER AH L IY
GENERALLY(2)	JH EH N R AH L IY
GENERATIONALLY	JH EH N ER EY SH AH N AH L IY
GENERICALLY	JH AH N EH R IH K L IY
GENETICALLY	JH AH N EH T IH K L IY
GENIALLY	JH IY N Y AH L IY
GENICALLY	JH IY N IH K AH L IY
GENITALLY	JH EH N AH T AH L IY
GENITIVALLY	JH AH N IH T AH V AE L IY
GENOTYPICALLY	JH EH N AH T IH P AH K AE L IY
GENTEELLY	JH EH N T IY L IY
GEOCENTRICALLY	JH IY OW S EH N T R IH K AH L IY
GEOCHEMICALLY	JH IY AH K EH M AH K AE L IY
GEOCHRONOLOGICALLY	JH IY AA K R AH N AH L AA JH AH K AE L IY
GEOGRAPHICALLY	JH IY AH G R AE F IH K AH L IY
GEOGRAPHICALLY(2)	JH IY AH G R AE F IH K L IY
GEOLOGICALLY	JH IY AH L AA JH IH K AH L IY
GEOMAGNETICALLY	JH IY AH M AE G N EH T AH K AE L IY
GEOMETRICALLY	JH IY AH M EH T R IH K L IY
GEOPHYSICALLY	JH IY AH F IH S AH K AE L IY
GEOPOLITICALLY	JH IY OW P AH L IH T IH K L IY
GEOSTROPHICALLY	JH IY AA S T R AA F AH K AE L IY
GEOTECTONICALLY	JH IY AH T EH K T AA N AH K AE L IY
GEOTHERMALLY	JH IY AH TH AH R M AE L IY
GEOTROPICALLY	JH IY AA T R AA P AH K AE L IY
GERBILLE	JH AH R B AH L
GERBILLES	JH AH R B AH L Z
GERMINALLY	JH ER M AH N AH L IY
GESELLSCHAFT	G AH S EH L SH AE F T
GESELLSCHAFTEN	JH AH S EH L S AE F T AH N
GESELLSCHAFTS	JH AH S EH L S AH F T S
GESTURALLY	JH EH S CH ER AH L IY
GHASTFULLY	G AE S T F AH L IY
GHILLIE	G IH L AY
GHILLIES	G IH L AY Z
GHYLL	G IH L
GHYLLS	G IH L Z
GIBBERELLIN	JH IH B AH R EH L AH N
GIBBERELLINS	JH IH B AH R EH L AH N Z
GIGANTICALLY	JH AY G AE N T IH K AH L IY
GILDHALL	G IH L D HH AO L
GILDHALLS	G IH L D HH AO L Z
GILL	G IH L
GILLED	G IH L D
GILLER	G IH L ER
GILLERS	G IH L ER Z
GILLIE	G IH L IY
GILLIED	G IH L IY D
GILLIES	G IH L IY Z
GILLING	G IH L IH NG
GILLNET	G IH L N EH T
GILLNETS	G IH L N EH T S
GILLNETTED	G IH L N EH T IH D
GILLNETTER	G IH L N EH T ER
GILLNETTERS	G IH L N EH T ER Z
GILLNETTING	G IH L N EH T IH NG
GILLS	G IH L Z
GILLY	G IH L IY
GILLYFLOWER	G IH L IY F L AW ER
GILLYFLOWERS	G IH L IY F L AW ER Z
GILLYING	G IH L IY IH NG
GIMBALLED	JH IH M B AH L D
GIMBALLING	JH IH M B AO L AH NG
GINGALL	JH IH N G AO L
GINGALLS	JH IH N G AO L Z
GINGELLI	JH IH N JH EH L IY
GINGELLIES	JH IH N JH EH L IY Z
GINGELLIS	JH IH N JH EH L IY Z
GINGELLY	JH IH N JH EH L IY
GINGILLI	JH IH N JH IH L IY
GINGILLIS	JH IH N G IH L IY Z
GLABELLA	G L AH B EH L AH
GLABELLAE	G L AH B EH L IY
GLABELLAR	G L AH B EH L AH R
GLACIALLY	G L EY SH AH L IY
GLEEFULLY	G L IY F AH L IY
GLOBALLY	G L OW B AH L IY
GLYCOSIDICALLY	G L AY K AH S AY D IH K AH L IY
GNOTOBIOTICALLY	N AH T AH B IY AA T AH K AE L IY
GOALLESS	G OW L AH S
GOLLIWOG	G AA L AH W AH G
GOLLIWOGG	G AA L AH W AH G
GOLLIWOGGS	G AA L AH W AH G Z
GOLLIWOGS	G AA L AH W AH G Z
GOLLY	G AA L IY
GOLLYWOG	G AA L AH W AH G
GOLLYWOGS	G AA L AH W AH G Z
GOODWILL	G UH D W IH L
GOODWILLED	G UH D W IH L D
GOODWILLS	G UH D W IH L Z
GOOFBALL	G UW F B AO L
GOOFBALLS	G UW F B AO L Z
GORBELLIES	G AO R B EH L AY Z
GORBELLY	G AO R B EH L IY
GORILLA	G ER IH L AH
GORILLAS	G ER IH L AH Z
GOSPELLER	G AA S P AH L ER
GOSPELLERS	G AA S P AH L ER Z
GOTHICALLY	G OW TH IH K AH L IY
GOVERNMENTALLY	G AH V ER M EH N T AH L IY
GRACEFULLER	G R EY S F AH L ER
GRACEFULLEST	G R EY S F AH L AH S T
GRACEFULLY	G R EY S F AH L IY
GRADATIONALLY	G R EY D EY SH AH N AH L IY
GRADUALLY	G R AE JH UW AH L IY
GRADUALLY(2)	G R AE JH UW L IY
GRAMMATICALLY	G R AH M AE T IH K AH L IY
GRANADILLA	G R AE N AH D IH L AH
GRANADILLAS	G R AE N AH D IH L AH Z
GRAPHEMICALLY	G R AE F IH M AY S AH L IY
GRAPHICALLY	G R AE F IH K L IY
GRATEFULLER	G R EY T F AH L ER
GRATEFULLEST	G R EY T F AH L AH S T
GRATEFULLY	G R EY T F AH L IY
GRAVELLED	G R AE V AH L D
GRAVELLING	G R AE V AH L IH NG
GRAVELLY	G R AE V AH L IY
GRAVIMETRICALLY	G R AE V AH M EH T R AH K AE L IY
GRAVITATIONALLY	G R AE V AH T EY SH N AH L IY
GREASEBALL	G R IY S B AO L
GREASEBALLS	G R IY S B AO L Z
GRILL	G R IH L
GRILLADE	G R IH L EY D
GRILLADES	G R IH L EY D Z
GRILLAGE	G R IH L IH JH
GRILLAGES	G R IH L IH JH IH Z
GRILLE	G R IH L
GRILLED	G R IH L D
GRILLER	G R IH L ER
GRILLERS	G R IH L ER Z
GRILLES	G R IH L Z
GRILLING	G R IH L IH NG
GRILLROOM	G R IH L R UW M
GRILLROOMS	G R IH L R UW M Z
GRILLS	G R IH L Z
GRILLWORK	G R IH L W ER K
GRILLWORKS	G R IH L W ER K S
GRISAILLE	G R AH S EY L
GRISAILLES	G R AH S EY L Z
GRISTMILL	G R IH S T M IH L
GRISTMILLS	G R IH S T M IH L Z
GROMWELL	G R AA M W AH L
GROMWELLS	G R AA M W AH L Z
GROUNDSWELL	G R AW N D S W EH L
GROUNDSWELLS	G R AW N D S W EH L Z
GROVELLED	G R AA V AH L D
GROVELLING	G R AA V AH L IH NG
GRUELLED	G R UW AH L D
GRUELLER	G R UW EH L AH R
GRUELLERS	G R UW EH L AH R Z
GRUELLING	G R UW EH L AH NG
GRUELLINGS	G R UW EH L AH NG Z
GUERILLA	G ER IH L AH
GUERILLAS	G ER IH L AH Z
GUERRILLA	G ER IH L AH
GUERRILLAS	G ER IH L AH Z
GUIDWILLIE	G UW D W IH L AY
GUILDHALL	G IH L D HH AO L
GUILDHALLS	G IH L D HH AO L Z
GUILEFULLY	G AY L F AH L IY
GUILLEMET	G UW L AH M AH T
GUILLEMETS	G UW L AH M AH T S
GUILLEMOT	G UW L AH M AH T
GUILLEMOTS	G UW L AH M AH T S
GUILLOCHE	G UW L AH CH
GUILLOCHES	G UW L AH CH AH Z
GUILLOTINE	G IH L AH T IY N
GUILLOTINE(2)	G IY Y AH T IY N
GUILLOTINED	G UW L AH T AY N D
GUILLOTINES	G UW L AH T AY N Z
GUILLOTINING	G UW L AH T AY N AH NG
GULL	G AH L
GULLABLE	G AH L AH B AH L
GULLABLY	G AH L AH B L IY
GULLED	G AH L D
GULLET	G AH L AH T
GULLETS	G AH L AH T S
GULLEY	G AH L IY
GULLEYS	G AH L EY Z
GULLIBILITIES	G AH L AH B IH L AH T IY Z
GULLIBILITY	G AH L AH B IH L IH T IY
GULLIBLE	G AH L AH B AH L
GULLIBLY	G AH L AH B L IY
GULLIED	G AH L IY D
GULLIES	G AH L IY Z
GULLING	G AH L IH NG
GULLS	G AH L Z
GULLY	G AH L IY
GULLYING	G AH L IY IH NG
GYMNASTICALLY	JH IH M N AE S T IH K AH L IY
GYRALLY	JH AY R AH L IY
GYROSCOPICALLY	JH AY R OW S K OW P IH K AH L IY
HABITUALLY	HH AH B IH CH UW AH L IY
HABITUALLY(2)	HH AH B IH CH UW L IY
HAIRBALL	HH EH R B AO L
HAIRBALLS	HH EH R B AO L Z
HALL	HH AO L
HALLAH	HH AE L AH
HALLAHS	HH AE L AH Z
HALLEL	HH AE L AH L
HALLELS	HH AE L AH L Z
HALLELUJAH	HH AE L AH L UW Y AH
HALLELUJAHS	HH AE L AH L UW Y AH Z
HALLIARD	HH AE L IY AH R D
HALLIARDS	HH AE L IY AH R D Z
HALLMARK	HH AA L M AA R K
HALLMARKED	HH AO L M AA R K T
HALLMARKING	HH AO L M AA R K IH NG
HALLMARKS	HH AO L M AA R K S
HALLO	HH AE L OW
HALLOA	HH AE L OW AH
HALLOAED	HH AE L OW D
HALLOAING	HH AE L OW AH NG
HALLOAS	HH AE L OW Z
HALLOED	HH AE L OW D
HALLOES	HH AE L OW Z
HALLOING	HH AE L OW AH NG
HALLOO	HH AE L UW
HALLOOED	HH AE L UW D
HALLOOING	HH AE L UW AH NG
HALLOOS	HH AE L UW Z
HALLOS	HH AO L AA S
HALLOT	HH AE L AH T
HALLOTH	HH AE L AH TH
HALLOW	HH AE L OW
HALLOWED	HH AE L OW D
HALLOWER	HH AE L OW ER
HALLOWERS	HH AE L OW ER Z
HALLOWING	HH AE L OW IH NG
HALLOWS	HH AE L OW Z
HALLS	HH AO L Z
HALLUCES	HH AE L UW S AH Z
HALLUCINATE	HH AH L UW S AH N EY T
HALLUCINATED	HH AH L UW S AH N EY T IH D
HALLUCINATES	HH AH L UW S AH N EY T S
HALLUCINATING	HH AH L UW S AH N EY T IH NG
HALLUCINATING(2)	HH AH L UW S IH N EY T IH NG
HALLUCINATION	HH AH L UW S AH N EY SH AH N
HALLUCINATIONS	HH AH L UW S AH N EY SH AH N Z
HALLUCINATOR	HH AH L UW S AH N AH T ER
HALLUCINATORS	HH AH L UW S AH N AH T ER Z
HALLUCINATORY	HH AH L UW S AH N AH T AO R IY
HALLUCINOGEN	HH AE L AH S IH N AH JH AH N
HALLUCINOGENIC	HH AH L UW S AH N AH JH EH N IH K
HALLUCINOGENICS	HH AE L AH S AH N AA JH AH N AH S Z
HALLUCINOGENS	HH AE L AH S IH N AH JH AH N Z
HALLUCINOSES	HH AE L UW S AH N OW Z AH Z
HALLUCINOSIS	HH AE L UW S AH N OW S AH S
HALLUX	HH AE L AH K S
HALLWAY	HH AO L W EY
HALLWAYS	HH AO L W EY Z
HANDBALL	HH AE N D B AO L
HANDBALLS	HH AE N D B AO L Z
HANDBELL	HH AE N D B EH L
HANDBELLS	HH AE N D B EH L Z
HANDBILL	HH AE N D B IH L
HANDBILLS	HH AE N D B IH L Z
HANDSELLED	HH AE N D S EH L D
HANDSELLING	HH AE N D S EH L IH NG
HANSELLED	HH AE N S AH L D
HANSELLING	HH AE N S EH L AH NG
HARDBALL	HH AA R D B AO L
HARDBALLS	HH AA R D B AO L Z
HAREBELL	HH EH R B EH L
HAREBELLS	HH EH R B EH L Z
HARMFULLY	HH AA R M F AH L IY
HARMONICALLY	HH AA R M AA N IH K AH L IY
HATCHELLED	HH AE CH AH L D
HATCHELLING	HH AH CH EH L AH NG
HATEFULLY	HH EY T F AH L IY
HAUSTELLA	HH AO S T EH L AH
HAUSTELLUM	HH AO S T EH L AH M
HAWKBILL	HH AO K B IH L
HAWKBILLS	HH AO K B IH L Z
HAWKSBILL	HH AO K S B IH L
HAWKSBILLS	HH AO K S B IH L Z
HAZELLY	HH EY Z AH L IY
HEADSTALL	HH EH D S T AO L
HEADSTALLS	HH EH D S T AO L Z
HEALTHFULLY	HH EH L TH F AH L IY
HEBDOMADALLY	HH EH B D AA M AH D AE L IY
HECTICALLY	HH EH K T IH K AH L IY
HEDONICALLY	HH IY D AO N IH K AH L IY
HEDONISTICALLY	HH IY D AH N IH S T IH K AH L IY
HEEDFULLY	HH IY D F AH L IY
HEELBALL	HH IY L B AO L
HEELBALLS	HH IY L B AO L Z
HEELLESS	HH IY L AH S
HELIACALLY	HH IY L IY AH K AE L IY
HELICALLY	HH EH L AH K AE L IY
HELIOMETRICALLY	HH IY L IY AH M EH T R AH K AE L IY
HELL	HH EH L
HELLACIOUS	HH EH L EY SH AH S
HELLACIOUSLY	HH EH L EY SH AH S L IY
HELLBENDER	HH EH L B EH N D ER
HELLBENDERS	HH EH L B EH N D ER Z
HELLBENT	HH EH L B IY AH N T
HELLBOX	HH EH L B AA K S
HELLBOXES	HH EH L B AA K S IH Z
HELLBROTH	HH EH L B R AO TH
HELLBROTHS	HH EH L B R AO TH S
HELLCAT	HH EH L K AE T
HELLCATS	HH EH L K AE T S
HELLEBORE	HH EH L AH B AH R
HELLEBORES	HH EH L AH B AH R Z
HELLED	HH EH L D
HELLENIZATION	HH EH L AH N AH Z EY SH AH N
HELLENIZATIONS	HH EH L AH N AH Z EY SH AH N Z
HELLENIZE	HH EH L AH N AY Z
HELLENIZED	HH EH L AH N AY Z D
HELLENIZES	HH EH L AH N AY Z IH Z
HELLENIZING	HH EH L AH N AY Z IH NG
HELLER	HH EH L ER
HELLERI	HH EH L AH R IY
HELLERIES	HH EH L AH R IY Z
HELLERIS	HH EH L AH R IY Z
HELLERS	HH EH L ER Z
HELLERY	HH EH L AH R IY
HELLFIRE	HH EH L F AY R
HELLFIRES	HH EH L F AY ER Z
HELLGRAMMITE	HH EH L G R AE M AY T
HELLGRAMMITES	HH EH L G R AE M AY T S
HELLHOLE	HH EH L HH OW L
HELLHOLES	HH EH L HH OW L Z
HELLHOUND	HH EH L HH AW N D
HELLHOUNDS	HH EH L HH AW N D Z
HELLING	HH EH L IH NG
HELLION	HH EH L Y AH N
HELLIONS	HH EH L Y AH N Z
HELLISH	HH EH L IH SH
HELLISHLY	HH EH L IH SH L IY
HELLISHNESS	HH EH L IH SH N AH S
HELLISHNESSES	HH EH L IH SH N AH S IH Z
HELLKITE	HH EH L K AY T
HELLKITES	HH EH L K AY T S
HELLO	HH AH L OW
HELLO(2)	HH EH L OW
HELLOED	HH AH L OW D
HELLOES	HH AH L OW Z
HELLOING	HH AH L OW IH NG
HELLOS	HH EH L AA S
HELLS	HH EH L Z
HELLUVA	HH EH L UW V AH
HELPFULLY	HH EH L P F AH L IY
HEMEROCALLIS	HH AH M EH R AH K AE L AH S
HEMEROCALLISES	HH AH M AH R AA K AH L AY Z AH Z
HEMICELLULOSE	HH AH M AH S EH L AH L OW Z
HEMICELLULOSES	HH AH M AH S EH L AH L OW Z AH Z
HEMODYNAMICALLY	HH EH M AH D AH N AE M AH K AE L IY
HEMOFLAGELLATE	HH AH M AA F L AE JH AH L EY T
HEMOFLAGELLATES	HH AH M AA F L AE JH AH L EY T S
HENDECASYLLABIC	HH EH N D AH K AH S IH L AH B AH K
HENDECASYLLABICS	HH EH N D AH K AH S IH L AH B AH S Z
HENDECASYLLABLE	HH EH N D EH K AH S IH L AH B AH L
HENDECASYLLABLES	HH EH N D EH K AH S IH L AH B AH L Z
HEPATOCELLULAR	HH AH P AE T AH S EH L Y AH L AH R
HERALDICALLY	HH EH R AH L D IH K AH L IY
HERBICIDALLY	ER B IH K S AH D AH L IY
HERETICALLY	HH EH R AH T IH K AH L IY
HERMENEUTICALLY	HH AH R M IY N Y UW T AH K AE L IY
HERMETICALLY	HH ER M EH T IH K AH L IY
HERMETICALLY(2)	HH ER M EH T IH K L IY
HEROICALLY	HH IH R OW IH K L IY
HETEROPHYLLIES	HH EH T AH R AH F IH L AY Z
HETEROPHYLLOUS	HH AH T EH R AH F IH L AH S
HETEROPHYLLY	HH AH T EH R AH F IH L IY
HETEROSEXUALLY	HH EH T AH R AH S EH K S Y UW AE L IY
HETEROTHALLIC	HH AH T EH R AH TH AH L AH K
HETEROTHALLISM	HH AH T EH R AH TH AH L IH Z AH M
HETEROTHALLISMS	HH EH T AH R AH TH AE L AH Z AH M Z
HETEROTROPHICALLY	HH EH T AH R AA T R AA F AH K AE L IY
HEURISTICALLY	HH Y AH R IH S T AH K AE L IY
HEXAGONALLY	HH EH K S AE G AH N AH L IY
HIERARCHICALLY	HH IY R AA R K AH K AE L IY
HIERATICALLY	HH IY R AE T AH K AE L IY
HIEROGLYPHICALLY	HH IY R AA G L IH F AH K AE L IY
HIGHBALL	HH AY B AO L
HIGHBALLED	HH AY B AO L D
HIGHBALLING	HH AY B AO L IH NG
HIGHBALLS	HH AY B AO L Z
HILL	HH IH L
HILLBILLIES	HH IH L B IH L IY Z
HILLBILLY	HH IH L B IH L IY
HILLCREST	HH IH L K R EH S T
HILLCRESTS	HH IH L K R EH S T S
HILLED	HH IH L D
HILLER	HH IH L ER
HILLERS	HH IH L ER Z
HILLIER	HH IH L IY ER
HILLIEST	HH IH L IY AH S T
HILLING	HH IH L IH NG
HILLO	HH IH L OW
HILLOA	HH IH L OW AH
HILLOAED	HH IH L OW D
HILLOAING	HH IH L OW AH NG
HILLOAS	HH IH L OW Z
HILLOCK	HH IH L AH K
HILLOCKS	HH IH L AH K S
HILLOCKY	HH IH L AA K IY
HILLOED	HH IH L OW D
HILLOES	HH IH L OW Z
HILLOING	HH IH L OW AH NG
HILLOS	HH IH L AA S
HILLS	HH IH L Z
HILLSIDE	HH IH L S AY D
HILLSIDES	HH IH L S AY D Z
HILLTOP	HH IH L T AA P
HILLTOPS	HH IH L T AA P S
HILLY	HH IH L IY
HIRSELLED	HH AH R S AH L D
HIRSELLING	HH AH R S EH L AH NG
HISTOCHEMICALLY	HH IH S T OW K EH M IH K AH L IY
HISTOLOGICALLY	HH IH S T AH L AA JH AH K AE L IY
HISTOPATHOLOGICALLY	HH IH S T AA P AH TH AH L AA JH AH K AE L IY
HISTORICALLY	HH IH S T AO R IH K AH L IY
HISTORICALLY(2)	HH IH S T AO R IH K L IY
HISTORIOGRAPHICALLY	HH IH S T AO R IY AA G R AE F AH K AE L IY
HISTRIONICALLY	HH AY Z T R IY OW N AY S AH L IY
HOLDALL	HH OW L D AO L
HOLDALLS	HH OW L D AO L Z
HOLISTICALLY	HH OW L IH S T IH K AH L IY
HOLLA	HH AA L AH
HOLLAED	HH AA L EY D
HOLLAING	HH AA L EY AH NG
HOLLAND	HH AA L AH N D
HOLLANDAISE	HH AA L AH N D EY Z
HOLLANDAISES	HH AA L AH N D EY Z AH Z
HOLLANDS	HH AA L AH N D Z
HOLLAS	HH AA L AH Z
HOLLER	HH AA L ER
HOLLERED	HH AA L ER D
HOLLERING	HH AA L ER IH NG
HOLLERS	HH AA L ER Z
HOLLIES	HH AA L IY Z
HOLLO	HH AA L OW
HOLLOA	HH AA L OW AH
HOLLOAED	HH AA L OW D
HOLLOAING	HH AA L OW AH NG
HOLLOAS	HH AA L OW Z
HOLLOED	HH AA L OW D
HOLLOES	HH AA L OW Z
HOLLOING	HH AA L OW AH NG
HOLLOO	HH AA L UW
HOLLOOED	HH AA L UW D
HOLLOOING	HH AA L UW AH NG
HOLLOOS	HH AA L UW Z
HOLLOS	HH AA L AH Z
HOLLOW	HH AA L OW
HOLLOWARE	HH AA L OW AH R
HOLLOWARES	HH AA L OW AH R Z
HOLLOWED	HH AA L OW D
HOLLOWER	HH AA L OW ER
HOLLOWEST	HH AA L OW AH S T
HOLLOWING	HH AA L OW IH NG
HOLLOWLY	HH AA L OW L IY
HOLLOWNESS	HH AA L OW N AH S
HOLLOWNESSES	HH AA L OW N AH S IH Z
HOLLOWS	HH AA L OW Z
HOLLOWWARE	HH AA L OW W EH R
HOLLOWWARES	HH AA L OW W EH R Z
HOLLY	HH AA L IY
HOLLYHOCK	HH AA L IY HH AA K
HOLLYHOCKS	HH AA L IY HH AA K S
HOLOGRAPHICALLY	HH AH L AA G R AE F AH K AE L IY
HOMEOPATHICALLY	HH OW M IY AH P AE TH AH K AE L IY
HOMICIDALLY	HH AA M AH S AY D AH L IY
HOMOLOGICALLY	HH OW M OW L AA JH IH K AH L IY
HOMOSEXUALLY	HH OW M OW S EH K SH AH W AH L IY
HOMOTHALLIC	HH OW M OW TH AH L IH K
HOMOTHALLISM	HH OW M OW TH AH L IH Z AH M
HOMOTHALLISMS	HH OW M OW TH AH L IH Z AH M Z
HONORIFICALLY	HH AA N AH R IH F AH K AE L IY
HOPEFULLY	HH OW P F AH L IY
HORIZONTALLY	HH AO R IH Z AA N T AH L IY
HORIZONTALLY(2)	HH AO R IH Z AO N AH L IY
HORMONALLY	HH AO R M OW N AH L IY
HORNBILL	HH AO R N B IH L
HORNBILLS	HH AO R N B IH L Z
HORRIFICALLY	HH AO R IH F AH K AE L IY
HORTICULTURALLY	HH AO R T AH K AH L T Y AH R AE L IY
HOSTELLED	HH AA S T AH L D
HOSTELLER	HH AA S T AH L ER
HOSTELLERS	HH AA S T AH L ER Z
HOSTELLING	HH AA S T AH L IH NG
HOUSELLED	HH AW S AH L D
HOUSELLING	HH AW S EH L AH NG
HOVELLED	HH AH V AH L D
HOVELLING	HH AH V AH L IH NG
HULL	HH AH L
HULLABALOO	HH AH L AH B AH L UW
HULLABALOOS	HH AH L AE B AH L UW Z
HULLED	HH AH L D
HULLER	HH AH L ER
HULLERS	HH AH L ER Z
HULLING	HH AH L IH NG
HULLO	HH AH L OW
HULLOA	HH AH L OW AH
HULLOAED	HH AH L OW D
HULLOAING	HH AH L OW AH NG
HULLOAS	HH AH L OW Z
HULLOED	HH AH L OW D
HULLOES	HH AH L OW Z
HULLOING	HH AH L OW AH NG
HULLOS	HH AH L AA S
HULLS	HH AH L Z
HUMANISTICALLY	HH Y UW M AH N IH S T IH K AH L IY
HURTFULLY	HH ER T F AH L IY
HYDRAULICALLY	HH AY D R AO L IH K AH L IY
HYDROCOLLOID	HH IH D R AA K AH L OY D
HYDROCOLLOIDAL	HH IH D R AA K AH L OY D AH L
HYDROCOLLOIDS	HH IH D R AA K AH L OY D Z
HYDRODYNAMICALLY	HH IH D R AH D AH N AE M AH K AE L IY
HYDROELECTRICALLY	HH IH D R OW AH L EH K T R AH K AE L IY
HYDROLOGICALLY	HH IH D R AH L AA JH AH K AE L IY
HYDROLYTICALLY	HH IH D R AH L IH T AH K AE L IY
HYDROMETALLURGICAL	HH IH D R AA M AH T AE L AH R JH IH S AH L
HYDROMETALLURGIES	HH IH D R AA M AH T AE L AH R JH AY Z
HYDROMETALLURGIST	HH IH D R AA M AH T AE L AH R JH AH S T
HYDROMETALLURGISTS	HH IH D R AA M AH T AH L AH R JH AH S T S
HYDROMETALLURGY	HH IH D R AA M AH T AE L AH R JH IY
HYDRONICALLY	HH IH D R AA N AH K AE L IY
HYDROPONICALLY	HH IH D R AH P AA N AH K AE L IY
HYDROSTATICALLY	HH AY D R AH S T AE T IH K AH L IY
HYDROTHERMALLY	HH IH D R AH TH AH R M AE L IY
HYGIENICALLY	HH AY JH IY N IH K AH L IY
HYMENEALLY	HH IH M AH N IY L IY
HYPABYSSALLY	HH IH P AH B IH S AE L IY
HYPALLAGE	HH AH P AE L AH JH
HYPALLAGES	HH AH P AE L AH JH AH Z
HYPERBARICALLY	HH AY P ER B EH R IH K AH L IY
HYPERBOLICALLY	HH AY P ER B AA L IH K AH L IY
HYPERCRITICALLY	HH AY P ER K R IH T IH K AH L IY
HYPERGOLICALLY	HH AY P ER G OW L AY S AH L IY
HYPERINTELLECTUAL	HH AY P ER IH N T AH L EH K CH AH W AH L
HYPERINTELLIGENT	HH AY P ER IH N T EH L AH JH AH N T
HYPERSONICALLY	HH AY P ER S AA N IH K AH L IY
HYPNOTICALLY	HH IH P N AA T IH K AH L IY
HYPOALLERGENIC	HH IH P OW L AH R JH AH N AH K
HYPOCHONDRIACALLY	HH IH P AH CH AA N D R IY AH K AE L IY
HYPOCORISTICALLY	HH IH P AH K AH R IH S T AH K AE L IY
HYPOCRITICALLY	HH IH P AH K R IH T IH K AH L IY
HYPODERMICALLY	HH AY P AH D ER M IH K AH L IY
HYPOSTATICALLY	HH AH P AA S T AE T AH K AE L IY
HYPOTHETICALLY	HH AY P AH TH EH T IH K L IY
HYSTERICALLY	HH IH S T EH R IH K L IY
IATROGENICALLY	AY AE T R AH JH EH N AH K AE L IY
ICEFALL	AY S F AO L
ICEFALLS	AY S F AO L Z
ICHTHYOLOGICALLY	IH CH TH AY AH L AA JH AH K AE L IY
ICONICALLY	AH K AA N AH K AE L IY
ICONOCLASTICALLY	IH K AH N AH K L AE S T AH K AE L IY
ICONOGRAPHICALLY	IH K AH N AA G R AE F AH K AE L IY
IDEALISTICALLY	AY D IY AH L IH S T IH K AH L IY
IDEALLESS	AY D IY L AH S
IDEALLY	AY D IY L IY
IDEATIONALLY	AY D IY EY SH AH N AH L IY
IDENTICALLY	AY D EH N T IH K AH L IY
IDEOGRAPHICALLY	IH D IY AA G R AE F AH K AE L IY
IDEOLOGICALLY	AY D IY AH L AA JH IH K L IY
IDIOMATICALLY	IH D IY AH M AE T IH K AH L IY
IDIOPATHICALLY	IH D IY AH P AE TH AH K AE L IY
IDIOSYNCRATICALLY	IH D IY OW S IH N K R AE T IH K AH L IY
IDIOTICALLY	IH D IY AA T IH K L IY
IDYLL	AY D AH L
IDYLLIC	AY D IH L IH K
IDYLLICALLY	AY D IH L IH K AH L IY
IDYLLIST	AY D AH L IH S T
IDYLLISTS	AY D AH L IH S T S
IDYLLS	AY D AH L Z
ILL	IH L
ILLATION	IH L EY SH AH N
ILLATIONS	IH L EY SH AH N Z
ILLATIVE	IH L EY T IH V
ILLATIVELY	IH L EY T IH V L IY
ILLATIVES	IH L EY T IH V Z
ILLAUDABLE	IH L AO D AH B AH L
ILLAUDABLY	IH L AO D AH B L IY
ILLEGAL	IH L IY G AH L
ILLEGALITIES	IH L IY G AE L IH T IY Z
ILLEGALITY	IH L IY G AE L IH T IY
ILLEGALIZATION	IH L IY G AH L AH Z EY SH AH N
ILLEGALIZATIONS	IH L IY G AH L AH Z EY SH AH N Z
ILLEGALIZE	IH L IY G AH L AY Z
ILLEGALIZED	IH L IY G AH L AY Z D
ILLEGALIZES	IH L IY G AH L AY Z IH Z
ILLEGALIZING	IH L IY G AH L AY Z IH NG
ILLEGALLY	IH L IY G AH L IY
ILLEGALS	IH L IY G AH L Z
ILLEGIBILITIES	IH L EH JH AH B IH L AH T IY Z
ILLEGIBILITY	IH L EH JH AH B IH L AH T IY
ILLEGIBLE	IH L EH JH AH B AH L
ILLEGIBLY	IH L EH G AH B L IY
ILLEGITIMACIES	IH L IH JH IH T AH M AH S IY Z
ILLEGITIMACY	IH L IH JH IH T AH M AH S IY
ILLEGITIMATE	IH L IH JH IH T AH M IH T
ILLEGITIMATELY	IH L IH JH IH T AH M AH T L IY
ILLER	IH L ER
ILLEST	IH L AH S T
ILLIBERAL	IH L IH B ER AH L
ILLIBERALISM	IH L IH B ER AH L IH Z AH M
ILLIBERALISMS	IH L IH B ER AH L IH Z AH M Z
ILLIBERALITIES	IH L IH B AH R AE L AH T IY Z
ILLIBERALITY	IH L IH B AH R AE L AH T IY
ILLIBERALLY	IH L IH B ER AH L IY
ILLIBERALNESS	IH L IH B ER AH L N AH S
ILLIBERALNESSES	IH L IH B ER AH L N AH S IH Z
ILLICIT	IH L IH S AH T
ILLICITLY	IH L IH S IH T L IY
ILLICITNESS	IH L AH S IH T N AH S
ILLICITNESSES	IH L AH S IH T N EH S AH Z
ILLIMITABILITIES	IH L IH M AH T AH B IH L AH T EH Z
ILLIMITABILITY	IH L IH M AH T AH B IH L AH T EH
ILLIMITABLE	IH L IH M AH T AH B AH L
ILLIMITABLENESS	IH L IH M AH T AH B AH L N AH S
ILLIMITABLENESSES	IH L IH M AH T AH B AH L N AH S IH Z
ILLIMITABLY	IH L IH M AH T AH B L IY
ILLINIUM	IH L IH N IY AH M
ILLINIUMS	IH L IH N IY AH M Z
ILLIQUID	IH L IH K W IH D
ILLIQUIDITIES	IH L IH K W IH D AH T IY Z
ILLIQUIDITY	IH L IH K W IH D IH T IY
ILLITE	IH L AY T
ILLITERACIES	IH L IH T ER AH S IY Z
ILLITERACY	IH L IH T ER AH S IY
ILLITERATE	IH L IH T ER AH T
ILLITERATELY	IH L IH T ER AH T L IY
ILLITERATENESS	IH L IH T ER AH T N AH S
ILLITERATENESSES	IH L IH T ER AH T N AH S IH Z
ILLITERATES	IH L IH T ER AH T S
ILLITES	IH L AY T S
ILLITIC	IH L IH T IH K
ILLNESS	IH L N AH S
ILLNESSES	IH L N AH S IH Z
ILLOCUTIONARY	IH L OW K Y UW SH AH N EH R IY
ILLOGIC	IH L AA JH IH K
ILLOGICAL	IH L AA JH IH K AH L
ILLOGICALITIES	IH L AA JH IH K AH L AH T IY Z
ILLOGICALITY	IH L AA JH IH K AH L AH T IY
ILLOGICALLY	IH L AA JH IH K AH L IY
ILLOGICALNESS	IH L AA JH IH K AH L N AH S
ILLOGICALNESSES	IH L AA JH IH K AH L N AH S IH Z
ILLOGICS	IH L AA JH IH K S
ILLS	IH L Z
ILLUME	IH L UW M
ILLUMED	IH L UW M D
ILLUMES	IH L UW M Z
ILLUMINABLE	IH L UW M AH N AH B AH L
ILLUMINANCE	IH L UW M AH N AH N S
ILLUMINANCES	IH L UW M AH N AH N S IH Z
ILLUMINANT	IH L UW M AH N AH N T
ILLUMINANTS	IH L UW M AH N AH N T S
ILLUMINATE	IH L UW M IH N IH T
ILLUMINATED	IH L UW M AH N EY T AH D
ILLUMINATES	IH L UW M AH N EY T S
ILLUMINATI	IH L AH M IH N AH T IY
ILLUMINATING	IH L UW M AH N EY T IH NG
ILLUMINATINGLY	IH L UW M AH N AH T IH NG L IY
ILLUMINATION	IH L UW M AH N EY SH AH N
ILLUMINATIONS	IH L UW M AH N EY SH AH N Z
ILLUMINATIVE	IH L UW M AH N AH T IH V
ILLUMINATOR	IH L UW M AH N EY T ER
ILLUMINATORS	IH L UW M AH N AH T ER Z
ILLUMINE	IH L UW M AH N
ILLUMINED	IH L UW M AH N D
ILLUMINES	IH L UW M AH N Z
ILLUMING	IH L UW M AH NG
ILLUMINING	IH L UW M AH N IH NG
ILLUMINISM	IH L UW M AH N IH Z AH M
ILLUMINISMS	IH L UW M AH N IH Z AH M Z
ILLUMINIST	IH L UW M AH N IH S T
ILLUMINISTS	IH L UW M AH N IH S T S
ILLUSION	IH L UW ZH AH N
ILLUSIONAL	IH L UW ZH AH N AH L
ILLUSIONARY	IH L UW ZH AH N EH R IY
ILLUSIONISM	IH L UW ZH AH N IH Z AH M
ILLUSIONISMS	IH L UW ZH AH N IH Z AH M Z
ILLUSIONIST	IH L UW ZH AH N AH S T
ILLUSIONISTIC	IH L UW ZH AH N IH S T IH K
ILLUSIONISTICALLY	IH L UW ZH AH N IH S T IH K AH L IY
ILLUSIONISTS	IH L UW ZH AH N AH S T S
ILLUSIONS	IH L UW ZH AH N Z
ILLUSIVE	IH L UW S IH V
ILLUSIVELY	IH L UW S IH V L IY
ILLUSIVENESS	IH L UW S IH V N AH S
ILLUSIVENESSES	IH L UW S IH V N AH S IH Z
ILLUSORILY	IH L UW S AH R IY L IY
ILLUSORINESS	IH L UW S AH R IY N AH S
ILLUSORINESSES	IH L UW S AH R IY N AH S IH Z
ILLUSORY	IH L UW S ER IY
ILLUSTRATE	IH L AH S T R EY T
ILLUSTRATED	IH L AH S T R EY T AH D
ILLUSTRATED(2)	IH L AH S T R EY T IH D
ILLUSTRATES	IH L AH S T R EY T S
ILLUSTRATING	IH L AH S T R EY T IH NG
ILLUSTRATION	IH L AH S T R EY SH AH N
ILLUSTRATIONAL	IH L AH S T R EY SH AH N AH L
ILLUSTRATIONS	IH L AH S T R EY SH AH N Z
ILLUSTRATIVE	IH L AH S T R AH T IH V
ILLUSTRATIVELY	IH L AH S T R AH T IH V L IY
ILLUSTRATOR	IH L AH S T R EY T ER
ILLUSTRATORS	IH L AH S T R EY T ER Z
ILLUSTRIOUS	IH L AH S T R IY AH S
ILLUSTRIOUSLY	IH L AH S T R IY AH S L IY
ILLUSTRIOUSNESS	IH L AH S T R IY AH S N AH S
ILLUSTRIOUSNESSES	IH L AH S T R IY AH S N AH S IH Z
ILLUVIA	IH L UW V IY AH
ILLUVIAL	IH L UW V IY AH L
ILLUVIATED	IH L UW V AY EY T AH D
ILLUVIATION	IH L UW V AY EY SH AH N
ILLUVIATIONS	IH L UW V IY EY T IY AH N Z
ILLUVIUM	IH L UW V IY AH M
ILLUVIUMS	IH L UW V IY AH M Z
ILLY	IH L IY
IMAGISTICALLY	IH M EY JH IH S T IH K AH L IY
IMMEMORIALLY	IH M AH M OW R IY AH L IY
IMMETHODICALLY	IH M AH TH AA D IH K AH L IY
IMMORALLY	IH M AO R AH L IY
IMMORTALLY	IH M AO R T AH L IY
IMMORTELLE	IH M AO R T AH L
IMMORTELLES	IH M AO R T AH L Z
IMMUNOCHEMICALLY	IH M Y AH N AH K EH M AH K AE L IY
IMMUNOCYTOCHEMICALLY	IH M Y AH N AA S AH T AH K EH M AH K AE L IY
IMMUNOELECTROPHORETICALLY	IH M Y UW N OW AH L EH K T R AH F AH R EH T AH K AE L IY
IMMUNOGENETICALLY	IH M Y UW N AH JH AH N EH T AH K AE L IY
IMMUNOLOGICALLY	IH M Y AH N AH L AA JH AH K AE L IY
IMPANELLED	IH M P AE N AH L D
IMPANELLING	IH M P AE N AH L IH NG
IMPARTIALLY	IH M P AA R SH AH L IY
IMPELLED	IH M P EH L D
IMPELLER	IH M P EH L ER
IMPELLERS	IH M P EH L ER Z
IMPELLING	IH M P EH L IH NG
IMPELLOR	IH M P EH L ER
IMPELLORS	IH M P EH L ER Z
IMPERIALISTICALLY	IH M P IH R IY AH L IH S T IH K AH L IY
IMPERIALLY	IH M P IH R IY AH L IY
IMPERILLED	IH M P EH R AH L D
IMPERILLING	IH M P EH R AH L IH NG
IMPERSONALLY	IH M P ER S AH N AH L IY
IMPOLITICALLY	IH M P AH L IH T IH K AH L IY
IMPRACTICALLY	IH M P R AE K T IH K AH L IY
IMPRESSIONISTICALLY	IH M P R EH SH AH N IH S T IH K AH L IY
IMPROVISATIONALLY	IH M P R AA V AH Z EY SH AH N AH L IY
INARTISTICALLY	IH N AA R T IH S T IH K AH L IY
INCIDENTALLY	IH N S IH D EH N T AH L IY
INCIDENTALLY(2)	IH N S IH D EH N T L IY
INCONSEQUENTIALLY	IH N K AA N S AH K W EH N CH AH L IY
INCONTROLLABLE	IH N K AH N T R OW L AH B AH L
INCORPOREALLY	IH N K AO R P OW R IY AH L IY
INCREMENTALLY	IH N K R AH M EH N T AH L IY
INDIVIDUALISTICALLY	IH N D AH V IH JH AH W AH L IH S T IH K AH L IY
INDIVIDUALLY	IH N D IH V IH JH UW AH L IY
INDIVIDUALLY(2)	IH N D IH V IH JH AH L IY
INDUSTRIALLY	IH N D AH S T R IY AH L IY
INDWELL	IH N D W EH L
INDWELLER	IH N D W EH L ER
INDWELLERS	IH N D W EH L ER Z
INDWELLING	IH N D W EH L IH NG
INDWELLS	IH N D W EH L Z
INEFFECTUALLY	IH N IH F EH K CH AH W AH L IY
INERTIALLY	IH N ER SH AH L IY
INFALL	IH N F AO L
INFALLIBILITIES	IH N F AE L AH B IH L AH T IY Z
INFALLIBILITY	IH N F AE L IH B IH L IH T IY
INFALLIBLE	IH N F AE L AH B AH L
INFALLIBLY	IH N F AE L AH B L IY
INFALLING	IH N F AO L IH NG
INFALLS	IH N F AO L Z
INFERENTIALLY	IH N F AH R EH N CH AH L IY
INFERNALLY	IH N F ER N AH L IY
INFINITESIMALLY	IH N F IH N AH T EH S AH M AH L IY
INFLECTIONALLY	IH N F L EH K SH AH N AH L IY
INFLUENTIALLY	IH N F L UW EH N CH AH L IY
INFORMALLY	IH N F AO R M AH L IY
INFORMATIONALLY	IH N F ER M EY SH AH N AH L IY
INIMICALLY	IH N IH M IH K AH L IY
INITIALLED	IH N IH SH AH L D
INITIALLING	IH N IH SH AH L IH NG
INITIALLY	IH N IH SH AH L IY
INKWELL	IH NG K W EH L
INKWELLS	IH NG K W EH L Z
INORGANICALLY	IH N AO R G AE N IH K AH L IY
INQUISITORIALLY	IH N K W IH Z AH T ER IY AH L IY
INSCROLL	IH N S R AO L
INSCROLLED	IH N S R AA L D
INSCROLLING	IH N S R AA L AH NG
INSCROLLS	IH N S R AA L Z
INSECTICIDALLY	IH N S EH K T AH S AY D AH L IY
INSIGHTFULLY	IH N S AY T F AH L IY
INSPIRATIONALLY	IH N S P AH R EY SH AH N AH L IY
INSTALL	IH N S T AO L
INSTALLATION	IH N S T AH L EY SH AH N
INSTALLATIONS	IH N S T AH L EY SH AH N Z
INSTALLED	IH N S T AO L D
INSTALLER	IH N S T AO L ER
INSTALLERS	IH N S T AO L ER Z
INSTALLING	IH N S T AO L IH NG
INSTALLMENT	IH N S T AO L M AH N T
INSTALLMENTS	IH N S T AO L M AH N T S
INSTALLS	IH N S T AO L Z
INSTILL	IH N S T IH L
INSTILLATION	IH N S T IH L EY SH AH N
INSTILLATIONS	IH N S T IH L EY SH AH N Z
INSTILLED	IH N S T IH L D
INSTILLER	IH N S T IH L ER
INSTILLERS	IH N S T IH L ER Z
INSTILLING	IH N S T IH L IH NG
INSTILLMENT	IH N S T IH L M AH N T
INSTILLMENTS	IH N S T IH L M AH N T S
INSTILLS	IH N S T IH L Z
INSTINCTUALLY	IH N S T IH NG K CH AH W AH L IY
INSTITUTIONALLY	IH N S T IH T UW SH AH N AH L IY
INSTRUMENTALLY	IH N S T R AH M EH N T AH L IY
INTEGRALLY	IH N T AH G R AH L IY
INTELLECT	IH N T AH L EH K T
INTELLECT(2)	IH N AH L EH K T
INTELLECTION	IH N T AH L EH K SH AH N
INTELLECTIONS	IH N T AH L EH K SH AH N Z
INTELLECTIVE	IH N T AH L EH K T IH V
INTELLECTIVELY	IH N T AH L EH K T IH V L IY
INTELLECTS	IH N T AH L EH K T S
INTELLECTS(2)	IH N AH L EH K T S
INTELLECTS(3)	IH N T AH L EH K S
INTELLECTS(4)	IH N AH L EH K S
INTELLECTUAL	IH N T AH L EH K CH UW AH L
INTELLECTUAL(2)	IH N AH L EH K CH UW AH L
INTELLECTUALISM	IH N T EH L AH K CH UW AH L IH Z AH M
INTELLECTUALISM(2)	IH N EH L AH K CH UW AH L IH Z AH M
INTELLECTUALISMS	IH N T AH L EH K CH AH W AH L IH Z AH M Z
INTELLECTUALIST	IH N T AH L EH K CH AH W AH L IH S T
INTELLECTUALISTIC	IH N T AH L EH K CH AH W AH L IH S T IH K
INTELLECTUALISTS	IH N T AH L EH K CH AH W AH L IH S T S
INTELLECTUALITIES	IH N T AH L EH K CH AH W AE L AH T IY Z
INTELLECTUALITY	IH N T AH L EH K CH AH W AE L AH T IY
INTELLECTUALIZATION	IH N T AH L EH K CH AH W AH L AH Z EY SH AH N
INTELLECTUALIZATIONS	IH N T AH L EH K CH AH W AH L AH Z EY SH AH N Z
INTELLECTUALIZE	IH N T AH L EH K CH AH W AH L AY Z
INTELLECTUALIZED	IH N T AH L EH K CH AH W AH L AY Z D
INTELLECTUALIZER	IH N T AH L EH K CH AH W AH L AY Z ER
INTELLECTUALIZERS	IH N T AH L EH K CH AH W AH L AY Z ER Z
INTELLECTUALIZES	IH N T AH L EH K CH AH W AH L AY Z IH Z
INTELLECTUALIZING	IH N T AH L EH K CH AH W AH L AY Z IH NG
INTELLECTUALLY	IH N T AH L EH K CH UW AH L IY
INTELLECTUALLY(2)	IH N T AH L EH K CH UW L IY
INTELLECTUALLY(3)	IH N AH L EH K CH UW AH L IY
INTELLECTUALLY(4)	IH N AH L EH K CH UW L IY
INTELLECTUALNESS	IH N T AH L EH K CH AH W AH L N AH S
INTELLECTUALNESSES	IH N T AH L EH K CH AH W AH L N AH S IH Z
INTELLECTUALS	IH N T AH L EH K CH UW AH L Z
INTELLIGENCE	IH N T EH L AH JH AH N S
INTELLIGENCER	IH N T EH L AH JH AH N S ER
INTELLIGENCERS	IH N T EH L AH JH AH N S ER Z
INTELLIGENCES	IH N T EH L AH JH AH N S IH Z
INTELLIGENT	IH N T EH L AH JH AH N T
INTELLIGENTIAL	IH N T EH L AH JH AH N T IY AH L
INTELLIGENTLY	IH N T EH L IH JH AH N T L IY
INTELLIGENTSIA	IH N T EH L AH JH EH N T S IY AH
INTELLIGENTSIAS	IH N T EH L AH JH EH N T S IY AH Z
INTELLIGIBILITIES	IH N T EH L AH JH AH B IH L AH T IY Z
INTELLIGIBILITY	IH N T EH L AH JH AH B IH L AH T IY
INTELLIGIBLE	IH N T EH L AH JH AH B AH L
INTELLIGIBLENESS	IH N T EH L AH JH AH B AH L N AH S
INTELLIGIBLENESSES	IH N T EH L AH JH AH B AH L N AH S IH Z
INTELLIGIBLY	IH N T EH L AH JH AH B L IY
INTENSIONALLY	IH N T EH N CH AH N AH L IY
INTENTIONALLY	IH N T EH N SH AH N AH L IY
INTERALLELIC	IH N T AH R AE L AH L AH K
INTERALLIED	IH N T ER AH L AY D
INTERCELL	IH N T ER S EH L
INTERCELLULAR	IH N T ER S EH L Y AH L ER
INTERCOLLEGIATE	IH N T ER K AH L IY JH AH T
INTERCRYSTALLINE	IH N T ER K R IH S T AH L AH N
INTERCULTURALLY	IH N T ER K AH L CH ER AH L IY
INTERDENTALLY	IH N T ER D EH N T AH L IY
INTERDEPARTMENTALLY	IH N T ER D IH P AA R T M EH N T AH L IY
INTERFEROMETRICALLY	IH N T AH R F EH R AH M EH T R AH K AE L IY
INTERJECTIONALLY	IH N T ER JH EH K SH AH N AH L IY
INTERMETALLIC	IH N T ER M AH T AE L IH K
INTERMETALLICS	IH N T ER M AH T AE L IH K S
INTERNALLY	IH N T ER N AH L IY
INTERNATIONALLY	IH N T ER N AE SH AH N AA L IY
INTERNATIONALLY(2)	IH N T ER N AE SH N AA L IY
INTERNATIONALLY(3)	IH N ER N AE SH AH N AA L IY
INTERNATIONALLY(4)	IH N ER N AE SH N AA L IY
INTERPELLATE	IH N T ER P EH L AH T
INTERPELLATED	IH N T ER P EH L EY T IH D
INTERPELLATES	IH N T ER P EH L AH T S
INTERPELLATING	IH N T ER P EH L EY T IH NG
INTERPELLATION	IH N T ER P EH L EY SH AH N
INTERPELLATIONS	IH N T ER P EH L EY SH AH N Z
INTERPELLATOR	IH N T ER P EH L AH T ER
INTERPELLATORS	IH N T ER P EH L AH T ER Z
INTERPERSONALLY	IH N T ER P ER S AH N AH L IY
INTERPUPILLARY	IH N T ER P Y UW P AH L EH R IY
INTERRACIALLY	IH N T ER R EY SH AH L IY
INTERSEXUALLY	IH N T ER S EH K SH AH W AH L IY
INTERSTELLAR	IH N T ER S T EH L ER
INTERSTITIALLY	IH N T ER S T IH SH AH L IY
INTERTEXTUALLY	IH N T ER T EH K S CH AH W AH L IY
INTERTIDALLY	IH N T ER T AY D AH L IY
INTERTILL	IH N T ER T IH L
INTERTILLAGE	IH N T ER T IH L IH JH
INTERTILLAGES	IH N T ER T IH L IH JH IH Z
INTERTILLED	IH N T ER T IH L D
EOSIN	IY AH S AH N
BO	B OW
LIKABILITIES	L AY K AH B IH L AH T EH Z
BO	B OW
RYA	R AY AH
EDGY	EH JH IY
IAMB	AY AH M
