ME	M IY
ABANDONMENT	AH B AE N D AH N M AH N T
ABANDONMENTS	AH B AE N D AH N M AH N T S
ABASEMENT	AH B EY S M AH N T
ABASEMENTS	AH B EY S M AH N T S
ABASHMENT	AH B AE SH M AH N T
ABASHMENTS	AH B AE SH M AH N T S
ABATEMENT	AH B EY T M AH N T
ABATEMENTS	AH B EY T M AH N T S
ABDOMEN	AE B D OW M AH N
ABDOMEN(2)	AE B D AH M AH N
ABDOMENS	AE B D AH M AH N Z
ABETMENT	AH B EH T M AH N T
ABETMENTS	AH B EH T M AH N T S
ABOLISHMENT	AH B AA L IH SH M AH N T
ABOLISHMENTS	AH B AA L IH SH M AH N T S
ABRIDGEMENT	AH B R IH JH M AH N T
ABRIDGEMENTS	AH B R IH JH M AH N T S
ABRIDGMENT	AH B R IH JH M AH N T
ABRIDGMENTS	AH B R IH JH M AH N T S
ABUTMENT	AH B AH T M AH N T
ABUTMENTS	AH B AH T M AH N T S
ACADEME	AE K AH D IY M
ACADEMES	AE K AH D IY M Z
ACCELEROMETER	AE K S EH L ER AA M AH T ER
ACCELEROMETERS	AE K S EH L ER AA M AH T ER Z
ACCLAIMED	AH K L EY M D
ACCLAIMER	AH K L EY M ER
ACCLAIMERS	AH K L EY M ER Z
ACCOMPANIMENT	AH K AH M P N IH M AH N T
ACCOMPANIMENT(2)	AH K AH M P N IY M AH N T
ACCOMPANIMENTS	AH K AH M P N IH M AH N T S
ACCOMPANIMENTS(2)	AH K AH M P N IY M AH N T S
ACCOMPLISHMENT	AH K AA M P L IH SH M AH N T
ACCOMPLISHMENTS	AH K AA M P L IH SH M AH N T S
ACCOUCHEMENT	AE K AW CH M AH N T
ACCOUCHEMENTS	AE K AW K AH M AH N T S
ACCOUTERMENT	AH K UW T ER M AH N T
ACCOUTERMENTS	AH K UW T ER M AH N T S
ACCOUTREMENT	AH K UW T ER M AH N T
ACCOUTREMENTS	AH K UW T ER M AH N T S
ACCRUEMENT	AH K R UW M AH N T
ACCRUEMENTS	AH K R UW M AH N T S
ACCUSTOMED	AH K AH S T AH M D
ACCUSTOMEDNESS	AH K AH S T AH M AH D N AH S
ACCUSTOMEDNESSES	AH K AH S T AH M AH D N AH S IH Z
ACHIEVEMENT	AH CH IY V M AH N T
ACHIEVEMENTS	AH CH IY V M AH N T S
ACIDIMETER	AE S AH D IH M AH T AH R
ACIDIMETERS	AE S AH D IH M AH T AH R Z
ACIDIMETRIC	AH S IH D AH M AH T R AH K
ACIDIMETRIES	AE S AH D AH M EH T R AY Z
ACIDIMETRY	AE S AH D AH M EH T R IY
ACKNOWLEDGEMENT	AE K N AA L IH JH M AH N T
ACKNOWLEDGEMENTS	AE K N AA L IH JH M AH N T S
ACKNOWLEDGMENT	AE K N AA L IH JH M AH N T
ACKNOWLEDGMENTS	AE K N AA L IH JH M AH N T S
ACME	AE K M IY
ACMES	AE K M Z
ACQUIREMENT	AH K W AY ER M AH N T
ACQUIREMENTS	AH K W AY ER M AH N T S
ACROMEGALIC	AE K R AA M AH G AH L AH K
ACROMEGALICS	AE K R AH M EH G AH L AH S Z
ACROMEGALIES	AE K R AH M EH G AH L AY Z
ACROMEGALY	AE K R AH M EH G AH L IY
ACROSOME	AE K R AH S AH M
ACROSOMES	AE K R AH S AH M Z
ACTINOMETER	AE K T AH N AA M AH T ER
ACTINOMETERS	AE K T AH N AA M AH T ER Z
ACTINOMETRIC	AE K T IH N AH M AH T R AH K
ACTINOMETRIES	AE K T AH N AH M EH T R AY Z
ACTINOMETRY	AE K T AH N AH M EH T R IY
ACUMEN	AH K Y UW M AH N
ACUMENS	AH K Y UW M AH N Z
ADEEMED	AH D IY M D
ADJOURNMENT	AH JH ER N M AH N T
ADJOURNMENTS	AH JH ER N M AH N T S
ADJUSTMENT	AH JH AH S T M AH N T
ADJUSTMENTAL	AH JH AH S T M AH N T AH L
ADJUSTMENTS	AH JH AH S T M AH N T S
ADMEASURE	AE D M IY ZH Y AH R
ADMEASURED	AE D M IY ZH Y AH R D
ADMEASUREMENT	AE D M AH S UH R M AH N T
ADMEASUREMENTS	AE D M AH S UH R AH M AH N T S
ADMEASURES	AE D M IY ZH Y AH R Z
ADMEASURING	AE D M IY ZH Y AH R AH NG
ADMEN	AE D M AH N
ADMONISHMENT	AE D M AA N IH SH M EH N T
ADMONISHMENTS	AE D M AA N IH SH M AH N T S
ADORNMENT	AH D AO R N M AH N T
ADORNMENTS	AH D AO R N M AH N T S
ADRENOCHROME	AE D R EH N AH K R OW M
ADRENOCHROMES	AE D R EH N AH K R OW M Z
ADVANCEMENT	AH D V AE N S M AH N T
ADVANCEMENTS	AH D V AE N S M AH N T S
ADVENTURESOME	AE D V EH N CH ER S AH M
ADVENTURESOMENESS	AH D V EH N CH ER S AH M N AH S
ADVENTURESOMENESSES	AH D V EH N CH ER S AH M N AH S IH Z
ADVERTISEMENT	AE D V ER T AH Z M AH N T
ADVERTISEMENT(2)	AE D V ER T AY Z M AH N T
ADVERTISEMENTS	AE D V ER T AY Z M AH N T S
ADVERTIZEMENT	AE D V ER T AY Z M AH N T
ADVERTIZEMENTS	AE D V ER T AY Z M AH N T S
ADVISEMENT	AH D V AY Z M AH N T
ADVISEMENTS	AH D V AY Z M AH N T S
AERODROME	EH R AH D R OW M
AERODROMES	EH R AH D R OW M Z
AEROGRAMME	AH R AA G R AH M
AEROGRAMMES	AH R AA G R AH M Z
AEROMECHANICS	EH R AH M EH CH AH N AH S Z
AEROMEDICAL	AH R AA M AH D IH S AH L
AEROMEDICINE	AH R AH M EH D AH S AY N
AEROMEDICINES	AH R AH M EH D AH S AY N Z
AEROMETER	AH R AA M AH T AH R
AEROMETERS	AH R AA M AH T AH R Z
AERONOMER	EH R AH N OW M AH R
AERONOMERS	AH R AA N AH M AH R Z
AFFIRMED	AH F ER M D
AFFIRMER	AH F ER M ER
AFFIRMERS	AH F ER M ER Z
AFFIXMENT	AH F IH K S M AH N T
AFFIXMENTS	AH F IH K S M AH N T S
AFLAME	AH F L EY M
AFOREMENTIONED	AH F AO R M EH N SH AH N D
AFTERTIME	AE F T ER T AY M
AFTERTIMES	AE F T ER T AY M Z
AGAMETE	AE G AH M IY T
AGAMETES	AE G AH M IY T S
AGGIORNAMENTO	AE JH IY AO R N AH M EH N T OW
AGGIORNAMENTOS	EY JH IY ER N EY M AH N T AA S
AGGLOMERATE	AH G L AA M ER EY T
AGGLOMERATED	AH G L AA M AH R EY T IH D
AGGLOMERATES	AH G L AA M AH R EY T S
AGGLOMERATING	AH G L AA M AH R EY T IH NG
AGGLOMERATION	AH G L AA M ER EY SH AH N
AGGLOMERATIONS	AH G L AA M AH R EY SH AH N Z
AGGLOMERATIVE	AH G L AA M AH R EY T IH V
AGGRANDIZEMENT	AE G R AH N D AY Z M AH N T
AGGRANDIZEMENT(2)	AH G R AE N D AY Z M AH N T
AGGRANDIZEMENTS	AE G R AH N D IH Z AH M AH N T S
AGGRIEVEMENT	AH G R IY V M AH N T
AGGRIEVEMENTS	AH G R IY V M AH N T S
AGLIMMER	AH G L IH M ER
AGNOMEN	AE G N OW M AH N
AGNOMENS	AE G N OW M AH N Z
AGREEMENT	AH G R IY M AH N T
AGREEMENTS	AH G R IY M AH N T S
AGRIBUSINESSMEN	AE G R AH B Y UW S AH N EH S M AH N
AIDMEN	EY D M EH N
AILMENT	EY L M AH N T
AILMENTS	EY L M AH N T S
AIMED	EY M D
AIMER	EY M ER
AIMERS	EY M ER Z
AIRDROME	AE AH R D R OW M
AIRDROMES	AE AH R D R OW M Z
AIRFRAME	EH R F R EY M
AIRFRAMES	EH R F R EY M Z
AIRMEN	EH R M EH N
AIRTIME	EH R T AY M
AIRTIMES	AH IH R T AY M Z
AIRWOMEN	AH IH R W IH M AH N
ALAMEDA	AE L AH M IY D AH
ALAMEDAS	AH L AE M AH D AH Z
ALARMED	AH L AA R M D
ALARUMED	AE L AH R UW M D
ALBUMEN	AE L B AH M AH N
ALBUMENS	AE L B AH M AH N Z
ALDERMEN	AO L D ER M IH N
ALDERWOMEN	AE L D AH R W AH M AH N
ALIGHTMENT	AH L AY T M AH N T
ALIGHTMENTS	AH L AY T M AH N T S
ALIGNMENT	AH L AY N M AH N T
ALIGNMENTS	AH L AY N M AH N T S
ALIMENT	AH L AY M AH N T
ALIMENTARY	AE L AH M EH N T ER IY
ALIMENTATION	AH L AY M AH N T EY SH AH N
ALIMENTATIONS	AH L AY M AH N T EY SH AH N Z
ALIMENTED	AH L AY M AH N T IH D
ALIMENTING	AH L AY M AH N T IH NG
ALIMENTS	AH L AY M AH N T S
ALINEMENT	AH L AY N M AH N T
ALINEMENTS	AH L AY N M AH N T S
ALKALIMETER	AE L K AH L AY M IY T ER
ALKALIMETERS	AE L K AH L AY M IY T ER Z
ALKALIMETRIES	AE L K AH L AY M IY T ER IY Z
ALKALIMETRY	AE L K AH L AY M IY T ER IY
ALLOMETRIC	AE L AH M AH T R AH K
ALLOMETRIES	AE L AH M EH T R AY Z
ALLOMETRY	AE L AH M EH T R IY
ALLOTMENT	AH L AA T M AH N T
ALLOTMENTS	AH L AA T M AH N T S
ALLUREMENT	AH L UH R M AH N T
ALLUREMENTS	AH L UH R M AH N T S
ALME	AE L M
ALMEH	AE L M
ALMEHS	AE L M AH Z
ALMEMAR	AE L M AH M AH R
ALMEMARS	AE L M AH M AH R Z
ALMES	AE M Z
ALMSMEN	AE L M Z M AH N
ALPHAMERIC	AE L F AH M IH ER IH K
ALPHANUMERIC	AE L F AH N UW M EH R IH K
ALPHANUMERICAL	AE L F AH N UH M EH R IH K AH L
ALPHANUMERICALLY	AE L F AH N UH M EH R IH K AH L IY
ALPHANUMERICS	AE L F AH N UW M ER IH K S
ALTIMETER	AE L T IH M AH T ER
ALTIMETERS	AE L T IH M AH T ER Z
ALTIMETRIES	AE L T AH M EH T R AY Z
ALTIMETRY	AE L T IH M AH T R IY
AMASSMENT	AH M AE S M AH N T
AMASSMENTS	AH M AE S M AH N T S
AMAZEMENT	AH M EY Z M AH N T
AMAZEMENTS	AH M EY Z M AH N T S
AMBUSHMENT	AE M B UH SH M AH N T
AMBUSHMENTS	AE M B UH SH M AH N T S
AMEBA	AE M AH B AH
AMEBAE	AE M AH B IY
AMEBAN	AE M AH B AH N
AMEBAS	AE M AH B AH Z
AMEBEAN	AH M IY B IY AH N
AMEBIASES	AH M IY B IY EY Z AH Z
AMEBIASIS	AE M AH B IY AH S AH S
AMEBIC	AE M AH B AH K
AMEBOCYTE	AH M EH B AH S AY T
AMEBOCYTES	AH M EH B AH S AY T S
AMEBOID	AE M AH B OY D
AMEER	EY M IH R
AMEERATE	EY M AH R EY T
AMEERATES	EY M AH R EY T S
AMEERS	EY M AH R Z
AMELCORN	AH M EH L K AH R N
AMELCORNS	AH M EH L K AH R N Z
AMELIORATE	AH M IY L Y ER EY T
AMELIORATED	AH M IY L IY ER EY T IH D
AMELIORATED(2)	AH M IY L Y ER EY T IH D
AMELIORATES	AH M IY L IY AH R EY T S
AMELIORATING	AH M IY L IY AH R EY T AH NG
AMELIORATION	AH M IY L Y ER EY SH AH N
AMELIORATIONS	AH M IY L Y AH R EY SH AH N Z
AMELIORATIVE	AH M IY L IY AH R EY T AH V
AMELIORATOR	AH M IY L IY AH R EY T AH R
AMELIORATORS	AH M IY L IY AO R AH T AH R Z
AMELIORATORY	AE M AH L IY AH R AH T AO R IY
AMELOBLAST	AE M AH L AA B L AH S T
AMELOBLASTS	AE M AH L AA B L AH S T S
AMEN	EY M EH N
AMEN(2)	AA M EH N
AMENABILITIES	AH M EH N AH B IH L AH T EH Z
AMENABILITY	AH M EH N AH B IH L AH T EH
AMENABLE	AH M EH N AH B AH L
AMENABLE(2)	AH M IY N AH B AH L
AMENABLY	AH M EH N AH B L IY
AMEND	AH M EH N D
AMENDABLE	AH M EH N D AH B AH L
AMENDATORY	AH M EH N D AH T OW R IY
AMENDED	AH M EH N D IH D
AMENDER	AH M EH N D ER
AMENDERS	AH M EH N D ER Z
AMENDING	AH M EH N D IH NG
AMENDMENT	AH M EH N D M AH N T
AMENDMENTS	AH M EH N D M AH N T S
AMENDS	AH M EH N D Z
AMENITIES	AH M EH N AH T IY Z
AMENITY	AH M EH N AH T IY
AMENORRHEA	AH M EH N ER R IY AH
AMENORRHEAS	AH M EH N ER R IY AH Z
AMENORRHEIC	AE M AH N AO R IY AH K
AMENS	AH M EH N Z
AMENT	AE M IH N T
AMENTIA	AH M EH N CH IY AH
AMENTIAS	AH M EH N T IY AH Z
AMENTIFEROUS	AH M EH N T IH F AH R AH S
AMENTS	AE M AH N T S
AMERCE	AE M AH R S
AMERCED	AE M AH R S T
AMERCEMENT	AH M AH R S M AH N T
AMERCEMENTS	AH M AH R S AH M AH N T S
AMERCER	AH M ER S ER
AMERCERS	AH M ER S ER Z
AMERCES	AH M AH R S AH Z
AMERCIABLE	AH M ER S IY AH B AH L
AMERCING	AH M AH R S AH NG
AMERICIUM	AE M AH R IH S IY AH M
AMERICIUMS	AE M AH R IH S IY AH M Z
AMESACE	AE M AH Z AH S
AMESACES	AH M EH Z AH S AH Z
AMETHYST	AE M IH TH IH S T
AMETHYSTINE	AE M AH TH IH S T AH N
AMETHYSTS	AE M AH TH AH S T S
AMETROPIA	AE M AH T R OW P IY AH
AMETROPIAS	AE M AH T R OW P IY AH Z
AMETROPIC	AH M EH T R OW P IH K
AMMETER	AE M IY T ER
AMMETERS	AE M IY T ER Z
AMPEROMETRIC	AE M P EH R AH M AH T R AH K
AMUSEMENT	AH M Y UW Z M AH N T
AMUSEMENTS	AH M Y UW Z M AH N T S
ANAGRAMMED	AE N AH G R AE M D
ANALCIME	AE N AH L S AY M
ANALCIMES	AE N AH L S AY M Z
ANCHORMEN	AE NG K ER M EH N
ANCHORWOMEN	AE NG K ER W IH M AH N
ANDROMEDA	AE N D R AA M AH D AH
ANDROMEDAS	AE N D R AA M AH D AH Z
ANEMOMETER	AE N AH M AA M AH T ER
ANEMOMETERS	AE N AH M AA M AH T AH R Z
ANEMOMETRIES	AE N AH M AH M EH T R AY Z
ANEMOMETRY	AE N AH M AH M EH T R IY
ANIME	AH N AY M
ANIMES	AH N AY M Z
ANISOMETROPIA	AH N IH S AH M AH T R OW P IY AH
ANISOMETROPIAS	AH N IH S AH M AH T R OW P IY AH Z
ANISOMETROPIC	AE N AH S AH M EH T R AH P AH K
ANNOUNCEMENT	AH N AW N S M EH N T
ANNOUNCEMENTS	AH N AW N S M EH N T S
ANNULMENT	AE N AH L M AH N T
ANNULMENTS	AE N AH L M AH N T S
ANOINTMENT	AH N OY N T M AH N T
ANOINTMENTS	AH N OY N T M AH N T S
ANTHEMED	AE N TH AH M D
ANTHROPOMETRIC	AE N TH R AA P AH M AH T R AH K
ANTHROPOMETRIES	AE N TH R AH P AH M EH T R AY Z
ANTHROPOMETRY	AE N TH R AH P AH M EH T R IY
ANTICOMMERCIAL	AE N T AY K AH M ER SH AH L
ANTICOMMERCIALISM	AE N T AY K AH M ER SH AH L IH Z AH M
ANTICOMMERCIALISMS	AE N T AY K AH M ER SH AH L IH Z AH M Z
ANTICONGLOMERATE	AE N T AY K AH N G L AA M ER AH T
ANTICONSUMER	AE N T AY K AH N S UW M ER
ANTICONSUMERS	AE N T AY K AH N S UW M ER Z
ANTICRIME	AE N T IY K R AY M
ANTICRIME(2)	AE N T AY K R AY M
ANTIDEVELOPMENT	AE N T AY D IH V EH L AH P M AH N T
ANTIEMETIC	AE N T IY M IY T IH K
ANTIEMETICS	AE N T IY M IY T IH K S
ANTIESTABLISHMENT	AE N T AY IH S T AE B L IH SH M AH N T
ANTIGOVERNMENT	AE N T IY G AH V ER M AH N T
ANTIGOVERNMENT(2)	AE N T AY G AH V ER M AH N T
ANTIMANAGEMENT	AE N T AY M AE N IH JH M AH N T
ANTIMANAGEMENTS	AE N T AY M AE N IH JH M AH N T S
ANTIMECHANIST	AE N T AY M EH K AH N AH S T
ANTIMECHANISTS	AE N T AY M EH K AH N AH S T S
ANTIMERE	AE N T AY M IH ER
ANTIMERES	AE N T AY M IH ER Z
ANTIMERGER	AE N T AY M ER JH ER
ANTIMETABOLIC	AE N T AY M EH T AH B AA L IH K
ANTIMETABOLICS	AE N T AY M EH T AH B AA L IH K S
ANTIMETABOLITE	AE N T AY M AH T AE B AH L AY T
ANTIMETABOLITES	AE N T AY M AH T AE B AH L AY T S
ANTIMETAPHYSICAL	AE N T AY M EH T AH F IH Z IH K AH L
ANTISENTIMENTAL	AE N T AY S EH N T AH M EH N T AH L
ANTISYMMETRIC	AE N T AY S AH M EH T R IH K
ANTIUNEMPLOYMENT	AE N T AY AH N IH M P L OY M AH N T
ANYTIME	EH N IY T AY M
APARTMENT	AH P AA R T M AH N T
APARTMENTAL	AH P AA R T M AH N T AH L
APARTMENTS	AH P AA R T M AH N T S
APOENZYME	AE P OW AH N Z AY M
APOENZYMES	AE P OW AH N Z AY M Z
APPEASEMENT	AH P IY Z M AH N T
APPEASEMENTS	AH P IY Z M AH N T S
APPOINTMENT	AH P OY N T M AH N T
APPOINTMENTS	AH P OY N T M AH N T S
APPORTIONMENT	AH P AO R SH AH N M AH N T
APPORTIONMENTS	AH P OW R SH AH N M AH N T S
APPRAISEMENT	AH P R EY Z M AH N T
APPRAISEMENTS	AH P R EY Z M AH N T S
ARBITRAMENT	AA R B IH T R AH M AH N T
ARBITRAMENTS	AA R B IH T R AH M AH N T S
ARGUMENT	AA R G Y AH M AH N T
ARGUMENTA	AA R G Y AH M EH N T AH
ARGUMENTATION	AA R G Y AH M EH N T EY SH AH N
ARGUMENTATIONS	AA R G Y AH M AH N T EY SH AH N Z
ARGUMENTATIVE	AA R G Y AH M EH N T AH T IH V
ARGUMENTATIVELY	AA R G Y AH M AH N T AH T IH V L IY
ARGUMENTIVE	AA R G Y AH M AH N T IH V
ARGUMENTS	AA R G Y AH M AH N T S
ARGUMENTUM	AA R G Y AH M EH N T AH M
ARITHMETIC	EH R IH TH M EH T IH K
ARITHMETIC(2)	ER IH TH M AH T IH K
ARITHMETICAL	AE R IH TH M EH T IH K AH L
ARITHMETICALLY	AE R IH TH M EH T IH K AH L IY
ARITHMETICIAN	AH R IH TH M AH T IH S IY AH N
ARITHMETICIANS	AH R IH TH M AH T IH S IY AH N Z
ARITHMETICS	AH R IH TH M AH T IH K S
ARMAMENT	AA R M AH M AH N T
ARMAMENTARIA	AA R M AH M AH N T AE R IY AH
ARMAMENTARIUM	AA R M AH M AH N T AE R IY AH M
ARMAMENTARIUMS	AA R M AH M AH N T AE R IY AH M Z
ARMAMENTS	AA R M AH M AH N T S
ARMED	AA R M D
ARMER	AA R M ER
ARMERS	AA R M ER Z
ARMET	AA R M AH T
ARMETS	AA R M AH T S
ARRAIGNMENT	ER EY N M AH N T
ARRAIGNMENTS	ER EY N M AH N T S
ARRANGEMENT	ER EY N JH M AH N T
ARRANGEMENTS	ER EY N JH M AH N T S
ARRESTMENT	AH R EH S T M AH N T
ARRESTMENTS	AH R EH S T M AH N T S
ARRONDISSEMENT	AE R AA N D IH S M AH N T
ARRONDISSEMENTS	AE R AH N D IH S AH M AH N T S
ARTILLERYMEN	AA R T IH L AH R IY M EH N
ASCERTAINMENT	AE S ER T EY N M AH N T
ASCERTAINMENTS	AE S ER T EY N M AH N T S
ASHAMED	AH SH EY M D
ASHAMEDLY	AH SH EY M AH D L IY
ASHMEN	AE SH M EH N
ASPARTAME	AE S P ER T EY M
ASPARTAMES	AH S P AA R T EY M Z
ASSEMBLYMEN	AH S EH M B L IY M IH N
ASSEMBLYWOMEN	AH S EH M B L IY W IH M AH N
ASSESSMENT	AH S EH S M AH N T
ASSESSMENTS	AH S EH S M AH N T S
ASSIGNMENT	AH S AY N M AH N T
ASSIGNMENTS	AH S AY N M AH N T S
ASSOILMENT	AE S OY L M AH N T
ASSOILMENTS	AE S OY L M AH N T S
ASSORTMENT	AH S AO R T M AH N T
ASSORTMENTS	AH S AO R T M AH N T S
ASSUAGEMENT	AH S W EY JH M AH N T
ASSUAGEMENTS	AH S W EY JH M AH N T S
ASSUME	AH S UW M
ASSUMED	AH S UW M D
ASSUMER	AH S UW M ER
ASSUMERS	AH S UW M ER Z
ASSUMES	AH S UW M Z
ASTONISHMENT	AH S T AA N IH SH M AH N T
ASTONISHMENTS	AH S T AA N IH SH M AH N T S
ASTRODOME	AE S T R AH D OW M
ASTRODOMES	AE S T R AH D OW M Z
ASTROMETRIC	AE S T R AH M AH T R AH K
ASTROMETRIES	AE S T R AH M EH T R AY Z
ASTROMETRY	AE S T R AH M EH T R IY
ASTRONOMER	AH S T R AA N AH M ER
ASTRONOMERS	AH S T R AA N AH M ER Z
ASYMMETRIC	EY S AH M EH T R IH K
ASYMMETRICAL	EY S AH M EH T R IH K AH L
ASYMMETRICALLY	EY S AH M EH T R IH K AH L IY
ASYMMETRIES	EY S IH M AH T R IY Z
ASYMMETRY	EY S IH M AH T R IY
ATMOMETER	AE T M AA M AH T AH R
ATMOMETERS	AE T M AA M AH T AH R Z
ATONEMENT	AH T OW N M AH N T
ATONEMENTS	AH T OW N M AH N T S
ATTACHMENT	AH T AE CH M AH N T
ATTACHMENTS	AH T AE CH M AH N T S
ATTACKMEN	AH T AE K M EH N
ATTAINMENT	AH T EY N M AH N T
ATTAINMENTS	AH T EY N M AH N T S
ATTORNMENT	AE T AO R N M AH N T
ATTORNMENTS	AE T AO R N M AH N T S
ATTUNEMENT	AH T UW N M AH N T
ATTUNEMENTS	AH T UW N M AH N T S
AUDIOMETER	AO D IY OW M IY T ER
AUDIOMETERS	AO D IY OW M IY T ER Z
AUDIOMETRIC	AO D IY OW M EH T R IH K
AUDIOMETRIES	AO D IY OW M IY T ER IY Z
AUDIOMETRY	AO D IY OW M IY T ER IY
AUGMENT	AO G M EH N T
AUGMENTATION	AA G M EH N T EY SH AH N
AUGMENTATIONS	AO G M EH N T EY SH AH N Z
AUGMENTATIVE	AO G M EH N T AH T IH V
AUGMENTATIVES	AO G M EH N T AH T IH V Z
AUGMENTED	AA G M EH N T AH D
AUGMENTER	AO G M EH N T ER
AUGMENTERS	AO G M EH N T ER Z
AUGMENTING	AO G M EH N T IH NG
AUGMENTOR	AO G M EH N T ER
AUGMENTORS	AO G M EH N T ER Z
AUGMENTS	AO G M EH N T S
AUSFORMED	AO S AH R M D
AUTOMEN	AO T OW M EH N
AUTOSOME	AO T OW S AH M
AUTOSOMES	AO T OW S AH M Z
AUTOTRANSFORMER	AO T OW T R AE N S F AO R M ER
AUTOTRANSFORMERS	AO T OW T R AE N S F AO R M ER Z
AVERMENT	AH V EH R M AH N T
AVERMENTS	AH V EH R M AH N T S
AVOUCHMENT	AH V AW CH M AH N T
AVOUCHMENTS	AH V AW CH M AH N T S
AWESOME	AA S AH M
AWESOME(2)	AO S AH M
AWESOMELY	AA S AH M L IY
AWESOMELY(2)	AO S AH M L IY
AWESOMENESS	AO S AH M N AH S
AWESOMENESSES	AO S AH M N AH S IH Z
AXEMEN	AE K S M EH N
AXISYMMETRIC	AE K S AH S IH M AH T R AH K
AXISYMMETRICAL	AE K S AH S IH M EH T R IH S AH L
AXISYMMETRIES	AE K S AH S IH M EH T R AY Z
AXISYMMETRY	AE K S AH S AH M EH T R IY
AXMEN	AE K S M EH N
AXONEME	AE K S AH N IY M
AXONEMES	AE K S AH N IY M Z
AXONOMETRIC	AE K S AA N AH M AH T R AH K
BABBLEMENT	B AE B AH L M AH N T
BABBLEMENTS	B AE B AH L M AH N T S
BACKCOURTMEN	B AE K OW R T M EH N
BACKWOODSMEN	B AE K W UH D Z M EH N
BADMEN	B AE D M EH N
BAFFLEMENT	B AE F AH L M AH N T
BAFFLEMENTS	B AE F AH L M AH N T S
BAGMEN	B AE G M EH N
BAILMENT	B EY L M AH N T
BAILMENTS	B EY L M AH N T S
BAILSMEN	B EY L Z M EH N
BAKEMEAT	B EY K M IY T
BAKEMEATS	B EY K M IY T S
BALLGAME	B AO L G EY M
BALLGAMES	B AO L G EY M Z
BALSAMED	B AO L S AH M D
BAMBOOZLEMENT	B AE M B UW Z L M AH N T
BAMBOOZLEMENTS	B AE M B UW Z L AH M AH N T S
BAMMED	B AE M D
BANDSMEN	B AE N D Z M EH N
BANISHMENT	B AE N IH SH M AH N T
BANISHMENTS	B AE N IH SH M AH N T S
BARGEMEN	B AA R JH EH M AH N
BARMEN	B AA R M EH N
BARNSTORMED	B AA R N S T AO R M D
BARNSTORMER	B AA R N S T AO R M ER
BARNSTORMERS	B AA R N S T AO R M ER Z
BAROMETER	B ER AA M IH T ER
BAROMETERS	B ER AA M IH T ER Z
BAROMETRIC	B AE R AH M EH T R IH K
BAROMETRICALLY	B AE R AH M EH T R IH K AH L IY
BAROMETRIES	B AE R AH M EH T R AY Z
BAROMETRY	B AE R AH M EH T R IY
BASEMEN	B EY S M EH N
BASEMENT	B EY S M AH N T
BASEMENTLESS	B EY S M AH N T L AH S
BASEMENTS	B EY S M AH N T S
BATHYMETRIC	B EY DH IY M EH T R IH K
BATHYMETRICAL	B EY DH IY M EH T R IH K AH L
BATHYMETRICALLY	B EY DH IY M EH T R IH K AH L IY
BATHYMETRIES	B EY DH IY M IY T ER IY Z
BATHYMETRY	B EY DH IY M IY T ER IY
BATMEN	B AE T M EH N
BATSMEN	B AE T S M EH N
BATTEMENT	B AE T M AH N T
BATTEMENTS	B AE T AH M AH N T S
BATTLEMENT	B AE T AH L M AH N T
BATTLEMENT(2)	B AE T AH L M EH N T
BATTLEMENTED	B AE T AH L M AH N T IH D
BATTLEMENTS	B AE T AH L M AH N T S
BAYMEN	B EY M EH N
BEADMEN	B IY D M EH N
BEADSMEN	B IY D Z M EH N
BEAMED	B IY M D
BECALMED	B IH K AA M D
BECAME	B IH K EY M
BECAME(2)	B IY K EY M
BECHAMEL	B AH CH AE M AH L
BECHAMELS	B AH CH AE M AH L Z
BECHARMED	B IH CH AA R M D
BECOME	B IH K AH M
BECOMES	B IH K AH M Z
BECRIME	B IH K R AY M
BECRIMED	B IH K R AY M D
BECRIMES	B IH K R AY M Z
BEDAZZLEMENT	B IH D AE Z AH L M AH N T
BEDAZZLEMENTS	B IH D AE Z AH L M AH N T S
BEDEMEN	B IH D IY M EH N
BEDESMEN	B AH D EH Z M AH N
BEDEVILMENT	B IH D IY V IH L M AH N T
BEDEVILMENTS	B IH D IY V IH L M AH N T S
BEDFRAME	B EH D F R EY M
BEDFRAMES	B EH D F R EY M Z
BEDIMMED	B IH D IH M D
BEDIZENMENT	B EH D AY Z AH N M AH N T
BEDIZENMENTS	B EH D AY Z AH N M AH N T S
BEDROOMED	B EH D R UW M D
BEDTIME	B EH D T AY M
BEDTIMES	B EH D T AY M Z
BEFORETIME	B IH F OW R T AY M
BEFUDDLEMENT	B IH F AH D AH L M AH N T
BEFUDDLEMENTS	B IH F AH D AH L M AH N T S
BEGLOOMED	B IH G L UW M D
BEGRIME	B IH G R AY M
BEGRIMED	B IH G R AY M D
BEGRIMES	B IH G R AY M Z
BEGRIMMED	B IH G R IH M D
BEGUILEMENT	B IH G AY L M AH N T
BEGUILEMENTS	B IH G AY L M AH N T S
BELDAME	B EH L D EY M
BELDAMES	B EH L D EY M Z
BELEAGUERMENT	B IH L IY G ER M AH N T
BELEAGUERMENTS	B IH L IY G ER M AH N T S
BELITTLEMENT	B IH L IH T AH L M AH N T
BELITTLEMENTS	B IH L IH T AH L M AH N T S
BELLMEN	B EH L M EH N
BEMADAMED	B IH M AH D AE M D
BEMEAN	B IH M IY N
BEMEANED	B IH M IY N D
BEMEANING	B IH M IY N IH NG
BEMEANS	B IH M IY N Z
BEMEDALED	B IH M EH D AH L D
BEMEDALLED	B IH M EH D AH L D
BEMUSEMENT	B EH M Y UW S M AH N T
BEMUSEMENTS	B IH M Y UW Z M AH N T S
BENAME	B IH N EY M
BENAMED	B IH N EY M D
BENAMES	B IH N EY M Z
BENCHWARMER	B EH N CH W AO R M ER
BENCHWARMERS	B EH N CH W AO R M ER Z
BEREAVEMENT	B ER IY V M AH N T
BEREAVEMENTS	B IH R IY V M AH N T S
BERHYME	B IH R AY M
BERHYMED	B IH R AY M D
BERHYMES	B IH R AY M Z
BERIME	B IH R AY M
BERIMED	B IH R AY M D
BERIMES	B IH R AY M Z
BERME	B IH R M IY
BERMES	B AH R M Z
BESEEMED	B IH S IY M D
BESETMENT	B IH S EH T M AH N T
BESETMENTS	B IH S EH T M AH N T S
BESHAME	B IH SH EY M
BESHAMED	B IH SH EY M D
BESHAMES	B IH SH EY M Z
BESLIME	B IH S L AY M
BESLIMED	B IH S L AY M D
BESLIMES	B IH S L AY M Z
BESMEAR	B IH S M IH ER
BESMEARED	B IH S M IH ER D
BESMEARING	B IH S M IH ER IH NG
BESMEARS	B IH S M IH ER Z
BESWARMED	B IH S W AO R M D
BETIME	B IH T AY M
BETIMES	B IH T AY M Z
BETTERMENT	B EH T ER M AH N T
BETTERMENTS	B EH T ER M AH N T S
BETWEENTIMES	B IH T W IY N T AY M Z
BEWILDERMENT	B IH W IH L D ER M AH N T
BEWILDERMENTS	B IH W IH L D ER M AH N T S
BEWITCHMENT	B IH W IH CH M AH N T
BEWITCHMENTS	B IH W IH CH M AH N T S
BEWORMED	B IH W ER M D
BICAMERAL	B AY K AE M AH R AH L
BICAMERALISM	B AY K AE M AH R AH L IH Z AH M
BICAMERALISMS	B AY K AE M AH R AH L IH Z AH M Z
BICHROME	B AY K R OW M
BIFORMED	B AY F AO R M D
BIMENSAL	B AY M EH N Z AH L
BIMESTER	B AY M EH S T AH R
BIMESTERS	B AY M EH S T AH R Z
BIMETAL	B AY M EH T AH L
BIMETALLIC	B AY M AH T AE L IH K
BIMETALLICS	B AY M AH T AE L IH K S
BIMETALLISM	B AY M EH T AH L IH Z AH M
BIMETALLISMS	B AY M EH T AH L IH Z AH M Z
BIMETALLIST	B AY M EH T AH L IH S T
BIMETALLISTIC	B AY M EH T AH L IH S T IH K
BIMETALLISTS	B AY M EH T AH L IH S T S
BIMETALS	B AY M EH T AH L Z
BIMETHYL	B AY M EH TH AH L
BIMETHYLS	B AY M EH TH AH L Z
BIOME	B AY OW M
BIOMECHANICAL	B AY AH M EH CH AH N IH S AH L
BIOMECHANICALLY	B AY AH M AH CH AE N AH K AE L IY
BIOMECHANICS	B AY AH M EH CH AH N AH S Z
BIOMEDICAL	B AY OW M EH D IH K AH L
BIOMEDICINE	B AY AH M EH D AH S AY N
BIOMEDICINES	B AY AH M EH D AH S AY N Z
BIOMES	B AY OW M Z
BIOMETEOROLOGICAL	B AY AH M IY T IY AH R AA L AH JH IH S AH L
BIOMETEOROLOGIES	B AY AH M IY T IY AH R AA L AH JH AY Z
BIOMETEOROLOGY	B AY AH M IY T IY AH R AA L AH JH IY
BIOMETRIC	B AY AH M EH T R AH K
BIOMETRICAL	B AY AH M EH T R IH S AH L
BIOMETRICIAN	B AY AH M EH T R IH S IY AH N
BIOMETRICIANS	B AY AA M AH T R IH S IY AH N Z
BIOMETRICS	B AY AH M EH T R AH S Z
BIOMETRIES	B AY AH M EH T R AY Z
BIOMETRY	B AY AH M EH T R IY
BIOPOLYMER	B AY AA P AH L AY M AH R
BIOPOLYMERS	B AY AH P AA L AH M AH R Z
BIOREMEDIATION	B AY OW R M IY D IY EY SH AH N
BIOREMEDIATIONS	B AY OW R M IY D IY EY SH AH N Z
BIOTELEMETRIC	B AY AH T EH L AH M AH T R AH K
BIOTELEMETRIES	B AY AH T AH L AH M EH T R AY Z
BIOTELEMETRY	B AY AH T IY L M EH T R IY
BIRDLIME	B ER D L AY M
BIRDLIMED	B ER D L AY M D
BIRDLIMES	B ER D L AY M Z
BIRDMEN	B ER D M EH N
BIREME	B AY R IY M
BIREMES	B AY R IY M Z
BITUMEN	B IH T UW M AH N
BITUMEN(2)	B AY T UW M AH N
BITUMENS	B AY T UW M AH N Z
BLAME	B L EY M
BLAMED	B L EY M D
BLAMEFUL	B L EY M F AH L
BLAMEFULLY	B L EY M F AH L IY
BLAMELESS	B L EY M L AH S
BLAMELESSLY	B L EY M L AH S L IY
BLAMELESSNESS	B L EY M L AH S N AH S
BLAMELESSNESSES	B L EY M L AH S N AH S IH Z
BLAMER	B L EY M ER
BLAMERS	B L EY M ER Z
BLAMES	B L EY M Z
BLAMEWORTHINESS	B L EY M W ER DH IY N AH S
BLAMEWORTHINESSES	B L EY M W ER DH IY N AH S IH Z
BLAMEWORTHY	B L EY M W ER DH IY
BLANDISHMENT	B L AE N D IH SH M AH N T
BLANDISHMENTS	B L AE N D IH SH M AH N T S
BLASPHEME	B L AE S F IY M
BLASPHEMED	B L AE S F IY M D
BLASPHEMER	B L AE S F IY M ER
BLASPHEMERS	B L AE S F IY M ER Z
BLASPHEMES	B L AE S F IY M Z
BLASTMENT	B L AE S T M AH N T
BLASTMENTS	B L AE S T M AH N T S
BLASTOMERE	B L AE S T OW M AH R
BLASTOMERES	B L AE S T AH M IY R Z
BLIMEY	B L IH M IY
BLITHESOME	B L AY TH S AH M
BLITHESOMELY	B L AY TH S AH M L IY
BLOOMED	B L UW M D
BLOOMER	B L UW M ER
BLOOMERIES	B L UW M AH R IY Z
BLOOMERS	B L UW M ER Z
BLOOMERY	B L UW M AH R IY
BLOSSOMED	B L AA S AH M D
BLUESMEN	B L UW Z M EH N
BLUME	B L UW M
BLUMED	B L UW M D
BLUMES	B L UW M Z
BOARDMEN	B OW R D M EH N
BOATMEN	B OW T M EH N
BOATSMEN	B OW T S M EH N
BODEMENT	B OW D M AH N T
BODEMENTS	B OW D M AH N T S
BOGEYMEN	B OW G IY M IH N
BOGEYMEN(2)	B UH G IY M IH N
BOGYMEN	B OW G IY M EH N
BOLOMETER	B OW L OW M IY T ER
BOLOMETERS	B OW L OW M IY T ER Z
BOLOMETRIC	B OW L OW M EH T R IH K
BOLOMETRICALLY	B OW L OW M EH T R IH K AH L IY
BOMBARDMENT	B AA M B AA R D M AH N T
BOMBARDMENTS	B AA M B AA R D M AH N T S
BONDMEN	B AA N D M EH N
BONDSMEN	B AA N D Z M EH N
BONDWOMEN	B AA N D W IH M AH N
BONEMEAL	B OW N M IY L
BONEMEALS	B OW N M IY L Z
BOOGERMEN	B UW JH ER M AH N
BOOGEYMEN	B UW JH EY M AH N
BOOGYMEN	B UW JH AH M AH N
BOOKMEN	B UH K M EH N
BOOMED	B UW M D
BOOMER	B UW M ER
BOOMERANG	B UW M ER AE NG
BOOMERANGED	B UW M ER AE NG D
BOOMERANGING	B UW M AH R AE NG IH NG
BOOMERANGS	B UW M AH R AE NG Z
BOOMERS	B UW M ER Z
BORESOME	B AO R S AH M
BOSOMED	B UH Z AH M D
BOTHERSOME	B AA DH ER S AH M
BOTTOMED	B AA T AH M D
BOTTOMER	B AA T AH M ER
BOTTOMERS	B AA T AH M ER Z
BOULEVERSEMENT	B AW L AH V AH R S M AH N T
BOULEVERSEMENTS	B AW L AH V AH R S AH M AH N T S
BOWMEN	B OW M AH N
BRAINSTORMED	B R EY N S T AO R M D
BRAINSTORMER	B R EY N S T AO R M ER
BRAINSTORMERS	B R EY N S T AO R M ER Z
BRAKEMEN	B R EY K M EH N
BREAMED	B R IY M D
BRIMMED	B R IH M D
BRIMMER	B R IH M ER
BRIMMERS	B R IH M ER Z
BROME	B R OW M
BROMEGRASS	B R AH M EH G R AH S
BROMEGRASSES	B R AH M EH G R AE S AH Z
BROMELAIN	B R AA M AH L EY N
BROMELAINS	B R AA M AH L EY N Z
BROMELIAD	B R AH M IY L IY AH D
BROMELIADS	B R AH M IY L IY AH D Z
BROMELIN	B R AA M AH L AH N
BROMELINS	B R AA M AH L AH N Z
BROMES	B R OW M Z
BROOMED	B R UW M D
BRUME	B R UW M
BRUMES	B R UW M Z
BUCKRAMED	B AH K R AE M D
BUMMED	B AH M D
BUMMER	B AH M ER
BUMMERS	B AH M ER Z
BUMMEST	B AH M AH S T
BUNGLESOME	B AH NG G AH L S AH M
BURDENSOME	B ER D AH N S AH M
BUSHMEN	B UH SH M EH N
BUSINESSMEN	B IH Z N IH S M EH N
BUSINESSWOMEN	B IH Z N AH S W OW M AH N
BUSMEN	B AH S M EH N
BUXOMER	B AH K S AH M ER
BUXOMEST	B AH K S AH M AH S T
BYNAME	B AY N EY M
BYNAMES	B AY N EY M Z
CABMEN	K AE B M EH N
CAJOLEMENT	K AH JH OW L M AH N T
CAJOLEMENTS	K AH JH AA L AH M AH N T S
CALMED	K AA M D
CALMED(2)	K AA L M D
CALMER	K AA M ER
CALMER(2)	K AA L M ER
CALMEST	K AA M AH S T
CALMEST(2)	K AA L M AH S T
CALOMEL	K AE L AH M AH L
CALOMELS	K AE L AH M AH L Z
CALORIMETER	K AE L AH R IH M AH T ER
CALORIMETERS	K AE L AH R IH M AH T ER Z
CALORIMETRIC	K AH L AO R AH M EH T R IH K
CALORIMETRICALLY	K AH L AO R AH M EH T R IH K AH L IY
CALORIMETRIES	K AE L AH R AH M EH T R AY Z
CALORIMETRY	K AE L AH R AH M EH T R IY
CALUMET	K AE L Y AH M EH T
CALUMETS	K AH L UW M AH T S
CAME	K EY M
CAMEL	K AE M AH L
CAMELBACK	K AE M AH L B AE K
CAMELBACKS	K AE M AH L B AE K S
CAMELEER	K AE M AH L IH R
CAMELEERS	K AE M AH L IH R Z
CAMELIA	K AH M IY L Y AH
CAMELIAS	K AH M IY L Y AH Z
CAMELLIA	K AH M IY L Y AH
CAMELLIAS	K AH M IY L Y AH Z
CAMELOPARD	K AH M EH L AH P AH R D
CAMELOPARDS	K AH M EH L AH P AH R D Z
CAMELS	K AE M AH L Z
CAMEO	K AE M IY OW
CAMEOED	K AE M IY OW D
CAMEOING	K AE M IY OW IH NG
CAMEOS	K AE M IY OW Z
CAMERA	K AE M ER AH
CAMERA(2)	K AE M R AH
CAMERAE	K AE M AH R IY
CAMERAL	K AE M AH R AH L
CAMERAMAN	K AE M ER AH M AH N
CAMERAMEN	K AE M ER AH M EH N
CAMERAPERSON	K AE M R AH P ER S AH N
CAMERAPERSONS	K AE M R AH P ER S AH N Z
CAMERAS	K AE M ER AH Z
CAMERAS(2)	K AE M R AH Z
CAMERAWOMAN	K AE M R AH W UH M AH N
CAMERAWOMEN	K AE M R AH W IH M AH N
CAMERLENGO	K AE M AH R L EH N G OW
CAMERLENGOS	K AE M AH R L EH N G AH Z
CAMES	K EY M Z
CANTONMENT	K AE N T AH N M AH N T
CANTONMENTS	K AE N T AH N M AH N T S
CAPSOMER	K EY P S AH M ER
CAPSOMERS	K EY P S AH M ER Z
CARAMEL	K EH R AH M AH L
CARAMELISE	K AH R AE M AH L AY Z
CARAMELISED	K AA R M AH L IY Z D
CARAMELISES	K AA R M AH L IY Z IH Z
CARAMELISING	K AA R M AH L IY Z IH NG
CARAMELIZE	K EH R AH M AH L AY Z
CARAMELIZED	K EH R AH M AH L AY Z D
CARAMELIZES	K AA R M AH L AY Z IH Z
CARAMELIZING	K AA R M AH L AY Z IH NG
CARAMELS	K AA R M AH L Z
CARBOXYMETHYLCELLULOSE	K AA R B AA K S IY M EH TH AH L S EH L Y AH L OW S
CARBOXYMETHYLCELLULOSES	K AA R B AA K S IY M EH TH AH L S EH L Y AH L OW S IH
CARMEN	K AA R M AH N
CAROMED	K AH R OW M D
CARROMED	K AE R OW M D
CASEMENT	K EY S M AH N T
CASEMENTS	K EY S M AH N T S
CASHMERE	K AE ZH M IH R
CASHMERES	K AE ZH M IH R Z
CASIMERE	K AE S AH M AH R
CASIMERES	K AE S AH M IY R Z
CASSIMERE	K AE S AH M AH R
CASSIMERES	K AE S AH M IY R Z
CATAMENIA	K AE T AH M IY N Y AH
CATAMENIAL	K AE T AH M EH N IY AH L
CATCHMENT	K AE CH M AH N T
CATCHMENTS	K AE CH M AH N T S
CATECHUMEN	K EY T CH AH M AH N
CATECHUMENS	K EY T CH AH M AH N Z
CATTLEMEN	K AE T AH L M AH N
CATTLEMEN(2)	K AE T AH L M IH N
CAVALRYMEN	K AE V AH L R IY M EH N
CAVEMEN	K EY V M EH N
CEILOMETER	S IY AH L AA M AH T AH R
CEILOMETERS	S IY L AA M AH T AH R Z
CEMENT	S AH M EH N T
CEMENT(2)	S IH M EH N T
CEMENTA	S AH M EH N T AH
CEMENTATION	S IH M EH N T EY SH AH N
CEMENTATIONS	S IH M EH N T EY SH AH N Z
CEMENTED	S IH M EH N T IH D
CEMENTER	S IH M EH N T ER
CEMENTERS	S IH M EH N T ER Z
CEMENTING	S IH M EH N T IH NG
CEMENTITE	S EH M AH N T AY T
CEMENTITES	S EH M AH N T AY T S
CEMENTITIOUS	S IH M EH N T AH T IY AH S
CEMENTS	S IH M EH N T S
CEMENTUM	S AH M EH N T AH M
CEMENTUMS	S AH M EH N T AH M Z
CEMETERIES	S EH M AH T EH R IY Z
CEMETERY	S EH M AH T EH R IY
CEMETERY(2)	S EH M IH T EH R IY
CENTIME	S EH N T AY M
CENTIMES	S EH N T AY M Z
CENTIMETER	S EH N T AH M IY T ER
CENTIMETERS	S EH N T AH M IY T ER Z
CENTROMERE	S EH N T R OW M AH R
CENTROMERES	S EH N T R AH M IY R Z
CENTROMERIC	S EH N T R AH M AH R AH K
CENTROSOME	S EH N T R AH S AH M
CENTROSOMES	S EH N T R AH S AH M Z
CENTROSYMMETRIC	S EH N T R AH S IH M AH T R AH K
CEPHALOMETRIC	S AH F AE L AH M AH T R AH K
CEPHALOMETRIES	S EH F AH L AH M EH T R AY Z
CEPHALOMETRY	S EH F AH L AH M EH T R IY
CEREMENT	S IH R M AH N T
CEREMENTS	S EH R AH M AH N T S
CERMET	S AH R M AH T
CERMETS	S AH R M AH T S
CERUMEN	S AH R UW M AH N
CERUMENS	S AH R UW M AH N Z
CHAINMEN	CH EY N M EH N
CHAIRMEN	CH EH R M IH N
CHAIRWOMEN	CH EH R W IH M EH N
CHAMELEON	K AH M IY L IY AH N
CHAMELEONIC	CH AH M IY L IY AH N AH K
CHAMELEONLIKE	CH AH M IY L IY AH N L AY K
CHAMELEONS	CH AH M IY L IY AH N Z
CHAPMEN	CH AE P M EH N
CHARMED	CH AA R M D
CHARMER	CH AA R M ER
CHARMERS	CH AA R M ER Z
CHARMEUSE	CH AA R M Y UW Z
CHARMEUSES	CH AA R M IY AH Z AH Z
CHARWOMEN	CH AA R W IH M AH N
CHASMED	K AE Z AH M D
CHASTISEMENT	CH AE S T AY Z M AH N T
CHASTISEMENTS	CH AE S T AY Z M AH N T S
CHESSMEN	CH EH S M EH N
CHIME	CH AY M
CHIMED	CH AY M D
CHIMER	CH AY M ER
CHIMERA	CH IH M EH R AH
CHIMERAS	CH IH M AH R AH Z
CHIMERE	CH IH M AH R
CHIMERES	CH AH M IY R Z
CHIMERIC	CH AY M ER IH K
CHIMERICAL	K IH M EH R AH K AH L
CHIMERICALLY	CH AY M ER IH K AH L IY
CHIMERISM	CH AY M ER IH Z AH M
CHIMERISMS	CH AY M ER IH Z AH M Z
CHIMERS	CH AY M ER Z
CHIMES	CH AY M Z
CHIRMED	CH AH R M D
CHLOROFLUOROMETHANE	K L AH R AH F L AH W AH R AA M AH TH EY N
CHLOROFLUOROMETHANES	K L AH R AH F L AH W AH R AA M AH TH EY N Z
CHLOROFORMED	K L AO R AH F AH R M D
CHONDRIOSOME	CH AA N D R IY AH S AH M
CHONDRIOSOMES	CH AA N D R IY AH S AH M Z
CHORDAMESODERM	CH AO R D AH M EH S AH D AH R M
CHORDAMESODERMAL	CH AO R D AH M EH S AH D AH R M AH L
CHORDAMESODERMS	CH AO R D AH M EH S AH D AH R M Z
CHOREMEN	CH OW R M EH N
CHOWTIME	CH AW T AY M
CHOWTIMES	CH AW T AY M Z
CHROME	K R OW M
CHROMED	K R OW M D
CHROMES	K R OW M Z
CHROMOMERE	K R AH M OW M AH R
CHROMOMERES	K R AA M AH M IY R Z
CHROMOMERIC	K R AA M AH M AH R AH K
CHROMOSOME	K R OW M AH S OW M
CHROMOSOME(2)	K R OW M AH Z OW M
CHROMOSOMES	K R OW M AH Z OW M Z
CHROMOSOMES(2)	K R OW M AH S OW M Z
CHRONOMETER	K R OW N AA M AH T AH R
CHRONOMETERS	K R AH N AA M AH T AH R Z
CHRONOMETRIC	K R AA N AH M AH T R AH K
CHRONOMETRICAL	K R AA N AH M EH T R IH S AH L
CHRONOMETRICALLY	K R AA N AH M EH T R AH K AE L IY
CHRONOMETRIES	K R AA N AH M EH T R AY Z
CHRONOMETRY	K R OW N AH M EH T R IY
CHRYSOMELID	K R AH S AA M AH L AH D
CHRYSOMELIDS	K R AH S AA M AH L AH D Z
CHUCKLESOME	CH AH K AH L S AH M
CHUMMED	CH AH M D
CHURCHMEN	CH ER CH M AH N
CHURCHWOMEN	CH ER CH W IH M AH N
CHYME	CH AY M
CHYMES	CH AY M Z
CIMETIDINE	S AH M EH T AH D AY N
CIMETIDINES	S AH M EH T AH D AY N Z
CIMEX	S IH M AH K S
CLAIMED	K L EY M D
CLAIMER	K L EY M ER
CLAIMERS	K L EY M ER Z
CLAMMED	K L AE M D
CLAMMER	K L AE M ER
CLAMMERS	K L AE M ER Z
CLANSMEN	K L AE N Z M EH N
CLAWHAMMER	K L AO HH AE M ER
CLEMENCIES	K L EH M AH N S IY Z
CLEMENCY	K L EH M AH N S IY
CLEMENT	K L EH M AH N T
CLEMENTLY	K L EH M AH N T L IY
CLEOME	K L IY OW M
CLEOMES	K L IY OW M Z
CLERGYMEN	K L ER JH IY M IH N
CLERGYMEN(2)	K L ER JH IY M EH N
CLERGYWOMEN	K L ER JH IY W IH M AH N
CLIME	K L AY M
CLIMES	K L AY M Z
CLINOMETER	K L AY N AA M AH T AH R
CLINOMETERS	K L AH N AA M AH T AH R Z
CLIOMETRIC	K L AY AH M AH T R AH K
CLIOMETRICIAN	K L AY AH M EH T R IH S IY AH N
CLIOMETRICIANS	K L AY AH M AH T R IH S IY AH N Z
CLIOMETRICS	K L AY AH M EH T R AH S Z
CLUBMEN	K L AH B M EH N
COACHMEN	K OW CH M EH N
COASSUME	K OW AH S UW M
COASSUMED	K OW AH S UW M D
COASSUMES	K OW AH S UW M Z
COASTGUARDMEN	K OW S T G AA R D M EH N
COASTGUARDSMEN	K OW S T G AA R D Z M EH N
COCHAIRMEN	K OW CH EH ER M EH N
COCHAIRWOMEN	K OW CH EH ER W IH M AH N
COELOME	K OW AH L OW M
COELOMES	K OW AH L OW M Z
COENZYME	K OW EH N Z AY M
COENZYMES	K OW EH N Z AY M Z
COGNOMEN	K OW N OW M AH N
COGNOMENS	K OW N OW M AH N Z
COLORIMETER	K OW L AH R IH M AH T AH R
COLORIMETERS	K OW L AH R IH M AH T AH R Z
COLORIMETRIC	K OW L AO R AH M AH T R AH K
COLORIMETRICALLY	K OW L AO R AH M EH T R AH K AE L IY
COLORIMETRIES	K OW L AH R AH M EH T R AY Z
COLORIMETRY	K OW L AO R AH M EH T R IY
COLORMEN	K AH L ER M EH N
COLUMEL	K OW L UW M AH L
COLUMELLA	K OW L AH M EH L AH
COLUMELLAE	K OW L AH M EH L IY
COLUMELLAR	K OW L AH M EH L AH R
COLUMELS	K OW L UW M AH L Z
COMANAGEMENT	K OW M AE N IH JH M AH N T
COMANAGEMENTS	K OW M AE N IH JH M AH N T S
COME	K AH M
COMEBACK	K AH M B AE K
COMEBACKS	K AH M B AE K S
COMEDIAN	K AH M IY D IY AH N
COMEDIANS	K AH M IY D IY AH N Z
COMEDIC	K AH M IY D IH K
COMEDICALLY	K OW M EH D IH K AH L IY
COMEDIENNE	K AH M IY D IY EH N
COMEDIENNES	K AA M AH D IY N Z
COMEDIES	K AA M AH D IY Z
COMEDO	K AH M D UW
COMEDONES	K AH M D AH N Z
COMEDOS	K AH M D UW Z
COMEDOWN	K AH M D AW N
COMEDOWNS	K AH M D AW N Z
COMEDY	K AA M AH D IY
COMELIER	K AH M L IY ER
COMELIEST	K AH M L IY AH S T
COMELILY	K AH M L IY L IY
COMELINESS	K AH M L IY N AH S
COMELINESSES	K AH M L IY N AH S IH Z
COMELY	K AH M L IY
COMEMBER	K OW M EH M B ER
COMEMBERS	K OW M EH M B ER Z
COMER	K AH M ER
COMERS	K AH M ER Z
COMES	K AH M Z
COMESTIBLE	K AH M AH S T AH B AH L
COMESTIBLES	K AH M AH S T AH B AH L Z
COMET	K AA M AH T
COMETARY	K AA M AH T EH R IY
COMETH	K AH M IH TH
COMETHER	K AH M IY TH ER
COMETHERS	K AH M IY TH ER Z
COMETIC	K AA M AH T IH K
COMETS	K AA M AH T S
COMEUPPANCE	K AH M AH P AH N S
COMEUPPANCES	K AH M AH P AH N S IH Z
COMMANDMENT	K AH M AE N D M AH N T
COMMANDMENTS	K AH M AE N D M AH N T S
COMMEMORATE	K AH M EH M ER EY T
COMMEMORATED	K AH M EH M ER EY T IH D
COMMEMORATES	K AH M EH M ER EY T S
COMMEMORATING	K AH M EH M ER EY T IH NG
COMMEMORATION	K AH M EH M ER EY SH AH N
COMMEMORATIONS	K AH M EH M ER EY SH AH N Z
COMMEMORATIVE	K AH M EH M R AH T IH V
COMMEMORATIVE(2)	K AH M EH M ER EY T IH V
COMMEMORATIVELY	K AH M EH M ER AH T IH V L IY
COMMEMORATIVES	K AH M EH M ER AH T IH V Z
COMMEMORATOR	K AH M EH M ER AH T ER
COMMEMORATORS	K AH M EH M ER AH T ER Z
COMMENCE	K AH M EH N S
COMMENCED	K AH M EH N S T
COMMENCEMENT	K AH M EH N S M AH N T
COMMENCEMENTS	K AH M EH N S M AH N T S
COMMENCER	K AH M EH N S ER
COMMENCERS	K AH M EH N S ER Z
COMMENCES	K AH M EH N S AH Z
COMMENCING	K AH M EH N S IH NG
COMMEND	K AH M EH N D
COMMENDABLE	K AH M EH N D AH B AH L
COMMENDABLY	K AH M EH N D AH B L IY
COMMENDATION	K AA M AH N D EY SH AH N
COMMENDATIONS	K AA M AH N D EY SH AH N Z
COMMENDATORY	K AH M EH N D AH T OW R IY
COMMENDED	K AH M EH N D IH D
COMMENDER	K AH M EH N D ER
COMMENDERS	K AH M EH N D ER Z
COMMENDING	K AH M EH N D IH NG
COMMENDS	K AH M EH N D Z
COMMENSAL	K AH M EH N Z AH L
COMMENSALISM	K AH M EH N Z AH L IH Z AH M
COMMENSALISMS	K AH M EH N Z AH L IH Z AH M Z
COMMENSALLY	K AH M EH N S AE L IY
COMMENSALS	K AH M EH N Z AH L Z
COMMENSURABILITIES	K AH M EH N Z Y ER AH B IH L AH T EH Z
COMMENSURABILITY	K AH M EH N Z Y ER AH B IH L AH T EH
COMMENSURABLE	K AH M EH N Z Y ER AH B AH L
COMMENSURABLY	K AH M EH N Z Y ER AH B L IY
COMMENSURATE	K AH M EH N S ER AH T
COMMENSURATE(2)	K AH M EH N S ER IH T
COMMENSURATELY	K AH M EH N S ER AH T L IY
COMMENSURATELY(2)	K AH M EH N SH ER AH T L IY
COMMENSURATION	K AH M EH N S AH R AH SH AH N
COMMENSURATIONS	K AH M EH N S AH R AH SH AH N Z
COMMENT	K AA M EH N T
COMMENTARIES	K AA M AH N T EH R IY Z
COMMENTARY	K AA M AH N T EH R IY
COMMENTATE	K AH M EH N T AH T
COMMENTATED	K AH M EH N T EY T IH D
COMMENTATES	K AH M EH N T AH T S
COMMENTATING	K AH M EH N T EY T IH NG
COMMENTATOR	K AA M AH N T EY T ER
COMMENTATORS	K AA M AH N T EY T ER Z
COMMENTED	K AA M EH N T AH D
COMMENTING	K AA M EH N T IH NG
COMMENTS	K AA M EH N T S
COMMERCE	K AA M ER S
COMMERCED	K AA M ER S T
COMMERCES	K AA M ER S IH Z
COMMERCIAL	K AH M ER SH AH L
COMMERCIALISE	K AA M AH R S IY AH L AY Z
COMMERCIALISED	K AH M ER SH AH L IY Z D
COMMERCIALISES	K AH M ER SH AH L IY Z IH Z
COMMERCIALISING	K AH M ER SH AH L IY Z IH NG
COMMERCIALISM	K AH M ER SH AH L IH Z AH M
COMMERCIALISMS	K AH M ER SH AH L IH Z AH M Z
COMMERCIALIST	K AH M ER SH AH L IH S T
COMMERCIALISTIC	K AH M ER SH AH L IH S T IH K
COMMERCIALISTS	K AH M ER SH AH L IH S T S
COMMERCIALITIES	K AH M ER SH AH L AH T IY Z
COMMERCIALITY	K AH M ER SH AH L AH T IY
COMMERCIALIZATION	K AH M ER SH AH L IH Z EY SH AH N
COMMERCIALIZATIONS	K AH M ER SH AH L AH Z EY SH AH N Z
COMMERCIALIZE	K AH M ER SH AH L AY Z
COMMERCIALIZED	K AH M ER SH AH L AY Z D
COMMERCIALIZES	K AH M ER SH AH L AY Z IH Z
COMMERCIALIZING	K AH M ER SH AH L AY Z IH NG
COMMERCIALLY	K AH M ER SH AH L IY
COMMERCIALS	K AH M ER SH AH L Z
COMMERCING	K AA M ER S IH NG
COMMITMENT	K AH M IH T M AH N T
COMMITMENTS	K AH M IH T M AH N T S
COMMITTEEMEN	K AH M IH T IY M EH N
COMMITTEEWOMEN	K AH M IH T IY W IH M AH N
COMONOMER	K OW M AA N AH M ER
COMONOMERS	K OW M AA N AH M ER Z
COMPARTMENT	K AH M P AA R T M AH N T
COMPARTMENTAL	K AH M P AA R T M EH N T AH L
COMPARTMENTALISE	K AA M P AH R T M EH N T AH L AY Z
COMPARTMENTALISED	K AH M P AA R T M AH N T AH L IY Z D
COMPARTMENTALISES	K AH M P AA R T M AH N T AH L IY Z IH Z
COMPARTMENTALISING	K AH M P AA R T M AH N T AH L IY Z IH NG
COMPARTMENTALIZATION	K AH M P AA R T M AH N T AH L AH Z EY SH AH N
COMPARTMENTALIZATIONS	K AH M P AA R T M AH N T AH L AH Z EY SH AH N Z
COMPARTMENTALIZE	K AH M P AA R T M EH N T AH L AY Z
COMPARTMENTALIZED	K AA M P AA R T M EH N T AH L AY Z D
COMPARTMENTALIZES	K AH M P AA R T M AH N T AH L AY Z IH Z
COMPARTMENTALIZING	K AH M P AA R T M AH N T AH L AY Z IH NG
COMPARTMENTATION	K AH M P AA R T M AH N T EY SH AH N
COMPARTMENTATIONS	K AH M P AA R T M AH N T EY SH AH N Z
COMPARTMENTED	K AH M P AA R T M AH N T IH D
COMPARTMENTING	K AH M P AA R T M AH N T IH NG
COMPARTMENTS	K AH M P AA R T M AH N T S
COMPLEMENT	K AA M P L AH M AH N T
COMPLEMENTAL	K AA M P L AH M AH N T AH L
COMPLEMENTARIES	K AA M P L AH M EH N T AH R IY Z
COMPLEMENTARILY	K AA M P L AH M EH N T AH R IY L IY
COMPLEMENTARINESS	K AA M P L AH M EH N T AH R IY N AH S
COMPLEMENTARINESSES	K AA M P L AH M EH N T AH R IY N AH S IH Z
COMPLEMENTARITIES	K AA M P L AH M AH N T ER AH T IY Z
COMPLEMENTARITY	K AA M P L AH M AH N T ER AH T IY
COMPLEMENTARY	K AA M P L AH M EH N T R IY
COMPLEMENTARY(2)	K AA M P L AH M EH N CH IY
COMPLEMENTATION	K AA M P L AH M AH N T EY SH AH N
COMPLEMENTATIONS	K AA M P L AH M AH N T EY SH AH N Z
COMPLEMENTED	K AA M P L AH M EH N T IH D
COMPLEMENTING	K AA M P L AH M EH N T IH NG
COMPLEMENTIZER	K AA M P L AH M AH N T AY Z ER
COMPLEMENTIZERS	K AA M P L AH M AH N T AY Z ER Z
COMPLEMENTS	K AA M P L AH M AH N T S
COMPLIMENT	K AA M P L AH M EH N T
COMPLIMENTARILY	K AA M P L AH M EH N T AH R IY L IY
COMPLIMENTARY	K AA M P L AH M EH N T ER IY
COMPLIMENTED	K AA M P L AH M EH N T IH D
COMPLIMENTING	K AA M P L AH M EH N T IH NG
COMPLIMENTS	K AA M P L AH M EH N T S
COMPORTMENT	K AH M P AO R T M AH N T
COMPORTMENTS	K AH M P OW R T M AH N T S
CONCEALMENT	K AH N S IY L M AH N T
CONCEALMENTS	K AH N S IY L M AH N T S
CONCERNMENT	K AH N S ER N M AH N T
CONCERNMENTS	K AH N S ER N M AH N T S
CONCERTMEISTER	K AA N S AH R T M IY S T AH R
CONCERTMEISTERS	K AA N S AH R T M IY S T AH R Z
CONDIMENT	K AA N D AH M AH N T
CONDIMENTAL	K AA N D AH M AH N T AH L
CONDIMENTS	K AA N D AH M AH N T S
CONDUCTIMETRIC	K AA N D AH K T AH M AH T R AH K
CONDUCTOMETRIC	K AA N D AH K T AH M AH T R AH K
CONFERMENT	K AH N F ER M EH N T
CONFERMENTS	K AH N F ER M EH N T S
CONFINEMENT	K AH N F AY N M AH N T
CONFINEMENTS	K AH N F AY N M AH N T S
CONFIRMED	K AH N F ER M D
CONFIRMEDLY	K AH N F ER M AH D L IY
CONFIRMEDNESS	K AH N F ER M AH D N AH S
CONFIRMEDNESSES	K AH N F ER M AH D N AH S IH Z
CONFORMED	K AH N F AO R M D
CONFORMER	K AH N F AO R M ER
CONFORMERS	K AH N F AO R M ER Z
CONGEALMENT	K AH N JH IY L M AH N T
CONGEALMENTS	K AH N JH IY L M AH N T S
CONGLOMERATE	K AH N G L AA M ER AH T
CONGLOMERATED	K AH N G L AA M ER EY T IH D
CONGLOMERATES	K AH N G L AA M ER AH T S
CONGLOMERATEUR	K AA N G L AA M AH R EY T AH R
CONGLOMERATEURS	K AA N G L AA M AH R AH T IY Y AH R Z
CONGLOMERATIC	K AH N G L AA M ER AH T IH K
CONGLOMERATING	K AH N G L AA M ER EY T IH NG
CONGLOMERATION	K AH N G L AA M ER EY SH AH N
CONGLOMERATIONS	K AH N G L AA M ER EY SH AH N Z
CONGLOMERATIVE	K AH N G L AA M ER AH T IH V
CONGLOMERATOR	K AH N G L AA M ER AH T ER
CONGLOMERATORS	K AH N G L AA M ER AH T ER Z
CONGRESSMEN	K AA NG G R AH S M IH N
CONGRESSWOMEN	K AA NG G R AH S W IH M IH N
CONSIGNMENT	K AH N S AY N M AH N T
CONSIGNMENTS	K AH N S AY N M AH N T S
CONSOMME	K AA N S AA M
CONSOMMES	K AA N S AA M Z
CONSUME	K AH N S UW M
CONSUMED	K AH N S UW M D
CONSUMEDLY	K AH N S UW M AH D L IY
CONSUMER	K AH N S UW M ER
CONSUMERISM	K AH N S UW M ER IH Z AH M
CONSUMERISMS	K AH N S UW M ER IH Z AH M Z
CONSUMERIST	K AH N S UW M ER IH S T
CONSUMERISTIC	K AH N S UW M ER IH S T IH K
CONSUMERISTS	K AH N S UW M ER IH S T S
CONSUMERS	K AH N S UW M ER Z
CONSUMERSHIP	K AH N S UW M ER SH IH P
CONSUMERSHIPS	K AH N S UW M ER SH IH P S
CONSUMES	K AH N S UW M Z
CONTAINMENT	K AH N T EY N M AH N T
CONTAINMENTS	K AH N T EY N M AH N T S
CONTENTMENT	K AH N T EH N T M AH N T
CONTENTMENTS	K AH N T EH N T M AH N T S
CONTROLMENT	K AH N T R OW L M AH N T
CONTROLMENTS	K AH N T R OW L M AH N T S
CONTUMELIES	K AA N T Y UW M AH L AY Z
CONTUMELIOUS	K AA N T Y AH M IY L IY AH S
CONTUMELIOUSLY	K AA N T Y AH M AH L IY OW AH S L IY
CONTUMELY	K AA N T Y UW M L IY
COPAYMENT	K OW P EY M AH N T
COPAYMENTS	K OW P EY M AH N T S
COPOLYMER	K OW P AA L AH M ER
COPOLYMERIC	K OW P AA L AH M EH R IH K
COPOLYMERIZATION	K OW P AA L AH M ER AH Z EY SH AH N
COPOLYMERIZATIONS	K OW P AA L AH M ER AH Z EY SH AH N Z
COPOLYMERIZE	K OW P AA L AH M ER AY Z
COPOLYMERIZED	K OW P AA L AH M ER AY Z D
COPOLYMERIZES	K OW P AA L AH M ER AY Z IH Z
COPOLYMERIZING	K OW P AA L AH M ER AY Z IH NG
COPOLYMERS	K OW P AA L AH M ER Z
COREDEEMED	K OW R IY D IY M D
CORMEL	K AA R M EH L
CORMELS	K AA R M EH L Z
CORNERMEN	K AO R N ER M EH N
CORNMEAL	K AO R N M IY L
CORNMEALS	K AO R N M IY L Z
CORPSMEN	K OW R M EH N
COSMETIC	K AA Z M EH T IH K
COSMETICALLY	K AO Z M EH T IH K L IY
COSMETICIAN	K AA S M AH T IH S IY AH N
COSMETICIANS	K AA S M AH T IH S IY AH N Z
COSMETICIZE	K AA Z M EH T IH K AY Z
COSMETICIZED	K AA Z M EH T IH K AY Z D
COSMETICIZES	K AA Z M EH T IH K AY Z IH Z
COSMETICIZING	K AA Z M EH T IH K AY Z IH NG
COSMETICS	K AA Z M EH T IH K S
COSMETOLOGIES	K AA S M AH T AA L AH JH AY Z
COSMETOLOGIST	K AA S M AH T AA L AH JH AH S T
COSMETOLOGISTS	K AA S M AH T AA L AH JH AH S T S
COSMETOLOGY	K AA Z M AH T AA L AH JH IY
COSTUME	K AA S T UW M
COSTUMED	K AO S T UW M D
COSTUMER	K AA S T UW M ER
COSTUMERIES	K AA S T UW M AH R IY Z
COSTUMERS	K AA S T UW M ER Z
COSTUMERY	K AA S T UW M AH R IY
COSTUMES	K AA S T UW M Z
COSTUMEY	K AA S T UW M IY
COULOMETER	K OW AH L AA M AH T AH R
COULOMETERS	K OW Y AH L AA M AH T AH R Z
COULOMETRIC	K OW Y UW L AH M AH T R AH K
COULOMETRICALLY	K OW Y UW L AH M EH T R AH K AE L IY
COULOMETRIES	K OW Y AH L AH M EH T R AY Z
COULOMETRY	K OW AH L AH M EH T R IY
COUNCILMEN	K AW N S AH L M EH N
COUNCILWOMEN	K AW N S IH L W IH M AH N
COUNTERARGUMENT	K AW N T ER AA R G Y AH M AH N T
COUNTERARGUMENTS	K AW N T ER AA R G Y AH M AH N T S
COUNTERCLAIMED	K AW N T ER K L EY M D
COUNTERCOMMERCIAL	K AW N T ER K AH M ER SH AH L
COUNTERCOUNTERMEASURE	K AW N T ER K AW N T ER M EH ZH ER
COUNTERCOUNTERMEASURES	K AW N T ER K AW N T ER M EH ZH ER Z
COUNTERDEPLOYMENT	K AW N T ER D IH P L OY M AH N T
COUNTERDEPLOYMENTS	K AW N T ER D IH P L OY M AH N T S
COUNTERGOVERNMENT	K AW N T ER G AH V ER N M AH N T
COUNTERGOVERNMENTS	K AW N T ER G AH V ER N M AH N T S
COUNTERMEASURE	K AW N T ER M EH ZH ER
COUNTERMEASURES	K AW N T ER M EH ZH ER Z
COUNTERMELODIES	K AW N T ER M EH L AH D IY Z
COUNTERMELODY	K AW N T ER M EH L AH D IY
COUNTERMEMO	K AW N T ER M EH M OW
COUNTERMEMOS	K AW N T ER M EH M OW Z
COUNTERMEN	K OW AH N T ER M AH N
COUNTERMOVEMENT	K AW N T ER M UW V M AH N T
COUNTERMOVEMENTS	K AW N T ER M UW V M AH N T S
COUNTERREFORMER	K AW N T ER R IY F AO R M ER
COUNTERREFORMERS	K AW N T ER R IY F AO R M ER Z
COUNTERSTATEMENT	K AW N T ER S T EY T M AH N T
COUNTERSTATEMENTS	K AW N T ER S T EY T M AH N T S
COUNTRYMEN	K AH N T R IY M IH N
COUNTRYWOMEN	K AH N T R IY W IH M AH N
COUPLEMENT	K AH P AH L M AH N T
COUPLEMENTS	K AH P AH L M AH N T S
COWMEN	K AW M EH N
CRABMEAT	K R AE B M IY T
CRABMEATS	K R AE B M IY T S
CRACKSMEN	K R AE K S M EH N
CRAFTSMEN	K R AE F T S M EH N
CRAFTSMEN(2)	K R AE F S M EH N
CRAFTSWOMEN	K R AE F T S W IH M AH N
CRAGSMEN	K R AE G Z M EH N
CRAMMED	K R AE M D
CRAMMER	K R AE M ER
CRAMMERS	K R AE M ER Z
CRANIOMETRIES	K R EY N IY AH M EH T R AY Z
CRANIOMETRY	K R EY N IY AH M EH T R IY
CREAMED	K R IY M D
CREAMER	K R IY M ER
CREAMERIES	K R IY M AH R IY Z
CREAMERS	K R IY M ER Z
CREAMERY	K R IY M ER IY
CREME	K R IY M
CREMES	K R IY M Z
CREWMEN	K R UW M IH N
CRIME	K R AY M
CRIMELESS	K R AY M L AH S
CRIMES	K R AY M Z
CRIMMER	K R IH M AH R
CRIMMERS	K R IH M AH R Z
CROSSBOWMEN	K R AO S B AW M EH N
CRYPTOMERIA	K R IH P T AH M IY R IY AH
CRYPTOMERIAS	K R IH P T AH M IY R IY AH Z
CUDDLESOME	K AH D L S AH M
CULMED	K AH L M D
CUMBERSOME	K AH M B ER S AH M
CUMBERSOMELY	K AH M B ER S AH M L IY
CUMBERSOMENESS	K AH M B ER S AH M N AH S
CUMBERSOMENESSES	K AH M B ER S AH M N AH S IH Z
CUMMER	K AH M AH R
CUMMERBUND	K AH M AH R B AH N D
CUMMERBUNDS	K AH M AH R B AH N D Z
CUMMERS	K AH M AH R Z
CURETTEMENT	K Y UH R EH T M AH N T
CURETTEMENTS	K Y UH R EH T M AH N T S
CURTAILMENT	K ER T EY L M AH N T
CURTAILMENTS	K ER T EY L M AH N T S
CUSTOMER	K AH S T AH M ER
CUSTOMERS	K AH S T AH M ER Z
CYCLAMEN	S IH K L AH M AH N
CYCLAMENS	S IH K L AH M AH N Z
CYCLOMETER	S IH K L AA M AH T AH R
CYCLOMETERS	S IH K L AA M AH T AH R Z
CYCLOSTOME	S AY K L AH S T OW M
CYCLOSTOMES	S AY K L AH S T OW M Z
CYME	S AY M
CYMENE	S AH M IY N
CYMENES	S AH M IY N Z
CYMES	S AY M Z
CYTOCHROME	S IH T AH K R OW M
CYTOCHROMES	S IH T AH K R OW M Z
CYTOMEGALIC	S AH T AA M AH G AH L AH K
CYTOMEGALOVIRUS	S AY T AH M EH G AH L OW V AY R AH S
CYTOMEGALOVIRUSES	S AH T AH M AH G AH L AA V AH R UW Z AH Z
CYTOMEMBRANE	S AH T AA M AH M B R EY N
CYTOMEMBRANES	S AH T AA M AH M B R EY N Z
CYTOPHOTOMETRIC	S IH T AH F AA T AH M AH T R AH K
CYTOPHOTOMETRIES	S AH T AH F AH T AH M EH T R AY Z
CYTOPHOTOMETRY	S AH T AA F AH T AH M EH T R IY
DAIMEN	D EY M AH N
DAIRYMEN	D EY R IY M AH N
DALESMEN	D EY L Z M EH N
DAME	D EY M
DAMES	D EY M Z
DAMEWORT	D AE M Y UW AH R T
DAMEWORTS	D AE M Y UW AH R T S
DAMMED	D AE M D
DAMMER	D AE M ER
DAMMERS	D AE M ER Z
DARKSOME	D AA R K S AH M
DAYDREAMED	D EY D R IY M D
DAYDREAMER	D EY D R IY M ER
DAYDREAMERS	D EY D R IY M ER Z
DAYSMEN	D EY Z M EH N
DAYTIME	D EY T AY M
DAYTIMES	D EY T AY M Z
DEATHSMEN	D EH TH S M EH N
DEBARMENT	D IH B AA R M AH N T
DEBARMENTS	D IY B AA R M AH N T S
DEBASEMENT	D AH B EY S M AH N T
DEBASEMENTS	D IY B EY S M AH N T S
DEBATEMENT	D AH B EY T M AH N T
DEBATEMENTS	D AH B EY T M AH N T S
DEBOUCHMENT	D AH B AW CH M AH N T
DEBOUCHMENTS	D AH B AW CH M AH N T S
DEBRIDEMENT	D IY B R AY D M AH N T
DEBRIDEMENTS	D IY B R AY D M AH N T S
DECAMETER	D AH K AE M AH T AH R
DECAMETERS	D AH K AE M AH T AH R Z
DECAMETHONIUM	D AH K AE M AH TH OW N IY AH M
DECAMETHONIUMS	D AH K AE M AH TH OW N IY AH M Z
DECAMETRIC	D AH K AE M AH T R AH K
DECAMPMENT	D IY K AE M P M AH N T
DECAMPMENTS	D IY K AE M P M AH N T S
DECIMETER	D AH S IH M AH T AH R
DECIMETERS	D AH S IH M AH T AH R Z
DECIPHERMENT	D IY S AY F ER M AH N T
DECIPHERMENTS	D IY S AY F ER M AH N T S
DECLAIMED	D IH K L EY M D
DECLAIMER	D IY K L EY M ER
DECLAIMERS	D IY K L EY M ER Z
DECREMENT	D EH K R AH M AH N T
DECREMENTAL	D EH K R AH M AH N T AH L
DECREMENTED	D EH K R AH M AH N T IH D
DECREMENTING	D EH K R AH M AH N T IH NG
DECREMENTS	D EH K R AH M AH N T S
DEEMED	D IY M D
DEFACEMENT	D IY F EY S M AH N T
DEFACEMENTS	D IY F EY S M AH N T S
DEFAME	D IH F EY M
DEFAMED	D IH F EY M D
DEFAMER	D IY F EY M ER
DEFAMERS	D IY F EY M ER Z
DEFAMES	D IY F EY M Z
DEFENCEMEN	D IY F EH N S M EH N
DEFENSEMEN	D IH F EH N S M EH N
DEFERMENT	D IH F ER M AH N T
DEFERMENTS	D IH F ER M AH N T S
DEFILEMENT	D IY F AY L M AH N T
DEFILEMENTS	D IY F AY L M AH N T S
DEFINEMENT	D IH F AY N M AH N T
DEFINEMENTS	D IH F AY N M AH N T S
DEFOAMED	D IY F OW M D
DEFOAMER	D IY F OW M ER
DEFOAMERS	D IY F OW M ER Z
DEFORCEMENT	D IY F OW R S M AH N T
DEFORCEMENTS	D IY F OW R S M AH N T S
DEFORMED	D IH F AO R M D
DEFORMER	D IY F AO R M ER
DEFORMERS	D IY F AO R M ER Z
DEGAME	D IY G EY M
DEGAMES	D IY G EY M Z
DEGERMED	D IY JH ER M D
DEGUMMED	D IY G AH M D
DEKAMETER	D AH K AE M AH T AH R
DEKAMETERS	D AH K AE M AH T AH R Z
DEKAMETRIC	D AH K AE M AH T R AH K
DELIGHTSOME	D IH L AY T S AH M
DELIME	D IY L AY M
DELIMED	D IY L AY M D
DELIMES	D IY L AY M Z
DELIVERYMEN	D IH L IH V AH R IY M EH N
DEME	D AH M IY
DEMEAN	D IH M IY N
DEMEANED	D IH M IY N D
DEMEANING	D IH M IY N IH NG
DEMEANOR	D IH M IY N ER
DEMEANORS	D IH M IY N ER Z
DEMEANOUR	D AH M IY N AH R
DEMEANOURS	D AH M AH N OW Y AH R Z
DEMEANS	D IH M IY N Z
DEMENT	D AH M EH N T
DEMENTED	D IH M EH N T IH D
DEMENTEDLY	D IY M EH N T EH D L IY
DEMENTEDNESS	D IY M EH N T EH D N AH S
DEMENTEDNESSES	D IY M EH N T EH D N AH S IH Z
DEMENTIA	D IH M EH N SH IY AH
DEMENTIAL	D IY M EH N T IY AH L
DEMENTIAS	D AH M EH N T IY AH Z
DEMENTING	D AH M EH N T AH NG
DEMENTS	D AH M EH N T S
DEMERARA	D AH M EH R AH R AH
DEMERARAS	D AH M EH R AH R AH Z
DEMERGE	D IY M ER JH
DEMERGED	D IY M ER JH D
DEMERGER	D IY M ER JH ER
DEMERGERED	D IY M ER JH ER D
DEMERGERING	D IY M ER JH ER IH NG
DEMERGERS	D IY M ER JH ER Z
DEMERGES	D IY M ER JH IH Z
DEMERGING	D IY M ER JH IH NG
DEMERIT	D IY M EH R AH T
DEMERITED	D IY M EH R AH T IH D
DEMERITING	D IY M EH R AH T IH NG
DEMERITS	D IY M EH R AH T S
DEMERSAL	D AH M EH R Z AH L
DEMES	D IY M Z
DEMESNE	D AH M EH Z N
DEMESNES	D AH M EH Z N Z
DEMETON	D IY M EH T AO N
DEMETONS	D IY M EH T AO N Z
DEMOLISHMENT	D IH M AA L IH SH M AH N T
DEMOLISHMENTS	D IH M AA L IH SH M AH N T S
DENOTEMENT	D IY N OW T M AH N T
DENOTEMENTS	D IY N OW T M AH N T S
DENOUEMENT	D EY N UW M AA N
DENOUEMENTS	D EY N UW M AA N Z
DENOUNCEMENT	D IH N AW N S M AH N T
DENOUNCEMENTS	D IH N AW N S M AH N T S
DENSITOMETER	D EH N S AH T AA M AH T ER
DENSITOMETERS	D IH N S AH T AA M AH T AH R Z
DENSITOMETRIC	D IH N S IH T AH M AH T R AH K
DENSITOMETRIES	D EH N S AH T AA M AH T R IY Z
DENSITOMETRY	D EH N S AH T AA M AH T R IY
DENUDEMENT	D IY N UW D M AH N T
DENUDEMENTS	D IY N UW D M AH N T S
DENUMERABILITIES	D IY N UW M ER AH B IH L AH T EH Z
DENUMERABILITY	D IY N UW M ER AH B IH L AH T EH
DENUMERABLE	D IY N UW M ER AH B AH L
DENUMERABLY	D IY N UW M ER AH B L IY
DEPARTMENT	D IH P AA R T M AH N T
DEPARTMENTAL	D IH P AA R T M EH N AH L
DEPARTMENTAL(2)	D IH P AA R T M EH N T AH L
DEPARTMENTALIZATION	D IH P AA R T M EH N T AH L AH Z EY SH AH N
DEPARTMENTALIZATIONS	D IH P AA R T M EH N T AH L AH Z EY SH AH N Z
DEPARTMENTALIZE	D IH P AA R T M EH N T AH L AY Z
DEPARTMENTALIZE(2)	D IH P AA R T M EH N AH L AY Z
DEPARTMENTALIZED	D IH P AA R T M EH N T AH L AY Z D
DEPARTMENTALIZED(2)	D IH P AA R T M EH N AH L AY Z D
DEPARTMENTALIZES	D IH P AA R T M EH N T AH L AY Z IH Z
DEPARTMENTALIZING	D IH P AA R T M EH N T AH L AY Z IH NG
DEPARTMENTALLY	D IH P AA R T M EH N T AH L IY
DEPARTMENTS	D IH P AA R T M AH N T S
DEPERMED	D AH P AH R M D
DEPIGMENTATION	D IY P IH G M AH N T EY SH AH N
DEPIGMENTATIONS	D IY P IH G M AH N T EY SH AH N Z
DEPLOYMENT	D IH P L OY M AH N T
DEPLOYMENTS	D IH P L OY M AH N T S
DEPLUME	D IY P L UW M
DEPLUMED	D IY P L UW M D
DEPLUMES	D IY P L UW M Z
DEPOLYMERIZATION	D IY P AA L AH M ER AH Z EY SH AH N
DEPOLYMERIZATIONS	D IY P AA L AH M ER AH Z EY SH AH N Z
DEPOLYMERIZE	D IY P AA L AH M ER AY Z
DEPOLYMERIZED	D IY P AA L AH M ER AY Z D
DEPOLYMERIZES	D IY P AA L AH M ER AY Z IH Z
DEPOLYMERIZING	D IY P AA L AH M ER AY Z IH NG
DEPORTMENT	D AH P AO R T M AH N T
DEPORTMENTS	D IY P OW R T M AH N T S
DEPRAVEMENT	D IH P R EY V M AH N T
DEPRAVEMENTS	D IH P R EY V M AH N T S
DEPROGRAMED	D IY P R OW G R AE M D
DEPROGRAMMED	D IY P R OW G R AE M D
DEPROGRAMMER	D IY P R OW G R AE M ER
DEPROGRAMMERS	D IY P R OW G R AE M ER Z
DERAILMENT	D IH R EY L M AH N T
DERAILMENTS	D IH R EY L M AH N T S
DERANGEMENT	D IY R EY N JH M AH N T
DERANGEMENTS	D IY R EY N JH M AH N T S
DERMATOME	D IH R M AH T OW M
DERMATOMES	D IH R M AH T OW M Z
DERMESTID	D IH R M EH S T AH D
DERMESTIDS	D IH R M EH S T AH D Z
DESIGNMENT	D IH Z AY N M AH N T
DESIGNMENTS	D IH Z AY N M AH N T S
DESKMEN	D EH S K M EH N
DESMOSOME	D IH S M AA S AH M
DESMOSOMES	D IH S M AA S AH M Z
DESPISEMENT	D IH S P AY Z M AH N T
DESPISEMENTS	D IH S P AY Z M AH N T S
DESPOILMENT	D IY S P OY L M AH N T
DESPOILMENTS	D IY S P OY L M AH N T S
DETACHMENT	D IH T AE CH M AH N T
DETACHMENT(2)	D IY T AE CH M AH N T
DETACHMENTS	D IH T AE CH M AH N T S
DETAINMENT	D IH T EY N M AH N T
DETAINMENTS	D IH T EY N M AH N T S
DETERMENT	D IH T ER M AH N T
DETERMENTS	D IH T ER M AH N T S
DETHRONEMENT	D IY TH R OW N M AH N T
DETHRONEMENTS	D IY TH R OW N M AH N T S
DETRAINMENT	D IY T R EY N M AH N T
DETRAINMENTS	D IY T R EY N M AH N T S
DETRIMENT	D EH T R AH M AH N T
DETRIMENTAL	D EH T R AH M EH N T AH L
DETRIMENTAL(2)	D EH T R AH M EH N AH L
DETRIMENTALLY	D EH T R AH M EH N T AH L IY
DETRIMENTALS	D EH T R AH M EH N T AH L Z
DETRIMENTS	D EH T R AH M AH N T S
DETUMESCENCE	D IH T Y AH M EH S AH N S
DETUMESCENCES	D IH T Y AH M AH S EH N S AH Z
DETUMESCENT	D IH T Y AH M EH S AH N T
DEUTEROSTOME	D IY Y AH T EH R AH S T OW M
DEUTEROSTOMES	D IY Y AH T EH R AH S T OW M Z
DEVELOPMENT	D IH V EH L AH P M AH N T
DEVELOPMENTAL	D IH V EH L AH P M EH N T AH L
DEVELOPMENTAL(2)	D IH V EH L AH P M EH N AH L
DEVELOPMENTALLY	D IH V EH L AH P M EH N AH L IY
DEVELOPMENTALLY(2)	D IH V EH L AH P M EH N T AH L IY
DEVELOPMENTS	D IH V EH L AH P M AH N T S
DEVILMENT	D IY V IH L M AH N T
DEVILMENTS	D IY V IH L M AH N T S
DEVOTEMENT	D IH V OW T M AH N T
DEVOTEMENTS	D IH V OW T M AH N T S
DEWORMED	D IY W ER M D
DEWORMER	D IY W ER M ER
DEWORMERS	D IY W ER M ER Z
DEXAMETHASONE	D AH Z AH M EH TH AH S OW N
DEXAMETHASONES	D AH Z AH M EH TH AH S OW N Z
DIADEMED	D AY AH D IY M D
DIAGRAMED	D AY AH G R AE M D
DIAGRAMMED	D AY AH G R AE M D
DIAMETER	D AY AE M AH T ER
DIAMETERS	D AY AE M AH T ER Z
DIAMETRAL	D AY AH M EH T R AH L
DIAMETRIC	D AY AH M EH T R IH K
DIAMETRICAL	D AY AH M EH T R IH K AH L
DIAMETRICALLY	D AY AH M EH T R IH K AH L IY
DIAMETRICALLY(2)	D AY AH M EH T R IH K L IY
DIASTEREOISOMER	D AY AH S T IY R IY OY S AH M AH R
DIASTEREOISOMERIC	D AY AH S T IY R IY OY S AH M AH R AH K
DIASTEREOISOMERISM	D AY AH S T IY R IY OY S AH M AH R IH Z AH M
DIASTEREOISOMERISMS	D AY AH S T IY R IY OY S AA M AH R AH Z AH M Z
DIASTEREOISOMERS	D AY AH S T IY R IY OY S AH M AH R Z
DIASTEREOMER	D AY AH S T IY R IY OW M AH R
DIASTEREOMERIC	D AY AE S T AH R IY AH M AH R AH K
DIASTEREOMERS	D AY AE S T AH R IY AH M AH R Z
DICHLORODIFLUOROMETHANE	D IH K L AH R AH D AH F L AH W AH R AA M AH TH EY N
DICHLORODIFLUOROMETHANES	D IH K L AH R AH D AH F L AH W AH R AA M AH TH EY N Z
DICTYOSOME	D IH K T AY AH S AH M
DICTYOSOMES	D IH K T AY AH S AH M Z
DIFFRACTOMETER	D IH F R AH K T AA M AH T AH R
DIFFRACTOMETERS	D IH F R AH K T AA M AH T AH R Z
DIFFRACTOMETRIC	D IH F R AE K T AH M AH T R AH K
DIFFRACTOMETRIES	D IH F R AE K T AH M EH T R AY Z
DIFFRACTOMETRY	D IH F R AE K T AH M EH T R IY
DILATOMETER	D AY L AH T AA M AH T AH R
DILATOMETERS	D IH L AH T AA M AH T AH R Z
DILATOMETRIC	D AH L AE T AH M AH T R AH K
DILATOMETRIES	D IH L AH T AH M EH T R AY Z
DILATOMETRY	D AY L EY T AH M EH T R IY
DIME	D AY M
DIMENHYDRINATE	D IH M AH N HH IH D R AH N EY T
DIMENHYDRINATES	D IH M AH N HH IH D R AH N EY T S
DIMENSION	D IH M EH N SH AH N
DIMENSIONAL	D IH M EH N SH AH N AH L
DIMENSIONALITIES	D AH M EH N CH AH N AH L AH T IY Z
DIMENSIONALITY	D IH M EH N SH AH N AE L AH T IY
DIMENSIONALLY	D AH M EH N CH AH N AH L IY
DIMENSIONED	D AH M EH N CH AH N D
DIMENSIONING	D AH M EH N CH AH N IH NG
DIMENSIONLESS	D AH M EH N CH AH N L AH S
DIMENSIONS	D IH M EH N SH AH N Z
DIMER	D AY M ER
DIMERCAPROL	D IH M AH R K AE P R AH L
DIMERCAPROLS	D IH M AH R K AE P R AH L Z
DIMERIC	D AY M ER IH K
DIMERISM	D AY M ER IH Z AH M
DIMERISMS	D AY M ER IH Z AH M Z
DIMERIZATION	D AY M ER AH Z EY SH AH N
DIMERIZATIONS	D AY M ER AH Z EY SH AH N Z
DIMERIZE	D AY M ER AY Z
DIMERIZED	D AY M ER AY Z D
DIMERIZES	D AY M ER AY Z IH Z
DIMERIZING	D AY M ER AY Z IH NG
DIMEROUS	D AY M ER AH S
DIMERS	D AY M ER Z
DIMES	D AY M Z
DIMETER	D IH M AH T AH R
DIMETERS	D IH M AH T AH R Z
DIMETHOATE	D AH M EH TH OW EY T
DIMETHOATES	D AH M EH TH OW EY T S
DIMETHYL	D IH M EH TH AH L
DIMETHYLHYDRAZINE	D AH M AH TH AH L HH IH D R AH Z AY N
DIMETHYLHYDRAZINES	D AH M AH TH AH L HH IH D R AH Z AY N Z
DIMETHYLNITROSAMINE	D AH M AH TH AH L N IH T R AA S AH M AY N
DIMETHYLNITROSAMINES	D AH M AH TH AH L N IH T R AA S AH M AY N Z
DIMETHYLS	D IH M EH TH AH L Z
DIMETHYLTRYPTAMINE	D AH M AH TH AH L T R IH P T AH M AY N
DIMETHYLTRYPTAMINES	D AH M AH TH AH L T R IH P T AH M AY N Z
DIMETRIC	D IH M AH T R AH K
DIMINISHMENT	D IH M IH N IH SH M AH N T
DIMINISHMENTS	D AH M IH N IH SH M AH N T S
DIMMED	D IH M D
DIMMER	D IH M ER
DIMMERS	D IH M ER Z
DIMMEST	D IH M AH S T
DINNERTIME	D IH N ER T AY M
DINNERTIMES	D IH N ER T AY M Z
DIRIGISME	D IH R AH JH AH Z M
DIRIGISMES	D IH R AH JH AH Z M Z
DIRIMENT	D AY ER IY M AH N T
DISABLEMENT	D IH S EY B AH L M AH N T
DISABLEMENTS	D IH S EY B AH L M AH N T S
DISACCUSTOMED	D IH S AH K AH S T AH M D
DISAFFIRMED	D IH S AH F ER M D
DISAGREEMENT	D IH S AH G R IY M AH N T
DISAGREEMENTS	D IH S AH G R IY M AH N T S
DISAPPOINTMENT	D IH S AH P OY N T M AH N T
DISAPPOINTMENTS	D IH S AH P OY N T M AH N T S
DISARMAMENT	D IH S AA R M AH M AH N T
DISARMAMENTS	D IH S AA R M AH M AH N T S
DISARMED	D IH S AA R M D
DISARMER	D IH S AA R M ER
DISARMERS	D IH S AA R M ER Z
DISARRANGEMENT	D IH S AH R EY N JH M AH N T
DISARRANGEMENTS	D IH S AH R EY N JH M AH N T S
DISBANDMENT	D IH S B AE N D M AH N T
DISBANDMENTS	D IH S B AE N D M AH N T S
DISBARMENT	D IH S B AA R M AH N T
DISBARMENTS	D IH S B AA R M AH N T S
DISBOSOMED	D IH S B UH Z AH M D
DISBURDENMENT	D IH S B ER D AH N M AH N T
DISBURDENMENTS	D IH S B ER D AH N M AH N T S
DISBURSEMENT	D IH S B ER S M AH N T
DISBURSEMENTS	D IH S B ER S M AH N T S
DISCERNMENT	D IH S ER N M AH N T
DISCERNMENTS	D IH S ER N M AH N T S
DISCLAIMED	D IH S K L EY M D
DISCLAIMER	D IH S K L EY M ER
DISCLAIMERS	D IH S K L EY M ER Z
DISCOMMEND	D IH S K AH M EH N D
DISCOMMENDED	D IH S K AH M EH N D IH D
DISCOMMENDING	D IH S K AH M EH N D IH NG
DISCOMMENDS	D IH S K AH M EH N D Z
DISCONCERTMENT	D IH S K AH N S ER T M AH N T
DISCONCERTMENTS	D IH S K AH N S ER T M AH N T S
DISCONFIRMED	D IH S K AH N F ER M D
DISCONTENTMENT	D IH S K AH N T EH N T M AH N T
DISCONTENTMENTS	D IH S K AH N T EH N T M AH N T S
DISCOURAGEMENT	D IH S K ER IH JH M AH N T
DISCOURAGEMENTS	D IH S K ER IH JH M AH N T S
DISEMBOWELMENT	D IH S IH M B AW AH L M AH N T
DISEMBOWELMENTS	D IH S IH M B AW AH L M AH N T S
DISENCHANTMENT	D IH S IH N CH AE N T M AH N T
DISENCHANTMENTS	D IH S EH N CH AE N T M AH N T S
DISENDOWMENT	D IH S EH N D AW M AH N T
DISENDOWMENTS	D IH S EH N D AW M AH N T S
DISENFRANCHISEMENT	D IH S IH N F R AE N CH AY Z M AH N T
DISENFRANCHISEMENTS	D IH S EH N F R AE N CH AY Z M AH N T S
DISENGAGEMENT	D IH S IH N G EY JH M AH N T
DISENGAGEMENTS	D IH S EH N G EY JH M AH N T S
DISENTANGLEMENT	D IH S EH N T AE NG G AH L M AH N T
DISENTANGLEMENTS	D IH S EH N T AE NG G AH L M AH N T S
DISESTABLISHMENT	D IH S IH S T AE B L IH SH M AH N T
DISESTABLISHMENTARIAN	D AH S EH S T AH B L IH SH M AH N T EH R IY AH N
DISESTABLISHMENTARIANS	D AH S AH S T AH B L IH SH M AH N T AE R IY AH N Z
DISESTABLISHMENTS	D IH S IH S T AE B L IH SH M AH N T S
DISESTEEMED	D IH S IH S T IY M D
DISFIGUREMENT	D IH S F IH G Y ER M EH N T
DISFIGUREMENTS	D IH S F IH G Y ER M AH N T S
DISFRANCHISEMENT	D IH S F R AE N CH AY Z M AH N T
DISFRANCHISEMENTS	D IH S F R AE N CH AY Z M AH N T S
DISFURNISHMENT	D IH S F ER N IH SH M AH N T
DISFURNISHMENTS	D IH S F ER N IH SH M AH N T S
DISGRUNTLEMENT	D IH S G R AH N T AH L M AH N T
DISGRUNTLEMENTS	D IH S G R AH N T AH L M AH N T S
DISGUISEMENT	D IH S G AY Z M AH N T
DISGUISEMENTS	D IH S G AY Z M AH N T S
DISHEARTENMENT	D IH S HH AA R T AH N M AH N T
DISHEARTENMENTS	D IH S HH AA R T AH N M AH N T S
DISHELMED	D IH S HH EH L M D
DISILLUSIONMENT	D IH S IH L UW ZH AH N M AH N T
DISILLUSIONMENTS	D IH S IH L UW ZH AH N M AH N T S
DISINTERMEDIATION	D IH S IH N T ER M IY D IY EY SH AH N
DISINTERMEDIATIONS	D IH S IH N T ER M IY D IY EY SH AH N Z
DISINTERMENT	D IH S IH N T ER M AH N T
DISINTERMENTS	D IH S IH N T ER M AH N T S
DISINVESTMENT	D IH S IH N V EH S T M AH N T
DISINVESTMENT(2)	D IH S IH N V EH S M AH N T
DISINVESTMENTS	D IH S IH N V EH S T M AH N T S
DISLODGEMENT	D IH S L AA JH M AH N T
DISLODGEMENTS	D IH S L AA JH M AH N T S
DISLODGMENT	D IH S L AA JH M AH N T
DISLODGMENTS	D IH S L AA JH M AH N T S
DISMANTLEMENT	D IH S M AE N T AH L M AH N T
DISMANTLEMENTS	D IH S M AE N T AH L M AH N T S
DISME	D IH S M IY
DISMEMBER	D IH S M EH M B ER
DISMEMBERED	D IH S M EH M B ER D
DISMEMBERING	D IH S M EH M B ER IH NG
DISMEMBERMENT	D IH S M EH M B ER M AH N T
DISMEMBERMENTS	D IH S M EH M B ER M AH N T S
DISMEMBERS	D IH S M EH M B ER Z
DISMES	D IH Z M Z
DISOWNMENT	D IH S OW N M AH N T
DISOWNMENTS	D IH S OW N M AH N T S
DISPARAGEMENT	D IH S P AE R IH JH M AH N T
DISPARAGEMENTS	D IH S P AE R IH JH M AH N T S
DISPLACEMENT	D IH S P L EY S M AH N T
DISPLACEMENTS	D IH S P L EY S M AH N T S
DISPLUME	D IH S P L UW M
DISPLUMED	D IH S P L UW M D
DISPLUMES	D IH S P L UW M Z
DISPORTMENT	D IH S P OW R T M AH N T
DISPORTMENTS	D IH S P OW R T M AH N T S
DISREMEMBER	D IH S R IH M EH M B ER
DISREMEMBERED	D IH S R IH M EH M B ER D
DISREMEMBERING	D IH S R IH M EH M B ER IH NG
DISREMEMBERS	D IH S R IH M EH M B ER Z
DISSEPIMENT	D IH S EH P AH M AH N T
DISSEPIMENTS	D IH S EH P AH M AH N T S
DISSEVERMENT	D IH S EH V ER M AH N T
DISSEVERMENTS	D IH S EH V ER M AH N T S
DISSYMMETRIC	D IH S IH M EH T R IH K
DISSYMMETRIES	D IH S IH M AH T R IY Z
DISSYMMETRY	D IH S IH M AH T R IY
DISTOME	D IH S T OW M
DISTOMES	D IH S T OW M Z
DIVERTIMENTI	D AH V AH R T AH M EH N T IY
DIVERTIMENTO	D IH V ER T AH M EH N T OW
DIVERTIMENTOS	D IH V ER T AH M EH N T OW Z
DIVERTISSEMENT	D AH V AH R T IH S M AH N T
DIVERTISSEMENTS	D IH V AH R T IH S AH M AH N T S
DIVESTMENT	D AY V EH S T M AH N T
DIVESTMENT(2)	D AY V EH S M AH N T
DIVESTMENT(3)	D IH V EH S M AH N T
DIVESTMENTS	D AY V EH S T M AH N T S
DIVESTMENTS(2)	D AY V EH S M AH N T S
DIVESTMENTS(3)	D IH V EH S M AH N T S
DIVORCEMENT	D AH V OW R S M AH N T
DIVORCEMENTS	D AH V OW R S M AH N T S
DOCUMENT	D AA K Y AH M EH N T
DOCUMENT(2)	D AA K Y UW M EH N T
DOCUMENTABLE	D AA K Y AH M AH N T AH B AH L
DOCUMENTAL	D AA K Y AH M AH N T AH L
DOCUMENTALIST	D AA K Y AH M AH N T AH L IH S T
DOCUMENTALISTS	D AA K Y AH M AH N T AH L IH S T S
DOCUMENTARIAN	D AA K Y UW M AH N T EH R IY AH N
DOCUMENTARIANS	D AA K Y UW M AH N T AE R IY AH N Z
DOCUMENTARIES	D AA K Y AH M EH N T ER IY Z
DOCUMENTARIES(2)	D AA K Y AH M EH N ER IY Z
DOCUMENTARIES(3)	D AA K Y UW M EH N T ER IY Z
DOCUMENTARIES(4)	D AA K Y UW M EH N ER IY Z
DOCUMENTARILY	D AA K Y AH M EH N T AH R IY L IY
DOCUMENTARIST	D AA K Y AH M AH N T ER IH S T
DOCUMENTARISTS	D AA K Y AH M AH N T ER IH S T S
DOCUMENTARY	D AA K Y AH M EH N T ER IY
DOCUMENTARY(2)	D AA K Y AH M EH N ER IY
DOCUMENTARY(3)	D AA K Y UW M EH N T ER IY
DOCUMENTARY(4)	D AA K Y UW M EH N ER IY
DOCUMENTATION	D AA K Y AH M EH N T EY SH AH N
DOCUMENTATION(2)	D AA K Y UW M EH N T EY SH AH N
DOCUMENTATIONAL	D AA K Y AH M AH N T EY SH AH N AH L
DOCUMENTATIONS	D AA K Y AH M AH N T EY SH AH N Z
DOCUMENTED	D AA K Y AH M EH N T AH D
DOCUMENTED(2)	D AA K Y AH M EH N AH D
DOCUMENTED(3)	D AA K Y UW M EH N T AH D
DOCUMENTED(4)	D AA K Y UW M EH N AH D
DOCUMENTER	D AA K Y AH M AH N T ER
DOCUMENTERS	D AA K Y AH M AH N T ER Z
DOCUMENTING	D AA K Y AH M AH N T IH NG
DOCUMENTING(2)	D AA K Y AH M AH N IH NG
DOCUMENTING(3)	D AA K Y UW M AH N T IH NG
DOCUMENTING(4)	D AA K Y UW M AH N IH NG
DOCUMENTS	D AA K Y AH M AH N T S
DOCUMENTS(2)	D AA K Y UW M AH N T S
DOLESOME	D OW L S AH M
DOLMEN	D OW L M AH N
DOLMENS	D OW L M AH N Z
DOME	D OW M
DOMED	D OW M D
DOMELIKE	D OW M L AY K
DOMES	D OW M Z
DOMESDAY	D OW M Z D EY
DOMESDAYS	D OW M Z D EY Z
DOMESTIC	D AH M EH S T IH K
DOMESTICALLY	D AH M EH S T IH K L IY
DOMESTICATE	D AH M EH S T AH K EY T
DOMESTICATED	D AH M EH S T AH K EY T AH D
DOMESTICATES	D AH M EH S T AH K EY T S
DOMESTICATING	D AH M EH S T AH K EY T IH NG
DOMESTICATION	D AH M EH S T AH K EY SH AH N
DOMESTICATIONS	D AH M EH S T IH K EY SH AH N Z
DOMESTICITIES	D OW M EH S T IH S AH T IY Z
DOMESTICITY	D OW M EH S T IH S AH T IY
DOMESTICS	D AH M EH S T IH K S
DOOMED	D UW M D
DOORMEN	D OW R M EH N
DORMER	D AO R M ER
DORMERS	D AO R M ER Z
DOSIMETER	D AH S IH M AH T AH R
DOSIMETERS	D OW S IH M AH T ER Z
DOSIMETRIC	D AA S AH M AH T R AH K
DOSIMETRIES	D AA S AH M EH T R AY Z
DOSIMETRY	D AA S AH M EH T R IY
DOWNCOME	D AW N K AH M
DOWNCOMES	D AW N K AH M Z
DOWNTIME	D AW N T AY M
DOWNTIMES	D AW N T AY M Z
DRAFTSMEN	D R AE F T S M AH N
DRAGOMEN	D R AE G OW M AH N
DRAMEDIES	D R AE M D IY Z
DRAMEDY	D R AE M D IY
DRAMMED	D R AE M D
DRAUGHTSMEN	D R AE F T S M EH N
DRAYMEN	D R EY M AH N
DREAMED	D R IY M D
DREAMER	D R IY M ER
DREAMERS	D R IY M ER Z
DREAMTIME	D R IY M T AY M
DREAMTIMES	D R IY M T AY M Z
DROMEDARIES	D R AH M EH D AH R AY Z
DROMEDARY	D R AA M AH D EH R IY
DRUMMED	D R AH M D
DRUMMER	D R AH M ER
DRUMMERS	D R AH M ER Z
DULCIMER	D AH L S IH M ER
DULCIMERS	D AH L S AH M AH R Z
DURAMEN	D Y UH R AH M AH N
DURAMENS	D Y UH R AH M AH N Z
DUROMETER	D Y AH R AA M AH T AH R
DUROMETERS	D Y AH R AA M AH T AH R Z
DUSTMEN	D AH S T M EH N
DUTCHMEN	D AH CH M EH N
DYNAMOMETER	D AY N AH M AA M AH T ER
DYNAMOMETERS	D AY N AH M OW M IY T ER Z
DYNAMOMETRIC	D AY N AH M OW M EH T R IH K
DYNAMOMETRIES	D AY N AH M OW M IY T ER IY Z
DYNAMOMETRY	D AY N AH M OW M IY T ER IY
DYSMENORRHEA	D IH Z M AH N AO R IY AH
DYSMENORRHEAS	D IH Z M AH N AO R IY Z
DYSMENORRHEIC	D IH Z M AH N AO R IY AH K
EALDORMEN	EH L D AO R M AH N
EARTHMEN	ER TH M EH N
EASEMENT	IY Z M AH N T
EASEMENTS	IY Z M AH N T S
ECLAIRCISSEMENT	EH K L AH AH R S IH S M AH N T
ECLAIRCISSEMENTS	EH K L AH AH R S IH S AH M AH N T S
ECONOMETRIC	IH K AA N AH M EH T R IH K
ECONOMETRICALLY	EH K AH N AH M EH T R AH K AE L IY
ECONOMETRICIAN	AH K AA N AH M EH T R IH S IY AH N
ECONOMETRICIANS	AH K AA N AH M AH T R IH S IY AH N Z
ECONOMETRICS	IH K AA N AH M EH T R IH K S
ECONOMETRIST	AH K AA N AH M EH T R AH S T
ECONOMETRISTS	EH K AH N AH M EH T R AH S T S
ECTOMERE	EH K T OW M AH R
ECTOMERES	EH K T AH M IY R Z
ECUMENIC	EH K Y UW M AH N AH K
ECUMENICAL	EH K Y UW M EH N IH K AH L
ECUMENICALISM	EH K Y AH M EH N IH K AH L IH Z AH M
ECUMENICALISMS	EH K Y AH M EH N IH K AH L IH Z AH M Z
ECUMENICALLY	EH K Y AH M EH N IH K AH L IY
ECUMENICISM	EH K Y UW M AH N AH S IH Z AH M
ECUMENICISMS	EH K Y AH M EH N AH S AH Z AH M Z
ECUMENICIST	EH K Y UW M AH N IH S AH S T
ECUMENICISTS	EH K Y AH M EH N AH S AH S T S
ECUMENICITIES	EH K Y AH M AH N IH S AH T AY Z
ECUMENICITY	EH K Y UW M AH N IH S AH T IY
ECUMENICS	EH K Y UW M AH N AH S Z
ECUMENISM	EH K Y UW M AH N IH Z AH M
ECUMENISMS	EH K Y UW M AH N AH Z AH M Z
ECUMENIST	EH K Y UW M AH N AH S T
ECUMENISTS	EH K Y UW M AH N AH S T S
EDUTAINMENT	EH D Y AH T EY N M AH N T
EDUTAINMENTS	EH D Y AH T EY N M AH N T S
EFFACEMENT	IH F EY S M AH N T
EFFACEMENTS	IH F EY S M AH N T S
EJECTMENT	IH JH EH K T M AH N T
EJECTMENTS	IH JH EH K T M AH N T S
ELASTOMER	IH L AE S T AH M ER
ELASTOMERIC	AH L AE S T AH M AH R AH K
ELASTOMERS	IH L AE S T AH M ER Z
ELECTRODYNAMOMETER	EH L AH K T R AA D AH N AH M AA M AH T AH R
ELECTRODYNAMOMETERS	AH L AH K T R AA D AH N AH M AA M AH T AH R Z
ELECTROFORMED	AH L EH K T R AH F AH R M D
ELECTROMECHANICAL	IH L EH K T R OW M AH K AE N IH K AH L
ELECTROMECHANICALLY	AH L EH K T R AH M AH CH AE N AH K AE L IY
ELECTROMETALLURGIES	AH L AH K T R AA M AH T AE L AH R JH AY Z
ELECTROMETALLURGY	AH L EH K T R AA M AH T AE L AH R JH IY
ELECTROMETER	EH L AH K T R AA M AH T AH R
ELECTROMETERS	EH L AH K T R AA M AH T AH R Z
ELEMENT	EH L AH M AH N T
ELEMENTAL	EH L AH M EH N T AH L
ELEMENTAL(2)	EH L AH M EH N AH L
ELEMENTALLY	EH L AH M EH N T AH L IY
ELEMENTALS	EH L AH M EH N T AH L Z
ELEMENTARILY	EH L AH M EH N T R IY L IY
ELEMENTARINESS	EH L AH M EH N T R IY N AH S
ELEMENTARINESSES	EH L AH M EH N T R IY N AH S IH Z
ELEMENTARY	EH L AH M EH N T R IY
ELEMENTARY(2)	EH L AH M EH N T ER R IY
ELEMENTARY(3)	EH L AH M EH N CH R IY
ELEMENTS	EH L AH M AH N T S
ELOPEMENT	IH L OW P M AH N T
ELOPEMENTS	IH L OW P M AH N T S
EMBALMED	EH M B AA M D
EMBALMER	IH M B AA M ER
EMBALMERS	IH M B AA M ER Z
EMBALMMENT	IH M B AA M AH N T
EMBALMMENTS	IH M B AA M AH N T S
EMBANKMENT	EH M B AE NG K M AH N T
EMBANKMENTS	EH M B AE NG K M AH N T S
EMBARKMENT	IH M B AA R K M AH N T
EMBARKMENTS	IH M B AA R K M AH N T S
EMBARRASSMENT	IH M B EH R AH S M AH N T
EMBARRASSMENTS	IH M B EH R AH S M AH N T S
EMBATTLEMENT	IH M B AE T AH L M AH N T
EMBATTLEMENTS	IH M B AE T AH L M AH N T S
EMBAYMENT	EH M B EY M AH N T
EMBAYMENTS	IH M B EY M AH N T S
EMBEDMENT	IH M B EH D M AH N T
EMBEDMENTS	IH M B EH D M AH N T S
EMBELLISHMENT	EH M B EH L IH SH M AH N T
EMBELLISHMENTS	IH M B EH L IH SH M AH N T S
EMBEZZLEMENT	EH M B EH Z AH L M AH N T
EMBEZZLEMENTS	IH M B EH Z AH L M AH N T S
EMBITTERMENT	IH M B IH T ER M AH N T
EMBITTERMENTS	IH M B IH T ER M AH N T S
EMBLAZONMENT	IH M B L EY Z AH N M AH N T
EMBLAZONMENTS	IH M B L EY Z AH N M AH N T S
EMBLEMED	IH M B L IY M D
EMBLEMENTS	IH M B L EH M AH N T S
EMBODIMENT	EH M B AA D IY M AH N T
EMBODIMENTS	IH M B AA D IY M AH N T S
EMBOSOMED	IH M B UH Z AH M D
EMBOSSMENT	IH M B AO S M AH N T
EMBOSSMENTS	IH M B AO S M AH N T S
EMBOURGEOISEMENT	IH M B AH R JH IY OY Z M AH N T
EMBOURGEOISEMENTS	IH M B AH R JH IY OY S AH M AH N T S
EMBRACEMENT	IH M B R EY S M AH N T
EMBRACEMENTS	IH M B R EY S M AH N T S
EMBRANGLEMENT	IH M B R AE N G L M AH N T
EMBRANGLEMENTS	IH M B R AE N G L AH M AH N T S
EMBRITTLEMENT	IH M B R IH T AH L M AH N T
EMBRITTLEMENTS	IH M B R IH T AH L M AH N T S
EMBROILMENT	IH M B R OY L M AH N T
EMBROILMENTS	IH M B R OY L M AH N T S
EME	IH M
EMEER	IY M IH R
EMEERATE	IH M AH R EY T
EMEERATES	IH M AH R EY T S
EMEERS	AH M IH R Z
EMEND	IH M EH N D
EMENDABLE	IH M EH N D AH B AH L
EMENDATE	IH M EH N D EY T
EMENDATED	IH M EH N D EY T IH D
EMENDATES	IH M EH N D EY T S
EMENDATING	IH M EH N D EY T IH NG
EMENDATION	IH M EH N D EY SH AH N
EMENDATIONS	IH M EH N D EY SH AH N Z
EMENDED	IH M EH N D IH D
EMENDER	IH M EH N D ER
EMENDERS	IH M EH N D ER Z
EMENDING	IH M EH N D IH NG
EMENDS	IH M EH N D Z
EMERALD	EH M R AH L D
EMERALD(2)	EH M ER R AH L D
EMERALDS	EH M R AH L D Z
EMERALDS(2)	EH M ER R AH L D Z
EMERGE	IH M ER JH
EMERGE(2)	IY M ER JH
EMERGED	IH M ER JH D
EMERGED(2)	IY M ER JH D
EMERGENCE	IH M ER JH AH N S
EMERGENCE(2)	IY M ER JH AH N S
EMERGENCES	IH M ER JH AH N S IH Z
EMERGENCIES	IH M ER JH AH N S IY Z
EMERGENCIES(2)	IY M ER JH AH N S IY Z
EMERGENCY	IH M ER JH AH N S IY
EMERGENCY(2)	IY M ER JH AH N S IY
EMERGENT	IH M ER JH AH N T
EMERGENT(2)	IY M ER JH AH N T
EMERGENTS	IH M ER JH AH N T S
EMERGES	IH M ER JH IH Z
EMERGES(2)	IY M ER JH IH Z
EMERGING	IH M ER JH IH NG
EMERGING(2)	IY M ER JH IH NG
EMERIES	IH M AH R AY Z
EMERITA	AH M EH R AH T AH
EMERITAE	AH M EH R AH T IY
EMERITAS	AH M EH R AH T AH Z
EMERITI	AH M EH R AH T IY
EMERITUS	IH M EH R AH T AH S
EMEROD	AH M EH R AH D
EMERODS	AH M EH R AH D Z
EMEROID	IH M AH R OY D
EMEROIDS	IH M AH R OY D Z
EMERSED	IH M ER S T
EMERSION	AH M EH R Z IY AH N
EMERSIONS	AH M AH R S IY AH N Z
EMERY	EH M ER IY
EMES	IY M Z
EMESES	AH M IY Z AH Z
EMESIS	AH M EH S AH S
EMETIC	IH M EH T IH K
EMETICALLY	AH M EH T AH K AE L IY
EMETICS	AH M EH T AH S Z
EMETIN	AH M EH T AH N
EMETINE	IH M AH T AY N
EMETINES	IH M AH T AY N Z
EMETINS	AH M EH T AH N Z
EMEU	IH M Y UW
EMEUS	AH M IY AH S
EMEUTE	IH M AH Y UW T
EMEUTES	IH M AH Y UW T S
EMMENAGOGUE	IH M EH N AH G AH G
EMMENAGOGUES	IH M EH N AH G AH G Z
EMMER	EH M ER
EMMERS	IH M EH R Z
EMMET	EH M IH T
EMMETS	IH M EH T S
EMOLUMENT	AH M AH L UW M AH N T
EMOLUMENTS	AH M AH L UW M AH N T S
EMPLACEMENT	IH M P L EY S M AH N T
EMPLACEMENTS	IH M P L EY S M AH N T S
EMPLOYMENT	EH M P L OY M AH N T
EMPLOYMENT(2)	IH M P L OY M AH N T
EMPLOYMENTS	EH M P L OY M AH N T S
EMPLOYMENTS(2)	IH M P L OY M AH N T S
EMPOISONMENT	IH M P OY Z AH N M AH N T
EMPOISONMENTS	IH M P OY Z AH N M AH N T S
EMPOWERMENT	IH M P AW ER M AH N T
EMPOWERMENTS	IH M P AW ER M AH N T S
EMPRESSEMENT	IH M P R IY S M EH N T
EMPRESSEMENTS	IH M P R IY S EH M AH N T S
ENACTMENT	EH N AE K T M AH N T
ENACTMENT(2)	EH N AE K M AH N T
ENACTMENTS	EH N AE K T M AH N T S
ENACTMENTS(2)	EH N AE K M AH N T S
ENACTMENTS(3)	EH N AE K M AH N S
ENAMEL	IH N AE M AH L
ENAMELED	IH N AE M AH L D
ENAMELER	IH N AE M AH L ER
ENAMELERS	IH N AE M AH L ER Z
ENAMELING	IH N AE M AH L IH NG
ENAMELIST	IH N AE M AH L IH S T
ENAMELISTS	IH N AE M AH L IH S T S
ENAMELLED	IH N AE M AH L D
ENAMELLING	IH N AE M AH L IH NG
ENAMELS	IH N AE M AH L Z
ENAMELWARE	IH N AE M AH L W EH R
ENAMELWARES	IH N AE M AH L W EH R Z
ENANTIOMER	AH N AE N T AY OW M AH R
ENANTIOMERIC	AH N AH N T AY AA M AH R AH K
ENANTIOMERS	AH N AH N T AY AA M AH R Z
ENCAMPMENT	IH N K AE M P M IH N T
ENCAMPMENTS	IH N K AE M P M IH N T S
ENCASEMENT	EH N K EY S M AH N T
ENCASEMENTS	EH N K EY S M AH N T S
ENCASHMENT	EH N K AE SH M AH N T
ENCASHMENTS	EH N K AE SH M AH N T S
ENCHAINMENT	EH N CH EY N M AH N T
ENCHAINMENTS	EH N CH EY N M AH N T S
ENCHANTMENT	EH N CH AE N T M AH N T
ENCHANTMENTS	EH N CH AE N T M AH N T S
ENCIPHERMENT	EH N S AY F ER M AH N T
ENCIPHERMENTS	EH N S AY F ER M AH N T S
ENCIRCLEMENT	EH N S ER K AH L M AH N T
ENCIRCLEMENTS	EH N S ER K AH L M AH N T S
ENCOMPASSMENT	EH N K AH M P AE S M AH N T
ENCOMPASSMENTS	EH N K AH M P AE S M AH N T S
ENCOURAGEMENT	EH N K ER IH JH M AH N T
ENCOURAGEMENTS	EH N K ER IH JH M AH N T S
ENCROACHMENT	EH N K R OW CH M AH N T
ENCROACHMENTS	IH N K R OW CH M AH N T S
ENCYSTMENT	EH N S IH S T M AH N T
ENCYSTMENTS	EH N S IH S T M AH N T S
ENDAMEBA	IH N D AE M AH B AH
ENDAMEBAE	IH N D AE M AH B IY
ENDAMEBAS	IH N D AE M AH B AH Z
ENDANGERMENT	EH N D EY N JH ER M AH N T
ENDANGERMENTS	EH N D EY N JH ER M AH N T S
ENDEARMENT	IH N D IH R M AH N T
ENDEARMENTS	EH N D IH ER M AH N T S
ENDGAME	EH N D G EY M
ENDGAMES	EH N D G EY M Z
ENDOENZYME	EH N D UW EH N Z AY M
ENDOENZYMES	EH N D UW EH N Z AY M Z
ENDOMETRIA	IH N D AH M EH T R IY AH
ENDOMETRIAL	EH N D OW M IY T R IY AH L
ENDOMETRIOSES	EH N D OW M T R IY OW Z IH Z
ENDOMETRIOSIS	EH N D OW M EH T R IY OW S IH S
ENDOMETRITIS	EH N D UW M IY T ER AH T IY Z
ENDOMETRITISES	EH N D UW M IY T ER AH T IY Z IH Z
ENDOMETRIUM	IH N D AH M EH T R IY AH M
ENDORSEMENT	EH N D AO R S M AH N T
ENDORSEMENTS	EH N D AO R S M AH N T S
ENDOSOME	EH N D UW S AH M
ENDOSOMES	EH N D UW S AH M Z
ENDOWMENT	EH N D AW M AH N T
ENDOWMENTS	EH N D AW M AH N T S
ENFEEBLEMENT	EH N F IY B AH L M AH N T
ENFEEBLEMENTS	EH N F IY B AH L M AH N T S
ENFEOFFMENT	IH N F IY AA F M AH N T
ENFEOFFMENTS	IH N F IY AA F M AH N T S
ENFLAME	EH N F L EY M
ENFLAMED	EH N F L EY M D
ENFLAMES	EH N F L EY M Z
ENFORCEMENT	EH N F AO R S M AH N T
ENFORCEMENTS	EH N F AO R S M AH N T S
ENFRAME	EH N F R EY M
ENFRAMED	EH N F R EY M D
ENFRAMEMENT	EH N F R EY M AH N T
ENFRAMEMENTS	EH N F R EY M AH N T S
ENFRAMES	EH N F R EY M Z
ENFRANCHISEMENT	EH N F R AE N CH AY Z M AH N T
ENFRANCHISEMENTS	EH N F R AE N CH AY Z M AH N T S
ENGAGEMENT	EH N G EY JH M AH N T
ENGAGEMENTS	IH N G EY JH M AH N T S
ENGORGEMENT	EH N G AO R JH M AH N T
ENGORGEMENTS	EH N G AO R JH M AH N T S
ENGRAFTMENT	EH N G R AE F T M AH N T
ENGRAFTMENTS	EH N G R AE F T M AH N T S
ENGRAMME	IH N G R AE M
ENGRAMMES	IH N G R AE M Z
ENGROSSMENT	IH N G R OW S M AH N T
ENGROSSMENTS	EH N G R OW S M AH N T S
ENGULFMENT	EH N G AH L F M AH N T
ENGULFMENTS	EH N G AH L F M AH N T S
ENHANCEMENT	EH N HH AE N S M AH N T
ENHANCEMENTS	EH N HH AE N S M AH N T S
ENJAMBEMENT	EH N JH AE M B IY M AH N T
ENJAMBEMENTS	EH N JH AE M B IY M AH N T S
ENJAMBMENT	IH N JH AE M AH N T
ENJAMBMENTS	IH N JH AE M B M AH N T S
ENJOYMENT	EH N JH OY M AH N T
ENJOYMENTS	EH N JH OY M AH N T S
ENLACEMENT	EH N L EY S M AH N T
ENLACEMENTS	EH N L EY S M AH N T S
ENLARGEMENT	EH N L AA R JH M AH N T
ENLARGEMENTS	EH N L AA R JH M AH N T S
ENLIGHTENMENT	EH N L AY T AH N M AH N T
ENLIGHTENMENTS	EH N L AY T AH N M AH N T S
ENLISTMENT	EH N L IH S T M AH N T
ENLISTMENTS	EH N L IH S T M AH N T S
ENMESH	EH N M EH SH
ENMESHED	EH N M EH SH T
ENMESHES	EH N M EH SH AH Z
ENMESHING	EH N M EH SH IH NG
ENMESHMENT	EH N M EH SH M AH N T
ENMESHMENTS	EH N M EH SH M AH N T S
ENNOBLEMENT	EH N OW B AH L M AH N T
ENNOBLEMENTS	EH N OW B AH L M AH N T S
ENRICHMENT	EH N R IH CH M AH N T
ENRICHMENT(2)	IH N R IH CH M AH N T
ENRICHMENTS	EH N R IH CH M AH N T S
ENROLLMENT	EH N R OW L M AH N T
ENROLLMENTS	EH N R OW L M AH N T S
ENROLMENT	IH N R AA L M AH N T
ENROLMENTS	IH N R OW L M AH N T S
ENSERFMENT	EH N S ER F M AH N T
ENSERFMENTS	EH N S ER F M AH N T S
ENSHRINEMENT	EH N SH R AY N M AH N T
ENSHRINEMENTS	EH N SH R AY N M AH N T S
ENSLAVEMENT	EH N S L EY V M AH N T
ENSLAVEMENTS	EH N S L EY V M AH N T S
ENSORCELLMENT	EH N Z ER S EH L M AH N T
ENSORCELLMENTS	EH N Z ER S EH L M AH N T S
ENTAILMENT	IH N T EY L M AH N T
ENTAILMENTS	IH N T EY L M AH N T S
ENTAMEBA	IH N T AE M AH B AH
ENTAMEBAE	IH N T AE M AH B IY
ENTAMEBAS	IH N T AE M AH B AH Z
ENTANGLEMENT	EH N T AE NG G AH L M AH N T
ENTANGLEMENT(2)	IH N T AE NG G AH L M AH N T
ENTANGLEMENTS	EH N T AE NG G AH L M AH N T S
ENTANGLEMENTS(2)	IH N T AE NG G AH L M AH N T S
ENTERTAINMENT	EH N T ER T EY N M AH N T
ENTERTAINMENT(2)	EH N ER T EY N M AH N T
ENTERTAINMENTS	EH N T ER T EY N M AH N T S
ENTERTAINMENTS(2)	EH N ER T EY N M AH N T S
ENTHRALLMENT	IH N TH R AE L M AH N T
ENTHRALLMENTS	IH N TH R AE L M AH N T S
ENTHRONEMENT	EH N TH R OW N M AH N T
ENTHRONEMENTS	EH N TH R OW N M AH N T S
ENTHYMEME	IH N TH AH M IY M
ENTHYMEMES	IH N TH AH M IY M Z
ENTICEMENT	IH N T AY S M AH N T
ENTICEMENTS	IH N T AY S M AH N T S
ENTITLEMENT	EH N T AY T AH L M AH N T
ENTITLEMENTS	EH N T AY T AH L M AH N T S
ENTOMBMENT	IH N T UW M M AH N T
ENTOMBMENTS	EH N T UW M AH N T S
ENTRAINMENT	EH N T R EY N M AH N T
ENTRAINMENTS	EH N T R EY N M AH N T S
ENTRANCEMENT	EH N T R AH N S M AH N T
ENTRANCEMENTS	EH N T R AH N S M AH N T S
ENTRAPMENT	IH N T R AE P M AH N T
ENTRAPMENTS	EH N T R AE P M AH N T S
ENTREATMENT	EH N T R IY T M AH N T
ENTREATMENTS	EH N T R IY T M AH N T S
ENTREMETS	IH N T R EH M AH T S
ENTRENCHMENT	EH N T R EH N CH M AH N T
ENTRENCHMENTS	EH N T R EH N CH M AH N T S
ENTRUSTMENT	EH N T R AH S T M AH N T
ENTRUSTMENTS	EH N T R AH S T M AH N T S
ENUMERABILITIES	IH N UW M ER AH B IH L AH T EH Z
ENUMERABILITY	IH N UW M ER AH B IH L AH T EH
ENUMERABLE	IH N UW M ER AH B AH L
ENUMERATE	IH N UW M ER EY T
ENUMERATED	IH N UW M ER EY T IH D
ENUMERATES	IH N UW M ER EY T S
ENUMERATING	IH N UW M ER EY T IH NG
ENUMERATION	IH N UW M ER EY SH AH N
ENUMERATIONS	IH N UW M ER EY SH AH N Z
ENUMERATIVE	IH N UW M ER AH T IH V
ENUMERATOR	IH N UW M ER AH T ER
ENUMERATORS	IH N UW M ER AH T ER Z
ENVELOPMENT	IH N V EH L AH P M AH N T
ENVELOPMENTS	IH N V EH L AH P M AH N T S
ENVENOMED	EH N V EH N AH M D
ENVIRONMENT	IH N V AY R AH N M AH N T
ENVIRONMENTAL	IH N V AY R AH N M EH N T AH L
ENVIRONMENTAL(2)	IH N V AY R AH N M EH N AH L
ENVIRONMENTALISM	EH N V AY R AH N M EH N T AH L IH Z AH M
ENVIRONMENTALISM(2)	EH N V AY R AH N M EH N AH L IH Z AH M
ENVIRONMENTALISMS	IH N V AY R AH N M EH N T AH L IH Z AH M Z
ENVIRONMENTALIST	IH N V AY R AH N M EH N T AH L IH S T
ENVIRONMENTALIST(2)	IH N V AY R AH N M EH N AH L IH S T
ENVIRONMENTALISTS	EH N V AY R AH N M EH N T AH L IH S T S
ENVIRONMENTALISTS(2)	EH N V AY R AH N M EH N AH L IH S T S
ENVIRONMENTALISTS(3)	EH N V AY R AH N M EH N T AH L IH S
ENVIRONMENTALISTS(4)	EH N V AY R AH N M EH N AH L IH S
ENVIRONMENTALLY	IH N V AY R AH N M EH N T AH L IY
ENVIRONMENTALLY(2)	IH N V AY R AH N M EH N AH L IY
ENVIRONMENTS	IH N V AY R AH N M AH N T S
ENZYME	EH N Z AY M
ENZYMES	EH N Z AY M Z
EPHEMERA	AH F EH M AH R AH
EPHEMERAE	AH F EH M AH R IY
EPHEMERAL	IH F EH M ER AH L
EPHEMERALITIES	IH F EH M AH R AH L AH T IY Z
EPHEMERALITY	IH F EH M AH R AH L AH T IY
EPHEMERALLY	IH F EH M AH R AH L IY
EPHEMERALS	IH F EH M AH R AH L Z
EPHEMERAS	AH F EH M AH R AH Z
EPHEMERID	AH F EH M AH R AH D
EPHEMERIDES	AH F EH M AH R AY D Z
EPHEMERIDS	AH F EH M AH R AH D Z
EPHEMERIS	AH F EH M AH R AH S
EPHEMERON	AH F EH M AH R AH N
EPIMER	AH P AY M AH R
EPIMERASE	AH P IH M AH R EY Z
EPIMERASES	AH P IH M AH R EY Z AH Z
EPIMERE	EH P AH M AH R
EPIMERES	EH P AH M IY R Z
EPIMERIC	EH P AH M AH R AH K
EPIMERS	EH P AH M AH R Z
EPIPHENOMENA	EH P AH F AH N AA M AH N AH
EPIPHENOMENAL	EH P AH F AH N AA M AH N AH L
EPIPHENOMENALISM	EH P AH F AH N AA M AH N AH L IH Z AH M
EPIPHENOMENALISMS	AH P IH F AH N AH M EH N AH L AH Z AH M Z
EPIPHENOMENALLY	EH P AH F AH N AA M AH N AE L IY
EPIPHENOMENON	EH P AH F AH N AA M AH N AH N
EPISOME	EH P AH S AH M
EPISOMES	EH P AH S AH M Z
EPISTOME	EH P AH S T OW M
EPISTOMES	EH P AH S T OW M Z
EPITOME	IH P IH T AH M IY
EPITOMES	IH P IH T AH M IY Z
EQUIPMENT	IH K W IH P M AH N T
EQUIPMENTS	IH K W IH P M AH N T S
ERGOMETER	AH R G AA M AH T AH R
ERGOMETERS	AH R G AA M AH T AH R Z
ERGOMETRIC	AH R G AH M AH T R AH K
ESCAPEMENT	IH S K EY P M AH N T
ESCAPEMENTS	IH S K EY P M AH N T S
ESCARPMENT	EH S K AA R P M AH N T
ESCARPMENTS	EH S K AA R P M AH N T S
ESTABLISHMENT	IH S T AE B L IH SH M AH N T
ESTABLISHMENTARIAN	EH S T AH B L IH SH M AH N T EH R IY AH N
ESTABLISHMENTARIANISM	EH S T AH B L IH SH M AH N T AE R IY AH N IH Z AH M
ESTABLISHMENTARIANISMS	EH S T AH B L AH SH M EH N T AH R IY AH N AH Z AH M Z
ESTABLISHMENTARIANS	EH S T AH B L IH SH M AH N T AE R IY AH N Z
ESTABLISHMENTS	EH S T AE B L IH SH M AH N T S
ESTEEMED	EH S T IY M D
ESTRANGEMENT	IH S T R EY N JH M AH N T
ESTRANGEMENTS	IH S T R EY N JH M AH N T S
ETHNOMETHODOLOGIES	EH TH N AA M AH TH AH D AA L AH JH AY Z
ETHNOMETHODOLOGIST	EH TH N AA M AH TH AH D AA L AH JH AH S T
ETHNOMETHODOLOGISTS	EH TH N AA M AH TH AH D AA L AH JH AH S T S
ETHNOMETHODOLOGY	EH TH N AA M AH TH AH D AA L AH JH IY
EUDIOMETER	Y UW D IY AA M AH T AH R
EUDIOMETERS	Y UW D IY AA M AH T AH R Z
EUDIOMETRIC	Y UW D IY AH M AH T R AH K
EUDIOMETRICALLY	Y UW D IY AH M EH T R AH K AE L IY
EUHEMERISM	Y UW HH AH M AH R IH Z AH M
EUHEMERISMS	Y UW HH EH M AH R AH Z AH M Z
EUHEMERIST	Y UW HH EH M AH R AH S T
EUHEMERISTIC	Y UW HH EH M AH R AH S T AH K
EUHEMERISTS	Y UW HH EH M AH R AH S T S
EVERYMEN	IY V AH R IY M EH N
EVERYWOMEN	IY V AH R IY W IH M AH N
EVOLVEMENT	IH V AA L V M AH N T
EVOLVEMENTS	IH V AA L V M AH N T S
EXAMEN	EH K S AH M EH N
EXAMENS	EH K S AH M EH N Z
EXCIMER	EH K S IH M ER
EXCIMERS	IH K S IH M AH R Z
EXCISEMEN	EH K S AY Z M EH N
EXCITEMENT	IH K S AY T M AH N T
EXCITEMENTS	IH K S AY T M AH N T S
EXCLAIMED	IH K S K L EY M D
EXCLAIMER	IH K S K L EY M ER
EXCLAIMERS	IH K S K L EY M ER Z
EXCREMENT	EH K S K R AH M AH N T
EXCREMENTAL	IH K S R AH M EH N T AH L
EXCREMENTITIOUS	IH K S R AH M EH N T AH SH AH S
EXCREMENTS	IH K S R EH M AH N T S
EXHUME	EH K S HH Y UW M
EXHUMED	EH K S HH Y UW M D
EXHUMER	EH K S HH AH M ER
EXHUMERS	EH K S HH AH M ER Z
EXHUMES	EH K S HH Y UW M Z
EXOENZYME	IH G Z OW AH N Z AY M
EXOENZYMES	IH G Z OW AH N Z AY M Z
EXPERIMENT	IH K S P EH R AH M AH N T
EXPERIMENTAL	IH K S P EH R IH M EH N T AH L
EXPERIMENTALISM	IH K S P EH R AH M EH N T AH L IH Z AH M
EXPERIMENTALISMS	IH K S P EH R AH M EH N T AH L IH Z AH M Z
EXPERIMENTALIST	IH K S P EH R AH M EH N T AH L IH S T
EXPERIMENTALISTS	IH K S P EH R AH M EH N T AH L IH S T S
EXPERIMENTALLY	IH K S P EH R AH M EH N T AH L IY
EXPERIMENTATION	IH K S P EH R AH M AH N T EY SH AH N
EXPERIMENTATIONS	IH K S P EH R AH M AH N T EY SH AH N Z
EXPERIMENTED	IH K S P EH R AH M AH N T AH D
EXPERIMENTER	IH K S P EH R AH M EH N T ER
EXPERIMENTERS	IH K S P EH R AH M EH N T ER Z
EXPERIMENTING	EH K S P EH R AH M EH N T IH NG
EXPERIMENTS	IH K S P EH R AH M AH N T S
EXPRESSMEN	IH K S P R EH S M EH N
EXTENSOMETER	IH K S T EH N S AA M AH T AH R
EXTENSOMETERS	IH K S T EH N S AA M AH T AH R Z
EXTINGUISHMENT	IH K S T IH NG G W IH SH M AH N T
EXTINGUISHMENTS	IH K S T IH NG G W IH SH M AH N T S
EXTOLMENT	IH K S T AA L M AH N T
EXTOLMENTS	IH K S T OW L M AH N T S
EXTREME	IH K S T R IY M
EXTREMELY	IH K S T R IY M L IY
EXTREMENESS	IH K S T R IY M N AH S
EXTREMENESSES	IH K S T R IY M N AH S IH Z
EXTREMER	IH K S T R IY M ER
EXTREMES	IH K S T R IY M Z
EXTREMEST	IH K S T R IY M AH S T
EYESOME	AY S AH M
FAME	F EY M
FAMED	F EY M D
FAMELESS	F EY M L AH S
FAMES	F EY M Z
FAMISHMENT	F EY M IH SH M AH N T
FAMISHMENTS	F EY M IH SH M AH N T S
FARMED	F AA R M D
FARMER	F AA R M ER
FARMERETTE	F AA R M ER EH T
FARMERETTES	F AA R M ER EH T S
FARMERS	F AA R M ER Z
FATHOMED	F AE DH AH M D
FEARSOME	F IH R S AH M
FEARSOMELY	F IH ER S AH M L IY
FEARSOMENESS	F IH ER S AH M N AH S
FEARSOMENESSES	F IH ER S AH M N AH S IH Z
FELLOWMEN	F EH L OW M EH N
FEME	F IY M
FEMES	F IY M Z
FEMME	F EH M
FEMMES	F EH M Z
FEOFFMENT	F IY AA F M AH N T
FEOFFMENTS	F IY AA F M AH N T S
FERMENT	F ER M EH N T
FERMENTABLE	F ER M EH N T AH B AH L
FERMENTATION	F ER M AH N T EY SH AH N
FERMENTATIONS	F ER M EH N T EY SH AH N Z
FERMENTATIVE	F ER M EH N T AH T IH V
FERMENTED	F ER M EH N T AH D
FERMENTER	F ER M EH N T ER
FERMENTERS	F ER M EH N T ER Z
FERMENTING	F ER M EH N T IH NG
FERMENTOR	F ER M EH N T ER
FERMENTORS	F ER M EH N T ER Z
FERMENTS	F ER M EH N T S
FERRYMEN	F EH R IY M EH N
FIGMENT	F IH G M IH N T
FIGMENTS	F IH G M IH N T S
FILAMENT	F IH L AH M AH N T
FILAMENTARY	F IH L AH M AH N T EH R IY
FILAMENTOUS	F IH L AH M AH N T AH S
FILAMENTS	F IH L AH M AH N T S
FILENAME	F AY L N EY M
FILENAMES	F AY L N EY M Z
FILMED	F IH L M D
FILMER	F IH L M ER
FILMERS	F IH L M ER Z
FIREMEN	F AY R M AH N
FIRMAMENT	F AH R M AH M AH N T
FIRMAMENTAL	F ER M AH M EH N T AH L
FIRMAMENTS	F AH R M AH M AH N T S
FIRMED	F ER M D
FIRMER	F ER M ER
FIRMERS	F ER M ER Z
FIRMEST	F ER M AH S T
FISHERMEN	F IH SH ER M IH N
FISHERWOMEN	F IH SH ER W IH M AH N
FISHMEAL	F IH SH M IY L
FISHMEALS	F IH SH M IY L Z
FITMENT	F IH T M AH N T
FITMENTS	F IH T M AH N T S
FLAGMEN	F L AE G M EH N
FLAME	F L EY M
FLAMED	F L EY M D
FLAMEN	F L EY M AH N
FLAMENCO	F L AH M EH NG K OW
FLAMENCOS	F L AH M EH NG K AH Z
FLAMENS	F L EY M AH N Z
FLAMEOUT	F L EY M AW T
FLAMEOUTS	F L EY M AW T S
FLAMEPROOF	F L EY M P R UW F
FLAMEPROOFED	F L EY M P R UW F T
FLAMEPROOFER	F L EY M P R UW F ER
FLAMEPROOFERS	F L EY M P R UW F ER Z
FLAMEPROOFING	F L EY M P R UW F IH NG
FLAMEPROOFS	F L EY M P R UW F S
FLAMER	F L EY M ER
FLAMERS	F L EY M ER Z
FLAMES	F L EY M Z
FLAMETHROWER	F L EY M TH R OW ER
FLAMETHROWERS	F L EY M TH R OW ER Z
FLAMMED	F L AE M D
FLAVORSOME	F L EY V ER S AH M
FLESHMENT	F L EH SH M AH N T
FLESHMENTS	F L EH SH M AH N T S
FLEXITIME	F L EH K S AH T AY M
FLEXITIMES	F L EH K S AH T AY M Z
FLEXTIME	F L EH K S T AY M
FLEXTIMES	F L EH K S T AY M Z
FLIMFLAMMED	F L IH M F L AH M D
FLIMFLAMMER	F L IH M F L AE M AH R
FLIMFLAMMERIES	F L IH M F L AE M AH R AY Z
FLIMFLAMMERS	F L IH M F L AE M AH R Z
FLIMFLAMMERY	F L IH M F L AH M EH R IY
FLOWMETER	F L OW M IY T ER
FLOWMETERS	F L OW M IY T ER Z
FLUME	F L UW M
FLUMED	F L UW M D
FLUMES	F L UW M Z
FLUMMERIES	F L AH M AH R AY Z
FLUMMERY	F L AH M AH R IY
FLUORIMETER	F L UW W AH R IH M AH T AH R
FLUORIMETERS	F L UW W AH R IH M AH T AH R Z
FLUORIMETRIC	F L UW W AO R AH M AH T R AH K
FLUORIMETRIES	F L UW W AH R AH M EH T R AY Z
FLUORIMETRY	F L UW W AH R AH M EH T R IY
FLUOROCHROME	F L UW W AO R AH K R OW M
FLUOROCHROMES	F L UW W AO R AH K R OW M Z
FLUOROMETER	F L UH R AA M AH T ER
FLUOROMETER(2)	F L AO R AA M AH T ER
FLUOROMETERS	F L UW W AH R AA M AH T AH R Z
FLUOROMETRIC	F L UW W AO R AH M AH T R AH K
FLUOROMETRIES	F L UW W AH R AH M EH T R AY Z
FLUOROMETRY	F L UW W AH R AH M EH T R IY
FLYMEN	F L AY M EH N
FOAMED	F OW M D
FOAMER	F OW M ER
FOAMERS	F OW M ER Z
FOEMEN	F OW M EH N
FOILSMEN	F OY L Z M EH N
FOMENT	F OW M EH N T
FOMENTATION	F AA M AH N T EY SH AH N
FOMENTATIONS	F AA M AH N T EY T IY AH N Z
FOMENTED	F OW M EH N T IH D
FOMENTER	F AH M EH N T AH R
FOMENTERS	F AH M EH N T AH R Z
FOMENTING	F OW M EH N T IH NG
FOMENTS	F AA M AH N T S
FOOTMEN	F UH T M EH N
FORAMEN	F ER EY M AH N
FORAMENS	F AO R AH M EH N Z
FORCEMEAT	F OW R S M IY T
FORCEMEATS	F OW R S M IY T S
FOREARMED	F OW R AA R M D
FOREDOOMED	F OW R D UW M D
FOREMEN	F AO R M AH N
FORENAME	F OW R N EY M
FORENAMED	F OW R N EY M D
FORENAMES	F OW R N EY M Z
FORESTALLMENT	F OW R S T AO L M AH N T
FORESTALLMENTS	F OW R S T AO L M AH N T S
FORETIME	F OW R T AY M
FORETIMES	F OW R T AY M Z
FORETOPMEN	F OW R T AA P M EH N
FOREWOMEN	F AO R W IH M EH N
FORME	F AO R M
FORMED	F AO R M D
FORMEE	F AO R M IY
FORMER	F AO R M ER
FORMERLY	F AO R M ER L IY
FORMERS	F AO R M ER Z
FORMES	F AO R M Z
FOURSOME	F AO R S AH M
FOURSOMES	F OW R S AH M Z
FRAGMENT	F R AE G M AH N T
FRAGMENTAL	F R AE G M AH N T AH L
FRAGMENTALLY	F R AE G M AH N T AH L IY
FRAGMENTARILY	F R AE G M AH N T EH R IY L IY
FRAGMENTARINESS	F R AE G M AH N T EH R IY N AH S
FRAGMENTARINESSES	F R AE G M AH N T EH R IY N AH S IH Z
FRAGMENTARY	F R AE G M AH N T EH R IY
FRAGMENTATE	F R AE G M AH N T AH T
FRAGMENTATED	F R AE G M AH N T EY T IH D
FRAGMENTATES	F R AE G M AH N T AH T S
FRAGMENTATING	F R AE G M AH N T EY T IH NG
FRAGMENTATION	F R AE G M AH N T EY SH AH N
FRAGMENTATIONS	F R AE G M AH N T EY SH AH N Z
FRAGMENTED	F R AE G M AH N T IH D
FRAGMENTING	F R AE G M EH N T IH NG
FRAGMENTIZE	F R AE G M AH N T AY Z
FRAGMENTIZED	F R AE G M AH N T AY Z D
FRAGMENTIZES	F R AE G M AH N T AY Z IH Z
FRAGMENTIZING	F R AE G M AH N T AY Z IH NG
FRAGMENTS	F R AE G M AH N T S
FRAME	F R EY M
FRAMEABLE	F R EY M AH B AH L
FRAMED	F R EY M D
FRAMER	F R EY M ER
FRAMERS	F R EY M ER Z
FRAMES	F R EY M Z
FRAMESHIFT	F R EY M SH IH F T
FRAMESHIFTS	F R EY M SH IH F T S
FRAMEWORK	F R EY M W ER K
FRAMEWORKS	F R EY M W ER K S
FREEDMEN	F R IY D M AH N
FREEDWOMEN	F R IY D W AH M AH N
FREEMEN	F R IY M EH N
FRESHMEN	F R EH SH M IH N
FRETSOME	F R EH T S AH M
FROGMEN	F R AA G M IH N
FROLICSOME	F R AA L IH K S AH M
FROMENTIES	F R AH M EH N T AY Z
FROMENTY	F R AH M EH N T IY
FRONTIERSMEN	F R AH N T IH ER Z M EH N
FRUMENTIES	F R UW M EH N T AY Z
FRUMENTY	F R UW M EH N T IY
FUGLEMEN	F AH G L AH M AH N
FULFILLMENT	F UH L F IH L M AH N T
FULFILLMENTS	F UH L F IH L M AH N T S
FULSOME	F UH L S AH M
FULSOMELY	F UH L S OW M L IY
FULSOMENESS	F UH L S OW M N AH S
FULSOMENESSES	F UH L S AA M AH N EH S AH Z
FUME	F Y UW M
FUMED	F Y UW M D
FUMELESS	F Y UW M L AH S
FUMELIKE	F Y UW M L AY K
FUMER	F Y UW M ER
FUMERS	F Y UW M ER Z
FUMES	F Y UW M Z
FUMET	F Y UW M AH T
FUMETS	F Y UW M AH T S
FUMETTE	F Y UW M EH T
FUMETTES	F Y UW M EH T S
FUNDAMENT	F AH N D EY M AH N T
FUNDAMENTAL	F AH N D AH M EH N T AH L
FUNDAMENTAL(2)	F AH N D AH M EH N AH L
FUNDAMENTALISM	F AH N D AH M EH N T AH L IH Z AH M
FUNDAMENTALISM(2)	F AH N D AH M EH N AH L IH Z AH M
FUNDAMENTALISMS	F AH N D AH M EH N T AH L IH Z AH M Z
FUNDAMENTALIST	F AH N D AH M EH N T AH L IH S T
FUNDAMENTALIST(2)	F AH N D AH M EH N AH L IH S T
FUNDAMENTALISTIC	F AH N D AH M EH N T AH L IH S T IH K
FUNDAMENTALISTS	F AH N D AH M EH N T AH L IH S T S
FUNDAMENTALISTS(2)	F AH N D AH M EH N AH L IH S T S
FUNDAMENTALISTS(3)	F AH N D AH M EH N T AH L IH S
FUNDAMENTALISTS(4)	F AH N D AH M EH N AH L IH S
FUNDAMENTALLY	F AH N D AH M EH N T AH L IY
FUNDAMENTALLY(2)	F AH N D AH M EH N AH L IY
FUNDAMENTALS	F AH N D AH M EH N T AH L Z
FUNDAMENTALS(2)	F AH N D AH M EH N AH L Z
FUNDAMENTS	F AH N D EY M AH N T S
FUNNYMEN	F AH N IY M EH N
FURMENTIES	F Y UH R M AH N T IY Z
FURMENTY	F Y UH R M AH N T IY
FURMETIES	F ER M IY T IY Z
FURMETY	F ER M IY T IY
GAGMEN	G AE G M EH N
GALVANOMETER	G AE L V AH N AA M AH T AH R
GALVANOMETERS	G AE L V AH N AA M AH T AH R Z
GALVANOMETRIC	G AE L V AE N AH M AH T R AH K
GAME	G EY M
GAMECOCK	G EY M K AO K
GAMECOCKS	G EY M K AO K S
GAMED	G EY M D
GAMEKEEPER	G EY M K IY P ER
GAMEKEEPERS	G EY M K IY P ER S
GAMELAN	G AE M AH L AH N
GAMELANS	G AE M AH L AH N Z
GAMELIKE	G EY M L AY K
GAMELY	G EY M L IY
GAMENESS	G EY M N AH S
GAMENESSES	G EY M N AH S IH Z
GAMER	G EY M ER
GAMERS	G EY M ER Z
GAMES	G EY M Z
GAMESMAN	G EY M Z M AE N
GAMESMANSHIP	G EY M Z M AH N SH IH P
GAMESMANSHIPS	G EY M Z M AE N SH IH P S
GAMESMEN	G EY M Z M EH N
GAMESOME	G EY M S AH M
GAMESOMELY	G EY M S AH M L IY
GAMESOMENESS	G EY M S AH M N AH S
GAMESOMENESSES	G EY M S AH M N AH S IH Z
GAMEST	G EY M AH S T
GAMESTER	G EY M S T ER
GAMESTERS	G EY M S T ER Z
GAMETANGIA	G AE M AH T AE N JH IY AH
GAMETANGIUM	G AE M AH T AE N JH IY AH M
GAMETE	G AE M IY T
GAMETE(2)	G AH M IY T
GAMETES	G AH M IY T S
GAMETIC	G AE M AH T AH K
GAMETICALLY	G AH M EH T AH K AE L IY
GAMETOCYTE	G AH M EH T AH S AY T
GAMETOCYTES	G AH M EH T AH S AY T S
GAMETOGENESES	G AH M AH T AA JH AH N IY Z AH Z
GAMETOGENESIS	G AE M AH T AH JH IY N AH S AH S
GAMETOGENIC	G EY M T AA G AH N IH K
GAMETOGENOUS	G EY M T AA G AH N AH S
GAMETOPHORE	G AH M EH T AH F AH R
GAMETOPHORES	G AH M EH T AH F AH R Z
GAMETOPHYTE	G AH M IY T AH F AY T
GAMETOPHYTES	G AH M EH T AH F AY T S
GAMETOPHYTIC	G AH M EH T AH F AH T AH K
GAMEY	G EY M IY
GAMMED	G AE M D
GAMMER	G AE M AH R
GAMMERS	G AE M AH R Z
GAMODEME	G AE M AH D IY M
GAMODEMES	G AE M AH D IY M Z
GANYMEDE	G AE N AH M IY D
GANYMEDES	G AE N AH M IY D Z
GARAGEMEN	G AH R AA ZH M EH N
GARBAGEMEN	G AA R B IH JH M EH N
GARMENT	G AA R M AH N T
GARMENTED	G AA R M AH N T IH D
GARMENTING	G AA R M AH N T IH NG
GARMENTS	G AA R M AH N T S
GARNISHMENT	G AA R N IH SH M AH N T
GARNISHMENTS	G AA R N IH SH M AH N T S
GASMEN	G AE S M EH N
GASOMETER	G EY Z AA M AH T AH R
GASOMETERS	G AH S AA M AH T AH R Z
GASTRONOME	G AE S T R AH N OW M
GASTRONOMES	G AE S T R AH N OW M Z
GATEMEN	G EY T M EH N
GAUMED	G AO M D
GEDANKENEXPERIMENT	JH AH D AE NG K AH N EH K S EH R AH M AH N T
GEDANKENEXPERIMENTS	JH AH D AE NG K AH N AH K S EH R AH M AH N T S
GEMEINSCHAFT	JH IY M IY N S AH F T
GEMEINSCHAFTEN	JH IY M IY N S AE F T AH N
GEMEINSCHAFTS	JH IY M IY N S AH F T S
GEMMED	JH EH M D
GENDARME	ZH AA N D AA R M
GENDARMERIE	JH EH N D AH R M IY R AY
GENDARMERIES	JH EH N D AA R M AH R AY Z
GENDARMERY	JH EH N D AH R M EH R IY
GENDARMES	JH EH N D AH R M Z
GENOME	JH IY N OW M
GENOMES	JH AH N OW M Z
GENTLEMEN	JH EH N T AH L M IH N
GENTLEMEN(2)	JH EH N AH L M IH N
GENTLEWOMEN	JH EH N T AH L W IH M AH N
GENTLEWOMEN(2)	JH EH N AH L W IH M AH N
GEOMETER	JH IY AA M AH T AH R
GEOMETERS	JH IY AA M AH T AH R Z
GEOMETRIC	JH IY AH M EH T R IH K
GEOMETRICAL	JH IY AH M EH T R IH K AH L
GEOMETRICALLY	JH IY AH M EH T R IH K L IY
GEOMETRICIAN	JH IY AH M EH T R IH S IY AH N
GEOMETRICIANS	JH IY AH M AH T R IH S IY AH N Z
GEOMETRICS	JH IY AH M EH T R IH K S
GEOMETRID	JH IY AH M EH T R AH D
GEOMETRIDS	JH IY AH M EH T R AH D Z
GEOMETRIES	JH IY AA M AH T R IY Z
GEOMETRISE	JH IY AA M AH T R AY Z
GEOMETRISED	JH IY AA M AH T R IY Z D
GEOMETRISES	JH IY AA M AH T R IY Z IH Z
GEOMETRISING	JH IY AA M AH T R IY Z IH NG
GEOMETRIZATION	JH IY AH M EH T R AH Z EY SH AH N
GEOMETRIZATIONS	JH IY AH M EH T R AH Z EY T IY AH N Z
GEOMETRIZE	JH IY AA M AH T R AY Z
GEOMETRIZED	JH IY AA M AH T R AY Z D
GEOMETRIZES	JH IY AA M AH T R AY Z AH Z
GEOMETRIZING	JH IY AA M AH T R AY Z AH NG
GEOMETRY	JH IY AA M AH T R IY
GERMEN	JH ER M AH N
GERMENS	JH ER M AH N Z
GIMEL	JH IH M AH L
GIMELS	JH IH M AH L Z
GIMME	G IH M IY
GIMMES	JH IH M Z
GISARME	JH IH S AH R M
GISARMES	JH IH S AH R M Z
GLADSOME	G L AE D S AH M
GLADSOMELY	G L AE D S AH M L IY
GLADSOMENESS	G L AE D S AH M N AH S
GLADSOMENESSES	G L AE D S AH M N AH S IH Z
GLADSOMER	G L AE D S AH M ER
GLADSOMEST	G L AE D S AH M AH S T
GLASSMEN	G L AE S M EH N
GLEAMED	G L IY M D
GLEAMER	G L IY M ER
GLEAMERS	G L IY M ER Z
GLEEMEN	G L IY M EH N
GLEESOME	G L IY S AH M
GLIME	G L AY M
GLIMED	G L AY M D
GLIMES	G L AY M Z
GLIMMER	G L IH M ER
GLIMMERED	G L IH M ER D
GLIMMERING	G L IH M ER IH NG
GLIMMERINGS	G L IH M ER IH NG Z
GLIMMERS	G L IH M ER Z
GLOMERA	G L AA M IH R AH
GLOMERULAR	G L AA M EH R Y AH L ER
GLOMERULE	G L AA M AH R UW L
GLOMERULES	G L AA M AH R AH L Z
GLOMERULI	G L AA M AH R UW L IY
GLOMERULONEPHRITIDES	G L AH M AH R UW L AH N EH F R AH T AY D Z
GLOMERULONEPHRITIS	G L AA M AH R UW L AH N AH F R AY T AH S
GLOMERULUS	G L AH M EH R AH L AH S
GLOMMED	G L AA M D
GLOOMED	G L UW M D
GLOSSEME	G L AA S IY M
GLOSSEMES	G L AA S IY M Z
GLUME	G L UW M
GLUMES	G L UW M Z
GLUMMER	G L AH M ER
GLUMMEST	G L AH M AH S T
GNOME	N OW M
GNOMELIKE	N OW M L AY K
GNOMES	N OW M Z
GODDAMMED	G AA D AE M D
GOMERAL	G OW M IH ER AH L
GOMERALS	G OW M IH ER AH L Z
GOMEREL	G AA M AH R AH L
GOMERELS	G AA M AH R AH L Z
GOMERIL	G AA M AH R AH L
GOMERILS	G AA M AH R AH L Z
GONIOMETER	G OW N IY AA M AH T ER
GONIOMETERS	G OW N IY AA M AH T AH R Z
GONIOMETRIC	G OW N IY AH M AH T R AH K
GONIOMETRIES	G OW N IY AH M EH T R AY Z
GONIOMETRY	G OW N IY AH M EH T R IY
GOODMEN	G UH D M EH N
GOSSAMER	G AA S AH M ER
GOSSAMERS	G AA S AH M ER Z
GOSSAMERY	G AA S AH M ER IY
GOURMET	G UH R M EY
GOURMETS	G UH R M EY Z
GOVERNMENT	G AH V ER N M AH N T
GOVERNMENTAL	G AH V ER M EH N T AH L
GOVERNMENTAL(2)	G AH V ER N M EH N T AH L
GOVERNMENTALISM	G AH V ER N M EH N T AH L IH Z AH M
GOVERNMENTALISMS	G AH V ER N M EH N T AH L IH Z AH M Z
GOVERNMENTALIST	G AH V ER N M EH N T AH L IH S T
GOVERNMENTALISTS	G AH V ER N M EH N T AH L IH S T S
GOVERNMENTALIZE	G AH V ER N M EH N T AH L AY Z
GOVERNMENTALIZED	G AH V ER N M EH N T AH L AY Z D
GOVERNMENTALIZES	G AH V ER N M EH N T AH L AY Z IH Z
GOVERNMENTALIZING	G AH V ER N M EH N T AH L AY Z IH NG
GOVERNMENTALLY	G AH V ER M EH N T AH L IY
GOVERNMENTESE	G AH V AH R N M AH N T IY Z
GOVERNMENTESES	G AH V AH R N M AH N T IY Z AH Z
GOVERNMENTS	G AH V ER N M AH N T S
GOWNSMEN	G AW N Z M EH N
GRADIOMETER	G R EY D IY AA M AH T AH R
GRADIOMETERS	G R EY D IY AA M AH T AH R Z
GRAMERCIES	G R AH M AH R S AY Z
GRAMERCY	G R AH M ER S IY
GRAMME	G R AE M
GRAMMES	G R AE M Z
GRANDAME	G R AE N D EY M
GRANDAMES	G R AE N D EY M Z
GRANTSMEN	G R AE N T S M EH N
GRAPHEME	G R AH F IY M
GRAPHEMES	G R AH F IY M Z
GRAVAMEN	G R AE V AH M AH N
GRAVAMENS	G R AE V AH M AH N Z
GRAVIMETER	G R AE V AH M IY T ER
GRAVIMETERS	G R AH V IH M AH T AH R Z
GRAVIMETRIC	G R AE V AH M EH T R IH K
GRAVIMETRICALLY	G R AE V AH M EH T R AH K AE L IY
GRAVIMETRIES	G R AE V AH M EH T R AY Z
GRAVIMETRY	G R AE V AH M EH T R IY
GREWSOME	G R UW S AH M
GREWSOMER	G R UW S AH M ER
GREWSOMEST	G R UW S AH M AH S T
GRIME	G R AY M
GRIMED	G R AY M D
GRIMES	G R AY M Z
GRIMMER	G R IH M ER
GRIMMEST	G R IH M AH S T
GRIPMEN	G R IH P M EH N
GROMMET	G R AA M AH T
GROMMETS	G R AA M AH T S
GROOMED	G R UW M D
GROOMER	G R UW M ER
GROOMERS	G R UW M ER Z
GROOMSMEN	G R UW M Z M EH N
GROUNDSMEN	G R AW N D Z M EH N
GRUESOME	G R UW S AH M
GRUESOMELY	G R UW S AH M L IY
GRUESOMENESS	G R UW S AH M N AH S
GRUESOMENESSES	G R UW S AH M N AH S IH Z
GRUESOMER	G R UW S AH M ER
GRUESOMEST	G R UW S AH M AH S T
GRUME	G R UW M
GRUMES	G R UW M Z
GRUMMER	G R AH M AH R
GRUMMEST	G R AH M AH S T
GRUMMET	G R AH M AH T
GRUMMETS	G R AH M AH T S
GUARDSMEN	G AA R D Z M IH N
GUILDSMEN	G IH L D Z M EH N
GUILLEMET	G UW L AH M AH T
GUILLEMETS	G UW L AH M AH T S
GUMMED	G AH M D
GUMMER	G AH M ER
GUMMERS	G AH M ER Z
GUNMEN	G AH N M EH N
GUNMETAL	G AH N M EH T AH L
GUNMETALS	G AH N M EH T AH L Z
HABILIMENT	HH AH B IH L AH M AH N T
HABILIMENTS	HH AH B IH L AH M AH N T S
HACKMEN	HH AE K M EH N
HALFTIME	HH AE F T AY M
HALFTIMES	HH AE F T AY M Z
HALIDOME	HH AE L AH D OW M
HALIDOMES	HH AE L AH D OW M Z
HAME	HH EY M
HAMES	HH EY M Z
HAMMED	HH AE M D
HAMMER	HH AE M ER
HAMMERED	HH AE M ER D
HAMMERER	HH AE M ER ER
HAMMERERS	HH AE M ER ER Z
HAMMERHEAD	HH AE M ER HH EH D
HAMMERHEADS	HH AE M ER HH EH D Z
HAMMERING	HH AE M ER IH NG
HAMMERLESS	HH AE M ER L AH S
HAMMERLOCK	HH AE M ER L AA K
HAMMERLOCKS	HH AE M ER L AA K S
HAMMERS	HH AE M ER Z
HAMMERTOE	HH AE M ER T OW
HAMMERTOES	HH AE M ER T OW Z
HANDCRAFTSMEN	HH AE N D K R AE F T S M EH N
HANDICRAFTSMEN	HH AE N D IH K R AE F T S M EH N
HANDSOME	HH AE N S AH M
HANDSOMELY	HH AE N S AH M L IY
HANDSOMENESS	HH AE N S AH M N AH S
HANDSOMENESSES	HH AE N S AH M N AH S IH Z
HANDSOMER	HH AE N S AH M ER
HANDSOMEST	HH AE N S AH M AH S T
HANDYMEN	HH AE N D IY M EH N
HANGMEN	HH AE NG M EH N
HARASSMENT	HH ER AE S M AH N T
HARASSMENTS	HH AH R AE S M AH N T S
HARDIMENT	HH AA R D IY M AH N T
HARDIMENTS	HH AA R D IY M AH N T S
HARMED	HH AA R M D
HARMER	HH AA R M ER
HARMERS	HH AA R M ER Z
HARVESTMEN	HH AA R V AH S T M EH N
HARVESTTIME	HH AA R V AH S T AY M
HARVESTTIMES	HH AA R V AH S T AY M Z
HATCHMENT	HH AE CH M AH N T
HATCHMENTS	HH AE CH M AH N T S
HEADMEN	HH EH D M EH N
HEADSMEN	HH EH D Z M EH N
HEARTSOME	HH AA R T S AH M
HEARTSOMELY	HH AA R T S AH M L IY
HEAUME	HH IY UW M
HEAUMES	HH IY UW M Z
HECTOMETER	HH EH K T AA M AH T AH R
HECTOMETERS	HH EH K T AA M AH T AH R Z
HEGUMEN	HH EH G Y UW M AH N
HEGUMENE	HH EH G Y AH M IY N
HEGUMENES	HH EH G Y AH M IY N Z
HEGUMENIES	HH EH G Y UW M AH N AY Z
HEGUMENS	HH EH G Y UW M AH N Z
HEGUMENY	HH EH G Y UW M AH N IY
HELIOMETER	HH IY L IY AA M AH T AH R
HELIOMETERS	HH IY L IY AA M AH T AH R Z
HELIOMETRIC	HH IY L IY AH M AH T R AH K
HELIOMETRICALLY	HH IY L IY AH M EH T R AH K AE L IY
HELMED	HH EH L M D
HELMET	HH EH L M AH T
HELMETED	HH EH L M AH T IH D
HELMETING	HH EH L M AH T IH NG
HELMETLIKE	HH EH L M AH T L AY K
HELMETS	HH EH L M AH T S
HELMSMEN	HH EH L M Z M EH N
HELPMEET	HH EH L P M IY T
HELPMEETS	HH EH L P M IY T S
HEMACYTOMETER	HH EH M AH S AH T AA M AH T AH R
HEMACYTOMETERS	HH EH M AH S AH T AA M AH T AH R Z
HEME	HH IY M
HEMELYTRA	HH EH M AH L IH T R AH
HEMELYTRON	HH EH M AH L IH T R AH N
HEMEROCALLIS	HH AH M EH R AH K AE L AH S
HEMEROCALLISES	HH AH M AH R AA K AH L AY Z AH Z
HEMERYTHRIN	HH EH M AH R IH TH R AH N
HEMERYTHRINS	HH EH M AH R IH TH R AH N Z
HEMES	HH IY M Z
HEMIMETABOLOUS	HH EH M AH M AH T AE B AH L AH S
HEMMED	HH EH M D
HEMMER	HH EH M ER
HEMMERS	HH EH M ER Z
HEMOCYTOMETER	HH EH M AH S AH T AA M AH T AH R
HEMOCYTOMETERS	HH EH M AH S AH T AA M AH T AH R Z
HENCHMEN	HH EH N CH M AH N
HEPATOMEGALIES	HH EH P AH T AH M EH G AH L AY Z
HEPATOMEGALY	HH EH P AH T AH M EH G AH L IY
HEPTAMETER	HH EH P T AE M AH T AH R
HEPTAMETERS	HH EH P T AE M AH T AH R Z
HERDMEN	HH ER D M EH N
HERDSMEN	HH ER D Z M IH N
HEREDITAMENT	HH EH R AH D IH T AH M AH N T
HEREDITAMENTS	HH EH R AH D IH T AH M AH N T S
HERMENEUTIC	HH AH R M IY N AH Y UW T AH K
HERMENEUTICAL	HH AH R M AH N AH Y AH T IH S AH L
HERMENEUTICALLY	HH AH R M IY N Y UW T AH K AE L IY
HERMENEUTICS	HH ER M AH N UW T IH K S
HERMETIC	HH ER M EH T IH K
HERMETICAL	HH ER M EH T IH K AH L
HERMETICALLY	HH ER M EH T IH K AH L IY
HERMETICALLY(2)	HH ER M EH T IH K L IY
HERMETICISM	HH ER M EH T IH K IH Z AH M
HERMETICISMS	HH ER M EH T IH K IH Z AH M Z
HERMETISM	HH AH R M AH T IH Z AH M
HERMETISMS	HH AH R M AH T AH Z AH M Z
HERMETIST	HH AH R M AH T AH S T
HERMETISTS	HH AH R M AH T AH S T S
HETEROGAMETE	HH AH T AH R AA G AH M IY T
HETEROGAMETES	HH AH T AH R AA G AH M IY T S
HETEROGAMETIC	HH EH T AH R AA G AH M AH T AH K
HETEROGAMETIES	HH EH T AH R AH G AE M AH T AY Z
HETEROGAMETY	HH EH T AH R AH G EY M AH T IY
HEXAMETER	HH EH K S AE M AH T ER
HEXAMETERS	HH EH K S AE M AH T ER Z
HEXAMETHONIUM	HH EH K S AH M AH TH OW N IY AH M
HEXAMETHONIUMS	HH EH K S AH M AH TH OW N IY AH M Z
HEXAMETHYLENETETRAMINE	HH EH K S AH M AH TH AH L AH N AH T EH T R AH M AY N
HEXAMETHYLENETETRAMINES	HH EH K S AH M AH TH AH L AH N AH T EH T R AH M AY N Z
HIGHWAYMEN	HH AY W EY M EH N
HIPPODROME	HH IH P AH D R OW M
HIPPODROMES	HH IH P AH D R OW M Z
HOGMENAY	HH AA G M EH N EY IY
HOGMENAYS	HH AA G M AH N EY Z
HOLOENZYME	HH AA L OW AH N Z AY M
HOLOENZYMES	HH AA L OW AH N Z AY M Z
HOLOMETABOLISM	HH AA L AH M EH T AH B AH L IH Z AH M
HOLOMETABOLISMS	HH AA L AH M AH T AE B AH L AH Z AH M Z
HOLOMETABOLOUS	HH AA L AH M AH T AE B AH L AH S
HOME	HH OW M
HOMEBODIES	HH OW M B AA D IY Z
HOMEBODY	HH OW M B AA D IY
HOMEBOUND	HH OW M B AW N D
HOMEBOY	HH OW M B OY
HOMEBOYS	HH OW M B OY Z
HOMEBRED	HH OW M B R EH D
HOMEBREDS	HH OW M B R EH D Z
HOMEBREW	HH OW M B R UW
HOMEBREWS	HH OW M B R UW Z
HOMEBUILT	HH OW M B IH L T
HOMECOMING	HH OW M K AH M IH NG
HOMECOMINGS	HH OW M K AH M IH NG Z
HOMED	HH OW M D
HOMEGIRL	HH OW M G ER L
HOMEGIRLS	HH OW M G ER L Z
HOMEGROWN	HH OW M G R OW N
HOMELAND	HH OW M L AE N D
HOMELANDS	HH OW M L AE N D Z
HOMELESS	HH OW M L AH S
HOMELESSNESS	HH OW M L AH S N AH S
HOMELESSNESSES	HH OW M L AH S N AH S IH Z
HOMELIER	HH OW M L IY ER
HOMELIEST	HH OW M L IY AH S T
HOMELIKE	HH OW M L AY K
HOMELINESS	HH OW M L IY N AH S
HOMELINESSES	HH OW M L IY N AH S IH Z
HOMELY	HH OW M L IY
HOMEMADE	HH OW M M EY D
HOMEMADE(2)	HH OW M EY D
HOMEMAKER	HH OW M M EY K ER
HOMEMAKERS	HH OW M M EY K ER Z
HOMEMAKING	HH OW M M EY K IH NG
HOMEMAKINGS	HH OW M EY K IH NG Z
HOMEOBOX	HH OW M IY AH B AH K S
HOMEOBOXES	HH OW M IY AH B AH K S
HOMEOMORPHIC	HH OW M IY AH M AH R F AH K
HOMEOMORPHISM	HH OW M IY AH M AH R F IH Z AH M
HOMEOMORPHISMS	HH OW M IY AH M AO R F AH Z AH M Z
HOMEOPATH	HH OW M IY AH P AH TH
HOMEOPATHIC	HH OW M IY OW P AE TH AH K
HOMEOPATHICALLY	HH OW M IY AH P AE TH AH K AE L IY
HOMEOPATHIES	HH OW M IY AA P AH TH AY Z
HOMEOPATHS	HH OW M IY AH P AH TH S
HOMEOPATHY	HH OW M IY OW P AE TH IY
HOMEOSTASES	HH OW M IY AH S T EY Z AH Z
HOMEOSTASIS	HH OW M IY OW S T EY S AH S
HOMEOSTATIC	HH OW M IY OW S T AE T IH K
HOMEOTHERM	HH OW M IY AH TH AH R M
HOMEOTHERMIC	HH OW M IY AH TH AH R M AH K
HOMEOTHERMIES	HH OW M IY AH TH AH R M AY Z
HOMEOTHERMS	HH OW M IY AH TH AH R M Z
HOMEOTHERMY	HH OW M IY AH TH AH R M IY
HOMEOTIC	HH OW M IY AH T AH K
HOMEOWNER	HH OW M OW N ER
HOMEOWNERS	HH OW M OW N ER Z
HOMEPORT	HH OW M P OW R T
HOMEPORTED	HH OW M P OW R T IH D
HOMEPORTING	HH OW M P AO R T IH NG
HOMEPORTS	HH OW M P OW R T S
HOMER	HH OW M ER
HOMERED	HH OW M ER D
HOMERING	HH OW M ER IH NG
HOMEROOM	HH OW M R UW M
HOMEROOMS	HH OW M R UW M Z
HOMERS	HH OW M ER Z
HOMES	HH OW M Z
HOMESCHOOL	HH OW M S K UW L
HOMESCHOOLED	HH OW M S K UW L D
HOMESCHOOLER	HH OW M S K UW L ER
HOMESCHOOLERS	HH OW M S K UW L ER Z
HOMESCHOOLING	HH OW M S K UW L IH NG
HOMESCHOOLINGS	HH OW M S K UW L IH NG Z
HOMESCHOOLS	HH OW M S K UW L Z
HOMESICK	HH OW M S IH K
HOMESICKNESS	HH OW M S IH K N AH S
HOMESICKNESSES	HH OW M S IH K N AH S IH Z
HOMESITE	HH OW M S AY T
HOMESITES	HH OW M S AY T S
HOMESPUN	HH OW M S P AH N
HOMESPUNS	HH OW M S P AH N Z
HOMESTAY	HH OW M S T EY
HOMESTAYS	HH OW M S T EY Z
HOMESTEAD	HH OW M S T EH D
HOMESTEADED	HH OW M S T EH D IH D
HOMESTEADER	HH OW M S T EH D ER
HOMESTEADERS	HH OW M S T EH D ER Z
HOMESTEADING	HH OW M S T EH D IH NG
HOMESTEADS	HH OW M S T EH D Z
HOMESTRETCH	HH OW M S T R EH CH
HOMESTRETCHES	HH OW M S T R EH CH IH Z
HOMETOWN	HH OW M T AW N
HOMETOWNS	HH OW M T AW N Z
HOMEWARD	HH OW M W ER D
HOMEWARDS	HH OW M W ER D Z
HOMEWORK	HH OW M W ER K
HOMEWORKS	HH OW M W ER K S
HOMEY	HH OW M IY
HOMEYNESS	HH OW M IY N AH S
HOMEYNESSES	HH OW M IY N AH S IH Z
HOMOGAMETIC	HH AH M AA G AH M AH T AH K
HOMOPOLYMER	HH OW M OW P AA L AH M ER
HOMOPOLYMERIC	HH OW M OW P AA L AH M EH R IH K
HOMOPOLYMERS	HH OW M OW P AA L AH M ER Z
HORSEMEN	HH AO R S M AH N
HORSEWOMEN	HH AO R S W IH M AH N
HOTELMEN	HH AA T EH L M AH N
HOUSEMEN	HH AW S M EH N
HUMECTANT	HH Y UW M EH K T AH N T
HUMECTANTS	HH Y UW M EH K T AH N T S
HUMERAL	HH AH M ER AH L
HUMERALS	HH AH M ER AH L Z
HUMERI	HH Y UW M AH R IY
HUMERUS	HH Y UW M ER AH S
HUMMED	HH AH M D
HUMMER	HH AH M ER
HUMMERS	HH AH M ER Z
HUNTSMEN	HH AH N T S M EH N
HUSBANDMEN	HH AH Z B AH N D M EH N
HUTMENT	HH AH T M AH N T
HUTMENTS	HH AH T M AH N T S
HYDROMECHANICAL	HH IH D R AH M EH CH AH N IH S AH L
HYDROMECHANICS	HH IH D R AH M EH CH AH N AH S Z
HYDROMEDUSA	HH IH D R AH M AH D Y UW S AH
HYDROMEDUSAE	HH IH D R AH M AH D Y UW S IY
HYDROMEL	HH IH D R AH M AH L
HYDROMELS	HH IH D R AH M AH L Z
HYDROMETALLURGICAL	HH IH D R AA M AH T AE L AH R JH IH S AH L
HYDROMETALLURGIES	HH IH D R AA M AH T AE L AH R JH AY Z
HYDROMETALLURGIST	HH IH D R AA M AH T AE L AH R JH AH S T
HYDROMETALLURGISTS	HH IH D R AA M AH T AH L AH R JH AH S T S
HYDROMETALLURGY	HH IH D R AA M AH T AE L AH R JH IY
HYDROMETEOR	HH IH D R AH M IY T IY AH R
HYDROMETEOROLOGICAL	HH IH D R AH M IY T IY AH R AA L AH JH IH S AH L
HYDROMETEOROLOGIES	HH IH D R AH M IY T IY AH R AA L AH JH AY Z
HYDROMETEOROLOGIST	HH IH D R AH M IY T IY AH R AA L AH JH AH S T
HYDROMETEOROLOGISTS	HH IH D R AH M IY T IY AH R AA L AH JH AH S T S
HYDROMETEOROLOGY	HH IH D R AH M IY T IY AH R AA L AH JH IY
HYDROMETEORS	HH IH D R AH M IY T IY AH R Z
HYDROMETER	HH AY D R AA M AH T ER
HYDROMETERS	HH IH D R AA M AH T AH R Z
HYDROMETRIC	HH IH D R AH M AH T R AH K
HYGROMETER	HH AY G R AA M AH T ER
HYGROMETERS	HH IH G R AA M AH T AH R Z
HYGROMETRIC	HH IH G R AH M AH T R AH K
HYMEN	HH AY M AH N
HYMENAL	HH AY M AH N AH L
HYMENEAL	HH AH M IY N IY AH L
HYMENEALLY	HH IH M AH N IY L IY
HYMENEALS	HH IH M AH N IY L Z
HYMENIA	HH AH M IY N Y AH
HYMENIAL	HH AY M AH N IY AH L
HYMENIUM	HH AH M IY N IY AH M
HYMENIUMS	HH AH M IY N IY AH M Z
HYMENOPTERA	HH AY M AH N AA P T IH R AH
HYMENOPTERAN	HH IH M AH N AA P T AH R AH N
HYMENOPTERANS	HH IH M AH N AA P T AH R AH N Z
HYMENOPTERON	HH AY M AH N AA P T ER AO N
HYMENOPTERONS	HH AY M AH N AA P T ER AO N Z
HYMENOPTEROUS	HH AY M AH N AA P T ER AH S
HYMENS	HH AY M AH N Z
HYPERALIMENTATION	HH AY P ER AH L AY M AH N T EY SH AH N
HYPERALIMENTATIONS	HH AY P ER AH L AY M AH N T EY SH AH N Z
HYPERDEVELOPMENT	HH AY P ER D IH V EH L AH P M AH N T
HYPERDEVELOPMENTS	HH AY P ER D IH V EH L AH P M AH N T S
HYPEREXCITEMENT	HH AY P ER IH K S AY T M AH N T
HYPEREXCITEMENTS	HH AY P ER IH K S AY T M AH N T S
HYPERMEDIA	HH AY P AH R M IY D IY AH
HYPERMEDIAS	HH AY P AH R M IY D IY AH Z
HYPERMETABOLIC	HH AY P ER M EH T AH B AA L IH K
HYPERMETABOLISM	HH AY P ER M AH T AE B AH L IH Z AH M
HYPERMETABOLISMS	HH AY P ER M AH T AE B AH L IH Z AH M Z
HYPERMETER	HH AY P ER M IY T ER
HYPERMETERS	HH AY P ER M IY T ER Z
HYPERMETRIC	HH AY P ER M EH T R IH K
HYPERMETRICAL	HH AY P ER M EH T R IH K AH L
HYPERMETROPIA	HH AY P AH R M EH T R OW P IY AH
HYPERMETROPIAS	HH AY P AH R M EH T R OW P IY AH Z
HYPERMETROPIC	HH AY P ER M EH T R OW P IH K
HYPERPIGMENTATION	HH AY P ER P IH G M AH N T EY SH AH N
HYPERPIGMENTATIONS	HH AY P ER P IH G M AH N T EY SH AH N Z
HYPERPIGMENTED	HH AY P ER P IH G M AH N T IH D
HYPOSTOME	HH IH P AH S T OW M
HYPOSTOMES	HH IH P AH S T OW M Z
HYPSOMETER	HH IH P S AA M AH T AH R
HYPSOMETERS	HH IH P S AA M AH T AH R Z
HYPSOMETRIC	HH IH P S AH M AH T R AH K
ICEMEN	AY S M EH N
ILLUME	IH L UW M
ILLUMED	IH L UW M D
ILLUMES	IH L UW M Z
ILMENITE	IH L M AH N AY T
ILMENITES	IH L M AH N AY T S
IMBALMED	IH M B AA M D
IMBALMER	IH M B AA M ER
IMBALMERS	IH M B AA M ER Z
IMBOSOMED	IH M B UH Z AH M D
IMMEASURABLE	IH M EH ZH ER AE B AH L
IMMEASURABLENESS	IH M EH ZH ER AH B AH L N AH S
IMMEASURABLENESSES	IH M EH ZH ER AH B AH L N AH S IH Z
IMMEASURABLY	IH M EH ZH ER AE B L IY
IMMEDIACIES	IH M IY D IY AH S IY Z
IMMEDIACY	IH M IY D IY AH S IY
IMMEDIATE	IH M IY D IY AH T
IMMEDIATELY	IH M IY D IY AH T L IY
IMMEDIATENESS	IH M IY D IY AH T N AH S
IMMEDIATENESSES	IH M IY D IY AH T N AH S IH Z
IMMEDICABLE	IH M EH D IH K AH B AH L
IMMEDICABLY	IH M EH D IH K AH B L IY
IMMEMORIAL	IH M AH M AO R IY AH L
IMMEMORIALLY	IH M AH M OW R IY AH L IY
IMMENSE	IH M EH N S
IMMENSELY	IH M EH N S L IY
IMMENSENESS	IH M EH N S N AH S
IMMENSENESSES	IH M EH N S N AH S IH Z
IMMENSER	IH M EH N S ER
IMMENSEST	IH M EH N S AH S T
IMMENSITIES	IH M EH N S AH T IY Z
IMMENSITY	IH M EH N S AH T IY
IMMENSURABLE	IH M EH N CH ER AH B AH L
IMMERGE	IH M ER JH
IMMERGED	IH M ER JH D
IMMERGES	IH M ER JH IH Z
IMMERGING	IH M ER JH IH NG
IMMERSE	IH M ER S
IMMERSED	IH M ER S T
IMMERSES	IH M ER S IH Z
IMMERSIBLE	IH M ER S AH B AH L
IMMERSING	IH M ER S IH NG
IMMERSION	IH M ER ZH AH N
IMMERSIONS	IH M ER ZH AH N Z
IMMESH	IH M EH SH
IMMESHED	IH M EH SH T
IMMESHES	IH M EH SH IH Z
IMMESHING	IH M EH SH IH NG
IMMETHODICAL	IH M AH TH AA D IH K AH L
IMMETHODICALLY	IH M AH TH AA D IH K AH L IY
IMMUREMENT	IH M Y UH R M AH N T
IMMUREMENTS	IH M Y UH R AH M AH N T S
IMPAIRMENT	IH M P EH R M AH N T
IMPAIRMENTS	IH M P EH R M AH N T S
IMPALEMENT	IH M P EY L M AH N T
IMPALEMENTS	IH M P EY L M AH N T S
IMPARTMENT	IH M P AA R T M AH N T
IMPARTMENTS	IH M P AA R T M AH N T S
IMPEACHMENT	IH M P IY CH M AH N T
IMPEACHMENTS	IH M P IY CH M AH N T S
IMPEDIMENT	IH M P EH D AH M AH N T
IMPEDIMENTA	IH M P EH D AH M EH N T AH
IMPEDIMENTS	IH M P EH D AH M AH N T S
IMPERILMENT	IH M P EH R AH L M AH N T
IMPERILMENTS	IH M P EH R AH L M AH N T S
IMPERMEABILITIES	IH M P ER M IY AH B IH L AH T EH Z
IMPERMEABILITY	IH M P ER M IY AH B IH L AH T EH
IMPERMEABLE	IH M P ER M IY AH B AH L
IMPINGEMENT	IH M P IH N JH M AH N T
IMPINGEMENTS	IH M P IH N JH M AH N T S
IMPLEMENT	IH M P L AH M AH N T
IMPLEMENTATION	IH M P L AH M EH N T EY SH AH N
IMPLEMENTATIONS	IH M P L AH M AH N T EY SH AH N Z
IMPLEMENTED	IH M P L AH M EH N T AH D
IMPLEMENTED(2)	IH M P L AH M EH N AH D
IMPLEMENTER	IH M P L AH M AH N T ER
IMPLEMENTERS	IH M P L AH M AH N T ER Z
IMPLEMENTING	IH M P L AH M EH N T IH NG
IMPLEMENTING(2)	IH M P L AH M EH N IH NG
IMPLEMENTOR	IH M P L AH M AH N T ER
IMPLEMENTORS	IH M P L AH M AH N T ER Z
IMPLEMENTS	IH M P L AH M AH N T S
IMPOSTHUME	IH M P AA S TH UW M
IMPOSTHUMES	IH M P AA S TH UW M Z
IMPOSTUME	IH M P AA S T Y UW M
IMPOSTUMES	IH M P AA S T Y UW M Z
IMPOUNDMENT	IH M P AW N D M AH N T
IMPOUNDMENTS	IH M P AW N D M AH N T S
IMPOVERISHMENT	IH M P AA V R IH SH M AH N T
IMPOVERISHMENTS	IH M P AA V R IH SH M AH N T S
IMPRESSMENT	IH M P R EH S M AH N T
IMPRESSMENTS	IH M P R EH S M AH N T S
IMPRISONMENT	IH M P R IH Z AH N M AH N T
IMPRISONMENTS	IH M P R IH Z AH N M AH N T S
IMPROVEMENT	IH M P R UW V M AH N T
IMPROVEMENTS	IH M P R UW V M AH N T S
INARMED	IH N AA R M D
INCHMEAL	IH N CH M IY L
INCITEMENT	IH N S AY T M AH N T
INCITEMENTS	IH N S AY T M AH N T S
INCLEMENCIES	IH N K L EH M AH N S IY Z
INCLEMENCY	IH N K L EH M AH N S IY
INCLEMENT	IH N K L EH M AH N T
INCLEMENT(2)	IH N K L IH M AH N T
INCLEMENTLY	IH N K L EH M AH N T L IY
INCLINOMETER	IH N K L AH N AA M AH T AH R
INCLINOMETERS	IH N K L AH N AA M AH T AH R Z
INCOME	IH N K AH M
INCOMER	IH N K AH M ER
INCOMERS	IH N K AH M ER Z
INCOMES	IH N K AH M Z
INCOMMENSURABILITIES	IH N K AH M EH N Z Y ER AH B IH L AH T EH Z
INCOMMENSURABILITY	IH N K AH M EH N Z Y ER AH B IH L AH T EH
INCOMMENSURABLE	IH N K AH M EH N Z Y ER AH B AH L
INCOMMENSURABLES	IH N K AH M EH N Z Y ER AH B AH L Z
INCOMMENSURABLY	IH N K AH M EH N Z Y ER AH B L IY
INCOMMENSURATE	IH N K AH M EH N S AH R AH T
INCREMENT	IH N K R AH M AH N T
INCREMENTAL	IH N K R AH M EH N T AH L
INCREMENTALISM	IH N K R AH M EH N T AH L IH Z M
INCREMENTALISMS	IH NG K R AH M EH N T AH L IH Z AH M Z
INCREMENTALIST	IH NG K R AH M EH N T AH L IH S T
INCREMENTALISTS	IH NG K R AH M EH N T AH L IH S T S
INCREMENTALLY	IH N K R AH M EH N T AH L IY
INCREMENTED	IH N K R AH M EH N T IH D
INCREMENTING	IH N K R AH M EH N T AH NG
INCREMENTS	IH NG K R AH M EH N T S
INDICTMENT	IH N D AY T M AH N T
INDICTMENTS	IH N D AY T M AH N T S
INDOMETHACIN	IH N D AH M EH TH AH S AH N
INDOMETHACINS	IH N D AH M EH TH AH S AH N Z
INDORSEMENT	IH N D AO R S M AH N T
INDORSEMENTS	IH N D AO R S M AH N T S
INDUCEMENT	IH N D UW S M AH N T
INDUCEMENTS	IH N D UW S M AH N T S
INFANTRYMEN	IH N F AE N T R IY M AH N
INFIRMED	IH N F ER M D
INFLAME	IH N F L EY M
INFLAMED	IH N F L EY M D
INFLAMER	IH N F L EY M ER
INFLAMERS	IH N F L EY M ER Z
INFLAMES	IH N F L EY M Z
INFOMERCIAL	IH N F OW M ER SH AH L
INFOMERCIALS	IH N F OW M ER SH AH L Z
INFORMED	IH N F AO R M D
INFORMEDLY	IH N F AO R M AH D L IY
INFORMER	IH N F AO R M ER
INFORMERS	IH N F AO R M ER Z
INFOTAINMENT	IH N F OW T EY N M AH N T
INFOTAINMENTS	IH N F AH T EY N M AH N T S
INFRINGEMENT	IH N F R IH N JH M AH N T
INFRINGEMENTS	IH N F R IH N JH M AH N T S
INHUME	IH N HH Y UW M
INHUMED	IH N HH AH M D
INHUMER	IH N HH AH M ER
INHUMERS	IH N HH AH M ER Z
INHUMES	IH N HH Y UW M Z
INMESH	IH N M EH SH
INMESHED	IH N M EH SH T
INMESHES	IH N M EH SH IH Z
INMESHING	IH N M EH SH IH NG
INNUMERABLE	IH N UW M ER AH B AH L
INNUMERABLY	IH N UW M ER AH B L IY
INNUMERACIES	IH N UW M ER AH S IY Z
INNUMERACY	IH N UW M ER AH S IY
INNUMERATE	IH N UW M ER AH T
INNUMERATES	IH N UW M ER AH T S
INNUMEROUS	IH N UW M ER AH S
INSTALLMENT	IH N S T AO L M AH N T
INSTALLMENTS	IH N S T AO L M AH N T S
INSTALMENT	IH N S T AO L M AH N T
INSTALMENTS	IH N S T AO L M AH N T S
INSTILLMENT	IH N S T IH L M AH N T
INSTILLMENTS	IH N S T IH L M AH N T S
INSTRUMENT	IH N S T R AH M AH N T
INSTRUMENTAL	IH N S T R AH M EH N T AH L
INSTRUMENTAL(2)	IH N S T R AH M EH N AH L
INSTRUMENTALISM	IH N S T R AH M EH N T AH L IH Z AH M
INSTRUMENTALISMS	IH N S T R AH M EH N T AH L IH Z AH M Z
INSTRUMENTALIST	IH N S T R AH M EH N T AH L IH S T
INSTRUMENTALIST(2)	IH N S T R AH M EH N AH L IH S T
INSTRUMENTALISTS	IH N S T R AH M EH N T AH L IH S T S
INSTRUMENTALISTS(2)	IH N S T R AH M EH N AH L IH S T S
INSTRUMENTALISTS(3)	IH N S T R AH M EH N T AH L IH S
INSTRUMENTALISTS(4)	IH N S T R AH M EH N AH L IH S
INSTRUMENTALITIES	IH N S T R AH M AH N T AE L AH T IY Z
INSTRUMENTALITY	IH N S T R AH M EH N T AE L IH T IY
INSTRUMENTALLY	IH N S T R AH M EH N T AH L IY
INSTRUMENTALS	IH N S T R AH M EH N T AH L Z
INSTRUMENTALS(2)	IH N S T R AH M EH N AH L Z
INSTRUMENTATION	IH N S T R AH M EH N T EY SH AH N
INSTRUMENTATIONS	IH N S T R AH M AH N T EY SH AH N Z
INSTRUMENTED	IH N S T R AH M AH N T IH D
INSTRUMENTING	IH N S T R AH M AH N T IH NG
INSTRUMENTS	IH N S T R AH M AH N T S
INTEGUMENT	IH N T EH G Y AH M AH N T
INTEGUMENTARY	IH N T EH G Y UW M AH N T EH R IY
INTEGUMENTS	IH N T EH G Y UW M AH N T S
INTENDMENT	IH N T EH N D M AH N T
INTENDMENTS	IH N T EH N D M AH N T S
INTERDEPARTMENTAL	IH N T ER D IH P AA R T M EH N T AH L
INTERDEPARTMENTALLY	IH N T ER D IH P AA R T M EH N T AH L IY
INTERFEROMETER	IH N T ER F ER AA M AH T ER
INTERFEROMETERS	IH N T ER F AH R AA M AH T ER Z
INTERFEROMETRIC	IH N T AH R F EH R AH M AH T R AH K
INTERFEROMETRICALLY	IH N T AH R F EH R AH M EH T R AH K AE L IY
INTERFEROMETRIES	IH N T AH R F AH R AH M EH T R AY Z
INTERFEROMETRY	IH N T AH R F IY R AH M EH T R IY
INTERGOVERNMENTAL	IH N T ER G AH V ER N M EH N T AH L
INTERLACEMENT	IH N T ER L EY S M AH N T
INTERLACEMENTS	IH N T ER L EY S M AH N T S
INTERMEDDLE	IH N T ER M EH D AH L
INTERMEDDLED	IH N T ER M EH D AH L D
INTERMEDDLER	IH N T ER M EH D AH L ER
INTERMEDDLERS	IH N T ER M EH D AH L ER Z
INTERMEDDLES	IH N T ER M EH D AH L Z
INTERMEDDLING	IH N T ER M EH D AH L IH NG
INTERMEDIACIES	IH N T ER M IY D IY AH S IY Z
INTERMEDIACY	IH N T ER M IY D IY AH S IY
INTERMEDIARIES	IH N T ER M IY D IY EH R IY Z
INTERMEDIARIES(2)	IH N ER M IY D IY EH R IY Z
INTERMEDIARY	IH N ER M IY D IY EH R IY
INTERMEDIARY(2)	IH N T ER M IY D IY EH R IY
INTERMEDIATE	IH N T ER M IY D IY IH T
INTERMEDIATE(2)	IH N ER M IY D IY IH T
INTERMEDIATED	IH N T ER M IY D IY EY T IH D
INTERMEDIATELY	IH N T ER M IY D IY AH T L IY
INTERMEDIATENESS	IH N T ER M IY D IY AH T N AH S
INTERMEDIATENESSES	IH N T ER M IY D IY AH T N AH S IH Z
INTERMEDIATES	IH N T ER M IY D IY AH T S
INTERMEDIATES(2)	IH N T ER M IY D IY EY T S
INTERMEDIATES(3)	IH N ER M IY D IY AH T S
INTERMEDIATES(4)	IH N ER M IY D IY EY T S
INTERMEDIATING	IH N T ER M IY D IY EY T IH NG
INTERMEDIATION	IH N T ER M IY D IY EY SH AH N
INTERMEDIATIONS	IH N T ER M IY D IY EY SH AH N Z
INTERMEDIN	IH N T ER M D IH N
INTERMEDINS	IH N T ER M D IH N Z
INTERMEMBRANE	IH N T ER M EH M B R EY N
INTERMENSTRUAL	IH N T ER M EH N S T R AH W AH L
INTERMENT	IH N T ER M AH N T
INTERMENTS	IH N T ER M AH N T S
INTERMESH	IH N T ER M EH SH
INTERMESHED	IH N T ER M EH SH T
INTERMESHES	IH N T ER M EH SH IH Z
INTERMESHING	IH N T ER M EH SH IH NG
INTERMETALLIC	IH N T ER M AH T AE L IH K
INTERMETALLICS	IH N T ER M AH T AE L IH K S
INTERMEZZI	IH N T AH R M EH Z IY
INTERMEZZO	IH N T AH R M EH Z OW
INTERMEZZOS	IH N T AH R M EH Z AH Z
INTERNMENT	IH N T ER N M AH N T
INTERNMENTS	IH N T ER N M AH N T S
INTERPERMEATE	IH N T ER P ER M IY AH T
INTERPERMEATED	IH N T ER P ER M IY EY T IH D
INTERPERMEATES	IH N T ER P ER M IY AH T S
INTERPERMEATING	IH N T ER P ER M IY EY T IH NG
INTERSEGMENT	IH N T ER S EH G M AH N T
INTERSEGMENTAL	IH N T ER S EH G M EH N T AH L
INTERSEGMENTS	IH N T ER S EH G M AH N T S
INTERTESTAMENTAL	IH N T ER T EH S T AH M AH N T AH L
INTERTWINEMENT	IH N T ER T W AY N M AH N T
INTERTWINEMENTS	IH N T ER T W AY N M AH N T S
INTERVALOMETER	IH N T AH R V AH L AA M AH T AH R
INTERVALOMETERS	IH N T AH R V AH L AA M AH T AH R Z
INTIME	IH N T AY M
INTUMESCENCE	IH N T Y AH M EH S AH N S
INTUMESCENCES	IH N T Y AH M AH S EH N S AH Z
INTUMESCENT	IH N T Y AH M EH S AH N T
INUREMENT	IH N Y UH R M AH N T
INUREMENTS	IH N Y UH R M AH N T S
INVEIGLEMENT	IH N V EY G L M AH N T
INVEIGLEMENTS	IH N V EY G L AH M AH N T S
INVESTMENT	IH N V EH S T M AH N T
INVESTMENT(2)	IH N V EH S M AH N T
INVESTMENTS	IH N V EH S T M AH N T S
INVESTMENTS(2)	IH N V EH S M AH N T S
INVOLVEMENT	IH N V AA L V M AH N T
INVOLVEMENTS	IH N V AA L V M AH N T S
IONOMER	AY AH N OW M AH R
IONOMERS	AY AA N AH M AH R Z
IRKSOME	ER K S AH M
IRKSOMELY	ER K S AH M L IY
IRKSOMENESS	ER K S AH M N AH S
IRKSOMENESSES	ER K S AH M N AH S IH Z
IRREMEABLE	AH R AH M IY AH B AH L
IRREMEDIABLE	IH R IH M IY D IY AH B AH L
IRREMEDIABLENESS	IH R IH M IY D IY AH B AH L N AH S
IRREMEDIABLENESSES	IH R IH M IY D IY AH B AH L N AH S IH Z
IRREMEDIABLY	IH R IH M IY D IY AH B AH L IY
ISOCHIME	IH S AH CH AY M
ISOCHIMES	IH S AH CH AY M Z
ISOCHROMOSOME	AH S AA K R AA M AH S AH M
ISOCHROMOSOMES	AH S AA K R AA M AH S AH M Z
ISODIAMETRIC	IH S AH D IY AH M AH T R AH K
ISOENZYME	IH S OW AH N Z AY M
ISOENZYMES	IH S OW AH N Z AY M Z
ISOGAMETE	AH S AA G AH M IY T
ISOGAMETES	AH S AA G AH M IY T S
ISOGAMETIC	AH S AA G AH M AH T AH K
ISOMER	AY S AH M ER
ISOMERASE	AH S AA M AH R EY Z
ISOMERASES	AH S AA M AH R EY Z AH Z
ISOMERIC	AY S AH M ER IH K
ISOMERISM	AY S AH M ER IH Z AH M
ISOMERISMS	AY S AH M ER IH Z AH M Z
ISOMERIZATION	AY S AH M ER AH Z EY SH AH N
ISOMERIZATIONS	AY S AH M ER AH Z EY SH AH N Z
ISOMERIZE	AY S AH M ER AY Z
ISOMERIZED	AY S AH M ER AY Z D
ISOMERIZES	AY S AH M ER AY Z IH Z
ISOMERIZING	AY S AH M ER AY Z IH NG
ISOMERS	AY S AH M ER Z
ISOMETRIC	IH S AH M AH T R AH K
ISOMETRICALLY	IH S AH M EH T R AH K AE L IY
ISOMETRICS	IH S AH M EH T R AH S Z
ISOMETRIES	IH S AH M EH T R AY Z
ISOMETRY	AY Z AH M EH T R IY
ISOZYME	IH S AH Z AY M
ISOZYMES	IH S AH Z AY M Z
ITEMED	AY T AH M D
IVERMECTIN	IH V AH R M EH K T AH N
IVERMECTINS	IH V AH R M EH K T AH N Z
JACKHAMMER	JH AE K HH AE M ER
JACKHAMMERED	JH AE K HH AE M ER D
JACKHAMMERING	JH AE K HH AE M ER IH NG
JACKHAMMERS	JH AE K HH AE M ER Z
JACKSMELT	JH AE K S M EH L T
JACKSMELTS	JH AE K S M EH L T S
JAMMED	JH AE M D
JAMMER	JH AE M ER
JAMMERS	JH AE M ER Z
JAZZMEN	JH AE Z M AH N
JOBNAME	JH AA B N EY M
JOBNAMES	JH AA B N EY M Z
JOURNEYMEN	JH ER N IY M EH N
JUDGEMENT	JH AH JH M AH N T
JUDGEMENTS	JH AH JH M AH N T S
JUDGMENT	JH AH JH M AH N T
JUDGMENTAL	JH AH JH M EH N T AH L
JUDGMENTAL(2)	JH AH JH M EH N AH L
JUDGMENTALLY	JH AH JH M AH N T AH L IY
JUDGMENTS	JH AH JH M AH N T S
JUNKMEN	JH AH NG K M EH N
JURYMEN	JH UH R IY M EH N
KAME	K EY M
KAMES	K EY M Z
KAPELLMEISTER	K AE P AH L M IY S T AH R
KAPELLMEISTERS	K AE P AH L M IY S T AH R Z
KARYOSOME	K AH R AY AH S AH M
KARYOSOMES	K AH R AY AH S AH M Z
KATZENJAMMER	K AE T S EH N JH AE M AH R
KATZENJAMMERS	K AE T S AH N JH AE M AH R Z
KERMES	K AH R M Z
KERMESES	K AH R M IY Z AH Z
KERMESS	K AH R M AH S
KERMESSE	K AH R M AH S
KERMESSES	K AH R M EH S AH Z
KERSEYMERE	K AH R S EY M AH R
KERSEYMERES	K AH R S AH M IY R Z
KILOMETER	K AH L AA M AH T ER
KILOMETER(2)	K IH L AH M IY T ER
KILOMETERS	K AH L AA M AH T ER Z
KILOMETERS(2)	K IH L AH M IY T ER Z
KINETOSOME	K AH N EH T AH S AH M
KINETOSOMES	K AH N EH T AH S AH M Z
KINSMEN	K IH N Z M EH N
KINSWOMEN	K IH N Z W IH M AH N
KIRKMEN	K AH R K M AH N
KIRMESS	K AH R M AH S
KIRMESSES	K AH R M EH S AH Z
KISMET	K IH Z M IH T
KISMETIC	K IH Z M AH T AH K
KISMETS	K IH Z M IH T S
KLEZMER	K L EH Z M ER
KLEZMERS	K L EH Z M AH R Z
KRIMMER	K R IH M AH R
KRIMMERS	K R IH M AH R Z
KUMMEL	K AH M AH L
KUMMELS	K AH M AH L Z
LAME	L EY M
LAMEBRAIN	L EY M B R EY N
LAMEBRAINED	L EY M B R EY N D
LAMEBRAINS	L EY M B R EY N Z
LAMED	L EY M D
LAMEDH	L AE M AH D
LAMEDHS	L AE M AH D Z
LAMEDS	L EY M D Z
LAMELLA	L AH M EH L AH
LAMELLAE	L AH M EH L IY
LAMELLAR	L AH M EH L ER
LAMELLAS	L AH M EH L AH Z
LAMELLATE	L AE M AH L EY T
LAMELLATELY	L AE M AH L EY T L IY
LAMELLIBRANCH	L AE M AH L IH B R AH N CH
LAMELLIBRANCHS	L AE M AH L IH B R AH N CH S
LAMELLICORN	L AH M EH L AH K AH R N
LAMELLICORNS	L AH M EH L AH K AH R N Z
LAMELLIFORM	L AH M EH L AH F AH R M
LAMELY	L EY M L IY
LAMENESS	L EY M N AH S
LAMENESSES	L EY M N AH S IH Z
LAMENT	L AH M EH N T
LAMENTABLE	L AH M EH N T AH B AH L
LAMENTABLENESS	L AH M EH N T AH B AH L N AH S
LAMENTABLENESSES	L AH M EH N T AH B AH L N AH S IH Z
LAMENTABLY	L AH M EH N T AH B L IY
LAMENTATION	L AE M AH N T EY SH AH N
LAMENTATIONS	L AE M AH N T EY SH AH N Z
LAMENTED	L AH M EH N T IH D
LAMENTEDLY	L AH M EH N T AH D L IY
LAMENTER	L AH M EH N T ER
LAMENTERS	L AH M EH N T ER Z
LAMENTING	L AH M EH N T IH NG
LAMENTS	L AH M EH N T S
LAMER	L EY M ER
LAMES	L EY M Z
LAMEST	L EY M AH S T
LAMMED	L AE M D
LAMMERGEIER	L AE M ER JH IY ER
LAMMERGEIERS	L AE M ER JH IY ER Z
LAMMERGEYER	L AE M ER JH IY ER
LAMMERGEYERS	L AE M ER JH IY ER Z
LANDMEN	L AE N D M EH N
LANDSMEN	L AE N D Z M EH N
LANGUISHMENT	L AE NG G W IH SH M AH N T
LANGUISHMENTS	L AE NG G W IH SH M AH N T S
LARKSOME	L AA R K S AH M
LARYNGECTOMEE	L AH R IH N JH AH K T AH M IY IY
LARYNGECTOMEES	L AH R IH N JH EH K T AH M IY Z
LATECOMER	L EY T K AH M ER
LATECOMERS	L EY T K AH M ER Z
LAUNDRYMEN	L AO N D R IY M EH N
LAWMEN	L AO M EH N
LAYMEN	L EY M AH N
LAYWOMEN	L EY W IH M AH N
LEADMEN	L IY D M EH N
LEADSMEN	L IY D Z M EH N
LEGMEN	L EH G M EH N
LEGUME	L EH G Y UW M
LEGUMES	L EH G Y UW M Z
LENSMEN	L EH N Z M EH N
LENTAMENTE	L EH N T AH M AH N T
LEPTOSOME	L EH P T AH S AH M
LEPTOSOMES	L EH P T AH S AH M Z
LETTERMEN	L EH T ER M AH N
LEXEME	L EH K S IY M
LEXEMES	L EH K S IY M Z
LIEGEMEN	L AY JH EH M AH N
LIFETIME	L AY F T AY M
LIFETIMES	L AY F T AY M Z
LIFTMEN	L IH F T M EH N
LIGAMENT	L IH G AH M AH N T
LIGAMENTOUS	L IH G AH M AH N T AH S
LIGAMENTS	L IH G AH M AH N T S
LIGHTSOME	L AY T S AH M
LIGHTSOMELY	L AY T S AH M L IY
LIGHTSOMENESS	L AY T S AH M N AH S
LIGHTSOMENESSES	L AY T S AH M N AH S IH Z
LIME	L AY M
LIMEADE	L AY M EY D
LIMEADES	L AY M EY D Z
LIMED	L AY M D
LIMEKILN	L IH M AH K AH L N
LIMEKILNS	L IH M AH K AH L N Z
LIMELESS	L AY M L AH S
LIMELIGHT	L AY M L AY T
LIMELIGHTED	L AY M L AY T IH D
LIMELIGHTING	L AY M L AY T IH NG
LIMELIGHTS	L AY M L AY T S
LIMEN	L AY M AH N
LIMENS	L AY M AH N Z
LIMERICK	L IH M ER IH K
LIMERICKS	L IH M ER IH K S
LIMES	L AY M Z
LIMESTONE	L AY M S T OW N
LIMESTONES	L AY M S T OW N Z
LIMEWATER	L AY M W AO T ER
LIMEWATERS	L AY M W AO T ER Z
LIMEY	L AY M IY
LIMEYS	L AY M IY Z
LIMMER	L IH M ER
LIMMERS	L IH M AH R Z
LINEAMENT	L AH N IY M AH N T
LINEAMENTAL	L AY N AH M EH N T AH L
LINEAMENTS	L AH N IY M AH N T S
LINEMEN	L AY N M AH N
LINESMEN	L AY N Z M EH N
LINIMENT	L IH N AH M AH N T
LINIMENTS	L IH N AH M AH N T S
LINKMEN	L IH NG K M EH N
LINKSMEN	L IH NG K S M EH N
LIPOSOME	L IH P AH S OW M
LIPOSOMES	L IH P AH S OW M Z
LISSOME	L IH Z S AH M
LISSOMELY	L IH S OW M L IY
LISSOMENESS	L IH S OW M N AH S
LISSOMENESSES	L IH S AA M AH N EH S AH Z
LITHESOME	L AY DH S AH M
LIVERYMEN	L IH V R IY M EH N
LOAMED	L OW M D
LOATHSOME	L OW DH S AH M
LOATHSOME(2)	L OW TH S AH M
LOATHSOMELY	L OW TH S AH M L IY
LOATHSOMENESS	L OW TH S AH M N AH S
LOATHSOMENESSES	L OW TH S AH M N AH S IH Z
LOBSTERMEN	L AA B S T ER M IH N
LODGEMENT	L AA JH M AH N T
LODGEMENTS	L AA JH M AH N T S
LODGMENT	L AA JH M AH N T
LODGMENTS	L AA JH M AH N T S
LOMEIN	L OW M IY N
LOMEINS	L OW M IY N Z
LOMENT	L AA M AH N T
LOMENTA	L AH M EH N T AH
LOMENTS	L AA M AH N T S
LOMENTUM	L AH M EH N T AH M
LOMENTUMS	L AH M EH N T AH M Z
LONESOME	L OW N S AH M
LONESOMELY	L OW N S AH M L IY
LONESOMENESS	L OW N S AH M N AH S
LONESOMENESSES	L OW N S AH M N AH S IH Z
LONESOMES	L OW N S AH M Z
LONGBOWMEN	L AO NG B AW M EH N
LONGSHOREMEN	L AO NG SH AO R M IH N
LONGSOME	L AO NG S AH M
LONGSOMELY	L AO NG S AH M L IY
LONGSOMENESS	L AO NG S AH M N AH S
LONGSOMENESSES	L AO NG S AH M N AH S IH Z
LONGTIME	L AO NG T AY M
LOOMED	L UW M D
LORIMER	L AO R IH M ER
LORIMERS	L AO R AH M AH R Z
LOTHSOME	L AA TH S AH M
LOVESOME	L AH V S AH M
LOWERCLASSMEN	L OW ER K L AE S M EH N
LOXODROME	L AA K S AH D R OW M
LOXODROMES	L AA K S AH D R OW M Z
LUFTMENSCH	L AH F T M AH N S
LUFTMENSCHEN	L AH F T M EH N S AH N
LUMBERMEN	L AH M B ER M EH N
LUMEN	L UW M AH N
LUMENAL	L UW M AH N AH L
LUMENS	L UW M AH N Z
LUNCHMEAT	L AH N CH M IY T
LUNCHMEATS	L AH N CH M IY T S
LUNCHTIME	L AH N CH T AY M
LUNCHTIMES	L AH N CH T AY M Z
LYSIMETER	L AH S IH M AH T AH R
LYSIMETERS	L AH S IH M AH T AH R Z
LYSIMETRIC	L IH S AH M AH T R AH K
LYSOSOME	L IH S AH S AH M
LYSOSOMES	L IH S AH S AH M Z
LYSOZYME	L IH S AH Z AY M
LYSOZYMES	L IH S AH Z AY M Z
MACRAME	M AE K R AH M EY
MACRAMES	M AE K R EY M Z
MACROGAMETE	M AE K R AA G AH M IY T
MACROGAMETES	M AE K R AA G AH M IY T S
MACROMERE	M AE K R OW M AH R
MACROMERES	M AE K R AH M IY R Z
MADAME	M AE D AH M
MADAME(2)	M AH D AE M
MADAMES	M AH D AE M Z
MADMEN	M AE D M AH N
MADWOMEN	M AE D W IH M AH N
MAGNETOMETER	M AE G N AH T AA M AH T ER
MAGNETOMETERS	M AE G N AH T AA M AH T ER Z
MAGNETOMETRIC	M AE G N EH T AH M AH T R AH K
MAGNETOMETRIES	M AE G N AH T AH M EH T R AY Z
MAGNETOMETRY	M AE G N AH T AH M EH T R IY
MAILMEN	M EY L M EH N
MAIMED	M EY M D
MAIMER	M EY M ER
MAIMERS	M EY M ER Z
MAINFRAME	M EY N F R EY M
MAINFRAMES	M EY N F R EY M Z
MAINSTREAMED	M EY N S T R IY M D
MALADJUSTMENT	M AE L AH JH AH S T M AH N T
MALADJUSTMENTS	M AE L AH JH AH S T M AH N T S
MALAPPORTIONMENT	M AE L AH P OW R SH AH N M AH N T
MALAPPORTIONMENTS	M AE L AH P OW R SH AH N M AH N T S
MALFORMED	M AE L F AO R M D
MALTREATMENT	M AE L T R IY T M AH N T
MALTREATMENTS	M AE L T R IY T M AH N T S
MAMELUKE	M AE M AH L UW K
MAMELUKES	M AE M AH L UW K S
MAMEY	M EY M IY
MAMEYES	M EY M EY Z
MAMEYS	M EY M EY Z
MAMMEE	M AE M IY IY
MAMMEES	M AE M IY Z
MAMMER	M AE M AH R
MAMMERED	M AE M IY R D
MAMMERING	M AE M IY R AH NG
MAMMERS	M AE M AH R Z
MAMMET	M AE M AH T
MAMMETS	M AE M AH T S
MAMMEY	M AE M IY
MAMMEYS	M AE M EY Z
MANAGEMENT	M AE N AH JH M AH N T
MANAGEMENT(2)	M AE N IH JH M AH N T
MANAGEMENTAL	M AE N IH JH M AH N T AH L
MANAGEMENTS	M AE N IH JH M AH N T S
MANOMETER	M AH N AA M AH T ER
MANOMETERS	M AH N AA M AH T ER Z
MANOMETRIC	M AE N AH M AH T R AH K
MANOMETRICALLY	M AE N AH M EH T R AH K AE L IY
MANOMETRIES	M AE N AH M EH T R AY Z
MANOMETRY	M EY N AH M EH T R IY
MAREMME	M AE R AH M
MARITIME	M AE R AH T AY M
MARKSMEN	M AA R K S M EH N
MARKSWOMEN	M AA R K S W IH M AH N
MAUMET	M AO M AH T
MAUMETRIES	M AH M EH T R AY Z
MAUMETRY	M AH M EH T R IY
MAUMETS	M AO M AH T S
ME	M IY
MEAD	M IY D
MEADOW	M EH D OW
MEADOWLAND	M EH D OW L AE N D
MEADOWLANDS	M EH D OW L AE N D Z
MEADOWLARK	M EH D OW L AA R K
MEADOWLARKS	M EH D OW L AA R K S
MEADOWS	M EH D OW Z
MEADOWSWEET	M EH D OW S W IY T
MEADOWSWEETS	M EH D OW S W IY T S
MEADOWY	M EH D OW IY
MEADS	M IY D Z
MEAGER	M IY G ER
MEAGERLY	M IY G ER L IY
MEAGERNESS	M IY G ER N AH S
MEAGERNESSES	M IY G ER N AH S IH Z
MEAGRE	M IY G AH R
MEAGRELY	M IY G R L IY
MEAL	M IY L
MEALIE	M IY L IY
MEALIER	M IY L IY ER
MEALIES	M IY L IY Z
MEALIEST	M IY L IY AH S T
MEALLESS	M IY L AH S
MEALS	M IY L Z
MEALTIME	M IY L T AY M
MEALTIMES	M IY L T AY M Z
MEALWORM	M IY L W ER M
MEALWORMS	M IY L W ER M Z
MEALY	M IY L IY
MEALYBUG	M IY L IY B AH G
MEALYBUGS	M IY L IY B AH G Z
MEALYMOUTHED	M IY L IY M AW TH T
MEAN	M IY N
MEANDER	M IY AE N D ER
MEANDERED	M IY AE N D ER D
MEANDERING	M IY AE N D ER IH NG
MEANDERS	M IY AE N D ER Z
MEANDROUS	M IY N D R AH S
MEANER	M IY N ER
MEANERS	M IY N ER Z
MEANEST	M IY N AH S T
MEANIE	M IY N IY
MEANIES	M IY N IY Z
MEANING	M IY N IH NG
MEANINGFUL	M IY N IH NG F AH L
MEANINGFULLY	M IY N IH NG F AH L IY
MEANINGFULNESS	M IY N IH NG F AH L N AH S
MEANINGFULNESSES	M IY N IH NG F AH L N AH S IH Z
MEANINGLESS	M IY N IH NG L AH S
MEANINGLESSLY	M IY N IH NG L AH S L IY
MEANINGLESSNESS	M IY N IH NG L AH S N AH S
MEANINGLESSNESSES	M IY N IH NG L AH S N AH S IH Z
MEANINGLY	M IY N IH NG L IY
MEANINGS	M IY N IH NG Z
MEANLY	M IY N L IY
MEANNESS	M IY N N AH S
MEANNESSES	M IY N AH S IH Z
MEANS	M IY N Z
MEANSPIRITED	M IY N S P IH R AH T IH D
MEANT	M EH N T
MEANTIME	M IY N T AY M
MEANTIMES	M IY N T AY M Z
MEANWHILE	M IY N W AY L
MEANWHILES	M IY N W AY L Z
MEANY	M IY N IY
MEASLE	M IY Z AH L
MEASLED	M IY Z AH L D
MEASLES	M IY Z AH L Z
MEASLIER	M IY Z L AY AH R
MEASLIEST	M IY Z L AY AH S T
MEASLY	M IY Z L IY
MEASURABILITIES	M EH ZH ER AH B IH L AH T EH Z
MEASURABILITY	M EH ZH ER AH B IH L AH T EH
MEASURABLE	M EH ZH ER AH B AH L
MEASURABLY	M EH ZH ER AH B L IY
MEASURE	M EH ZH ER
MEASURED	M EH ZH ER D
MEASUREDLY	M EH ZH ER AH D L IY
MEASURELESS	M EH ZH ER L AH S
MEASUREMENT	M EH ZH ER M AH N T
MEASUREMENTS	M EH ZH ER M AH N T S
MEASURER	M EH ZH ER ER
MEASURERS	M EH ZH ER ER Z
MEASURES	M EH ZH ER Z
MEASURING	M EH ZH ER IH NG
MEAT	M IY T
MEATAL	M IY T AH L
MEATBALL	M IY T B AO L
MEATBALLS	M IY T B AO L Z
MEATED	M IY T IH D
MEATHEAD	M IY T HH EH D
MEATHEADS	M IY T HH EH D Z
MEATIER	M IY T IY ER
MEATIEST	M IY T IY AH S T
MEATILY	M IY T IY L IY
MEATINESS	M IY T IY N AH S
MEATINESSES	M IY T IY N AH S IH Z
MEATLESS	M IY T L AH S
MEATLOAF	M IY T L OW F
MEATLOAVES	M IY T L OW V Z
MEATMAN	M IY T M AE N
MEATMEN	M IY T M EH N
MEATPACKING	M IY T P AE K IH NG
MEATPACKINGS	M IY T P AE K IH NG Z
MEATS	M IY T S
MEATUS	M IY EY T AH S
MEATUSES	M IY T Y UW S IH Z
MEATY	M IY T IY
MECAMYLAMINE	M AH K AH M IH L AH M AY N
MECAMYLAMINES	M AH K AH M IH L AH M AY N Z
MECCA	M EH K AH
MECCAS	M EH K AH Z
MECHANIC	M AH K AE N IH K
MECHANIC(2)	M IH K AE N IH K
MECHANICAL	M AH K AE N IH K AH L
MECHANICALLY	M AH K AE N IH K L IY
MECHANICALS	M IH K AE N IH K AH L Z
MECHANICIAN	M EH CH AH N IH S IY AH N
MECHANICIANS	M EH CH AH N IH S IY AH N Z
MECHANICS	M AH K AE N IH K S
MECHANISM	M EH K AH N IH Z AH M
MECHANISMS	M EH K AH N IH Z AH M Z
MECHANIST	M EH K AH N AH S T
MECHANISTIC	M EH K AH N IH S T IH K
MECHANISTICALLY	M EH K AH N IH S T IH K AH L IY
MECHANISTS	M EH K AH N AH S T S
MECHANIZABLE	M EH K AH N AY Z AH B AH L
MECHANIZATION	M EH K AH N AH Z EY SH AH N
MECHANIZATIONS	M EH K AH N AH Z EY SH AH N Z
MECHANIZE	M EH K AH N AY Z
MECHANIZED	M EH K AH N AY Z D
MECHANIZER	M EH K AH N AY Z ER
MECHANIZERS	M EH K AH N AY Z ER Z
MECHANIZES	M EH K AH N AY Z IH Z
MECHANIZING	M EH K AH N AY Z IH NG
MECHANOCHEMICAL	M EH CH AH N AA K AH M IH S AH L
MECHANOCHEMISTRIES	M AH CH AH N AH K AH M IH S T R AY Z
MECHANOCHEMISTRY	M EH CH AH N AA K AH M IH S T R IY
MECHANORECEPTION	M EH CH AH N AO R AH S EH P AH N
MECHANORECEPTIONS	M AH CH AE N AH R AH S EH P T IY AH N Z
MECHANORECEPTIVE	M EH CH AH N AO R AH S EH P T AH V
MECHANORECEPTOR	M EH CH AH N AO R AH S EH P T AH R
MECHANORECEPTORS	M AH CH AE N AH R AH S EH P T AH R Z
MECLIZINE	M EH K L AH Z AY N
MECLIZINES	M EH K L AH Z AY N Z
MECONIUM	M AH K OW N IY AH M
MECONIUMS	M AH K OW N IY AH M Z
MED	M EH D
MEDAILLON	M IY D AH IH L AO N
MEDAILLONS	M IY D AH IH L AO N Z
MEDAKA	M EH D AH K AH
MEDAKAS	M EH D AH K AH Z
MEDAL	M EH D AH L
MEDALED	M EH D AH L D
MEDALING	M EH D AH L IH NG
MEDALIST	M EH D AH L IH S T
MEDALISTS	M EH D AH L IH S T S
MEDALLED	M EH D AH L D
MEDALLIC	M EH D AH L IH K
MEDALLING	M EH D AH L IH NG
MEDALLION	M AH D AE L Y AH N
MEDALLIONS	M AH D AE L Y AH N Z
MEDALLIST	M EH D AH L IH S T
MEDALLISTS	M EH D AH L IH S T S
MEDALS	M EH D AH L Z
MEDDLE	M EH D AH L
MEDDLED	M EH D AH L D
MEDDLER	M EH D AH L ER
MEDDLERS	M EH D AH L ER Z
MEDDLES	M EH D AH L Z
MEDDLESOME	M EH D AH L S AH M
MEDDLESOMENESS	M EH D AH L S AH M N AH S
MEDDLESOMENESSES	M EH D AH L S AH M N AH S IH Z
MEDDLING	M EH D AH L IH NG
MEDDLING(2)	M EH D L IH NG
MEDEVAC	M EH D AH V AH K
MEDEVACKED	M EH D AH V AH K T
MEDEVACKING	M EH D AH V AE K AH NG
MEDEVACS	M EH D AH V AH S
MEDFLIES	M IY D F L AY Z
MEDFLY	M EH D F L IY
MEDIA	M IY D IY AH
MEDIACIES	M IY D IY AH S IY Z
MEDIACY	M IY D IY AH S IY
MEDIAD	M IY D IY AH D
MEDIAE	M IY D IY IY
MEDIAEVAL	M IY D IY IY V AH L
MEDIAEVALS	M IY D IY IY V AH L Z
MEDIAGENIC	M IY D IY IH JH AH N IH K
MEDIAL	M IY D IY AH L
MEDIAL(2)	M IY D Y AH L
MEDIALLY	M IY D IY AH L IY
MEDIALS	M IY D IY AH L Z
MEDIAN	M IY D IY AH N
MEDIANLY	M IY D IY AH N L IY
MEDIANS	M IY D IY AH N Z
MEDIANT	M IY D IY AH N T
MEDIANTS	M IY D IY AH N T S
MEDIAS	M IY D IY AH Z
MEDIASTINA	M IY D IY AE S T AH N AH
MEDIASTINAL	M IY D IY AH Z T AY N AH L
MEDIASTINUM	M IY D IY AE S T AH N AH M
MEDIATE	M IY D IY EY T
MEDIATED	M IY D IY EY T IH D
MEDIATELY	M IY D IY AH T L IY
MEDIATES	M IY D IY AH T S
MEDIATING	M IY D IY EY T IH NG
MEDIATION	M IY D IY EY SH AH N
MEDIATIONAL	M IY D IY EY SH AH N AH L
MEDIATIONS	M IY D IY EY SH AH N Z
MEDIATIVE	M IY D IY AH T IH V
MEDIATOR	M IY D IY EY T ER
MEDIATORS	M IY D IY EY T ER Z
MEDIATORY	M IY D IY AH T OW R IY
MEDIATRICES	M IY D IY AE T R AH S
MEDIATRIX	M IY D IY AE T R AH K S
MEDIATRIXES	M IY D IY AE T R AH K S
MEDIC	M EH D IH K
MEDICABLE	M EH D IH K AH B AH L
FEAL	F IY AH L
NIACIN	N AY AH S AH N
NIACIN(2)	N AY AH S IH N
BO	B OW
NGULTRUM	N G AH L T R AH M
EPACT	EH P AH K T
TWO	T UW
RAVIGOTE	R AE V AH G OW T
