MM	EH M
ACCOMMODATE	AH K AA M AH D EY T
ACCOMMODATED	AH K AA M AH D EY T AH D
ACCOMMODATES	AH K AA M AH D EY T S
ACCOMMODATING	AH K AA M AH D EY T IH NG
ACCOMMODATINGLY	AH K AA M AH D EY T IH NG L IY
ACCOMMODATION	AH K AA M AH D EY SH AH N
ACCOMMODATIONAL	AH K AA M AH D EY SH AH N AH L
ACCOMMODATIONIST	AH K AA M AH D EY SH AH N IH S T
ACCOMMODATIONISTS	AH K AA M AH D EY SH AH N IH S T S
ACCOMMODATIONS	AH K AA M AH D EY SH AH N Z
ACCOMMODATIVE	AH K AA M AH D EY T IH V
ACCOMMODATIVENESS	AH K AA M AH D EY T IH V N AH S
ACCOMMODATIVENESSES	AH K AA M AH D EY T IH V N AH S IH Z
ACCOMMODATOR	AH K AA M AH D EY T ER
ACCOMMODATORS	AH K AA M AH D EY T ER Z
AEROGRAMME	AH R AA G R AH M
AEROGRAMMES	AH R AA G R AH M Z
AGAMMAGLOBULINEMIA	AH G AH M AH G L AH B Y UW L AH N IY M IY AH
AGAMMAGLOBULINEMIAS	AH G AH M AH G L AH B Y UW L AH N IY M IY AH Z
AGAMMAGLOBULINEMIC	AH G AH M AE G L AH B Y UW L AH N AH M AH K
AGLIMMER	AH G L IH M ER
AMMETER	AE M IY T ER
AMMETERS	AE M IY T ER Z
AMMINE	AE M AY N
AMMINES	AE M AY N Z
AMMINO	AE M AH N OW
AMMO	AE M OW
AMMOCETE	AE M AH S IY T
AMMOCETES	AE M AH S IY T S
AMMONAL	AE M AH N AH L
AMMONALS	AE M AH N AH L Z
AMMONIA	AH M OW N Y AH
AMMONIAC	AH M OW N IY AE K
AMMONIACAL	AH M OW N IY AE K AH L
AMMONIACS	AH M OW N IY AE K S
AMMONIAS	AE M OW N Y AH Z
AMMONIATE	AE M AA N AY EY T
AMMONIATED	AE M AA N AY EY T AH D
AMMONIATES	AE M AA N AY EY T S
AMMONIATING	AE M AA N AY EY T AH NG
AMMONIATION	AE M AA N AY EY SH AH N
AMMONIATIONS	AE M OW N IY EY T IY AH N Z
AMMONIC	AE M AH N AH K
AMMONIFICATION	AE M AA N AH F AH K EY SH AH N
AMMONIFICATIONS	AE M AA N AH F AH K EY T IY AH N Z
AMMONIFIED	AE M AA N AH F AY D
AMMONIFIES	AE M AA N AH F AY Z
AMMONIFY	AE M AA N AH F AY
AMMONIFYING	AE M AH N IH F AY AH NG
AMMONITE	AE M AH N AY T
AMMONITES	AE M AH N AY T S
AMMONITIC	AE M AH N AH T AH K
AMMONIUM	AH M OW N IY AH M
AMMONIUMS	AH M OW N IY AH M Z
AMMONO	AE M AH N OW
AMMONOID	AE M AH N OY D
AMMONOIDS	AE M AH N OY D Z
AMMOS	AE M OW Z
AMMUNITION	AE M Y AH N IH SH AH N
AMMUNITIONS	AE M Y AH N IH SH AH N Z
ANAGRAMMATIC	AE N AH G R AE M AH T IH K
ANAGRAMMATICAL	AE N AH G R AE M AH T IH K AH L
ANAGRAMMATICALLY	AE N AH G R AE M AH T IH K AH L IY
ANAGRAMMATIZATION	AE N AH G R AE M AH T AH Z EY SH AH N
ANAGRAMMATIZATIONS	AE N AH G R AE M AH T AH Z EY SH AH N Z
ANAGRAMMATIZE	AE N AH G R AE M AH T AY Z
ANAGRAMMATIZED	AE N AH G R AE M AH T AY Z D
ANAGRAMMATIZES	AE N AH G R AE M AH T AY Z IH Z
ANAGRAMMATIZING	AE N AH G R AE M AH T AY Z IH NG
ANAGRAMMED	AE N AH G R AE M D
ANAGRAMMING	AE N AH G R AE M IH NG
ANALEMMA	AE N AH L EH M AH
ANALEMMAS	AE N AH L EH M AH Z
ANALEMMATA	AE N AH L EH M AH T AH
ANALEMMATIC	AE N AH L EH M AH T AH K
ANTICOMMERCIAL	AE N T AY K AH M ER SH AH L
ANTICOMMERCIALISM	AE N T AY K AH M ER SH AH L IH Z AH M
ANTICOMMERCIALISMS	AE N T AY K AH M ER SH AH L IH Z AH M Z
ANTICOMMUNISM	AE N T AY K AH M Y UW N IH Z AH M
ANTICOMMUNISMS	AE N T AY K AH M Y UW N IH Z AH M Z
ANTICOMMUNIST	AE N T IY K AA M Y AH N IH S T
ANTICOMMUNISTS	AE N T AY K AH M Y UW N IH S T S
ANTIJAMMING	AE N T AY JH AE M IH NG
ANTISYMMETRIC	AE N T AY S AH M EH T R IH K
ASYMMETRIC	EY S AH M EH T R IH K
ASYMMETRICAL	EY S AH M EH T R IH K AH L
ASYMMETRICALLY	EY S AH M EH T R IH K AH L IY
ASYMMETRIES	EY S IH M AH T R IY Z
ASYMMETRY	EY S IH M AH T R IY
AUTOIMMUNE	AO T OY M Y UW N
AUTOIMMUNITIES	AO T OW IH M Y UW N AH T IY Z
AUTOIMMUNITY	AO T OW IH M Y UW N AH T IY
AUTOIMMUNIZATION	AO T OW IH M Y UW N AH Z EY SH AH N
AUTOIMMUNIZATIONS	AO T OW IH M Y UW N AH Z EY SH AH N Z
AXISYMMETRIC	AE K S AH S IH M AH T R AH K
AXISYMMETRICAL	AE K S AH S IH M EH T R IH S AH L
AXISYMMETRIES	AE K S AH S IH M EH T R AY Z
AXISYMMETRY	AE K S AH S AH M EH T R IY
BACKGAMMON	B AE K G AE M AH N
BACKGAMMONS	B AE K G AE M AH N Z
BAMMED	B AE M D
BAMMING	B AE M AH NG
BEDIMMED	B IH D IH M D
BEDIMMING	B IH D IH M IH NG
BEGRIMMED	B IH G R IH M D
BEGRIMMING	B IH G R IH M IH NG
BOTTOMMOST	B AA T AH M OW S T
BRIMMED	B R IH M D
BRIMMER	B R IH M ER
BRIMMERS	B R IH M ER Z
BRIMMING	B R IH M IH NG
BRUMMAGEM	B R AH M AH JH AH M
BRUMMAGEMS	B R AH M AH JH AH M Z
BUMMED	B AH M D
BUMMER	B AH M ER
BUMMERS	B AH M ER Z
BUMMEST	B AH M AH S T
BUMMING	B AH M IH NG
CENTROSYMMETRIC	S EH N T R AH S IH M AH T R AH K
CHAMMIED	CH AE M AY D
CHAMMIES	CH AE M AY Z
CHAMMY	CH AE M IY
CHAMMYING	CH AE M AY AH NG
CHUMMED	CH AH M D
CHUMMIER	CH AH M IY ER
CHUMMIEST	CH AH M IY AH S T
CHUMMILY	CH AH M IY L IY
CHUMMINESS	CH AH M IY N AH S
CHUMMINESSES	CH AH M IY N AH S IH Z
CHUMMING	CH AH M IH NG
CHUMMY	CH AH M IY
CLAMMED	K L AE M D
CLAMMER	K L AE M ER
CLAMMERS	K L AE M ER Z
CLAMMIER	K L AE M IY ER
CLAMMIEST	K L AE M IY AH S T
CLAMMILY	K L AE M IY L IY
CLAMMINESS	K L AE M IY N AH S
CLAMMINESSES	K L AE M IY N AH S IH Z
CLAMMING	K L AE M IH NG
CLAMMY	K L AE M IY
CLAWHAMMER	K L AO HH AE M ER
COMMA	K AA M AH
COMMAND	K AH M AE N D
COMMANDABLE	K AH M AE N D AH B AH L
COMMANDANT	K AA M AH N D AA N T
COMMANDANTS	K AA M AH N D AA N T S
COMMANDED	K AH M AE N D IH D
COMMANDEER	K AA M AH N D IH R
COMMANDEERED	K AA M AH N D IH R D
COMMANDEERING	K AA M AH N D IH ER IH NG
COMMANDEERS	K AA M AH N D IH ER Z
COMMANDER	K AH M AE N D ER
COMMANDERIES	K AH M AE N D AH R IY Z
COMMANDERS	K AH M AE N D ER Z
COMMANDERSHIP	K AH M AE N D ER SH IH P
COMMANDERSHIPS	K AH M AE N D ER SH IH P S
COMMANDERY	K AH M AE N D AH R IY
COMMANDING	K AH M AE N D IH NG
COMMANDINGLY	K AH M AE N D IH NG L IY
COMMANDMENT	K AH M AE N D M AH N T
COMMANDMENTS	K AH M AE N D M AH N T S
COMMANDO	K AH M AE N D OW
COMMANDOES	K AH M AE N D OW Z
COMMANDOS	K AH M AE N D OW Z
COMMANDS	K AH M AE N D Z
COMMAS	K AA M AH Z
COMMATA	K AA M AE T AH
COMMEMORATE	K AH M EH M ER EY T
COMMEMORATED	K AH M EH M ER EY T IH D
COMMEMORATES	K AH M EH M ER EY T S
COMMEMORATING	K AH M EH M ER EY T IH NG
COMMEMORATION	K AH M EH M ER EY SH AH N
COMMEMORATIONS	K AH M EH M ER EY SH AH N Z
COMMEMORATIVE	K AH M EH M R AH T IH V
COMMEMORATIVE(2)	K AH M EH M ER EY T IH V
COMMEMORATIVELY	K AH M EH M ER AH T IH V L IY
COMMEMORATIVES	K AH M EH M ER AH T IH V Z
COMMEMORATOR	K AH M EH M ER AH T ER
COMMEMORATORS	K AH M EH M ER AH T ER Z
COMMENCE	K AH M EH N S
COMMENCED	K AH M EH N S T
COMMENCEMENT	K AH M EH N S M AH N T
COMMENCEMENTS	K AH M EH N S M AH N T S
COMMENCER	K AH M EH N S ER
COMMENCERS	K AH M EH N S ER Z
COMMENCES	K AH M EH N S AH Z
COMMENCING	K AH M EH N S IH NG
COMMEND	K AH M EH N D
COMMENDABLE	K AH M EH N D AH B AH L
COMMENDABLY	K AH M EH N D AH B L IY
COMMENDATION	K AA M AH N D EY SH AH N
COMMENDATIONS	K AA M AH N D EY SH AH N Z
COMMENDATORY	K AH M EH N D AH T OW R IY
COMMENDED	K AH M EH N D IH D
COMMENDER	K AH M EH N D ER
COMMENDERS	K AH M EH N D ER Z
COMMENDING	K AH M EH N D IH NG
COMMENDS	K AH M EH N D Z
COMMENSAL	K AH M EH N Z AH L
COMMENSALISM	K AH M EH N Z AH L IH Z AH M
COMMENSALISMS	K AH M EH N Z AH L IH Z AH M Z
COMMENSALLY	K AH M EH N S AE L IY
COMMENSALS	K AH M EH N Z AH L Z
COMMENSURABILITIES	K AH M EH N Z Y ER AH B IH L AH T EH Z
COMMENSURABILITY	K AH M EH N Z Y ER AH B IH L AH T EH
COMMENSURABLE	K AH M EH N Z Y ER AH B AH L
COMMENSURABLY	K AH M EH N Z Y ER AH B L IY
COMMENSURATE	K AH M EH N S ER AH T
COMMENSURATE(2)	K AH M EH N S ER IH T
COMMENSURATELY	K AH M EH N S ER AH T L IY
COMMENSURATELY(2)	K AH M EH N SH ER AH T L IY
COMMENSURATION	K AH M EH N S AH R AH SH AH N
COMMENSURATIONS	K AH M EH N S AH R AH SH AH N Z
COMMENT	K AA M EH N T
COMMENTARIES	K AA M AH N T EH R IY Z
COMMENTARY	K AA M AH N T EH R IY
COMMENTATE	K AH M EH N T AH T
COMMENTATED	K AH M EH N T EY T IH D
COMMENTATES	K AH M EH N T AH T S
COMMENTATING	K AH M EH N T EY T IH NG
COMMENTATOR	K AA M AH N T EY T ER
COMMENTATORS	K AA M AH N T EY T ER Z
COMMENTED	K AA M EH N T AH D
COMMENTING	K AA M EH N T IH NG
COMMENTS	K AA M EH N T S
COMMERCE	K AA M ER S
COMMERCED	K AA M ER S T
COMMERCES	K AA M ER S IH Z
COMMERCIAL	K AH M ER SH AH L
COMMERCIALISE	K AA M AH R S IY AH L AY Z
COMMERCIALISED	K AH M ER SH AH L IY Z D
COMMERCIALISES	K AH M ER SH AH L IY Z IH Z
COMMERCIALISING	K AH M ER SH AH L IY Z IH NG
COMMERCIALISM	K AH M ER SH AH L IH Z AH M
COMMERCIALISMS	K AH M ER SH AH L IH Z AH M Z
COMMERCIALIST	K AH M ER SH AH L IH S T
COMMERCIALISTIC	K AH M ER SH AH L IH S T IH K
COMMERCIALISTS	K AH M ER SH AH L IH S T S
COMMERCIALITIES	K AH M ER SH AH L AH T IY Z
COMMERCIALITY	K AH M ER SH AH L AH T IY
COMMERCIALIZATION	K AH M ER SH AH L IH Z EY SH AH N
COMMERCIALIZATIONS	K AH M ER SH AH L AH Z EY SH AH N Z
COMMERCIALIZE	K AH M ER SH AH L AY Z
COMMERCIALIZED	K AH M ER SH AH L AY Z D
COMMERCIALIZES	K AH M ER SH AH L AY Z IH Z
COMMERCIALIZING	K AH M ER SH AH L AY Z IH NG
COMMERCIALLY	K AH M ER SH AH L IY
COMMERCIALS	K AH M ER SH AH L Z
COMMERCING	K AA M ER S IH NG
COMMIE	K AA M IY
COMMIES	K AA M IY Z
COMMINATION	K AH M AY N EY SH AH N
COMMINATIONS	K AH M AY N EY SH AH N Z
COMMINATORY	K AH M AY N AH T OW R IY
COMMINGLE	K AH M IH NG G AH L
COMMINGLE(2)	K OW M IH NG G AH L
COMMINGLED	K AA M IH NG G AH L D
COMMINGLED(2)	K OW M IH NG G AH L D
COMMINGLES	K AH M IH NG G AH L Z
COMMINGLING	K AA M IH NG G AH L IH NG
COMMINGLING(2)	K OW M IH NG G L IH NG
COMMINUTE	K AH M IH N AH T
COMMINUTED	K AH M IH N AH T IH D
COMMINUTES	K AH M IH N AH T S
COMMINUTING	K AH M IH N AH T IH NG
COMMINUTION	K AH M IH N AH SH AH N
COMMINUTIONS	K AH M IH N AH SH AH N Z
COMMISERATE	K AH M IH S ER EY T
COMMISERATED	K AH M IH Z ER EY T IH D
COMMISERATES	K AH M IH Z ER AH T S
COMMISERATING	K AH M IH Z ER EY T IH NG
COMMISERATINGLY	K AH M IH Z ER AH T IH NG L IY
COMMISERATION	K AH M IH Z ER EY SH AH N
COMMISERATIONS	K AH M IH Z ER EY SH AH N Z
COMMISERATIVE	K AH M IH Z ER AH T IH V
COMMISSAR	K AA M AH S AA R
COMMISSARIAL	K AA M AH S EH R IY AH L
COMMISSARIAT	K AA M AH S AE R IY AH T
COMMISSARIATS	K AA M AH S AE R AY EY T S
COMMISSARIES	K AA M AH S EH R IY Z
COMMISSARS	K AA M IH S AA Z
COMMISSARY	K AA M AH S EH R IY
COMMISSION	K AH M IH SH AH N
COMMISSIONAIRE	K AH M IH SH AH N AH AY ER
COMMISSIONAIRES	K AH M IH SH AH N AH AY ER Z
COMMISSIONED	K AH M IH SH AH N D
COMMISSIONER	K AH M IH SH AH N ER
COMMISSIONERS	K AH M IH SH AH N ER Z
COMMISSIONERSHIP	K AH M IH SH AH N ER SH IH P
COMMISSIONERSHIPS	K AH M IH SH AH N ER SH IH P S
COMMISSIONING	K AH M IH SH AH N IH NG
COMMISSIONS	K AH M IH SH AH N Z
COMMISSURAL	K AH M IH SH ER AH L
COMMISSURE	K AH M IH SH ER
COMMISSURES	K AH M IH SH ER Z
COMMIT	K AH M IH T
COMMITMENT	K AH M IH T M AH N T
COMMITMENTS	K AH M IH T M AH N T S
COMMITS	K AH M IH T S
COMMITTABLE	K AH M IH T AH B AH L
COMMITTAL	K AH M IH T AH L
COMMITTALS	K AH M IH T AH L Z
COMMITTED	K AH M IH T IH D
COMMITTEE	K AH M IH T IY
COMMITTEEMAN	K AH M IH T IY M AH N
COMMITTEEMEN	K AH M IH T IY M EH N
COMMITTEES	K AH M IH T IY Z
COMMITTEEWOMAN	K AH M IH T IY W UH M AH N
COMMITTEEWOMEN	K AH M IH T IY W IH M AH N
COMMITTING	K AH M IH T IH NG
COMMIX	K AH M IH K S
COMMIXED	K AH M IH K S T
COMMIXES	K AH M IH K S IH Z
COMMIXING	K AH M IH K S IH NG
COMMIXT	K AA M IH K S T
COMMIXTURE	K AH M IH K S CH ER
COMMIXTURES	K AH M IH K S CH ER Z
COMMODE	K AH M OW D
COMMODES	K AH M OW D Z
COMMODIFICATION	K AH M AA D AH F AH K EY SH AH N
COMMODIFICATIONS	K AH M AA D AH F AH K EY SH AH N Z
COMMODIFIED	K AH M AA D AH F AY D
COMMODIFIES	K AH M AA D AH F AY Z
COMMODIFY	K AH M AA D AH F AY
COMMODIFYING	K AH M AA D AH F AY IH NG
COMMODIOUS	K AH M OW D IY AH S
COMMODIOUSLY	K AH M OW D IY AH S L IY
COMMODIOUSNESS	K AH M OW D IY AH S N AH S
COMMODIOUSNESSES	K AH M OW D IY AH S N AH S IH Z
COMMODITIES	K AH M AA D AH T IY Z
COMMODITY	K AH M AA D AH T IY
COMMODORE	K AA M AH D AO R
COMMODORES	K AA M AH D OW R Z
COMMON	K AA M AH N
COMMONAGE	K AA M AH N IH JH
COMMONAGES	K AA M AH N IH JH IH Z
COMMONALITIES	K AA M AH N AE L AH T IY Z
COMMONALITY	K AA M AH N AE L AH T IY
COMMONALTIES	K AA M AH N AH L T AY Z
COMMONALTY	K AA M AH N AE L T IY
COMMONER	K AA M AH N ER
COMMONERS	K AA M AH N ER Z
COMMONEST	K AA M AH N AH S T
COMMONLY	K AA M AH N L IY
COMMONNESS	K AA M AH N AH S
COMMONNESSES	K AA M AH N AH S IH Z
COMMONPLACE	K AA M AH N P L EY S
COMMONPLACENESS	K AA M AH N P L EY S N AH S
COMMONPLACENESSES	K AA M AH N P L EY S N AH S IH Z
COMMONPLACES	K AA M AH N P L EY S IH Z
COMMONS	K AA M AH N Z
COMMONSENSE	K AA M AH N S EH N S
COMMONSENSIBLE	K AA M AH N S EH N S AH B AH L
COMMONSENSICAL	K AA M AH N S EH N S IH K AH L
COMMONSENSICALLY	K AA M AH N S EH N S IH K AH L IY
COMMONWEAL	K AA M AH N W IY L
COMMONWEALS	K AA M AH N W IY L Z
COMMONWEALTH	K AA M AH N W EH L TH
COMMONWEALTHS	K AA M AH N W EH L TH S
COMMOTION	K AH M OW SH AH N
COMMOTIONS	K AH M OW SH AH N Z
COMMOVE	K AH M UW V
COMMOVED	K AH M UW V D
COMMOVES	K AH M UW V Z
COMMOVING	K AH M UW V IH NG
COMMUNAL	K AH M Y UW N AH L
COMMUNALISM	K AH M Y UW N AH L IH Z AH M
COMMUNALISMS	K AH M Y UW N AH L IH Z AH M Z
COMMUNALIST	K AH M Y UW N AH L IH S T
COMMUNALISTS	K AH M Y UW N AH L IH S T S
COMMUNALITIES	K AH M Y UW N AH L AH T IY Z
COMMUNALITY	K AH M Y UW N AH L AH T IY
COMMUNALIZE	K AH M Y UW N AH L AY Z
COMMUNALIZED	K AH M Y UW N AH L AY Z D
COMMUNALIZES	K AH M Y UW N AH L AY Z IH Z
COMMUNALIZING	K AH M Y UW N AH L AY Z IH NG
COMMUNALLY	K AH M Y UW N AH L IY
COMMUNARD	K AA M Y UW N AH R D
COMMUNARDS	K AA M Y UW N AH R D Z
COMMUNE	K AA M Y UW N
COMMUNE(2)	K AH M Y UW N
COMMUNED	K AH M Y UW N D
COMMUNES	K AA M Y UW N Z
COMMUNES(2)	K AH M Y UW N Z
COMMUNICABILITIES	K AH M Y UW N AH K AH B IH L AH T EH Z
COMMUNICABILITY	K AH M Y UW N AH K AH B IH L AH T EH
COMMUNICABLE	K AH M Y UW N AH K AH B AH L
COMMUNICABLENESS	K AH M Y UW N AH K AH B AH L N AH S
COMMUNICABLENESSES	K AH M Y UW N AH K AH B AH L N AH S IH Z
COMMUNICABLY	K AH M Y UW N AH K AH B L IY
COMMUNICANT	K AH M Y UW N AH K AH N T
COMMUNICANTS	K AH M Y UW N AH K AH N T S
COMMUNICATE	K AH M Y UW N AH K EY T
COMMUNICATED	K AH M Y UW N AH K EY T IH D
COMMUNICATEE	K AH M Y UW N AH K AH T IY
COMMUNICATEES	K AH M Y UW N AH K AH T IY Z
COMMUNICATES	K AH M Y UW N IH K EY T S
COMMUNICATING	K AH M Y UW N AH K EY T IH NG
COMMUNICATION	K AH M Y UW N AH K EY SH AH N
COMMUNICATIONAL	K AH M Y UW N AH K EY SH AH N AH L
COMMUNICATIONS	K AH M Y UW N AH K EY SH AH N Z
COMMUNICATIVE	K AH M Y UW N AH K AH T IH V
COMMUNICATIVELY	K AH M Y UW N AH K AH T IH V L IY
COMMUNICATIVENESS	K AH M Y UW N AH K AH T IH V N AH S
COMMUNICATIVENESSES	K AH M Y UW N AH K AH T IH V N AH S IH Z
COMMUNICATOR	K AH M Y UW N AH K EY T ER
COMMUNICATORS	K AH M Y UW N AH K EY T ER Z
COMMUNICATORY	K AH M Y UW N AH K AH T OW R IY
COMMUNING	K AH M Y UW N IH NG
COMMUNION	K AH M Y UW N Y AH N
COMMUNIONS	K AH M Y UW N Y AH N Z
COMMUNIQUE	K AH M Y UW N AH K EY
COMMUNIQUES	K AH M Y UW N IH K EY Z
COMMUNISE	K AA M Y AH N AY Z
COMMUNISED	K AH M Y UW N IY Z D
COMMUNISES	K AH M Y UW N IY Z IH Z
COMMUNISING	K AH M Y UW N IY Z IH NG
COMMUNISM	K AA M Y AH N IH Z AH M
COMMUNISMS	K AH M Y UW N IH Z AH M Z
COMMUNIST	K AA M Y AH N AH S T
COMMUNISTIC	K AA M Y AH N IH S T IH K
COMMUNISTICALLY	K AA M Y AH N IH S T IH K AH L IY
COMMUNISTS	K AA M Y AH N AH S T S
COMMUNITARIAN	K AA M Y UW N AH T EH R IY AH N
COMMUNITARIANISM	K AA M Y UW N AH T AE R IY AH N IH Z AH M
COMMUNITARIANISMS	K AA M Y UW N AH T AH R IY AH N AH Z AH M Z
COMMUNITARIANS	K AA M Y UW N AH T AE R IY AH N Z
COMMUNITIES	K AH M Y UW N AH T IY Z
COMMUNITIES(2)	K AH M Y UW N IH T IY Z
COMMUNITY	K AH M Y UW N AH T IY
COMMUNITY(2)	K AH M Y UW N IH T IY
COMMUNIZATION	K AA M Y AH N AH Z EY SH AH N
COMMUNIZATIONS	K AH M Y UW N AH Z EY SH AH N Z
COMMUNIZE	K AA M Y AH N AY Z
COMMUNIZED	K AH M Y UW N AY Z D
COMMUNIZES	K AH M Y UW N AY Z IH Z
COMMUNIZING	K AH M Y UW N AY Z IH NG
COMMUTABLE	K AH M Y UW T AH B AH L
COMMUTATE	K AA M Y AH T EY T
COMMUTATED	K AH M Y UW T EY T IH D
COMMUTATES	K AH M Y UW T AH T S
COMMUTATING	K AH M Y UW T EY T IH NG
COMMUTATION	K AA M Y AH T EY SH AH N
COMMUTATIONS	K AA M Y AH T EY SH AH N Z
COMMUTATIVE	K AH M Y UW T AH T IH V
COMMUTATIVITIES	K AH M Y UW T AH T IH V AH T IY Z
COMMUTATIVITY	K AH M Y UW T AH T IH V AH T IY
COMMUTATOR	K AH M Y UW T AH T ER
COMMUTATORS	K AH M Y UW T AH T ER Z
COMMUTE	K AH M Y UW T
COMMUTED	K AH M Y UW T IH D
COMMUTER	K AH M Y UW T ER
COMMUTERS	K AH M Y UW T ER Z
COMMUTES	K AH M Y UW T S
COMMUTING	K AH M Y UW T IH NG
COMMY	K AA M IY
CONSOMME	K AA N S AA M
CONSOMMES	K AA N S AA M Z
CONSUMMATE	K AA N S AH M AH T
CONSUMMATE(2)	K AA N S AH M EY T
CONSUMMATED	K AA N S AH M EY T AH D
CONSUMMATELY	K AH N S AH M AH T L IY
CONSUMMATES	K AA N S AH M EY T S
CONSUMMATING	K AA N S AH M EY T IH NG
CONSUMMATION	K AA N S AH M EY SH AH N
CONSUMMATIONS	K AH N S AH M AH SH AH N Z
CONSUMMATIVE	K AH N S AH M AH T IH V
CONSUMMATOR	K AH N S AH M AH T ER
CONSUMMATORS	K AH N S AH M AH T ER Z
CONSUMMATORY	K AH N S AH M AH T OW R IY
COUNTERCOMMERCIAL	K AW N T ER K AH M ER SH AH L
COUNTERPROGRAMMING	K AW N T ER P R OW G R AE M IH NG
COUNTERPROGRAMMINGS	K AW N T ER P R OW G R AE M IH NG Z
CRAMMED	K R AE M D
CRAMMER	K R AE M ER
CRAMMERS	K R AE M ER Z
CRAMMING	K R AE M IH NG
CRIMMER	K R IH M AH R
CRIMMERS	K R IH M AH R Z
CRUMMIE	K R AH M AY
CRUMMIER	K R AH M IY ER
CRUMMIES	K R AH M IY Z
CRUMMIEST	K R AH M IY AH S T
CRUMMINESS	K R AH M IY N AH S
CRUMMINESSES	K R AH M IY N AH S IH Z
CRUMMY	K R AH M IY
CUMMER	K AH M AH R
CUMMERBUND	K AH M AH R B AH N D
CUMMERBUNDS	K AH M AH R B AH N D Z
CUMMERS	K AH M AH R Z
CUMMIN	K AH M AH N
CUMMINS	K AH M IH N Z
DAMMAR	D AE M ER
DAMMARS	D AE M ER Z
DAMMED	D AE M D
DAMMER	D AE M ER
DAMMERS	D AE M ER Z
DAMMING	D AE M IH NG
DECOMMISSION	D IY K AH M IH SH AH N
DECOMMISSIONED	D IY K AH M IH SH AH N D
DECOMMISSIONING	D IY K AH M IH SH AH N IH NG
DECOMMISSIONS	D IY K AH M IH SH AH N Z
DEGUMMED	D IY G AH M D
DEGUMMING	D IY G AH M IH NG
DEPROGRAMMED	D IY P R OW G R AE M D
DEPROGRAMMER	D IY P R OW G R AE M ER
DEPROGRAMMERS	D IY P R OW G R AE M ER Z
DEPROGRAMMING	D IY P R OW G R AE M IH NG
DIAGRAMMABLE	D AY AH G R AE M AH B AH L
DIAGRAMMATIC	D AY AH G R AH M AE T IH K
DIAGRAMMATICAL	D AY AH G R AE M AH T IH K AH L
DIAGRAMMATICALLY	D AY AH G R AE M AH T IH K AH L IY
DIAGRAMMED	D AY AH G R AE M D
DIAGRAMMING	D AY AH G R AE M IH NG
DIGAMMA	D AH G AE M AH
DIGAMMAS	D AH G AE M AH Z
DILEMMA	D IH L EH M AH
DILEMMAS	D AH L EH M AH Z
DILEMMATIC	D AH L EH M AH T AH K
DILEMMIC	D IH L AH M AH K
DIMMABLE	D IH M AH B AH L
DIMMED	D IH M D
DIMMER	D IH M ER
DIMMERS	D IH M ER Z
DIMMEST	D IH M AH S T
DIMMING	D IH M IH NG
DISCOMMEND	D IH S K AH M EH N D
DISCOMMENDED	D IH S K AH M EH N D IH D
DISCOMMENDING	D IH S K AH M EH N D IH NG
DISCOMMENDS	D IH S K AH M EH N D Z
DISCOMMODE	D IH S K AH M OW D
DISCOMMODED	D IH S K AH M OW D IH D
DISCOMMODES	D IH S K AH M OW D Z
DISCOMMODING	D IH S K AH M OW D IH NG
DISSYMMETRIC	D IH S IH M EH T R IH K
DISSYMMETRIES	D IH S IH M AH T R IY Z
DISSYMMETRY	D IH S IH M AH T R IY
DRAMMED	D R AE M D
DRAMMING	D R AE M IH NG
DRAMMOCK	D R AE M AA K
DRAMMOCKS	D R AE M AA K S
DRUMMED	D R AH M D
DRUMMER	D R AH M ER
DRUMMERS	D R AH M ER Z
DRUMMING	D R AH M IH NG
DUMMIED	D AH M IY D
DUMMIES	D AH M IY Z
DUMMKOPF	D AH M K AH P
DUMMKOPFS	D AH M K AH P S
DUMMY	D AH M IY
DUMMYING	D AH M IY IH NG
EMBALMMENT	IH M B AA M AH N T
EMBALMMENTS	IH M B AA M AH N T S
EMMENAGOGUE	IH M EH N AH G AH G
EMMENAGOGUES	IH M EH N AH G AH G Z
EMMER	EH M ER
EMMERS	IH M EH R Z
EMMET	EH M IH T
EMMETS	IH M EH T S
ENGRAMME	IH N G R AE M
ENGRAMMES	IH N G R AE M Z
EPIGRAMMATIC	EH P IH G R AH M AE T IH K
EPIGRAMMATICALLY	EH P IH G R AH M AE T IH K AH L IY
EPIGRAMMATISM	EH P AH G R AE M AH T IH Z AH M
EPIGRAMMATISMS	EH P AH G R AE M AH T IH Z AH M Z
EPIGRAMMATIST	EH P AH G R AE M AH T IH S T
EPIGRAMMATISTS	EH P AH G R AE M AH T IH S T S
EPIGRAMMATIZE	EH P AH G R AE M AH T AY Z
EPIGRAMMATIZED	EH P AH G R AE M AH T AY Z D
EPIGRAMMATIZER	EH P AH G R AE M AH T AY Z ER
EPIGRAMMATIZERS	EH P AH G R AE M AH T AY Z ER Z
EPIGRAMMATIZES	EH P AH G R AE M AH T AY Z IH Z
EPIGRAMMATIZING	EH P AH G R AE M AH T AY Z IH NG
EXCOMMUNICATE	EH K S K AH M Y UW N AH K EY T
EXCOMMUNICATED	EH K S K AH M Y UW N AH K EY T AH D
EXCOMMUNICATES	EH K S K AH M Y UW N AH K EY T S
EXCOMMUNICATING	EH K S K AH M Y UW N AH K EY T IH NG
EXCOMMUNICATION	EH K S K AH M Y UW N AH K EY SH AH N
EXCOMMUNICATIONS	EH K S K AH M Y UW N AH K EY SH AH N Z
EXCOMMUNICATIVE	EH K S K AH M Y UW N AH K EY T IH V
EXCOMMUNICATOR	EH K S K AH M Y UW N AH K EY T ER
EXCOMMUNICATORS	EH K S K AH M Y UW N AH K EY T ER Z
FEMME	F EH M
FEMMES	F EH M Z
FILMMAKER	F IH L M EY K ER
FILMMAKERS	F IH L M EY K ER Z
FILMMAKING	F IH L M EY K IH NG
FILMMAKINGS	F IH L M EY K IH NG Z
FLAMMABILITIES	F L AE M AH B IH L AH T AY Z
FLAMMABILITY	F L AE M AH B IH L IH T IY
FLAMMABLE	F L AE M AH B AH L
FLAMMABLES	F L AE M AH B AH L Z
FLAMMED	F L AE M D
FLAMMING	F L AE M AH NG
FLIMFLAMMED	F L IH M F L AH M D
FLIMFLAMMER	F L IH M F L AE M AH R
FLIMFLAMMERIES	F L IH M F L AE M AH R AY Z
FLIMFLAMMERS	F L IH M F L AE M AH R Z
FLIMFLAMMERY	F L IH M F L AH M EH R IY
FLIMFLAMMING	F L IH M F L AE M AH NG
FLUMMERIES	F L AH M AH R AY Z
FLUMMERY	F L AH M AH R IY
FLUMMOX	F L AH M AO K S
FLUMMOXED	F L AH M AO K S T
FLUMMOXES	F L AH M AH K S
FLUMMOXING	F L AH M AA K S AH NG
GAMMA	G AE M AH
GAMMADIA	G AE M EY D IY AH
GAMMADION	G AE M EY D IY AH N
GAMMAS	G AE M AH Z
GAMMED	G AE M D
GAMMER	G AE M AH R
GAMMERS	G AE M AH R Z
GAMMIER	G AE M AY AH R
GAMMIEST	G AE M AY AH S T
GAMMING	G AE M AH NG
GAMMON	G AE M AH N
GAMMONED	G AE M OW N D
GAMMONER	G AE M OW N AH R
GAMMONERS	G AE M AH N AH R Z
GAMMONING	G AE M OW N AH NG
GAMMONS	G AE M AH N Z
GAMMY	G AE M IY
GEMMA	JH EH M AH
GEMMAE	JH EH M IY
GEMMATE	JH EH M AH T
GEMMATED	JH EH M EY T IH D
GEMMATES	JH EH M AH T S
GEMMATING	JH EH M EY T IH NG
GEMMATION	JH EH M EY SH AH N
GEMMATIONS	JH EH M EY SH AH N Z
GEMMED	JH EH M D
GEMMIER	JH EH M IY ER
GEMMIEST	JH EH M IY AH S T
GEMMILY	JH EH M IY L IY
GEMMING	JH EH M IH NG
GEMMOLOGIES	JH EH M AA L AH JH IY Z
GEMMOLOGIST	JH EH M AA L AH JH AH S T
GEMMOLOGISTS	JH EH M AA L AH JH AH S T S
GEMMOLOGY	JH EH M AA L AH JH IY
GEMMULE	JH EH M Y UW L
GEMMULES	JH EH M Y UW L Z
GEMMY	JH EH M IY
GIMMAL	JH IH M AH L
GIMMALS	JH IH M AH L Z
GIMME	G IH M IY
GIMMES	JH IH M Z
GIMMICK	G IH M IH K
GIMMICKED	JH IH M AH K T
GIMMICKING	JH IH M IH K AH NG
GIMMICKRIES	JH IH M IH K R AY Z
GIMMICKRY	G IH M IH K R IY
GIMMICKS	G IH M IH K S
GIMMICKY	G IH M IH K IY
GIMMIE	JH IH M AY
GIMMIES	JH IH M AY Z
GLIMMER	G L IH M ER
GLIMMERED	G L IH M ER D
GLIMMERING	G L IH M ER IH NG
GLIMMERINGS	G L IH M ER IH NG Z
GLIMMERS	G L IH M ER Z
GLOMMED	G L AA M D
GLOMMING	G L AA M IH NG
GLUMMER	G L AH M ER
GLUMMEST	G L AH M AH S T
GODDAMMED	G AA D AE M D
GODDAMMING	G AA D AE M IH NG
GRAMMAR	G R AE M ER
GRAMMARIAN	G R AH M EH R IY AH N
GRAMMARIANS	G R AH M EH R IY AH N Z
GRAMMARS	G R AE M ER Z
GRAMMATICAL	G R AH M AE T AH K AH L
GRAMMATICAL(2)	G R AH M AE T IH K AH L
GRAMMATICALITIES	G R AH M AE T IH K AH L AH T IY Z
GRAMMATICALITY	G R AH M AE T IH K AH L AH T IY
GRAMMATICALLY	G R AH M AE T IH K AH L IY
GRAMMATICALNESS	G R AH M AE T IH K AH L N AH S
GRAMMATICALNESSES	G R AH M AE T IH K AH L N AH S IH Z
GRAMME	G R AE M
GRAMMES	G R AE M Z
GREMMIE	G R EH M AY
GREMMIES	G R EH M AY Z
GREMMY	G R EH M IY
GRIMMER	G R IH M ER
GRIMMEST	G R IH M AH S T
GROMMET	G R AA M AH T
GROMMETS	G R AA M AH T S
GRUMMER	G R AH M AH R
GRUMMEST	G R AH M AH S T
GRUMMET	G R AH M AH T
GRUMMETS	G R AH M AH T S
GUMMA	G AH M AH
GUMMAS	G AH M AH Z
GUMMATA	G AH M AH T AH
GUMMATOUS	G AH M AH T AH S
GUMMED	G AH M D
GUMMER	G AH M ER
GUMMERS	G AH M ER Z
GUMMIER	G AH M IY ER
GUMMIEST	G AH M IY AH S T
GUMMINESS	G AH M IY N AH S
GUMMINESSES	G AH M IY N AH S IH Z
GUMMING	G AH M IH NG
GUMMITE	G AH M AY T
GUMMITES	G AH M AY T S
GUMMOSE	G AH M OW Z
GUMMOSES	G AH M OW Z AH Z
GUMMOSIS	G AH M OW S AH S
GUMMOUS	G AH M AH S
GUMMY	G AH M IY
HAMMADA	HH AE M AH D AH
HAMMADAS	HH AE M AH D AH Z
HAMMAL	HH AE M AH L
HAMMALS	HH AE M AH L Z
HAMMED	HH AE M D
HAMMER	HH AE M ER
HAMMERED	HH AE M ER D
HAMMERER	HH AE M ER ER
HAMMERERS	HH AE M ER ER Z
HAMMERHEAD	HH AE M ER HH EH D
HAMMERHEADS	HH AE M ER HH EH D Z
HAMMERING	HH AE M ER IH NG
HAMMERLESS	HH AE M ER L AH S
HAMMERLOCK	HH AE M ER L AA K
HAMMERLOCKS	HH AE M ER L AA K S
HAMMERS	HH AE M ER Z
HAMMERTOE	HH AE M ER T OW
HAMMERTOES	HH AE M ER T OW Z
HAMMIER	HH AE M IY ER
HAMMIEST	HH AE M IY AH S T
HAMMILY	HH AE M IY L IY
HAMMINESS	HH AE M IY N AH S
HAMMINESSES	HH AE M IY N AH S IH Z
HAMMING	HH AE M IH NG
HAMMOCK	HH AE M AH K
HAMMOCKS	HH AE M AH K S
HAMMY	HH AE M IY
HELLGRAMMITE	HH EH L G R AE M AY T
HELLGRAMMITES	HH EH L G R AE M AY T S
HEMMED	HH EH M D
HEMMER	HH EH M ER
HEMMERS	HH EH M ER Z
HEMMING	HH EH M IH NG
HMM	HH AH M
HOMMOCK	HH AA M AH K
HOMMOCKS	HH AA M AH K S
HOMMOS	HH AA M AH Z
HOMMOSES	HH AA M OW Z AH Z
HUMMABLE	HH AH M AH B AH L
HUMMED	HH AH M D
HUMMER	HH AH M ER
HUMMERS	HH AH M ER Z
HUMMING	HH AH M IH NG
HUMMINGBIRD	HH AH M IH NG B ER D
HUMMINGBIRDS	HH AH M IH NG B ER D Z
HUMMOCK	HH AH M AH K
HUMMOCKED	HH AH M AH K T
HUMMOCKING	HH AH M AH K IH NG
HUMMOCKS	HH AH M AH K S
HUMMOCKY	HH AH M AH K IY
HUMMUS	HH UH M AH S
HUMMUSES	HH AH M Y UW Z IH Z
HYPERIMMUNE	HH AY P ER IH M Y UW N
HYPERIMMUNIZATION	HH AY P ER IH M Y UW N AH Z EY SH AH N
HYPERIMMUNIZATIONS	HH AY P ER IH M Y UW N AH Z EY SH AH N Z
HYPERIMMUNIZE	HH AY P ER IH M Y UW N AY Z
HYPERIMMUNIZED	HH AY P ER IH M Y UW N AY Z D
HYPERIMMUNIZES	HH AY P ER IH M Y UW N AY Z IH Z
HYPERIMMUNIZING	HH AY P ER IH M Y UW N AY Z IH NG
IDEOGRAMMATIC	IH D IY AA G R AE M AH T AH K
IDEOGRAMMIC	IH D IY AA G R AH M AH K
IMMACULACIES	IH M AE K Y UW L AH S AY Z
IMMACULACY	IH M AH S UH L AH S IY
IMMACULATE	IH M AE K Y UW L IH T
IMMACULATELY	IH M AE K Y AH L AH T L IY
IMMANE	IH M EY N
IMMANENCE	IH M AH N AH N S
IMMANENCES	IH M AH N AH N S IH Z
IMMANENCIES	IH M AH N AH N S IY Z
IMMANENCY	IH M AH N AH N S IY
IMMANENT	IH M AH N AH N T
IMMANENTISM	IH M AH N AH N T IH Z AH M
IMMANENTISMS	IH M AH N AH N T IH Z AH M Z
IMMANENTIST	IH M AH N AH N T IH S T
IMMANENTISTIC	IH M AH N AH N T IH S T IH K
IMMANENTISTS	IH M AH N AH N T IH S T S
IMMANENTLY	IH M AH N AH N T L IY
IMMATERIAL	IH M AH T IH R IY AH L
IMMATERIALISM	IH M AH T IH R IY AH L IH Z AH M
IMMATERIALISMS	IH M AH T IH R IY AH L IH Z AH M Z
IMMATERIALIST	IH M AH T IH R IY AH L IH S T
IMMATERIALISTS	IH M AH T IH R IY AH L IH S T S
IMMATERIALITIES	IH M AH T IH R IY AH L AH T IY Z
IMMATERIALITY	IH M AH T IH R IY AH L AH T IY
IMMATERIALIZE	IH M AH T IH R IY AH L AY Z
IMMATERIALIZED	IH M AH T IH R IY AH L AY Z D
IMMATERIALIZES	IH M AH T IH R IY AH L AY Z IH Z
IMMATERIALIZING	IH M AH T IH R IY AH L AY Z IH NG
IMMATURE	IH M AH T Y UH R
IMMATURELY	IH M AH T Y UH R L IY
IMMATURES	IH M AH T Y UH R Z
IMMATURITIES	IH M AH T Y UH R AH T IY Z
IMMATURITY	IH M AH CH UH R IH T IY
IMMEASURABLE	IH M EH ZH ER AE B AH L
IMMEASURABLENESS	IH M EH ZH ER AH B AH L N AH S
IMMEASURABLENESSES	IH M EH ZH ER AH B AH L N AH S IH Z
IMMEASURABLY	IH M EH ZH ER AE B L IY
IMMEDIACIES	IH M IY D IY AH S IY Z
IMMEDIACY	IH M IY D IY AH S IY
IMMEDIATE	IH M IY D IY AH T
IMMEDIATELY	IH M IY D IY AH T L IY
IMMEDIATENESS	IH M IY D IY AH T N AH S
IMMEDIATENESSES	IH M IY D IY AH T N AH S IH Z
IMMEDICABLE	IH M EH D IH K AH B AH L
IMMEDICABLY	IH M EH D IH K AH B L IY
IMMEMORIAL	IH M AH M AO R IY AH L
IMMEMORIALLY	IH M AH M OW R IY AH L IY
IMMENSE	IH M EH N S
IMMENSELY	IH M EH N S L IY
IMMENSENESS	IH M EH N S N AH S
IMMENSENESSES	IH M EH N S N AH S IH Z
IMMENSER	IH M EH N S ER
IMMENSEST	IH M EH N S AH S T
IMMENSITIES	IH M EH N S AH T IY Z
IMMENSITY	IH M EH N S AH T IY
IMMENSURABLE	IH M EH N CH ER AH B AH L
IMMERGE	IH M ER JH
IMMERGED	IH M ER JH D
IMMERGES	IH M ER JH IH Z
IMMERGING	IH M ER JH IH NG
IMMERSE	IH M ER S
IMMERSED	IH M ER S T
IMMERSES	IH M ER S IH Z
IMMERSIBLE	IH M ER S AH B AH L
IMMERSING	IH M ER S IH NG
IMMERSION	IH M ER ZH AH N
IMMERSIONS	IH M ER ZH AH N Z
IMMESH	IH M EH SH
IMMESHED	IH M EH SH T
IMMESHES	IH M EH SH IH Z
IMMESHING	IH M EH SH IH NG
IMMETHODICAL	IH M AH TH AA D IH K AH L
IMMETHODICALLY	IH M AH TH AA D IH K AH L IY
IMMIES	IH M AY Z
IMMIGRANT	IH M AH G R AH N T
IMMIGRANTS	IH M AH G R AH N T S
IMMIGRATE	IH M AH G R EY T
IMMIGRATED	IH M AH G R EY T IH D
IMMIGRATES	IH M AH G R AH T S
IMMIGRATING	IH M AH G R EY T IH NG
IMMIGRATION	IH M AH G R EY SH AH N
IMMIGRATIONAL	IH M AH G R EY SH AH N AH L
IMMIGRATIONS	IH M AH G R EY SH AH N Z
IMMINENCE	IH M AH N AH N S
IMMINENCES	IH M AH N AH N S IH Z
IMMINENCIES	IH M AH N AH N S IY Z
IMMINENCY	IH M AH N AH N S IY
IMMINENT	IH M AH N AH N T
IMMINENTLY	IH M AH N AH N T L IY
IMMINGLE	IH M IH NG G AH L
IMMINGLED	IH M IH NG G AH L D
IMMINGLES	IH M IH NG G AH L Z
IMMINGLING	IH M IH NG G AH L IH NG
IMMISCIBILITIES	IH M AH S AH B IH L AH T AY Z
IMMISCIBILITY	IH M IH S AH B IH L AH T IY
IMMISCIBLE	IH M IH S AH B AH L
IMMITIGABLE	IH M IH T AH G AH B AH L
IMMITIGABLY	IH M IH T AH G AH B L IY
IMMITTANCE	IH M IH T AH N S
IMMITTANCES	IH M IH T AH N S IH Z
IMMIX	IH M IH K S
IMMIXED	IH M IH K S T
IMMIXES	IH M IH K S IH Z
IMMIXING	IH M IH K S IH NG
IMMIXTURE	IH M IH K S CH ER
IMMIXTURES	IH M IH K S CH ER Z
IMMOBILE	IH M OW B AH L
IMMOBILE(2)	IH M OW B AY L
IMMOBILE(3)	IH M OW B IY L
IMMOBILISM	IH M OW B AH L IH Z AH M
IMMOBILISMS	IH M OW B AH L IH Z AH M Z
IMMOBILITIES	IH M OW B IH L AH T IY Z
IMMOBILITY	IH M OW B IH L IH T IY
IMMOBILIZATION	IH M OW B AH L AH Z EY SH AH N
IMMOBILIZATIONS	IH M OW B AH L AH Z EY SH AH N Z
IMMOBILIZE	IH M OW B AH L AY Z
IMMOBILIZED	IH M OW B AH L AY Z D
IMMOBILIZER	IH M OW B AH L AY Z ER
IMMOBILIZERS	IH M OW B AH L AY Z ER Z
IMMOBILIZES	IH M OW B AH L AY Z IH Z
IMMOBILIZING	IH M OW B AH L AY Z IH NG
IMMODERACIES	IH M OW D ER AH S IY Z
IMMODERACY	IH M OW D ER AH S IY
IMMODERATE	IH M AA D AH R AH T
IMMODERATELY	IH M AA D AH R AH T L IY
IMMODERATENESS	IH M AA D AH R AH T N AH S
IMMODERATENESSES	IH M AA D AH R AH T N AH S IH Z
IMMODERATION	IH M AA D AH R AH SH AH N
IMMODERATIONS	IH M AA D AH R AH SH AH N Z
IMMODEST	IH M AA D AH S T
IMMODESTIES	IH M AA D AH S T IY Z
IMMODESTLY	IH M AA D AH S T L IY
IMMODESTY	IH M AA D AH S T IY
IMMOLATE	IH M AH L EY T
IMMOLATED	IH M AH L EY T AH D
IMMOLATES	IH M AH L EY T S
IMMOLATING	IH M AH L EY T IH NG
IMMOLATION	IH M AH L EY SH AH N
IMMOLATIONS	IH M OW L EY SH AH N Z
IMMOLATOR	IH M OW L AH T ER
IMMOLATORS	IH M OW L AH T ER Z
IMMORAL	IH M AO R AH L
IMMORALISM	IH M AH R AE L IH Z AH M
IMMORALISMS	IH M AH R AE L IH Z AH M Z
IMMORALIST	IH M AH R AE L IH S T
IMMORALISTS	IH M AH R AE L IH S T S
IMMORALITIES	IH M AH R AE L AH T IY Z
IMMORALITY	IH M ER AE L IH T IY
IMMORALLY	IH M AO R AH L IY
IMMORTAL	IH M AO R T AH L
IMMORTALISE	IH M AO R T AH L AY Z
IMMORTALISED	IH M AO R T AH L IY Z D
IMMORTALISES	IH M AO R T AH L IY Z IH Z
IMMORTALISING	IH M AO R T AH L IY Z IH NG
IMMORTALITIES	IH M AO R T AE L AH T IY Z
IMMORTALITY	IH M AO R T AE L IH T IY
IMMORTALIZATION	IH M AO R T AH L AH Z EY SH AH N
IMMORTALIZATIONS	IH M AO R T AH L AH Z EY SH AH N Z
IMMORTALIZE	IH M AO R T AH L AY Z
IMMORTALIZED	IH M AO R T AH L AY Z D
IMMORTALIZER	IH M AO R T AH L AY Z ER
IMMORTALIZERS	IH M AO R T AH L AY Z ER Z
IMMORTALIZES	IH M AO R T AH L AY Z IH Z
IMMORTALIZING	IH M AO R T AH L AY Z IH NG
IMMORTALLY	IH M AO R T AH L IY
IMMORTALS	IH M AO R T AH L Z
IMMORTELLE	IH M AO R T AH L
IMMORTELLES	IH M AO R T AH L Z
IMMOTILE	IH M OW T AH L
IMMOVABILITIES	IH M UW V AH B IH L AH T EH Z
IMMOVABILITY	IH M UW V AH B IH L AH T EH
IMMOVABLE	IH M UW V AH B AH L
IMMOVABLENESS	IH M UW V AH B AH L N AH S
IMMOVABLENESSES	IH M UW V AH B AH L N AH S IH Z
IMMOVABLES	IH M UW V AH B AH L Z
IMMOVABLY	IH M UW V AH B L IY
IMMUNE	IH M Y UW N
IMMUNES	IH M Y UW N Z
IMMUNISE	IH M Y AH N AY Z
IMMUNISED	IH M Y UW N IY Z D
IMMUNISES	IH M Y UW N IY Z IH Z
IMMUNISING	IH M Y UW N IY Z IH NG
IMMUNITIES	IH M Y UW N IH T IY Z
IMMUNITY	IH M Y UW N AH T IY
IMMUNITY(2)	IH M Y UW N IH T IY
IMMUNIZATION	IH M Y UW N AH Z EY SH AH N
IMMUNIZATIONS	IH M Y UW N AH Z EY SH AH N Z
IMMUNIZE	IH M Y UW N AY Z
IMMUNIZED	IH M Y AH N AY Z D
IMMUNIZES	IH M Y AH N AY Z IH Z
IMMUNIZING	IH M Y AH N AY Z IH NG
IMMUNOASSAY	IH M Y AH N OW S EY IY
IMMUNOASSAYABLE	IH M Y AH N OW S EY AH B AH L
IMMUNOASSAYS	IH M Y AH N OW S EY Z
IMMUNOBLOT	IH M Y AH N AA B L AH T
IMMUNOBLOTS	IH M Y AH N AA B L AH T S
IMMUNOBLOTTING	IH M Y AH N AA B L AA T AH NG
IMMUNOBLOTTINGS	IH M Y UW N AH B L AA T AH NG Z
IMMUNOCHEMICAL	IH M Y AH N AA K AH M IH S AH L
IMMUNOCHEMICALLY	IH M Y AH N AH K EH M AH K AE L IY
IMMUNOCHEMIST	IH M Y AH N AA K AH M AH S T
IMMUNOCHEMISTRIES	IH M Y AH N AH K AH M IH S T R AY Z
IMMUNOCHEMISTRY	IH M Y AH N AA K AH M IH S T R IY
IMMUNOCHEMISTS	IH M Y AH N AA K AH M AH S T S
IMMUNOCOMPETENCE	IH M Y UW N AH K AA M P AH T AH N S
IMMUNOCOMPETENCES	IH M Y UW N AH K AA M P AH T EH N S AH Z
IMMUNOCOMPETENT	IH M Y UW N AH K AA M P AH T AH N T
IMMUNOCOMPROMISED	IH M Y UW N AH K AA M P R AH M AH S T
IMMUNOCYTOCHEMICAL	IH M Y UW N AH S AH T AA K AH M IH S AH L
IMMUNOCYTOCHEMICALLY	IH M Y AH N AA S AH T AH K EH M AH K AE L IY
IMMUNOCYTOCHEMISTRIES	IH M Y UW N AH S AH T AH K AH M IH S T R AY Z
IMMUNOCYTOCHEMISTRY	IH M Y UW N AH S AH T AA K AH M IH S T R IY
IMMUNODEFICIENCIES	IH M Y AH N AH D AH F AH S IY N S AY Z
IMMUNODEFICIENCY	IH M Y UW N OW D IH F IH SH AH N S IY
IMMUNODEFICIENT	IH M Y AH N AA D AH F IH S IY AH N T
IMMUNODIAGNOSES	IH M Y AH N OW D IY AH G N OW Z AH Z
IMMUNODIAGNOSIS	IH M Y AH N OW D IY AH G N OW S AH S
IMMUNODIAGNOSTIC	IH M Y AH N OW D IY AE G N AH S T AH K
IMMUNODIFFUSION	IH M Y UW N AH D IH F AH S IY AH N
IMMUNODIFFUSIONS	IH M Y UW N AH D AH F Y UW S IY AH N Z
IMMUNOELECTROPHORESES	IH M Y UW N OW AH L EH K T R AA F AH R IY Z AH Z
IMMUNOELECTROPHORESIS	IH M Y AH N OW AH L EH K T R AH F AO R AH S AH S
IMMUNOELECTROPHORETIC	IH M Y AH N OW AH L AH K T R AA F AH R AH T AH K
IMMUNOELECTROPHORETICALLY	IH M Y UW N OW AH L EH K T R AH F AH R EH T AH K AE L IY
IMMUNOFLUORESCENCE	IH M Y UW N AH F L AH W AH R EH S AH N S
IMMUNOFLUORESCENCES	IH M Y UW N AH F L AH W AH R AH S EH N S AH Z
IMMUNOFLUORESCENT	IH M Y UW N AH F L AH W AH R EH S AH N T
IMMUNOGEN	IH M Y UW N AH JH AH N
IMMUNOGENESES	IH M Y AH N AA JH AH N IY Z AH Z
IMMUNOGENESIS	IH M Y UW N AH JH IY N AH S AH S
IMMUNOGENETIC	IH M Y AH N AA JH AH N AH T AH K
IMMUNOGENETICALLY	IH M Y UW N AH JH AH N EH T AH K AE L IY
IMMUNOGENETICIST	IH M Y AH N AH JH EH N AH T IH S AH S T
IMMUNOGENETICISTS	IH M Y UW N AH JH AH N EH T AH S AH S T S
IMMUNOGENETICS	IH M Y AH N AH JH EH N AH T AH S Z
IMMUNOGENIC	IH M Y UW N AH JH AH N AH K
IMMUNOGENICITIES	IH M Y UW N AH JH AH N IH S AH T AY Z
IMMUNOGENICITY	IH M Y AH N AA JH AH N IH S AH T IY
IMMUNOGENS	IH M Y UW N AH JH AH N Z
IMMUNOGLOBULIN	IH M Y AH N AA G L AH B Y UW L AH N
IMMUNOGLOBULINS	IH M Y AH N AA G L AH B Y UW L AH N Z
IMMUNOHEMATOLOGIC	IH M Y UW N AH HH AH M AE T AH L AH JH AH K
IMMUNOHEMATOLOGICAL	IH M Y AH N AA HH AH M AH T AA L AH JH IH S AH L
IMMUNOHEMATOLOGIES	IH M Y AH N AA HH AH M AH T AA L AH JH AY Z
IMMUNOHEMATOLOGIST	IH M Y AH N AA HH AH M AH T AA L AH JH AH S T
IMMUNOHEMATOLOGISTS	IH M Y AH N AA HH AH M AH T AA L AH JH AH S T S
IMMUNOHEMATOLOGY	IH M Y AH N AA HH AH M AH T AA L AH JH IY
IMMUNOHISTOCHEMICAL	IH M Y UW N AH HH IH S T AA K AH M IH S AH L
IMMUNOHISTOCHEMISTRIES	IH M Y UW N AH HH IH S T AH K AH M IH S T R AY Z
IMMUNOHISTOCHEMISTRY	IH M Y UW N AH HH IH S T AA K AH M IH S T R IY
IMMUNOLOGIC	IH M Y UW N AH L AH JH AH K
IMMUNOLOGICAL	IH M Y UW N AH L AA JH IH K AH L
IMMUNOLOGICALLY	IH M Y AH N AH L AA JH AH K AE L IY
IMMUNOLOGIES	IH M Y UW N AA L AH JH IY Z
IMMUNOLOGIST	IH M Y UW N AA L AH JH IH S T
IMMUNOLOGISTS	IH M Y UW N AA L AH JH AH S T S
IMMUNOLOGY	IH M Y UW N AA L AH JH IY
IMMUNOMODULATOR	IH M Y UW N AH M AA D Y AH L EY T AH R
IMMUNOMODULATORS	IH M Y UW N AH M AH D Y UW L AH T AH R Z
IMMUNOMODULATORY	IH M Y UW N AH M AA D Y AH L AH T AO R IY
IMMUNOPATHOLOGIC	IH M Y UW N AH P AE TH AH L AH JH AH K
IMMUNOPATHOLOGICAL	IH M Y UW N AH P AH TH AA L AH JH IH S AH L
IMMUNOPATHOLOGIES	IH M Y UW N AH P AH TH AA L AH JH AY Z
IMMUNOPATHOLOGIST	IH M Y UW N AH P AH TH AA L AH JH AH S T
IMMUNOPATHOLOGISTS	IH M Y UW N AH P AH TH AA L AH JH AH S T S
IMMUNOPATHOLOGY	IH M Y UW N AH P AH TH AA L AH JH IY
IMMUNOPRECIPITATE	IH M Y UW N AH P R AH S IH P AH T EY T
IMMUNOPRECIPITATED	IH M Y UW N AH P R AH S IH P AH T EY T AH D
IMMUNOPRECIPITATES	IH M Y UW N AH P R AH S IH P AH T EY T S
IMMUNOPRECIPITATING	IH M Y UW N AH P R AH S IH P AH T EY T AH NG
IMMUNOPRECIPITATION	IH M Y UW N AH P R AH S IH P AH T EY SH AH N
IMMUNOPRECIPITATIONS	IH M Y UW N AH P R EH S AH P AH T EY T IY AH N Z
IMMUNOREACTIVE	IH M Y UW N AH R IY K T AH V
IMMUNOREACTIVITIES	IH M Y UW N AH R IY K T IH V AH T AY Z
IMMUNOREACTIVITY	IH M Y UW N AH R IY K T IH V AH T IY
IMMUNOREGULATION	IH M Y UW N AH R EH G Y AH L EY SH AH N
IMMUNOREGULATIONS	IH M Y UW N AH R EH G Y AH L EY T IY AH N Z
IMMUNOREGULATORY	IH M Y UW N AH R EH G Y AH L AH T AO R IY
IMMUNOSORBENT	IH M Y UW N AH S AO R B AH N T
IMMUNOSORBENTS	IH M Y UW N AH S AO R B AH N T S
IMMUNOSUPPRESS	IH M Y UW N AH S AH P R AH S
IMMUNOSUPPRESSANT	IH M Y UW N AH S AH P R AH S AH N T
IMMUNOSUPPRESSANTS	IH M Y UW N AH S AH P R EH S AH N T S
IMMUNOSUPPRESSED	IH M Y UW N AH S AH P R AH S T
IMMUNOSUPPRESSES	IH M Y UW N AH S AH P R EH S AH Z
IMMUNOSUPPRESSING	IH M Y UW N AH S AH P R EH S AH NG
IMMUNOSUPPRESSION	IH M Y UW N AH S AH P R EH S IY AH N
IMMUNOSUPPRESSIONS	IH M Y UW N AH S AH P R EH S IY AH N Z
IMMUNOSUPPRESSIVE	IH M Y UW N AH S AH P R AH S AH V
IMMUNOTHERAPEUTIC	IH M Y UW N AH TH AH R EY P AH Y UW T AH K
IMMUNOTHERAPIES	IH M Y AH N AH TH EH R AH P AY Z
IMMUNOTHERAPY	IH M Y UW N OW TH EH R AH P IY
IMMURE	IH M Y AH R
IMMURED	IH M Y AH R D
IMMUREMENT	IH M Y UH R M AH N T
IMMUREMENTS	IH M Y UH R AH M AH N T S
IMMURES	IH M Y AH R Z
IMMURING	IH M Y AH R AH NG
IMMUTABILITIES	IH M Y UW T AH B IH L AH T EH Z
IMMUTABILITY	IH M Y UW T AH B IH L AH T EH
IMMUTABLE	IH M Y UW T AH B AH L
IMMUTABLENESS	IH M Y UW T AH B AH L N AH S
IMMUTABLENESSES	IH M Y UW T AH B AH L N AH S IH Z
IMMUTABLY	IH M Y UW T AH B L IY
IMMY	IH M IY
INCOMMENSURABILITIES	IH N K AH M EH N Z Y ER AH B IH L AH T EH Z
INCOMMENSURABILITY	IH N K AH M EH N Z Y ER AH B IH L AH T EH
INCOMMENSURABLE	IH N K AH M EH N Z Y ER AH B AH L
INCOMMENSURABLES	IH N K AH M EH N Z Y ER AH B AH L Z
INCOMMENSURABLY	IH N K AH M EH N Z Y ER AH B L IY
INCOMMENSURATE	IH N K AH M EH N S AH R AH T
INCOMMODE	IH N K AH M OW D
INCOMMODED	IH N K AH M OW D IH D
INCOMMODES	IH N K AH M OW D Z
INCOMMODING	IH N K AH M OW D IH NG
INCOMMODIOUS	IH N K AH M OW D IY AH S
INCOMMODIOUSLY	IH N K AH M OW D IY AH S L IY
INCOMMODIOUSNESS	IH N K AH M OW D IY AH S N AH S
INCOMMODIOUSNESSES	IH N K AH M OW D IY AH S N AH S IH Z
INCOMMODITIES	IH N K AH M AA D AH T IY Z
INCOMMODITY	IH N K AH M AA D AH T IY
INCOMMUNICABILITIES	IH N K AH M Y UW N AH K AH B IH L AH T EH Z
INCOMMUNICABILITY	IH N K AH M Y UW N AH K AH B IH L AH T EH
INCOMMUNICABLE	IH N K AH M Y UW N AH K AH B AH L
INCOMMUNICABLY	IH N K AH M Y UW N AH K AH B L IY
INCOMMUNICADO	IH N K AH M Y UW N AH K AA D OW
INCOMMUNICATIVE	IH N K AH M Y UW N AH K AH T IH V
INCOMMUTABLE	IH N K AH M Y UW T AH B AH L
INCOMMUTABLY	IH N K AH M Y UW T AH B L IY
INFLAMMABILITIES	IH N F L AE M AH B IH L AH T AY Z
INFLAMMABILITY	IH N F L AE M AH B IH L AH T IY
INFLAMMABLE	IH N F L AE M AH B AH L
INFLAMMABLENESS	IH N F L AE M AH B AH L N AH S
INFLAMMABLENESSES	IH N F L AE M AH B AH L N AH S IH Z
INFLAMMABLES	IH N F L AE M AH B AH L Z
INFLAMMABLY	IH N F L AE M AH B AH L IY
INFLAMMATION	IH N F L AH M EY SH AH N
INFLAMMATIONS	IH N F L AH M EY SH AH N Z
INFLAMMATORILY	IH N F L AE M AH T OW R IY L IY
INFLAMMATORY	IH N F L AE M AH T AO R IY
INTERCOMMUNAL	IH N T ER K AH M Y UW N AH L
INTERCOMMUNICATE	IH N T ER K AH M Y UW N AH K AH T
INTERCOMMUNICATED	IH N T ER K AH M Y UW N AH K EY T IH D
INTERCOMMUNICATES	IH N T ER K AH M Y UW N AH K AH T S
INTERCOMMUNICATING	IH N T ER K AH M Y UW N AH K EY T IH NG
INTERCOMMUNICATION	IH N T ER K AH M Y UW N AH K EY SH AH N
INTERCOMMUNICATIONS	IH N T ER K AH M Y UW N AH K EY SH AH N Z
INTERCOMMUNION	IH N T ER K AH M Y UW N Y AH N
INTERCOMMUNIONS	IH N T ER K AH M Y UW N Y AH N Z
INTERCOMMUNITIES	IH N T ER K AH M Y UW N AH T IY Z
INTERCOMMUNITY	IH N T ER K AH M Y UW N AH T IY
JACKHAMMER	JH AE K HH AE M ER
JACKHAMMERED	JH AE K HH AE M ER D
JACKHAMMERING	JH AE K HH AE M ER IH NG
JACKHAMMERS	JH AE K HH AE M ER Z
JAMMED	JH AE M D
JAMMER	JH AE M ER
JAMMERS	JH AE M ER Z
JAMMIER	JH AE M IY ER
JAMMIES	JH AE M IY Z
JAMMIEST	JH AE M IY AH S T
JAMMING	JH AE M IH NG
JAMMY	JH AE M IY
JEMMIED	JH EH M AY D
JEMMIES	JH EH M AY Z
JEMMY	JH EH M IY
JEMMYING	JH EH M AY AH NG
JIMMIED	JH IH M IY D
JIMMIES	JH IH M IY Z
JIMMINY	JH IH M AY N IY
JIMMY	JH IH M IY
JIMMYING	JH IH M IY IH NG
KATZENJAMMER	K AE T S EH N JH AE M AH R
KATZENJAMMERS	K AE T S AH N JH AE M AH R Z
KRIMMER	K R IH M AH R
KRIMMERS	K R IH M AH R Z
KRUMMHOLZ	K R AH M HH OW L Z
KRUMMHORN	K R AH M HH AH R N
KRUMMHORNS	K R AH M HH AH R N Z
KUMMEL	K AH M AH L
KUMMELS	K AH M AH L Z
LAMMED	L AE M D
LAMMERGEIER	L AE M ER JH IY ER
LAMMERGEIERS	L AE M ER JH IY ER Z
LAMMERGEYER	L AE M ER JH IY ER
LAMMERGEYERS	L AE M ER JH IY ER Z
LAMMING	L AE M IH NG
LEMMA	L EH M AH
LEMMAS	L EH M AH Z
LEMMATA	L EH M AH T AH
LEMMING	L EH M IH NG
LEMMINGLIKE	L EH M AH NG L AY K
LEMMINGS	L EH M IH NG Z
LIMMER	L IH M ER
LIMMERS	L IH M AH R Z
LOGOGRAMMATIC	L AH G AA G R AE M AH T AH K
LUMMOX	L AH M AH K S
LUMMOXES	L AH M AH K S IH Z
MAMMA	M AA M AH
MAMMAE	M AE M IY
MAMMAL	M AE M AH L
MAMMALIAN	M AH M EY L IY AH N
MAMMALIAN(2)	M AH M EY L Y AH N
MAMMALIANS	M AH M EY L IY AH N Z
MAMMALOGIES	M AA M AH L AA G IY Z
MAMMALOGIST	M AA M AH L AA G IH S T
MAMMALOGISTS	M AA M AH L AA G IH S T S
MAMMALOGY	M AA M AH L AA G IY
MAMMALS	M AE M AH L Z
MAMMARY	M AE M ER IY
MAMMAS	M AA M AH Z
MAMMATE	M AE M EY T
MAMMATI	M AE M AH T IY
MAMMATUS	M AE M EY T AH S
MAMMEE	M AE M IY IY
MAMMEES	M AE M IY Z
MAMMER	M AE M AH R
MAMMERED	M AE M IY R D
MAMMERING	M AE M IY R AH NG
MAMMERS	M AE M AH R Z
MAMMET	M AE M AH T
MAMMETS	M AE M AH T S
MAMMEY	M AE M IY
MAMMEYS	M AE M EY Z
MAMMIE	M AE M AY
MAMMIES	M AE M AY Z
MAMMILLA	M AE M IH L AH
MAMMILLAE	M AE M IH L IY
MAMMILLARY	M AE M AH L EH R IY
MAMMILLATED	M AE M AH L EY T AH D
MAMMITIDES	M AE M AH T AY D Z
MAMMITIS	M AE M AY T AH S
MAMMOCK	M AE M AH K
MAMMOCKED	M AE M AH K T
MAMMOCKING	M AE M AA K AH NG
MAMMOCKS	M AE M AH K S
MAMMOGRAM	M AE M OW G R AE M
MAMMOGRAMS	M AE M OW G R AE M Z
MAMMOGRAPHIC	M AE M AA G R AH F AH K
MAMMOGRAPHIES	M AE M AA G R AH F AY Z
MAMMOGRAPHY	M AH M AA G R AH F IY
MAMMON	M AE M AH N
MAMMONISM	M AE M AH N IH Z AH M
MAMMONISMS	M AE M AH N AH Z AH M Z
MAMMONIST	M AE M AH N AH S T
MAMMONISTS	M AE M AH N AH S T S
MAMMONS	M AE M AH N Z
MAMMOTH	M AE M AH TH
MAMMOTHS	M AE M AH TH S
MAMMY	M AE M IY
MAREMMA	M AH R EH M AH
MAREMME	M AE R AH M
MICROPROGRAMMING	M AY K R OW P R OW G R AE M IH NG
MICROPROGRAMMINGS	M AY K R OW P R OW G R AE M IH NG Z
MIDSUMMER	M IH D S AH M ER
MIDSUMMERS	M IH D S AH M ER Z
MISCOMMUNICATION	M IH S K AH M Y UW N AH K EY SH AH N
MISCOMMUNICATIONS	M IH S K AH M Y UW N AH K EY SH AH N Z
MISPROGRAMMED	M IH S P R OW G R AE M D
MISPROGRAMMING	M IH S P R OW G R AE M IH NG
MM	EH M
MOMMA	M AA M AH
MOMMAS	M AA M AH Z
MOMMIES	M AA M IY Z
MOMMY	M AA M IY
MONOGRAMMATIC	M AA N OW G R AE M AH T IH K
MONOGRAMMED	M AA N AH G R AE M D
MONOGRAMMER	M AA N OW G R AE M ER
MONOGRAMMERS	M AA N OW G R AE M ER Z
MONOGRAMMING	M AA N OW G R AE M IH NG
MULTIPROGRAMMING	M AH L T AY P R OW G R AE M IH NG
MULTIPROGRAMMINGS	M AH L T AY P R OW G R AE M IH NG Z
MULTISTEMMED	M AH L T AY S T EH M D
MUMM	M AH M
MUMMED	M AH M D
MUMMER	M AH M ER
MUMMERIES	M AH M AH R IY Z
MUMMERS	M AH M ER Z
MUMMERY	M AH M AH R IY
MUMMICHOG	M AH M IH K HH AA G
MUMMICHOGS	M AH M IH K HH AA G Z
MUMMIED	M AH M IY D
MUMMIES	M AH M IY Z
MUMMIFICATION	M AH M IH F IH K EY SH AH N
MUMMIFICATIONS	M AH M AH F AH K EY SH AH N Z
MUMMIFIED	M AH M IH F AY D
MUMMIFIES	M AH M IH F AY Z
MUMMIFY	M AH M AH F AY
MUMMIFYING	M AH M AH F AY IH NG
MUMMING	M AH M IH NG
MUMMS	M AH M Z
MUMMY	M AH M IY
MUMMYING	M AH M IY IH NG
NEURILEMMA	N Y UH R AH L EH M AH
NEURILEMMAL	N Y UH R AH L EH M AH L
NEURILEMMAS	N Y UH R AH L EH M AH Z
NIMMED	N IH M D
NIMMING	N IH M AH NG
NINNYHAMMER	N IH N AH HH AE M AH R
NINNYHAMMERS	N IH N AH HH AE M AH R Z
NONCOMMERCIAL	N AA N K AH M ER SH AH L
NONCOMMERCIALS	N AA N K AH M ER SH AH L Z
NONCOMMITMENT	N AA N K AH M IH T M AH N T
NONCOMMITMENTS	N AA N K AH M IH T M AH N T S
NONCOMMITTAL	N AA N K AH M IH T AH L
NONCOMMITTALLY	N AA N K AH M IH T AH L IY
NONCOMMITTED	N AA N K AH M IH T IH D
NONCOMMUNICATING	N AA N K AH M Y UW N AH K EY T IH NG
NONCOMMUNICATION	N AA N K AH M Y UW N AH K EY SH AH N
NONCOMMUNICATIONS	N AA N K AH M Y UW N AH K EY SH AH N Z
NONCOMMUNICATIVE	N AA N K AH M Y UW N AH K AH T IH V
NONCOMMUNIST	N AA N K AA M Y UW N IH S T
NONCOMMUNISTS	N AA N K AA M Y UW N IH S T S
NONCOMMUNITIES	N AA N K AH M Y UW N AH T IY Z
NONCOMMUNITY	N AA N K AH M Y UW N AH T IY
NONCOMMUTATIVE	N AA N K AH M Y UW T AH T IH V
NONCOMMUTATIVITIES	N AA N K AH M Y UW T AH T IH V AH T IY Z
NONCOMMUTATIVITY	N AA N K AH M Y UW T AH T IH V AH T IY
NONFLAMMABILITIES	N AA N F L AE M AH B IH L AH T AY Z
NONFLAMMABILITY	N AA N F L AE M AH B IH L AH T IY
NONFLAMMABLE	N AA N F L AE M AH B AH L
NONGRAMMATICAL	N AA N G R AH M AE T IH K AH L
NONIMMIGRANT	N AA N IH M AH G R AH N T
NONIMMIGRANTS	N AA N IH M AH G R AH N T S
NONIMMUNE	N AA N IH M Y UW N
NONINFLAMMABLE	N AA N IH N F L AE M AH B AH L
NONINFLAMMATORY	N AA N IH N F L AE M AH T OW R IY
NONPROGRAMMER	N AA N P R OW G R AE M ER
NONPROGRAMMERS	N AA N P R OW G R AE M ER Z
NONSWIMMER	N AA N S W IH M ER
NONSWIMMERS	N AA N S W IH M ER Z
NONSYMMETRIC	N AA N S AH M EH T R IH K
NONSYMMETRICAL	N AA N S AH M EH T R IH K AH L
NUMMARY	N AH M AH R IY
NUMMULAR	N AH M Y AH L AH R
OHMMETER	AA M AH T AH R
OHMMETERS	AA M AH T AH R Z
OMMATIDIA	AA M AH T IH D IY AH
OMMATIDIAL	AA M AH T IH D IY AH L
OMMATIDIUM	AA M AH T IH D IY AH M
ORIFLAMME	AH R IH F L AH M
ORIFLAMMES	AH R IH F L AH M Z
OUTSWIMMING	AW T S W IH M IH NG
OVERCOMMERCIALIZATION	OW V ER K AH M ER SH AH L AH Z EY SH AH N
OVERCOMMERCIALIZATIONS	OW V ER K AH M ER SH AH L AH Z EY SH AH N Z
OVERCOMMERCIALIZE	OW V ER K AH M ER SH AH L AY Z
OVERCOMMERCIALIZED	OW V ER K AH M ER SH AH L AY Z D
OVERCOMMERCIALIZES	OW V ER K AH M ER SH AH L AY Z IH Z
OVERCOMMERCIALIZING	OW V ER K AH M ER SH AH L AY Z IH NG
OVERCOMMIT	OW V ER K AH M IH T
OVERCOMMITMENT	OW V ER K AH M IH T M AH N T
OVERCOMMITMENTS	OW V ER K AH M IH T M AH N T S
OVERCOMMITS	OW V ER K AH M IH T S
OVERCOMMITTED	OW V ER K AH M IH T IH D
OVERCOMMITTING	OW V ER K AH M IH T IH NG
OVERCOMMUNICATE	OW V ER K AH M Y UW N AH K AH T
OVERCOMMUNICATED	OW V ER K AH M Y UW N AH K EY T IH D
OVERCOMMUNICATES	OW V ER K AH M Y UW N AH K AH T S
OVERCOMMUNICATING	OW V ER K AH M Y UW N AH K EY T IH NG
OVERCOMMUNICATION	OW V ER K AH M Y UW N AH K EY SH AH N
OVERCOMMUNICATIONS	OW V ER K AH M Y UW N AH K EY SH AH N Z
OVERCRAMMED	OW V ER K R AE M D
OVERCRAMMING	OW V ER K R AE M IH NG
OVERPROGRAMMED	OW V ER P R OW G R AE M D
OVERPROGRAMMING	OW V ER P R OW G R AE M IH NG
OVERTRIMMED	OW V ER T R IH M D
OVERTRIMMING	OW V ER T R IH M IH NG
PEMMICAN	P EH M IH K AH N
PEMMICANS	P EH M IH K AH N Z
PERSIMMON	P ER S IH M AH N
PERSIMMONS	P ER S IH M AH N Z
PHONOGRAMMIC	F AH N AA G R AH M AH K
PHONOGRAMMICALLY	F AA N AH G R AE M AH K AE L IY
PHOTOGRAMMETRIC	F OW T OW G R AE M EH T R IH K
PHOTOGRAMMETRIES	F OW T OW G R AE M IY T ER IY Z
PHOTOGRAMMETRIST	F OW T OW G R AE M IY T ER IH S T
PHOTOGRAMMETRISTS	F OW T OW G R AE M IY T ER IH S T S
PHOTOGRAMMETRY	F OW T OW G R AE M IY T ER IY
PLASMALEMMA	P L AE Z M AH L EH M AH
PLASMALEMMAS	P L AE Z M AH L EH M AH Z
PLUMMET	P L AH M AH T
PLUMMETED	P L AH M AH T IH D
PLUMMETING	P L AH M AH T IH NG
PLUMMETS	P L AH M AH T S
PLUMMIER	P L AH M IY ER
PLUMMIEST	P L AH M IY AH S T
PLUMMY	P L AH M IY
POMMEE	P AA M IY IY
POMMEL	P AA M AH L
POMMELED	P AA M IY L D
POMMELING	P AA M IY L AH NG
POMMELLED	P AA M AH L D
POMMELLING	P AA M EH L AH NG
POMMELS	P AA M AH L Z
POMMIE	P AA M AY
POMMIES	P AA M AY Z
POMMY	P AA M IY
PRECOMMITMENT	P R IY K AH M IH T M AH N T
PREPROGRAMMED	P R IY P R OW G R AE M D
PREPROGRAMMING	P R IY P R OW G R AE M IH NG
PRESUMMIT	P R IY S AH M AH T
PRETRIMMED	P R IY T R IH M D
PRETRIMMING	P R IY T R IH M IH NG
PRIMMED	P R IH M D
PRIMMER	P R IH M ER
PRIMMEST	P R IH M AH S T
PRIMMING	P R IH M IH NG
PROGRAMMABILITIES	P R OW G R AE M AH B IH L AH T EH Z
PROGRAMMABILITY	P R OW G R AE M AH B IH L AH T EH
PROGRAMMABLE	P R OW G R AE M AH B AH L
PROGRAMMABLES	P R OW G R AE M AH B AH L Z
PROGRAMMATIC	P R AA G R AH M AE T IH K
PROGRAMMATICALLY	P R OW G R AH M AE T IH K AH L IY
PROGRAMME	P R OW G R AE M
PROGRAMMED	P R OW G R AE M D
PROGRAMMER	P R OW G R AE M ER
PROGRAMMERS	P R OW G R AE M ER Z
PROGRAMMES	P R OW G R AE M Z
PROGRAMMING	P R OW G R AE M IH NG
PROGRAMMINGS	P R OW G R AE M IH NG Z
PSAMMITE	S AE M AY T
PSAMMITES	S AE M AY T S
PSAMMON	S AE M AH N
PSAMMONS	S AE M AH N Z
PUMMEL	P AH M AH L
PUMMELED	P AH M AH L D
PUMMELING	P AH M AH L IH NG
PUMMELLED	P AH M AH L D
PUMMELLING	P AH M AH L IH NG
PUMMELO	P AH M AH L OW
PUMMELOS	P AH M AH L AA S
PUMMELS	P AH M AH L Z
RADIOIMMUNOASSAY	R EY D IY OY M Y AH N OW S EY IY
RADIOIMMUNOASSAYABLE	R EY D IY OY M Y AH N OW S EY AH B AH L
RADIOIMMUNOASSAYS	R EY D IY OY M Y AH N OW S EY Z
RAMMED	R AE M D
RAMMER	R AE M ER
RAMMERS	R AE M ER Z
RAMMIER	R AE M IY ER
RAMMIEST	R AE M IY AH S T
RAMMING	R AE M IH NG
RAMMISH	R AE M IH SH
RAMMY	R AE M IY
RECOMMENCE	R IY K AH M EH N S
RECOMMENCED	R IY K AH M EH N S T
RECOMMENCEMENT	R IY K AH M EH N S M AH N T
RECOMMENCEMENTS	R IY K AH M EH N S M AH N T S
RECOMMENCES	R IY K AH M EH N S IH Z
RECOMMENCING	R IY K AH M EH N S IH NG
RECOMMEND	R EH K AH M EH N D
RECOMMENDABLE	R EH K AH M EH N D AH B AH L
RECOMMENDATION	R EH K AH M AH N D EY SH AH N
RECOMMENDATIONS	R EH K AH M AH N D EY SH AH N Z
RECOMMENDATORY	R EH K AH M EH N D AH T OW R IY
RECOMMENDED	R EH K AH M EH N D AH D
RECOMMENDED(2)	R EH K AH M EH N D IH D
RECOMMENDING	R EH K AH M EH N D IH NG
RECOMMENDS	R EH K AH M EH N D Z
RECOMMISSION	R IY K AH M IH SH AH N
RECOMMISSIONED	R IY K AH M IH SH AH N D
RECOMMISSIONING	R IY K AH M IH SH AH N IH NG
RECOMMISSIONS	R IY K AH M IH SH AH N Z
RECOMMIT	R IH K AA M IH T
RECOMMIT(2)	R IY K AH M IH T
RECOMMITMENT	R IY K AH M IH T M AH N T
RECOMMITMENTS	R IY K AH M IH T M AH N T S
RECOMMITS	R IH K AA M IH T S
RECOMMITTAL	R IY K AH M IH T AH L
RECOMMITTALS	R IY K AH M IH T AH L Z
RECOMMITTED	R IY K AH M IH T IH D
RECOMMITTING	R IY K AH M IH T IH NG
REHAMMER	R IY HH AE M ER
REHAMMERED	R IY HH AE M ER D
REHAMMERING	R IY HH AE M ER IH NG
REHAMMERS	R IY HH AE M ER Z
REHEMMED	R IY HH EH M D
REHEMMING	R IY HH EH M IH NG
REIMMERSE	R IY IH M ER S
REIMMERSED	R IY IH M ER S T
REIMMERSES	R IY IH M ER S IH Z
REIMMERSING	R IY IH M ER S IH NG
REPROGRAMMABLE	R IY P R OW G R AE M AH B AH L
REPROGRAMMED	R IY P R OW G R AE M D
REPROGRAMMING	R IY P R OW G R AE M IH NG
RESUMMON	R IY S AH M AH N
RESUMMONED	R IY S AH M AH N D
RESUMMONING	R IY S AH M AH N IH NG
RESUMMONS	R IY S AH M AH N Z
RETRIMMED	R IY T R IH M D
RETRIMMING	R IY T R IH M IH NG
RIMMED	R IH M D
RIMMER	R IH M ER
RIMMERS	R IH M ER Z
RIMMING	R IH M IH NG
ROOMMATE	R UW M EY T
ROOMMATES	R UW M EY T S
RUMMAGE	R AH M IH JH
RUMMAGED	R AH M IH JH D
RUMMAGER	R AH M IH JH ER
RUMMAGERS	R AH M IH JH ER Z
RUMMAGES	R AH M IH JH AH Z
RUMMAGING	R AH M IH JH IH NG
RUMMER	R AH M ER
RUMMERS	R AH M ER Z
RUMMEST	R AH M AH S T
RUMMIER	R AH M IY ER
RUMMIES	R AH M IY Z
RUMMIEST	R AH M IY AH S T
RUMMY	R AH M IY
SARCOLEMMA	S AA R K AH L EH M AH
SARCOLEMMAL	S AA R K AH L EH M AH L
SARCOLEMMAS	S AA R K AH L EH M AH Z
SCAMMED	S K AE M D
SCAMMING	S K AE M AH NG
SCAMMONIES	S K AE M AH N AY Z
SCAMMONY	S K AE M AH N IY
SCRAMMED	S K R AE M D
SCRAMMING	S K R AE M AH NG
SCRIMMAGE	S K R IH M IH JH
SCRIMMAGED	S K R IH M IH JH D
SCRIMMAGER	S K R IH M IH JH ER
SCRIMMAGERS	S K R IH M IH JH ER Z
SCRIMMAGES	S K R IH M IH JH IH Z
SCRIMMAGING	S K R IH M IH JH IH NG
SCRUMMAGE	S K R AH M AH JH
SCRUMMAGED	S K R AH M AH JH D
SCRUMMAGES	S K R AH M AH JH AH Z
SCRUMMAGING	S K R AH M AH JH AH NG
SCRUMMED	S K R AH M D
SCRUMMING	S K R AH M AH NG
SCUMMED	S K AH M D
SCUMMER	S K AH M AH R
SCUMMERS	S K AH M AH R Z
SCUMMIER	S K AH M AY AH R
SCUMMIEST	S K AH M AY AH S T
SCUMMING	S K AH M AH NG
SCUMMY	S K AH M IY
SEMICOMMERCIAL	S EH M IY K AH M ER SH AH L
SHAMMAS	SH AE M AH Z
SHAMMASH	SH AE M AE SH
SHAMMASHIM	SH AE M AH SH AH M
SHAMMASIM	SH AE M AH S AH M
SHAMMED	SH AE M D
SHAMMER	SH AE M ER
SHAMMERS	SH AE M ER Z
SHAMMES	SH AE M Z
SHAMMIED	SH AE M IY D
SHAMMIES	SH AE M IY Z
SHAMMING	SH AE M IH NG
SHAMMOS	SH AE M AH Z
SHAMMOSIM	SH AE M AH S AH M
SHAMMY	SH AE M IY
SHAMMYING	SH AE M IY IH NG
SHIMMED	SH IH M D
SHIMMER	SH IH M ER
SHIMMERED	SH IH M ER D
SHIMMERING	SH IH M ER IH NG
SHIMMERS	SH IH M ER Z
SHIMMERY	SH IH M AH R IY
SHIMMIED	SH IH M IY D
SHIMMIES	SH IH M IY Z
SHIMMING	SH IH M IH NG
SHIMMY	SH IH M IY
SHIMMYING	SH IH M IY IH NG
SIMMER	S IH M ER
SIMMERED	S IH M ER D
SIMMERING	S IH M ER IH NG
SIMMERS	S IH M ER Z
SKIMMED	S K IH M D
SKIMMER	S K IH M ER
SKIMMERS	S K IH M ER Z
SKIMMING	S K IH M IH NG
SKIMMINGS	S K IH M IH NG Z
SLAMMED	S L AE M D
SLAMMER	S L AE M ER
SLAMMERS	S L AE M ER Z
SLAMMING	S L AE M IH NG
SLEDGEHAMMER	S L EH JH HH AE M ER
SLEDGEHAMMERED	S L EH JH EH HH AH M IY R D
SLEDGEHAMMERING	S L EH JH EH HH AH M IY R AH NG
SLEDGEHAMMERS	S L EH JH AH HH AE M AH R Z
SLIMMED	S L IH M D
SLIMMER	S L IH M ER
SLIMMERS	S L IH M ER Z
SLIMMEST	S L IH M AH S T
SLIMMING	S L IH M IH NG
SLUMMED	S L AH M D
SLUMMER	S L AH M ER
SLUMMERS	S L AH M ER Z
SLUMMIER	S L AH M IY ER
SLUMMIEST	S L AH M IY AH S T
SLUMMING	S L AH M IH NG
SLUMMY	S L AH M IY
SOMMELIER	S AH M AH L Y EY
SOMMELIERS	S AH M AH L Y EY Z
SPAMMED	S P AE M D
SPAMMER	S P AE M AH R
SPAMMERS	S P AE M AH R Z
SPAMMING	S P AE M AH NG
STAMMEL	S T AE M AH L
STAMMELS	S T AE M AH L Z
STAMMER	S T AE M ER
STAMMERED	S T AE M ER D
STAMMERER	S T AE M ER ER
STAMMERERS	S T AE M ER ER Z
STAMMERING	S T AE M ER IH NG
STAMMERS	S T AE M ER Z
STEMMA	S T EH M AH
STEMMAS	S T EH M AH Z
STEMMATA	S T EH M AH T AH
STEMMATIC	S T EH M AH T IH K
STEMMED	S T EH M D
STEMMER	S T EH M ER
STEMMERIES	S T EH M AH R IY Z
STEMMERS	S T EH M ER Z
STEMMERY	S T EH M AH R IY
STEMMIER	S T EH M IY ER
STEMMIEST	S T EH M IY AH S T
STEMMING	S T EH M IH NG
STEMMY	S T EH M IY
STRUMMED	S T R AH M D
STRUMMER	S T R AH M ER
STRUMMERS	S T R AH M ER Z
STRUMMING	S T R AH M IH NG
STUMMED	S T AH M D
STUMMING	S T AH M AH NG
SUBCOMMISSION	S AH B K AH M IH SH AH N
SUBCOMMISSIONS	S AH B K AH M IH SH AH N Z
SUBCOMMITTEE	S AH B K AH M IH T IY
SUBCOMMITTEES	S AH B K AH M IH T IY Z
SUBCOMMUNITIES	S AH B K AH M Y UW N AH T IY Z
SUBCOMMUNITY	S AH B K AH M Y UW N AH T IY
SUMMA	S UW M AH
SUMMABILITIES	S AH M AH B IH L AH T EH Z
SUMMABILITY	S AH M AH B IH L AH T EH
SUMMABLE	S AH M AH B AH L
SUMMAE	S AH M IY
SUMMAND	S AH M AH N D
SUMMANDS	S AH M AH N D Z
SUMMARIES	S AH M ER IY Z
SUMMARILY	S AH M EH R IH L IY
SUMMARISE	S AH M AH R AY Z
SUMMARISED	S AH M EH R IY Z D
SUMMARISES	S AH M EH R IY Z IH Z
SUMMARISING	S AH M EH R IY Z IH NG
SUMMARIZABLE	S AH M ER AY Z AH B AH L
SUMMARIZATION	S AH M AH R AH Z EY SH AH N
SUMMARIZATIONS	S AH M AH R AH Z EY SH AH N Z
SUMMARIZE	S AH M ER AY Z
SUMMARIZED	S AH M ER AY Z D
SUMMARIZER	S AH M ER AY Z ER
SUMMARIZERS	S AH M ER AY Z ER Z
SUMMARIZES	S AH M ER AY Z IH Z
SUMMARIZING	S AH M ER AY Z IH NG
SUMMARY	S AH M ER IY
SUMMAS	S AH M AH Z
SUMMATE	S AH M AH T
SUMMATED	S AH M EY T IH D
SUMMATES	S AH M AH T S
SUMMATING	S AH M EY T IH NG
SUMMATION	S AH M EY SH AH N
SUMMATIONAL	S AH M EY SH AH N AH L
SUMMATIONS	S AH M EY SH AH N Z
SUMMATIVE	S AH M AH T IH V
SUMMED	S AH M D
SUMMER	S AH M ER
SUMMERED	S AH M ER D
SUMMERHOUSE	S AH M ER HH AW S
SUMMERHOUSES	S AH M ER HH AW S IH Z
SUMMERIER	S AH M AH R IY ER
SUMMERIEST	S AH M AH R IY AH S T
SUMMERING	S AH M ER IH NG
SUMMERLIKE	S AH M ER L AY K
SUMMERLONG	S AH M ER L AO NG
SUMMERLY	S AH M ER L IY
SUMMERS	S AH M ER Z
SUMMERSAULT	S AH M AH R S AH L T
SUMMERSAULTED	S AH M AH R S AO L T AH D
SUMMERSAULTING	S AH M AH R S AO L T AH NG
SUMMERSAULTS	S AH M AH R S AH L T S
SUMMERTIME	S AH M ER T AY M
SUMMERTIMES	S AH M ER T AY M Z
SUMMERWOOD	S AH M ER W UH D
SUMMERWOODS	S AH M ER W UH D Z
SUMMERY	S AH M AH R IY
SUMMING	S AH M IH NG
SUMMIT	S AH M AH T
SUMMIT(2)	S AH M IH T
SUMMITAL	S AH M AH T AH L
SUMMITED	S AH M AH T IH D
SUMMITEER	S AH M IH T IH R
SUMMITEERS	S AH M IH T IH R Z
SUMMITING	S AH M AH T IH NG
SUMMITRIES	S AH M AH T R IY Z
SUMMITRY	S AH M IH T R IY
SUMMITS	S AH M IH T S
SUMMON	S AH M AH N
SUMMONABLE	S AH M AH N AH B AH L
SUMMONED	S AH M AH N D
SUMMONER	S AH M AH N ER
SUMMONERS	S AH M AH N ER Z
SUMMONING	S AH M AH N IH NG
SUMMONS	S AH M AH N Z
SUMMONSED	S AH M AH N Z D
SUMMONSES	S AH M AH N Z IH Z
SUMMONSING	S AH M AH N Z IH NG
SUPERSYMMETRIC	S UW P ER S AH M EH T R IH K
SUPERSYMMETRIES	S UW P ER S IH M AH T R IY Z
SUPERSYMMETRY	S UW P ER S IH M AH T R IY
SWIMMABLE	S W IH M AH B AH L
SWIMMER	S W IH M ER
SWIMMERET	S W IH M AH R AH T
SWIMMERETS	S W IH M AH R AH T S
SWIMMERS	S W IH M ER Z
SWIMMIER	S W IH M IY ER
SWIMMIEST	S W IH M IY AH S T
SWIMMILY	S W IH M IY L IY
SWIMMING	S W IH M IH NG
SWIMMINGLY	S W IH M IH NG L IY
SWIMMINGS	S W IH M IH NG Z
SWIMMY	S W IH M IY
SYMMETALLISM	S IH M AH T AH L IH Z AH M
SYMMETALLISMS	S IH M AH T AE L AH Z AH M Z
SYMMETRIC	S AH M EH T R IH K
SYMMETRICAL	S AH M EH T R IH K AH L
SYMMETRICALLY	S AH M EH T R IH K L IY
SYMMETRICALNESS	S AH M EH T R IH K AH L N AH S
SYMMETRICALNESSES	S AH M EH T R IH K AH L N AH S IH Z
SYMMETRIES	S IH M AH T R IY Z
SYMMETRIZATION	S IH M EH T R AH Z EY SH AH N
SYMMETRIZATIONS	S IH M EH T R AH Z EY T IY AH N Z
SYMMETRIZE	S IH M AH T R AY Z
SYMMETRIZED	S IH M AH T R AY Z D
SYMMETRIZES	S IH M AH T R AY Z AH Z
SYMMETRIZING	S IH M AH T R AY Z AH NG
SYMMETRY	S IH M AH T R IY
TAMMIE	T AE M IY
TAMMIES	T AE M AY Z
TAMMY	T AE M IY
TEAMMATE	T IY M EY T
TEAMMATES	T IY M M EY T S
TELECOMMUNICATION	T EH L AH K AH M Y UW N IH K EY SH AH N
TELECOMMUNICATIONS	T EH L AH K AH M Y UW N AH K EY SH AH N Z
TELECOMMUTE	T EH L AH K AH M Y UW T
TELECOMMUTED	T EH L AH K AH M Y UW T IH D
TELECOMMUTER	T EH L AH K AH M Y UW T ER
TELECOMMUTERS	T EH L AH K AH M Y UW T ER Z
TELECOMMUTES	T EH L AH K AH M Y UW T S
TELECOMMUTING	T EH L AH K AH M Y UW T IH NG
TELEGRAMMED	T EH L AH G R AE M D
TELEGRAMMING	T EH L AH G R AE M IH NG
TETRAGRAMMATON	T EH T R AH G R AE M AH T AH N
TETRAGRAMMATONS	T EH T R AH G R AE M AH T AH N Z
THINGUMMIES	TH IH N G AH M IY Z
THINGUMMY	TH IH N G AH M IY
THRUMMED	TH R AH M D
THRUMMER	TH R AH M ER
THRUMMERS	TH R AH M ER Z
THRUMMIER	TH R AH M IY ER
THRUMMIEST	TH R AH M IY AH S T
THRUMMING	TH R AH M IH NG
THRUMMY	TH R AH M IY
TOMMED	T AA M D
TOMMIES	T AA M IY Z
TOMMING	T AA M IH NG
TOMMY	T AA M IY
TOMMYROT	T AA M IY R AA T
TOMMYROTS	T AA M IY R AA T S
TRAMMED	T R AE M D
TRAMMEL	T R AE M AH L
TRAMMELED	T R AE M AH L D
TRAMMELING	T R AE M AH L IH NG
TRAMMELLED	T R AE M AH L D
TRAMMELLING	T R AE M AH L IH NG
TRAMMELS	T R AE M AH L Z
TRAMMING	T R AE M IH NG
TRIMMED	T R IH M D
TRIMMER	T R IH M ER
TRIMMERS	T R IH M ER Z
TRIMMEST	T R IH M AH S T
TRIMMING	T R IH M IH NG
TRIMMINGS	T R IH M IH NG Z
TROMMEL	T R AA M AH L
TROMMELS	T R AA M AH L Z
TSIMMES	T S IH M Z
TSIMMESES	T S IH M IY Z AH Z
TUMMIES	T AH M IY Z
TUMMLER	T AH M L AH R
TUMMLERS	T AH M L AH R Z
TUMMY	T AH M IY
TZIMMES	T S IH M Z
TZIMMESES	T S IH M IY Z AH Z
ULTRACOMMERCIAL	AH L T R AH K AH M ER SH AH L
UMM	AH M
UNACCOMMODATED	AH N AH K AA M AH D EY T IH D
UNACCOMMODATING	AH N AH K AA M AH D EY T IH NG
UNCOMMERCIAL	AH N K AH M ER SH AH L
UNCOMMERCIALIZED	AH N K AH M ER SH AH L AY Z D
UNCOMMITTED	AH N K AH M IH T IH D
UNCOMMON	AH N K AA M AH N
UNCOMMONER	AH N K AA M AH N ER
UNCOMMONEST	AH N K AA M AH N AH S T
UNCOMMONLY	AH N K AA M AH N L IY
UNCOMMONNESS	AH N K AA M AH N AH S
UNCOMMONNESSES	AH N K AA M AH N AH S IH Z
UNCOMMUNICABLE	AH N K AH M Y UW N AH K AH B AH L
UNCOMMUNICATIVE	AH N K AH M Y UW N AH K AH T IH V
UNCONSUMMATED	AH N K AH N S AH M AH T IH D
UNDIMMED	AH N D IH M D
UNGIMMICKY	AH N JH IH M IH K IY
UNGRAMMATICAL	AH N G R AH M AE T IH K AH L
UNGRAMMATICALITIES	AH N G R AH M AE T IH K AH L AH T IY Z
UNGRAMMATICALITY	AH N G R AH M AE T IH K AH L AH T IY
UNIMMUNIZED	AH N IH M Y UW N AY Z D
UNJAMMED	AH N JH AE M D
UNJAMMING	AH N JH AE M IH NG
UNPROGRAMMABLE	AH N P R OW G R AE M AH B AH L
UNPROGRAMMED	AH N P R OW G R AE M D
UNSYMMETRICAL	AH N S AH M EH T R IH K AH L
UNSYMMETRICALLY	AH N S AH M EH T R IH K AH L IY
UNTRAMMELED	AH N T R AE M AH L D
UNTRIMMED	AH N T R IH M D
UNTRIMMING	AH N T R IH M IH NG
WAMMUS	W AA M AH S
WAMMUSES	W AA M Y UW Z AH Z
WHAMMED	W AA M D
WHAMMIES	W AA M AY Z
WHAMMING	W AA M AH NG
WHAMMO	W AA M OW
WHAMMY	W AE M IY
WHAMMY(2)	HH W AE M IY
WINDJAMMER	W IH N D JH AE M ER
WINDJAMMERS	W IH N D JH AE M ER Z
WINDJAMMING	W IH N D JH AE M IH NG
WINDJAMMINGS	W IH N D JH AE M IH NG Z
WOMMERA	W AA M AH R AH
WOMMERAS	W AA M AH R AH Z
YAMMER	Y AE M AH R
YAMMERED	Y AE M IY R D
YAMMERER	Y AE M IY R AH R
YAMMERERS	Y AE M AH R AH R Z
YAMMERING	Y AE M IY R AH NG
YAMMERS	Y AE M AH R Z
YELLOWHAMMER	Y EH L OW HH AE M ER
YELLOWHAMMERS	Y EH L OW HH AE M ER Z
YUMMIER	Y AH M AY AH R
YUMMIES	Y AH M IY Z
YUMMIEST	Y AH M AY AH S T
YUMMY	Y AH M IY
IHRAM	IH R AH M
OKES	OW K S
ONUS	OW N AH S
ROACH	R OW CH
FIACRE	F AY AH K AH R
VOCABLE	V OW K AH B AH L
OKRA	OW K R AH
