NE	N IY
NE(2)	N EY
ABALONE	AE B AH L OW N IY
ABALONES	AE B AH L OW N IY Z
ABANDONED	AH B AE N D AH N D
ABANDONER	AH B AE N D AH N ER
ABANDONERS	AH B AE N D AH N ER Z
ABIOGENESES	EY B IY AA JH AH N IY Z AH Z
ABIOGENESIS	EY B IY AH JH IY N AH S AH S
ABJECTNESS	AE B JH EH K T N AH S
ABJECTNESSES	AE B JH EH K T N AH S IH Z
ABNEGATE	AE B N AH G EY T
ABNEGATED	AE B N AH G EY T AH D
ABNEGATES	AE B N AH G EY T S
ABNEGATING	AE B N AH G EY T AH NG
ABNEGATION	AE B N EH G EY SH AH N
ABNEGATIONS	AE B N AH G EY T IY AH N Z
ABNEGATOR	AE B N AH G EY T AH R
ABNEGATORS	AE B N EH G AH T AH R Z
ABORIGINE	AE B ER IH JH AH N IY
ABORIGINES	AE B ER IH JH AH N IY Z
ABORTIVENESS	AH B AO R T IH V N AH S
ABORTIVENESSES	AH B AO R T IH V N AH S IH Z
ABRASIVENESS	AH B R EY S IH V N AH S
ABRASIVENESSES	AH B R EY S IH V N AH S IH Z
ABRUPTNESS	AH B R AH P T N AH S
ABRUPTNESSES	AH B R AH P T N AH S IH Z
ABSENTMINDEDNESS	AE B S AH N T M AY N D AH D N AH S
ABSENTMINDEDNESSES	AE B S AH N T M AY N D AH D N AH S IH Z
ABSOLUTENESS	AE B S AH L UW T N AH S
ABSOLUTENESSES	AE B S AH L UW T N AH S IH Z
ABSTAINED	AH B S T EY N D
ABSTAINED(2)	AE B S T EY N D
ABSTAINER	AH B S T EY N ER
ABSTAINERS	AH B S T EY N ER Z
ABSTEMIOUSNESS	AE B S T IY M IY AW Z N AH S
ABSTEMIOUSNESSES	AE B S T IY M IY AW Z N EH S AH Z
ABSTINENCE	AE B S T AH N AH N S
ABSTINENCES	AE B S T AH N AH N S IH Z
ABSTINENT	AE B S T AH N AH N T
ABSTINENTLY	AE B S T AH N EH N T L IY
ABSTRACTEDNESS	AE B S T R AE K T AH D N AH S
ABSTRACTEDNESSES	AE B S T R AE K T AH D N AH S IH Z
ABSTRACTNESS	AE B S T R AE K T N AH S
ABSTRACTNESSES	AE B S T R AE K T N AH S IH Z
ABSTRUSENESS	AH B S T R UW S N AH S
ABSTRUSENESSES	AH B S T R UW S N AH S IH Z
ABSURDNESS	AH B S ER D N AH S
ABSURDNESSES	AH B S ER D N AH S IH Z
ABUSIVENESS	AH B Y UW S IH V N AH S
ABUSIVENESSES	AH B Y UW S IH V N AH S IH Z
ACARINE	AE K AH R AY N
ACARINES	AE K AH R AY N Z
ACAULINE	AE K AH L AY N
ACCEPTABLENESS	AE K S EH P T AH B AH L N AH S
ACCEPTABLENESSES	AE K S EH P T AH B AH L N AH S IH Z
ACCEPTINGNESS	AE K S EH P T IH NG N AH S
ACCEPTINGNESSES	AE K S EH P T IH NG N AH S IH Z
ACCESSIBLENESS	AE K S EH S AH B AH L N AH S
ACCESSIBLENESSES	AE K S EH S AH B AH L N AH S IH Z
ACCESSIONED	AE K S EH SH AH N D
ACCIDENTALNESS	AE K S AH D EH N T AH L N AH S
ACCIDENTALNESSES	AE K S AH D EH N T AH L N AH S IH Z
ACCIPITRINE	AE K S IH P AH T R AY N
ACCIPITRINES	AE K S IH P AH T R AY N Z
ACCOMMODATIVENESS	AH K AA M AH D EY T IH V N AH S
ACCOMMODATIVENESSES	AH K AA M AH D EY T IH V N AH S IH Z
ACCOUNTABLENESS	AH K AW N T AH B AH L N AH S
ACCOUNTABLENESSES	AH K AW N T AH B AH L N AH S IH Z
ACCUMULATIVENESS	AH K Y UW M Y AH L EY T IH V N AH S
ACCUMULATIVENESSES	AH K Y UW M Y AH L EY T IH V N AH S IH Z
ACCURATENESS	AE K Y ER AH T N AH S
ACCURATENESSES	AE K Y ER AH T N AH S IH Z
ACCURSEDNESS	AE K AH R S EH D N AH S
ACCURSEDNESSES	AE K AH R S EH D N EH S AH Z
ACCUSTOMEDNESS	AH K AH S T AH M AH D N AH S
ACCUSTOMEDNESSES	AH K AH S T AH M AH D N AH S IH Z
ACETONE	AE S AH T OW N
ACETONES	AE S AH T OW N Z
ACETOPHENETIDIN	AH S EH T AH F AH N EH T AH D AH N
ACETOPHENETIDINS	AH S EH T AH F AH N EH T AH D AH N Z
ACETYLCHOLINE	AH S EH T AH L K OW L IY N
ACETYLCHOLINE(2)	AH S IY T AH L K OW L IY N
ACETYLCHOLINES	AH S AH T IH L CH AH L AY N Z
ACETYLCHOLINESTERASE	AH S AH T AH L CH AH L AH N EH S T AH R EY Z
ACETYLCHOLINESTERASES	AH S AH T AH L CH AH L AH N EH S T AH R EY Z AH Z
ACETYLENE	AH S EH T AH L IY N
ACETYLENES	AH S EH T AH L IY N Z
ACHENE	AH CH IY N
ACHENES	AH CH IY N Z
ACHINESS	AH CH AY N AH S
ACHINESSES	AH CH AY N AH S IH Z
ACIDNESS	AE S AH D N AH S
ACIDNESSES	AE S AH D N AH S IH Z
ACNE	AE K N IY
ACNED	AE K N D
ACNES	AE K N Z
ACQUISITIVENESS	AH K W IH Z AH T IH V N AH S
ACQUISITIVENESSES	AH K W IH Z AH T IH V N AH S IH Z
ACRIDINE	AE K R AH D AY N
ACRIDINES	AE K R AH D AY N Z
ACRIDNESS	AE K R AH D N AH S
ACRIDNESSES	AE K R AH D N AH S IH Z
ACRIFLAVINE	AE K R IH F L AH V AY N
ACRIFLAVINES	AE K R IH F L AH V AY N Z
ACRIMONIOUSNESS	AE K R AH M OW N IY AW Z N AH S
ACRIMONIOUSNESSES	AE K R AH M OW N IY AW Z N EH S AH Z
ACTIVENESS	AE K T IH V N AH S
ACTIVENESSES	AE K T IH V N AH S IH Z
ACUTENESS	AH K Y UW T N AH S
ACUTENESSES	AH K Y UW T N AH S IH Z
ADAMANTINE	AH D AE M AH N T AY N
ADAPTEDNESS	AH D AE P T AH D N AH S
ADAPTEDNESSES	AH D AE P T AH D N AH S IH Z
ADAPTIVENESS	AH D AE P T IH V N AH S
ADAPTIVENESSES	AH D AE P T IH V N AH S IH Z
ADENINE	AE D AH N IY N
ADENINES	AH D IY N AY N Z
ADENOSINE	AH D EH N AH S IY N
ADENOSINES	AH D EH N AH S AY N Z
ADEPTNESS	AE D EH P T N AH S
ADEPTNESSES	AE D EH P T N AH S IH Z
ADEQUATENESS	AE D IH K W AH T N AH S
ADEQUATENESSES	AE D IH K W AH T N AH S IH Z
ADHESIVENESS	AE D HH IY S IH V N AH S
ADHESIVENESSES	AE D HH IY S IH V N AH S IH Z
ADJOINED	AH JH OY N D
ADJOURNED	AH JH ER N D
ADMIRABLENESS	AE D M AH R AH B AH L N AH S
ADMIRABLENESSES	AE D M AH R AH B AH L N AH S IH Z
ADNEXA	AE D N EH K S AH
ADNEXAL	AE D N EH K S AH L
ADORABLENESS	AH D OW R AH B AH L N AH S
ADORABLENESSES	AH D OW R AH B AH L N AH S IH Z
ADORNED	AH D AO R N D
ADORNER	AH D AO R N ER
ADORNERS	AH D AO R N ER Z
ADRENALINE	AH D R EH N AH L AH N
ADRENALINES	AE D R EH N AH L AY N Z
ADRENERGIC	AE D R AH N AH R JH AH K
ADRENERGICALLY	AE D R AH N AH R JH AH K AE L IY
ADROITNESS	AH D R OY T N AH S
ADROITNESSES	AH D R OY T N AH S IH Z
ADULTERINE	AH D AH L T AH R AY N
ADULTNESS	AH D AH L T N AH S
ADULTNESSES	AH D AH L T N AH S IH Z
ADVANTAGEOUSNESS	AE D V AE N T EY JH AH S N AH S
ADVANTAGEOUSNESSES	AE D V AE N T EY JH AH S N AH S IH Z
ADVENTURESOMENESS	AH D V EH N CH ER S AH M N AH S
ADVENTURESOMENESSES	AH D V EH N CH ER S AH M N AH S IH Z
ADVENTUROUSNESS	AH D V EH N CH ER AH S N AH S
ADVENTUROUSNESSES	AH D V EH N CH ER AH S N AH S IH Z
ADVERSARINESS	AE D V AH S EH R IY N AH S
ADVERSARINESSES	AE D V AH S EH R IY N AH S IH Z
ADVERSENESS	AE D V ER S N AH S
ADVERSENESSES	AE D V ER S N AH S IH Z
ADVISABLENESS	AH D V AY Z AH B AH L N AH S
ADVISABLENESSES	AH D V AY Z AH B AH L N AH S IH Z
AEDINE	AH D AY N
AENEOUS	EH N IY AH S
AENEUS	EH N IY AH S
AERODYNE	EH R AH D AY N
AERODYNES	EH R AH D AY N Z
AEROMAGNETIC	EH R AH M AE G N AH T AH K
AEROMEDICINE	AH R AH M EH D AH S AY N
AEROMEDICINES	AH R AH M EH D AH S AY N Z
AEROPLANE	EH R AH P L EY N
AEROPLANES	EH R AH P L EY N Z
AFFECTEDNESS	AH F EH K T AH D N AH S
AFFECTEDNESSES	AH F EH K T AH D N AH S IH Z
AFFECTIONED	AH F EH K SH AH N D
AFFECTLESSNESS	AH F EH K T L AH S N AH S
AFFECTLESSNESSES	AH F EH K T L AH S N AH S IH Z
AFFINE	AH F AY N
AFFINED	AH F AY N D
AFFINELY	AE F AY N L IY
AFFINES	AH F AY N Z
AFOREMENTIONED	AH F AO R M EH N SH AH N D
AFTERBURNER	AE F T ER B ER N ER
AFTERBURNERS	AE F T ER B ER N ER Z
AGAMMAGLOBULINEMIA	AH G AH M AH G L AH B Y UW L AH N IY M IY AH
AGAMMAGLOBULINEMIAS	AH G AH M AH G L AH B Y UW L AH N IY M IY AH Z
AGAMMAGLOBULINEMIC	AH G AH M AE G L AH B Y UW L AH N AH M AH K
AGEDNESS	EY JH AH D N AH S
AGEDNESSES	EY JH AH D N AH S IH Z
AGELESSNESS	EY JH L AH S N AH S
AGELESSNESSES	EY JH L AH S N AH S IH Z
AGENE	AH JH IY N
AGENES	AH JH IY N Z
AGENESES	AH JH IY N Z IH Z
AGENESIA	AE JH AH N IY ZH IY AH
AGENESIAS	AE JH AH N IY S IY AH Z
AGENESIS	AH JH EH N AH S AH S
AGENETIC	AH JH AH N EH T IH K
AGGREGATENESS	AE G R IH G AH T N AH S
AGGREGATENESSES	AE G R IH G AH T N AH S IH Z
AGGRESSIVENESS	AH G R EH S IH V N AH S
AGGRESSIVENESSES	AH G R EH S IH V N AH S IH Z
AGINNER	AH JH IH N ER
AGINNERS	AH JH IH N ER Z
AGLYCONE	EY JH L IY K OW N
AGLYCONES	EY JH L IY K OW N Z
AGONE	AH G AO N
AGONES	AH G AO N Z
AGREEABLENESS	AH G R IY AH B AH L N AH S
AGREEABLENESSES	AH G R IY AH B AH L N AH S IH Z
AGRIBUSINESS	AE G R AH B IH Z N AH S
AGRIBUSINESSES	AE G R AH B Y UW S AH N EH S AH Z
AGRIBUSINESSMAN	AE G R AH B Y UW S AH N EH S M AH N
AGRIBUSINESSMEN	AE G R AH B Y UW S AH N EH S M AH N
AIMLESSNESS	EY M L AH S N AH S
AIMLESSNESSES	EY M L AH S N AH S IH Z
AIRBORNE	EH R B AO R N
AIRINESS	EH R IY N AH S
AIRINESSES	EH R IY N AH S IH Z
AIRLESSNESS	EH R L AH S N AH S
AIRLESSNESSES	EH R L AH S N AH S IH Z
AIRLINE	EH R L AY N
AIRLINER	EH R L AY N ER
AIRLINERS	EH R L AY N ER Z
AIRLINES	EH R L AY N Z
AIRPLANE	EH R P L EY N
AIRPLANES	EH R P L EY N Z
AIRSICKNESS	AH IH R S IH K N AH S
AIRSICKNESSES	AH IH R S IH K N AH S IH Z
AIRTIGHTNESS	AH IH R T AY T N AH S
AIRTIGHTNESSES	AH IH R T AY T N AH S IH Z
AIRWORTHINESS	EH R W ER DH IY N AH S
AIRWORTHINESSES	EH R W ER DH IY N AH S IH Z
AITCHBONE	AH IH CH B OW N
AITCHBONES	AH IH CH B OW N Z
AKENE	AH K IY N
AKENES	AH K IY N Z
ALABASTRINE	AH L AE B AH S T R AY N
ALANE	AH L EY N
ALANINE	AE L AH N AY N
ALANINES	AE L AH N AY N Z
ALCIDINE	AE L S AH D AY N
ALDOSTERONE	AE L D AA S T AH R OW N
ALDOSTERONES	AE L D AA S T AH R OW N Z
ALERTNESS	AH L ER T N AH S
ALERTNESSES	AH L ER T N AH S IH Z
ALEURONE	EY L AH R OW N
ALEURONES	EY L AH R OW N Z
ALEXANDRINE	AE L AH G Z AE N D R IY N
ALEXANDRINES	AE L AH G Z AE N D R IY N Z
ALEXINE	AH L EH K S AY N
ALEXINES	AE L AH K S AY N Z
ALGERINE	AE L JH AH R AY N
ALGERINES	AE L JH AH R AY N Z
ALIENED	EY L IY AH N D
ALIENEE	EY L IY AH N IY
ALIENEES	EY L IY AH N IY Z
ALIENER	EY L IY AH N ER
ALIENERS	EY L IY AH N ER Z
ALIENNESS	EY L IY AH N AH S
ALIENNESSES	EY L IY AH N AH S IH Z
ALIGNED	AH L AY N D
ALIGNER	AH L AY N ER
ALIGNERS	AH L AY N ER Z
ALIKENESS	AH L AY K N AH S
ALIKENESSES	AH L AY K N AH S IH Z
ALINE	AH L AY N
ALINED	AH L AY N D
ALINEMENT	AH L AY N M AH N T
ALINEMENTS	AH L AY N M AH N T S
ALINER	AH L AY N ER
ALINERS	AH L AY N ER Z
ALINES	AH L AY N Z
ALIVENESS	AH L IH V N AH S
ALIVENESSES	AH L IH V N AH S IH Z
ALKALINE	AE L K AH L AY N
ALKANE	AE L K EY N
ALKANES	AE L K EY N Z
ALKANET	AE L K AH N AH T
ALKANETS	AE L K AH N AH T S
ALKENE	AE L K IY N
ALKENES	AE L K IY N Z
ALKINE	AE L K AY N
ALKINES	AE L K AY N Z
ALKYNE	AE L K AY N
ALKYNES	AE L K AY N Z
ALLEGORICALNESS	AH L EH JH ER IH K AH L N AH S
ALLEGORICALNESSES	AH L EH JH ER IH K AH L N AH S IH Z
ALLOGENEIC	AE L AH JH IY N IY AH K
ALLOPHANE	AE L AH F EY N
ALLOPHANES	AE L AH F EY N Z
ALLOPHONE	AE L AH F OW N
ALLOPHONES	AE L AH F OW N Z
ALLUSIVENESS	AH L UW S IH V N AH S
ALLUSIVENESSES	AH L UW S IH V N AH S IH Z
ALMANDINE	AE L M AH N D AY N
ALMANDINES	AE L M AH N D AY N Z
ALMIGHTINESS	AO L M AY T IY N AH S
ALMIGHTINESSES	AO L M AY T IY N AH S IH Z
ALMNER	AE L M AH R
ALMNERS	AE L M N AH R Z
ALMONER	AA L M AH N ER
ALMONERS	AE L M AH N AH R Z
ALONE	AH L OW N
ALONENESS	AH L OW N AH S
ALONENESSES	AH L OW N AH S IH Z
ALOOFNESS	AH L UW F N AH S
ALOOFNESSES	AH L UW F N AH S IH Z
ALPINE	AE L P AY N
ALPINELY	AE L P AY N L IY
ALPINES	AE L P AY N Z
ALTERNATIVENESS	AO L T ER N AH T IH V N AH S
ALTERNATIVENESSES	AO L T ER N AH T IH V N AH S IH Z
ALUMINE	AH L UW M AH N
ALUMINES	AH L UW M AH N Z
ALVINE	AE L V AY N
AMANDINE	AH M AE N D AY N
AMANTADINE	AH M AE N T AH D AY N
AMANTADINES	AH M AE N T AH D AY N Z
AMARANTHINE	AH M AE R AH N TH AY N
AMATEURISHNESS	AE M AH T ER IH SH N AH S
AMATEURISHNESSES	AE M AH T ER IH SH N AH S IH Z
AMATIVENESS	AH M EY T IH V N AH S
AMATIVENESSES	AH M EY T IH V N AH S IH Z
AMAZONSTONE	AE M AH Z AA N S T OW N
AMAZONSTONES	AE M AH Z AA N S T OW N Z
AMBIGUOUSNESS	AE M B IH G Y AH W AH S N AH S
AMBIGUOUSNESSES	AE M B IH G Y AH W AH S N AH S IH Z
AMBITIONED	AE M B IH SH AH N D
AMBITIOUSNESS	AE M B IH SH AH S N AH S
AMBITIOUSNESSES	AE M B IH SH AH S N AH S IH Z
AMBONES	AE M B OW N Z
AMETHYSTINE	AE M AH TH IH S T AH N
AMIABLENESS	EY M IY AH B AH L N AH S
AMIABLENESSES	EY M IY AH B AH L N AH S IH Z
AMICABLENESS	AE M IH K AH B AH L N AH S
AMICABLENESSES	AE M IH K AH B AH L N AH S IH Z
AMIDINE	AE M AH D AY N
AMIDINES	AE M AH D AY N Z
AMIDONE	AE M AH D OW N
AMIDONES	AE M AH D OW N Z
AMINE	AH M AY N
AMINES	AH M AY N Z
AMINOPHYLLINE	AH M AH N AA F AH L AY N
AMINOPHYLLINES	AH M AH N AA F AH L AY N Z
AMINOPYRINE	AH M AH N AA P AH R AY N
AMINOPYRINES	AH M AH N AA P AH R AY N Z
AMITRIPTYLINE	AH M AH T R IH P T AH L AY N
AMITRIPTYLINES	AH M AH T R IH P T AH L AY N Z
AMMINE	AE M AY N
AMMINES	AE M AY N Z
AMNESIA	AE M N IY ZH AH
AMNESIAC	AE M N IY Z IY AE K
AMNESIACS	AE M N IY S IY AH S
AMNESIAS	AE M N IY S IY AH Z
AMNESIC	AE M Z AH K
AMNESICS	AE M N AH Z AH S Z
AMNESTIC	AE M AH S T AH K
AMNESTIED	AE M N EH S T AY D
AMNESTIES	AE M N AH S T IY Z
AMNESTY	AE M N AH S T IY
AMNESTYING	AE M N EH S T AY AH NG
AMOROUSNESS	AE M AH R AH S N AH S
AMOROUSNESSES	AE M AH R AH S N AH S IH Z
AMORPHOUSNESS	AH M AO R F AH S N AH S
AMORPHOUSNESSES	AH M AO R F AH S N AH S IH Z
AMPHETAMINE	AE M F EH T AH M IY N
AMPHETAMINES	AE M F EH T AH M IY N Z
AMPHIBIOUSNESS	AE M F IH B IY AH S N AH S
AMPHIBIOUSNESSES	AE M F IH B IY AH S N AH S IH Z
AMPLENESS	AE M P AH L N AH S
AMPLENESSES	AE M P AH L N AH S IH Z
AMPLIDYNE	AE M P L AH D AY N
AMPLIDYNES	AE M P L AH D AY N Z
AMUSINGNESS	AH M Y UW Z IH NG N AH S
AMUSINGNESSES	AH M Y UW Z IH NG N AH S IH Z
AMYLENE	AE M AH L IY N
AMYLENES	AE M AH L IY N Z
ANAGENESES	AH N AE JH AH N IY Z AH Z
ANAGENESIS	AE N AH JH IY N AH S AH S
ANALOGOUSNESS	AH N AE L AH G AH S N AH S
ANALOGOUSNESSES	AH N AE L AH G AH S N AH S IH Z
ANAMNESES	AE N AH M N IY Z AH Z
ANAMNESIS	AH N AE M AH S AH S
ANAMNESTIC	AH N AE M AH S T AH K
ANCIENTNESS	EY N SH AH N T N AH S
ANCIENTNESSES	EY N SH AH N T N AH S IH Z
ANCONE	AE NG K OW N
ANCONEAL	AE NG K OW N IY AH L
ANCONES	AE NG K OW N Z
ANDROGENESES	AE N D R AA JH AH N IY Z AH Z
ANDROGENESIS	AE N D R AH JH IY N AH S AH S
ANDROGENETIC	AE N D R AA JH AH N AH T AH K
ANDROGYNE	AE N D R AH JH AY N
ANDROGYNES	AE N D R AH JH AY N Z
ANDROSTERONE	AE N D R AA S T AH R OW N
ANDROSTERONES	AE N D R AA S T AH R OW N Z
ANE	EY N
ANE(2)	AE N
ANEAR	AH N IH ER
ANEARED	AH N IH ER D
ANEARING	AH N IH ER IH NG
ANEARS	AH N IH ER Z
ANECDOTA	AH N EH K D AH T AH
ANECDOTAGE	AE N IH K D OW T IH JH
ANECDOTAGES	AE N IH K D OW T IH JH IH Z
ANECDOTAL	AE N IH K D OW T AH L
ANECDOTALISM	AE N IH K D OW T AH L IH Z AH M
ANECDOTALISMS	AE N IH K D OW T AH L IH Z AH M Z
ANECDOTALIST	AE N IH K D OW T AH L IH S T
ANECDOTALISTS	AE N IH K D OW T AH L IH S T S
ANECDOTALLY	AE N IH K D OW T AH L IY
ANECDOTE	AE N IH K D OW T
ANECDOTES	AE N IH K D OW T S
ANECDOTIC	AE N IH K D OW T IH K
ANECDOTICAL	AE N IH K D OW T IH K AH L
ANECDOTICALLY	AE N IH K D OW T IH K AH L IY
ANECDOTIST	AE N IH K D OW T IH S T
ANECDOTISTS	AE N IH K D OW T IH S T S
ANECHOIC	AE N AH CH OW AH K
ANELASTIC	AE N AH L AH S T AH K
ANELASTICITIES	AE N AH L AE S T IH S AH T AY Z
ANELASTICITY	AE N AH L AE S T IH S AH T IY
ANELE	EY N IY L
ANELED	AH N IY L D
ANELES	AH N IY L Z
ANELING	AH N IY L AH NG
ANEMIA	AH N IY M IY AH
ANEMIAS	AH N IY M IY AH Z
ANEMIC	AH N IY M IH K
ANEMICALLY	AH N IY M IH K AH L IY
ANEMOGRAPH	AE N AH M AA G R AH F
ANEMOGRAPHS	AE N AH M AA G R AH F S
ANEMOMETER	AE N AH M AA M AH T ER
ANEMOMETERS	AE N AH M AA M AH T AH R Z
ANEMOMETRIES	AE N AH M AH M EH T R AY Z
ANEMOMETRY	AE N AH M AH M EH T R IY
ANEMONE	AE N IH M OW N
ANEMONE(2)	AH N EH M AH N IY
ANEMONES	AE N AH M OW N Z
ANEMOPHILOUS	AH N EH M AH F AY L AH S
ANEMOSES	AE N AH M OW Z AH Z
ANEMOSIS	AE N AH M OW S AH S
ANENCEPHALIC	AE N EH N S EH F AE L IH K
ANENCEPHALIC(2)	AE N IH N S EH F AH L IH K
ANENCEPHALIES	AH N EH N S EH F AH L AY Z
ANENCEPHALY	AE N IH N S EH F AH L IY
ANENST	AE N AH N S T
ANENT	EY N AH N T
ANERGIA	AH N AH R JH IY AH
ANERGIAS	AH N AH R JH IY AH Z
ANERGIC	AE N AH R JH AH K
ANERGIES	AH N AH R JH AY Z
ANERGY	AH N AH R JH IY
ANEROID	AE N AH R OY D
ANEROIDS	AE N AH R OY D Z
ANES	EY N Z
ANESTHESIA	AE N IH S TH IY ZH IY AH
ANESTHESIAS	AE N AH S TH IY S IY AH Z
ANESTHESIOLOGIES	AH N AH S TH AH S IY AA L AH JH AY Z
ANESTHESIOLOGIST	AE N AH S TH IY Z IY AA L AH JH IH S T
ANESTHESIOLOGISTS	AE N AH S TH IY Z IY AA L AH JH IH S T S
ANESTHESIOLOGISTS(2)	AE N AH S TH IY Z IY AA L AH JH IH S
ANESTHESIOLOGY	AE N AH S TH IY Z IY AA L AH JH IY
ANESTHETIC	AE N AH S TH EH T IH K
ANESTHETICALLY	AE N AH S TH EH T IH K AH L IY
ANESTHETICS	AE N AH S TH EH T IH K S
ANESTHETIST	AH N EH S TH EH T IH S T
ANESTHETISTS	AH N EH S TH AH T AH S T S
ANESTHETIZE	AH N EH S TH AH T AY Z
ANESTHETIZED	AH N EH S TH AH T AY Z D
ANESTHETIZES	AH N EH S TH AH T AY Z IH Z
ANESTHETIZING	AH N EH S TH AH T AY Z IH NG
ANESTRI	AH N EH S T R IY
ANESTROUS	AH N EH S T R AH S
ANESTRUS	AH N EH S T R AH S
ANESTRUSES	AH N EH S T R UW Z IH Z
ANETHOL	AE N AH TH AH L
ANETHOLE	AH N EH T HH OW L
ANETHOLES	AH N EH T HH OW L Z
ANETHOLS	AE N AH TH AH L Z
ANEUPLOID	EY N Y UW P L OY D
ANEUPLOIDIES	EY N Y UW P L OY D AY Z
ANEUPLOIDS	EY N Y UW P L OY D Z
ANEUPLOIDY	EY N Y UW P L OY D IY
ANEURIN	EY N Y UW R AH N
ANEURINS	EY N Y UW R AH N Z
ANEURISM	AE N Y UH R IH Z AH M
ANEURISM(2)	AE N Y UH R IH Z M
ANEURISMS	EY N Y UW R AH Z AH M Z
ANEURYSM	EY N Y UW R AH Z AH M
ANEURYSMAL	EY N Y AH R IH Z M AH L
ANEURYSMS	EY N Y UW R AH Z AH M Z
ANEW	AH N UW
ANEW(2)	AH N Y UW
ANGIOGENESES	AE N JH IY AA JH AH N IY Z AH Z
ANGIOGENESIS	AE N JH IY OW JH EH N IH S AH S
ANGLOPHONE	AE N G L AH F OW N
ANGRINESS	AE NG G R IY N AH S
ANGRINESSES	AE NG G R IY N AH S IH Z
ANGUINE	AE N G W AY N
ANILINE	AE N AH L IY N
ANILINES	AE N AH L AH N Z
ANIMATENESS	AE N AH M AH T N AH S
ANIMATENESSES	AE N AH M AH T N AH S IH Z
ANKLEBONE	AE NG K AH L B OW N
ANKLEBONES	AE NG K AH L B OW N Z
ANNEAL	AH N IY L
ANNEALED	AE N IY L D
ANNEALER	AE N IY L AH R
ANNEALERS	AE N IY L AH R Z
ANNEALING	AH N IY L IH NG
ANNEALS	AE N IY L Z
ANNELID	AE N AH L IH D
ANNELIDAN	AE N EH L AH D AH N
ANNELIDANS	AE N EH L AH D AH N Z
ANNELIDS	AE N AH L IH D Z
ANNEX	AE N EH K S
ANNEX(2)	AH N EH K S
ANNEXATION	AE N EH K S EY SH AH N
ANNEXATIONAL	AH N EH K S EY SH AH N AH L
ANNEXATIONIST	AH N EH K S EY SH AH N IH S T
ANNEXATIONISTS	AH N EH K S EY SH AH N IH S T S
ANNEXATIONS	AH N EH K S EY SH AH N Z
ANNEXE	AE N AH K S
ANNEXED	AE N EH K S T
ANNEXED(2)	AH N EH K S T
ANNEXES	AE N EH K S IH Z
ANNEXING	AH N EH K S IH NG
ANODYNE	AE N AH D AY N
ANODYNES	AE N AH D AY N Z
ANOMALOUSNESS	AH N AA M AH L AH S N AH S
ANOMALOUSNESSES	AH N AA M AH L AH S N AH S IH Z
ANONYMOUSNESS	AH N AA N AH M AH S N AH S
ANONYMOUSNESSES	AH N AA N AH M AH S N AH S IH Z
ANOPHELINE	AH N AA F AH L AY N
ANOPHELINES	AH N AA F AH L AY N Z
ANSERINE	AE N S AH R AY N
ANSERINES	AE N S AH R AY N Z
ANTHRACENE	AE N TH R AH S IY N
ANTHRACENES	AE N TH R AH S IY N Z
ANTHRAQUINONE	AE N TH R AE K W AH N OW N
ANTHRAQUINONES	AE N TH R AE K W AH N OW N Z
ANTIANEMIA	AE N T AY AH N IY M IY AH
ANTIBUSINESS	AE N T AY B IH Z N AH S
ANTICHOLINERGIC	AE N T AH CH AA L AH N AH R JH AH K
ANTICHOLINERGICS	AE N T AH CH AA L AH N AH R JH AH S Z
ANTICHOLINESTERASE	AE N T AY K OW L AH N EH S T AH R EY Z
ANTICHOLINESTERASES	AE N T AY K OW L AH N EH S T AH R EY Z IH Z
ANTICLINE	AE N T IH K L AY N
ANTICLINES	AE N T IH K L AY N Z
ANTICYCLONE	AE N T IY S AY K L OW N
ANTICYCLONES	AE N T IY S AY K L OW N Z
ANTIFEMININE	AE N T AY F EH M AH N AH N
ANTIFERROMAGNET	AE N T AY F EH R OW M AE G N AH T
ANTIFERROMAGNETIC	AE N T AY F EH R OW M AE G N EH T IH K
ANTIFERROMAGNETICALLY	AE N T AY F EH R OW M AE G N EH T IH K AH L IY
ANTIFERROMAGNETISM	AE N T AY F EH R OW M AE G N AH T IH Z AH M
ANTIFERROMAGNETISMS	AE N T AY F EH R OW M AE G N AH T IH Z AH M Z
ANTIFERROMAGNETS	AE N T AY F EH R OW M AE G N AH T S
ANTIFOREIGNER	AE N T AY F AO R AH N ER
ANTIGENE	AE N T AY JH IY N
ANTIGENES	AE N T AY JH IY N Z
ANTIHEROINE	AE N T AY HH EH R AH W AH N
ANTIHEROINES	AE N T AY HH EH R AH W AH N Z
ANTIHISTAMINE	AE N T IY HH IH S T AH M AH N
ANTIHISTAMINES	AE N T IY HH IH S T AH M AH N Z
ANTIMAGNETIC	AE N T AY M AE G N EH T IH K
ANTINEOPLASTIC	AE N T AY N IY OW P L AE S T IH K
ANTINEPOTISM	AE N T AH N EH P AH T IH Z AH M
ANTINEPOTISMS	AE N T AH N EH P AH T AH Z AH M Z
ANTINEUTRINO	AE N T AY N Y UW T R AH N OW
ANTINEUTRINOS	AE N T AY N Y UW T R AH N AH Z
ANTINEUTRON	AE N T AY N UW T R AA N
ANTINEUTRONS	AE N T AY N UW T R AA N Z
ANTIPERSONNEL	AE N T AY P ER S AH N EH L
ANTIPYRINE	AE N T AH P AH R AY N
ANTIPYRINES	AE N T AH P AH R AY N Z
ANTISUBMARINE	AE N T IH S AH B M ER IY N
ANTISUBMARINE(2)	AE N T AY S AH B M ER IY N
ANTIUNEMPLOYMENT	AE N T AY AH N IH M P L OY M AH N T
ANXIOUSNESS	AE NG K SH AH S N AH S
ANXIOUSNESSES	AE NG K SH AH S N AH S IH Z
ANYONE	EH N IY W AH N
APARTNESS	AH P AA R T N AH S
APARTNESSES	AH P AA R T N AH S IH Z
APISHNESS	EY P IH SH N AH S
APISHNESSES	EY P IH SH N AH S IH Z
APNEA	AE P N IY AH
APNEAL	AE P N IY AH L
APNEAS	AE P N IY Z
APNEIC	AE P N IY AH K
APOCRINE	AE P AH K R AY N
APOCRYPHALNESS	AH P AA K R AH F AH L N AH S
APOCRYPHALNESSES	AH P AA K R AH F AH L N AH S IH Z
APOLUNE	AE P AH L UW N
APOLUNES	AE P AH L UW N Z
APOMORPHINE	AH P AA M AH R F AY N
APOMORPHINES	AH P AA M AH R F AY N Z
APONEUROSES	AH P OW N Y AH R OW Z AH Z
APONEUROSIS	AE P AH N IY Y AH R OW S AH S
APONEUROTIC	AE P OW N Y UW R AH T AH K
APPARENTNESS	AH P AE R AH N T N AH S
APPARENTNESSES	AH P AE R AH N T N AH S IH Z
APPERTAINED	AE P AH R T EY N D
APPORTIONED	AH P AO R SH AH N D
APPOSITENESS	AE P AH S AY T N AH S
APPOSITENESSES	AE P AH S IH T AH N EH S AH Z
APPRECIATIVENESS	AH P R IY SH IY EY T IH V N AH S
APPRECIATIVENESSES	AH P R IY SH IY EY T IH V N AH S IH Z
APPREHENSIVENESS	AE P R IH HH EH N S IH V N AH S
APPREHENSIVENESSES	AE P R IH HH EH N S IH V N AH S IH Z
APPROPRIATENESS	AH P R OW P R IY AH T N AH S
APPROPRIATENESSES	AH P R OW P R IY AH T N AH S IH Z
APRONED	EY P R AH N D
APTNESS	AE P T N AH S
APTNESSES	AE P T N AH S IH Z
AQUAMARINE	AA K W AH M ER IY N
AQUAMARINES	AE K W AH M AH R IY N Z
AQUAPLANE	AE K W AH P L EY N
AQUAPLANED	AE K W AH P L EY N D
AQUAPLANER	AE K W AH P L EY N ER
AQUAPLANERS	AE K W AH P L EY N ER Z
AQUAPLANES	AE K W AH P L EY N Z
AQUATONE	AE K W AH T OW N
AQUATONES	AE K W AH T OW N Z
AQUILINE	AE K W AH L AY N
ARANEID	AE R AH N IY D
ARANEIDS	AE R AH N IY D Z
ARBITRARINESS	AA R B AH T R EH R IY N AH S
ARBITRARINESSES	AA R B AH T R EH R IY N AH S IH Z
ARCANE	AA R K EY N
ARCCOSINE	AA R K OW S AY N
ARCCOSINES	AA R K OW S AY N Z
ARCHENEMIES	AA R CH EH N AH M IY Z
ARCHENEMY	AA R CH EH N AH M IY
ARCHINE	AA R K AY N
ARCHINES	AA R K AY N Z
ARCHNESS	AA R CH N AH S
ARCHNESSES	AA R CH N AH S IH Z
ARCSINE	AA R K S AY N
ARCSINES	AA R K S AY N Z
ARDUOUSNESS	AA R JH AH W AH S N AH S
ARDUOUSNESSES	AA R JH AH W AH S N AH S IH Z
ARECOLINE	AH R IY K OW L AY N
ARECOLINES	AH R IY K OW L AY N Z
ARGENTINE	AA R JH AH N T IY N
ARGENTINES	AA R JH AH N T IY N Z
ARGININE	AA R JH AH N AY N
ARGININES	AA R JH AH N AY N Z
ARIDNESS	AE R AH D N AH S
ARIDNESSES	AE R AH D N AH S IH Z
ARRAIGNED	ER EY N D
ARSINE	AA R S IY N
ARSINES	AA R S IY N Z
ARSPHENAMINE	AA R S EH N AH M AY N
ARSPHENAMINES	AA R S EH N AH M AY N Z
ARTFULNESS	AA R T F AH L N AH S
ARTFULNESSES	AA R T F AH L N AH S IH Z
ARTICULATENESS	AA R T IH K Y AH L AH T N AH S
ARTICULATENESSES	AA R T IH K Y AH L AH T N AH S IH Z
ARTIFICIALNESS	AA R T AH F IH SH AH L N AH S
ARTIFICIALNESSES	AA R T AH F IH SH AH L N AH S IH Z
ARTINESS	AA R T IY N AH S
ARTINESSES	AA R T IY N AH S IH Z
ARTLESSNESS	AA R T L AH S N AH S
ARTLESSNESSES	AA R T L AH S N AH S IH Z
ASCERTAINED	AE S ER T EY N D
ASHINESS	AH SH AY N AH S
ASHINESSES	AH SH AY N AH S IH Z
ASININE	AE S AH N AY N
ASININELY	AE S AH N AY N L IY
ASKEWNESS	AH S K Y UW N AH S
ASKEWNESSES	AH S K Y UW N AH S IH Z
ASPARAGINE	AE S AE R AH JH AY N
ASPARAGINES	AE S AE R AH JH AY N Z
ASSAULTIVENESS	AH S AO L T IH V N AH S
ASSAULTIVENESSES	AH S AO L T IH V N AH S IH Z
ASSERTIVENESS	AH S ER T IH V N AH S
ASSERTIVENESSES	AH S ER T IH V N AH S IH Z
ASSIDUOUSNESS	AE S IH D Y UW AW Z N AH S
ASSIDUOUSNESSES	AE S IH D Y UW AW Z N EH S AH Z
ASSIGNED	AH S AY N D
ASSIGNEE	AH S AY N IY
ASSIGNEES	AH S AY N IY Z
ASSIGNER	AH S AY N ER
ASSIGNERS	AH S AY N ER Z
ASSUREDNESS	AH SH UW R AH D N AH S
ASSUREDNESSES	AH SH UW R AH D N AH S IH Z
ASTATINE	AE S T AH T AY N
ASTATINES	AE S T AH T AY N Z
ASTUTENESS	AH S T UW T N AH S
ASTUTENESSES	AH S T UW T N AH S IH Z
ATHENEUM	AE TH AH N UW M
ATHENEUMS	AH TH IY N IY AH M Z
ATHEROGENESES	AH TH AH R AA JH AH N IY Z AH Z
ATHEROGENESIS	AE TH AH R AH JH IY N AH S AH S
ATONE	AH T OW N
ATONED	AH T OW N D
ATONEMENT	AH T OW N M AH N T
ATONEMENTS	AH T OW N M AH N T S
ATONER	AH T OW N ER
ATONERS	AH T OW N ER Z
ATONES	AH T OW N Z
ATRABILIOUSNESS	AE T R AH B IH L IY AW Z N AH S
ATRABILIOUSNESSES	AE T R AH B IH L IY AW Z N EH S AH Z
ATRAZINE	AE T R AH Z AY N
ATRAZINES	AE T R AH Z AY N Z
ATROCIOUSNESS	AH T R OW SH AH S N AH S
ATROCIOUSNESSES	AH T R OW SH AH S N AH S IH Z
ATROPINE	AE T R AH P AY N
ATROPINES	AE T R AH P AY N Z
ATTAINED	AH T EY N D
ATTAINER	AH T EY N ER
ATTAINERS	AH T EY N ER Z
ATTENTIVENESS	AH T EH N T IH V N AH S
ATTENTIVENESSES	AH T EH N T IH V N AH S IH Z
ATTORNED	AE T AH R N D
ATTORNEY	AH T ER N IY
ATTORNEYS	AH T ER N IY Z
ATTORNEYSHIP	AH T ER N IY SH IH P
ATTORNEYSHIPS	AH T ER N IY SH IH P S
ATTRACTIVENESS	AH T R AE K T IH V N AH S
ATTRACTIVENESSES	AH T R AE K T IH V N AH S IH Z
ATTUNE	AH T UW N
ATTUNED	AH T UW N D
ATTUNEMENT	AH T UW N M AH N T
ATTUNEMENTS	AH T UW N M AH N T S
ATTUNES	AH T UW N Z
AUBERGINE	AO B AH R JH AY N
AUBERGINES	AO B AH R JH AY N Z
AUCTIONED	AO K SH AH N D
AUCTIONEER	AA K SH AH N IH R
AUCTIONEERS	AO K SH AH N IH R Z
AUDACIOUSNESS	AO D AH S IY AH S N AH S
AUDACIOUSNESSES	AO D AH S IY AH S N AH S IH Z
AUDITIONED	AO D IH SH AH N D
AUGUSTNESS	AO G AH S T N AH S
AUGUSTNESSES	AO G AH S T N AH S IH Z
AUSPICIOUSNESS	AO S P IH SH AH S N AH S
AUSPICIOUSNESSES	AO S P IH SH AH S N AH S IH Z
AUSTERENESS	AO S T IH ER N AH S
AUSTERENESSES	AO S T IH ER N AH S IH Z
AUSTRALOPITHECINE	AO S T R EY L OW P IH TH AH S AY N
AUSTRALOPITHECINES	AO S T R AH L AH P IH TH AH S AY N Z
AUTHORITATIVENESS	AH TH AO R AH T EY T IH V N AH S
AUTHORITATIVENESSES	AH TH AO R AH T EY T IH V N AH S IH Z
AUTOBAHNEN	AH T AA B AH N AH N
AUTOCHTHONES	AO T AH CH TH OW N Z
AUTODYNE	AO T AH D AY N
AUTODYNES	AO T AH D AY N Z
AUTOIMMUNE	AO T OY M Y UW N
AVAILABLENESS	AH V EY L AH B AH L N AH S
AVAILABLENESSES	AH V EY L AH B AH L N AH S IH Z
AVARICIOUSNESS	AE V AH R IH SH AH S N AH S
AVARICIOUSNESSES	AE V AH R IH SH AH S N AH S IH Z
AVELLANE	AE V AH L EY N
AVENTURINE	AH V EH N T Y UH R AH N
AVENTURINES	AH V EH N T Y UH R AH N Z
AVERAGENESS	AE V R IH JH N AH S
AVERAGENESSES	AE V R IH JH N AH S IH Z
AVERSENESS	AH V ER S N AH S
AVERSENESSES	AH V ER S N AH S IH Z
AVERSIVENESS	AH V ER S IH V N AH S
AVERSIVENESSES	AH V ER S IH V N AH S IH Z
AVIDNESS	AE V AH D N AH S
AVIDNESSES	AE V AH D N AH S IH Z
AWAKENED	AH W EY K AH N D
AWAKENER	AH W EY K AH N ER
AWAKENERS	AH W EY K AH N ER Z
AWARENESS	AH W EH R N AH S
AWARENESSES	AH W EH R N AH S IH Z
AWAYNESS	AH W EY N AH S
AWAYNESSES	AH W EY N AH S IH Z
AWESOMENESS	AO S AH M N AH S
AWESOMENESSES	AO S AH M N AH S IH Z
AWFULNESS	AO F AH L N AH S
AWFULNESSES	AO F AH L N AH S IH Z
AWKWARDNESS	AO K W ER D N AH S
AWKWARDNESSES	AO K W ER D N AH S IH Z
AWNED	AO N D
AXONE	AE K S OW N
AXONEMAL	AE K S AA N AH M AH L
AXONEME	AE K S AH N IY M
AXONEMES	AE K S AH N IY M Z
AXONES	AE K S OW N Z
AZATHIOPRINE	AH Z AE TH IY AH P R AY N
AZATHIOPRINES	AH Z AE TH IY AH P R AY N Z
AZIDOTHYMIDINE	AH Z IH D AH TH AY M AH D IY N
AZIDOTHYMIDINE(2)	AH Z IH D AH TH AY M AH D AY N
AZIDOTHYMIDINE(3)	EY Z AY D AH TH AY M AH D IY N
AZIDOTHYMIDINE(4)	EY Z AY D AH TH AY M AH D AY N
AZIDOTHYMIDINES	AH Z AH D AH TH IH M AH D AY N Z
AZINE	AH Z AY N
AZINES	AH Z AY N Z
BACKBONE	B AE K B OW N
BACKBONES	B AE K B OW N Z
BACKWARDNESS	B AE K W ER D N AH S
BACKWARDNESSES	B AE K W ER D N AH S IH Z
BACULINE	B AE K Y AH L AY N
BADNESS	B AE D N AH S
BADNESSES	B AE D N AH S IH Z
BAGGINESS	B AE G IY N AH S
BAGGINESSES	B AE G IY N AH S IH Z
BALDNESS	B AO L D N AH S
BALDNESSES	B AO L D N AH S IH Z
BALEFULNESS	B EY L F AH L N AH S
BALEFULNESSES	B EY L F AH L N AH S IH Z
BALKINESS	B AO K IY N AH S
BALKINESSES	B AO K IY N AH S IH Z
BALKLINE	B AO K L AY N
BALKLINES	B AO K L AY N Z
BALLETOMANE	B AE L EH T AH M EY N
BALLETOMANES	B AE L EH T AH M EY N Z
BALLONET	B AE L AH N AH T
BALLONETS	B AE L AH N AH T S
BALLONNE	B AE L AH N
BALLONNES	B AE L AH N Z
BALLOONED	B AH L UW N D
BALMINESS	B AA M IY N AH S
BALMINESSES	B AA M IY N AH S IH Z
BALNEAL	B AE L N IY AH L
BALNEOLOGIES	B IY AH L N IY OW L AA G IY Z
BALNEOLOGY	B IY AH L N IY OW L AA G IY
BALONEY	B AH L OW N IY
BALONEYS	B AE L AH N EY Z
BANE	B EY N
BANEBERRIES	B EY N B EH R IY Z
BANEBERRY	B EY N B EH R IY
BANED	B EY N D
BANEFUL	B EY N F AH L
BANEFULLY	B EY N F AH L IY
BANES	B EY N Z
BANNED	B AE N D
BANNER	B AE N ER
BANNERED	B AE N ER D
BANNERET	B AE N AH R AH T
BANNERETS	B AE N AH R AH T S
BANNERETTE	B AE N ER EH T
BANNERETTES	B AE N ER EH T S
BANNERING	B AE N ER IH NG
BANNEROL	B AE N AH R AH L
BANNEROLS	B AE N AH R AH L Z
BANNERS	B AE N ER Z
BANNET	B AE N EH T
BANNETS	B AE N EH T S
BARBAROUSNESS	B AA R B AH R AH S N AH S
BARBAROUSNESSES	B AA R B AH R AH S N AH S IH Z
BARBITONE	B AA R B AY T OW N
BARBITONES	B AA R B AY T OW N Z
BAREFACEDNESS	B EH R F EY S AH D N AH S
BAREFACEDNESSES	B EH R F EY S AH D N AH S IH Z
BARENESS	B EH R N AH S
BARENESSES	B EH R N AH S IH Z
BARGAINED	B AA R G AH N D
BARGAINER	B AA R G IH N ER
BARGAINERS	B AA R G IH N ER Z
BARITONE	B EH R AH T OW N
BARITONES	B EH R AH T OW N Z
BARKENTINE	B AA R K EH N T AY N
BARKENTINES	B AA R K EH N T AY N Z
BARONESS	B EH R AH N IH S
BARONESSES	B AE R AH N AH S IH Z
BARONET	B EH R AH N AH T
BARONET(2)	B EH R AH N EH T
BARONETAGE	B AH R AA N AH T AH JH
BARONETAGES	B AE R AH N EH T AH JH AH Z
BARONETCIES	B AE R AH N EH T S AY Z
BARONETCY	B AE R AH N EH T S IY
BARONETS	B EH R AH N AH T S
BARONETS(2)	B EH R AH N EH T S
BARONNE	B AE R AH N
BARONNES	B AE R AH N Z
BARQUENTINE	B AA R K W AH N T AY N
BARQUENTINES	B AA R K W AH N T AY N Z
BARRENER	B AE R AH N ER
BARRENEST	B AE R AH N AH S T
BARRENNESS	B AE R AH N AH S
BARRENNESSES	B AE R AH N AH S IH Z
BARYTONE	B IY EH R IY T OW N
BARYTONES	B IY EH R IY T OW N Z
BASELINE	B EY S L AY N
BASELINER	B EY S L AY N ER
BASELINERS	B EY S L AY N ER Z
BASELINES	B EY S L AY N Z
BASENESS	B EY S N AH S
BASENESSES	B EY S N AH S IH Z
BASHFULNESS	B AE SH F AH L N AH S
BASHFULNESSES	B AE SH F AH L N AH S IH Z
BASINED	B EY S AH N D
BASINET	B AE S AH N AH T
BASINETS	B AE S AH N AH T S
BASSINET	B AE S AH N EH T
BASSINETS	B AE S AH N EH T S
BASSNESS	B EY S N AH S
BASSNESSES	B EY S N AH S IH Z
BASTIONED	B AE S CH AH N D
BATTENED	B AE T AH N D
BATTENER	B AE T AH N ER
BATTENERS	B AE T AH N ER Z
BATTINESS	B AE T IY N AH S
BATTINESSES	B AE T IY N AH S IH Z
BAWDINESS	B AO D IY N AH S
BAWDINESSES	B AO D IY N AH S IH Z
BAYONET	B EY AH N EH T
BAYONETED	B EY AH N AH T IH D
BAYONETING	B EY AH N AH T IH NG
BAYONETS	B EY AH N EH T S
BAYONETTED	B EY AH N AH T IH D
BAYONETTING	B EY AH N AH T IH NG
BEACONED	B IY K AH N D
BEANED	B IY N D
BEANERIES	B IY N AH R IY Z
BEANERY	B IY N AH R IY
BEARDEDNESS	B IH ER D AH D N AH S
BEARDEDNESSES	B IH ER D AH D N AH S IH Z
BEARISHNESS	B EH R IH SH N AH S
BEARISHNESSES	B AE ER IH SH N AH S IH Z
BEASTLINESS	B IY S T L IY N AH S
BEASTLINESSES	B IY S T L IY N AH S IH Z
BEAUTEOUSNESS	B Y UW T IY AH S N AH S
BEAUTEOUSNESSES	B Y UW T IY AH S N AH S IH Z
BEAUTIFULNESS	B Y UW T IY F AH L N AH S
BEAUTIFULNESSES	B Y UW T IY F AH L N AH S IH Z
BECKONED	B EH K AH N D
BECKONER	B EH K AH N ER
BECKONERS	B EH K AH N ER Z
BECLOWNED	B IH K L AW N D
BEDAMNED	B IH D AE M D
BEDARKENED	B IH D AA R K AH N D
BEDEAFENED	B IH D EH F AH N D
BEDIZENED	B EH D AY Z AH N D
BEELINE	B IY L AY N
BEELINED	B IY L AY N D
BEELINES	B IY L AY N Z
BEGGARLINESS	B EH G ER L IY N AH S
BEGGARLINESSES	B EH G ER L IY N AH S IH Z
BEGINNER	B IH G IH N ER
BEGINNERS	B IH G IH N ER Z
BEGONE	B IH G AO N
BEGROANED	B IH G R OW N D
BEGUINE	B AH G UW N
BEGUINES	B AH G UW N Z
BEIGNET	B AH IH G N AH T
BEIGNETS	B AH IH G N AH T S
BELATEDNESS	B IH L EY T AH D N AH S
BELATEDNESSES	B IH L EY T AH D N AH S IH Z
BELONGINGNESS	B IH L AO NG IH NG N AH S
BELONGINGNESSES	B IH L AO NG IH NG N AH S IH Z
BELTLINE	B EH L T L AY N
BELTLINES	B EH L T L AY N Z
BEMADDENED	B IH M AE D AH N D
BEMEANED	B IH M IY N D
BEMOANED	B IH M OW N D
BENE	B EH N AH
BENEATH	B IH N IY TH
BENEDICK	B EH N AH D IH K
BENEDICKS	B AH N EH D AH K S
BENEDICT	B EH N AH D IH K T
BENEDICTION	B EH N AH D IH K SH AH N
BENEDICTIONS	B EH N AH D IH K SH AH N Z
BENEDICTORY	B EH N AH D IH K T ER IY
BENEDICTS	B AH N EH D AH K T S
BENEFACTION	B AH N AH F AE K AH N
BENEFACTIONS	B AH N AH F AE K T IY AH N Z
BENEFACTOR	B EH N AH F AE K T ER
BENEFACTORS	B EH N AH F AE K T ER Z
BENEFACTRESS	B AH N AH F AE K T R AH S
BENEFACTRESSES	B AH N AH F AE K T R EH S AH Z
BENEFIC	B AH N IY F AH K
BENEFICE	B AH N IY F AH S
BENEFICED	B AH N IY F AH S T
BENEFICENCE	B AH N EH F AH S AH N S
BENEFICENCES	B AH N EH F AH S AH N S IH Z
BENEFICENT	B EH N AH F IH SH AH N T
BENEFICENTLY	B AH N EH F AH S EH N T L IY
BENEFICES	B AH N IY F AH S
BENEFICIAL	B EH N AH F IH SH AH L
BENEFICIALLY	B EH N AH F IH SH AH L IY
BENEFICIALNESS	B EH N AH F IH SH AH L N AH S
BENEFICIALNESSES	B EH N AH F IH SH AH L N AH S IH Z
BENEFICIARIES	B EH N AH F IH SH IY EH R IY Z
BENEFICIARY	B EH N AH F IH SH IY EH R IY
BENEFICIATE	B AH N AH F IH S AY EY T
BENEFICIATED	B AH N AH F IH S AY EY T AH D
BENEFICIATES	B AH N AH F IH S AY EY T S
BENEFICIATING	B AH N AH F IH S AY EY T AH NG
BENEFICIATION	B AH N AH F IH S AY EY SH AH N
BENEFICIATIONS	B AH N EH F AH S IY EY T IY AH N Z
BENEFICING	B AH N AH F IH S AH NG
BENEFIT	B EH N AH F IH T
BENEFITED	B EH N AH F IH T IH D
BENEFITER	B EH N AH F IH T ER
BENEFITERS	B EH N AH F IH T ER Z
BENEFITING	B EH N AH F IH T IH NG
BENEFITS	B EH N AH F IH T S
BENEFITTED	B EH N AH F IH T IH D
BENEFITTING	B EH N AH F IH T IH NG
BENEMPT	B AH N EH M P T
BENEMPTED	B AH N EH M P T AH D
BENES	B EH N IY S
BENEVOLENCE	B AH N EH V AH L AH N S
BENEVOLENCES	B AH N EH V AH L AH N S IH Z
BENEVOLENT	B AH N EH V AH L AH N T
BENEVOLENTLY	B AH N EH V AH L AH N T L IY
BENEVOLENTNESS	B AH N EH V AH L AH N T N AH S
BENEVOLENTNESSES	B AH N EH V AH L AH N T N AH S IH Z
BENGALINE	B IH N G AH L AY N
BENGALINES	B IH N G AH L AY N Z
BENIGHTEDNESS	B IH N AY T AH D N AH S
BENIGHTEDNESSES	B IH N AY T AH D N AH S IH Z
BENNE	B EH N
BENNES	B EH N Z
BENNET	B EH N IH T
BENNETS	B IY AH N EH T S
BENZANTHRACENE	B IH N Z AE N TH R AH S IY N
BENZANTHRACENES	B IH N Z AE N TH R AH S IY N Z
BENZENE	B EH N Z IY N
BENZENES	B EH N Z IY N Z
BENZIDINE	B IH N Z AH D AY N
BENZIDINES	B IH N Z AH D AY N Z
BENZINE	B EH N Z IY N
BENZINES	B IH N Z AY N Z
BENZOAPYRENE	B IH N Z OW P AH R IY N
BENZOAPYRENES	B IH N Z OW P AH R IY N Z
BENZOCAINE	B IH N Z AH K EY N
BENZOCAINES	B IH N Z AH K EY N Z
BENZODIAZEPINE	B EH N Z OW D IY AE Z AH P IY N
BENZODIAZEPINES	B IH N Z AH D IY AE Z AH P AY N Z
BENZOPHENONE	B IH N Z AA F AH N OW N
BENZOPHENONES	B IH N Z AA F AH N OW N Z
BERBERINE	B IH R B AH R AY N
BERBERINES	B IH R B AH R AY N Z
BERIBBONED	B IH R IH B AH N D
BERLINE	B IY ER L AY N
BERLINES	B IY ER L AY N Z
BERYLINE	B IY AH R IY L AY N
BESCREENED	B IH S K R IY N D
BETAINE	B AH T EY N
BETAINES	B AH T EY N Z
BETHORNED	B IH TH AO R N D
BETOKENED	B IH T OW K AH N D
BETWEENNESS	B IH T W IY N AH S
BETWEENNESSES	B IH T W IY N EH S AH Z
BEWILDEREDNESS	B IH W IH L D ER AH D N AH S
BEWILDEREDNESSES	B IH W IH L D ER AH D N AH S IH Z
BIASNESS	B AY AH S N AH S
BIASNESSES	B AY AH S N AH S IH Z
BIBULOUSNESS	B AY B Y AH L AW Z N AH S
BIBULOUSNESSES	B AY B Y AH L AW Z N EH S AH Z
BICOMPONENT	B AY K AH M P OW N AH N T
BICORNE	B AY K AH R N IY
BICORNES	B AY K AO R N Z
BIGENERIC	B AY JH EH N ER IH K
BIGHEARTEDNESS	B IH G HH AA R T AH D N AH S
BIGHEARTEDNESSES	B IH G HH AA R T AH D N AH S IH Z
BIGNESS	B IH G N AH S
BIGNESSES	B IH G N AH S IH Z
BILDUNGSROMANE	B AY L D AH N G S R AH M EY N
BILINEAR	B AY L IH N IY ER
BILIOUSNESS	B AY L AY AH S N AH S
BILIOUSNESSES	B AY L AY AH S N AH S IH Z
BINDINGNESS	B AY N D IH NG N AH S
BINDINGNESSES	B AY N D IH NG N AH S IH Z
BINE	B AY N IY
BINES	B AY N Z
BINNED	B IH N D
BIOENERGETIC	B AY OW AH N AH R JH AH T AH K
BIOENERGETICS	B AY OW AH N AH R JH AH T AH S Z
BIOENGINEER	B AY OW EH N JH AH N IH R
BIOENGINEERED	B AY OW EH N JH AH N IH R D
BIOENGINEERING	B AY OW EH N JH AH N IH R IH NG
BIOENGINEERINGS	B AY OW AH N JH IH N AH R AH NG Z
BIOENGINEERS	B AY OW EH N JH AH N AH R Z
BIOGENESES	B AY AA JH AH N IY Z AH Z
BIOGENESIS	B AY AH JH IY N AH S AH S
BIOGENETIC	B AY AA JH AH N AH T AH K
BIOGENETICALLY	B AY AH JH AH N EH T AH K AE L IY
BIOLUMINESCENCE	B AY AH L AH M AH N EH S AH N S
BIOLUMINESCENCES	B AY AH L AH M AH N AH S EH N S AH Z
BIOLUMINESCENT	B AY AH L AH M AH N EH S AH N T
BIOMEDICINE	B AY AH M EH D AH S AY N
BIOMEDICINES	B AY AH M EH D AH S AY N Z
BIPLANE	B AY P L EY N
BIPLANES	B AY P L EY N Z
BIRDBRAINED	B ER D B R EY N D
BIRTHSTONE	B ER TH S T OW N
BIRTHSTONES	B ER TH S T OW N Z
BISONTINE	B AY S AH N T AY N
BITCHINESS	B IH CH IY N AH S
BITCHINESSES	B IH CH IY N AH S IH Z
BITTERNESS	B IH T ER N AH S
BITTERNESSES	B IH T ER N AH S IH Z
BITTERSWEETNESS	B IH T ER S W IY T N AH S
BITTERSWEETNESSES	B IH T ER S W IY T N AH S IH Z
BIUNIQUENESS	B AY Y UH N IY K N AH S
BIUNIQUENESSES	B AY Y UH N IY K N AH S IH Z
BIZARRENESS	B AH Z AA R N AH S
BIZARRENESSES	B AH Z AA R N AH S IH Z
BIZONE	B AY Z OW N
BIZONES	B AY Z OW N Z
BLACKENED	B L AE K AH N D
BLACKENER	B L AE K AH N ER
BLACKENERS	B L AE K AH N ER Z
BLACKNESS	B L AE K N AH S
BLACKNESSES	B L AE K N AH S IH Z
BLAMELESSNESS	B L EY M L AH S N AH S
BLAMELESSNESSES	B L EY M L AH S N AH S IH Z
BLAMEWORTHINESS	B L EY M W ER DH IY N AH S
BLAMEWORTHINESSES	B L EY M W ER DH IY N AH S IH Z
BLANDNESS	B L AE N D N AH S
BLANDNESSES	B L AE N D N AH S IH Z
BLANKNESS	B L AE NG K N AH S
BLANKNESSES	B L AE NG K N AH S IH Z
BLARNEY	B L AA R N IY
BLARNEYED	B L AA R N EY D
BLARNEYING	B L AA R N EY AH NG
BLARNEYS	B L AA R N EY Z
BLASPHEMOUSNESS	B L AE S F AH M AH S N AH S
BLASPHEMOUSNESSES	B L AE S F AH M AH S N AH S IH Z
BLAZONED	B L EY Z AH N D
BLAZONER	B L EY Z AH N ER
BLAZONERS	B L EY Z AH N ER Z
BLEAKNESS	B L IY K N AH S
BLEAKNESSES	B L IY K N AH S IH Z
BLEARINESS	B L IH ER IY N AH S
BLEARINESSES	B L IH ER IY N AH S IH Z
BLESSEDNESS	B L EH S AH D N AH S
BLESSEDNESSES	B L EH S AH D N AH S IH Z
BLIMPISHNESS	B L IH M P IH SH N AH S
BLIMPISHNESSES	B L IH M P IH SH N AH S IH Z
BLINDNESS	B L AY N D N AH S
BLINDNESSES	B L AY N D N AH S IH Z
BLISSFULNESS	B L IH S F AH L N AH S
BLISSFULNESSES	B L IH S F AH L N AH S IH Z
BLOODGUILTINESS	B L AH D G IH L T IY N AH S
BLOODGUILTINESSES	B L AH D G IH L T IY N AH S IH Z
BLOODINESS	B L AH D IY N AH S
BLOODINESSES	B L AH D IY N AH S IH Z
BLOODLESSNESS	B L AH D L AH S N AH S
BLOODLESSNESSES	B L AH D L AH S N AH S IH Z
BLOODLINE	B L AH D L AY N
BLOODLINES	B L AH D L AY N Z
BLOODSTAINED	B L AH D S T EY N D
BLOODSTONE	B L AH D S T OW N
BLOODSTONES	B L AH D S T OW N Z
BLOODTHIRSTINESS	B L AH D TH ER S T IY N AH S
BLOODTHIRSTINESSES	B L AH D TH ER S T IY N AH S IH Z
BLUDGEONED	B L AH JH AH N D
BLUEBONNET	B L UW B AA N AH T
BLUEBONNETS	B L UW B AA N AH T S
BLUELINE	B L UW L AY N
BLUELINES	B L UW L AY N Z
BLUENESS	B L UW N AH S
BLUENESSES	B L UW N AH S IH Z
BLUESTONE	B L UW S T OW N
BLUESTONES	B L UW S T OW N Z
BLUFFNESS	B L AH F N AH S
BLUFFNESSES	B L AH F N AH S IH Z
BLUISHNESS	B L UW IH SH N AH S
BLUISHNESSES	B L UW IH SH N AH S IH Z
BLUNTNESS	B L AH N T N AH S
BLUNTNESSES	B L AH N T N AH S IH Z
BLURRINESS	B L ER IY N AH S
BLURRINESSES	B L ER IY N AH S IH Z
BOASTFULNESS	B OW S T F AH L N AH S
BOASTFULNESSES	B OW S T F AH L N AH S IH Z
BOBBINET	B AA B AY N EH T
BOBBINETS	B AA B AY N EH T S
BOISTEROUSNESS	B OY S T AH R AH S N AH S
BOISTEROUSNESSES	B OY S T AH R AH S N AH S IH Z
BOLDNESS	B OW L D N AH S
BOLDNESSES	B OW L D N AH S IH Z
BOLONEY	B AH L OW N IY
BOLONEYS	B AA L AH N EY Z
BOMBAZINE	B AA M B AH Z AY N
BOMBAZINES	B AA M B AH Z AY N Z
BONDSTONE	B AA N D S T OW N
BONDSTONES	B AA N D S T OW N Z
BONE	B OW N
BONED	B OW N D
BONEFISH	B OW N F IH SH
BONEFISHES	B OW N F IH SH IH Z
BONEFISHING	B OW N F IH SH IH NG
BONEFISHINGS	B OW N F IH SH IH NG Z
BONEHEAD	B OW N HH EH D
BONEHEADED	B OW N HH EH D IH D
BONEHEADEDNESS	B OW N HH EH D AH D N AH S
BONEHEADEDNESSES	B OW N HH EH D AH D N AH S IH Z
BONEHEADS	B OW N HH EH D Z
BONELESS	B OW N L AH S
BONEMEAL	B OW N M IY L
BONEMEALS	B OW N M IY L Z
BONER	B OW N ER
BONERS	B OW N ER Z
BONES	B OW N Z
BONESET	B OW N S EH T
BONESETS	B OW N S EH T S
BONESETTER	B OW N S EH T ER
BONESETTERS	B OW N S EH T ER Z
BONEY	B OW N IY
BONEYARD	B OW N Y AA R D
BONEYARDS	B OW N Y AA R D Z
BONINESS	B OW N IY N AH S
BONINESSES	B OW N IY N AH S IH Z
BONNE	B AA N
BONNES	B AO N Z
BONNET	B AA N AH T
BONNETED	B AA N AH T IH D
BONNETING	B AA N AH T IH NG
BONNETS	B AA N AH T S
BOOKISHNESS	B UH K IH SH N AH S
BOOKISHNESSES	B UH K IH SH N AH S IH Z
BOORISHNESS	B UH R IH SH N AH S
BOORISHNESSES	B UH R IH SH N AH S IH Z
BOOTLESSNESS	B UW T L AH S N AH S
BOOTLESSNESSES	B UW T L AH S N AH S IH Z
BORANE	B AH R EY N
BORANES	B AH R EY N Z
BORDERLINE	B AO R D ER L AY N
BORDERLINES	B AO R D ER L AY N Z
BORINGNESS	B AO R IH NG N AH S
BORINGNESSES	B AO R IH NG N AH S IH Z
BORNE	B AO R N
BORNEOL	B AO R N IY AH L
BORNEOLS	B AO R N IY AH L Z
BOSSINESS	B AO S IY N AH S
BOSSINESSES	B AO S IY N AH S IH Z
BOTONEE	B AA T AH N IY IY
BOTONNEE	B AA T AH N IY IY
BOTTLENECK	B AA T AH L N EH K
BOTTLENECKED	B AA T AH L N EH K T
BOTTLENECKING	B AA T AH L N EH K IH NG
BOTTLENECKS	B AA T AH L N EH K S
BOTTOMLESSNESS	B AA T AH M L AH S N AH S
BOTTOMLESSNESSES	B AA T AH M L AH S N AH S IH Z
BOUNDEDNESS	B AW N D AH D N AH S
BOUNDEDNESSES	B AW N D AH D N AH S IH Z
BOUNDLESSNESS	B AW N D L AH S N AH S
BOUNDLESSNESSES	B AW N D L AH S N AH S IH Z
BOUNTEOUSNESS	B AW N T IY AW Z N AH S
BOUNTEOUSNESSES	B AW N T IY AW Z N EH S AH Z
BOUNTIFULNESS	B AW N T IY F AH L N AH S
BOUNTIFULNESSES	B AW N T IY F AH L N AH S IH Z
BOURGEONED	B AH R JH IY OW N D
BOURGUIGNONNE	B AH R G UW G N AH N
BOURNE	B AO R N
BOURNES	B AH R N Z
BOVINE	B OW V AY N
BOVINELY	B OW V AY N L IY
BOVINES	B OW V AY N Z
BOWLINE	B OW L AY N
BOWLINES	B AW L AY N Z
BOXINESS	B AA K S IY N AH S
BOXINESSES	B AA K S IY N AH S IH Z
BOYISHNESS	B OY IH SH N AH S
BOYISHNESSES	B OY IH SH N AH S IH Z
BRACKISHNESS	B R AE K IH SH N AH S
BRACKISHNESSES	B R AE K IH SH N AH S IH Z
BRAINED	B R EY N D
BRAININESS	B R EY N IY N AH S
BRAININESSES	B R EY N IY N AH S IH Z
BRAINLESSNESS	B R EY N L AH S N AH S
BRAINLESSNESSES	B R EY N L AH S N AH S IH Z
BRANCHLINE	B R AE N CH L AY N
BRANCHLINES	B R AE N CH L AY N Z
BRANNED	B R AE N D
BRANNER	B R AE N ER
BRANNERS	B R AE N ER Z
BRASHNESS	B R AE SH N AH S
BRASHNESSES	B R AE SH N AH S IH Z
BRASSINESS	B R AE S IY N AH S
BRASSINESSES	B R AE S IY N AH S IH Z
BRATTINESS	B R AE T AH N AH S
BRATTINESSES	B R AE T AH N EH S AH Z
BRAWNINESS	B R AO N AH N AH S
BRAWNINESSES	B R AO N AH N EH S AH Z
BRAZENED	B R EY Z AH N D
BRAZENNESS	B R EY Z AH N AH S
BRAZENNESSES	B R EY Z AH N AH S IH Z
BREADLINE	B R EH D L AY N
BREADLINES	B R EH D L AY N Z
BREADWINNER	B R EH D W IH N ER
BREADWINNERS	B R EH D W IH N ER Z
BREAKNECK	B R EY K N EH K
BREASTBONE	B R EH S T B OW N
BREASTBONES	B R EH S T B OW N Z
BREATHINESS	B R EH TH IY N AH S
BREATHINESSES	B R EH TH IY N AH S IH Z
BREATHLESSNESS	B R EH TH L AH S N AH S
BREATHLESSNESSES	B R EH TH L AH S N AH S IH Z
BREEZINESS	B R IY Z IY N AH S
BREEZINESSES	B R IY Z IY N AH S IH Z
BRIEFNESS	B R IY F N AH S
BRIEFNESSES	B R IY F N AH S IH Z
BRIGANDINE	B R IH G AH N D AY N
BRIGANDINES	B R IH G AH N D AY N Z
BRIGANTINE	B R IH G AH N T IY N
BRIGANTINES	B R IH G AH N T IY N Z
BRIGHTENED	B R AY T AH N D
BRIGHTENER	B R AY T AH N ER
BRIGHTENERS	B R AY T AH N ER Z
BRIGHTNESS	B R AY T N AH S
BRIGHTNESSES	B R AY T N AH S IH Z
BRILLIANTINE	B R IH L IY AH N T AY N
BRILLIANTINES	B R IH L IY AH N T AY N Z
BRIMSTONE	B R IH M S T OW N
BRIMSTONES	B R IH M S T OW N Z
BRINE	B R AY N
BRINED	B R AY N D
BRINER	B R AY N ER
BRINERS	B R IH N AH R Z
BRINES	B R AY N Z
BRININESS	B R IH N AH N AH S
BRININESSES	B R IH N AH N EH S AH Z
BRISKNESS	B R IH S K N AH S
BRISKNESSES	B R IH S K N AH S IH Z
BRITTLENESS	B R IH T AH L N AH S
BRITTLENESSES	B R IH T AH L N AH S IH Z
BROADENED	B R AO D AH N D
BROADNESS	B R AO D N AH S
BROADNESSES	B R AO D N AH S IH Z
BROKENNESS	B R OW K AH N AH S
BROKENNESSES	B R OW K AH N AH S IH Z
BROMINE	B R OW M IY N
BROMINES	B R AH M AY N Z
BROMOCRIPTINE	B R AH M AA K R AH P T AY N
BROMOCRIPTINES	B R AH M AA K R AH P T AY N Z
BRONCHOPNEUMONIA	B R AO NG K AA P N Y AH M OW N Y AH
BRONCHOPNEUMONIAS	B R AO NG K AA P N Y AH M OW N Y AH Z
BROODINESS	B R UW D IY N AH S
BROODINESSES	B R UW D IY N AH S IH Z
BROTHERLINESS	B R AH DH ER L IY N AH S
BROTHERLINESSES	B R AH DH ER L IY N AH S IH Z
BROWNED	B R AW N D
BROWNER	B R AW N ER
BROWNEST	B R AW N IH S T
BROWNSTONE	B R AW N S T OW N
BROWNSTONES	B R AW N S T OW N Z
BRUCINE	B R UW S AY N
BRUCINES	B R UW S AY N Z
BRUNET	B R UW N EH T
BRUNETS	B R UW N AH T S
BRUNETTE	B R UW N EH T
BRUNETTES	B R UW N EH T S
BRUSQUENESS	B R AH S K N AH S
BRUSQUENESSES	B R AH S K N AH S IH Z
BRUTISHNESS	B R UW T IH SH N AH S
BRUTISHNESSES	B R UW T IH SH N AH S IH Z
BUBALINE	B Y UW B AH L AY N
BUCCANEER	B AH K AH N IY R
BUCCANEERED	B AH K EY N AH R D
BUCCANEERING	B AH K EY N AH R AH NG
BUCCANEERISH	B AH K EY N AH R AH SH
BUCCANEERS	B AH K AH N IY R Z
BUCKMINSTERFULLERENE	B AH K M AH N S T AH R F UH L AH R IY N
BUCKMINSTERFULLERENES	B AH K M AH N S T AH R F UH L AH R IY N Z
BUCKSKINNED	B AH K S K IH N D
BUFFOONERIES	B AH F UW N AH R IY Z
BUFFOONERY	B AH F UW N AH R IY
BUGBANE	B AH G B EY N
BUGBANES	B AH G B EY N Z
BUHRSTONE	B AH R S T OW N
BUHRSTONES	B AH R S T OW N Z
BULKINESS	B AH L K IY N AH S
BULKINESSES	B AH L K IY N AH S IH Z
BULLETINED	B UH L AH T AH N D
BULLHEADEDNESS	B UH L HH EH D AH D N AH S
BULLHEADEDNESSES	B UH L HH EH D AH D N AH S IH Z
BULLISHNESS	B UH L IH SH N AH S
BULLISHNESSES	B UH L IH SH N AH S IH Z
BULLNECK	B UH L N EH K
BULLNECKED	B UH L N EH K T
BULLNECKS	B UH L N EH K S
BUMPINESS	B AH M P IY N AH S
BUMPINESSES	B AH M P IY N AH S IH Z
BUMPTIOUSNESS	B AH M P SH AH S N AH S
BUMPTIOUSNESSES	B AH M P SH AH S N AH S IH Z
BUNTLINE	B AH N T L AY N
BUNTLINES	B AH N T L AY N Z
BURDENED	B ER D AH N D
BURDENER	B ER D AH N ER
BURDENERS	B ER D AH N ER Z
BURGEONED	B ER JH AH N D
BURGONET	B AH R G AH N AH T
BURGONETS	B AH R G AH N AH T S
BURLINESS	B ER L IY N AH S
BURLINESSES	B ER L IY N AH S IH Z
BURNED	B ER N D
BURNER	B ER N ER
BURNERS	B ER N ER Z
BURNET	B ER N IH T
BURNETS	B ER N EH T S
BURRSTONE	B ER S T OW N
BURRSTONES	B ER S T OW N Z
BURSTONE	B AH R S T OW N
BURSTONES	B AH R S T OW N Z
BURTHENED	B AH R TH IY N D
BUSHINESS	B UH SH IY N AH S
BUSHINESSES	B UH SH IY N AH S IH Z
BUSINESS	B IH Z N AH S
BUSINESS(2)	B IH Z N IH S
BUSINESSES	B IH Z N AH S AH Z
BUSINESSES(2)	B IH Z N IH S IH Z
BUSINESSLIKE	B IH Z N IH S L AY K
BUSINESSMAN	B IH Z N AH S M AE N
BUSINESSMAN(2)	B IH Z N IH S M AE N
BUSINESSMEN	B IH Z N IH S M EH N
BUSINESSPEOPLE	B IH Z N AH S P IY P AH L
BUSINESSPERSON	B IH Z N AH S P ER S AH N
BUSINESSPERSONS	B IH Z N AH S P ER S AH N Z
BUSINESSWOMAN	B IH Z N IH S W UH M AH N
BUSINESSWOMEN	B IH Z N AH S W OW M AH N
BUSKINED	B AH S K IH N D
BUSTLINE	B AH S T L AY N
BUSTLINES	B AH S T L AY N Z
BUSYNESS	B IH Z IY N AH S
BUSYNESSES	B IH Z IY N AH S IH Z
BUTADIENE	B Y UW T AH D IY N
BUTADIENES	B Y UW T AH D IY N Z
BUTANE	B Y UW T EY N
BUTANES	B Y UW T EY N Z
BUTANONE	B Y UW T AH N OW N
BUTANONES	B Y UW T AH N OW N Z
BUTENE	B Y UW T IY N
BUTENES	B Y UW T IY N Z
BUTTONED	B AH T AH N D
BUTTONER	B AH T AH N ER
BUTTONERS	B AH T AH N ER Z
BUTYLENE	B Y UW T AH L IY N
BUTYLENES	B Y UW T AH L IY N Z
BUTYROPHENONE	B Y UW T AH R AA F AH N OW N
BUTYROPHENONES	B Y UW T AH R AA F AH N OW N Z
BUXOMNESS	B AH K S AH M N AH S
BUXOMNESSES	B AH K S AH M N AH S IH Z
BYGONE	B AY G AO N
BYGONES	B AY G AO N Z
BYLINE	B AY L AY N
BYLINED	B AY L AY N D
BYLINER	B AY L AY N ER
BYLINERS	B AY L AY N ER Z
BYLINES	B AY L IY N Z
BYZANTINE	B IH Z AH N T AY N
BYZANTINE(2)	B IH Z AH N T IY N
CABERNET	K AE B ER N EY
CABERNETS	K AE B ER N EH T S
CABERNETS(2)	K AE B ER N EY Z
CABEZONE	K AE B AH Z OW N
CABEZONES	K AE B AH Z OW N Z
CABINED	K AE B AH N D
CABINET	K AE B AH N AH T
CABINET(2)	K AE B N AH T
CABINETMAKER	K AE B N AH T M EY K ER
CABINETMAKERS	K AE B N AH T M EY K ER Z
CABINETMAKING	K AE B N AH T M EY K IH NG
CABINETMAKINGS	K AE B N AH T M EY K IH NG Z
CABINETRIES	K AE B N AH T R IY Z
CABINETRY	K AE B N AH T R IY
CABINETS	K AE B AH N AH T S
CABINETS(2)	K AE B N AH T S
CABINETWORK	K AE B N AH T W ER K
CABINETWORKS	K AE B N AH T W ER K S
CADAVERINE	K AH D AE V AH R AY N
CADAVERINES	K AH D AE V AH R AY N Z
CADDISHNESS	K EY D IH SH N AH S
CADDISHNESSES	K EY D IH SH N AH S IH Z
CAFFEINE	K AE F IY N
CAFFEINES	K AE F IY N Z
CAGEYNESS	K EY JH IY N AH S
CAGEYNESSES	K EY JH IY N AH S IH Z
CAGINESS	K EY JH IY N AH S
CAGINESSES	K EY JH IY N AH S IH Z
CAIRNED	K AE ER N D
CAJONES	K AH JH OW N Z
CALAMINE	K AE L AH M AY N
CALAMINED	K AE L AH M AY N D
CALAMINES	K AE L AH M AY N Z
CALCANEA	K AE L K EY N IY AH
CALCANEAL	K AE L K EY N IY AH L
CALCANEI	K AE L K AH N IY
CALCANEUM	K AE L K EY N IY AH M
CALCANEUS	K AE L K EY N IY AH S
CALCIMINE	K AE L S AH M AY N
CALCIMINED	K AE L S AH M AY N D
CALCIMINES	K AE L S AH M AY N Z
CALCINE	K AE L S AY N
CALCINED	K AE L S AY N D
CALCINES	K AE L S AY N Z
CALCULATEDNESS	K AE L K Y AH L AH T AH D N AH S
CALCULATEDNESSES	K AE L K Y AH L AH T AH D N AH S IH Z
CALLOUSNESS	K AE L AH S N AH S
CALLOUSNESSES	K AE L AH S N AH S IH Z
CALLOWNESS	K AO L OW N AH S
CALLOWNESSES	K AO L OW N AH S IH Z
CALMNESS	K AA M N AH S
CALMNESS(2)	K AA L M N AH S
CALMNESSES	K AA M N AH S IH Z
CALYCINE	K AE L AH S AY N
CALZONE	K AE L Z OW N
CALZONES	K AE L Z OW N Z
CAMPAGNE	K AE M P AH N
CAMPAIGNED	K AE M P EY N D
CAMPAIGNER	K AE M P EY N ER
CAMPAIGNERS	K AE M P EY N ER Z
CAMPHENE	K AE M F IY N
CAMPHENES	K AE M F IY N Z
CAMPHINE	K AE M F AY N
CAMPHINES	K AE M F AY N Z
CAMPINESS	K AE M P IY N AH S
CAMPINESSES	K AE M P IY N AH S IH Z
CANDIDNESS	K AE N D AH D N AH S
CANDIDNESSES	K AE N D AH D N AH S IH Z
CANE	K EY N
CANEBRAKE	K EY N B R EY K
CANEBRAKES	K EY N B R EY K S
CANED	K EY N D
CANELLA	K AH N EH L AH
CANELLAS	K AH N EH L AH Z
CANEPHOR	K AE N AH F AH R
CANEPHORS	K AE N AH F AH R Z
CANER	K EY N ER
CANERS	K EY N ER Z
CANES	K EY N Z
CANESCENT	K EY N S EH N T
CANEWARE	K EY N W EH R
CANEWARES	K EY N W EH R Z
CANINE	K EY N AY N
CANINES	K EY N AY N Z
CANNED	K AE N D
CANNEL	K AE N AH L
CANNELLONI	K AE N EH L AH N IY
CANNELON	K AE N AH L AH N
CANNELONS	K AE N AH L AH N Z
CANNELS	K AE N AH L Z
CANNER	K AE N ER
CANNERIES	K AE N ER IY Z
CANNERS	K AE N ER Z
CANNERY	K AE N ER IY
CANNINESS	K AE N IY N AH S
CANNINESSES	K AE N IY N AH S IH Z
CANNONED	K AE N AH N D
CANNONEER	K AE N AH N IH R
CANNONEERS	K AE N AH N IH R Z
CANONESS	K AE N AH N AH S
CANONESSES	K AE N AH N AH S IH Z
CANOROUSNESS	K EY N ER AH S N AH S
CANOROUSNESSES	K EY N ER AH S N AH S IH Z
CANTANKEROUSNESS	K AE N T AE NG K ER AH S N AH S
CANTANKEROUSNESSES	K AE N T AE NG K ER AH S N AH S IH Z
CANTONED	K AE N T AH N D
CANZONE	K AE N Z OW N
CANZONES	K AE N Z OW N Z
CANZONET	K AE N Z AH N AH T
CANZONETS	K AE N Z AH N AH T S
CAPABLENESS	K EY P AH B AH L N AH S
CAPABLENESSES	K EY P AH B AH L N AH S IH Z
CAPACIOUSNESS	K AH P EY SH AH S N AH S
CAPACIOUSNESSES	K AH P EY SH AH S N AH S IH Z
CAPARISONED	K EY P EH R IY Z AO N D
CAPRICIOUSNESS	K AH P R IH SH AH S N AH S
CAPRICIOUSNESSES	K AH P R IH SH AH S N AH S IH Z
CAPRINE	K AE P R AY N
CAPSTONE	K AE P S T OW N
CAPSTONES	K AE P S T OW N Z
CAPTAINED	K AE P T AH N D
CAPTIONED	K AE P SH AH N D
CAPTIOUSNESS	K AE P SH AH S N AH S
CAPTIOUSNESSES	K AE P SH AH S N AH S IH Z
CARABINE	K AE R AH B AY N
CARABINEER	K AA R AH B IH N IH R
CARABINEERS	K AA R AH B IH N IH R Z
CARABINER	K AA R AH B IH N ER
CARABINERO	K AE R AH B IH N AH R OW
CARABINEROS	K AA R AH B IH N ER AA S
CARABINERS	K AA R AH B IH N ER Z
CARABINES	K AE R AH B AY N Z
CARAVANED	K AE R AH V AE N D
CARAVANER	K AE R AH V AE N ER
CARAVANERS	K AE R AH V AE N ER Z
CARAVANNED	K AE R AH V AE N D
CARAVANNER	K AE R AH V AE N ER
CARAVANNERS	K AE R AH V AE N ER Z
CARBINE	K AA R B AY N
CARBINES	K AA R B AY N Z
CARCANET	K AA R K AH N AH T
CARCANETS	K AA R K AH N AH T S
CARCINOGENESES	K AA R S AH N AA JH AH N IY Z AH Z
CARCINOGENESIS	K AA R S AH N AH JH IY N AH S AH S
CAREENED	K ER IY N D
CAREENER	K AH R IY N ER
CAREENERS	K AH R IY N ER Z
CAREFULNESS	K EH R F AH L N AH S
CAREFULNESSES	K EH R F AH L N AH S IH Z
CARELESSNESS	K EH R L EH S N AH S
CARELESSNESSES	K EH R L AH S N AH S IH Z
CARILLONNED	K AA R IH L AO N D
CARILLONNEUR	K AE R AH L AA N AH R
CARILLONNEURS	K AH R IH L AA N IY Y AH R Z
CARLINE	K AA R L AY N
CARLINES	K AA R L AY N Z
CARMINE	K AA R M AY N
CARMINES	K AA R M AH N Z
CARNELIAN	K AA R N IY L IY AH N
CARNELIANS	K AA R N IY L IY AH N Z
CARNET	K AA R N EH T
CARNETS	K AA R N EH T S
CARNEY	K AA R N IY
CARNEYS	K AA R N IY Z
CARNITINE	K AA R N AH T AY N
CARNITINES	K AA R N AH T AY N Z
CARNIVOROUSNESS	K AA R N IH V ER AH S N AH S
CARNIVOROUSNESSES	K AA R N IH V ER AH S N AH S IH Z
CAROTENE	K EH R AH T IY N
CAROTENES	K EH R AH T IY N Z
CARSICKNESS	K AA R S IH K N AH S
CARSICKNESSES	K AA R S IH K N AH S IH Z
CARTONED	K AA R T AH N D
CARTOONED	K AA R T UW N D
CASERNE	K AE S AH R N
CASERNES	K AE S AH R N Z
CASTANET	K AE S T AH N EH T
CASTANETS	K AE S T AH N EH T S
CASUALNESS	K AE ZH AH W AH L N EH S
CASUALNESSES	K AE ZH AH W AH L N AH S IH Z
CATARRHINE	K EY T ER R AY N
CATARRHINES	K EY T ER R AY N Z
CATECHOLAMINE	K AH T AH K AA L AH M AY N
CATECHOLAMINERGIC	K AE T AH K AH L AE M AH N AH R JH AH K
CATECHOLAMINES	K AH T AH K AA L AH M AY N Z
CATERCORNER	K EY T ER K AO R N ER
CATERCORNERED	K EY T ER K AO R N ER D
CATTINESS	K AE T IY N AH S
CATTINESSES	K AE T IY N AH S IH Z
CAULINE	K AH L AY N
CAUTIONED	K AA SH AH N D
CAUTIONED(2)	K AO SH AH N D
CAUTIOUSNESS	K AO SH AH S N AH S
CAUTIOUSNESSES	K AO SH AH S N AH S IH Z
CAVATINE	K AE V AH T AY N
CAVERNED	K AE V ER N D
CAYENNE	K AY EH N
CAYENNE(2)	K EY EH N
CAYENNED	K EY EH N D
CAYENNES	K EY EH N Z
CEASELESSNESS	S IY S L AH S N AH S
CEASELESSNESSES	S IY S L AH S N AH S IH Z
CELANDINE	S EH L AH N D AY N
CELANDINES	S EH L AH N D AY N Z
CELEBRATEDNESS	S EH L AH B R AH T AH D N AH S
CELEBRATEDNESSES	S EH L AH B R AH T AH D N AH S IH Z
CELLOPHANE	S EH L AH F EY N
CELLOPHANES	S EH L AH F EY N Z
CELLPHONE	S EH L F OW N
CELLPHONES	S EH L F OW N Z
CENSORIOUSNESS	S EH N S ER IY AH S N AH S
CENSORIOUSNESSES	S EH N S ER IY AH S N AH S IH Z
CENTEREDNESS	S EH N T ER AH D N AH S
CENTEREDNESSES	S EH N T ER AH D N AH S IH Z
CENTERLINE	S EH N T ER L AY N
CENTERLINES	S EH N T ER L AY N Z
CENTNER	S EH N T N ER
CENTNERS	S EH N T N AH R Z
CENTONES	S EH N T OW N Z
CEPHALORIDINE	S AH F AH L AO R AH D AY N
CEPHALORIDINES	S AH F AH L AO R AH D AY N Z
CEREMONIOUSNESS	S EH R AH M OW N IY AH S N AH S
CEREMONIOUSNESSES	S EH R AH M OW N IY AH S N AH S IH Z
CERTAINER	S ER T AH N ER
CERTAINEST	S ER T AH N AH S T
CERVINE	S AH R V AY N
CETANE	S AH T EY N
CETANES	S AH T EY N Z
CHACONNE	CH AE K AH N
CHACONNES	CH AE K AH N Z
CHAGRINED	SH AH G R IH N D
CHAGRINNED	SH AH G R IH N D
CHAINE	CH EY N
CHAINED	CH EY N D
CHAINES	CH EY N Z
CHAIRMANED	CH EH ER M EY N D
CHAIRMANNED	CH EH ER M AE N D
CHALONE	CH AH L OW N
CHALONES	CH AH L OW N Z
CHAMPAGNE	SH AE M P EY N
CHAMPAGNES	SH AE M P EY N Z
CHAMPIONED	CH AE M P IY AH N D
CHANCINESS	CH AE N S IY N AH S
CHANCINESSES	CH AE N S IY N AH S IH Z
CHANGEABLENESS	CH EY N JH AH B AH L N AH S
CHANGEABLENESSES	CH EY N JH AH B AH L N AH S IH Z
CHANGEFULNESS	CH EY N JH F AH L N AH S
CHANGEFULNESSES	CH EY N JH F AH L N AH S IH Z
CHANGELESSNESS	CH EY N JH L AH S N AH S
CHANGELESSNESSES	CH EY N JH L AH S N AH S IH Z
CHANNEL	CH AE N AH L
CHANNELED	CH AE N AH L D
CHANNELER	CH AE N AH L ER
CHANNELERS	CH AE N AH L ER Z
CHANNELING	CH AE N AH L IH NG
CHANNELING(2)	CH AE N L IH NG
CHANNELIZATION	CH AE N AH L AH Z EY SH AH N
CHANNELIZATIONS	CH AE N AH L AH Z EY SH AH N Z
CHANNELIZE	CH AE N AH L AY Z
CHANNELIZED	CH AE N AH L AY Z D
CHANNELIZES	CH AE N AH L AY Z IH Z
CHANNELIZING	CH AE N AH L AY Z IH NG
CHANNELLED	CH AE N AH L D
CHANNELLING	CH AE N AH L IH NG
CHANNELS	CH AE N AH L Z
CHAPERONE	SH AE P ER OW N
CHAPERONED	SH AE P AH R OW N D
CHAPERONES	SH AE P ER OW N Z
CHARINESS	CH AA R IY N AH S
CHARINESSES	CH AA R IY N AH S IH Z
CHARITABLENESS	CH AE R AH T AH B AH L N AH S
CHARITABLENESSES	CH AE R AH T AH B AH L N AH S IH Z
CHARNEL	CH AA R N AH L
CHARNELS	CH AA R N AH L Z
CHASTENED	CH EY S AH N D
CHASTENER	CH AE S T IY N AH R
CHASTENERS	CH AE S T AH N AH R Z
CHASTENESS	CH EY S T N AH S
CHASTENESSES	CH AE S T AH N EH S AH Z
CHATELAINE	CH AE T AH L EY N
CHATELAINES	CH AE T AH L EY N Z
CHATTINESS	CH AE T IY N AH S
CHATTINESSES	CH AE T IY N AH S IH Z
CHEAPENED	CH IY P AH N D
CHEAPNESS	CH IY P N AH S
CHEAPNESSES	CH IY P N AH S IH Z
CHEEKBONE	CH IY K B OW N
CHEEKBONES	CH IY K B OW N Z
CHEEKINESS	CH IY K IY N AH S
CHEEKINESSES	CH IY K IY N AH S IH Z
CHEERFULNESS	CH IH R F AH L N AH S
CHEERFULNESSES	CH IH ER F AH L N AH S IH Z
CHEERINESS	CH IH ER IY N AH S
CHEERINESSES	CH IH ER IY N AH S IH Z
CHEERLESSNESS	CH IH ER L AH S N AH S
CHEERLESSNESSES	CH IH ER L AH S N AH S IH Z
CHEESINESS	CH IY Z IY N AH S
CHEESINESSES	CH IY Z IY N AH S IH Z
CHEMILUMINESCENCE	K EH M AH L AH M AH N EH S AH N S
CHEMILUMINESCENCES	K EH M AH L AH M AH N AH S EH N S AH Z
CHEMILUMINESCENT	K EH M AH L AH M AH N EH S AH N T
CHERRYSTONE	CH EH R IY S T OW N
CHERRYSTONES	CH EH R IY S T OW N Z
CHICANE	CH AH K EY N
CHICANED	CH AH K EY N D
CHICANER	CH AH K EY N AH R
CHICANERIES	SH IH K EY N AH R IY Z
CHICANERS	CH IH K AH N AH R Z
CHICANERY	SH IH K EY N ER IY
CHICANES	CH AH K EY N Z
CHICKENED	CH IH K AH N D
CHICNESS	SH IY K N AH S
CHICNESSES	SH IY K N AH S IH Z
CHILDISHNESS	CH AY L D IH SH N AH S
CHILDISHNESSES	CH AY L D IH SH N AH S IH Z
CHILDLESSNESS	CH AY L D L AH S N AH S
CHILDLESSNESSES	CH AY L D L AH S N AH S IH Z
CHILDLIKENESS	CH AY L D L AY K N AH S
CHILDLIKENESSES	CH AY L D L AY K N AH S IH Z
CHILLINESS	CH IH L IY N AH S
CHILLINESSES	CH IH L IY N AH S IH Z
CHILLNESS	CH IH L N AH S
CHILLNESSES	CH IH L N AH S IH Z
CHIMNEY	CH IH M N IY
CHIMNEYLIKE	CH IH M N IY L AY K
CHIMNEYPIECE	CH IH M N IY P IY S
CHIMNEYPIECES	CH IH M N IY P IY S IH Z
CHIMNEYS	CH IH M N IY Z
CHINBONE	CH IH N B OW N
CHINBONES	CH IH N B OW N Z
CHINE	CH AY N
CHINED	CH AY N D
CHINES	CH AY N Z
CHINNED	CH IH N D
CHINONE	CH AH N OW N
CHINONES	CH AH N OW N Z
CHIVALROUSNESS	SH IH V AH L R AH S N AH S
CHIVALROUSNESSES	SH IH V AH L R AH S N AH S IH Z
CHLORACNE	K L AO R AH K N
CHLORACNES	K L AO R AH K N Z
CHLORAMINE	K L AO R AH M AY N
CHLORAMINES	K L AO R AH M AY N Z
CHLORDANE	K L AO R D EY N
CHLORDANES	K L AO R D EY N Z
CHLORINE	K L AO R IY N
CHLORINES	K L OW R IY N Z
CHLOROBENZENE	K L AH R AA B AH N Z IY N
CHLOROBENZENES	K L AH R AA B AH N Z IY N Z
CHLOROFLUOROMETHANE	K L AH R AH F L AH W AH R AA M AH TH EY N
CHLOROFLUOROMETHANES	K L AH R AH F L AH W AH R AA M AH TH EY N Z
CHLOROPRENE	K L AO R AH P R IY N
CHLOROPRENES	K L AO R AH P R IY N Z
CHLOROQUINE	K L AO R AH K W AY N
CHLOROQUINES	K L AO R AH K W AY N Z
CHLORPROMAZINE	K L OW R P R AA M AH Z IY N
CHLORPROMAZINES	K L OW R P R AA M AH Z IY N Z
CHLORTETRACYCLINE	K L OW R T EH T R AH S AY K L IY N
CHLORTETRACYCLINES	K L OW R T EH T R AH S AY K L IY N Z
CHOICENESS	CH OY S N AH S
CHOICENESSES	CH OY S N AH S IH Z
CHOLESTYRAMINE	K OW L EH S T IH R AH M AY N
CHOLESTYRAMINES	CH AH L EH S T IH R AH M AY N Z
CHOLINE	CH AH L AY N
CHOLINERGIC	CH AA L AH N AH R JH AH K
CHOLINERGICALLY	CH AA L AH N AH R JH AH K AE L IY
CHOLINES	CH AH L AY N Z
CHOLINESTERASE	K OW L AH N EH S T AH R EY Z
CHOLINESTERASES	K OW L AH N EH S T AH R EY Z IH Z
CHOPINE	CH AH P AY N
CHOPINES	CH AH P AY N Z
CHOPPINESS	CH AA P IY N AH S
CHOPPINESSES	CH AA P IY N AH S IH Z
CHORINE	CH AH R AY N
CHORINES	CH AH R AY N Z
CHRISTENED	K R IH S AH N D
CHROMONEMA	K R AH M AA N AH M AH
CHROMONEMATA	K R AA M AH N EH M AH T AH
CHROMONEMATIC	K R AH M AA N AH M AH T AH K
CHUBBINESS	CH AH B IY N AH S
CHUBBINESSES	CH AH B IY N AH S IH Z
CHUMMINESS	CH AH M IY N AH S
CHUMMINESSES	CH AH M IY N AH S IH Z
CHURCHLINESS	CH ER CH L IY N AH S
CHURCHLINESSES	CH ER CH L IY N AH S IH Z
CHURLISHNESS	CH AH R L IH SH N AH S
CHURLISHNESSES	CH AH R L IH SH N EH S AH Z
CHURNED	CH ER N D
CHURNER	CH ER N ER
CHURNERS	CH ER N ER Z
CHUTNEE	CH AH T N IY IY
CHUTNEES	CH AH T N IY Z
CHUTNEY	CH AH T N IY
CHUTNEYS	CH AH T N IY Z
CICERONE	S IH S ER OW N
CICERONES	S IH S AH R OW N Z
CIMETIDINE	S AH M EH T AH D AY N
CIMETIDINES	S AH M EH T AH D AY N Z
CINCHONINE	S IH NG K AH N AY N
CINCHONINES	S IH NG K AH N AY N Z
CINE	S AY N
CINEAST	S AH N IY S T
CINEASTE	S AH N IY S T
CINEASTES	S AH N IY S T S
CINEASTS	S AH N IY S T S
CINEMA	S IH N AH M AH
CINEMAGOER	S IH N AH M AH G OW ER
CINEMAGOERS	S IH N AH M AH G OW ER Z
CINEMAS	S IH N AH M AH Z
CINEMATHEQUE	S AH N EH M AH TH AH K
CINEMATHEQUES	S AH N EH M AH TH AH K S
CINEMATIC	S IH N AH M AE T IH K
CINEMATICALLY	S IH N AH M AE T IH K AH L IY
CINEMATIZE	S AH N EH M AH T AY Z
CINEMATIZED	S AH N EH M AH T AY Z D
CINEMATIZES	S AH N EH M AH T AY Z AH Z
CINEMATIZING	S AH N EH M AH T AY Z AH NG
CINEMATOGRAPH	S IH N AH M AH T AA G R AH F
CINEMATOGRAPHER	S IH N IH M AH T AA G R AH F ER
CINEMATOGRAPHERS	S IH N AH M AH T AA G R AH F AH R Z
CINEMATOGRAPHIC	S IH N AH M AH T AA G R AH F AH K
CINEMATOGRAPHICALLY	S AH N EH M AH T AA G R AE F AH K AE L IY
CINEMATOGRAPHIES	S IH N AH M AH T AA G R AH F AY Z
CINEMATOGRAPHS	S IH N AH M AH T AA G R AH F S
CINEMATOGRAPHY	S IH N IH M AH T AA G R AH F IY
CINEOL	S IH N IY AH L
CINEOLE	S IH N IY OW L
CINEOLES	S IH N IY OW L Z
CINEOLS	S IH N IY AH L Z
CINEPLEX	S IH N AH P L EH K S
CINEPLEXES	S AH N EH P L AH K S
CINERARIA	S IH N AH R AE R IY AH
CINERARIAS	S IH N AH R AE R IY AH Z
CINERARIUM	S IH N AH R AE R IY AH M
CINERARY	S IH N AH R EH R IY
CINEREOUS	S AH N IY R IY AH S
CINERIN	S IH N AH R AH N
CINERINS	S IH N AH R AH N Z
CINES	S AY N Z
CINNABARINE	S IH N AE B AH R AY N
CIRCUITOUSNESS	S ER K Y UW AH T AH S N AH S
CIRCUITOUSNESSES	S ER K Y UW AH T AH S N AH S IH Z
CIRCULARNESS	S ER K Y AH L ER N AH S
CIRCULARNESSES	S ER K Y AH L ER N AH S IH Z
CISALPINE	S IH S AH L P AY N
CITIZENESS	S IH T AH Z AH N AH S
CITIZENESSES	S IH T AH Z AH N AH S IH Z
CITRINE	S IH T R IY N
CITRINES	S IH T R AY N Z
CITRONELLA	S IH T R AA N EH L AH
CITRONELLAL	S IH T R AH N EH L AH L
CITRONELLALS	S IH T R AH N EH L AH L Z
CITRONELLAS	S IH T R AH N EH L AH Z
CITRONELLOL	S IH T R AH N EH L AH L
CITRONELLOLS	S IH T R AH N EH L AH L Z
CITRULLINE	S IH T R AH L AY N
CITRULLINES	S IH T R AH L AY N Z
CLADOGENESES	K L AH D AA JH AH N IY Z AH Z
CLADOGENESIS	K L AE D AH JH IY N AH S AH S
CLADOGENETIC	K L AH D AA JH AH N AH T AH K
CLADOGENETICALLY	K L AE D AH JH AH N EH T AH K AE L IY
CLAMMINESS	K L AE M IY N AH S
CLAMMINESSES	K L AE M IY N AH S IH Z
CLAMOROUSNESS	K L AE M ER AH S N AH S
CLAMOROUSNESSES	K L AE M ER AH S N AH S IH Z
CLANDESTINE	K L AE N D EH S T IH N
CLANDESTINELY	K L AE N D EH S T AH N L IY
CLANDESTINENESS	K L AE N D EH S T AH N AH S
CLANDESTINENESSES	K L AE N D EH S T AH N AH S IH Z
CLANNISHNESS	K L AE N IH SH N AH S
CLANNISHNESSES	K L AE N IH SH N AH S IH Z
CLARINET	K L EH R AH N EH T
CLARINETIST	K L EH R AH N EH T IH S T
CLARINETISTS	K L EH R AH N EH T IH S T S
CLARINETS	K L AE R AH N EH T S
CLARINETTIST	K L AE R AH N EH T IH S T
CLARINETTISTS	K L AE R AH N EH T IH S T S
CLARIONED	K L AE R IY AH N D
CLASSINESS	K L AE S IY N AH S
CLASSINESSES	K L AE S IY N AH S IH Z
CLASSLESSNESS	K L AE S L AH S N AH S
CLASSLESSNESSES	K L AE S L AH S N AH S IH Z
CLEANED	K L IY N D
CLEANER	K L IY N ER
CLEANERS	K L IY N ER Z
CLEANEST	K L IY N AH S T
CLEANLINESS	K L EH N L IY N IH S
CLEANLINESSES	K L IY N L IY N AH S IH Z
CLEANNESS	K L IY N IH S
CLEANNESSES	K L IY N AH S IH Z
CLEARHEADEDNESS	K L IH ER HH EH D AH D N AH S
CLEARHEADEDNESSES	K L IH ER HH EH D AH D N AH S IH Z
CLEARNESS	K L IH R N AH S
CLEARNESSES	K L IH ER N AH S IH Z
CLEVERNESS	K L EH V ER N AH S
CLEVERNESSES	K L EH V ER N AH S IH Z
CLINE	K L AY N
CLINES	K L AY N Z
CLINGSTONE	K L IH NG S T OW N
CLINGSTONES	K L IH NG S T OW N Z
CLIQUISHNESS	K L IY K IH SH N AH S
CLIQUISHNESSES	K L IY K IH SH N AH S IH Z
CLODDISHNESS	K L AA D IH SH N AH S
CLODDISHNESSES	K L AA D IH SH N AH S IH Z
CLOISONNE	K L OY S AH N
CLOISONNES	K L OY S AH N Z
CLOMIPHENE	K L AA M AH F IY N
CLOMIPHENES	K L AA M AH F IY N Z
CLONE	K L OW N
CLONED	K L OW N D
CLONER	K L OW N AH R
CLONERS	K L AA N AH R Z
CLONES	K L OW N Z
CLONIDINE	K L AA N IH D IY N
CLONIDINES	K L AA N AH D AY N Z
CLOSENESS	K L OW S N IH S
CLOSENESSES	K L OW Z N AH S IH Z
CLOTHESLINE	K L OW DH Z L AY N
CLOTHESLINED	K L OW DH Z L AY N D
CLOTHESLINES	K L OW DH Z L AY N Z
CLOUDINESS	K L AW D IY N IH S
CLOUDINESSES	K L AW D IY N AH S IH Z
CLOUDLESSNESS	K L AW D L AH S N AH S
CLOUDLESSNESSES	K L AW D L AH S N AH S IH Z
CLOWNED	K L AW N D
CLOWNERIES	K L AW N AH R IY Z
CLOWNERY	K L AW N AH R IY
CLOWNISHNESS	K L AW N IH SH N AH S
CLOWNISHNESSES	K L AW N IH SH N AH S IH Z
CLUBBINESS	K L AH B IY N AH S
CLUBBINESSES	K L AH B IY N AH S IH Z
CLUMSINESS	K L AH M Z IY N AH S
CLUMSINESSES	K L AH M Z IY N AH S IH Z
COANNEX	K OW AH N EH K S
COANNEXED	K OW AH N EH K S T
COANNEXES	K OW AH N EH K S IH Z
COANNEXING	K OW AH N EH K S IH NG
COARSENED	K OW R S AH N D
COARSENESS	K OW R S N AH S
COARSENESSES	K OW R S N AH S IH Z
COASTLINE	K OW S T L AY N
COASTLINES	K OW S T L AY N Z
COBALTINE	K OW B IY AH L T AY N
COBALTINES	K OW B IY AH L T AY N Z
COBBLESTONE	K AA B AH L S T OW N
COBBLESTONED	K AA B AH L S T OW N D
COBBLESTONES	K AA B AH L S T OW N Z
COCAINE	K OW K EY N
COCAINES	K OW K EY N Z
COCAPTAINED	K OW K AE P T AH N D
COCHINEAL	K OW CH AY N AH L
COCHINEALS	K OW CH AY N AH L Z
COCINERA	K OW S IH N AH R AH
COCINERAS	K OW S IH N AH R AH Z
COCKEYEDNESS	K AA K AY AH D N AH S
COCKEYEDNESSES	K AA K AY AH D N AH S IH Z
COCKINESS	K AA K IY N AH S
COCKINESSES	K AA K IY N AH S IH Z
COCKNEY	K AA K N IY
COCKNEYFIED	K AA K N AH F AY D
COCKNEYFIES	K AA K N AH F AY Z
COCKNEYFY	K AA K N EY F IY
COCKNEYFYING	K AA K N EY F AY AH NG
COCKNEYISH	K AA K N EY AH SH
COCKNEYISM	K AA K N EY AH Z AH M
COCKNEYISMS	K AA K N EY AH Z AH M Z
COCKNEYS	K AA K N EY Z
COCKSURENESS	K AA K SH UH R N AH S
COCKSURENESSES	K AA K SH UH R N AH S IH Z
COCOONED	K AH K UW N D
CODEINE	K OW D IY IH N
CODEINES	K OW D IY AY N Z
CODESIGNED	K OW D IH Z AY N D
COERCIVENESS	K OW ER S IH V N AH S
COERCIVENESSES	K OW ER S IH V N AH S IH Z
COETANEOUS	K OW AH T EY N IY AH S
COFFINED	K AO F AH N D
COGENERATION	K OW JH EH N ER EY SH AH N
COGENERATIONS	K OW JH EH N ER EY SH AH N Z
COGENERATOR	K OW JH EH N ER EY T ER
COGENERATORS	K OW JH EH N ER EY T ER Z
COHESIVENESS	K OW HH IY S IH V N AH S
COHESIVENESSES	K OW HH IY S IH V N AH S IH Z
COHUNE	K OW HH Y UW N
COHUNES	K OW HH Y UW N Z
COIGNE	K OW IH N
COIGNED	K OW IH N D
COIGNES	K OW IH N Z
COINED	K OY N D
COINER	K OY N ER
COINERS	K OY N ER Z
COJOINED	K OW JH OY N D
COJONES	K OW JH OW N Z
COLCHICINE	K AO L CH AH S IY N
COLCHICINES	K AA L CH AH S AY N Z
COLDHEARTEDNESS	K OW L D HH AA R T AH D N AH S
COLDHEARTEDNESSES	K OW L D HH AA R T AH D N AH S IH Z
COLDNESS	K OW L D N AH S
COLDNESSES	K OW L D N AH S IH Z
COLICINE	K OW L AH S AY N
COLICINES	K OW L AH S AY N Z
COLINEAR	K OW L IH N IY ER
COLINEARITIES	K OW L IH N IY ER AH T IY Z
COLINEARITY	K OW L IH N IY ER AH T IY
COLLARBONE	K AA L ER B OW N
COLLARBONES	K AA L ER B OW N Z
COLLECTANEA	K AA L EH K T EY N IY AH
COLLECTEDNESS	K AA L IH K T AH D N AH S
COLLECTEDNESSES	K AA L IH K T AH D N AH S IH Z
COLLINEAR	K AA L AY N IY AH R
COLLINEARITIES	K AA L AH N IY R AH T AY Z
COLLINEARITY	K AA L AH N IY R AH T IY
COLOGNE	K AH L OW N
COLOGNED	K AH L OW N D
COLOGNES	K AH L OW N Z
COLONE	K OW L OW N
COLONEL	K ER N AH L
COLONELCIES	K OW L AH N EH L S AY Z
COLONELCY	K OW L AH N EH L S IY
COLONELS	K ER N AH L Z
COLONES	K OW L OW N Z
COLONIALNESS	K AH L OW N IY AH L N AH S
COLONIALNESSES	K AH L OW N IY AH L N AH S IH Z
COLORBLINDNESS	K AH L ER B L AY N D N AH S
COLORBLINDNESSES	K AH L ER B L AY N D N AH S IH Z
COLORFASTNESS	K AH L ER F AE S T N AH S
COLORFASTNESSES	K AH L ER F AE S T N AH S IH Z
COLORFULNESS	K AH L ER F AH L N AH S
COLORFULNESSES	K AH L ER F AH L N AH S IH Z
COLORLESSNESS	K AH L ER L AH S N AH S
COLORLESSNESSES	K AH L ER L AH S N AH S IH Z
COLTISHNESS	K OW L T IH SH N AH S
COLTISHNESSES	K OW L T IH SH N AH S IH Z
COLUBRINE	K OW L AH B R AY N
COLUMBINE	K AA L AH M B AY N
COLUMBINES	K AA L AH M B AY N Z
COLUMNED	K AA L AH M D
COMBATIVENESS	K AH M B AE T IH V N AH S
COMBATIVENESSES	K AH M B AE T IH V N AH S IH Z
COMBINE	K AA M B AY N
COMBINE(2)	K AH M B AY N
COMBINED	K AH M B AY N D
COMBINER	K AH M B AY N ER
COMBINERS	K AH M B AY N ER Z
COMBINES	K AH M B AY N Z
COMEDIENNE	K AH M IY D IY EH N
COMEDIENNES	K AA M AH D IY N Z
COMEDONES	K AH M D AH N Z
COMELINESS	K AH M L IY N AH S
COMELINESSES	K AH M L IY N AH S IH Z
COMFORTABLENESS	K AH M F ER T AH B AH L N AH S
COMFORTABLENESSES	K AH M F ER T AH B AH L N AH S IH Z
COMMISSIONED	K AH M IH SH AH N D
COMMISSIONER	K AH M IH SH AH N ER
COMMISSIONERS	K AH M IH SH AH N ER Z
COMMISSIONERSHIP	K AH M IH SH AH N ER SH IH P
COMMISSIONERSHIPS	K AH M IH SH AH N ER SH IH P S
COMMODIOUSNESS	K AH M OW D IY AH S N AH S
COMMODIOUSNESSES	K AH M OW D IY AH S N AH S IH Z
COMMONER	K AA M AH N ER
COMMONERS	K AA M AH N ER Z
COMMONEST	K AA M AH N AH S T
COMMONNESS	K AA M AH N AH S
COMMONNESSES	K AA M AH N AH S IH Z
COMMONPLACENESS	K AA M AH N P L EY S N AH S
COMMONPLACENESSES	K AA M AH N P L EY S N AH S IH Z
COMMUNE	K AA M Y UW N
COMMUNE(2)	K AH M Y UW N
COMMUNED	K AH M Y UW N D
COMMUNES	K AA M Y UW N Z
COMMUNES(2)	K AH M Y UW N Z
COMMUNICABLENESS	K AH M Y UW N AH K AH B AH L N AH S
COMMUNICABLENESSES	K AH M Y UW N AH K AH B AH L N AH S IH Z
COMMUNICATIVENESS	K AH M Y UW N AH K AH T IH V N AH S
COMMUNICATIVENESSES	K AH M Y UW N AH K AH T IH V N AH S IH Z
COMPACTNESS	K AH M P AE K T N AH S
COMPACTNESSES	K AH M P AE K T N AH S IH Z
COMPANIONABLENESS	K AH M P AE N Y AH N AH B AH L N AH S
COMPANIONABLENESSES	K AH M P AE N Y AH N AH B AH L N AH S IH Z
COMPANIONED	K AH M P AE N Y AH N D
COMPARABLENESS	K AA M P AH R AH B AH L N AH S
COMPARABLENESSES	K AA M P AH R AH B AH L N AH S IH Z
COMPARATIVENESS	K AH M P AE R AH T IH V N AH S
COMPARATIVENESSES	K AH M P AE R AH T IH V N AH S IH Z
COMPASSIONATENESS	K AH M P AE SH AH N AH T N AH S
COMPASSIONATENESSES	K AH M P AE SH AH N AH T N AH S IH Z
COMPATIBLENESS	K AH M P AE T AH B AH L N AH S
COMPATIBLENESSES	K AH M P AE T AH B AH L N AH S IH Z
COMPENDIOUSNESS	K AH M P EH N D AY AH S N AH S
COMPENDIOUSNESSES	K AH M P EH N D AY AH S N AH S IH Z
COMPETITIVENESS	K AH M P EH T IH T IH V N IH S
COMPETITIVENESSES	K AH M P EH T AH T IH V N AH S IH Z
COMPLAINED	K AH M P L EY N D
COMPLAINER	K AH M P L EY N ER
COMPLAINERS	K AA M P L EY N ER Z
COMPLEMENTARINESS	K AA M P L AH M EH N T AH R IY N AH S
COMPLEMENTARINESSES	K AA M P L AH M EH N T AH R IY N AH S IH Z
COMPLETENESS	K AH M P L IY T N AH S
COMPLETENESSES	K AH M P L IY T N AH S IH Z
COMPLEXIONED	K AH M P L EH K SH AH N D
COMPLEXNESS	K AH M P L EH K S N AH S
COMPLEXNESSES	K AH M P L EH K S N AH S IH Z
COMPLICATEDNESS	K AA M P L AH K AH T AH D N AH S
COMPLICATEDNESSES	K AA M P L AH K AH T AH D N AH S IH Z
COMPLINE	K AA M P L AY N
COMPLINES	K AA M P L AY N Z
COMPONE	K AA M P OW N
COMPONENT	K AH M P OW N AH N T
COMPONENTIAL	K AH M P OW N AH N T IY AH L
COMPONENTS	K AH M P OW N AH N T S
COMPOSEDNESS	K AH M P OW Z AH D N AH S
COMPOSEDNESSES	K AH M P OW Z AH D N AH S IH Z
COMPREHENSIBLENESS	K AA M P R IH HH EH N S AH B AH L N AH S
COMPREHENSIBLENESSES	K AA M P R IH HH EH N S AH B AH L N AH S IH Z
COMPREHENSIVENESS	K AA M P R IH HH EH N S IH V N AH S
COMPREHENSIVENESSES	K AA M P R IH HH EH N S IH V N AH S IH Z
COMPULSIVENESS	K AH M P AH L S IH V N AH S
COMPULSIVENESSES	K AH M P AH L S IH V N AH S IH Z
COMRADELINESS	K AA M R AE D L IY N AH S
COMRADELINESSES	K AA M R AE D L IY N AH S IH Z
CONCEITEDNESS	K AH N S IY T AH D N AH S
CONCEITEDNESSES	K AH N S IY T AH D N AH S IH Z
CONCEIVABLENESS	K AH N S IY V AH B AH L N AH S
CONCEIVABLENESSES	K AH N S IY V AH B AH L N AH S IH Z
CONCERNED	K AH N S ER N D
CONCERTEDNESS	K AH N S ER T AH D N AH S
CONCERTEDNESSES	K AH N S ER T AH D N AH S IH Z
CONCESSIONER	K AH N S EH SH AH N ER
CONCESSIONERS	K AH N S EH SH AH N ER Z
CONCISENESS	K AH N S AY S N AH S
CONCISENESSES	K AH N S AY S N AH S IH Z
CONCLUSIVENESS	K AH N K L UW S IH V N AH S
CONCLUSIVENESSES	K AH N K L UW S IH V N AH S IH Z
CONCRETENESS	K AA N K R IY T N AH S
CONCRETENESSES	K AA N K R IY T N AH S IH Z
CONCUBINE	K AA N K Y AH B AY N
CONCUBINES	K AA N K Y AH B AY N Z
CONDEMNED	K AH N D EH M D
CONDEMNER	K AH N D EH M ER
CONDEMNERS	K AH N D EH M ER Z
CONDITIONED	K AH N D IH SH AH N D
CONDITIONER	K AH N D IH SH AH N ER
CONDITIONERS	K AH N D IH SH AH N ER Z
CONDONE	K AH N D OW N
CONDONED	K AH N D OW N D
CONDONER	K AH N D OW N ER
CONDONERS	K AH N D OW N ER Z
CONDONES	K AH N D OW N Z
CONDUCIVENESS	K AH N D UW S IH V N AH S
CONDUCIVENESSES	K AH N D UW S IH V N AH S IH Z
CONE	K OW N
CONED	K OW N D
CONEFLOWER	K OW N F L AW ER
CONEFLOWERS	K OW N F L AW ER Z
CONELRAD	K AH N EH L R AH D
CONELRADS	K AH N EH L R AH D Z
CONENOSE	K OW N OW Z
CONENOSES	K AH N EH N AA S IH Z
CONEPATE	K OW N P EY T
CONEPATES	K OW N P EY T S
CONEPATL	K AH N EH P AH T L
CONEPATLS	K AH N EH P AH T L Z
CONES	K OW N Z
CONEY	K OW N IY
CONEYS	K OW N IY Z
CONFECTIONER	K AH N F EH K SH AH N ER
CONFECTIONERIES	K AH N F EH K SH AH N AH R IY Z
CONFECTIONERS	K AH N F EH K SH AH N ER Z
CONFECTIONERY	K AH N F EH K SH AH N EH R IY
CONFIDINGNESS	K AH N F AY D IH NG N AH S
CONFIDINGNESSES	K AH N F AY D IH NG N AH S IH Z
CONFINE	K AH N F AY N
CONFINED	K AH N F AY N D
CONFINEMENT	K AH N F AY N M AH N T
CONFINEMENTS	K AH N F AY N M AH N T S
CONFINER	K AH N F AY N ER
CONFINERS	K AH N F AY N ER Z
CONFINES	K AA N F AY N Z
CONFINES(2)	K AH N F AY N Z
CONFIRMEDNESS	K AH N F ER M AH D N AH S
CONFIRMEDNESSES	K AH N F ER M AH D N AH S IH Z
CONFUSEDNESS	K AH N F Y UW Z AH D N AH S
CONFUSEDNESSES	K AH N F Y UW Z AH D N AH S IH Z
CONGENER	K AH N JH IY N ER
CONGENERIC	K AH N JH EH N ER IH K
CONGENEROUS	K AH N JH EH N ER AH S
CONGENERS	K AH N JH IY N ER Z
CONGRUOUSNESS	K AA NG G R AH W AH S N AH S
CONGRUOUSNESSES	K AA NG G R AH W AH S N AH S IH Z
CONIINE	K AH N IY N
CONIINES	K AH N IY N Z
CONINE	K OW N AY N
CONINES	K OW N AY N Z
CONJOINED	K AA N JH OY N D
CONJUGATENESS	K AA N JH IH G AH T N AH S
CONJUGATENESSES	K AA N JH IH G AH T N AH S IH Z
CONNECT	K AH N EH K T
CONNECTABLE	K AH N EH K T AH B AH L
CONNECTED	K AH N EH K T IH D
CONNECTEDLY	K AH N EH K T AH D L IY
CONNECTEDNESS	K AH N EH K T AH D N AH S
CONNECTEDNESSES	K AH N EH K T AH D N AH S IH Z
CONNECTER	K AH N EH K T ER
CONNECTERS	K AH N EH K T ER Z
CONNECTIBLE	K AH N EH K T AH B AH L
CONNECTING	K AH N EH K T IH NG
CONNECTION	K AH N EH K SH AH N
CONNECTIONAL	K AH N EH K SH AH N AH L
CONNECTIONS	K AH N EH K SH AH N Z
CONNECTIVE	K AH N EH K T IH V
CONNECTIVELY	K AH N EH K T IH V L IY
CONNECTIVES	K AH N EH K T IH V Z
CONNECTIVITIES	K AH N EH K T IH V AH T IY Z
CONNECTIVITY	K AH N EH K T IH V IH T IY
CONNECTOR	K AH N EH K T ER
CONNECTORS	K AH N EH K T ER Z
CONNECTS	K AH N EH K T S
CONNED	K AA N D
CONNER	K AA N ER
CONNERS	K AA N ER Z
CONNEXION	K AH N EH K SH AH N
CONNEXIONS	K AH N EH K SH AH N Z
CONOMINEE	K OW N AA M AH N IY
CONOMINEES	K OW N AA M AH N IY Z
CONSANGUINE	K AA N S AE N G W AY N
CONSANGUINEOUS	K AA N S AE N G W IH N IY AH S
CONSANGUINEOUSLY	K AA N S AE N G W IH N IY AH S L IY
CONSCIENTIOUSNESS	K AA N CH IY EH N CH AH S N AH S
CONSCIENTIOUSNESSES	K AA N CH IY EH N CH AH S N AH S IH Z
CONSCIOUSNESS	K AA N SH AH S N AH S
CONSCIOUSNESSES	K AA N SH AH S N AH S IH Z
CONSECUTIVENESS	K AH N S EH K Y AH T IH V N AH S
CONSECUTIVENESSES	K AH N S EH K Y AH T IH V N AH S IH Z
CONSENTANEOUS	K AA N S EH N T EY N IY AH S
CONSENTANEOUSLY	K AA N S EH N T AH N IY OW AH S L IY
CONSEQUENTIALNESS	K AA N S AH K W EH N CH AH L N AH S
CONSEQUENTIALNESSES	K AA N S AH K W EH N CH AH L N AH S IH Z
CONSERVATIVENESS	K AH N S ER V AH T IH V N AH S
CONSERVATIVENESSES	K AH N S ER V AH T IH V N AH S IH Z
CONSIDERATENESS	K AH N S IH D ER AH T N AH S
CONSIDERATENESSES	K AH N S IH D ER AH T N AH S IH Z
CONSIGNED	K AH N S AY N D
CONSIGNEE	K AH N S AY N IY
CONSIGNEES	K AH N S AY N IY Z
CONSPICUOUSNESS	K AH N S P IH K Y AH W AH S N AH S
CONSPICUOUSNESSES	K AH N S P IH K Y AH W AH S N AH S IH Z
CONSTRAINED	K AH N S T R EY N D
CONSTRAINEDLY	K AH N S T R EY N AH D L IY
CONSTRUCTIVENESS	K AH N S T R AH K T IH V N AH S
CONSTRUCTIVENESSES	K AH N S T R AH K T IH V N AH S IH Z
CONTAGIOUSNESS	K AH N T EY JH AH S N AH S
CONTAGIOUSNESSES	K AH N T EY JH AH S N AH S IH Z
CONTAINED	K AH N T EY N D
CONTAINER	K AH N T EY N ER
CONTAINERBOARD	K AH N T EY N ER B AO R D
CONTAINERBOARDS	K AH N T EY N ER B OW R D Z
CONTAINERISATION	K AH N T EY N AH R IY Z EY SH AH N
CONTAINERISATIONS	K AH N T EY N AH R IY Z EY SH AH N Z
CONTAINERISE	K AA N T EY N AH R AY Z
CONTAINERISED	K AH N T EY N AH R IY Z D
CONTAINERISES	K AH N T EY N AH R IY Z IH Z
CONTAINERISING	K AH N T EY N AH R IY Z IH NG
CONTAINERIZATION	K AH N T EY N ER AH Z EY SH AH N
CONTAINERIZATIONS	K AH N T EY N ER AH Z EY SH AH N Z
CONTAINERIZE	K AH N T EY N ER AY Z
CONTAINERIZED	K AH N T EY N ER AY Z D
CONTAINERIZES	K AH N T EY N ER AY Z IH Z
CONTAINERIZING	K AH N T EY N ER AY Z IH NG
CONTAINERLESS	K AH N T EY N ER L AH S
CONTAINERPORT	K AH N T EY N ER P OW R T
CONTAINERPORTS	K AH N T EY N ER P OW R T S
CONTAINERS	K AH N T EY N ER Z
CONTAINERSHIP	K AH N T EY N ER SH IH P
CONTAINERSHIPS	K AH N T EY N ER SH IH P S
CONTEMNED	K AA N T EH M D
CONTEMNER	K AA N T EH M AH R
CONTEMNERS	K AA N T EH M N AH R Z
CONTEMPLATIVENESS	K AA N T AH M P L EY T IH V N AH S
CONTEMPLATIVENESSES	K AA N T AH M P L EY T IH V N AH S IH Z
CONTEMPORANEITIES	K AA N T EH M P AH R AH N AH T AY Z
CONTEMPORANEITY	K AA N T EH M P AH R AH N IY AH T IY
CONTEMPORANEOUS	K AH N T EH M P ER EY N IY AH S
CONTEMPORANEOUSLY	K AH N T EH M P ER EY N IY AH S L IY
CONTEMPORANEOUSNESS	K AA N T AH M P AH R EY N IY AW Z N AH S
CONTEMPORANEOUSNESSES	K AA N T AH M P AH R EY N IY AW Z N EH S AH Z
CONTEMPTIBLENESS	K AH N T EH M P T AH B AH L N AH S
CONTEMPTIBLENESSES	K AH N T EH M P T AH B AH L N AH S IH Z
CONTEMPTUOUSNESS	K AH N T EH M P CH AH W AH S N AH S
CONTEMPTUOUSNESSES	K AH N T EH M P CH AH W AH S N AH S IH Z
CONTENTEDNESS	K AH N T EH N T AH D N AH S
CONTENTEDNESSES	K AH N T EH N T AH D N AH S IH Z
CONTENTIOUSNESS	K AH N T EH N SH AH S N AH S
CONTENTIOUSNESSES	K AH N T EH N T IY AH S N AH S IH Z
CONTIGUOUSNESS	K AH N T IH G Y AH W AH S N AH S
CONTIGUOUSNESSES	K AH N T IH G Y AH W AH S N AH S IH Z
CONTINENCE	K AA N T AH N AH N S
CONTINENCES	K AA N T AH N AH N S IH Z
CONTINENT	K AA N T AH N AH N T
CONTINENTAL	K AA N T AH N EH N T AH L
CONTINENTAL(2)	K AA N T AH N EH N AH L
CONTINENTALLY	K AA N T AH N EH N T AH L IY
CONTINENTALLY(2)	K AA N T AH N EH N AH L IY
CONTINENTALS	K AA N T AH N EH N T AH L Z
CONTINENTALS(2)	K AA N T AH N EH N AH L Z
CONTINENTLY	K AA N T AH N AH N T L IY
CONTINENTS	K AA N T AH N AH N T S
CONTINUOUSNESS	K AH N T IH N Y UW AH S N AH S
CONTINUOUSNESSES	K AH N T IH N Y UW AH S N AH S IH Z
CONTRADICTORINESS	K AA N T R AH D IH K T ER IY N AH S
CONTRADICTORINESSES	K AA N T R AH D IH K T ER IY N AH S IH Z
CONTRARINESS	K AA N T R EH R IY N AH S
CONTRARINESSES	K AA N T R EH R IY N AH S IH Z
CONTRAVENE	K AA N T R AH V IY N
CONTRAVENED	K AA N T R AH V IY N D
CONTRAVENER	K AA N T R AH V IY N AH R
CONTRAVENERS	K AA N T R AE V AH N AH R Z
CONTRAVENES	K AA N T R AH V IY N Z
CONTRITENESS	K AH N T R AY T N AH S
CONTRITENESSES	K AH N T R AY T N AH S IH Z
CONVENE	K AH N V IY N
CONVENED	K AH N V IY N D
CONVENER	K AH N V IY N ER
CONVENERS	K AH N V IY N ER Z
CONVENES	K AH N V IY N Z
CONVENTIONEER	K AH N V EH N SH AH N IH R
CONVENTIONEERS	K AH N V EH N SH AH N IH R Z
CONVERSAZIONE	K AA N V AH R S EY Z IY OW N
CONVERSAZIONES	K AA N V AH R S EY Z IY OW N Z
CONVERTAPLANE	K AH N V ER T AH P L EY N
CONVERTAPLANES	K AH N V ER T AH P L EY N Z
CONVERTIBLENESS	K AH N V ER T AH B AH L N AH S
CONVERTIBLENESSES	K AH N V ER T AH B AH L N AH S IH Z
CONVERTIPLANE	K AA N V AH R T AH P L EY N
CONVERTIPLANES	K AA N V AH R T AH P L EY N Z
CONVINCINGNESS	K AH N V IH N S IH NG N AH S
CONVINCINGNESSES	K AH N V IH N S IH NG N AH S IH Z
CONVULSIVENESS	K AH N V AH L S IH V N AH S
CONVULSIVENESSES	K AH N V AH L S IH V N AH S IH Z
COOLNESS	K UW L N AH S
COOLNESSES	K UW L N AH S IH Z
COOPERATIVENESS	K OW AA P ER AH T IH V N AH S
COOPERATIVENESSES	K OW AA P ER AH T IH V N AH S IH Z
COORDINATENESS	K OW AO R D AH N AH T N AH S
COORDINATENESSES	K OW AO R D AH N AH T N AH S IH Z
COPARCENER	K AA P AA R K AH N ER
COPARCENERS	K AA P AA R K AH N ER Z
COPARTNER	K OW P AA R T N ER
COPARTNERED	K OW P AA R T N ER D
COPARTNERING	K OW P AA R T N ER IH NG
COPARTNERS	K OW P AA R T N ER Z
COPARTNERSHIP	K OW P AA R T N ER SH IH P
COPARTNERSHIPS	K OW P AA R T N ER SH IH P S
COPESTONE	K OW P S T OW N
COPESTONES	K OW P S T OW N Z
COPINGSTONE	K OW P IH NG S T OW N
COPINGSTONES	K OW P IH NG S T OW N Z
COPIOUSNESS	K OW P IY AH S N AH S
COPIOUSNESSES	K OW P IY AH S N AH S IH Z
COPRISONER	K OW P R IH Z AH N ER
COPRISONERS	K OW P R IH Z AH N ER Z
COQUETTISHNESS	K OW K EH T IH SH N AH S
COQUETTISHNESSES	K OW K EH T IH SH N AH S IH Z
CORALLINE	K AO R AH L AY N
CORALLINES	K AO R AH L AY N Z
CORDIALNESS	K AO R JH AH L N AH S
CORDIALNESSES	K AO R JH AH L N AH S IH Z
CORDONED	K AO R D AH N D
CORDWAINER	K AA R D W EY N AH R
CORDWAINERIES	K AA R D W EY N AH R AY Z
CORDWAINERS	K AA R D W EY N AH R Z
CORDWAINERY	K AA R D W AH N EH R IY
CORKINESS	K AO R K IY N AH S
CORKINESSES	K AO R K IY N AH S IH Z
CORNEA	K AO R N IY AH
CORNEAE	K AA R N IY
CORNEAL	K AO R N IY L
CORNEAS	K AO R N IY AH Z
CORNED	K AO R N D
CORNEL	K AO R N AH L
CORNELIAN	K AA R N IY L IY AH N
CORNELIANS	K AA R N IY L IY AH N Z
CORNELS	K AA R N EH L Z
CORNEOUS	K AO R N IY AH S
CORNER	K AO R N ER
CORNERBACK	K AO R N ER B AE K
CORNERBACKS	K AO R N ER B AE K S
CORNERED	K AO R N ER D
CORNERING	K AO R N ER IH NG
CORNERMAN	K AO R N ER M AE N
CORNERMEN	K AO R N ER M EH N
CORNERS	K AO R N ER Z
CORNERSTONE	K AO R N ER S T OW N
CORNERSTONES	K AO R N ER S T OW N Z
CORNERWAYS	K AO R N ER W EY Z
CORNERWISE	K AO R N ER W AY Z
CORNET	K AO R N EH T
CORNETCIES	K AA R N EH T S AY Z
CORNETCY	K AA R N EH T S IY
CORNETIST	K AA R N IY T AH S T
CORNETISTS	K AA R N EH T AH S T S
CORNETS	K AA R N EH T S
CORNETTIST	K AO R N EH T AH S T
CORNETTISTS	K AO R N EH T IH S T S
CORNINESS	K AO R N IY N AH S
CORNINESSES	K AO R N IY N AH S IH Z
CORNPONE	K AA R N P OW N
CORNPONES	K AA R N P OW N Z
CORONEL	K OW R AA N AH L
CORONELS	K OW R AA N AH L Z
CORONER	K AO R AH N ER
CORONERS	K AO R AH N ER Z
CORONET	K AO R AH N EH T
CORONETS	K AO R AH N EH T S
CORPOREALNESS	K AO R P OW R IY AH L N AH S
CORPOREALNESSES	K AO R P OW R IY AH L N AH S IH Z
CORRECTNESS	K ER EH K T N AH S
CORRECTNESSES	K AH R EH K T N AH S IH Z
CORROSIVENESS	K AH R OW S IH V N AH S
CORROSIVENESSES	K AH R OW S IH V N AH S IH Z
CORRUPTNESS	K AH R AH P T N AH S
CORRUPTNESSES	K AH R AH P T N AH S IH Z
CORTICOSTERONE	K AA R T AH K AA S T AH R OW N
CORTICOSTERONES	K AA R T AH K AA S T AH R OW N Z
CORTISONE	K AO R T AH Z OW N
CORTISONES	K AA R T AH S OW N Z
CORVINE	K AA R V AY N
CORYNEBACTERIA	K OW R IH N AH B AH K T IY R IY AH
CORYNEBACTERIAL	K OW R AH N EH B AH K T IY R IY AH L
CORYNEBACTERIUM	K OW R IH N AH B AH K T IY R IY AH M
CORYNEFORM	K OW R IH N AH F AH R M
COSIGNED	K OW S AY N D
COSIGNER	K OW S AY N ER
COSIGNERS	K OW S AY N ER Z
COSINE	K OW S AY N
COSINES	K OW S AY N Z
COSINESS	K OW Z IY N AH S
COSINESSES	K OW Z IY N AH S IH Z
COSTIVENESS	K AA S T IH V N AH S
COSTIVENESSES	K AA S T IH V N AH S IH Z
COSTLINESS	K AO S T L IY N AH S
COSTLINESSES	K AO S T L IY N AH S IH Z
COTONEASTER	K OW T OW N AE S T ER
COTONEASTERS	K OW T OW N AE S T ER Z
COTTONED	K AA T AH N D
COUNTERMINE	K AW N T ER M AY N
COUNTERMINED	K AW N T ER M AY N D
COUNTERMINES	K AW N T ER M AY N Z
COUNTERPANE	K AW N T ER P EY N
COUNTERPANES	K AW N T ER P EY N Z
COUNTERPETITIONED	K AW N T ER P AH T IH SH AH N D
COUNTERQUESTIONED	K AW N T ER K W EH S CH AH N D
COUNTERSIGNED	K AW N T ER S AY N D
COUNTERSTAINED	K AW N T ER S T EY N D
COURAGEOUSNESS	K AH R EY JH AH S N AH S
COURAGEOUSNESSES	K AH R EY JH AH S N AH S IH Z
COURTEOUSNESS	K ER T IY AH S N AH S
COURTEOUSNESSES	K ER T IY AH S N AH S IH Z
COURTLINESS	K OW R T L IY N AH S
COURTLINESSES	K OW R T L IY N AH S IH Z
COVELLINE	K OW V EH L AY N
COVELLINES	K OW V EH L AY N Z
COVERTNESS	K AH V ER T N AH S
COVERTNESSES	K AH V ER T N AH S IH Z
COVETOUSNESS	K AH V AH T AH S N AH S
COVETOUSNESSES	K AH V AH T AH S N AH S IH Z
COWARDLINESS	K AW ER D L IY N AH S
COWARDLINESSES	K AW ER D L IY N AH S IH Z
COWBANE	K AW B EY N
COWBANES	K AW B EY N Z
COWINNER	K OW W IH N ER
COWINNERS	K OW W IH N ER Z
COXSWAINED	K AA Z S W EY N D
COYNESS	K OY N AH S
COYNESSES	K OY N AH S IH Z
COZENED	K AH Z AH N D
COZENER	K AH Z AH N ER
COZENERS	K AH Z AH N ER Z
COZINESS	K OW Z IY N AH S
COZINESSES	K OW Z IY N AH S IH Z
CRABBEDNESS	K R AE B AH D N AH S
CRABBEDNESSES	K R AE B AH D N AH S IH Z
CRACKBRAINED	K R AE K B R EY N D
CRACKNEL	K R AE K N AH L
CRACKNELS	K R AE K N AH L Z
CRAFTINESS	K R AE F T IY N AH S
CRAFTINESSES	K R AE F T IY N AH S IH Z
CRAGGINESS	K R AE G IY N AH S
CRAGGINESSES	K R AE G IY N AH S IH Z
CRANE	K R EY N
CRANED	K R EY N D
CRANES	K R EY N Z
CRANESBILL	K R EY N Z B IH L
CRANESBILLS	K R EY N Z B IH L Z
CRANKINESS	K R AE NG K IY N AH S
CRANKINESSES	K R AE NG K IY N AH S IH Z
CRASHWORTHINESS	K R AE SH W ER DH IY N AH S
CRASHWORTHINESSES	K R AE SH W ER DH IY N AH S IH Z
CRASSNESS	K R AE S N AH S
CRASSNESSES	K R AE S N AH S IH Z
CRAVENED	K R EY V AH N D
CRAVENNESS	K R EY V AH N AH S
CRAVENNESSES	K R EY V AH N AH S IH Z
CRAYONED	K R EY AA N D
CRAZINESS	K R EY Z IY N AH S
CRAZINESSES	K R EY Z IY N AH S IH Z
CREAKINESS	K R IY K IY N AH S
CREAKINESSES	K R IY K IY N AH S IH Z
CREAMINESS	K R IY M IY N AH S
CREAMINESSES	K R IY M IY N AH S IH Z
CREATINE	K R IY T AY N
CREATINES	K R IY T AY N Z
CREATININE	K R IY T AH N AY N
CREATININES	K R IY T AH N AY N Z
CREATIVENESS	K R IY EY T IH V N AH S
CREATIVENESSES	K R IY EY T IH V N AH S IH Z
CREATURELINESS	K R IY CH ER L IY N AH S
CREATURELINESSES	K R IY CH ER L IY N AH S IH Z
CREDITABLENESS	K R EH D AH T AH B AH L N AH S
CREDITABLENESSES	K R EH D AH T AH B AH L N AH S IH Z
CREDITWORTHINESS	K R EH D IH T W ER DH IY N AH S
CREDITWORTHINESSES	K R EH D AH T W ER DH IY N AH S IH Z
CREDULOUSNESS	K R EH JH AH L AH S N AH S
CREDULOUSNESSES	K R EH JH AH L AH S N AH S IH Z
CREEPINESS	K R IY P IY N IH S
CREEPINESSES	K R IY P IY N AH S IH Z
CRENEL	K R EH N AH L
CRENELATED	K R EH N AH L EY T AH D
CRENELATION	K R EH N AH L EY SH AH N
CRENELATIONS	K R EH N AH L EY T IY AH N Z
CRENELED	K R AH N IY L D
CRENELING	K R AH N IY L AH NG
CRENELLATED	K R EH N AH L EY T AH D
CRENELLATION	K R EH N AH L EY SH AH N
CRENELLATIONS	K R EH N AH L EY T IY AH N Z
CRENELLE	K R EH N AH L
CRENELLED	K R EH N AH L D
CRENELLES	K R EH N AH L Z
CRENELLING	K R AH N EH L AH NG
CRENELS	K R EH N AH L Z
CRESTFALLENNESS	K R EH S T F AE L AH N AH S
CRESTFALLENNESSES	K R EH S T F AE L AH N AH S IH Z
CRETONNE	K R EH T AH N
CRETONNES	K R EH T AH N Z
CREWNECK	K R UW N EH K
CREWNECKS	K R UW N EH K S
CRIMSONED	K R IH M Z AH N D
CRINOLINE	K R IH N AH L AY N
CRINOLINED	K R IH N AH L AY N D
CRINOLINES	K R IH N AH L AY N Z
CRISPENED	K R IH S P AH N D
CRISPINESS	K R IH S P IY N AH S
CRISPINESSES	K R IH S P IY N AH S IH Z
CRISPNESS	K R IH S P N AH S
CRISPNESSES	K R IH S P N AH S IH Z
CRITICALNESS	K R IH T IH K AH L N AH S
CRITICALNESSES	K R IH T IH K AH L N AH S IH Z
CROCEINE	K R OW S IY N
CROCEINES	K R OW S IY N Z
CROCINE	K R AH S AY N
CRONE	K R OW N
CRONES	K R OW N Z
CROOKEDNESS	K R UH K AH D N AH S
CROOKEDNESSES	K R UH K AH D N AH S IH Z
CROOKNECK	K R UH K N EH K
CROOKNECKS	K R UH K N EH K S
CROONED	K R UW N D
CROONER	K R UW N ER
CROONERS	K R UW N ER Z
CROSSBONES	K R AO S B OW N Z
CROSSNESS	K R AO S N AH S
CROSSNESSES	K R AO S N AH S IH Z
CROTCHETINESS	K R AA CH AH T IY N AH S
CROTCHETINESSES	K R AA CH AH T IY N AH S IH Z
CROWDEDNESS	K R AW D AH D N AH S
CROWDEDNESSES	K R AW D AH D N AH S IH Z
CROWNED	K R AW N D
CROWNER	K R AW N ER
CROWNERS	K R AW N ER Z
CROWNET	K R OW N EH T
CROWNETS	K R OW N EH T S
CRUDENESS	K R UW D N AH S
CRUDENESSES	K R UW D N AH S IH Z
CRUELNESS	K R UW AH L N AH S
CRUELNESSES	K R UW AH L N AH S IH Z
CRUMBLINESS	K R AH M B L IY N AH S
CRUMBLINESSES	K R AH M B L IY N AH S IH Z
CRUMMINESS	K R AH M IY N AH S
CRUMMINESSES	K R AH M IY N AH S IH Z
CRUNCHINESS	K R AH N CH IY N AH S
CRUNCHINESSES	K R AH N CH IY N AH S IH Z
CRUSTINESS	K R AH S T IY N AH S
CRUSTINESSES	K R AH S T IY N AH S IH Z
CRYPTOCRYSTALLINE	K R IH P T AH K R IH S T AH L AY N
CRYSTALLINE	K R IH S T AH L AY N
CUISINE	K W IH Z IY N
CUISINES	K W IH Z IY N Z
CULICINE	K Y UW L AH S AY N
CULICINES	K Y UW L AH S AY N Z
CULPABLENESS	K AH L P AE B L N AH S
CULPABLENESSES	K AH L P AE B L AH N EH S AH Z
CULTISHNESS	K AH L T IH SH N AH S
CULTISHNESSES	K AH L T IH SH N AH S IH Z
CUMBERSOMENESS	K AH M B ER S AH M N AH S
CUMBERSOMENESSES	K AH M B ER S AH M N AH S IH Z
CUMBROUSNESS	K AH M B R AW Z N AH S
CUMBROUSNESSES	K AH M B R AW Z N EH S AH Z
CUMULATIVENESS	K Y UW M Y AH L AH T IH V N AH S
CUMULATIVENESSES	K Y UW M Y AH L AH T IH V N AH S IH Z
CUNEAL	K Y UW N IY AH L
CUNEATE	K Y UW N IY EY T
CUNEATED	K Y UW N IY EY T AH D
CUNEATIC	K Y UW N IY AH T AH K
CUNEIFORM	K Y UW N IY AH F AO R M
CUNEIFORMS	K Y UW N IY F AH R M Z
CUNNER	K AH N AH R
CUNNERS	K AH N AH R Z
CUNNINGNESS	K AH N IH NG N AH S
CUNNINGNESSES	K AH N IH NG N AH S IH Z
CURABLENESS	K Y UH R AH B AH L N AH S
CURABLENESSES	K Y UH R AH B AH L N AH S IH Z
CURARINE	K Y UH R AH R AY N
CURARINES	K Y UH R AH R AY N Z
CURBSTONE	K ER B S T OW N
CURBSTONES	K ER B S T OW N Z
CURIOUSNESS	K Y UH R IY AH S N AH S
CURIOUSNESSES	K Y UH R IY AH S N AH S IH Z
CURLINESS	K ER L IY N AH S
CURLINESSES	K ER L IY N AH S IH Z
CURMUDGEONLINESS	K AH R M AH JH IY AA N L AH N AH S
CURMUDGEONLINESSES	K AH R M AH JH IY AA N L AH N EH S AH Z
CURRENTNESS	K ER AH N T N AH S
CURRENTNESSES	K ER AH N T N AH S IH Z
CURSEDNESS	K ER S AH D N AH S
CURSEDNESSES	K ER S AH D N AH S IH Z
CURSIVENESS	K ER S IH V N AH S
CURSIVENESSES	K ER S IH V N AH S IH Z
CURSORINESS	K ER S AH R IY N AH S
CURSORINESSES	K ER S AH R IY N AH S IH Z
CURTAINED	K ER T AH N D
CURTNESS	K ER T N AH S
CURTNESSES	K ER T N AH S IH Z
CURVILINEAR	K AH R V AH L AY N IY AH R
CURVILINEARITIES	K AH R V AH L AH N IY R AH T AY Z
CURVILINEARITY	K AH R V IH L AH N IY R AH T IY
CUSHIONED	K UH SH AH N D
CUSSEDNESS	K AH S EH D N AH S
CUSSEDNESSES	K AH S EH D N EH S AH Z
CUSTOMARINESS	K AH S T AH M EH R IY N AH S
CUSTOMARINESSES	K AH S T AH M EH R IY N AH S IH Z
CUTANEOUS	K Y UW T EY N IY AH S
CUTANEOUSLY	K Y UW T AH N IY OW AH S L IY
CUTENESS	K Y UW T N AH S
CUTENESSES	K Y UW T N AH S IH Z
CUTLINE	K AH T L AY N
CUTLINES	K AH T L AY N Z
CUTTLEBONE	K AH T L AH B OW N
CUTTLEBONES	K AH T L AH B OW N Z
CYANINE	S AY AH N AY N
CYANINES	S AY AH N AY N Z
CYANOCOBALAMINE	S AY AH N AH K AH B AE L AH M AY N
CYANOCOBALAMINES	S AY AH N AH K AH B AE L AH M AY N Z
CYANOGENESES	S AY AH N AA JH AH N IY Z AH Z
CYANOGENESIS	S AY AH N AH JH IY N AH S AH S
CYANOGENETIC	S AY AH N AA JH AH N AH T AH K
CYBERNETIC	S AH B AH R N AH T AH K
CYBERNETICAL	S AH B AH R N AH T IH S AH L
CYBERNETICALLY	S AH B AH R N EH T AH K AE L IY
CYBERNETICIAN	S AH B AH R N AH T IH S IY AH N
CYBERNETICIANS	S AH B AH R N AH T IH S IY AH N Z
CYBERNETICIST	S AH B AH R N AH T IH S AH S T
CYBERNETICISTS	S IH B AH R N EH T AH S AH S T S
CYBERNETICS	S AH B AH R N AH T AH S Z
CYCLAZOCINE	S IH K L AE Z AH S AY N
CYCLAZOCINES	S IH K L AE Z AH S AY N Z
CYCLODIENE	S IH K L AH D IY N
CYCLODIENES	S IH K L AH D IY N Z
CYCLOGENESES	S IH K L AA JH AH N IY Z AH Z
CYCLOGENESIS	S IH K L AH JH IY N AH S AH S
CYCLOHEXANE	S AY K L AH HH EH K S EY N
CYCLOHEXANES	S IH K L AA HH AH K S EY N Z
CYCLOHEXANONE	S IH K L AH HH EH K S AH N OW N
CYCLOHEXANONES	S IH K L AH HH EH K S AH N OW N Z
CYCLOHEXYLAMINE	S IH K L AH HH EH K S IH L AH M AY N
CYCLOHEXYLAMINES	S IH K L AH HH EH K S IH L AH M AY N Z
CYCLONE	S IH K L OW N
CYCLONES	S IH K L OW N Z
CYCLOPROPANE	S IH K L AA P R AH P EY N
CYCLOPROPANES	S IH K L AA P R AH P EY N Z
CYCLOSERINE	S IH K L AA S AH R AY N
CYCLOSERINES	S IH K L AA S AH R AY N Z
CYCLOSPORINE	S IH K L AO S P ER IY N
CYCLOSPORINES	S IH K L AA S AH R AY N Z
CYGNET	S IH G N AH T
CYGNETS	S IH G N AH T S
CYMENE	S AH M IY N
CYMENES	S AH M IY N Z
CYMOGENE	S IH M AH JH IY N
CYMOGENES	S IH M AH JH IY N Z
CYMOPHANE	S IH M AH F EY N
CYMOPHANES	S IH M AH F EY N Z
CYPROHEPTADINE	S IH P R AH HH EH P T AH D AY N
CYPROHEPTADINES	S IH P R AH HH EH P T AH D AY N Z
CYPROTERONE	S IH P R AA T AH R OW N
CYPROTERONES	S IH P R AA T AH R OW N Z
CYSTEAMINE	S IH S T AH M AY N
CYSTEAMINES	S IH S T AH M AY N Z
CYSTEINE	S IH S T IY N
CYSTEINES	S IH S T IY N Z
CYSTINE	S IH S T AY N
CYSTINES	S IH S T AY N Z
CYTIDINE	S IH T AH D AY N
CYTIDINES	S IH T AH D AY N Z
CYTOGENETIC	S AH T AA JH AH N AH T AH K
CYTOGENETICAL	S IH T AH JH EH N AH T IH S AH L
CYTOGENETICALLY	S IH T AH JH AH N EH T AH K AE L IY
CYTOGENETICIST	S IH T AH JH EH N AH T IH S AH S T
CYTOGENETICISTS	S IH T AH JH AH N EH T AH S AH S T S
CYTOGENETICS	S IH T AH JH EH N AH T AH S Z
CYTOKINE	S IH T AH K AY N
CYTOKINES	S IH T AH K AY N Z
CYTOKINESES	S AH T AA K AH N IY Z AH Z
CYTOKINESIS	S IH T AH K AY N AH S AH S
CYTOKINETIC	S AH T AA K AH N AH T AH K
CYTOMEMBRANE	S AH T AA M AH M B R EY N
CYTOMEMBRANES	S AH T AA M AH M B R EY N Z
CYTOSINE	S IH T AH S AY N
CYTOSINES	S IH T AH S AY N Z
DAEMONES	D IY M OW N Z
DAFTNESS	D AE F T N AH S
DAFTNESSES	D AE F T N EH S AH Z
DAILINESS	D EY L IY N AH S
DAILINESSES	D EY L IY N AH S IH Z
DAIMONES	D EY M OW N Z
DAINTINESS	D EY N T IY N AH S
DAINTINESSES	D EY N T IY N AH S IH Z
DAMASCENE	D AE M AH S IY N
DAMASCENED	D AE M AH S IY N D
DAMASCENES	D AE M AH S IY N Z
DAMNABLENESS	D AE M AH B AH L N AH S
DAMNABLENESSES	D AE M AH B AH L N AH S IH Z
DAMNED	D AE M D
DAMNEDER	D AE M D ER
DAMNEDEST	D AE M D AH S T
DAMNEDESTS	D AE M D AH S T S
DAMNER	D AE M ER
DAMNERS	D AE M ER Z
DAMPENED	D AE M P AH N D
DAMPENER	D AE M P AH N ER
DAMPENERS	D AE M P AH N ER Z
DAMPNESS	D AE M P N IH S
DAMPNESSES	D AE M P N AH S IH Z
DANEGELD	D AE N AH JH AH L D
DANEGELDS	D AE N AH JH AH L D Z
DANEWEED	D AE N Y UW IY D
DANEWEEDS	D AE N Y UW IY D Z
DANEWORT	D AE N Y UW AH R T
DANEWORTS	D AE N Y UW AH R T S
DANGEROUSNESS	D EY N JH ER AH S N AH S
DANGEROUSNESSES	D EY N JH ER AH S N AH S IH Z
DANKNESS	D AE NG K N AH S
DANKNESSES	D AE NG K N AH S IH Z
DAPHNE	D AE F N IY
DAPHNES	D AE F N Z
DAPPERNESS	D AE P ER N AH S
DAPPERNESSES	D AE P ER N AH S IH Z
DAPSONE	D AE P S OW N
DAPSONES	D AE P S OW N Z
DARINGNESS	D EH R IH NG N AH S
DARINGNESSES	D EH R IH NG N AH S IH Z
DARKENED	D AA R K AH N D
DARKENER	D AA R K AH N ER
DARKENERS	D AA R K AH N ER Z
DARKNESS	D AA R K N AH S
DARKNESSES	D AA R K N AH S IH Z
DARLINGNESS	D AA R L IH NG N AH S
DARLINGNESSES	D AA R L IH NG N AH S IH Z
DARNED	D AA R N D
DARNEDER	D AA R N D ER
DARNEDEST	D AA R N D EH S T
DARNEDEST(2)	D AA R N EH S T
DARNEL	D AA R N AH L
DARNELS	D AA R N AH L Z
DARNER	D AA R N ER
DARNERS	D AA R N ER Z
DASTARDLINESS	D AE S T AA R D L AH N AH S
DASTARDLINESSES	D AE S T AA R D L AH N EH S AH Z
DATEDNESS	D EY T AH D N AH S
DATEDNESSES	D EY T AH D N AH S IH Z
DATELINE	D EY T L AY N
DATELINED	D EY T L AY N D
DATELINES	D EY T L AY N Z
DAUNTLESSNESS	D AO N T L AH S N AH S
DAUNTLESSNESSES	D AO N T L AH S N AH S IH Z
DAUPHINE	D AO F IY N
DAUPHINES	D AO F IY N Z
DAVENED	D AH V IY N D
DAWNED	D AO N D
DAZEDNESS	D EY Z AH D N AH S
DAZEDNESSES	D EY Z AH D N AH S IH Z
DEACONED	D IY K AH N D
DEACONESS	D IY K AH N AH S
DEACONESSES	D IY K AH N AH S IH Z
DEADENED	D EH D AH N D
DEADENER	D EH D AH N ER
DEADENERS	D EH D AH N ER Z
DEADLINE	D EH D L AY N
DEADLINES	D EH D L AY N Z
DEADLINESS	D EH D L IY N AH S
DEADLINESSES	D EH D L IY N AH S IH Z
DEADNESS	D EH D N AH S
DEADNESSES	D EH D N AH S IH Z
DEADPANNED	D EH D P AE N D
DEADPANNER	D EH D P AE N ER
DEADPANNERS	D EH D P AE N ER Z
DEAFENED	D EH F AH N D
DEAFNESS	D EH F N AH S
DEAFNESSES	D EH F N AH S IH Z
DEANED	D IY N D
DEANERIES	D IY N AH R IY Z
DEANERY	D IY N AH R IY
DEARNESS	D IH ER N AH S
DEARNESSES	D IH ER N AH S IH Z
DEATHLESSNESS	D EH TH L AH S N AH S
DEATHLESSNESSES	D EH TH L AH S N AH S IH Z
DEBONAIRNESS	D EH B AH N EH R N AH S
DEBONAIRNESSES	D EH B AH N EH R N AH S IH Z
DEBONE	D IY B OW N
DEBONED	D IY B OW N D
DEBONER	D IY B OW N ER
DEBONERS	D IY B OW N ER Z
DEBONES	D IY B OW N Z
DECANE	D IY K EY N
DECANES	D IY K EY N Z
DECEITFULNESS	D AH S IY T F AH L N AH S
DECEITFULNESSES	D AH S IY T F AH L N AH S IH Z
DECEPTIVENESS	D IH S EH P T IH V N AH S
DECEPTIVENESSES	D IH S EH P T IH V N AH S IH Z
DECERNED	D AH S AH R N D
DECIDEDNESS	D IH S AY D AH D N AH S
DECIDEDNESSES	D IH S AY D AH D N AH S IH Z
DECIDUOUSNESS	D AH S IH D Y UW AW Z N AH S
DECIDUOUSNESSES	D AH S IH D Y UW AW Z N EH S AH Z
DECISIONED	D IH S IH ZH AH N D
DECISIVENESS	D IH S AY S IH V N AH S
DECISIVENESSES	D AH S AY S IH V N AH S IH Z
DECLINE	D IH K L AY N
DECLINED	D IH K L AY N D
DECLINER	D IH K L AY N ER
DECLINERS	D IH K L AY N ER Z
DECLINES	D IH K L AY N Z
DECOMMISSIONED	D IY K AH M IH SH AH N D
DECONDITIONED	D IY K AH N D IH SH AH N D
DECORATIVENESS	D EH K AH R EY T IH V N AH S
DECORATIVENESSES	D EH K AH R EY T IH V N AH S IH Z
DECOROUSNESS	D EH K AH R AH S N AH S
DECOROUSNESSES	D EH K AH R AH S N AH S IH Z
DECROWNED	D IY K R AW N D
DEEPENED	D IY P AH N D
DEEPENER	D IY P AH N ER
DEEPENERS	D IY P AH N ER Z
DEEPNESS	D IY P N AH S
DEEPNESSES	D IY P N AH S IH Z
DEFECTIVENESS	D IY F EH K T IH V N AH S
DEFECTIVENESSES	D IY F EH K T IH V N AH S IH Z
DEFENESTRATE	D IY F EH N AH S T R EY T
DEFENESTRATED	D IY F EH N AH S T R EY T IH D
DEFENESTRATES	D IY F EH N AH S T R EY T S
DEFENESTRATING	D IY F EH N AH S T R EY T IH NG
DEFENESTRATION	D IY F EH N EH S T R EY SH AH N
DEFENESTRATIONS	D IY F EH N AH S T R AE SH AH N Z
DEFENSELESSNESS	D IH F EH N S L AH S N AH S
DEFENSELESSNESSES	D IH F EH N S L AH S N AH S IH Z
DEFENSIVENESS	D IH F EH N S IH V N AH S
DEFENSIVENESSES	D IH F EH N S IH V N AH S IH Z
DEFINE	D IH F AY N
DEFINED	D IH F AY N D
DEFINEMENT	D IH F AY N M AH N T
DEFINEMENTS	D IH F AY N M AH N T S
DEFINER	D IH F AY N ER
DEFINERS	D IH F AY N ER Z
DEFINES	D IH F AY N Z
DEFINITENESS	D EH F AH N AH T N AH S
DEFINITENESSES	D EH F AH N AH T N AH S IH Z
DEFINITIVENESS	D IH F IH N AH T IH V N AH S
DEFINITIVENESSES	D IH F IH N AH T IH V N AH S IH Z
DEFTNESS	D EH F T N AH S
DEFTNESSES	D EH F T N AH S IH Z
DEGENERACIES	D IY JH EH N ER AH S IY Z
DEGENERACY	D IH JH EH N ER AH S IY
DEGENERATE	D IH JH EH N ER AH T
DEGENERATE(2)	D IH JH EH N ER EY T
DEGENERATED	D IH JH EH N ER EY T IH D
DEGENERATELY	D IY JH EH N ER AH T L IY
DEGENERATENESS	D IY JH EH N ER AH T N AH S
DEGENERATENESSES	D IY JH EH N ER AH T N AH S IH Z
DEGENERATES	D IH JH EH N ER AH T S
DEGENERATING	D IH JH EH N ER EY T IH NG
DEGENERATION	D IH JH EH N ER EY SH AH N
DEGENERATIONS	D IY JH EH N ER EY SH AH N Z
DEGENERATIVE	D IH JH EH N ER AH T IH V
DEHORNED	D IY HH AO R N D
DEHORNER	D IY HH AO R N ER
DEHORNERS	D IY HH AO R N ER Z
DEIGNED	D EY N D
DEJECTEDNESS	D IH JH EH K T AH D N AH S
DEJECTEDNESSES	D IH JH EH K T AH D N AH S IH Z
DEJEUNER	D AH JH UW N AH R
DEJEUNERS	D AH JH UW N AH R Z
DELAINE	D IH L EY N
DELAINES	D AH L EY N Z
DELETERIOUSNESS	D IY L EH T AH R IY AH S N AH S
DELETERIOUSNESSES	D IY L EH T AH R IY AH S N AH S IH Z
DELIBERATENESS	D IH L IH B AH R AH T N AH S
DELIBERATENESSES	D IH L IH B AH R AH T N AH S IH Z
DELIBERATIVENESS	D IH L IH B AH R AH T IH V N AH S
DELIBERATIVENESSES	D IH L IH B AH R AH T IH V N AH S IH Z
DELICIOUSNESS	D IH L IH SH AH S N AH S
DELICIOUSNESSES	D IH L IH SH AH S N AH S IH Z
DELIGHTEDNESS	D IH L AY T AH D N AH S
DELIGHTEDNESSES	D IH L AY T AH D N AH S IH Z
DELIGHTFULNESS	D IH L AY T F AH L N AH S
DELIGHTFULNESSES	D IH L AY T F AH L N AH S IH Z
DELINEATE	D IH L IH N IY EY T
DELINEATED	D IH L IH N IY EY T IH D
DELINEATES	D IH L IH N IY EY T S
DELINEATING	D IH L IH N IY EY T IH NG
DELINEATION	D IH L IH N IY EY SH AH N
DELINEATIONS	D IY L IH N IY EY SH AH N Z
DELINEATIVE	D IH L IH N IY EY T IH V
DELINEATOR	D IH L IH N IY EY T ER
DELINEATORS	D IH L IH N IY EY T ER Z
DELIRIOUSNESS	D AH L IH R IY AW Z N AH S
DELIRIOUSNESSES	D AH L IH R IY AW Z N EH S AH Z
DELUSIVENESS	D IH L AH S AY V N AH S
DELUSIVENESSES	D AH L AH S IH V AH N EH S AH Z
DEMAGNETIZATION	D IY M AE G N AH T AH Z EY SH AH N
DEMAGNETIZATIONS	D IY M AE G N AH T AH Z EY SH AH N Z
DEMAGNETIZE	D IY M AE G N AH T AY Z
DEMAGNETIZED	D IY M AE G N AH T AY Z D
DEMAGNETIZER	D IY M AE G N AH T AY Z ER
DEMAGNETIZERS	D IY M AE G N AH T AY Z ER Z
DEMAGNETIZES	D IY M AE G N AH T AY Z IH Z
DEMAGNETIZING	D IY M AE G N AH T AY Z IH NG
DEMANDINGNESS	D IH M AE N D IH NG N AH S
DEMANDINGNESSES	D IH M AE N D IH NG N AH S IH Z
DEMEANED	D IH M IY N D
DEMENTEDNESS	D IY M EH N T EH D N AH S
DEMENTEDNESSES	D IY M EH N T EH D N AH S IH Z
DEMESNE	D AH M EH Z N
DEMESNES	D AH M EH Z N Z
DEMILUNE	D IH M AH L UW N
DEMILUNES	D IH M AH L UW N Z
DEMIMONDAINE	D AH M IH M AH N D EY N
DEMIMONDAINES	D AH M IH M AH N D EY N Z
DEMINERALIZATION	D IY M IH N AH R AH L AH Z EY SH AH N
DEMINERALIZATIONS	D IY M IH N AH R AH L AH Z EY SH AH N Z
DEMINERALIZE	D IY M IH N AH R AH L AY Z
DEMINERALIZED	D IY M IH N AH R AH L AY Z D
DEMINERALIZER	D IY M IH N AH R AH L AY Z ER
DEMINERALIZERS	D IY M IH N AH R AH L AY Z ER Z
DEMINERALIZES	D IY M IH N AH R AH L AY Z IH Z
DEMINERALIZING	D IY M IH N AH R AH L AY Z IH NG
DEMONESS	D IY M AH N AH S
DEMONESSES	D IY M AH N AH S IH Z
DEMONETIZATION	D AH M AH N AH T AH Z EY SH AH N
DEMONETIZATIONS	D AH M AA N AH T AH Z EY T IY AH N Z
DEMONETIZE	D AH M AA N AH T AY Z
DEMONETIZED	D AH M AA N AH T AY Z D
DEMONETIZES	D AH M AA N AH T AY Z AH Z
DEMONETIZING	D AH M AA N AH T AY Z AH NG
DEMONSTRATIVENESS	D IH M AA N S T R AH T IH V N AH S
DEMONSTRATIVENESSES	D IH M AA N S T R AH T IH V N AH S IH Z
DEMURENESS	D IH M Y UH R N AH S
DEMURENESSES	D IH M Y UH R N AH S IH Z
DENE	D AH N IY
DENEGATION	D IY N IH G EY SH AH N
DENEGATIONS	D IY N IH G EY SH AH N Z
DENERVATE	D IY N ER V AH T
DENERVATED	D IY N ER V EY T IH D
DENERVATES	D IY N ER V AH T S
DENERVATING	D IY N ER V EY T IH NG
DENERVATION	D IY N ER V EY SH AH N
DENERVATIONS	D IY N ER V EY SH AH N Z
DENES	D IY N Z
DENIZENED	D EH N AY Z AH N D
DENNED	D EH N D
DENSENESS	D EH N S N AH S
DENSENESSES	D EH N S N AH S IH Z
DENTINE	D EH N T IY N
DENTINES	D EH N T AY N Z
DEPENDABLENESS	D IH P EH N D AH B AH L N AH S
DEPENDABLENESSES	D IH P EH N D AH B AH L N AH S IH Z
DEPLANE	D IY P L EY N
DEPLANED	D IY P L EY N D
DEPLANES	D IY P L EY N Z
DEPLORABLENESS	D IH P L OW R AH B AH L N AH S
DEPLORABLENESSES	D IH P L OW R AH B AH L N AH S IH Z
DEPONE	D AH P OW N
DEPONED	D AH P OW N D
DEPONENT	D AH P OW N AH N T
DEPONENTS	D AH P AA N AH N T S
DEPONES	D AH P OW N Z
DEPRAVEDNESS	D IH P R EY V AH D N AH S
DEPRAVEDNESSES	D IH P R EY V AH D N AH S IH Z
DERAIGNED	D AH R EY N D
DERISIVENESS	D IH R AY S IH V N AH S
DERISIVENESSES	D IH R AY S IH V N AH S IH Z
DERIVATIVENESS	D IH R IH V AH T IH V N AH S
DERIVATIVENESSES	D IH R IH V AH T IH V N AH S IH Z
DESCRIPTIVENESS	D IY S K R IH P T IH V N AH S
DESCRIPTIVENESSES	D IY S K R IH P T IH V N AH S IH Z
DESERVEDNESS	D IH Z ER V AH D N AH S
DESERVEDNESSES	D IH Z ER V AH D N AH S IH Z
DESIGNED	D IH Z AY N D
DESIGNEDLY	D IH Z AY N AH D L IY
DESIGNEE	D EH Z IH G N IY
DESIGNEES	D EH Z IH G N IY Z
DESIGNER	D IH Z AY N ER
DESIGNERS	D IH Z AY N ER Z
DESINENT	D IY S AY N AH N T
DESIPRAMINE	D AH S IH P R AH M AY N
DESIPRAMINES	D AH S IH P R AH M AY N Z
DESIRABLENESS	D IH Z AY ER AH B AH L N AH S
DESIRABLENESSES	D IH Z AY ER AH B AH L N AH S IH Z
DESIROUSNESS	D IH Z AY ER AH S N AH S
DESIROUSNESSES	D IH Z AY ER AH S N AH S IH Z
DESOLATENESS	D EH S AH L AH T N AH S
DESOLATENESSES	D EH S AH L AH T N AH S IH Z
DESPERATENESS	D EH S P R AH T N AH S
DESPERATENESSES	D EH S P R AH T N AH S IH Z
DESPICABLENESS	D IY S P AY S AH B AH L N AH S
DESPICABLENESSES	D IY S P AY S AH B AH L N AH S IH Z
DESPITEFULNESS	D IH S P AY T F AH L N AH S
DESPITEFULNESSES	D IH S P AY T F AH L N AH S IH Z
DESTAINED	D IY S T EY N D
DESTINE	D EH S T AH N
DESTINED	D EH S T IH N D
DESTINES	D EH S T AH N Z
DESTITUTENESS	D EH S T AH T UW T N AH S
DESTITUTENESSES	D EH S T AH T UW T N AH S IH Z
DESTRUCTIVENESS	D IH S T R AH K T IH V N IH S
DESTRUCTIVENESSES	D IH S T R AH K T IH V N AH S IH Z
DESULTORINESS	D EH S AH L T OW R IY N AH S
DESULTORINESSES	D EH S AH L T OW R IY N AH S IH Z
DETACHEDNESS	D IH T AE CH AH D N AH S
DETACHEDNESSES	D IH T AE CH AH D N AH S IH Z
DETAILEDNESS	D IH T EY L AH D N AH S
DETAILEDNESSES	D IH T EY L AH D N AH S IH Z
DETAINED	D IH T EY N D
DETAINEE	D IY T EY N IY
DETAINEES	D IH T EY N IY Z
DETAINER	D IH T EY N ER
DETAINERS	D IH T EY N ER Z
DETERMINABLENESS	D IY T ER M AH N AH B AH L N AH S
DETERMINABLENESSES	D IY T ER M AH N AH B AH L N AH S IH Z
DETERMINATENESS	D IY T ER M AH N AH T N AH S
DETERMINATENESSES	D IY T ER M AH N AH T N AH S IH Z
DETERMINE	D AH T ER M AH N
DETERMINE(2)	D IH T ER M AH N
DETERMINED	D IH T ER M AH N D
DETERMINEDLY	D AH T ER M AH N AH D L IY
DETERMINEDLY(2)	D AH T ER M AH N D L IY
DETERMINEDNESS	D AH T ER M AH N AH D N AH S
DETERMINEDNESSES	D AH T ER M AH N AH D N AH S IH Z
DETERMINER	D IY T ER M AH N ER
DETERMINERS	D IY T ER M AH N ER Z
DETERMINES	D AH T ER M AH N Z
DETERMINES(2)	D IH T ER M AH N Z
DETESTABLENESS	D IH T EH S T AH B AH L N AH S
DETESTABLENESSES	D IH T EH S T AH B AH L N AH S IH Z
DETHRONE	D IH TH R OW N
DETHRONE(2)	D IY TH R OW N
DETHRONED	D IH TH R OW N D
DETHRONED(2)	D IY TH R OW N D
DETHRONEMENT	D IY TH R OW N M AH N T
DETHRONEMENTS	D IY TH R OW N M AH N T S
DETHRONER	D IY TH R OW N ER
DETHRONERS	D IY TH R OW N ER Z
DETHRONES	D IY TH R OW N Z
DETRAINED	D IY T R EY N D
DEVEINED	D IY V EY N D
DEVILISHNESS	D IY V IH L IH SH N AH S
DEVILISHNESSES	D IY V IH L IH SH N AH S IH Z
DEVIOUSNESS	D IY V IY AH S N AH S
DEVIOUSNESSES	D IY V IY AH S N AH S IH Z
DEVOTEDNESS	D IH V OW T AH D N AH S
DEVOTEDNESSES	D IH V OW T AH D N AH S IH Z
DEVOUTNESS	D IH V AW T N AH S
DEVOUTNESSES	D IH V AW T N AH S IH Z
DEWINESS	D IY W AY N AH S
DEWINESSES	D IY W AY N AH S IH Z
DEXAMETHASONE	D AH Z AH M EH TH AH S OW N
DEXAMETHASONES	D AH Z AH M EH TH AH S OW N Z
DEXTEROUSNESS	D EH K S T ER AH S N AH S
DEXTEROUSNESSES	D EH K S T ER AH S N AH S IH Z
DEXTRINE	D IH Z T R AY N
DEXTRINES	D IH Z T R AY N Z
DEXTROAMPHETAMINE	D IH Z T R OW M F EH T AH M AY N
DEXTROAMPHETAMINES	D IH Z T R OW M F EH T AH M AY N Z
DIABOLICALNESS	D AY AH B AA L IH K AH L N AH S
DIABOLICALNESSES	D AY AH B AA L IH K AH L N AH S IH Z
DIAGENESES	D AY AE JH AH N IY Z AH Z
DIAGENESIS	D AY AH JH IY N AH S AH S
DIAGENETIC	D AY IH JH N EH T IH K
DIAGENETICALLY	D AY IH JH N EH T IH K AH L IY
DIAKINESES	D AY AE K AH N IY Z AH Z
DIAKINESIS	D AY AH K AY N AH S AH S
DIAMAGNETIC	D AY AH M AE G N EH T IH K
DIAMAGNETISM	D AY AH M AE G N IH T IH Z AH M
DIAMAGNETISMS	D AY AH M AE G N AH T AH Z AH M Z
DIAMINE	D AY AH M AY N
DIAMINES	D AY AH M AY N Z
DIAPHANEITIES	D AY AH F AH N AH T AY Z
DIAPHANEITY	D AY AH F AH N IY AH T IY
DIAPHANOUSNESS	D AY AE F AH N AH S N AH S
DIAPHANOUSNESSES	D AY AE F AH N AH S N AH S IH Z
DIAPHONE	D AY AH F OW N
DIAPHONES	D AY AH F OW N Z
DIAZINE	D AY AH Z AY N
DIAZINES	D AY AH Z AY N Z
DICHLOROBENZENE	D IH K L AH R AA B AH N Z IY N
DICHLOROBENZENES	D IH K L AH R AA B AH N Z IY N Z
DICHLORODIFLUOROMETHANE	D IH K L AH R AH D AH F L AH W AH R AA M AH TH EY N
DICHLORODIFLUOROMETHANES	D IH K L AH R AH D AH F L AH W AH R AA M AH TH EY N Z
DICHLOROETHANE	D IH K L AO R OW AH TH EY N
DICHLOROETHANES	D IH K L AO R OW AH TH EY N Z
DICHOTOMOUSNESS	D AH CH AA T AH M AW Z N AH S
DICHOTOMOUSNESSES	D AH CH AA T AH M AW Z N EH S AH Z
DICTATORIALNESS	D IH K T AH T OW R IY AH L N AH S
DICTATORIALNESSES	D IH K T AH T OW R IY AH L N AH S IH Z
DIENE	D IY N
DIENES	D IY N EH Z
DIETHYLCARBAMAZINE	D IY TH AH L K AA R B AE M AH Z AY N
DIETHYLCARBAMAZINES	D IY TH AH L K AA R B AE M AH Z AY N Z
DIFFERENTNESS	D IH F ER AH N T N AH S
DIFFERENTNESSES	D IH F ER AH N T N AH S IH Z
DIFFUSENESS	D IH F Y UW S N AH S
DIFFUSENESSES	D IH F Y UW S N AH S IH Z
DIFFUSIVENESS	D IH F Y UW S IH V N AH S
DIFFUSIVENESSES	D IH F Y UW S IH V N AH S IH Z
DIGENETIC	D IH JH AH N AH T AH K
DIGRESSIVENESS	D AY G R EH S IH V N AH S
DIGRESSIVENESSES	D AY G R EH S IH V N AH S IH Z
DIHYDROERGOTAMINE	D AH HH AH D R AH R G AA T AH M AY N
DIHYDROERGOTAMINES	D AH HH AH D R AH R G AA T AH M AY N Z
DIHYDROXYACETONE	D AH HH AH D R AH K S AY AE S AH T OW N
DIHYDROXYACETONES	D AH HH AH D R AH K S AY AE S AH T OW N Z
DILATORINESS	D AY L EY T ER IY N AH S
DILATORINESSES	D AY L EY T ER IY N AH S IH Z
DILUTENESS	D AH L UW T N AH S
DILUTENESSES	D AH L UW T N AH S IH Z
DIMENSIONED	D AH M EH N CH AH N D
DIMETHYLHYDRAZINE	D AH M AH TH AH L HH IH D R AH Z AY N
DIMETHYLHYDRAZINES	D AH M AH TH AH L HH IH D R AH Z AY N Z
DIMETHYLNITROSAMINE	D AH M AH TH AH L N IH T R AA S AH M AY N
DIMETHYLNITROSAMINES	D AH M AH TH AH L N IH T R AA S AH M AY N Z
DIMETHYLTRYPTAMINE	D AH M AH TH AH L T R IH P T AH M AY N
DIMETHYLTRYPTAMINES	D AH M AH TH AH L T R IH P T AH M AY N Z
DIMINUTIVENESS	D AH M IH N Y AH T IH V N AH S
DIMINUTIVENESSES	D AH M IH N Y AH T IH V N AH S IH Z
DIMNESS	D IH M N AH S
DIMNESSES	D IH M N AH S IH Z
DINE	D AY N
DINED	D AY N D
DINER	D AY N ER
DINERIC	D AY N ER IH K
DINERO	D IH N AH R OW
DINEROS	D AY N ER AA S
DINERS	D AY N ER Z
DINES	D AY N Z
DINETTE	D AY N EH T
DINETTES	D AY N EH T S
DINGINESS	D IH N JH IY N AH S
DINGINESSES	D IH N JH IY N AH S IH Z
DINITROBENZENE	D AH N IH T R AA B AH N Z IY N
DINITROBENZENES	D AH N IH T R AA B AH N Z IY N Z
DINNED	D IH N D
DINNER	D IH N ER
DINNERLESS	D IH N ER L AH S
DINNERS	D IH N ER Z
DINNERTIME	D IH N ER T AY M
DINNERTIMES	D IH N ER T AY M Z
DINNERWARE	D IH N ER W EH R
DINNERWARES	D IH N ER W EH R Z
DIOXANE	D AY AH K S EY N
DIOXANES	D AY AH K S EY N Z
DIPHENHYDRAMINE	D AH F AH N HH IH D R AH M AY N
DIPHENHYDRAMINES	D AH F AH N HH IH D R AH M AY N Z
DIPHENYLAMINE	D AH F AH N IH L AH M AY N
DIPHENYLAMINES	D AH F AH N IH L AH M AY N Z
DIPHOSGENE	D IH F AH Z IY N
DIPHOSGENES	D IH F AH Z IY N Z
DIPLOTENE	D IH P L AH T IY N
DIPLOTENES	D IH P L AH T IY N Z
DIPNET	D IH P N EH T
DIPNETS	D IH P N EH T S
DIPNETTED	D IH P N EH T IH D
DIPNETTING	D IH P N EH T IH NG
DIRECTEDNESS	D AH R EH K T AH D N AH S
DIRECTEDNESSES	D AH R EH K T AH D N AH S IH Z
DIRECTIONLESSNESS	D AH R EH K SH AH N L AH S N AH S
DIRECTIONLESSNESSES	D AH R EH K SH AH N L AH S N AH S IH Z
DIRECTNESS	D ER EH K T N AH S
DIRECTNESS(2)	D IY R EH K N AH S
DIRECTNESS(3)	D AY R EH K N AH S
DIRECTNESS(4)	D IH R EH K N AH S
DIRECTNESSES	D AH R EH K T N AH S IH Z
DIRENESS	D AY ER N AH S
DIRENESSES	D AY ER N AH S IH Z
DIRTINESS	D ER T IY N AH S
DIRTINESSES	D ER T IY N AH S IH Z
DISADVANTAGEDNESS	D IH S AH D V AE N T IH JH AH D N AH S
DISADVANTAGEDNESSES	D IH S AH D V AE N T IH JH AH D N AH S IH Z
DISADVANTAGEOUSNESS	D IH S AE D V AE N T EY JH AH S N AH S
DISADVANTAGEOUSNESSES	D IH S AE D V AE N T EY JH AH S N AH S IH Z
DISAGREEABLENESS	D IH S AH G R IY AH B AH L N AH S
DISAGREEABLENESSES	D IH S AH G R IY AH B AH L N AH S IH Z
DISBENEFIT	D IH S B EH N AH F IH T
DISBENEFITS	D IH S B EH N AH F IH T S
DISBURDENED	D IH S B ER D AH N D
DISCERNED	D IH S ER N D
DISCERNER	D IH S ER N ER
DISCERNERS	D IH S ER N ER Z
DISCIPLINE	D IH S AH P L AH N
DISCIPLINED	D IH S AH P L AH N D
DISCIPLINER	D IH S AH P L AH N ER
DISCIPLINERS	D IH S AH P L AH N ER Z
DISCIPLINES	D IH S AH P L AH N Z
DISCONNECT	D IH S K AH N EH K T
DISCONNECTED	D IH S K AH N EH K T IH D
DISCONNECTEDLY	D IH S K AH N EH K T AH D L IY
DISCONNECTEDNESS	D IH S K AH N EH K T AH D N AH S
DISCONNECTEDNESSES	D IH S K AH N EH K T AH D N AH S IH Z
DISCONNECTING	D IH S K AH N EH K T IH NG
DISCONNECTION	D IH S K AH N EH K SH AH N
DISCONNECTIONS	D IH S K AH N EH K SH AH N Z
DISCONNECTS	D IH S K AH N EH K T S
DISCONSOLATENESS	D IH S K AH N S OW L AH T N AH S
DISCONSOLATENESSES	D IH S K AH N S OW L AH T N AH S IH Z
DISCONTENTEDNESS	D IH S K AH N T EH N T IH D N AH S
DISCONTENTEDNESSES	D IH S K AH N T EH N T AH D N AH S IH Z
DISCOURTEOUSNESS	D IH S K ER T IY AH S N AH S
DISCOURTEOUSNESSES	D IH S K ER T IY AH S N AH S IH Z
DISCREETNESS	D IH S K R IY T N AH S
DISCREETNESSES	D IH S K R IY T N AH S IH Z
DISCRETENESS	D IH S K R IY T N AH S
DISCRETENESSES	D IH S K R IY T N AH S IH Z
DISCROWNED	D IH S K R AW N D
DISCURSIVENESS	D IH S K ER S IH V N AH S
DISCURSIVENESSES	D IH S K ER S IH V N AH S IH Z
DISDAINED	D IH S D EY N D
DISDAINFULNESS	D IH S D EY N F AH L N AH S
DISDAINFULNESSES	D IH S D EY N F AH L N AH S IH Z
DISGRACEFULNESS	D IH S G R EY S F AH L N AH S
DISGRACEFULNESSES	D IH S G R EY S F AH L N AH S IH Z
DISHEARTENED	D IH S HH AA R T AH N D
DISHONEST	D IH S AA N AH S T
DISHONESTIES	D IH S AA N AH S T IY Z
DISHONESTLY	D IH S AO N AH S T L IY
DISHONESTY	D IH S AA N AH S T IY
DISHONORABLENESS	D IH S AA N ER AH B AH L N AH S
DISHONORABLENESSES	D IH S AA N ER AH B AH L N AH S IH Z
DISILLUSIONED	D IH S IH L UW ZH AH N D
DISINCLINE	D IH S IH N K L AY N
DISINCLINED	D IH S IH N K L AY N D
DISINCLINES	D IH S IH N K L AY N Z
DISINGENUOUSNESS	D IH S IH N JH EH N Y UW AH S N AH S
DISINGENUOUSNESSES	D AH S AH N JH EH N Y UW AW Z N EH S AH Z
DISINTERESTEDNESS	D IH S IH N T R AH S T AH D N AH S
DISINTERESTEDNESSES	D IH S IH N T R AH S T AH D N AH S IH Z
DISJOINED	D IH S JH OY N D
DISJOINTEDNESS	D IH S JH OY N T AH D N AH S
DISJOINTEDNESSES	D IH S JH OY N T AH D N AH S IH Z
DISLIMNED	D IH S L IH M D
DISMALNESS	D IH Z M AH L N AH S
DISMALNESSES	D IH Z M AH L N AH S IH Z
DISORDEREDNESS	D IH S AO R D ER AH D N AH S
DISORDEREDNESSES	D IH S AO R D ER AH D N AH S IH Z
DISORDERLINESS	D IH S AO R D ER L IY N AH S
DISORDERLINESSES	D IH S AO R D ER L IY N AH S IH Z
DISOWNED	D IH S OW N D
DISPARATENESS	D IH S P AH R AH T N AH S
DISPARATENESSES	D IH S P AH R AH T N AH S IH Z
DISPASSIONATENESS	D IH S P AE SH AH N AH T N AH S
DISPASSIONATENESSES	D IH S P AE SH AH N AH T N AH S IH Z
DISPERSIVENESS	D IH S P ER S IH V N AH S
DISPERSIVENESSES	D IH S P ER S IH V N AH S IH Z
DISPIRITEDNESS	D IH S IH R AH T EH D N AH S
DISPIRITEDNESSES	D IH S IH R AH T EH D N EH S AH Z
DISPROPORTIONED	D IH S P R OW P OW R SH AH N D
DISPUTATIOUSNESS	D IH S P Y UW T AH T IY AH S N AH S
DISPUTATIOUSNESSES	D IH S P Y UW T AH T IY AH S N AH S IH Z
DISREPUTABLENESS	D IH S R EH P Y AH T AH B AH L N AH S
DISREPUTABLENESSES	D IH S R EH P Y AH T AH B AH L N AH S IH Z
DISRESPECTFULNESS	D IH S R IH S P EH K T F AH L N AH S
DISRESPECTFULNESSES	D IH S R IH S P EH K T F AH L N AH S IH Z
DISRUPTIVENESS	D IH S R AH P T IH V N AH S
DISRUPTIVENESSES	D IH S R AH P T IH V N AH S IH Z
DISSIPATEDNESS	D IH S AH P EY T AH D N AH S
DISSIPATEDNESSES	D IH S AH P EY T AH D N AH S IH Z
DISSOLUTENESS	D IH S AH L UW T N AH S
DISSOLUTENESSES	D IH S AH L UW T AH N EH S AH Z
DISSUASIVENESS	D IH S W AH S AY V N AH S
DISSUASIVENESSES	D IH S W AH S IH V AH N EH S AH Z
DISTAINED	D IH S T EY N D
DISTANTNESS	D IH S T AH N T N AH S
DISTANTNESSES	D IH S T AH N T N AH S IH Z
DISTASTEFULNESS	D IH S T EY S T F AH L N AH S
DISTASTEFULNESSES	D IH S T EY S T F AH L N AH S IH Z
DISTINCTIVENESS	D IH S T IH NG K T IH V N AH S
DISTINCTIVENESSES	D IH S T IH NG K T IH V N AH S IH Z
DISTINCTNESS	D IH S T IH NG K T N AH S
DISTINCTNESSES	D IH S T IH NG K T N AH S IH Z
DISTRAINED	D IH S T R EY N D
DISTRAINER	D IH S T R EY N ER
DISTRAINERS	D IH S T R EY N ER Z
DISTRESSFULNESS	D IH S T R EH S F AH L N AH S
DISTRESSFULNESSES	D IH S T R EH S F AH L N AH S IH Z
DISTRUSTFULNESS	D IH S T R AH S T F AH L N AH S
DISTRUSTFULNESSES	D IH S T R AH S T F AH L N AH S IH Z
DIVERSENESS	D AY V ER S N AH S
DIVERSENESSES	D AY V ER S N AH S IH Z
DIVIDEDNESS	D AH V AY D AH D N AH S
DIVIDEDNESSES	D AH V AY D AH D N AH S IH Z
DIVINE	D IH V AY N
DIVINED	D AH V AY N D
DIVINELY	D IH V AY N L IY
DIVINER	D AH V AY N ER
DIVINERS	D AH V AY N ER Z
DIVINES	D AH V AY N Z
DIVINEST	D AH V AY N AH S T
DIVISIVENESS	D IH V AY S IH V N AH S
DIVISIVENESSES	D AH V IH Z IH V N AH S IH Z
DIZENED	D AH Z IY N D
DIZZINESS	D IH Z IY N AH S
DIZZINESSES	D IH Z IY N AH S IH Z
DOBLONES	D AA B L OW N Z
DOCTRINE	D AA K T R AH N
DOCTRINE(2)	D AO K T ER IH N
DOCTRINES	D AA K T R AH N Z
DODGINESS	D AA JH IY N AH S
DODGINESSES	D AA JH IY N AH S IH Z
DOGBANE	D AO G B EY N
DOGBANES	D AO G B EY N Z
DOGGEDNESS	D AO G AH D N AH S
DOGGEDNESSES	D AO G AH D N AH S IH Z
DOGGISHNESS	D AO G IH SH N AH S
DOGGISHNESSES	D AO G IH SH N AH S IH Z
DOGGONE	D AO G AO N
DOGGONED	D AO G AO N D
DOGGONEDER	D AO G AO N D ER
DOGGONEDEST	D AO G AO N D AH S T
DOGGONER	D AO G AO N ER
DOGGONES	D AO G AO N Z
DOGGONEST	D AO G OW N EH S T
DOGMATICALNESS	D AO G M AE T IH K AH L N AH S
DOGMATICALNESSES	D AO G M AE T IH K AH L N AH S IH Z
DOGVANE	D AA G EY N
DOGVANES	D AA G EY N Z
DOLEFULNESS	D OW L F AH L N AH S
DOLEFULNESSES	D OW L F AH L N AH S IH Z
DOLLISHNESS	D AA L IH SH N AH S
DOLLISHNESSES	D AA L IH SH N AH S IH Z
DOLOROUSNESS	D OW L ER AH S N AH S
DOLOROUSNESSES	D OW L ER AH S N AH S IH Z
DOLTISHNESS	D OW L T IH SH N AH S
DOLTISHNESSES	D OW L T IH SH N AH S IH Z
DOMINE	D OW M IY N IY
DOMINEER	D AA M AH N IH R
DOMINEERED	D AA M AH N IH R D
DOMINEERING	D AA M AH N IH R IH NG
DOMINEERINGLY	D AA M AH N IH R IH NG L IY
DOMINEERINGNESS	D AA M AH N IY R IH NG N AH S
DOMINEERINGNESSES	D AA M AH N IY R IH NG N AH S IH Z
DOMINEERS	D AA M AH N IH R Z
DOMINES	D UW M AY N Z
DONE	D AH N
DONEE	D AA N IY
DONEES	D AA N IY Z
DONENESS	D AA N AH N AH S
DONENESSES	D AA N AH N AH S IH Z
DONNE	D AH N
DONNED	D AA N D
DONNEE	D AA N IY
DONNEES	D AA N IY Z
DONNERD	D AA N AH R D
DONNERED	D AA N ER D
DONNERT	D AA N AH R T
DONNISHNESS	D AA N IH SH N AH S
DONNISHNESSES	D AA N IH SH N AH S IH Z
DOPAMINE	D AA P AH M AY N
DOPAMINERGIC	D AH P AE M AH N AH R JH AH K
DOPAMINES	D AA P AH M AY N Z
DOPINESS	D OW P IY N AH S
DOPINESSES	D OW P IY N AH S IH Z
DORNECK	D AO R N AH K
DORNECKS	D AO R N AH K S
DOTTINESS	D AA T IY N AH S
DOTTINESSES	D AA T IY N AH S IH Z
DOUBLENESS	D AH B AH L N AH S
DOUBLENESSES	D AH B AH L N AH S IH Z
DOUBTFULNESS	D AW T F AH L N AH S
DOUBTFULNESSES	D AW T F AH L N AH S IH Z
DOUBTLESSNESS	D AW T L AH S N AH S
DOUBTLESSNESSES	D AW T L AH S N AH S IH Z
DOUGHTINESS	D OW T AY N AH S
DOUGHTINESSES	D OW T AY N AH S IH Z
DOURINE	D UW Y UH R AH N
DOURINES	D UW Y UH R AH N Z
DOURNESS	D AW ER N AH S
DOURNESSES	D AW ER N AH S IH Z
DOVENED	D AH V AH N D
DOVISHNESS	D AH V IH SH N AH S
DOVISHNESSES	D AH V IH SH N AH S IH Z
DOWDINESS	D AW D AY N AH S
DOWDINESSES	D AW D AY N AH S IH Z
DOWNED	D AW N D
DOWNER	D AW N ER
DOWNERS	D AW N ER Z
DOWNHEARTEDNESS	D AW N HH AA R T AH D N AH S
DOWNHEARTEDNESSES	D AW N HH AA R T AH D N AH S IH Z
DOWNRIGHTNESS	D AW N R AY T N AH S
DOWNRIGHTNESSES	D AW N R AY T N AH S IH Z
DOWNTOWNER	D AW N T AW N ER
DOWNTOWNERS	D AW N T AW N ER Z
DOWNWARDNESS	D AW N W ER D N AH S
DOWNWARDNESSES	D AW N W ER D N AH S IH Z
DOXYCYCLINE	D AA K S IH S AH K L AY N
DOXYCYCLINES	D AA K S IH S AH K L AY N Z
DOYENNE	D OY AH N
DOYENNES	D OY AH N Z
DOZENED	D AH Z AH N D
DOZINESS	D OW Z IY N AH S
DOZINESSES	D OW Z IY N AH S IH Z
DRABNESS	D R AE B N AH S
DRABNESSES	D R AE B N AH S IH Z
DRAFTINESS	D R AE F T IY N AH S
DRAFTINESSES	D R AE F T IY N AH S IH Z
DRAGLINE	D R AE G L AY N
DRAGLINES	D R AE G L AY N Z
DRAGNET	D R AE G N EH T
DRAGNETS	D R AE G N EH T S
DRAGONET	D R AE G AH N AH T
DRAGONETS	D R AE G AH N AH T S
DRAGOONED	D R AH G UW N D
DRAINED	D R EY N D
DRAINER	D R EY N ER
DRAINERS	D R EY N ER Z
DREADFULNESS	D R EH D F AH L N AH S
DREADFULNESSES	D R EH D F AH L N AH S IH Z
DREAMFULNESS	D R IY M F AH L N AH S
DREAMFULNESSES	D R IY M F AH L N AH S IH Z
DREAMINESS	D R IY M IY N AH S
DREAMINESSES	D R IY M IY N AH S IH Z
DREAMLESSNESS	D R IY M L AH S N AH S
DREAMLESSNESSES	D R IY M L AH S N AH S IH Z
DREARINESS	D R IY R IY N AH S
DREARINESSES	D R IH ER IY N AH S IH Z
DRESSINESS	D R EH S IY N AH S
DRESSINESSES	D R EH S IY N AH S IH Z
DRIPSTONE	D R IH P S T OW N
DRIPSTONES	D R IH P S T OW N Z
DRIVELINE	D R AY V L AY N
DRIVELINES	D R AY V L AY N Z
DRIVENNESS	D R AY V AH N AH S
DRIVENNESSES	D R AY V AH N AH S IH Z
DROLLNESS	D R AA L N AH S
DROLLNESSES	D R AA L N EH S AH Z
DRONE	D R OW N
DRONED	D R OW N D
DRONER	D R OW N ER
DRONERS	D R OW N ER Z
DRONES	D R OW N Z
DROUGHTINESS	D R AW T IY N AH S
DROUGHTINESSES	D R AW T IY N AH S IH Z
DROWNED	D R AW N D
DROWNER	D R AW N ER
DROWNERS	D R AW N ER Z
DROWSINESS	D R AW Z IY N AH S
DROWSINESSES	D R AW Z IY N AH S IH Z
DRUNKENNESS	D R AH NG K AH N N AH S
DRUNKENNESSES	D R AH NG K AH N AH S IH Z
DRYNESS	D R AY N AH S
DRYNESSES	D R AY N AH S IH Z
DRYOPITHECINE	D R AY AH P IH TH AH S AY N
DRYOPITHECINES	D R AY AH P IH TH AH S AY N Z
DRYSTONE	D R AY S T OW N
DUBIOUSNESS	D UW B IY AH S N AH S
DUBIOUSNESSES	D UW B IY AH S N AH S IH Z
DUBONNET	D AH B AO N EH T
DUBONNETS	D AH B AO N EH T S
DUENESS	D UW N AH S
DUENESSES	D UW N AH S IH Z
DULCINEA	D AH L S IH N IY AH
DULCINEAS	D AH L S AH N IY Z
DULLNESS	D AH L N AH S
DULLNESSES	D AH L N AH S IH Z
DULNESS	D AH L N AH S
DULNESSES	D AH L N EH S AH Z
DUMBCANE	D AH M K EY N
DUMBCANES	D AH M K EY N Z
DUMBNESS	D AH M N AH S
DUMBNESSES	D AH M N AH S IH Z
DUMPINESS	D AH M P IY N AH S
DUMPINESSES	D AH M P IY N AH S IH Z
DUNE	D UW N
DUNELAND	D UW N L AE N D
DUNELANDS	D UW N L AE N D Z
DUNELIKE	D UW N L AY K
DUNES	D UW N Z
DUNGEONED	D AH N JH AH N D
DUNNED	D AH N D
DUNNER	D AH N ER
DUNNESS	D AH N AH S
DUNNESSES	D AH N AH S IH Z
DUNNEST	D AH N AH S T
DUOTONE	D Y UW AH T OW N
DUOTONES	D Y UW AH T OW N Z
DURABLENESS	D UH R AH B AH L N AH S
DURABLENESSES	D UH R AH B AH L N AH S IH Z
DURNED	D AH R N D
DURNEDER	D AH R N IY D AH R
DURNEDEST	D AH R N IY D AH S T
DUSKINESS	D AH S K IY N AH S
DUSKINESSES	D AH S K IY N AH S IH Z
DUSTINESS	D AH S T IY N AH S
DUSTINESSES	D AH S T IY N AH S IH Z
DUTIFULNESS	D UW T IY F AH L N AH S
DUTIFULNESSES	D UW T IY F AH L N AH S IH Z
DUVETINE	D Y UW V AH T AY N
DUVETINES	D Y UW V AH T AY N Z
DUVETYNE	D Y UW V AH T AY N
DUVETYNES	D Y UW V AH T AY N Z
DWARFISHNESS	D W AO R F IH SH N AH S
DWARFISHNESSES	D W AO R F IH SH N AH S IH Z
DWARFNESS	D W AO R F N AH S
DWARFNESSES	D W AO R F N AH S IH Z
DWINE	D W AY N
DWINED	D W AY N D
DWINES	D W AY N Z
DYNE	D AY N
DYNEIN	D AH N IY N
DYNEINS	D AH N IY N Z
DYNEL	D IH N AH L
DYNELS	D IH N AH L Z
DYNES	D AY N Z
DYSGENESES	D IH Z AH N IY Z AH Z
DYSGENESIS	D IH Z IY N AH S AH S
DYSKINESIA	D IH S AH N IY ZH IY AH
DYSKINESIAS	D IH S AH N IY S IY AH Z
DYSKINETIC	D IH S AH N AH T AH K
DYSPNEA	D IH S P N IY AH
DYSPNEAL	D IH S N IY AH L
DYSPNEAS	D IH S N IY Z
DYSPNEIC	D IH S N IY AH K
EAGERNESS	IY G ER N AH S
EAGERNESSES	IY G ER N AH S IH Z
EARLINESS	ER L IY N AH S
EARLINESSES	ER L IY N AH S IH Z
EARNED	ER N D
EARNER	ER N ER
EARNERS	ER N ER Z
EARNEST	ER N IH S T
EARNESTLY	ER N AH S T L IY
EARNESTNESS	ER N AH S T N AH S
EARNESTNESSES	ER N AH S T N AH S IH Z
EARNESTS	ER N AH S T S
EARPHONE	IH R F OW N
EARPHONE(2)	IY R F OW N
EARPHONES	IH R F OW N Z
EARPHONES(2)	IY R F OW N Z
EARSTONE	IH ER S T OW N
EARSTONES	IH ER S T OW N Z
EARTHINESS	ER TH IY N AH S
EARTHINESSES	ER TH IY N AH S IH Z
EARTHLINESS	ER TH L IY N AH S
EARTHLINESSES	ER TH L IY N AH S IH Z
EARTHSHINE	ER TH SH AY N
EARTHSHINES	ER TH SH AY N Z
EARWITNESS	IH ER W IH T N AH S
EARWITNESSES	IH ER W IH T N AH S IH Z
EASINESS	IY Z IY N AH S
EASINESSES	IY Z IY N AH S IH Z
EASTERNER	IY S T ER N ER
EASTERNERS	IY S T ER N ER Z
EASYGOINGNESS	IY Z IY G OW IH NG N AH S
EASYGOINGNESSES	IY Z IY G OW IH NG N AH S IH Z
ECCRINE	EH K R AY N
ECDYSONE	EH K D AH S OW N
ECDYSONES	EH K D AH S OW N Z
ECHELONED	EH SH AH L AA N D
ECOTONE	EH K AH T OW N
ECOTONES	EH K AH T OW N Z
EDGINESS	EH JH IY N AH S
EDGINESSES	EH JH IY N AH S IH Z
EDIBLENESS	EH D AH B AH L N AH S
EDIBLENESSES	EH D AH B AH L N AH S IH Z
EDUCATEDNESS	EH JH AH K AH T AH D N AH S
EDUCATEDNESSES	EH JH AH K AH T AH D N AH S IH Z
EDUCATIONESE	EH D Y AH K EY T IY AH N IY Z
EDUCATIONESES	EH D Y AH K EY T IY AH N IY Z AH Z
EERINESS	IH R AH N AH S
EERINESSES	IH R AH N EH S AH Z
EFFECTIVENESS	IH F EH K T IH V N AH S
EFFECTIVENESS(2)	IY F EH K T IH V N AH S
EFFECTIVENESSES	IH F EH K T IH V N AH S IH Z
EFFECTUALNESS	IH F EH K CH AH W AH L N AH S
EFFECTUALNESSES	IH F EH K CH AH W AH L N AH S IH Z
EFFETENESS	EH F IY T N AH S
EFFETENESSES	EH F IY T N AH S IH Z
EFFICACIOUSNESS	EH F AH K EY SH AH S N AH S
EFFICACIOUSNESSES	EH F AH K EY SH AH S N AH S IH Z
EFFORTFULNESS	EH F ER T F AH L N AH S
EFFORTFULNESSES	EH F ER T F AH L N AH S IH Z
EFFORTLESSNESS	EH F ER T L AH S N AH S
EFFORTLESSNESSES	EH F ER T L AH S N AH S IH Z
EFFUSIVENESS	IH F Y UW Z IH V N AH S
EFFUSIVENESSES	IH F Y UW Z IH V N AH S IH Z
EGGHEADEDNESS	EH G HH EH D AH D N AH S
EGGHEADEDNESSES	EH G HH EH D AH D N AH S IH Z
EGLANTINE	EH G L AH N T AY N
EGLANTINES	EH G L AH N T AY N Z
EGREGIOUSNESS	IH G R IY JH AH S N AH S
EGREGIOUSNESSES	IH G R IY JH AH S N AH S IH Z
EIKONES	IY K OW N Z
EKTEXINE	EH K T AH K S AY N
EKTEXINES	EH K T AH K S AY N Z
ELABORATENESS	IH L AE B AH R AH T N AH S
ELABORATENESSES	IH L AE B AH R AH T N AH S IH Z
ELAPHINE	EH L AH F AY N
ELAPINE	EH L AH P AY N
ELATEDNESS	IH L EY T AH D N AH S
ELATEDNESSES	IH L EY T AH D N AH S IH Z
ELDERLINESS	EH L D ER L IY N AH S
ELDERLINESSES	EH L D ER L IY N AH S IH Z
ELECAMPANE	AH L EH K AH M P EY N
ELECAMPANES	AH L EH K AH M P EY N Z
ELECTIONEER	IH L EH K SH AH N IH R
ELECTIONEERED	IH L EH K SH AH N IH R D
ELECTIONEERER	IH L EH K SH AH N IH R ER
ELECTIONEERERS	IH L EH K SH AH N IH R ER Z
ELECTIONEERING	IH L EH K SH AH N IH R IH NG
ELECTIONEERS	IH L EH K SH AH N IH R Z
ELECTIVENESS	IH L EH K T IH V N AH S
ELECTIVENESSES	IH L EH K T IH V N AH S IH Z
ELECTROGENESES	AH L EH K T R AA JH AH N IY Z AH Z
ELECTROGENESIS	AH L EH K T R AH JH IY N AH S AH S
ELECTROKINETIC	EH L AH K T R AA K AH N AH T AH K
ELECTROKINETICS	AH L EH K T R AH K IH N AH T AH S Z
ELECTROLUMINESCENCE	AH L EH K T R AH L AH M AH N EH S AH N S
ELECTROLUMINESCENCES	AH L EH K T R AH L AH M AH N AH S EH N S AH Z
ELECTROLUMINESCENT	AH L EH K T R AH L AH M AH N EH S AH N T
ELECTROMAGNET	IH L EH K T R OW M AE G N AH T
ELECTROMAGNETIC	IH L EH K T R OW M AE G N EH T IH K
ELECTROMAGNETICALLY	IH L EH K T R OW M AE G N AH T IH K AH L IY
ELECTROMAGNETISM	IH L EH K T R OW M AE G N AH T IH Z AH M
ELECTROMAGNETISMS	IH L EH K T R OW M AE G N AH T IH Z AH M Z
ELECTROMAGNETS	IH L EH K T R OW M AE G N AH T S
ELECTRONEGATIVE	AH L EH K T R AH N AH G EY T AH V
ELECTRONEGATIVITIES	AH L AH K T R AA N AH G AH T IH V AH T AY Z
ELECTRONEGATIVITY	AH L EH K T R AA N AH G AH T IH V AH T IY
ELEMENTARINESS	EH L AH M EH N T R IY N AH S
ELEMENTARINESSES	EH L AH M EH N T R IY N AH S IH Z
ELEPHANTINE	EH L AH F AE N T IY N
ELOIGNED	AH L OY N D
ELOIGNER	AH L OY N AH R
ELOIGNERS	AH L OY G N AH R Z
ELOINED	AH L OY N D
ELOINER	AH L OY N AH R
ELOINERS	AH L OY N AH R Z
ELUSIVENESS	IH L UW S IH V N AH S
ELUSIVENESSES	IH L UW S IH V N AH S IH Z
EMBLAZONED	EH M B L EY Z AH N D
EMBLAZONER	IH M B L EY Z AH N ER
EMBLAZONERS	IH M B L EY Z AH N ER Z
EMBOLDENED	EH M B OW L D AH N D
EMBROWNED	IH M B R AW N D
EMBRYOGENESES	EH M B R IY OW JH IY N Z IH Z
EMBRYOGENESIS	EH M B R IY OW JH EH N AH S AH S
EMBRYOGENETIC	EH M B R IY OW JH AH N EH T IH K
EMETINE	IH M AH T AY N
EMETINES	IH M AH T AY N Z
EMINENCE	EH M AH N AH N S
EMINENCES	EH M AH N AH N S IH Z
EMINENCIES	EH M AH N AH N S IY Z
EMINENCY	EH M AH N AH N S IY
EMINENT	EH M AH N AH N T
EMINENTLY	EH M AH N AH N T L IY
EMOTIONLESSNESS	IH M OW SH AH N L AH S N AH S
EMOTIONLESSNESSES	IH M OW SH AH N L AH S N AH S IH Z
EMPANEL	IH M P AE N AH L
EMPANELED	IH M P AE N AH L D
EMPANELING	EH M P AE N AH L IH NG
EMPANELLED	IH M P AE N AH L D
EMPANELLING	IH M P AE N AH L IH NG
EMPANELS	IH M P AE N AH L Z
EMPLANE	IH M P L EY N
EMPLANED	IH M P L EY N D
EMPLANES	IH M P L EY N Z
EMPOISONED	IH M P OY Z AH N D
EMPTINESS	EH M P T IY N AH S
EMPTINESS(2)	EH M T IY N AH S
EMPTINESSES	EH M P T IY N AH S IH Z
EMULOUSNESS	EH M Y AH L AH S N AH S
EMULOUSNESSES	EH M Y AH L AH S N AH S IH Z
ENAMINE	EH N AH M AY N
ENAMINES	EH N AH M AY N Z
ENCHAINED	EH N CH EY N D
ENCRIMSONED	EH N K R IH M Z AH N D
ENDEXINE	IH N D AH Z AY N
ENDEXINES	IH N D AH Z AY N Z
ENDLESSNESS	EH N D L AH S N AH S
ENDLESSNESSES	EH N D L AH S N AH S IH Z
ENDOCRINE	EH N D OW K R AY N
ENDOCRINES	IH N D AA K R AY N Z
ENDURINGNESS	EH N D Y UH R IH NG N AH S
ENDURINGNESSES	EH N D Y UH R IH NG N AH S IH Z
ENEMA	EH N AH M AH
ENEMAS	EH N AH M AH Z
ENEMATA	AH N AH M AE T AH
ENEMIES	EH N AH M IY Z
ENEMY	EH N AH M IY
ENERGETIC	EH N ER JH EH T IH K
ENERGETICALLY	EH N ER JH EH T IH K L IY
ENERGETICS	EH N ER JH EH T IH K S
ENERGID	AH N AH R JH AH D
ENERGIDS	AH N AH R JH AH D Z
ENERGIES	EH N ER JH IY Z
ENERGISE	AH N AH R JH AY Z
ENERGISED	EH N ER JH IY Z D
ENERGISES	EH N ER JH IY Z IH Z
ENERGISING	EH N ER JH IY Z IH NG
ENERGIZATION	AH N AH R JH AH Z EY SH AH N
ENERGIZATIONS	AH N AH R JH AH Z EY T IY AH N Z
ENERGIZE	EH N ER JH AY Z
ENERGIZED	EH N ER JH AY Z D
ENERGIZER	EH N ER JH AY Z ER
ENERGIZERS	AH N AH R JH AH Z AH R Z
ENERGIZES	EH N ER JH AY Z IH Z
ENERGIZING	EH N ER JH AY Z IH NG
ENERGY	EH N ER JH IY
ENERVATE	EH N ER V EY T
ENERVATED	EH N ER V EY T IH D
ENERVATES	EH N ER V EY T S
ENERVATING	EH N ER V EY T IH NG
ENERVATION	EH N ER V EY SH AH N
ENERVATIONS	EH N ER V EY SH AH N Z
ENGINE	EH N JH AH N
ENGINE(2)	IH N JH AH N
ENGINED	EH N JH AH N D
ENGINEER	EH N JH AH N IH R
ENGINEERED	EH N JH AH N IY R D
ENGINEERING	EH N JH AH N IH R IH NG
ENGINEERINGS	EH N JH AH N IH R IH NG Z
ENGINEERS	EH N JH AH N IH R Z
ENGINERIES	EH N JH AH N AH R IY Z
ENGINERY	EH N JH AH N AH R IY
ENGINES	EH N JH AH N Z
ENGRAINED	EH N G R EY N D
ENJOINED	EH N JH OY N D
ENJOINER	EH N JH OY N ER
ENJOINERS	EH N JH OY N ER Z
ENJOYABLENESS	EH N JH OY AH B AH L N AH S
ENJOYABLENESSES	EH N JH OY AH B AH L N AH S IH Z
ENLIGHTENED	EH N L AY T AH N D
ENLIVENED	EH N L AY V AH N D
ENNEAD	IH N IY D
ENNEADIC	IH N IY D AH K
ENNEADS	IH N IY D Z
ENNEAGON	IH N IY G AH N
ENNEAGONS	IH N IY G AH N Z
ENORMOUSNESS	IH N AO R M AH S N AH S
ENORMOUSNESSES	IH N AO R M AH S N AH S IH Z
ENPLANE	EH N P L EY N
ENPLANED	EH N P L EY N D
ENPLANES	EH N P L EY N Z
ENSANGUINE	IH N S AE N G W AY N
ENSANGUINED	IH N S AE N G W AY N D
ENSANGUINES	IH N S AE N G W AY N Z
ENSHRINE	EH N SH R AY N
ENSHRINED	EH N SH R AY N D
ENSHRINEE	EH N SH R AY N IY
ENSHRINEES	EH N SH R AY N IY Z
ENSHRINEMENT	EH N SH R AY N M AH N T
ENSHRINEMENTS	EH N SH R AY N M AH N T S
ENSHRINES	EH N SH R AY N Z
ENTEROGASTRONE	IH N T AH R AA G AH S T R OW N
ENTEROGASTRONES	IH N T AH R AA G AH S T R OW N Z
ENTERTAINED	EH N T ER T EY N D
ENTERTAINED(2)	EH N ER T EY N D
ENTERTAINER	EH N T ER T EY N ER
ENTERTAINER(2)	EH N ER T EY N ER
ENTERTAINERS	EH N T ER T EY N ER Z
ENTERTAINERS(2)	EH N ER T EY N ER Z
ENTHRONE	EH N TH R OW N
ENTHRONED	EH N TH R OW N D
ENTHRONEMENT	EH N TH R OW N M AH N T
ENTHRONEMENTS	EH N TH R OW N M AH N T S
ENTHRONES	EH N TH R OW N Z
ENTIRENESS	IH N T AY ER N AH S
ENTIRENESSES	IH N T AY ER N AH S IH Z
ENTRAINED	EH N T R EY N D
ENTRAINER	EH N T R EY N ER
ENTRAINERS	EH N T R EY N ER Z
ENTREPRENEUR	AA N T R AH P R AH N ER
ENTREPRENEUR(2)	AA N T R AH P R AH N UH R
ENTREPRENEURIAL	AA N T R AH P R AH N ER IY AH L
ENTREPRENEURIALISM	EH N T R AH P R AH N UW R IY AH L IH Z AH M
ENTREPRENEURIALISMS	AA N T R AH P R AH N ER IY AH L IH Z AH M Z
ENTREPRENEURIALLY	AA N T R AH P R AH N ER IY AH L IY
ENTREPRENEURS	AA N T R AH P R AH N ER Z
ENTREPRENEURSHIP	AA N T R AH P R AH N ER SH IH P
ENTREPRENEURSHIPS	AA N T R AH P R AH N ER SH IH P S
ENTWINE	EH N T W AY N
ENTWINED	EH N T W AY N D
ENTWINES	EH N T W AY N Z
ENVIABLENESS	EH N V IY AH B AH L N AH S
ENVIABLENESSES	EH N V IY AH B AH L N AH S IH Z
ENVIOUSNESS	EH N V IY AH S N AH S
ENVIOUSNESSES	EH N V IY AH S N AH S IH Z
ENVIRONED	IH N V AY R AH N D
ENVISIONED	EH N V IH ZH AH N D
EOSINE	IY AH S AY N
EOSINES	IY AH S AY N Z
EPERGNE	EH P AH R N
EPERGNES	EH P AH R N Z
EPHEDRINE	IH F EH D R IH N
EPHEDRINES	EH F AH D R AY N Z
EPICENE	EH P AH S IY N
EPICENES	EH P AH S IY N Z
EPICONTINENTAL	EH P IH K AO N T AY N AH N T AH L
EPIGENE	EH P AH JH IY N
EPIGENESES	AH P IH JH AH N IY Z AH Z
EPIGENESIS	EH P AH JH IY N AH S AH S
EPIGENETIC	EH P IH JH AH N EH T IH K
EPIGENETICALLY	EH P AH JH AH N EH T IH K AH L IY
EPIGONE	EH P AH G OW N
EPIGONES	EH P AH G OW N Z
EPINEPHRIN	EH P AH N EH F R AH N
EPINEPHRINE	AH P IH N AH F R AY N
EPINEPHRINES	AH P IH N AH F R AY N Z
EPINEPHRINS	EH P AH N EH F R AH N Z
EPINEURIA	EH P AH N Y UW R IY AH
EPINEURIUM	EH P AH N Y UW R IY AH M
EPINEURIUMS	EH P AH N Y UW R IY AH M Z
EQUABLENESS	EH K W AA B L N AH S
EQUABLENESSES	EH K W AA B L AH N EH S AH Z
EQUESTRIENNE	EH K W AH S T R IY N
EQUESTRIENNES	EH K W AH S T R IY N Z
EQUINE	IY K W AY N
EQUINELY	IY K W AY N L IY
EQUINES	IY K W AY N Z
EQUITABLENESS	EH K W AH T AH B AH L N AH S
EQUITABLENESSES	EH K W AH T AH B AH L N AH S IH Z
EQUIVOCALNESS	IH K W IH V AH K AH L N AH S
EQUIVOCALNESSES	IH K W IH V AH K AH L N AH S IH Z
ERECTNESS	IH R EH K T N AH S
ERECTNESSES	IH R EH K T N AH S IH Z
ERGONOVINE	AH R G AA N AH V AY N
ERGONOVINES	AH R G AA N AH V AY N Z
ERGOTAMINE	AH R G AA T AH M AY N
ERGOTAMINES	AH R G AA T AH M AY N Z
ERMINE	ER M AH N
ERMINED	AH R M AY N D
ERMINES	AH R M AY N Z
ERNE	ER N
ERNES	AH R N Z
EROSIVENESS	IH R OW S IH V N AH S
EROSIVENESSES	IH R OW S IH V N AH S IH Z
ERRHINE	EH R AY N
ERRHINES	EH R AY N Z
ERRONEOUS	EH R OW N IY AH S
ERRONEOUS(2)	ER OW N IY AH S
ERRONEOUSLY	EH R OW N IY AH S L IY
ERRONEOUSNESS	IH R OW N IY AH S N AH S
ERRONEOUSNESSES	IH R OW N IY AH S N AH S IH Z
ERYTHROSINE	AH R IH TH R AH S AY N
ERYTHROSINES	AH R IH TH R AH S AY N Z
ESERINE	EH S AH R AY N
ESERINES	EH S AH R AY N Z
ESSENTIALNESS	IH S EH N CH AH L N AH S
ESSENTIALNESSES	IH S EH N CH AH L N AH S IH Z
ESTAMINET	EH S T AE M AH N AH T
ESTAMINETS	EH S T AE M AH N AH T S
ESTIMABLENESS	EH S T AH M AH B AH L N AH S
ESTIMABLENESSES	EH S T AH M AH B AH L N AH S IH Z
ESTRONE	EH S T R OW N
ESTRONES	EH S T R OW N Z
ESTUARINE	EH S T Y UW AH R AY N
ETAMINE	EH T AH M AY N
ETAMINES	EH T AH M AY N Z
ETERNALNESS	IH T ER N AH L N AH S
ETERNALNESSES	IH T ER N AH L N AH S IH Z
ETERNE	IH T ER N
ETHANE	EH TH EY N
ETHANES	AH TH EY N Z
ETHANOLAMINE	EH TH AH N AO L AH M AY N
ETHANOLAMINES	EH TH AH N AO L AH M AY N Z
ETHENE	EH TH IY N
ETHENES	AH TH IY N Z
ETHEREALNESS	IH TH IH R IY AH L N AH S
ETHEREALNESSES	IH TH IH R IY AH L N AH S IH Z
ETHICALNESS	EH TH IH K AH L N AH S
ETHICALNESSES	EH TH IH K AH L N AH S IH Z
ETHIONINE	EH TH IY AH N AY N
ETHIONINES	EH TH IY AH N AY N Z
ETHYLBENZENE	EH TH AH L B EH N Z IY N
ETHYLBENZENES	EH TH AH L B EH N Z IY N Z
ETHYLENE	EH TH AH L IY N
ETHYLENEDIAMINETETRAACETATE	AH TH AH L AH N IY D IY AE M AH N AH T EH T R AA S AH T EY T
ETHYLENEDIAMINETETRAACETATES	AH TH AH L AH N IY D IY AE M AH N AH T EH T R AA S AH T EY T S
ETHYLENES	EH TH AH L IY N Z
ETHYNE	AH TH AY N
ETHYNES	AH TH AY N Z
EUCAINE	Y UW K EY N
EUCAINES	Y UW K EY N Z
EUGEOSYNCLINE	Y UW JH IY AA S AH NG K L AY N
EUGEOSYNCLINES	Y UW JH IY AA S AH NG K L AY N Z
EUPHONIOUSNESS	Y UW F OW N IY AW Z N AH S
EUPHONIOUSNESSES	Y UW F OW N IY AW Z N EH S AH Z
EUPNEA	Y UW P N IY AH
EUPNEAS	Y UW P N IY Z
EUPNEIC	Y UW P N IY AH K
EURYHALINE	Y UW R IH HH AH L AY N
EVANESCE	EH V AH N EH S
EVANESCED	EH V AH N EH S T
EVANESCENCE	EH V AH N EH S AH N S
EVANESCENCES	EH V AH N AH S EH N S AH Z
EVANESCENT	EH V AH N EH S AH N T
EVANESCES	EH V AH N EH S AH Z
EVANESCING	EH V AH N EH S AH NG
EVASIVENESS	IH V EY S IH V N AH S
EVASIVENESSES	IH V EY S IH V N AH S IH Z
EVENED	IY V AH N D
EVENER	IY V AH N ER
EVENERS	IY V AH N ER Z
EVENEST	IY V AH N AH S T
EVENHANDEDNESS	IY V AH N HH AE N D AH D N AH S
EVENHANDEDNESSES	IY V AH N HH AE N D AH D N AH S IH Z
EVENNESS	IY V AH N N AH S
EVENNESSES	IY V AH N AH S IH Z
EVENTFULNESS	IH V EH N T F AH L N AH S
EVENTFULNESSES	IH V EH N T F AH L N AH S IH Z
EVERLASTINGNESS	EH V ER L AE S T IH NG N AH S
EVERLASTINGNESSES	EH V ER L AE S T IH NG N AH S IH Z
EVERYDAYNESS	EH V R IY D EY N AH S
EVERYDAYNESSES	EH V R IY D EY N AH S IH Z
EVERYONE	EH V R IY W AH N
EVILNESS	IY V AH L N AH S
EVILNESSES	IY V AH L N AH S IH Z
EVOCATIVENESS	IH V AA K AH T IH V N AH S
EVOCATIVENESSES	IH V AA K AH T IH V N AH S IH Z
EVZONE	EH V Z OW N
EVZONES	EH V Z OW N Z
EXACTINGNESS	IH G Z AE K T IH NG N AH S
EXACTINGNESSES	IH G Z AE K T IH NG N AH S IH Z
EXACTNESS	IH G Z AE K T N AH S
EXACTNESSES	IH G Z AE K T N AH S IH Z
EXAGGERATEDNESS	IH G Z AE JH ER AH T AH D N AH S
EXAGGERATEDNESSES	IH G Z AE JH ER AH T AH D N AH S IH Z
EXAMINE	IH G Z AE M IH N
EXAMINED	IH G Z AE M AH N D
EXAMINEE	EH G Z AE M AH N IY
EXAMINEES	EH G Z AE M AH N IY Z
EXAMINER	IH G Z AE M AH N ER
EXAMINERS	IH G Z AE M IH N ER Z
EXAMINES	IH G Z AE M AH N Z
EXCEPTIONALNESS	IH K S EH P SH AH N AH L N AH S
EXCEPTIONALNESSES	IH K S EH P SH AH N AH L N AH S IH Z
EXCESSIVENESS	EH K S EH S IH V N AH S
EXCESSIVENESSES	EH K S EH S IH V N AH S IH Z
EXCITABLENESS	IH K S AY T AH B AH L N AH S
EXCITABLENESSES	IH K S AY T AH B AH L N AH S IH Z
EXCLUSIVENESS	IH K S K L UW S IH V N AH S
EXCLUSIVENESSES	IH K S K L UW S IH V N AH S IH Z
EXCURSIVENESS	EH K S K ER S IH V N AH S
EXCURSIVENESSES	EH K S K ER S IH V N AH S IH Z
EXCUSABLENESS	IH K S K Y UW Z AH B AH L N AH S
EXCUSABLENESSES	IH K S K Y UW Z AH B AH L N AH S IH Z
EXECRABLENESS	IH G Z EH K R AE B L N AH S
EXECRABLENESSES	IH G Z EH K R AE B L AH N EH S AH Z
EXECUTIONER	EH K S AH K Y UW SH AH N ER
EXECUTIONERS	EH K S AH K Y UW SH AH N ER Z
EXEMPLARINESS	IH G Z EH M P L EH R IY N AH S
EXEMPLARINESSES	IH G Z EH M P L EH R IY N AH S IH Z
EXHAUSTIVENESS	IH G Z AO S T IH V N AH S
EXHAUSTIVENESSES	IH G Z AO S T IH V N AH S IH Z
EXHAUSTLESSNESS	IH G Z AO S T L AH S N AH S
EXHAUSTLESSNESSES	IH G Z AO S T L AH S N AH S IH Z
EXHIBITIONER	EH K S AH B IH SH AH N ER
EXHIBITIONERS	EH K S AH B IH SH AH N ER Z
EXIGUOUSNESS	IH G Z IH G W AW Z N AH S
EXIGUOUSNESSES	IH G Z IH G W AW Z N EH S AH Z
EXINE	IH G Z IH N
EXINES	IH G Z AY N Z
EXOCRINE	IH G Z AA K R AY N
EXOCRINES	IH G Z AA K R AY N Z
EXONERATE	IH G Z AA N ER EY T
EXONERATED	IH G Z AA N ER EY T IH D
EXONERATES	IH G Z AA N ER EY T S
EXONERATING	IH G Z AA N ER EY T IH NG
EXONERATION	IH G Z AA N ER EY SH AH N
EXONERATIONS	IH G Z AA N AH R EY SH AH N Z
EXONERATIVE	IH G Z AA N AH R EY T IH V
EXOTICNESS	IH G Z AA T IH K N AH S
EXOTICNESSES	IH G Z AA T IH K N AH S IH Z
EXPANSIVENESS	IH K S P AE N S IH V N AH S
EXPANSIVENESSES	IH K S P AE N S IH V N AH S IH Z
EXPECTEDNESS	IH K S P EH K T AH D N AH S
EXPECTEDNESSES	IH K S P EH K T AH D N AH S IH Z
EXPEDITIOUSNESS	EH K S P AH D IH SH AH S N AH S
EXPEDITIOUSNESSES	EH K S P AH D IH SH AH S N AH S IH Z
EXPENSIVENESS	EH K S P EH N S IH V N AH S
EXPENSIVENESSES	EH K S P EH N S IH V N AH S IH Z
EXPERTNESS	EH K S P ER T N AH S
EXPERTNESSES	EH K S P ER T N AH S IH Z
EXPLAINED	IH K S P L EY N D
EXPLAINER	IH K S P L EY N ER
AJAR	AH JH AA R
NO	N OW
FOAL	F OW L
RIFE	R AY F
GUPPIES	G AH P IY Z
PNEUMA	N Y UW M AH
LO	L OW
