NN	EH N
AGINNER	AH JH IH N ER
AGINNERS	AH JH IH N ER Z
ALIENNESS	EY L IY AH N AH S
ALIENNESSES	EY L IY AH N AH S IH Z
ANNA	AE N AH
ANNAL	AE N AH L
ANNALIST	AE N AH L AH S T
ANNALISTIC	AE N AH L AH S T AH K
ANNALISTS	AE N AH L AH S T S
ANNALS	AE N AH L Z
ANNAS	AE N AH Z
ANNATES	AE N EY T S
ANNATTO	AE N AE T OW
ANNATTOS	AE N AE T AH Z
ANNEAL	AH N IY L
ANNEALED	AE N IY L D
ANNEALER	AE N IY L AH R
ANNEALERS	AE N IY L AH R Z
ANNEALING	AH N IY L IH NG
ANNEALS	AE N IY L Z
ANNELID	AE N AH L IH D
ANNELIDAN	AE N EH L AH D AH N
ANNELIDANS	AE N EH L AH D AH N Z
ANNELIDS	AE N AH L IH D Z
ANNEX	AE N EH K S
ANNEX(2)	AH N EH K S
ANNEXATION	AE N EH K S EY SH AH N
ANNEXATIONAL	AH N EH K S EY SH AH N AH L
ANNEXATIONIST	AH N EH K S EY SH AH N IH S T
ANNEXATIONISTS	AH N EH K S EY SH AH N IH S T S
ANNEXATIONS	AH N EH K S EY SH AH N Z
ANNEXE	AE N AH K S
ANNEXED	AE N EH K S T
ANNEXED(2)	AH N EH K S T
ANNEXES	AE N EH K S IH Z
ANNEXING	AH N EH K S IH NG
ANNIHILATE	AH N AY AH L EY T
ANNIHILATED	AH N AY AH L EY T IH D
ANNIHILATES	AH N AY AH L EY T S
ANNIHILATING	AH N AY AH L EY T IH NG
ANNIHILATION	AH N AY AH L EY SH AH N
ANNIHILATIONS	AH N AY AH L EY SH AH N Z
ANNIHILATOR	AH N AY AH L EY T ER
ANNIHILATORS	AH N AY AH L EY T ER Z
ANNIHILATORY	AH N AY AH L EY T ER IY
ANNIVERSARIES	AE N AH V ER S ER IY Z
ANNIVERSARY	AE N AH V ER S ER IY
ANNOTATE	AE N AH T EY T
ANNOTATED	AE N AH T EY T IH D
ANNOTATES	AE N AH T EY T S
ANNOTATING	AE N AH T EY T IH NG
ANNOTATION	AE N AH T EY SH AH N
ANNOTATIONS	AE N AH T EY SH AH N Z
ANNOTATIVE	AE N AH T EY T AH V
ANNOTATOR	AE N AH T EY T ER
ANNOTATORS	AE N AH T EY T ER Z
ANNOUNCE	AH N AW N S
ANNOUNCED	AH N AW N S T
ANNOUNCEMENT	AH N AW N S M EH N T
ANNOUNCEMENTS	AH N AW N S M EH N T S
ANNOUNCER	AH N AW N S ER
ANNOUNCERS	AH N AW N S ER Z
ANNOUNCES	AH N AW N S IH Z
ANNOUNCING	AH N AW N S IH NG
ANNOY	AH N OY
ANNOYANCE	AH N OY AH N S
ANNOYANCES	AH N OY AH N S IH Z
ANNOYED	AH N OY D
ANNOYER	AH N OY ER
ANNOYERS	AH N OY ER Z
ANNOYING	AH N OY IH NG
ANNOYINGLY	AH N OY IH NG L IY
ANNOYS	AH N OY Z
ANNUAL	AE N Y UW AH L
ANNUALIZE	AE N Y UW W AH L AY Z
ANNUALIZED	AE N Y UW W AH L AY Z D
ANNUALIZES	AE N Y AH W AH L AY Z IH Z
ANNUALIZING	AE N Y AH W AH L AY Z IH NG
ANNUALLY	AE N Y UW AH L IY
ANNUALS	AE N UW AH L Z
ANNUITANT	AE N UW T AH N T
ANNUITANTS	AE N UW T AH N T S
ANNUITIES	AH N UW IH T IY Z
ANNUITY	AH N UW IH T IY
ANNUITY(2)	AH N Y UW IH T IY
ANNUL	AE N AH L
ANNULAR	AE N Y AH L ER
ANNULATE	AE N Y AH L EY T
ANNULATION	AE N Y AH L EY SH AH N
ANNULATIONS	AE N Y AH L EY T IY AH N Z
ANNULET	AE N Y UW L AH T
ANNULETS	AE N Y UW L AH T S
ANNULI	AE N Y AH L IY
ANNULLED	AE N AH L D
ANNULLING	AE N AH L AH NG
ANNULMENT	AE N AH L M AH N T
ANNULMENTS	AE N AH L M AH N T S
ANNULOSE	AE N Y AH L OW Z
ANNULS	AE N Y AH L Z
ANNULUS	AE N Y AH L AH S
ANNULUSES	AE N Y AH L UW Z AH Z
ANNUNCIATE	AH N AH N S IY AH T
ANNUNCIATED	AH N AH N S IY EY T IH D
ANNUNCIATES	AH N AH N S IY AH T S
ANNUNCIATING	AH N AH N S IY EY T IH NG
ANNUNCIATION	AH N AH N S IY EY SH AH N
ANNUNCIATIONS	AH N AH N S IY EY SH AH N Z
ANNUNCIATOR	AH N AH N S IY AH T ER
ANNUNCIATORS	AH N AH N S IY AH T ER Z
ANNUNCIATORY	AH N AH N S IY AH T OW R IY
ANTENNA	AE N T EH N AH
ANTENNAE	AE N T EH N IY
ANTENNAL	AE N T AH N AH L
ANTENNAS	AE N T EH N AH Z
ANTENNULAR	AE N T EH N Y AH L AH R
ANTENNULE	AE N T AH N Y UW L
ANTENNULES	AE N T AH N Y UW L Z
ANTIPERSONNEL	AE N T AY P ER S AH N EH L
BALLONNE	B AE L AH N
BALLONNES	B AE L AH N Z
BANDANNA	B AE N D AE N AH
BANDANNAS	B AE N D AE N AH Z
BANNED	B AE N D
BANNER	B AE N ER
BANNERED	B AE N ER D
BANNERET	B AE N AH R AH T
BANNERETS	B AE N AH R AH T S
BANNERETTE	B AE N ER EH T
BANNERETTES	B AE N ER EH T S
BANNERING	B AE N ER IH NG
BANNEROL	B AE N AH R AH L
BANNEROLS	B AE N AH R AH L Z
BANNERS	B AE N ER Z
BANNET	B AE N EH T
BANNETS	B AE N EH T S
BANNING	B AE N IH NG
BANNISTER	B AE N AH S T ER
BANNISTER(2)	B AE N IH S T ER
BANNISTERS	B AE N IY S T ER Z
BANNOCK	B AE N AH K
BANNOCKS	B AE N AH K S
BANNS	B AE N Z
BARONNE	B AE R AH N
BARONNES	B AE R AH N Z
BARRENNESS	B AE R AH N AH S
BARRENNESSES	B AE R AH N AH S IH Z
BASERUNNING	B EY S R AH N IH NG
BASERUNNINGS	B EY S R AH N IH NG Z
BEGINNER	B IH G IH N ER
BEGINNERS	B IH G IH N ER Z
BEGINNING	B IH G IH N IH NG
BEGINNINGS	B IH G IH N IH NG Z
BELLADONNA	B EH L AH D AA N AH
BELLADONNAS	B EH L AH D AA N AH Z
BENNE	B EH N
BENNES	B EH N Z
BENNET	B EH N IH T
BENNETS	B IY AH N EH T S
BENNI	B IH N IY
BENNIES	B IY AH N IY Z
BENNIS	B EH N IH S
BENNY	B EH N IY
BETWEENNESS	B IH T W IY N AH S
BETWEENNESSES	B IH T W IY N EH S AH Z
BIANNUAL	B AY AE N UW AH L
BIANNUALLY	B AY AE N Y AH W AH L IY
BICENTENNIAL	B AY S EH N T EH N IY AH L
BICENTENNIALS	B AY S EH N T EH N IY AH L Z
BIENNALE	B IY EH N EY L
BIENNALES	B AY AH N EY L Z
BIENNIA	B AY AH N AY AH
BIENNIAL	B AY EH N IY AH L
BIENNIALLY	B AY EH N IY AH L IY
BIENNIALS	B AY EH N IY AH L Z
BIENNIUM	B AY EH N IY AH M
BIENNIUMS	B AY EH N IY AH M Z
BIMILLENNIAL	B AY M IH L AH N IY AH L
BIMILLENNIALS	B AY M IH L AH N IY AH L Z
BINNACLE	B AY N AE K AH L
BINNACLES	B AY N AE K AH L Z
BINNED	B IH N D
BINNING	B IH N IH NG
BIPINNATE	B AY P IH N AH T
BIPINNATELY	B AY P IH N AH T L IY
BLENNIES	B L EH N AY Z
BLENNY	B L EH N IY
BLUEBONNET	B L UW B AA N AH T
BLUEBONNETS	B L UW B AA N AH T S
BONNE	B AA N
BONNES	B AO N Z
BONNET	B AA N AH T
BONNETED	B AA N AH T IH D
BONNETING	B AA N AH T IH NG
BONNETS	B AA N AH T S
BONNIE	B AA N IY
BONNIER	B AA N IY ER
BONNIEST	B AA N IY AH S T
BONNILY	B AO N IY L IY
BONNOCK	B AA N AH K
BONNOCKS	B AA N AH K S
BONNY	B AA N IY
BONNYCLABBER	B AA N IH K L AE B AH R
BONNYCLABBERS	B AA N AH K L AE B AH R Z
BOTONNEE	B AA T AH N IY IY
BOURGUIGNONNE	B AH R G UW G N AH N
BOUTONNIERE	B AW T AH N IY R
BOUTONNIERES	B AW T AH N IY R Z
BRANNED	B R AE N D
BRANNER	B R AE N ER
BRANNERS	B R AE N ER Z
BRANNIER	B R AE N IY ER
BRANNIEST	B R AE N IY AH S T
BRANNIGAN	B R AE N IH G AH N
BRANNIGANS	B R AE N AH G AH N Z
BRANNING	B R AE N IH NG
BRANNY	B R AE N IY
BRAZENNESS	B R EY Z AH N AH S
BRAZENNESSES	B R EY Z AH N AH S IH Z
BREADWINNER	B R EH D W IH N ER
BREADWINNERS	B R EH D W IH N ER Z
BREADWINNING	B R EH D W IH N IH NG
BREADWINNINGS	B R EH D W IH N IH NG Z
BROKENNESS	B R OW K AH N AH S
BROKENNESSES	B R OW K AH N AH S IH Z
BROWNNOSE	B R AW N OW Z
BROWNNOSED	B R AW N OW Z D
BROWNNOSER	B R AW N OW Z ER
BROWNNOSERS	B R AW N OW Z ER Z
BROWNNOSES	B R AW N OW Z IH Z
BROWNNOSING	B R AW N OW Z IH NG
BUCKSKINNED	B AH K S K IH N D
BUNN	B AH N
BUNNIES	B AH N IY Z
BUNNS	B AH N Z
BUNNY	B AH N IY
CACHINNATE	K AE CH AH N EY T
CACHINNATED	K AE CH AH N EY T AH D
CACHINNATES	K AE CH AH N EY T S
CACHINNATING	K AE CH AH N EY T AH NG
CACHINNATION	K AE CH AH N EY SH AH N
CACHINNATIONS	K AE CH AH N EY T IY AH N Z
CANNA	K AE N AH
CANNABIC	K AE N AE B IH K
CANNABIN	K AE N AE B IH N
CANNABINOID	K AE N AE B AH N OY D
CANNABINOIDS	K AE N AE B AH N OY D Z
CANNABINOL	K AE N AE B AH N AH L
CANNABINOLS	K AE N AE B AH N AH L Z
CANNABINS	K AE N AE B IH N Z
CANNABIS	K AE N AH B AH S
CANNABISES	K AE N AE B IY Z IH Z
CANNAS	K AE N AH Z
CANNED	K AE N D
CANNEL	K AE N AH L
CANNELLONI	K AE N EH L AH N IY
CANNELON	K AE N AH L AH N
CANNELONS	K AE N AH L AH N Z
CANNELS	K AE N AH L Z
CANNER	K AE N ER
CANNERIES	K AE N ER IY Z
CANNERS	K AE N ER Z
CANNERY	K AE N ER IY
CANNIBAL	K AE N AH B AH L
CANNIBALISE	K AE N IH B AH L AY Z
CANNIBALISED	K AE N AH B AH L IY Z D
CANNIBALISES	K AE N AH B AH L IY Z IH Z
CANNIBALISING	K AE N AH B AH L IY Z IH NG
CANNIBALISM	K AE N AH B AH L IH Z AH M
CANNIBALISMS	K AE N AH B AH L IH Z AH M Z
CANNIBALISTIC	K AE N AH B AH L IH S T IH K
CANNIBALIZATION	K AE N AH B AH L IH Z EY SH AH N
CANNIBALIZATIONS	K AE N AH B AH L AH Z EY SH AH N Z
CANNIBALIZE	K AE N AH B AH L AY Z
CANNIBALIZED	K AE N AH B AH L AY Z D
CANNIBALIZES	K AE N AH B AH L AY Z IH Z
CANNIBALIZING	K AE N AH B AH L AY Z IH NG
CANNIBALS	K AE N AH B AH L Z
CANNIE	K AE N IY
CANNIER	K AE N IY ER
CANNIEST	K AE N IY AH S T
CANNIKIN	K AE N AH K AH N
CANNIKINS	K AE N AH K AH N Z
CANNILY	K AE N IY L IY
CANNINESS	K AE N IY N AH S
CANNINESSES	K AE N IY N AH S IH Z
CANNING	K AE N IH NG
CANNINGS	K AE N IH NG Z
CANNISTER	K AE N IH S T ER
CANNISTERS	K AE N IH S T ER Z
CANNOLI	K AE N AH L IY
CANNOLIS	K AE N AH L AH S
CANNON	K AE N AH N
CANNONADE	K AE N AH N EY D
CANNONADED	K AE N AH N EY D IH D
CANNONADES	K AE N AH N EY D Z
CANNONADING	K AE N AH N EY D IH NG
CANNONBALL	K AE N AH N B AO L
CANNONBALLED	K AE N AH N B AO L D
CANNONBALLING	K AE N AH N B AO L IH NG
CANNONBALLS	K AE N AH N B AO L Z
CANNONED	K AE N AH N D
CANNONEER	K AE N AH N IH R
CANNONEERS	K AE N AH N IH R Z
CANNONING	K AE N AH N IH NG
CANNONRIES	K AE N AH N R IY Z
CANNONRY	K AE N AH N R IY
CANNONS	K AE N AH N Z
CANNOT	K AE N AA T
CANNOT(2)	K AH N AA T
CANNULA	K AE N Y UW L AH
CANNULAE	K AE N Y AH L IY
CANNULAR	K AE N Y AH L AH R
CANNULAS	K AE N Y UW L AH Z
CANNY	K AE N IY
CARAVANNED	K AE R AH V AE N D
CARAVANNER	K AE R AH V AE N ER
CARAVANNERS	K AE R AH V AE N ER Z
CARAVANNING	K AE R AH V AE N IH NG
CARBONNADE	K AA R B AH N EY D
CARBONNADES	K AA R B AH N EY D Z
CARILLONNED	K AA R IH L AO N D
CARILLONNEUR	K AE R AH L AA N AH R
CARILLONNEURS	K AH R IH L AA N IY Y AH R Z
CARILLONNING	K AA R IH L AO N IH NG
CATCHPENNY	K AE CH P EH N IY
CAYENNE	K AY EH N
CAYENNE(2)	K EY EH N
CAYENNED	K EY EH N D
CAYENNES	K EY EH N Z
CENTENNIAL	S EH N T EH N IY AH L
CENTENNIALLY	S EH N T EH N IY AH L IY
CENTENNIALS	S EH N T EH N IY AH L Z
CHACONNE	CH AE K AH N
CHACONNES	CH AE K AH N Z
CHAGRINNED	SH AH G R IH N D
CHAGRINNING	SH AH G R IH N IH NG
CHAIRMANNED	CH EH ER M AE N D
CHAIRMANNING	CH EH ER M AE N IH NG
CHANNEL	CH AE N AH L
CHANNELED	CH AE N AH L D
CHANNELER	CH AE N AH L ER
CHANNELERS	CH AE N AH L ER Z
CHANNELING	CH AE N AH L IH NG
CHANNELING(2)	CH AE N L IH NG
CHANNELIZATION	CH AE N AH L AH Z EY SH AH N
CHANNELIZATIONS	CH AE N AH L AH Z EY SH AH N Z
CHANNELIZE	CH AE N AH L AY Z
CHANNELIZED	CH AE N AH L AY Z D
CHANNELIZES	CH AE N AH L AY Z IH Z
CHANNELIZING	CH AE N AH L AY Z IH NG
CHANNELLED	CH AE N AH L D
CHANNELLING	CH AE N AH L IH NG
CHANNELS	CH AE N AH L Z
CHANSONNIER	SH AA N S OW N IY ER
CHANSONNIERS	SH AA N S OW N IY ER Z
CHARDONNAY	CH AA R D AA N EY
CHARDONNAYS	CH AA R D AA N EY Z
CHINNED	CH IH N D
CHINNING	CH IH N IH NG
CINNABAR	S IH N AH B AA R
CINNABARINE	S IH N AE B AH R AY N
CINNABARS	S IH N AH B AH R Z
CINNAMIC	S IH N AH M AH K
CINNAMON	S IH N AH M AH N
CINNAMONS	S IH N AH M AH N Z
CINNAMYL	S IH N AH M AH L
CINNAMYLS	S IH N AH M AH L Z
CLANNISH	K L AE N IH SH
CLANNISHLY	K L AE N IH SH L IY
CLANNISHNESS	K L AE N IH SH N AH S
CLANNISHNESSES	K L AE N IH SH N AH S IH Z
CLEANNESS	K L IY N IH S
CLEANNESSES	K L IY N AH S IH Z
CLOISONNE	K L OY S AH N
CLOISONNES	K L OY S AH N Z
COANNEX	K OW AH N EH K S
COANNEXED	K OW AH N EH K S T
COANNEXES	K OW AH N EH K S IH Z
COANNEXING	K OW AH N EH K S IH NG
COLCANNON	K AA L K AE N AH N
COLCANNONS	K AA L K AE N AH N Z
COLONNADE	K AA L AH N EY D
COLONNADED	K AA L AH N EY D IH D
COLONNADES	K AA L AH N EY D Z
COMEDIENNE	K AH M IY D IY EH N
COMEDIENNES	K AA M AH D IY N Z
COMMONNESS	K AA M AH N AH S
COMMONNESSES	K AA M AH N AH S IH Z
CONCINNITIES	K AA N S IH N AH T AY Z
CONCINNITY	K AA N S IH N AH T IY
CONN	K AA N
CONNATE	K AA N AH T
CONNATELY	K AA N AH T L IY
CONNATURAL	K AH N AE CH AH R AH L
CONNATURALITIES	K AH N AE CH AH R AH L AH T IY Z
CONNATURALITY	K AH N AE CH AH R AH L AH T IY
CONNATURALLY	K AH N AE CH AH R AH L IY
CONNECT	K AH N EH K T
CONNECTABLE	K AH N EH K T AH B AH L
CONNECTED	K AH N EH K T IH D
CONNECTEDLY	K AH N EH K T AH D L IY
CONNECTEDNESS	K AH N EH K T AH D N AH S
CONNECTEDNESSES	K AH N EH K T AH D N AH S IH Z
CONNECTER	K AH N EH K T ER
CONNECTERS	K AH N EH K T ER Z
CONNECTIBLE	K AH N EH K T AH B AH L
CONNECTING	K AH N EH K T IH NG
CONNECTION	K AH N EH K SH AH N
CONNECTIONAL	K AH N EH K SH AH N AH L
CONNECTIONS	K AH N EH K SH AH N Z
CONNECTIVE	K AH N EH K T IH V
CONNECTIVELY	K AH N EH K T IH V L IY
CONNECTIVES	K AH N EH K T IH V Z
CONNECTIVITIES	K AH N EH K T IH V AH T IY Z
CONNECTIVITY	K AH N EH K T IH V IH T IY
CONNECTOR	K AH N EH K T ER
CONNECTORS	K AH N EH K T ER Z
CONNECTS	K AH N EH K T S
CONNED	K AA N D
CONNER	K AA N ER
CONNERS	K AA N ER Z
CONNEXION	K AH N EH K SH AH N
CONNEXIONS	K AH N EH K SH AH N Z
CONNING	K AA N IH NG
CONNIPTION	K AH N IH P SH AH N
CONNIPTIONS	K AA N IH P T IY AH N Z
CONNIVANCE	K AH N AY V AH N S
CONNIVANCES	K AH N AY V AH N S IH Z
CONNIVE	K AH N AY V
CONNIVED	K AH N AY V D
CONNIVENT	K AH N AY V AH N T
CONNIVER	K AH N AY V ER
CONNIVERS	K AH N AY V ER Z
CONNIVES	K AH N AY V Z
CONNIVING	K AH N AY V IH NG
CONNOISSEUR	K AA N AH S ER
CONNOISSEURS	K AA N AH S ER Z
CONNOISSEURSHIP	K AA N AH S ER SH IH P
CONNOISSEURSHIPS	K AA N AH S ER SH IH P S
CONNOTATION	K AA N AH T EY SH AH N
CONNOTATIONAL	K AA N AH T EY SH AH N AH L
CONNOTATIONS	K AA N AH T EY SH AH N Z
CONNOTATIVE	K AH N OW T AH T IH V
CONNOTATIVELY	K AH N OW T AH T IH V L IY
CONNOTE	K AH N OW T
CONNOTED	K AH N OW T IH D
CONNOTES	K AH N OW T S
CONNOTING	K AH N OW T IH NG
CONNS	K AA N Z
CONNUBIAL	K AA N Y UW B IY AH L
CONNUBIALISM	K AA N Y UW B IY AH L IH Z AH M
CONNUBIALISMS	K AA N Y AH B IY AH L AH Z AH M Z
CONNUBIALITIES	K AA N Y AH B IY AE L AH T AY Z
CONNUBIALITY	K AA N Y UW B IY AE L AH T IY
CONNUBIALLY	K AA N Y UW B IY AE L IY
COWINNER	K OW W IH N ER
COWINNERS	K OW W IH N ER Z
CRANNIED	K R AE N IY D
CRANNIES	K R AE N IY Z
CRANNOG	K R AE N AH G
CRANNOGE	K R AE N OW JH
CRANNOGES	K R AE N OW JH AH Z
CRANNOGS	K R AE N AH G Z
CRANNY	K R AE N IY
CRAVENNESS	K R EY V AH N AH S
CRAVENNESSES	K R EY V AH N AH S IH Z
CRESTFALLENNESS	K R EH S T F AE L AH N AH S
CRESTFALLENNESSES	K R EH S T F AE L AH N AH S IH Z
CRETONNE	K R EH T AH N
CRETONNES	K R EH T AH N Z
CUNNER	K AH N AH R
CUNNERS	K AH N AH R Z
CUNNILINCTUS	K AH N AH L IH NG K T AH S
CUNNILINCTUSES	K AH N IH L AH NG K T Y UW Z AH Z
CUNNILINGUS	K AH N AH L IH NG G AH S
CUNNILINGUSES	K AH N IH L AH N G Y UW Z AH Z
CUNNING	K AH N IH NG
CUNNINGER	K AH N IH NG ER
CUNNINGEST	K AH N IH NG AH S T
CUNNINGLY	K AH N IH NG L IY
CUNNINGNESS	K AH N IH NG N AH S
CUNNINGNESSES	K AH N IH NG N AH S IH Z
CUNNINGS	K AH N IH NG Z
DEADPANNED	D EH D P AE N D
DEADPANNER	D EH D P AE N ER
DEADPANNERS	D EH D P AE N ER Z
DEADPANNING	D EH D P AE N IH NG
DECENNIA	D AH S EH N IY AH
DECENNIAL	D AH S EH N IY AH L
DECENNIALLY	D IY S AH N IY AH L IY
DECENNIALS	D IY S AH N IY AH L Z
DECENNIUM	D AH S EH N IY AH M
DECENNIUMS	D AH S EH N IY AH M Z
DENNED	D EH N D
DENNING	D EH N IH NG
DINNED	D IH N D
DINNER	D IH N ER
DINNERLESS	D IH N ER L AH S
DINNERS	D IH N ER Z
DINNERTIME	D IH N ER T AY M
DINNERTIMES	D IH N ER T AY M Z
DINNERWARE	D IH N ER W EH R
DINNERWARES	D IH N ER W EH R Z
DINNING	D IH N IH NG
DISANNUL	D AH S AE N AH L
DISANNULLED	D AH S AE N AH L D
DISANNULLING	D AH S AE N AH L AH NG
DISANNULS	D AH S AE N Y AH L Z
DISCONNECT	D IH S K AH N EH K T
DISCONNECTED	D IH S K AH N EH K T IH D
DISCONNECTEDLY	D IH S K AH N EH K T AH D L IY
DISCONNECTEDNESS	D IH S K AH N EH K T AH D N AH S
DISCONNECTEDNESSES	D IH S K AH N EH K T AH D N AH S IH Z
DISCONNECTING	D IH S K AH N EH K T IH NG
DISCONNECTION	D IH S K AH N EH K SH AH N
DISCONNECTIONS	D IH S K AH N EH K SH AH N Z
DISCONNECTS	D IH S K AH N EH K T S
DJINN	JH IH N
DJINNI	JH IH N IY
DJINNS	JH IH N Z
DJINNY	JH IH N IY
DONNA	D AA N AH
DONNAS	D AA N AH Z
DONNE	D AH N
DONNED	D AA N D
DONNEE	D AA N IY
DONNEES	D AA N IY Z
DONNERD	D AA N AH R D
DONNERED	D AA N ER D
DONNERT	D AA N AH R T
DONNICKER	D AA N IH K S ER
DONNICKERS	D AA N IH K S ER Z
DONNIKER	D AA N AY K AH R
DONNIKERS	D AA N AH K AH R Z
DONNING	D AA N IH NG
DONNISH	D AA N IH SH
DONNISHLY	D AA N IH SH L IY
DONNISHNESS	D AA N IH SH N AH S
DONNISHNESSES	D AA N IH SH N AH S IH Z
DONNYBROOK	D AA N IY B R UH K
DONNYBROOKS	D AA N IY B R UH K S
DOYENNE	D OY AH N
DOYENNES	D OY AH N Z
DRIVENNESS	D R AY V AH N AH S
DRIVENNESSES	D R AY V AH N AH S IH Z
DRUNKENNESS	D R AH NG K AH N N AH S
DRUNKENNESSES	D R AH NG K AH N AH S IH Z
DUBONNET	D AH B AO N EH T
DUBONNETS	D AH B AO N EH T S
DUENNA	D Y UW EH N AH
DUENNAS	D Y UW EH N AH Z
DUENNASHIP	D Y UW EH N AH SH IH P
DUENNASHIPS	D Y UW EH N AH SH AH P S
DUNNAGE	D AH N IH JH
DUNNAGES	D AH N IH JH IH Z
DUNNED	D AH N D
DUNNER	D AH N ER
DUNNESS	D AH N AH S
DUNNESSES	D AH N AH S IH Z
DUNNEST	D AH N AH S T
DUNNING	D AH N IH NG
DUNNITE	D AH N AY T
DUNNITES	D AH N AY T S
ELECTROWINNING	IH L EH K T R OW IH N IH NG
ELECTROWINNINGS	IH L EH K T R OW IH N IH NG Z
EMPENNAGE	IH M P EH N IH JH
EMPENNAGES	IH M P EH N IH JH IH Z
ENNEAD	IH N IY D
ENNEADIC	IH N IY D AH K
ENNEADS	IH N IY D Z
ENNEAGON	IH N IY G AH N
ENNEAGONS	IH N IY G AH N Z
ENNOBLE	IH N OW B AH L
ENNOBLED	IH N OW B AH L D
ENNOBLEMENT	EH N OW B AH L M AH N T
ENNOBLEMENTS	EH N OW B AH L M AH N T S
ENNOBLER	EH N OW B AH L ER
ENNOBLERS	EH N OW B AH L ER Z
ENNOBLES	IH N OW B AH L Z
ENNOBLING	IH N OW B L IH NG
ENNUI	EH N UW IY
ENNUIS	IH N Y UW AH S
ENNUYE	IH N Y UW AY
ENNUYEE	IH N Y UW AY IY IY
EQUESTRIENNE	EH K W AH S T R IY N
EQUESTRIENNES	EH K W AH S T R IY N Z
EVENNESS	IY V AH N N AH S
EVENNESSES	IY V AH N AH S IH Z
FANNED	F AE N D
FANNER	F AE N ER
FANNERS	F AE N ER Z
FANNIES	F AE N IY Z
FANNING	F AE N IH NG
FANNY	F AE N IY
FENNEC	F EH N AH K
FENNECS	F EH N AH K S
FENNEL	F EH N AH L
FENNELS	F EH N AH L Z
FENNY	F EH N IY
FESCENNINE	F EH S AH N AY N
FIBRANNE	F IH B R AH N
FIBRANNES	F IH B R AH N Z
FINNED	F IH N D
FINNICKIER	F IH N IH K S IY ER
FINNICKIEST	F IH N IH K S IY AH S T
FINNICKY	F IH N IH K S IY
FINNIER	F IH N IY ER
FINNIEST	F IH N IY AH S T
FINNING	F IH N IH NG
FINNMARK	F IH N M AH R K
FINNMARKS	F IH N M AH R K S
FINNY	F IH N IY
FLANNEL	F L AE N AH L
FLANNELED	F L AE N AH L D
FLANNELETTE	F L AE N AH L EH T
FLANNELETTES	F L AE N AH L EH T S
FLANNELING	F L AE N AH L IH NG
FLANNELLED	F L AE N AH L D
FLANNELLING	F L AE N AH L IH NG
FLANNELLY	F L AE N AH L IY
FLANNELMOUTHED	F L AE N AH L M AW TH T
FLANNELS	F L AE N AH L Z
FOREIGNNESS	F AO R AH N AH S
FOREIGNNESSES	F AO R AH N AH S IH Z
FORERUNNER	F AO R AH N ER
FORERUNNERS	F AO R AH N ER Z
FORERUNNING	F OW R AH N IH NG
FORLORNNESS	F ER L AO R N AH S
FORLORNNESSES	F ER L AO R N AH S IH Z
FRANGIPANNI	F R AE N JH AH P AE N IY
FRONTRUNNER	F R AH N T R AH N ER
FRONTRUNNERS	F R AH N T R AH N ER Z
FROZENNESS	F R OW Z AH N AH S
FROZENNESSES	F R OW Z AH N AH S IH Z
FUNNED	F AH N D
FUNNEL	F AH N AH L
FUNNELED	F AH N AH L D
FUNNELFORM	F AH N AH L F AO R M
FUNNELING	F AH N AH L IH NG
FUNNELING(2)	F AH N L IH NG
FUNNELLED	F AH N AH L D
FUNNELLING	F AH N AH L IH NG
FUNNELS	F AH N AH L Z
FUNNER	F AH N ER
FUNNEST	F AH N IH S T
FUNNIER	F AH N IY ER
FUNNIES	F AH N IY Z
FUNNIEST	F AH N IY AH S T
FUNNILY	F AH N IY L IY
FUNNINESS	F AH N IY N AH S
FUNNINESSES	F AH N IY N AH S IH Z
FUNNING	F AH N IH NG
FUNNY	F AH N IY
FUNNYMAN	F AH N IY M AE N
FUNNYMEN	F AH N IY M EH N
GANNET	G AE N AH T
GANNETS	G AE N AH T S
GANNISTER	G AE N IH S T AH R
GANNISTERS	G AE N IH S T AH R Z
GINNED	JH IH N D
GINNER	JH IH N ER
GINNERS	JH IH N ER Z
GINNIER	JH IH N IY ER
GINNIEST	JH IH N IY AH S T
GINNING	JH IH N IH NG
GINNINGS	JH IH N IH NG Z
GINNY	JH IH N IY
GOANNA	G OW N AH
GOANNAS	G OW N AH Z
GOLDENNESS	G OW L D AH N AH S
GOLDENNESSES	G OW L D AH N AH S IH Z
GRANNIE	G R AE N AY
GRANNIES	G R AE N IY Z
GRANNY	G R AE N IY
GREENNESS	G R IY N N AH S
GREENNESSES	G R IY N AH S IH Z
GRINNED	G R IH N D
GRINNER	G R IH N ER
GRINNERS	G R IH N ER Z
GRINNING	G R IH N IH NG
GRINNINGLY	G R IH N IH NG L IY
GUNNED	G AH N D
GUNNEL	G AH N AH L
GUNNELS	G AH N AH L Z
GUNNEN	G AH N AH N
GUNNER	G AH N ER
GUNNERIES	G AH N AH R IY Z
GUNNERS	G AH N ER Z
GUNNERY	G AH N ER IY
GUNNIES	G AH N IY Z
GUNNING	G AH N IH NG
GUNNINGS	G AH N IH NG Z
GUNNY	G AH N IY
GUNNYBAG	G AH N IY B AE G
GUNNYBAGS	G AH N IY B AE G Z
GUNNYSACK	G AH N IY S AE K
GUNNYSACKS	G AH N IY S AE K S
GUNRUNNER	G AH N R AH N ER
GUNRUNNERS	G AH N R AH N ER Z
GUNRUNNING	G AH N R AH N IH NG
GUNRUNNINGS	G AH N R AH N IH NG Z
HALFPENNIES	HH AE F P EH N IY Z
HALFPENNY	HH AE F P EH N IY
HENNA	HH EH N AH
HENNAED	HH EH N EY D
HENNAING	HH EH N EY AH NG
HENNAS	HH EH N AH Z
HENNERIES	HH EH N AH R IY Z
HENNERY	HH EH N AH R IY
HIDDENNESS	HH IH D AH N AH S
HIDDENNESSES	HH IH D AH N AH S IH Z
HINNIED	HH IH N AY D
HINNIES	HH IH N AY Z
HINNY	HH IH N IY
HINNYING	HH IH N AY AH NG
HOOTENANNIES	HH UW T AH N AE N AY Z
HOOTENANNY	HH UW T AH N AE N IY
HOSANNA	HH AH S AE N AH
HOSANNAED	HH AH S AE N EY D
HOSANNAH	HH AH S AE N AH
HOSANNAHS	HH AH S AE N AH Z
HOSANNAING	HH AH S AE N EY AH NG
HOSANNAS	HH AH S AE N AH Z
HUMANNESS	HH Y UW M AH N N AH S
HUMANNESSES	HH Y UW M AH N AH S IH Z
HUNNISH	HH AH N AH SH
HYPERINNERVATION	HH AY P ER IH N ER V EY SH AH N
HYPERINNERVATIONS	HH AY P ER IH N ER V EY SH AH N Z
INCONCINNITIES	IH N K AH N S IH N AH T AY Z
INCONCINNITY	IH N K AH N S IH N AH T IY
INCONNU	IH N K AH N UW
INCONNUS	IH N K AA N AH S
INGROWNNESS	IH N G R OW N AH S
INGROWNNESSES	IH N G R OW N AH S IH Z
INHUMANNESS	IH N HH Y UW M AH N AH S
INHUMANNESSES	IH N HH Y UW M AH N AH S IH Z
INN	IH N
INNARDS	IH N ER D Z
INNATE	IH N EY T
INNATELY	IH N EY T L IY
INNATENESS	IH N EY T N AH S
INNATENESSES	IH N EY T N AH S IH Z
INNED	IH N D
INNER	IH N ER
INNERLY	IH N ER L IY
INNERMOST	IH N ER M OW S T
INNERMOSTS	IH N ER M OW S T S
INNERS	IH N ER Z
INNERSOLE	IH N ER S OW L
INNERSOLES	IH N ER S OW L Z
INNERSPRING	IH N ER S P R IH NG
INNERVATE	IH N ER V AH T
INNERVATED	IH N ER V EY T IH D
INNERVATES	IH N ER V AH T S
INNERVATING	IH N ER V EY T IH NG
INNERVATION	IH N ER V EY SH AH N
INNERVATIONS	IH N ER V EY SH AH N Z
INNERVE	IH N ER V
INNERVED	IH N ER V D
INNERVES	IH N ER V Z
INNERVING	IH N ER V IH NG
INNING	IH N IH NG
INNINGS	IH N IH NG Z
INNKEEPER	IH N K IY P ER
INNKEEPERS	IH N K IY P ER Z
INNLESS	IH N L AH S
INNOCENCE	IH N AH S AH N S
INNOCENCES	IH N AH S AH N S IH Z
INNOCENCIES	IH N AH S AH N S IY Z
INNOCENCY	IH N AH S AH N S IY
INNOCENT	IH N AH S AH N T
INNOCENTER	IH N AH S AH N T ER
INNOCENTEST	IH N AH S AH N T AH S T
INNOCENTLY	IH N AH S AH N T L IY
INNOCENTS	IH N AH S AH N T S
INNOCUOUS	IH N AA K Y UW AH S
INNOCUOUSLY	IH N AA K Y UW OW AH S L IY
INNOCUOUSNESS	IH N AA K Y UW AW Z N AH S
INNOCUOUSNESSES	IH N AA K Y UW AW Z N EH S AH Z
INNOMINATE	IH N AA M AH N AH T
INNOVATE	IH N AH V EY T
INNOVATE(2)	IH N OW V EY T
INNOVATED	IH N AH V EY T IH D
INNOVATED(2)	IH N OW V EY T IH D
INNOVATES	IH N AH V EY T S
INNOVATES(2)	IH N OW V EY T S
INNOVATING	IH N AH V EY T IH NG
INNOVATING(2)	IH N OW V EY T IH NG
INNOVATION	IH N AH V EY SH AH N
INNOVATION(2)	IH N OW V EY SH AH N
INNOVATIONAL	IH N AH V EY SH AH N AH L
INNOVATIONS	IH N AH V EY SH AH N Z
INNOVATIONS(2)	IH N OW V EY SH AH N Z
INNOVATIVE	IH N AH V EY T IH V
INNOVATIVE(2)	IH N OW V EY T IH V
INNOVATIVELY	IH N AH V EY T IH V L IY
INNOVATIVENESS	IH N AH V EY T IH V N AH S
INNOVATIVENESSES	IH N AH V EY T IH V N AH S IH Z
INNOVATOR	IH N AH V EY T ER
INNOVATOR(2)	IH N OW V EY T ER
INNOVATORS	IH N AH V EY T ER Z
INNOVATORS(2)	IH N OW V EY T ER Z
INNOVATORY	IH N AH V EY T ER IY
INNS	IH N Z
INNUENDO	IH N Y UW EH N D OW
INNUENDOED	IH N Y AH W EH N D OW D
INNUENDOES	IH N Y UW EH N D OW Z
INNUENDOING	IH N Y AH W EH N D OW IH NG
INNUENDOS	IH N Y UW EH N D OW Z
INNUMERABLE	IH N UW M ER AH B AH L
INNUMERABLY	IH N UW M ER AH B L IY
INNUMERACIES	IH N UW M ER AH S IY Z
INNUMERACY	IH N UW M ER AH S IY
INNUMERATE	IH N UW M ER AH T
INNUMERATES	IH N UW M ER AH T S
INNUMEROUS	IH N UW M ER AH S
INSPANNED	IH N S P AE N D
INSPANNING	IH N S P AE N IH NG
INTERANNUAL	IH N T ER AE N Y AH W AH L
INTERCHANNEL	IH N T ER CH AE N AH L
INTERCONNECT	IH N T ER K AH N EH K T
INTERCONNECTED	IH N T ER K AH N EH K T IH D
INTERCONNECTEDNESS	IH N T ER K AH N EH K T AH D N AH S
INTERCONNECTEDNESSES	IH N T ER K AH N EH K T AH D N AH S IH Z
INTERCONNECTING	IH N T ER K AH N EH K T IH NG
INTERCONNECTION	IH N T ER K AH N EH K SH AH N
INTERCONNECTIONS	IH N T ER K AH N EH K SH AH N Z
INTERCONNECTS	IH N T ER K AH N EH K T S
IRONNESS	AY ER N AH S
IRONNESSES	AY ER N AH S IH Z
JAPANNED	JH AH P AE N D
JAPANNER	JH AH P AE N ER
JAPANNERS	JH AH P AE N ER Z
JAPANNING	JH AH P AE N IH NG
JENNET	JH EH N AH T
JENNETS	JH EH N AH T S
JENNIES	JH EH N IY Z
JENNY	JH EH N IY
JINN	JH IH N
JINNEE	JH IH N IY IY
JINNI	JH IH N IY
JINNS	JH IH N Z
JOANNES	JH OW N Z
JOHANNES	JH OW HH AE N AH S
JOHNNIES	JH AA N IY Z
JOHNNY	JH AA N IY
JOHNNYCAKE	JH AA N IY K EY K
JOHNNYCAKES	JH AA N IY K EY K S
JULIENNE	JH UW L IY N
JULIENNED	JH UW L IY N D
JULIENNES	JH UW L IY N Z
JULIENNING	JH UW L IY N AH NG
KEENNESS	K IY N AH S
KEENNESSES	K IY N AH S IH Z
KENNED	K EH N D
KENNEL	K EH N AH L
KENNELED	K EH N AH L D
KENNELING	K EH N AH L IH NG
KENNELLED	K EH N AH L D
KENNELLING	K EH N AH L IH NG
KENNELS	K EH N AH L Z
KENNING	K EH N IH NG
KENNINGS	K EH N IH NG Z
KINNIKINNICK	K IH N AH K IH N AH K
KINNIKINNICKS	K IH N AH K IH N AH K S
LANNER	L AE N AH R
LANNERET	L AE N AH R AH T
LANNERETS	L AE N AH R AH T S
LANNERS	L AE N ER Z
LEADENNESS	L EH D AH N AH S
LEADENNESSES	L EH D AH N AH S IH Z
LEANNESS	L IY N AH S
LEANNESSES	L IY N AH S IH Z
LEGIONNAIRE	L IY JH AH N EH R
LEGIONNAIRES	L IY JH AH N EH R Z
LINN	L IH N
LINNET	L IH N IH T
LINNETS	L IH N AH T S
LINNS	L IH N Z
LORNNESS	L AO R N AH S
LORNNESSES	L AO R N AH S IH Z
LOVELORNNESS	L AH V L AO R N AH S
LOVELORNNESSES	L AH V L AO R N AH S IH Z
LYONNAISE	L AY AH N EY Z
MADONNA	M AH D AA N AH
MADONNAS	M AH D AA N AH Z
MANNA	M AE N AH
MANNAN	M AE N AH N
MANNANS	M AE N AH N Z
MANNAS	M AE N AH Z
MANNED	M AE N D
MANNEQUIN	M AE N AH K IH N
MANNEQUINS	M AE N AH K IH N Z
MANNER	M AE N ER
MANNERED	M AE N ER D
MANNERISM	M AE N ER IH Z AH M
MANNERISMS	M AE N ER IH Z AH M Z
MANNERIST	M AE N ER AH S T
MANNERIST(2)	M AE N ER IH S T
MANNERISTIC	M AE N ER IH S T IH K
MANNERISTS	M AE N ER IH S T S
MANNERLESS	M AE N ER L AH S
MANNERLINESS	M AE N ER L IY N AH S
MANNERLINESSES	M AE N ER L IY N AH S IH Z
MANNERLY	M AE N ER L IY
MANNERS	M AE N ER Z
MANNIKIN	M AE N AH K AH N
MANNIKINS	M AE N AH K AH N Z
MANNING	M AE N IH NG
MANNISH	M AE N IH SH
MANNISHLY	M AE N IH SH L IY
MANNISHNESS	M AE N IH SH N AH S
MANNISHNESSES	M AE N IH SH N AH S IH Z
MANNITE	M AE N AY T
MANNITES	M AE N AY T S
MANNITIC	M AE N AH T AH K
MANNITOL	M AE N AH T AH L
MANNITOLS	M AE N AH T AH L Z
MANNOSE	M AE N OW Z
MANNOSES	M AE N OW Z IH Z
MAYONNAISE	M EY AH N EY Z
MAYONNAISES	M EY AH N EY Z IH Z
MEANNESS	M IY N N AH S
MEANNESSES	M IY N AH S IH Z
MEGATONNAGE	M EH G AH T AH N IH JH
MEGATONNAGES	M EH G AH T AH N IH JH IH Z
MIGNONNE	M IH G N AH N
MILLENNIA	M AH L EH N IY AH
MILLENNIAL	M IH L EH N IY AH L
MILLENNIALISM	M IH L AH N IY AH L IH Z AH M
MILLENNIALISMS	M IH L AH N IY AH L IH Z AH M Z
MILLENNIALIST	M IH L AH N IY AH L IH S T
MILLENNIALISTS	M IH L AH N IY AH L IH S T S
MILLENNIUM	M AH L EH N IY AH M
MILLENNIUMS	M AH L EH N IY AH M Z
MINNESINGER	M IH N EH S AH NG AH R
MINNESINGERS	M IH N AH S IH N JH AH R Z
MINNIES	M IH N AY Z
MINNOW	M IH N OW
MINNOWS	M IH N OW Z
MINNY	M IH N IY
MISBEGINNING	M IH S B IH G IH N IH NG
MISCHANNEL	M IH S CH AE N AH L
MISCHANNELED	M IH S CH AE N AH L D
MISCHANNELING	M IH S CH AE N AH L IH NG
MISCHANNELLED	M IH S CH AE N AH L D
MISCHANNELLING	M IH S CH AE N AH L IH NG
MISCHANNELS	M IH S CH AE N AH L Z
MISCONNECT	M IH S K AH N EH K T
MISCONNECTED	M IH S K AH N EH K T IH D
MISCONNECTING	M IH S K AH N EH K T IH NG
MISCONNECTION	M IH S K AH N EH K SH AH N
MISCONNECTIONS	M IH S K AH N EH K SH AH N Z
MISCONNECTS	M IH S K AH N EH K T S
MISPENNED	M IH S P EH N D
MISPENNING	M IH S P EH N IH NG
MISPLANNED	M IH S P L AE N D
MISPLANNING	M IH S P L AE N IH NG
MODERNNESS	M AA D ER N AH S
MODERNNESSES	M AA D ER N AH S IH Z
MULTICHANNEL	M AH L T AY CH AE N AH L
MULTICHANNELS	M AH L T AY CH AE N AH L Z
MULTIMANNED	M AH L T AY M AE N D
MULTIMILLENNIAL	M AH L T AY M IH L AH N IY AH L
MUNNION	M AH N IY AH N
MUNNIONS	M AH N IY AH N Z
NANNIE	N AE N AY
NANNIES	N AE N IY Z
NANNOPLANKTON	N AE N AH P L AE NG K T AH N
NANNOPLANKTONS	N AE N AH P L AE NG K T AH N Z
NANNY	N AE N IY
NINNIES	N IH N AY Z
NINNY	N IH N IY
NINNYHAMMER	N IH N AH HH AE M AH R
NINNYHAMMERS	N IH N AH HH AE M AH R Z
NINNYISH	N IH N AY AH SH
NONCANNIBALISTIC	N AA N K AE N AH B AH L IH S T IH K
NONCONNECTION	N AA N K AH N EH K SH AH N
NONCONNECTIONS	N AA N K AH N EH K SH AH N Z
NONNARRATIVE	N AA N AE R AH T IH V
NONNARRATIVES	N AA N AE R AH T IH V Z
NONNATIONAL	N AA N AE SH AH N AH L
NONNATIONALS	N AA N AE SH AH N AH L Z
NONNATIVE	N AA N EY T IH V
NONNATIVES	N AA N EY T IH V Z
NONNATURAL	N AA N AE CH AH R AH L
NONNAVAL	N AA N EY V AH L
NONNECESSITIES	N AA N IH S EH S AH T IY Z
NONNECESSITY	N AA N IH S EH S AH T IY
NONNEGATIVE	N AA N EH G AH T IH V
NONNEGLIGENT	N AA N EH G L IH JH AH N T
NONNEGOTIABLE	N AA N AH G OW SH AH B AH L
NONNETWORK	N AA N EH T W ER K
NONNEWS	N AA N UW Z
NONNITROGENOUS	N AA N AY T R AH JH AH N AH S
NONNORMATIVE	N AA N AO R M AH T IH V
NONNOVEL	N AA N AA V AH L
NONNOVELS	N AA N AA V AH L Z
NONNUCLEAR	N AA N UW K L IY ER
NONNUCLEATED	N AA N UW K L IY EY T IH D
NONNUMERICAL	N AA N UH M EH R IH K AH L
NONNUMERICALS	N AA N UH M EH R IH K AH L Z
NONNUTRITIOUS	N AA N UH T R IH SH AH S
NONNUTRITIVE	N AA N UW T R AH T IH V
NONWINNING	N AA N W IH N IH NG
NUNNERIES	N AH N AH R IY Z
NUNNERY	N AH N ER IY
NUNNISH	N AH N IH SH
OPENNESS	OW P AH N N AH S
OPENNESS(2)	OW P AH N AH S
OPENNESSES	OW P AH N AH S IH Z
ORDONNANCE	AO R D AA N AH N S
ORDONNANCES	AO R D AA N AE N S AH Z
OUTGRINNED	AW T G R IH N D
OUTGRINNING	AW T G R IH N IH NG
OUTGUNNED	AW T G AH N D
OUTGUNNING	AW T G AH N IH NG
OUTMANNED	AW T M AE N D
OUTMANNING	AW T M AE N IH NG
OUTPLANNED	AW T P L AE N D
OUTPLANNING	AW T P L AE N IH NG
OUTRUNNING	AW T R AH N IH NG
OUTSINNED	AW T S IH N D
OUTSINNING	AW T S IH N IH NG
OUTSPANNED	AW T S P AE N D
OUTSPANNING	AW T S P AE N IH NG
OUTSPOKENNESS	AW T S P OW K AH N AH S
OUTSPOKENNESSES	AW T S P OW K AH N AH S IH Z
OVERMANNED	OW V ER M AE N D
OVERMANNERED	OW V ER M AE N ER D
OVERMANNING	OW V ER M AE N IH NG
OVERPLANNED	OW V ER P L AE N D
OVERPLANNING	OW V ER P L AE N IH NG
OVERRUNNING	OW V ER R AH N IH NG
PANNE	P AE N
PANNED	P AE N D
PANNES	P AE N Z
PANNIER	P AE N IY ER
PANNIERS	P AE N IY ER Z
PANNIKIN	P AE N AH K AH N
PANNIKINS	P AE N AH K AH N Z
PANNING	P AE N IH NG
PENNA	P EH N AH
PENNA(2)	P EH N S IH L V EY N Y AH
PENNAE	P EH N IY
PENNAME	P EH N EY M
PENNAMES	P EH N EY M Z
PENNANT	P EH N AH N T
PENNANTS	P EH N AH N T S
PENNATE	P EH N AH T
PENNATED	P EH N EY T IH D
PENNE	P EH N
PENNED	P EH N D
PENNER	P EH N ER
PENNERS	P EH N ER Z
PENNI	P EH N IY
PENNIA	P EH N IY AH
PENNIES	P EH N IY Z
PENNILESS	P EH N IY L AH S
PENNINE	P EH N AY N
PENNINES	P EH N AY N Z
PENNING	P EH N IH NG
PENNIS	P EH N IY Z
PENNON	P EH N AH N
PENNONCEL	P EH N AA N S AH L
PENNONCELS	P EH N AA N S AH L Z
PENNONED	P EH N OW N D
PENNONS	P EH N AH N Z
PENNY	P EH N IY
PENNYCRESS	P EH N IH K R AH S
PENNYCRESSES	P EH N IH K R EH S AH Z
PENNYROYAL	P EH N IY R OY AH L
PENNYROYALS	P EH N IY R OY AH L Z
PENNYWEIGHT	P EH N IY W EY T
PENNYWEIGHTS	P EH N IY W EY T S
PENNYWHISTLE	P EH N IY W IH S AH L
PENNYWHISTLES	P EH N IY W IH S AH L Z
PENNYWORT	P EH N AH W AH R T
PENNYWORTH	P EH N IY W ER TH
PENNYWORTHS	P EH N IY W ER TH S
PENNYWORTS	P EH N AH W AH R T S
PERENNATE	P AH R EH N EY T
PERENNATED	P AH R EH N EY T AH D
PERENNATES	P AH R EH N EY T S
PERENNATING	P AH R EH N EY T AH NG
PERENNATION	P ER EH N EY SH AH N
PERENNATIONS	P ER EH N EY SH AH N Z
PERENNIAL	P ER EH N IY AH L
PERENNIALLY	P ER EH N IY AH L IY
PERENNIALS	P ER EH N IY AH L Z
PERSONNEL	P ER S AH N EH L
PERSONNELS	P ER S AH N EH L Z
PFENNIG	F EH N IH G
PFENNIGE	F EH N AY JH
PFENNIGS	F EH N IH G Z
PHOTORECONNAISSANCE	F OW T OW R IH K AA N AH Z AH N S
PHOTORECONNAISSANCES	F OW T OW R IH K AA N AH Z AH N S IH Z
PICANINNIES	P IH K AH N IH N AY Z
PICANINNY	P IH K AH N IH N IY
PICKANINNIES	P IH K AH N IH N AY Z
PICKANINNY	P IH K AH N IH N IY
PINCHPENNY	P IH N CH P EH N IY
PINNA	P IH N AH
PINNACE	P IH N AH S
PINNACES	P IH N AH S AH Z
PINNACLE	P IH N AH K AH L
PINNACLED	P IH N IH K AH L D
PINNACLES	P IH N IH K AH L Z
PINNACLING	P IH N IH K AH L IH NG
PINNAE	P IH N IY
PINNAL	P IH N AH L
PINNAS	P IH N AH Z
PINNATE	P IH N AH T
PINNATED	P IH N EY T IH D
PINNATELY	P IH N AH T L IY
PINNATIFID	P IH N AE T AH F AH D
PINNED	P IH N D
PINNER	P IH N ER
PINNERS	P IH N ER Z
PINNIES	P IH N IY Z
PINNING	P IH N IH NG
PINNIPED	P IH N IH P T
PINNIPEDS	P IH N IH P T S
PINNULA	P IH N Y UW L AH
PINNULAE	P IH N Y AH L IY
PINNULAR	P IH N Y AH L AH R
PINNULE	P IH N Y UW L
PINNULES	P IH N Y UW L Z
PINNY	P IH N IY
PLAINNESS	P L EY N AH S
PLAINNESSES	P L EY N AH S IH Z
PLAINSPOKENNESS	P L EY N S P OW K AH N AH S
PLAINSPOKENNESSES	P L EY N S P OW K AH N AH S IH Z
PLANNED	P L AE N D
PLANNER	P L AE N ER
PLANNERS	P L AE N ER Z
PLANNING	P L AE N IH NG
PLANNINGS	P L AE N IH NG Z
POSTMILLENNIAL	P OW S T M IH L AH N IY AH L
POSTMILLENNIALISM	P OW S T M IH L AH N IY AH L IH Z AH M
POSTMILLENNIALISMS	P OW S T M IH L AH N IY AH L IH Z AH M Z
POSTMILLENNIALIST	P OW S T M IH L AH N IY AH L IH S T
POSTMILLENNIALISTS	P OW S T M IH L AH N IY AH L IH S T S
PREANNOUNCE	P R IY AH N AW N S
PREANNOUNCED	P R IY AH N AW N S T
PREANNOUNCES	P R IY AH N AW N S IH Z
PREANNOUNCING	P R IY AH N AW N S IH NG
PREDINNER	P R IY D IH N ER
PREMILLENNIAL	P R IY M IH L AH N IY AH L
PREMILLENNIALISM	P R IY M IH L AH N IY AH L IH Z AH M
PREMILLENNIALISMS	P R IY M IH L AH N IY AH L IH Z AH M Z
PREMILLENNIALIST	P R IY M IH L AH N IY AH L IH S T
PREMILLENNIALISTS	P R IY M IH L AH N IY AH L IH S T S
PREMILLENNIALLY	P R IY M IH L AH N IY AH L IY
PREPLANNED	P R IY P L AE N D
PREPLANNING	P R IY P L AE N IH NG
PRIZEWINNER	P R AY Z W IH N ER
PRIZEWINNERS	P R AY Z W IH N ER Z
PRIZEWINNING	P R AY Z W IH N IH NG
PUNNED	P AH N D
PUNNER	P AH N ER
PUNNERS	P AH N ER Z
PUNNET	P AH N EH T
PUNNETS	P AH N EH T S
PUNNIER	P AH N IY ER
PUNNIEST	P AH N IY AH S T
PUNNING	P AH N IH NG
PUNNY	P AH N IY
QUADRENNIA	K W AA D R EH N IY AH
QUADRENNIAL	K W AA D R EH N IY AH L
QUADRENNIALLY	K W AA D R EH N IY AH L IY
QUADRENNIALS	K W AA D R EH N IY AH L Z
QUADRENNIUM	K W AA D R EH N IY AH M
QUADRENNIUMS	K W AA D R EH N IY AH M Z
QUADRICENTENNIAL	K W AA D R IH K AH N T AH N IY AH L
QUADRICENTENNIALS	K W AA D R IH K AH N T AH N IY AH L Z
QUESTIONNAIRE	K W EH S CH AH N EH R
QUESTIONNAIRES	K W EH S CH AH N EH R Z
QUINCENTENNIAL	K W IH N S AH N T AH N IY AH L
QUINCENTENNIALS	K W IH N S AH N T AH N IY AH L Z
QUINNAT	K W IH N AH T
QUINNATS	K W IH N EY T S
QUINQUENNIA	K W IH NG K W EH N IY AH
QUINQUENNIAL	K W IH NG K W EH N IY AH L
QUINQUENNIALLY	K W IH NG K W EH N IY AE L IY
QUINQUENNIALS	K W IH NG K W EH N IY AH L Z
QUINQUENNIUM	K W IH NG K W EH N IY AH M
QUINQUENNIUMS	K W IH NG K W EH N IY AH M Z
RAISONNE	R EY S AH N
RATAPLANNED	R AE T AH P L AE N D
RATAPLANNING	R AE T AH P L AE N IH NG
REANNEX	R IY AH N EH K S
REANNEXATION	R IY AH N EH K S EY SH AH N
REANNEXATIONS	R IY AH N EH K S EY SH AH N Z
REANNEXED	R IY AH N EH K S T
REANNEXES	R IY AH N EH K S IH Z
REANNEXING	R IY AH N EH K S IH NG
REBEGINNING	R IY B IH G IH N IH NG
RECHANNEL	R IY CH AE N AH L
RECHANNELED	R IY CH AE N AH L D
RECHANNELING	R IY CH AE N AH L IH NG
RECHANNELLED	R IY CH AE N AH L D
RECHANNELLING	R IY CH AE N AH L IH NG
RECHANNELS	R IY CH AE N AH L Z
RECONNAISSANCE	R IY K AA N AH S AH N S
RECONNAISSANCES	R IH K AA N AH Z AH N S IH Z
RECONNECT	R IY K AH N EH K T
RECONNECTED	R IY K AH N EH K T IH D
RECONNECTING	R IY K AH N EH K T IH NG
RECONNECTION	R IY K AH N EH K SH AH N
RECONNECTIONS	R IY K AH N EH K SH AH N Z
RECONNECTS	R IY K AH N EH K T S
RECONNOITER	R IY K AH N OY T ER
RECONNOITERED	R AH K AA N OY T IY R D
RECONNOITERING	R AH K AA N OY T IY R AH NG
RECONNOITERS	R AH K AH N OY T AH R Z
RECONNOITRE	R AH K AH N OY T AH R
RECONNOITRED	R AH K AH N OY T AH R D
RECONNOITRES	R AH K AH N OY T AH R Z
RECONNOITRING	R IH K AH N OY T R AH NG
REDONNED	R IY D AA N D
REDONNING	R IY D AA N IH NG
REINNERVATE	R IY IH N ER V AH T
REINNERVATED	R IY IH N ER V EY T IH D
REINNERVATES	R IY IH N ER V AH T S
REINNERVATING	R IY IH N ER V EY T IH NG
REINNERVATION	R IY IH N ER V EY SH AH N
REINNERVATIONS	R IY IH N ER V EY SH AH N Z
REMANNED	R IY M AE N D
REMANNING	R IY M AE N IH NG
RENNASE	R IH N EY Z
RENNASES	R IH N EY Z AH Z
RENNET	R EH N AH T
RENNETS	R IH N EH T S
RENNIN	R IH N IH N
RENNINS	R IH N IH N Z
REPINNED	R IY P IH N D
REPINNING	R IY P IH N IH NG
REPLANNED	R IY P L AE N D
REPLANNING	R IY P L AE N IH NG
RERUNNING	R IY R AH N IH NG
REWINNING	R IY W IH N IH NG
RINNING	R IH N AH NG
ROADRUNNER	R OW D R AH N ER
ROADRUNNERS	R OW D R AH N ER Z
RONNEL	R AA N AH L
RONNELS	R AA N AH L Z
ROTTENNESS	R OW T AH N AH S
ROTTENNESSES	R OW T AH N AH S IH Z
RUMRUNNER	R AH M R AH N ER
RUMRUNNERS	R AH M R AH N ER Z
RUNNEL	R AH N AH L
RUNNELS	R AH N AH L Z
RUNNER	R AH N ER
RUNNERS	R AH N ER Z
RUNNIER	R AH N IY ER
RUNNIEST	R AH N IY AH S T
RUNNING	R AH N IH NG
RUNNINGS	R AH N IH NG Z
RUNNY	R AH N IY
SANNOP	S AE N AH P
SANNOPS	S AE N AH P S
SANNUP	S AE N AH P
SANNUPS	S AE N AH P S
SANNYASI	S AE N AY AH S IY
SANNYASIN	S AE N AY AH S AH N
SANNYASINS	S AE N AY AH S AH N Z
SANNYASIS	S AE N AY AH S AH S
SAVANNA	S AH V AE N AH
SAVANNAH	S AH V AE N AH
SAVANNAHS	S AH V AE N AH Z
SAVANNAS	S AH V AE N AH Z
SCANNABLE	S K AE N AH B AH L
SCANNED	S K AE N D
SCANNER	S K AE N ER
SCANNERS	S K AE N ER Z
SCANNING	S K AE N IH NG
SCANNINGS	S K AE N IH NG Z
SCRANNEL	S K R AE N AH L
SCRANNELS	S K R AE N AH L Z
SCUNNER	S K AH N AH R
SCUNNERED	S K AH N IY R D
SCUNNERING	S K AH N IY R AH NG
SCUNNERS	S K AH N AH R Z
SEMIANNUAL	S EH M IY AE N Y AH W AH L
SEMIANNUAL(2)	S EH M AY AE N Y AH W AH L
SEMIANNUAL(3)	S EH M AH AE N Y AH W AH L
SEMIANNUALLY	S EH M IY AE N UW AH L IY
SEMIANNUALLY(2)	S EH M AY AE N UW AH L IY
SEMIANNUALLY(3)	S EH M IY AE N UW L IY
SEMIANNUALLY(4)	S EH M AY AE N UW L IY
SEMICENTENNIAL	S EH M IY S EH N T EH N IY AH L
SEMICENTENNIALS	S EH M IY S EH N T EH N IY AH L Z
SENNA	S EH N AH
SENNAS	S EH N AH Z
SENNET	S EH N AH T
SENNETS	S EH N EH T S
SENNIGHT	S EH N AY T
SENNIGHTS	S EH N AY T S
SENNIT	S EH N AH T
SENNITS	S EH N AH T S
SEPTENNIAL	S EH P T EH N IY AH L
SEPTENNIALLY	S EH P T EH N IY AE L IY
SEQUINNED	S IY K W AH N D
SESQUICENTENNIAL	S EH S W AH S EH N T EH N IY AH L
SESQUICENTENNIALS	S EH S W AH S AH N T EH N IY AH L Z
SHANNIES	SH AE N AY Z
SHANNY	SH AE N IY
SHINNED	SH IH N D
SHINNERIES	SH IH N AH R IY Z
SHINNERY	SH IH N AH R IY
SHINNEY	SH IH N IY
SHINNEYED	SH IH N EY D
SHINNEYING	SH IH N EY AH NG
SHINNEYS	SH IH N EY Z
SHINNIED	SH IH N IY D
SHINNIES	SH IH N IY Z
SHINNING	SH IH N IH NG
SHINNY	SH IH N IY
SHINNYING	SH IH N IY IH NG
SHOTGUNNED	SH AA T G AH N D
SHOTGUNNER	SH AA T G AH N ER
SHOTGUNNERS	SH AA T G AH N ER Z
SHOTGUNNING	SH AA T G AH N IH NG
SHUNNED	SH AH N D
SHUNNER	SH AH N ER
SHUNNERS	SH AH N ER Z
SHUNNING	SH AH N IH NG
SIENNA	S IY EH N AH
SIENNAS	S IY EH N AH Z
SINNED	S IH N D
SINNER	S IH N ER
SINNERS	S IH N ER Z
SINNING	S IH N IH NG
SIXPENNY	S IH K S P EH N IY
SKINNED	S K IH N D
SKINNER	S K IH N ER
SKINNERS	S K IH N ER Z
SKINNIER	S K IH N IY ER
SKINNIEST	S K IH N IY AH S T
SKINNINESS	S K IH N IY N AH S
SKINNINESSES	S K IH N IY N AH S IH Z
SKINNING	S K IH N IH NG
SKINNY	S K IH N IY
SODDENNESS	S AA D AH N AH S
SODDENNESSES	S AA D AH N AH S IH Z
SOLEMNNESS	S AA L AH M N AH S
SOLEMNNESSES	S AA L AH M N AH S IH Z
SONNET	S AA N IH T
SONNETED	S AA N AH T IH D
SONNETEER	S AA N AH T IH R
SONNETEERING	S AA N AH T IH R IH NG
SONNETEERINGS	S AA N AH T IH R IH NG Z
SONNETEERS	S AA N AH T IH R Z
SONNETING	S AA N AH T IH NG
SONNETS	S AA N IH T S
SONNETTED	S AA N AH T IH D
SONNETTING	S AA N AH T IH NG
SONNIES	S AH N IY Z
SONNY	S AH N IY
SOUTHERNNESS	S AH DH ER N AH S
SOUTHERNNESSES	S AH DH ER N AH S IH Z
SPANNED	S P AE N D
SPANNER	S P AE N ER
SPANNERS	S P AE N ER Z
SPANNING	S P AE N IH NG
SPINNAKER	S P IH N EY K AH R
SPINNAKERS	S P IH N AH K AH R Z
SPINNER	S P IH N ER
SPINNERET	S P IH N AH R EH T
SPINNERETS	S P IH N AH R EH T S
SPINNERETTE	S P IH N ER EH T
SPINNERETTES	S P IH N ER EH T S
SPINNERIES	S P IH N AH R IY Z
SPINNERS	S P IH N ER Z
SPINNERY	S P IH N AH R IY
SPINNEY	S P IH N IY
SPINNEYS	S P IH N EY Z
SPINNIES	S P IH N IY Z
SPINNING	S P IH N IH NG
SPINNINGS	S P IH N IH NG Z
SPINNY	S P IH N IY
SQUINNIED	S K W IH N AY D
SQUINNIER	S K W IH N AY AH R
SQUINNIES	S K W IH N AY Z
SQUINNIEST	S K W IH N AY AH S T
SQUINNY	S K W IH N IY
SQUINNYING	S K W IH N AY AH NG
STANNARIES	S T AE N AH R AY Z
STANNARY	S T AE N AH R IY
STANNIC	S T AE N AH K
STANNITE	S T AE N AY T
STANNITES	S T AE N AY T S
STANNOUS	S T AE N AH S
STANNUM	S T AE N AH M
STANNUMS	S T AE N AH M Z
STERNNESS	S T ER N N AH S
STERNNESS(2)	S T ER N AH S
STERNNESSES	S T ER N AH S IH Z
STUBBORNNESS	S T AH B ER N N AH S
STUBBORNNESS(2)	S T AH B ER N AH S
STUBBORNNESSES	S T AH B ER N AH S IH Z
STUNNED	S T AH N D
STUNNER	S T AH N ER
STUNNERS	S T AH N ER Z
STUNNING	S T AH N IH NG
STUNNINGLY	S T AH N IH NG L IY
SUDDENNESS	S AH D AH N N AH S
SUDDENNESSES	S AH D AH N AH S IH Z
SULLENNESS	S AH L AH N AH S
SULLENNESSES	S AH L AH N AH S IH Z
SUNBONNET	S AH N B AA N AH T
SUNBONNETS	S AH N B AA N AH T S
SUNN	S AH N
SUNNA	S AH N AH
SUNNAH	S AH N AH
SUNNAHS	S AH N AH Z
SUNNAS	S AH N AH Z
SUNNED	S AH N D
SUNNIER	S AH N IY ER
SUNNIEST	S AH N IY AH S T
SUNNILY	S AH N IY L IY
SUNNINESS	S AH N IY N AH S
SUNNINESSES	S AH N IY N AH S IH Z
SUNNING	S AH N IH NG
SUNNS	S AH N Z
SUNNY	S AH N IY
SUNTANNED	S AH N T AE N D
SUPERANNUATE	S UW P AH R AE N Y UW EY T
SUPERANNUATED	S UW P AH R AE N Y UW EY T AH D
SUPERANNUATES	S UW P AH R AE N Y UW EY T S
SUPERANNUATING	S UW P AH R AE N Y UW EY T AH NG
SUPERANNUATION	S UW P AH R AE N Y UW EY SH AH N
SUPERANNUATIONS	S UW P AH R AE N Y UW EY T IY AH N Z
SUPERHUMANNESS	S UW P ER HH Y UW M AH N AH S
SUPERHUMANNESSES	S UW P ER HH Y UW M AH N AH S IH Z
SWANNED	S W AA N D
SWANNERIES	S W AA N AH R IY Z
SWANNERY	S W AA N AH R IY
SWANNING	S W AA N IH NG
SWINNEY	S W IH N IY
SWINNEYS	S W IH N EY Z
TANNABLE	T AE N AH B AH L
TANNAGE	T AE N IH JH
TANNAGES	T AE N IH JH IH Z
TANNATE	T AE N AH T
TANNATES	T AE N AH T S
TANNED	T AE N D
TANNER	T AE N ER
TANNERIES	T AE N AH R IY Z
TANNERS	T AE N ER Z
TANNERY	T AE N AH R IY
TANNEST	T AE N IH S T
TANNIC	T AE N IH K
TANNIN	T AE N AH N
TANNING	T AE N IH NG
TANNINGS	T AE N IH NG Z
TANNINS	T AE N AH N Z
TANNISH	T AE N IH SH
TENNER	T EH N ER
TENNERS	T EH N ER Z
TENNIES	T EH N IY Z
TENNIS	T EH N AH S
TENNIS(2)	T EH N IH S
TENNISES	T EH N AH S IH Z
TENNIST	T EH N IH S T
TENNISTS	T EH N IH S T S
TENPENNY	T EH N P EH N IY
TERCENTENNIAL	T AH R S EH N T EH N IY AH L
TERCENTENNIALS	T AH R S AH N T EH N IY AH L Z
TETRAHYDROCANNABINOL	T EH T R AH HH IH D R AH K AH N AE B AH N AH L
TETRAHYDROCANNABINOLS	T EH T R AH HH IH D R AH K AH N AE B AH N AH L Z
THINNED	TH IH N D
THINNER	TH IH N ER
THINNERS	TH IH N ER Z
THINNESS	TH IH N N IH S
THINNESS(2)	TH IH N IH S
THINNESSES	TH IH N AH S IH Z
THINNEST	TH IH N IH S T
THINNING	TH IH N IH NG
THINNISH	TH IH N IH SH
THREEPENNY	TH R IY P EH N IY
TIEMANNITE	T IY M AH N AY T
TIEMANNITES	T IY M AH N AY T S
TINNED	T IH N D
TINNER	T IH N ER
TINNERS	T IH N ER Z
TINNIER	T IH N IY ER
TINNIEST	T IH N IY AH S T
TINNILY	T IH N IY L IY
TINNINESS	T IH N IY N AH S
TINNINESSES	T IH N IY N AH S IH Z
TINNING	T IH N IH NG
TINNITUS	T IH N AH T AH S
TINNITUSES	T IH N AH T Y UW Z AH Z
TINNY	T IH N IY
TINTINNABULARY	T IH N T IH N AE B Y AH L EH R IY
TINTINNABULATION	T IH N T IH N AE B Y AH L EY SH AH N
TINTINNABULATIONS	T IH N T AH N AE B Y AH L EY T IY AH N Z
TONNAGE	T AH N AH JH
TONNAGE(2)	T AH N IH JH
TONNAGES	T AH N AH JH AH Z
TONNE	T AH N
TONNEAU	T AA N IY UW
TONNEAUS	T AA N IY AH S
TONNEAUX	T AA N IY AH K S
TONNER	T AH N ER
TONNERS	T AH N ER Z
TONNES	T AH N Z
TONNISH	T AH N IH SH
TOPMINNOW	T AA P M IH N OW
TOPMINNOWS	T AA P M IH N OW Z
TRAGEDIENNE	T R AE JH AH D IY N
TRAGEDIENNES	T R AE JH AH D IY N Z
TRAPANNED	T R AE P AH N D
TRAPANNING	T R AH P AE N AH NG
TREPANNED	T R EH P AH N D
TREPANNING	T R AH P AE N AH NG
TRIENNIA	T R IY N IY AH
TRIENNIAL	T R AY EH N IY AH L
TRIENNIALLY	T R AY AH N IY AH L IY
TRIENNIALS	T R AY AH N IY AH L Z
TRIENNIUM	T R IY N IY AH M
TRIENNIUMS	T R IY N IY AH M Z
TRIPINNATE	T R IH P IH N EY T
TRIPINNATELY	T R IH P IH N EY T L IY
TRUEPENNIES	T R UW P EH N IY Z
TRUEPENNY	T R UW P EH N IY
TRUNNEL	T R AH N AH L
TRUNNELS	T R AH N AH L Z
TRUNNION	T R AH N IY AH N
TRUNNIONS	T R AH N IY AH N Z
TUNNAGE	T AH N AH JH
TUNNAGES	T AH N AH JH AH Z
TUNNED	T AH N D
TUNNEL	T AH N AH L
TUNNELED	T AH N AH L D
TUNNELER	T AH N AH L ER
TUNNELERS	T AH N AH L ER Z
TUNNELING	T AH N AH L IH NG
TUNNELLED	T AH N AH L D
TUNNELLIKE	T AH N AH L AY K
TUNNELLING	T AH N AH L IH NG
TUNNELS	T AH N AH L Z
TUNNIES	T AH N AY Z
TUNNING	T AH N AH NG
TUNNY	T AH N IY
TUPPENNY	T AH P EH N IY
TURBANNED	T ER B AH N D
TWINNED	T W IH N D
TWINNING	T W IH N IH NG
TWINNINGS	T W IH N IH NG Z
TWOPENNY	T W AH P EH N IY
TYRANNIC	T AH R AE N IH K
TYRANNICAL	T ER AE N IH K AH L
TYRANNICALLY	T AH R AE N IH K AH L IY
TYRANNICALNESS	T AH R AE N IH K AH L N AH S
TYRANNICALNESSES	T AH R AE N IH K AH L N AH S IH Z
TYRANNICIDE	T AH R AE N AH S AY D
TYRANNICIDES	T AH R AE N AH S AY D Z
TYRANNIES	T IH R AH N IY Z
TYRANNISE	T IH R AH N AY Z
TYRANNISED	T IH R AH N IY Z D
TYRANNISES	T IH R AH N IY Z IH Z
TYRANNISING	T IH R AH N IY Z IH NG
TYRANNIZE	T IH R AH N AY Z
TYRANNIZED	T IH R AH N AY Z D
TYRANNIZER	T IH R AH N AY Z AH R
TYRANNIZERS	T AH R AE N AH Z AH R Z
TYRANNIZES	T IH R AH N AY Z AH Z
TYRANNIZING	T IH R AH N AY Z AH NG
TYRANNOSAUR	T AH R AE N AH S AH R
TYRANNOSAURS	T AH R AE N AH S EY Y AH R Z
TYRANNOSAURUS	T IH R AE N AH S AO R AH S
TYRANNOSAURUSES	T AH R AE N AA S AH R UW Z AH Z
TYRANNOUS	T AH R AE N AH S
TYRANNOUSLY	T AH R AE N OW AH S L IY
TYRANNY	T IH R AH N IY
UNANNOTATED	AH N AE N AH T EY T AH D
UNANNOUNCED	AH N AH N AW N S T
UNBANNED	AH N B AE N D
UNBANNING	AH N B AE N IH NG
UNBONNET	AH N B AA N AH T
UNBONNETED	AH N B AA N AH T IH D
UNBONNETING	AH N B AA N AH T IH NG
UNBONNETS	AH N B AA N AH T S
UNCANNIER	AH N K AE N IY ER
UNCANNIEST	AH N K AE N IY AH S T
UNCANNILY	AH N K AE N AH L IY
UNCANNINESS	AH N K AE N IY N AH S
UNCANNINESSES	AH N K AE N IY N AH S IH Z
UNCANNY	AH N K AE N IY
UNCERTAINNESS	AH N S ER T AH N AH S
UNCERTAINNESSES	AH N S ER T AH N AH S IH Z
UNCHANNELED	AH N CH AE N AH L D
UNCLEANNESS	AH N K L IY N AH S
UNCLEANNESSES	AH N K L IY N AH S IH Z
UNCOMMONNESS	AH N K AA M AH N AH S
UNCOMMONNESSES	AH N K AA M AH N AH S IH Z
UNCONNECTED	AH N K AH N EH K T IH D
UNDERMANNED	AH N D ER M AE N D
UNDERPINNED	AH N D ER P IH N D
UNDERPINNING	AH N D ER P IH N IH NG
UNDERPINNINGS	AH N D ER P IH N IH NG Z
UNDERRUNNING	AH N D ER R AH N IH NG
UNEVENNESS	AH N IY V AH N AH S
UNEVENNESSES	AH N IY V AH N AH S IH Z
UNFUNNY	AH N F AH N IY
UNKENNED	AH N K EH N D
UNKENNEL	AH N K EH N AH L
UNKENNELED	AH N K EH N AH L D
UNKENNELING	AH N K EH N AH L IH NG
UNKENNELLED	AH N K EH N AH L D
UNKENNELLING	AH N K EH N AH L IH NG
UNKENNELS	AH N K EH N AH L Z
UNMANNED	AH N M AE N D
UNMANNERED	AH N M AE N ER D
UNMANNEREDLY	AH N M AE N ER AH D L IY
UNMANNERLINESS	AH N M AE N ER L IY N AH S
UNMANNERLINESSES	AH N M AE N ER L IY N AH S IH Z
UNMANNERLY	AH N M AE N ER L IY
UNMANNING	AH N M AE N IH NG
UNNAIL	AH N EY L
UNNAILED	AH N EY L D
UNNAILING	AH N EY L IH NG
UNNAILS	AH N EY L Z
UNNAMEABLE	AH N EY M AH B AH L
UNNAMED	AH N N EY M D
UNNATURAL	AH N N AE CH ER AH L
UNNATURALLY	AH N N AE CH ER AH L IY
UNNATURALLY(2)	AH N N AE CH ER L IY
UNNATURALLY(3)	AH N AE CH ER L IY
UNNATURALLY(4)	AH N N AE CH R AH L IY
UNNATURALNESS	AH N AE CH AH R AH L N AH S
UNNATURALNESSES	AH N AE CH AH R AH L N AH S IH Z
UNNECESSARILY	AH N N EH S AH S EH R AH L IY
UNNECESSARY	AH N N EH S AH S EH R IY
UNNEEDED	AH N N IY D IH D
UNNEGOTIABLE	AH N IH G OW SH IY AH B AH L
UNNERVE	AH N ER V
UNNERVED	AH N N ER V D
UNNERVES	AH N ER V Z
UNNERVING	AH N ER V IH NG
UNNERVINGLY	AH N ER V IH NG L IY
UNNEUROTIC	AH N UH R AA T IH K
UNNEWSWORTHY	AH N UW Z W ER DH IY
UNNILHEXIUM	AH N IH L HH EH K S IY AH M
UNNILHEXIUMS	AH N IH L HH EH K S IY AH M Z
UNNILPENTIUM	AH N IH L P EH N T IY AH M
UNNILPENTIUMS	AH N IH L P EH N T IY AH M Z
UNNILQUADIUM	AH N IH L K W EY D IY AH M
UNNILQUADIUMS	AH N IH L K W EY D IY AH M Z
UNNOISY	AH N OY Z IY
UNNOTED	AH N OW T IH D
UNNOTICEABLE	AH N OW T AH S AH B AH L
UNNOTICED	AH N N OW T IH S T
UNNOURISHING	AH N ER IH SH IH NG
UNNUMBERED	AH N AH M B ER D
UNPENNED	AH N P EH N D
UNPENNING	AH N P EH N IH NG
UNPINNED	AH N P IH N D
UNPINNING	AH N P IH N IH NG
UNPLANNED	AH N P L AE N D
UNTANNED	AH N T AE N D
UNWINNABLE	AH N W IH N AH B AH L
VAINNESS	V EY N AH S
VAINNESSES	V EY N AH S IH Z
VANNED	V AE N D
VANNER	V AE N ER
VANNERS	V AE N ER Z
VANNING	V AE N IH NG
VICENNIAL	V AY S AH N IY AH L
WANNABE	W AA N AH B IY
WANNABES	W AA N AH B IY Z
WANNED	W AA N D
WANNER	W AA N ER
WANNESS	W AA N AH S
WANNESSES	W AA N AH S IH Z
WANNEST	W AA N AH S T
WANNIGAN	W AA N AH G AH N
WANNIGANS	W AA N AH G AH N Z
WANNING	W AA N IH NG
WANTONNESS	W AO N T AH N AH S
WANTONNESSES	W AO N T AH N AH S IH Z
WARBONNET	W AO R B AA N AH T
WARBONNETS	W AO R B AA N AH T S
WENNIER	W EH N AY AH R
WENNIEST	W EH N AY AH S T
WENNISH	W EH N AH SH
WENNY	W EH N IY
WHINNIED	W IH N IY D
WHINNIER	W IH N IY ER
WHINNIES	W IH N IY Z
WHINNIEST	W IH N IY AH S T
WHINNY	W IH N IY
WHINNYING	W IH N IY IH NG
WHODUNNIT	W AH D AH N AH T
WHODUNNITS	W AH D AH N AH T S
WINNABLE	W IH N AH B AH L
WINNED	W IH N D
WINNER	W IH N ER
WINNERS	W IH N ER Z
WINNING	W IH N IH NG
WINNINGLY	W IH N IH NG L IY
WINNINGS	W IH N IH NG Z
WINNOCK	W IH N AH K
WINNOCKS	W IH N AH K S
WINNOW	W IH N OW
WINNOWED	W IH N OW D
WINNOWER	W IH N OW ER
WINNOWERS	W IH N OW ER Z
WINNOWING	W IH N OW IH NG
WINNOWS	W IH N OW Z
WITHDRAWNNESS	W IH TH D R AO N AH S
WITHDRAWNNESSES	W IH TH D R AO N AH S IH Z
WONNED	W AH N D
WONNER	W AH N ER
WONNERS	W AH N ER Z
WONNING	W AH N IH NG
WOODENNESS	W UH D AH N AH S
WOODENNESSES	W UH D AH N AH S IH Z
WORNNESS	W OW R N AH S
WORNNESSES	W OW R N AH S IH Z
WYNN	W IH N
WYNNS	W IH N Z
YENNED	Y EH N D
YENNING	Y EH N IH NG
ZINNIA	Z IH N IY AH
ZINNIAS	Z IH N IY AH Z
WULFENITE	W AH L F AH N AY T
ADIABATIC	EY D IY AH B AH T AH K
MENUS	M EH N Y UW Z
MY	M AY
IHRAM	IH R AH M
AHOLD	AH HH OW L D
FRO	F R OW
