OU	UW
ABOUGHT	AH B AO T
ABOULIA	AH B AW L Y AH
ABOULIAS	AH B AW L Y AH Z
ABOULIC	AE B OW AH L AH K
ABOUND	AH B AW N D
ABOUNDED	AH B AW N D IH D
ABOUNDING	AH B AW N D IH NG
ABOUNDS	AH B AW N D Z
ABOUT	AH B AW T
ABOVEGROUND	AH B AH V G R AW N D
ABSTEMIOUS	AE B S T IY M IY AH S
ABSTEMIOUSLY	AE B S T AH M IY OW AH S L IY
ABSTEMIOUSNESS	AE B S T IY M IY AW Z N AH S
ABSTEMIOUSNESSES	AE B S T IY M IY AW Z N EH S AH Z
ABSTENTIOUS	AE B S T EH N CH AH S
ACAJOU	AE K AH JH UW
ACAJOUS	AE K AH JH AH S
ACARPOUS	AH K AA R P AH S
ACAULOUS	AH K EY AH L AH S
ACCOUCHEMENT	AE K AW CH M AH N T
ACCOUCHEMENTS	AE K AW K AH M AH N T S
ACCOUCHEUR	AE K AW CH AH R
ACCOUCHEURS	AE K AW CH IY Y AH R Z
ACCOUNT	AH K AW N T
ACCOUNTABILITIES	AH K AW N T AH B IH L AH T EH Z
ACCOUNTABILITY	AH K AW N T AH B IH L IH T IY
ACCOUNTABLE	AH K AW N T AH B AH L
ACCOUNTABLENESS	AH K AW N T AH B AH L N AH S
ACCOUNTABLENESSES	AH K AW N T AH B AH L N AH S IH Z
ACCOUNTABLY	AH K AW N T AH B L IY
ACCOUNTANCIES	AH K AW N T AH N S IY Z
ACCOUNTANCY	AH K AW N T AH N T S IY
ACCOUNTANT	AH K AW N T AH N T
ACCOUNTANTS	AH K AW N T AH N T S
ACCOUNTANTSHIP	AH K AW N T AH N T SH IH P
ACCOUNTANTSHIPS	AH K AW N T AH N T SH IH P S
ACCOUNTED	AH K AW N T IH D
ACCOUNTING	AH K AW N T IH NG
ACCOUNTING(2)	AH K AW N IH NG
ACCOUNTINGS	AH K AW N T IH NG Z
ACCOUNTS	AH K AW N T S
ACCOUTER	AH K UW T ER
ACCOUTERED	AH K UW T ER D
ACCOUTERING	AH K UW T ER IH NG
ACCOUTERMENT	AH K UW T ER M AH N T
ACCOUTERMENTS	AH K UW T ER M AH N T S
ACCOUTERS	AH K UW T ER Z
ACCOUTRE	AE K AW T AH R
ACCOUTRED	AE K AW T AH R D
ACCOUTREMENT	AH K UW T ER M AH N T
ACCOUTREMENTS	AH K UW T ER M AH N T S
ACCOUTRES	AE K AW T AH R Z
ACCOUTRING	AE K AW T R AH NG
ACEPHALOUS	AH S EH F AH L AH S
ACEROUS	EY S ER AH S
ACETOUS	AE S AH T AH S
ACIDULOUS	AH S IH JH AH L AH S
ACINOUS	AE S AH N AH S
ACOUSTIC	AH K UW S T IH K
ACOUSTICAL	AH K UW S T IH K AH L
ACOUSTICALLY	AH K UW S T IH K L IY
ACOUSTICIAN	AH K AW S T IH S IY AH N
ACOUSTICIANS	AE K AW S T IH S IY AH N Z
ACOUSTICS	AH K UW S T IH K S
ACRIMONIOUS	AE K R AH M OW N IY AH S
ACRIMONIOUSLY	AE K R AH M AH N IY OW AH S L IY
ACRIMONIOUSNESS	AE K R AH M OW N IY AW Z N AH S
ACRIMONIOUSNESSES	AE K R AH M OW N IY AW Z N EH S AH Z
ACTINOMYCETOUS	AE K T AH N AH M IH S AH T AH S
ADENOCARCINOMATOUS	AH D EH N AH K AA R S AH N AA M AH T AH S
ADENOMATOUS	AE D AH N AA M AH T AH S
ADIPOUS	AH D IH P AH S
ADJOURN	AH JH ER N
ADJOURNED	AH JH ER N D
ADJOURNING	AH JH ER N IH NG
ADJOURNMENT	AH JH ER N M AH N T
ADJOURNMENTS	AH JH ER N M AH N T S
ADJOURNS	AH JH ER N Z
ADNOUN	AE D N AW N
ADNOUNS	AE D N AW N Z
ADSCITITIOUS	AE D Z S AY T AH T IY AH S
ADULTEROUS	AH D AH L T ER AH S
ADULTEROUSLY	AH D AH L T ER AH S L IY
ADUNCOUS	AH D AH NG K AH S
ADVANTAGEOUS	AE D V AH N T EY JH AH S
ADVANTAGEOUSLY	AE D V AE N T EY JH AH S L IY
ADVANTAGEOUSNESS	AE D V AE N T EY JH AH S N AH S
ADVANTAGEOUSNESSES	AE D V AE N T EY JH AH S N AH S IH Z
ADVENTITIOUS	AE D V AH N T IH SH AH S
ADVENTITIOUSLY	AE D V AH N T IH SH AH S L IY
ADVENTUROUS	AE D V EH N CH ER AH S
ADVENTUROUSLY	AH D V EH N CH ER AH S L IY
ADVENTUROUSNESS	AH D V EH N CH ER AH S N AH S
ADVENTUROUSNESSES	AH D V EH N CH ER AH S N AH S IH Z
AENEOUS	EH N IY AH S
AFORETHOUGHT	AH F AO R TH AA T
AFOUL	AH F AW L
AFTERTHOUGHT	AE F T ER TH AA T
AFTERTHOUGHT(2)	AE F T ER TH AO T
AFTERTHOUGHTS	AE F T ER TH AA T S
AFTERTHOUGHTS(2)	AE F T ER TH AO T S
AGAMOUS	AH G EY M AH S
AGOUTI	AH G AW T IY
AGOUTIES	AH G AW T IY Z
AGOUTIS	AH G AW T IY Z
AGOUTY	AH G AW T IY
AGROUND	AH G R AW N D
AIRBOUND	AH IH R B AW N D
ALACRITOUS	AH L AE K R AH T AH S
ALBUMINOUS	AE L B Y UW M AH N AH S
ALEHOUSE	EY L HH AW S
ALEHOUSES	EY L HH AW S IH Z
ALLIACEOUS	AE L IY AH S IY AH S
ALLOGAMOUS	AE L AA G AH M AH S
ALMSHOUSE	AE L M SH AW Z
ALMSHOUSES	AE L M SH AW Z AH Z
ALOUD	AH L AW D
ALTHOUGH	AO L DH OW
ALTITUDINOUS	AE L T AH T Y UW D AH N AH S
ALUMINOUS	AH L UW M AH N AH S
AMADOU	AE M AH D UW
AMADOUS	AH M AE D AH S
AMBIDEXTROUS	AE M B IH D EH K S T R AH S
AMBIDEXTROUSLY	AE M B IH D EH K S T R AH S L IY
AMBIGUOUS	AE M B IH G Y UW AH S
AMBIGUOUSLY	AE M B IH G Y AH W AH S L IY
AMBIGUOUSNESS	AE M B IH G Y AH W AH S N AH S
AMBIGUOUSNESSES	AE M B IH G Y AH W AH S N AH S IH Z
AMBITIOUS	AE M B IH SH AH S
AMBITIOUSLY	AE M B IH SH AH S L IY
AMBITIOUSNESS	AE M B IH SH AH S N AH S
AMBITIOUSNESSES	AE M B IH SH AH S N AH S IH Z
AMENTIFEROUS	AH M EH N T IH F AH R AH S
AMOROUS	AE M ER AH S
AMOROUSLY	AE M AH R AH S L IY
AMOROUSNESS	AE M AH R AH S N AH S
AMOROUSNESSES	AE M AH R AH S N AH S IH Z
AMORPHOUS	AH M AO R F AH S
AMORPHOUSLY	AH M AO R F AH S L IY
AMORPHOUSNESS	AH M AO R F AH S N AH S
AMORPHOUSNESSES	AH M AO R F AH S N AH S IH Z
AMOUNT	AH M AW N T
AMOUNTED	AH M AW N T IH D
AMOUNTED(2)	AH M AW N IH D
AMOUNTING	AH M AW N T IH NG
AMOUNTING(2)	AH M AW N IH NG
AMOUNTS	AH M AW N T S
AMOUR	AA M UW R
AMOURS	AH M OW Y AH R Z
AMPHIBIOUS	AE M F IH B IY AH S
AMPHIBIOUSLY	AE M F IH B IY AH S L IY
AMPHIBIOUSNESS	AE M F IH B IY AH S N AH S
AMPHIBIOUSNESSES	AE M F IH B IY AH S N AH S IH Z
AMPOULE	AE M P OW UW L
AMPOULES	AE M P OW AH L Z
ANACHRONOUS	AH N AE K R AH N AH S
ANACHRONOUSLY	AH N AE K R AA N OW AH S L IY
ANADROMOUS	AH N AE D R AH M AH S
ANALOGOUS	AH N AE L AH G AH S
ANALOGOUSLY	AH N AE L AH G AH S L IY
ANALOGOUSNESS	AH N AE L AH G AH S N AH S
ANALOGOUSNESSES	AH N AE L AH G AH S N AH S IH Z
ANASARCOUS	AE N AH S AA R K AH S
ANATROPOUS	AH N AE T R AH P AH S
ANDOUILLE	AE N D AW AH L
ANDOUILLES	AE N D AW AH L Z
ANDOUILLETTE	AE N D AW AH L EH T
ANDOUILLETTES	AE N D AW IH L EH T S
ANDROGYNOUS	AE N D R AO JH AH N AH S
ANEMOPHILOUS	AH N EH M AH F AY L AH S
ANESTROUS	AH N EH S T R AH S
ANFRACTUOUS	AE N F R AE K T Y AH W AH S
ANGINOUS	AE N JH AH N AH S
ANGIOMATOUS	AE N JH IY AA M AH T AH S
ANGIOSPERMOUS	AE N JH IY AA S AH R M AH S
ANGULOUS	AE N G Y AH L AH S
ANHYDROUS	AE N HH AY D R AH S
ANISOGAMOUS	AE N AH S AA G AH M AH S
ANNOUNCE	AH N AW N S
ANNOUNCED	AH N AW N S T
ANNOUNCEMENT	AH N AW N S M EH N T
ANNOUNCEMENTS	AH N AW N S M EH N T S
ANNOUNCER	AH N AW N S ER
ANNOUNCERS	AH N AW N S ER Z
ANNOUNCES	AH N AW N S IH Z
ANNOUNCING	AH N AW N S IH NG
ANOMALOUS	AH N AA M AH L AH S
ANOMALOUSLY	AH N AA M AH L AH S L IY
ANOMALOUSNESS	AH N AA M AH L AH S N AH S
ANOMALOUSNESSES	AH N AA M AH L AH S N AH S IH Z
ANONYMOUS	AH N AA N AH M AH S
ANONYMOUSLY	AH N AA N AH M AH S L IY
ANONYMOUSNESS	AH N AA N AH M AH S N AH S
ANONYMOUSNESSES	AH N AA N AH M AH S N AH S IH Z
ANSEROUS	AE N Z ER AH S
ANTHOPHILOUS	AE N TH AH F AY L AH S
ANTHROPOPHAGOUS	AE N TH R AA P AH F EY JH AH S
ANTIBOURGEOIS	AE N T AY B UW R ZH W AA
ANTICOUNTERFEITING	AE N T AY K AW N T ER F IH T IH NG
ANTIFOULING	AE N T AY F AW L IH NG
ANTIRELIGIOUS	AE N T AY R IH L IH JH AH S
ANTITUBERCULOUS	AE N T AY T Y AH B AH R K Y AH L AH S
ANTONYMOUS	AE N T AA N AH M AH S
ANUROUS	AE N Y AH R AH S
ANXIOUS	AE NG K SH AH S
ANXIOUS(2)	AE NG SH AH S
ANXIOUSLY	AE NG K SH AH S L IY
ANXIOUSNESS	AE NG K SH AH S N AH S
ANXIOUSNESSES	AE NG K SH AH S N AH S IH Z
AOUDAD	EY AW D AH D
AOUDADS	EY AW D AH D Z
APETALOUS	AH P EH T AH L AH S
APHTHOUS	AE F TH AH S
APODOUS	AH P AA D AH S
APOGAMOUS	AH P AA G AH M AH S
APOSPOROUS	AH P AA S AH R AH S
APTEROUS	AE P T ER AH S
AQUEOUS	EY K W IY AH S
AQUIFEROUS	AE K W IH F AH R AH S
ARACEOUS	AH R EY S AH S
ARBOREOUS	AA R B AO R IY AH S
ARBOROUS	AA R B ER AH S
ARBOUR	AA R B ER
ARBOURED	AA R B OW Y AH R D
ARBOURS	AA R B OW Y AH R Z
ARDOUR	AA R D AH R
ARDOURS	AA R D OW Y AH R Z
ARDUOUS	AA R JH UW AH S
ARDUOUSLY	AA R JH AH W AH S L IY
ARDUOUSNESS	AA R JH AH W AH S N AH S
ARDUOUSNESSES	AA R JH AH W AH S N AH S IH Z
ARENACEOUS	AE R AH N AH S IY AH S
ARENICOLOUS	AE R AH N IH K AH L AH S
ARENOUS	AE R AH N AH S
ARGENTIFEROUS	AA R JH EH N T IH F AH R AH S
ARGILLACEOUS	AA R JH IH L AH S IY AH S
ARMIGEROUS	AA R M IH JH AH R AH S
ARMOUR	AA R M ER
ARMOURED	AA R M ER D
ARMOURER	AA R M ER ER
ARMOURERS	AA R M ER ER Z
ARMOURIES	AA R M ER IY Z
ARMOURING	AA R M ER IH NG
ARMOURS	AA R M ER Z
ARMOURY	AA R M ER IY
AROUND	ER AW N D
AROUND(2)	ER AW N
AROUSAL	ER AW Z AH L
AROUSALS	AH R AW Z AH L Z
AROUSE	ER AW Z
AROUSED	ER AW Z D
AROUSER	AH R AW Z ER
AROUSERS	AH R AW Z ER Z
AROUSES	ER AW Z IH Z
AROUSING	ER AW Z IH NG
ARSENIOUS	AA R S IY N IY AH S
ARSENOUS	AA R S AH N AH S
ARSONOUS	AA R S AH N AH S
ARTERIOVENOUS	AA R T AH R IY AA V AH N AH S
ASCOMYCETOUS	AE S AH M IH S AH T AH S
ASSIDUOUS	AH S IH D W AH S
ASSIDUOUSLY	AH S IH D W AH S L IY
ASSIDUOUSNESS	AE S IH D Y UW AW Z N AH S
ASSIDUOUSNESSES	AE S IH D Y UW AW Z N EH S AH Z
ASTOMOUS	AH Z T OW M AH S
ASTOUND	AH S T AW N D
ASTOUNDED	AH S T AW N D IH D
ASTOUNDING	AH S T AW N D IH NG
ASTOUNDINGLY	AH S T AW N D IH NG L IY
ASTOUNDS	AH S T AW N D Z
ASYNCHRONOUS	EY S IH NG K R AH N AH S
ASYNCHRONOUSLY	EY S IH NG K R AH N AH S L IY
ATHEROMATOUS	AE TH AH R AA M AH T AH S
ATRABILIOUS	AE T R AH B IH L IY AH S
ATRABILIOUSNESS	AE T R AH B IH L IY AW Z N AH S
ATRABILIOUSNESSES	AE T R AH B IH L IY AW Z N EH S AH Z
ATROCIOUS	AH T R OW SH AH S
ATROCIOUSLY	AH T R OW SH AH S L IY
ATROCIOUSNESS	AH T R OW SH AH S N AH S
ATROCIOUSNESSES	AH T R OW SH AH S N AH S IH Z
AUDACIOUS	AA D EY SH AH S
AUDACIOUSLY	AO D AH S IY AH S L IY
AUDACIOUSNESS	AO D AH S IY AH S N AH S
AUDACIOUSNESSES	AO D AH S IY AH S N AH S IH Z
AURIFEROUS	AH R IH F AH R AH S
AUROUS	EY Y AH R AH S
AUSPICIOUS	AA S P IH SH AH S
AUSPICIOUSLY	AO S P IH SH AH S L IY
AUSPICIOUSNESS	AO S P IH SH AH S N AH S
AUSPICIOUSNESSES	AO S P IH SH AH S N AH S IH Z
AUTOCEPHALOUS	AO T AH S EH F AH L AH S
AUTOCHTHONOUS	AH T AA CH TH AH N AH S
AUTOCHTHONOUSLY	AH T AA CH TH AA N OW AH S L IY
AUTOECIOUS	AH T OW AH SH AH S
AUTOECIOUSLY	AO T OW AH S IY OW AH S L IY
AUTOGAMOUS	AO T OW G EY M AH S
AUTOGENOUS	AO T OW JH IY N AH S
AUTOGENOUSLY	AO T OW JH IY N AH S L IY
AUTOLOGOUS	AO T OW L AA G AH S
AUTONOMOUS	AO T AA N AH M AH S
AUTONOMOUSLY	AO T AA N OW M AH S L IY
AUTOROUTE	AO T OW R UW T
AUTOROUTES	AO T OW R UW T S
AUTOTOMOUS	AO T OW T OW M AH S
AVARICIOUS	AE V AH R IH SH AH S
AVARICIOUSLY	AE V AH R IH SH AH S L IY
AVARICIOUSNESS	AE V AH R IH SH AH S N AH S
AVARICIOUSNESSES	AE V AH R IH SH AH S N AH S IH Z
AVOUCH	AH V AW CH
AVOUCHED	AH V AW CH T
AVOUCHER	AH V AW CH ER
AVOUCHERS	AH V AW CH ER Z
AVOUCHES	AH V AW CH IH Z
AVOUCHING	AH V AW CH IH NG
AVOUCHMENT	AH V AW CH M AH N T
AVOUCHMENTS	AH V AW CH M AH N T S
AWMOUS	AO M AH S
AZYGOUS	AE Z AH G AH S
BACKCOUNTRIES	B AE K AH N T R IY Z
BACKCOUNTRY	B AE K AH N T R IY
BACKCOURT	B AE K OW R T
BACKCOURTMAN	B AE K OW R T M AE N
BACKCOURTMEN	B AE K OW R T M EH N
BACKCOURTS	B AE K OW R T S
BACKGROUND	B AE K G R AW N D
BACKGROUNDED	B AE K G R AW N D IH D
BACKGROUNDER	B AE K G R AW N D ER
BACKGROUNDERS	B AE K G R AW N D ER Z
BACKGROUNDING	B AE K G R AW N D IH NG
BACKGROUNDS	B AE K G R AW N D Z
BACKHOUSE	B AE K HH AW S
BACKHOUSES	B AE K HH AW S IH Z
BACKOUT	B AE K AW T
BACKOUTS	B AE K AW T S
BADMOUTH	B AE D M AW TH
BADMOUTHED	B AE D M AW TH T
BADMOUTHING	B AE D M AW TH IH NG
BADMOUTHS	B AE D M AW TH S
BAGHOUSE	B AE G HH AW S
BAGHOUSES	B AE G HH AW S IH Z
BAILOUT	B EY L AW T
BAILOUTS	B EY L AW T S
BARBAROUS	B AA R B ER AH S
BARBAROUSLY	B AA R B AH R AH S L IY
BARBAROUSNESS	B AA R B AH R AH S N AH S
BARBAROUSNESSES	B AA R B AH R AH S N AH S IH Z
BAROUCHE	B AH R AW CH
BAROUCHES	B AH R AW CH AH Z
BARRACOUTA	B AE R AH K AW T AH
BARRACOUTAS	B AE R AH K AW T AH Z
BARRELHOUSE	B AE R AH L HH AW S
BARRELHOUSES	B AE R AH L HH AW S IH Z
BASIDIOMYCETOUS	B AH S IH D IY AH M IH S AH T AH S
BATHHOUSE	B AE TH HH AW S
BATHHOUSES	B AE TH AH S IH Z
BATTAILOUS	B AE T EY L AH S
BATTLEGROUND	B AE T AH L G R AW N D
BATTLEGROUNDS	B AE T AH L G R AW N D Z
BAWDYHOUSE	B AO D IY HH AW S
BAWDYHOUSES	B AO D IY HH AW S IH Z
BAYOU	B AY UW
BAYOUS	B AY UW Z
BEAUCOUP	B OW K UW
BEAUTEOUS	B Y UW T IY AH S
BEAUTEOUSLY	B Y UW T IY AH S L IY
BEAUTEOUSNESS	B Y UW T IY AH S N AH S
BEAUTEOUSNESSES	B Y UW T IY AH S N AH S IH Z
BECLOUD	B IH K L AW D
BECLOUDED	B IH K L AW D IH D
BECLOUDING	B IH K L AW D IH NG
BECLOUDS	B IH K L AW D Z
BEDOUIN	B EH D OW AH N
BEDOUIN(2)	B EH D UW IH N
BEDOUIN(3)	B EH D AH W AH N
BEDOUINS	B EH D OW AH N Z
BEDOUINS(2)	B EH D UW IH N Z
BEDOUINS(3)	B EH D AH W AH N Z
BEFOUL	B IH F AW L
BEFOULED	B IH F AW L D
BEFOULER	B IH F AW L ER
BEFOULERS	B IH F AW L ER Z
BEFOULING	B IH F AW L IH NG
BEFOULS	B IH F AW L Z
BEGLAMOUR	B IH G L AE M ER
BEGLAMOURED	B IH G L AE M ER D
BEGLAMOURING	B IH G L AE M ER IH NG
BEGLAMOURS	B IH G L AE M ER Z
BEHAVIOUR	B IH HH EY V Y ER
BEHAVIOURS	B IH HH EY V Y ER Z
BELABOUR	B IH L EY B ER
BELABOURED	B IH L EY B ER D
BELABOURING	B IH L EY B ER IH NG
BELABOURS	B IH L EY B ER Z
BELOWGROUND	B IH L OW G R AW N D
BEROUGED	B IH R UW ZH D
BESCOUR	B IH S K AW ER
BESCOURED	B IH S K AW ER D
BESCOURING	B IH S K AW ER IH NG
BESCOURS	B IH S K AW ER Z
BESHOUT	B IH SH AW T
BESHOUTED	B IH SH AW T IH D
BESHOUTING	B IH SH AW T IH NG
BESHOUTS	B IH SH AW T S
BESHROUD	B IH SH R AW D
BESHROUDED	B IH SH R AW D IH D
BESHROUDING	B IH SH R AW D IH NG
BESHROUDS	B IH SH R AW D Z
BESOUGHT	B IH S AO T
BESPOUSE	B IH S P AW S
BESPOUSED	B IH S P AW S T
BESPOUSES	B IH S P AW S IH Z
BESPOUSING	B IH S P AW S IH NG
BETHOUGHT	B IH TH AO T
BIBLIOLATROUS	B AY B L AY AH L AE T R AH S
BIBULOUS	B IH B Y AH L AH S
BIBULOUSLY	B AY B Y UW L OW AH S L IY
BIBULOUSNESS	B AY B Y AH L AW Z N AH S
BIBULOUSNESSES	B AY B Y AH L AW Z N EH S AH Z
BICOLOUR	B AY K AH L ER
BICOLOURS	B AY K AH L ER Z
BIGAMOUS	B AY G EY M AH S
BIGAMOUSLY	B AY G EY M AH S L IY
BIGMOUTH	B IH G M AW TH
BIGMOUTHED	B IH G M AW TH T
BIGMOUTHS	B IH G M AW TH S
BIHOURLY	B AY AW ER L IY
BIJOU	B AY JH UW
BIJOUS	B AY JH AH S
BIJOUTERIE	B IH ZH UW T AH R IY
BIJOUTERIES	B IH ZH UW T AH R IY Z
BIJOUX	B AY JH AW K S
BIJUGOUS	B AY JH AH G AH S
BILIOUS	B IH L IY AH S
BILIOUSLY	B AY L AY AH S L IY
BILIOUSNESS	B AY L AY AH S N AH S
BILIOUSNESSES	B AY L AY AH S N AH S IH Z
BIMANOUS	B AY M EY N AH S
BIOACOUSTICS	B AY AH K AW S T AH S Z
BIOFOULING	B AY AH F OW AH L AH NG
BIOFOULINGS	B AY AH F AW L AH NG Z
BIOGENOUS	B AY AA JH AH N AH S
BIPAROUS	B AY P EH R AH S
BIRAMOUS	B AY R AE M AH S
BIRDHOUSE	B ER D HH AW S
BIRDHOUSES	B ER D HH AW S IH Z
BISTOURIES	B AY Z T UH R IY Z
BISTOURY	B AY Z T UH R IY
BITUMINOUS	B IH T UW M AH N AH S
BIVOUAC	B IH V W AE K
BIVOUACKED	B IH V AH W AE K T
BIVOUACKING	B IH V AH W AE K IH NG
BIVOUACKS	B AY V AW AH K S
BIVOUACS	B IH V AH W AE K S
BLABBERMOUTH	B L AE B ER M AW TH
BLABBERMOUTHS	B L AE B ER M AW TH S
BLACKOUT	B L AE K AW T
BLACKOUTS	B L AE K AW T S
BLASPHEMOUS	B L AE S F AH M AH S
BLASPHEMOUSLY	B L AE S F AH M AH S L IY
BLASPHEMOUSNESS	B L AE S F AH M AH S N AH S
BLASPHEMOUSNESSES	B L AE S F AH M AH S N AH S IH Z
BLOCKHOUSE	B L AA K HH AW S
BLOCKHOUSES	B L AA K HH AW S AH Z
BLOODHOUND	B L AH D HH AW N D
BLOODHOUNDS	B L AH D HH AW N D Z
BLOODHOUNDS(2)	B L AH D HH AW N Z
BLOUSE	B L AW S
BLOUSED	B L AW S T
BLOUSES	B L AW S AH Z
BLOUSES(2)	B L AW S IH Z
BLOUSIER	B L AW S IY ER
BLOUSIEST	B L AW S IY AH S T
BLOUSILY	B L AW S IY L IY
BLOUSING	B L AW S IH NG
BLOUSON	B L AW S AH N
BLOUSONS	B L AW S AH N Z
BLOUSY	B L AW S IY
BLOWOUT	B L OW AW T
BLOWOUTS	B L OW AW T S
BLUSTEROUS	B L AH S T ER AH S
BOARDINGHOUSE	B AO R D IH NG HH AW S
BOARDINGHOUSES	B AO R D IH NG HH AW S IH Z
BOATHOUSE	B OW T HH AW S
BOATHOUSES	B OW AH TH AH S IH Z
BODACIOUS	B OW D AH S IY AH S
BODACIOUSLY	B OW D AH S IY AH S L IY
BOISTEROUS	B OY S T ER AH S
BOISTEROUS(2)	B OY S T R AH S
BOISTEROUSLY	B OY S T AH R AH S L IY
BOISTEROUSNESS	B OY S T AH R AH S N AH S
BOISTEROUSNESSES	B OY S T AH R AH S N AH S IH Z
BONHOMOUS	B AA N HH AH M AH S
BOOKLOUSE	B UH K L AW S
BOROUGH	B ER OW
BOROUGHS	B ER OW Z
BOUBOU	B AW B UW
BOUBOUS	B AW B AH S
BOUCHEE	B AW CH IY IY
BOUCHEES	B AW CH IY Z
BOUCLE	B UW K L EY
BOUCLES	B UW K L EY Z
BOUDOIR	B UW D OY R
BOUDOIRS	B UW D W AA Z
BOUFFANT	B UW F AA N T
BOUFFANTS	B UW F AA N T S
BOUFFE	B UW F
BOUFFES	B UW F S
BOUGAINVILLAEA	B AW G EY N V IH L IY AH
BOUGAINVILLAEAS	B AW G EY N V IH L IY AH Z
BOUGAINVILLEA	B UW G EY N V IH L IY AH
BOUGAINVILLEAS	B AW G EY N V IH L IY Z
BOUGH	B AW
BOUGHED	B AW D
BOUGHPOT	B AW P AA T
BOUGHPOTS	B AW P AA T S
BOUGHS	B AW Z
BOUGHT	B AA T
BOUGHT(2)	B AO T
BOUGHTEN	B AO T AH N
BOUGIE	B UW ZH IY
BOUGIES	B UW ZH IY Z
BOUILLABAISSE	B AW IH L AH B EY S
BOUILLABAISSES	B AW IH L AH B EY S AH Z
BOUILLON	B UW W IH L AH N
BOUILLONS	B AW IH L AH N Z
BOULDER	B OW L D ER
BOULDERED	B OW L D ER D
BOULDERS	B OW L D ER Z
BOULDERY	B OW L D ER IY
BOULE	B UW L
BOULES	B OW AH L Z
BOULEVARD	B UH L AH V AA R D
BOULEVARDIER	B UH L AH V AA R D IY ER
BOULEVARDIERS	B UH L AH V AA R D IY ER Z
BOULEVARDS	B UH L AH V AA R D Z
BOULEVERSEMENT	B AW L AH V AH R S M AH N T
BOULEVERSEMENTS	B AW L AH V AH R S AH M AH N T S
BOULLE	B UW L
BOULLES	B UW L Z
BOUNCE	B AW N S
BOUNCED	B AW N S T
BOUNCER	B AW N S ER
BOUNCERS	B AW N S ER Z
BOUNCES	B AW N S IH Z
BOUNCIER	B AW N S IY ER
BOUNCIEST	B AW N S IY AH S T
BOUNCILY	B AW N S IY L IY
BOUNCING	B AW N S IH NG
BOUNCINGLY	B AW N S IH NG L IY
BOUNCY	B AW N S IY
BOUND	B AW N D
BOUNDARIES	B AW N D ER IY Z
BOUNDARIES(2)	B AW N D R IY Z
BOUNDARY	B AW N D ER IY
BOUNDARY(2)	B AW N D R IY
BOUNDED	B AW N D AH D
BOUNDED(2)	B AW N D IH D
BOUNDEDNESS	B AW N D AH D N AH S
BOUNDEDNESSES	B AW N D AH D N AH S IH Z
BOUNDEN	B AW N D AH N
BOUNDER	B AW N D ER
BOUNDERISH	B AW N D ER IH SH
BOUNDERS	B AW N D ER Z
BOUNDING	B AW N D IH NG
BOUNDLESS	B AW N D L AH S
BOUNDLESSLY	B AW N D L AH S L IY
BOUNDLESSNESS	B AW N D L AH S N AH S
BOUNDLESSNESSES	B AW N D L AH S N AH S IH Z
BOUNDS	B AW N D Z
BOUNTEOUS	B AW N T IY AH S
BOUNTEOUSLY	B AW N T IY OW AH S L IY
BOUNTEOUSNESS	B AW N T IY AW Z N AH S
BOUNTEOUSNESSES	B AW N T IY AW Z N EH S AH Z
BOUNTIED	B AW N T IY D
BOUNTIES	B AW N T IY Z
BOUNTIFUL	B AW N T IH F AH L
BOUNTIFUL(2)	B AW N IH F AH L
BOUNTIFULLY	B AW N T IY F AH L IY
BOUNTIFULNESS	B AW N T IY F AH L N AH S
BOUNTIFULNESSES	B AW N T IY F AH L N AH S IH Z
BOUNTY	B AW N T IY
BOUQUET	B UW K EY
BOUQUETS	B OW K EY Z
BOUQUETS(2)	B UW K EY Z
BOURBON	B ER B AH N
BOURBONISM	B ER B AH N IH Z AH M
BOURBONISMS	B ER B AH N IH Z AH M Z
BOURBONS	B ER B AH N Z
BOURDON	B AH R D AH N
BOURDONS	B AH R D AH N Z
BOURG	B AO R G
BOURGEOIS	B UH R ZH W AA
BOURGEOISE	B AH R JH IY OY Z
BOURGEOISES	B UW R ZH W AA Z
BOURGEOISIE	B UH R ZH W AA Z IY
BOURGEOISIES	B UW R ZH W AA IY Z
BOURGEOISIFICATION	B UW R ZH W AA AH F AH K EY SH AH N
BOURGEOISIFICATIONS	B UW R ZH W AA AH F AH K EY SH AH N Z
BOURGEOISIFIED	B UW R ZH W AA AH F AY D
BOURGEOISIFIES	B UW R ZH W AA AH F AY Z
BOURGEOISIFY	B UW R ZH W AA AH F AY
BOURGEOISIFYING	B UW R ZH W AA AH F AY IH NG
BOURGEON	B AH R JH AH N
BOURGEONED	B AH R JH IY OW N D
BOURGEONING	B AH R JH IY OW N AH NG
BOURGEONS	B AH R JH IY AH N Z
BOURGS	B AH R G Z
BOURGUIGNON	B UH R G IY N Y OW N
BOURGUIGNONNE	B AH R G UW G N AH N
BOURN	B AO R N
BOURNE	B AO R N
BOURNES	B AH R N Z
BOURNS	B AO R N Z
BOURREE	B AH R IY IY
BOURREES	B OW R IY Z
BOURRIDE	B AH R AY D
BOURRIDES	B AH R AY D Z
BOURSE	B AO R S
BOURSES	B AO R S IH Z
BOURTREE	B AH R T R IY IY
BOURTREES	B AH R T R IY Z
BOUSE	B AW S
BOUSED	B IY AH S T
BOUSES	B IY AH S IH Z
BOUSING	B IY AH S IH NG
BOUSOUKI	B AW S AW K IY
BOUSOUKIA	B AW S AW K IY AH
BOUSOUKIS	B AW S AW K AH S
BOUSTROPHEDON	B AW S T R AA F AH D AH N
BOUSTROPHEDONIC	B AW S T R AA F AH D AH N AH K
BOUSTROPHEDONS	B AW S T R AA F AH D AH N Z
BOUSY	B IY AH S IY
BOUT	B AW T
BOUTIQUE	B UW T IY K
BOUTIQUES	B UW T IY K S
BOUTON	B AW T AH N
BOUTONNIERE	B AW T AH N IY R
BOUTONNIERES	B AW T AH N IY R Z
BOUTONS	B AW T AO N Z
BOUTS	B AW T S
BOUVIER	B UW V IY EY
BOUVIERS	B AW V IY R Z
BOUZOUKI	B AW Z AW K IY
BOUZOUKIA	B AW Z AW K IY AH
BOUZOUKIS	B AW Z AW K AH S
BRACHYPTEROUS	B R AH CH IH P T AH R AH S
BRASSBOUND	B R AE S B AW N D
BREAKOUT	B R EY K AW T
BREAKOUTS	B R EY K AW T S
BREAKTHROUGH	B R EY K TH R UW
BREAKTHROUGHS	B R EY K TH R UW Z
BREECHCLOUT	B R IY CH K L AW T
BREECHCLOUTS	B R IY CH K L AW T S
BROMOURACIL	B R AH M AH R AH S AH L
BROMOURACILS	B R AA M AH Y UH R AH S AH L Z
BROUGHAM	B R UW G AH M
BROUGHAMS	B R AW AH M Z
BROUGHT	B R AO T
BROUHAHA	B R UW HH AA HH AA
BROUHAHAS	B R AW HH AH HH AH Z
BROWNOUT	B R AW N AW T
BROWNOUTS	B R AW N AW T S
BRUMOUS	B R UW M AH S
BUGHOUSE	B AH G HH AW S
BUGHOUSES	B AH G HH AW S IH Z
BULBOUS	B AH L B AH S
BULBOUSLY	B AH L B AH S L IY
BULLOUS	B UH L AH S
BULLPOUT	B UH L P AW T
BULLPOUTS	B UH L P AW T S
BUMPTIOUS	B AH M P SH AH S
BUMPTIOUSLY	B AH M P SH AH S L IY
BUMPTIOUSNESS	B AH M P SH AH S N AH S
BUMPTIOUSNESSES	B AH M P SH AH S N AH S IH Z
BUNKHOUSE	B AH NG K HH AW S
BUNKHOUSES	B AH NG K HH AW S IH Z
BURGLARIOUS	B ER G L AH R IY AH S
BURGLARIOUSLY	B ER G L AH R IY AH S L IY
BURGOUT	B AH R G AW T
BURGOUTS	B AH R G AH Y UW T S
BURNOUS	B ER N AH S
BURNOUSES	B ER N AH S IH Z
BURNOUT	B ER N AW T
BURNOUTS	B ER N AW T S
BUTYROUS	B Y UW T AH R AH S
BUYOUT	B AY AW T
BUYOUTS	B AY AW T S
CACHOU	K AE CH UW
CACHOUS	K AE SH AH S
CACOPHONOUS	K AE K AA F AH N AH S
CACOPHONOUSLY	K AE K AA F AH N AH S L IY
CADAVEROUS	K AH D AE V ER AH S
CADAVEROUSLY	K AH D AE V ER AH S L IY
CADUCOUS	K AE D Y UW K AH S
CALAMITOUS	K AH L AE M AH T AH S
CALAMITOUSLY	K AH L AE M AH T AH S L IY
CALCAREOUS	K AE L K AE R IY AH S
CALCAREOUSLY	K AE L K AH R IY OW AH S L IY
CALCICOLOUS	K AE L S IH K AH L AH S
CALCIFEROUS	K AE L S IH F AH R AH S
CALCIFUGOUS	K AE L S AH F Y UW G AH S
CALCULOUS	K AE L K Y AH L AH S
CALIGINOUS	K AH L IH JH AH N AH S
CALLIPYGOUS	K AE L IH P AH G AH S
CALLOUS	K AE L AH S
CALLOUSED	K AE L AH S T
CALLOUSES	K AE L AH S IH Z
CALLOUSING	K AE L AH S IH NG
CALLOUSLY	K AE L AH S L IY
CALLOUSNESS	K AE L AH S N AH S
CALLOUSNESSES	K AE L AH S N AH S IH Z
CALUMNIOUS	K AE L AH M N IY AH S
CALUMNIOUSLY	K AE L AH M N IY AH S L IY
CAMOUFLAGE	K AE M AH F L AA ZH
CAMOUFLAGEABLE	K AE M AH F L AA ZH AH B AH L
CAMOUFLAGED	K AE M AH F L AA ZH D
CAMOUFLAGES	K AE M AH F L AA ZH IH Z
CAMOUFLAGIC	K AE M AH F L AA ZH IH K
CAMOUFLAGING	K AE M AH F L AA ZH IH NG
CAMPGROUND	K AE M P G R AW N D
CAMPGROUNDS	K AE M P G R AW N D Z
CAMPHORACEOUS	K AE M F AH R AH S IY AH S
CAMPYLOTROPOUS	K AE M P IY L AA T R OW P AH S
CANCELLOUS	K AE N S AH L AH S
CANCEROUS	K AE N S ER AH S
CANCEROUSLY	K AE N S ER AH S L IY
CANDOUR	K AE N D ER
CANDOURS	K AE N D ER Z
CANKEROUS	K AE NG K ER AH S
CANOROUS	K EY N ER AH S
CANOROUSLY	K EY N ER AH S L IY
CANOROUSNESS	K EY N ER AH S N AH S
CANOROUSNESSES	K EY N ER AH S N AH S IH Z
CANTALOUP	K AE N T AH L UW P
CANTALOUPE	K AE N T AH L OW P
CANTALOUPES	K AE N T AH L OW P S
CANTALOUPS	K AE N T AH L UW P S
CANTANKEROUS	K AE N T AE NG K ER AH S
CANTANKEROUSLY	K AE N T AE NG K ER AH S L IY
CANTANKEROUSNESS	K AE N T AE NG K ER AH S N AH S
CANTANKEROUSNESSES	K AE N T AE NG K ER AH S N AH S IH Z
CAOUTCHOUC	K EY AW CH AW K
CAOUTCHOUCS	K EY AW CH AW K S
CAPACIOUS	K AH P EY SH AH S
CAPACIOUSLY	K AH P EY SH AH S L IY
CAPACIOUSNESS	K AH P EY SH AH S N AH S
CAPACIOUSNESSES	K AH P EY SH AH S N AH S IH Z
CAPOUCH	K AH P AW CH
CAPOUCHES	K AH P AW CH AH Z
CAPRICIOUS	K AH P R IH SH AH S
CAPRICIOUSLY	K AH P R IH SH IH S L IY
CAPRICIOUSNESS	K AH P R IH SH AH S N AH S
CAPRICIOUSNESSES	K AH P R IH SH AH S N AH S IH Z
CAPTIOUS	K AE P SH AH S
CAPTIOUSLY	K AE P SH AH S L IY
CAPTIOUSNESS	K AE P SH AH S N AH S
CAPTIOUSNESSES	K AE P SH AH S N AH S IH Z
CARBONACEOUS	K AA R B AH N EY S AH S
CARBONIFEROUS	K AA R B AH N IH F ER AH S
CARCAJOU	K AA R K AH JH UW
CARCAJOUS	K AA R K AH JH AH S
CARCINOMATOUS	K AA R S AH N AA M AH T AH S
CARIBOU	K EH R IH B UW
CARIBOUS	K AE R AH B AH S
CARIOUS	K EH R IY AH S
CARNIVOROUS	K AA R N IH V ER AH S
CARNIVOROUSLY	K AA R N IH V ER AH S L IY
CARNIVOROUSNESS	K AA R N IH V ER AH S N AH S
CARNIVOROUSNESSES	K AA R N IH V ER AH S N AH S IH Z
CAROUSAL	K AH R AW Z AH L
CAROUSALS	K AH R AW Z AH L Z
CAROUSE	K ER AW Z
CAROUSED	K AH R AW Z D
CAROUSEL	K EH R AH S EH L
CAROUSELS	K AH R AW S AH L Z
CAROUSER	K AH R AW Z ER
CAROUSERS	K AH R AW Z ER Z
CAROUSES	K AH R AW Z IH Z
CAROUSING	K ER AW Z IH NG
CARREFOUR	K AA R IY F OW R
CARREFOURS	K AA R IY F OW R Z
CARROUSEL	K EH R AH S EH L
CARROUSELS	K AE R AW S AH L Z
CARRYOUT	K AE R IY AW T
CARRYOUTS	K AE R IY AW T S
CARTILAGINOUS	K AA R T IH L AH JH IH N AH S
CARTOUCH	K AA R T AH CH
CARTOUCHE	K AA R T AW CH
CARTOUCHES	K AA R T AH CH IH Z
CASEOUS	K EY S AH S
CASSOULET	K AE S AW L AH T
CASSOULETS	K AE S AW L AH T S
CATADROMOUS	K AH T AE D R AH M AH S
CATAMOUNT	K AE T AH M AW N T
CATAMOUNTS	K AE T AH M AW N T S
CATARACTOUS	K EY T ER AE K T AH S
CATHOUSE	K AE T HH AW S
CATHOUSES	K AE T HH AW S IH Z
CAUTIOUS	K AO SH AH S
CAUTIOUSLY	K AO SH AH S L IY
CAUTIOUSNESS	K AO SH AH S N AH S
CAUTIOUSNESSES	K AO SH AH S N AH S IH Z
CAVERNICOLOUS	K AH V AH R N IH K AH L AH S
CAVERNOUS	K AE V ER N AH S
CAVERNOUSLY	K AE V ER N AH S L IY
CEMENTITIOUS	S IH M EH N T AH T IY AH S
CENSORIOUS	S EH N S ER IY AH S
CENSORIOUSLY	S EH N S ER IY AH S L IY
CENSORIOUSNESS	S EH N S ER IY AH S N AH S
CENSORIOUSNESSES	S EH N S ER IY AH S N AH S IH Z
CEREMONIOUS	S EH R AH M OW N IY AH S
CEREMONIOUSLY	S EH R AH M OW N IY AH S L IY
CEREMONIOUSNESS	S EH R AH M OW N IY AH S N AH S
CEREMONIOUSNESSES	S EH R AH M OW N IY AH S N AH S IH Z
CERNUOUS	S AH R N Y AH W AH S
CEROUS	S IY R AH S
CERUMINOUS	S AH R UW M AH N AH S
CETACEOUS	S IY T AH S IY AH S
CHABOUK	CH AH B AW K
CHABOUKS	CH AH B AW K S
CHAMPERTOUS	CH AE M P AH R T AH S
CHANCROUS	CH AE NG K R AH S
CHECKOUT	CH EH K AW T
CHECKOUTS	CH EH K AW T S
CHIBOUK	CH AH B AW K
CHIBOUKS	CH AH B AW K S
CHIBOUQUE	CH AH B AW K
CHIBOUQUES	CH AH B AW K S
CHITINOUS	K AY T AH N AH S
CHIVALROUS	SH IH V AH L R AH S
CHIVALROUSLY	SH IH V AH L R AH S L IY
CHIVALROUSNESS	SH IH V AH L R AH S N AH S
CHIVALROUSNESSES	SH IH V AH L R AH S N AH S IH Z
CHLOROPHYLLOUS	K L AO R AH F IH L AH S
CHLOROUS	K L AO R AH S
CHOPHOUSE	CH AA P HH AW S
CHOPHOUSES	CH AA P HH AW S IH Z
CHOUGH	CH UW
CHOUGHS	CH AW Z
CHOUSE	CH AW Z
CHOUSED	CH OW AH S T
CHOUSER	CH OW AH S AH R
CHOUSERS	CH AW S AH R Z
CHOUSES	CH AW Z AH Z
CHOUSH	CH AW SH
CHOUSHES	CH AW SH AH Z
CHOUSING	CH AW Z AH NG
CHOWHOUND	CH AW HH AW N D
CHOWHOUNDS	CH AW HH AW N D Z
CHROMOUS	K R OW M AH S
CHYLOUS	CH AY L AH S
CHYMOUS	CH AY M AH S
CIBOULE	S IH B OW UW L
CIBOULES	S IH B OW AH L Z
CINEREOUS	S AH N IY R IY AH S
CIRCUITOUS	S ER K Y UW IH T AH S
CIRCUITOUSLY	S ER K Y UW AH T AH S L IY
CIRCUITOUSNESS	S ER K Y UW AH T AH S N AH S
CIRCUITOUSNESSES	S ER K Y UW AH T AH S N AH S IH Z
CIRCUMFLUOUS	S ER K AH M F L UW AH S
CIRROUS	S AH R AH S
CITREOUS	S IH T R IY AH S
CITROUS	S IH T R AH S
CLAMOROUS	K L AE M ER AH S
CLAMOROUSLY	K L AE M ER AH S L IY
CLAMOROUSNESS	K L AE M ER AH S N AH S
CLAMOROUSNESSES	K L AE M ER AH S N AH S IH Z
CLAMOUR	K L AE M ER
CLAMOURED	K L AH M OW Y AH R D
CLAMOURING	K L AH M OW Y AH R AH NG
CLAMOURS	K L AH M OW Y AH R Z
CLANGOROUS	K L AE NG ER AH S
CLANGOROUSLY	K L AE NG ER AH S L IY
CLANGOUR	K L AE N G AH R
CLANGOURED	K L AE N G OW Y ER D
CLANGOURING	K L AE N G OW Y ER IH NG
CLANGOURS	K L AE N G OW Y AH R Z
CLEARINGHOUSE	K L IH R IH NG HH AW S
CLEARINGHOUSES	K L IY R IH NG HH AW S IH Z
CLEISTOGAMOUS	K L IY S T AA G AH M AH S
CLEISTOGAMOUSLY	K L IY S T AH G AE M OW AH S L IY
CLOSEMOUTHED	K L OW Z M AW TH T
CLOSEOUT	K L OW Z AW T
CLOSEOUTS	K L OW Z AW T S
CLOTHBOUND	K L AO TH B AW N D
CLOUD	K L AW D
CLOUDBERRIES	K L AW D B EH R IY Z
CLOUDBERRY	K L AW D B EH R IY
CLOUDBURST	K L AW D B ER S T
CLOUDBURSTS	K L AW D B ER S T S
CLOUDED	K L AW D IH D
CLOUDIER	K L AW D IY ER
CLOUDIEST	K L AW D IY AH S T
CLOUDILY	K L AW D IY L IY
CLOUDINESS	K L AW D IY N IH S
CLOUDINESSES	K L AW D IY N AH S IH Z
CLOUDING	K L AW D IH NG
CLOUDLAND	K L AW D L AE N D
CLOUDLANDS	K L AW D L AE N D Z
CLOUDLESS	K L AW D L AH S
CLOUDLESSLY	K L AW D L AH S L IY
CLOUDLESSNESS	K L AW D L AH S N AH S
CLOUDLESSNESSES	K L AW D L AH S N AH S IH Z
CLOUDLET	K L AW D L AH T
CLOUDLETS	K L AW D L AH T S
CLOUDS	K L AW D Z
CLOUDSCAPE	K L AW D S K EY P
CLOUDSCAPES	K L AW D S K EY P S
CLOUDY	K L AW D IY
CLOUGH	K L AW
CLOUGHS	K L AW Z
CLOUR	K L AW R
CLOURED	K L OW Y AH R D
CLOURING	K L OW Y AH R AH NG
CLOURS	K L OW Y AH R Z
CLOUT	K L AW T
CLOUTED	K L AW T IH D
CLOUTER	K L AW T ER
CLOUTERS	K L AW T ER Z
CLOUTING	K L AW T IH NG
CLOUTS	K L AW T S
CLUBHOUSE	K L AH B HH AW S
CLUBHOUSES	K L AH B HH AW S IH Z
COBALTOUS	K OW B AO L T AH S
COCCOUS	K AA K AH S
COCOUNSEL	K OW K AW N S AH L
COCOUNSELED	K OW K AW N S AH L D
COCOUNSELING	K OW K AW N S AH L IH NG
COCOUNSELLED	K OW K AW N S AH L D
COCOUNSELLING	K OW K AW N S AH L IH NG
COCOUNSELS	K OW K AW N S AH L Z
COETANEOUS	K OW AH T EY N IY AH S
COFFEEHOUSE	K AO F IY HH AW S
COFFEEHOUSES	K AO F IY HH AW S IH Z
COFOUND	K OW F AW N D
COFOUNDED	K OW F AW N D IH D
COFOUNDER	K OW F AW N D ER
COFOUNDERS	K OW F AW N D ER Z
COFOUNDING	K OW F AW N D IH NG
COFOUNDS	K OW F AW N D Z
COLEOPTEROUS	K OW L AA P T ER AH S
COLLAGENOUS	K AA L AH JH EH N AH S
COLLEMBOLOUS	K AA L EH M B AH L AH S
COLLENCHYMATOUS	K AA L EH NG K IH M AH T AH S
COLOUR	K AH L ER
COLOURED	K AH L ER D
COLOURER	K AH L ER ER
COLOURERS	K AH L ER ER Z
COLOURING	K AH L ER R IH NG
COLOURS	K AH L ER Z
COMMODIOUS	K AH M OW D IY AH S
COMMODIOUSLY	K AH M OW D IY AH S L IY
COMMODIOUSNESS	K AH M OW D IY AH S N AH S
COMMODIOUSNESSES	K AH M OW D IY AH S N AH S IH Z
COMOUS	K AH M AH S
COMPENDIOUS	K AH M P EH N D AY AH S
COMPENDIOUSLY	K AH M P EH N D AY AH S L IY
COMPENDIOUSNESS	K AH M P EH N D AY AH S N AH S
COMPENDIOUSNESSES	K AH M P EH N D AY AH S N AH S IH Z
COMPLICITOUS	K AA M P L IH S AH T AH S
COMPOUND	K AA M P AW N D
COMPOUND(2)	K AH M P AW N D
COMPOUNDABLE	K AH M P AW N D AH B AH L
COMPOUNDED	K AH M P AW N D AH D
COMPOUNDED(2)	K AH M P AW N D IH D
COMPOUNDER	K AH M P AW N D ER
COMPOUNDERS	K AH M P AW N D ER Z
COMPOUNDING	K AH M P AW N D IH NG
COMPOUNDS	K AA M P AW N D Z
COMPOUNDS(2)	K AH M P AW N D Z
COMPUNCTIOUS	K AA M P AH NG K AH S
CONCOURSE	K AA N K AO R S
CONCOURSES	K AA N K AO R S IH Z
CONDYLOMATOUS	K AA N D AH L AA M AH T AH S
CONFOUND	K AA N F AW N D
CONFOUND(2)	K AH N F AW N D
CONFOUNDED	K AH N F AW N D IH D
CONFOUNDEDLY	K AH N F AW N D AH D L IY
CONFOUNDER	K AH N F AW N D ER
CONFOUNDERS	K AH N F AW N D ER Z
CONFOUNDING	K AH N F AW N D IH NG
CONFOUNDINGLY	K AH N F AW N D IH NG L IY
CONFOUNDS	K AH N F AW N D Z
CONGENEROUS	K AH N JH EH N ER AH S
CONGOU	K AA N G UW
CONGOUS	K AA N G AH S
CONGRUOUS	K AA NG G R AH W AH S
CONGRUOUSLY	K AA NG G R AH W AH S L IY
CONGRUOUSNESS	K AA NG G R AH W AH S N AH S
CONGRUOUSNESSES	K AA NG G R AH W AH S N AH S IH Z
CONIFEROUS	K AH N IH F ER AH S
CONSANGUINEOUS	K AA N S AE N G W IH N IY AH S
CONSANGUINEOUSLY	K AA N S AE N G W IH N IY AH S L IY
CONSCIENTIOUS	K AA N SH IY EH N SH AH S
CONSCIENTIOUSLY	K AA N CH IY EH N CH AH S L IY
CONSCIENTIOUSNESS	K AA N CH IY EH N CH AH S N AH S
CONSCIENTIOUSNESSES	K AA N CH IY EH N CH AH S N AH S IH Z
CONSCIOUS	K AA N SH AH S
CONSCIOUSES	K AA N SH AH S IH Z
CONSCIOUSLY	K AA N SH AH S L IY
CONSCIOUSNESS	K AA N SH AH S N AH S
CONSCIOUSNESSES	K AA N SH AH S N AH S IH Z
CONSENTANEOUS	K AA N S EH N T EY N IY AH S
CONSENTANEOUSLY	K AA N S EH N T AH N IY OW AH S L IY
CONSPICUOUS	K AH N S P IH K Y UW AH S
CONSPICUOUSLY	K AH N S P IH K Y UW AH S L IY
CONSPICUOUSNESS	K AH N S P IH K Y AH W AH S N AH S
CONSPICUOUSNESSES	K AH N S P IH K Y AH W AH S N AH S IH Z
CONTAGIOUS	K AH N T EY JH AH S
CONTAGIOUSLY	K AH N T EY JH AH S L IY
CONTAGIOUSNESS	K AH N T EY JH AH S N AH S
CONTAGIOUSNESSES	K AH N T EY JH AH S N AH S IH Z
CONTEMPORANEOUS	K AH N T EH M P ER EY N IY AH S
CONTEMPORANEOUSLY	K AH N T EH M P ER EY N IY AH S L IY
CONTEMPORANEOUSNESS	K AA N T AH M P AH R EY N IY AW Z N AH S
CONTEMPORANEOUSNESSES	K AA N T AH M P AH R EY N IY AW Z N EH S AH Z
CONTEMPTUOUS	K AH N T EH M P CH UW AH S
CONTEMPTUOUSLY	K AH N T EH M P CH UW AH S L IY
CONTEMPTUOUSNESS	K AH N T EH M P CH AH W AH S N AH S
CONTEMPTUOUSNESSES	K AH N T EH M P CH AH W AH S N AH S IH Z
CONTENTIOUS	K AH N T EH N SH AH S
CONTENTIOUSLY	K AH N T EH N T IY AH S L IY
CONTENTIOUSNESS	K AH N T EH N SH AH S N AH S
CONTENTIOUSNESSES	K AH N T EH N T IY AH S N AH S IH Z
CONTERMINOUS	K AH N T ER M AH N AH S
CONTERMINOUSLY	K AH N T ER M AH N AH S L IY
CONTIGUOUS	K AH N T IH G Y UW AH S
CONTIGUOUSLY	K AH N T IH G Y AH W AH S L IY
CONTIGUOUSNESS	K AH N T IH G Y AH W AH S N AH S
CONTIGUOUSNESSES	K AH N T IH G Y AH W AH S N AH S IH Z
CONTINUOUS	K AH N T IH N Y UW AH S
CONTINUOUSLY	K AH N T IH N Y UW AH S L IY
CONTINUOUSNESS	K AH N T IH N Y UW AH S N AH S
CONTINUOUSNESSES	K AH N T IH N Y UW AH S N AH S IH Z
CONTOUR	K AA N T UH R
CONTOURED	K AA N T UH R D
CONTOURING	K AA N T UH R IH NG
CONTOURS	K AA N T UH R Z
CONTRADICTIOUS	K AA N T R AH D IH K T IY AH S
CONTRARIOUS	K AA N T R EH R IY AH S
CONTUMACIOUS	K AH N T UW M AH S IY AH S
CONTUMACIOUSLY	K AH N T UW M AH S IY AH S L IY
CONTUMELIOUS	K AA N T Y AH M IY L IY AH S
CONTUMELIOUSLY	K AA N T Y AH M AH L IY OW AH S L IY
COOKHOUSE	K UH K HH AW S
COOKHOUSES	K UH K HH AW S IH Z
COOKOUT	K UH K AW T
COOKOUTS	K UH K AW T S
COONHOUND	K UW N HH AW N D
COONHOUNDS	K UW N HH AW N D Z
COPIOUS	K OW P IY AH S
COPIOUSLY	K OW P Y AH S L IY
COPIOUSNESS	K OW P IY AH S N AH S
COPIOUSNESSES	K OW P IY AH S N AH S IH Z
COPOUT	K OW P AW T
COPOUTS	K OW P AW T S
COPROPHAGOUS	K AA P R AH F EY JH AH S
COPROPHILOUS	K AA P R AH F AY L AH S
CORIACEOUS	K OW R AY AH S IY AH S
CORMOUS	K AO R M AH S
CORNEOUS	K AO R N IY AH S
COTERMINOUS	K OW T ER M AH N AH S
COTERMINOUSLY	K OW T ER M AH N AH S L IY
COTTONMOUTH	K AA T AH N M AW TH
COTTONMOUTHS	K AA T AH N M AW TH S
COUCH	K AW CH
COUCHANT	K AW CH AH N T
COUCHED	K AW CH T
COUCHER	K AW CH ER
COUCHERS	K AW CH ER Z
COUCHES	K AW CH IH Z
COUCHING	K AW CH IH NG
COUCHINGS	K AW CH IH NG Z
COUDE	K OW Y UW D IY
COUGAR	K UW G ER
COUGARS	K UW G ER Z
COUGH	K AA F
COUGH(2)	K AO F
COUGHED	K AO F T
COUGHER	K AO F ER
COUGHERS	K AO F ER Z
COUGHING	K AA F IH NG
COUGHS	K AO F S
COULD	K UH D
COULDEST	K OW AH L D AH S T
COULDST	K OW AH L D S T
COULEE	K UW L IY
COULEES	K OW Y AH L IY Z
COULIS	K OW AH L AH S
COULISES	K OW Y AH L AY Z AH Z
COULISSE	K OW Y UW L AH S
COULISSES	K OW Y AH L IH S AH Z
COULOIR	K OW Y AH L OY R
COULOIRS	K OW Y AH L OY R Z
COULOMB	K UW L OW M
COULOMBIC	K UW L OW M IH K
COULOMBS	K UW L OW M Z
COULOMETER	K OW AH L AA M AH T AH R
COULOMETERS	K OW Y AH L AA M AH T AH R Z
COULOMETRIC	K OW Y UW L AH M AH T R AH K
COULOMETRICALLY	K OW Y UW L AH M EH T R AH K AE L IY
COULOMETRIES	K OW Y AH L AH M EH T R AY Z
COULOMETRY	K OW AH L AH M EH T R IY
COULTER	K OW L T ER
COULTERS	K OW AH L T AH R Z
COUMARIC	K OW Y UW M AH R AH K
COUMARIN	K OW Y UW M AH R AH N
COUMARINS	K OW Y UW M AH R AH N Z
COUMAROU	K OW Y UW M AH R UW
COUMAROUS	K OW Y UW M AH R AH S
COUNCIL	K AW N S AH L
COUNCILLOR	K AW N S AH L ER
COUNCILLORS	K AW N S AH L ER Z
COUNCILLORSHIP	K AW N S AH L ER SH IH P
COUNCILLORSHIPS	K AW N S AH L ER SH IH P S
COUNCILMAN	K AW N S AH L M AH N
COUNCILMANIC	K AW N S AH L M AE N IH K
COUNCILMEN	K AW N S AH L M EH N
COUNCILOR	K AW N S IH L ER
COUNCILORS	K AW N S IH L ER Z
COUNCILS	K AW N S IH L Z
COUNCILWOMAN	K AW N S IH L W UH M AH N
COUNCILWOMEN	K AW N S IH L W IH M AH N
COUNSEL	K AW N S AH L
COUNSELED	K AW N S AH L D
COUNSELEE	K AW N S AH L IY
COUNSELEES	K AW N S AH L IY Z
COUNSELING	K AW N S AH L IH NG
COUNSELINGS	K AW N S AH L IH NG Z
COUNSELLED	K AW N S AH L D
COUNSELLING	K AW N S AH L IH NG
COUNSELLINGS	K AW N S AH L IH NG Z
COUNSELLOR	K AW N S AH L ER
COUNSELLORS	K AW N S AH L ER Z
COUNSELOR	K AW N S AH L ER
COUNSELORS	K AW N S AH L ER Z
COUNSELORSHIP	K AW N S AH L ER SH IH P
COUNSELORSHIPS	K AW N S AH L ER SH IH P S
COUNSELS	K AW N S AH L Z
COUNT	K AW N T
COUNTABILITIES	K AW N T AH B IH L AH T EH Z
COUNTABILITY	K AW N T AH B IH L AH T EH
COUNTABLE	K AW N T AH B AH L
COUNTABLY	K AW N T AH B L IY
COUNTDOWN	K AW N T D AW N
COUNTDOWNS	K AW N T D AW N Z
COUNTED	K AW N T IH D
COUNTENANCE	K AW N T AH N AH N S
COUNTENANCED	K AW N T AH N AH N S T
COUNTENANCER	K AW N T AH N AH N S ER
COUNTENANCERS	K AW N T AH N AH N S ER Z
COUNTENANCES	K AW N T AH N AH N S IH Z
COUNTENANCING	K AW N T AH N AH N S IH NG
COUNTER	K AW N T ER
COUNTERACCUSATION	K AW N T ER AE K Y AH Z EY SH AH N
COUNTERACCUSATIONS	K AW N T ER AE K Y AH Z EY SH AH N Z
COUNTERACT	K AW N T ER AE K T
COUNTERACTED	K AW N T ER AE K T IH D
COUNTERACTING	K AW N T ER AE K T IH NG
COUNTERACTION	K AW N T ER AE K SH AH N
COUNTERACTIONS	K AW N T ER AE K SH AH N Z
COUNTERACTIVE	K AW N T ER AE K T IH V
COUNTERACTS	K AW N T ER AE K T S
COUNTERADAPTATION	K AW N T ER AE D AE P T EY SH AH N
COUNTERADAPTATIONS	K AW N T ER AE D AE P T EY SH AH N Z
COUNTERADVERTISING	K AW N T ER AE D V ER T AY Z IH NG
COUNTERADVERTISINGS	K AW N T ER AE D V ER T AY Z IH NG Z
COUNTERAGENT	K AW N T ER IH JH AH N T
COUNTERAGENTS	K AW N T ER IH JH AH N T S
COUNTERAGGRESSION	K AW N T ER AH G R EH SH AH N
COUNTERAGGRESSIONS	K AW N T ER AH G R EH SH AH N Z
COUNTERARGUE	K AW N T ER AA R G Y UW
COUNTERARGUED	K AW N T ER AA R G Y UW D
COUNTERARGUES	K AW N T ER AA R G Y UW Z
COUNTERARGUING	K AW N T ER AA R G Y UW IH NG
COUNTERARGUMENT	K AW N T ER AA R G Y AH M AH N T
COUNTERARGUMENTS	K AW N T ER AA R G Y AH M AH N T S
COUNTERASSAULT	K AW N T ER AH S AO L T
COUNTERASSAULTS	K AW N T ER AH S AO L T S
COUNTERATTACK	K AW N T ER AH T AE K
COUNTERATTACK(2)	K AW N ER AH T AE K
COUNTERATTACKED	K AW N T ER AH T AE K T
COUNTERATTACKED(2)	K AW N ER AH T AE K T
COUNTERATTACKER	K AW N T ER AH T AE K ER
COUNTERATTACKERS	K AW N T ER AH T AE K ER Z
COUNTERATTACKING	K AW N T ER AH T AE K IH NG
COUNTERATTACKING(2)	K AW N ER AH T AE K IH NG
COUNTERATTACKS	K AW N T ER AH T AE K S
COUNTERATTACKS(2)	K AW N ER AH T AE K S
COUNTERBADE	K AW N T ER B IY EY D
COUNTERBALANCE	K AW N T ER B AE L AH N S
COUNTERBALANCE(2)	K AW N ER B AE L AH N S
COUNTERBALANCED	K AW N T ER B AE L AH N S T
COUNTERBALANCED(2)	K AW N ER B AE L AH N S T
COUNTERBALANCES	K AW N T ER B AE L AH N S IH Z
COUNTERBALANCES(2)	K AW N ER B AE L AH N S IH Z
COUNTERBALANCING	K AW N T ER B AE L AH N S IH NG
COUNTERBALANCING(2)	K AW N ER B AE L AH N S IH NG
COUNTERBID	K AW N T ER B IH D
COUNTERBIDDEN	K AW N T ER B IH D AH N
COUNTERBIDDING	K AW N T ER B IH D IH NG
COUNTERBIDS	K AW N T ER B IH D Z
COUNTERBLAST	K AW N T ER B L AE S T
COUNTERBLASTS	K AW N T ER B L AE S T S
COUNTERBLOCKADE	K AW N T ER B L AA K EY D
COUNTERBLOCKADED	K AW N T ER B L AA K EY D IH D
COUNTERBLOCKADES	K AW N T ER B L AA K EY D Z
COUNTERBLOCKADING	K AW N T ER B L AA K EY D IH NG
COUNTERBLOW	K AW N T ER B L OW
COUNTERBLOWS	K AW N T ER B L OW Z
COUNTERCAMPAIGN	K AW N T ER K AE M P EY N
COUNTERCAMPAIGNS	K AW N T ER K AE M P EY N Z
COUNTERCHANGE	K AW N T ER CH EY N JH
COUNTERCHANGED	K AW N T ER CH EY N JH D
COUNTERCHANGES	K AW N T ER CH EY N JH IH Z
COUNTERCHANGING	K AW N T ER CH EY N JH IH NG
COUNTERCHARGE	K AW N T ER CH AA R JH
COUNTERCHARGE(2)	K AW N ER CH AA R JH
COUNTERCHARGED	K AW N T ER CH AA R JH D
COUNTERCHARGES	K AW N T ER CH AA R JH IH Z
COUNTERCHARGES(2)	K AW N ER CH AA R JH IH Z
COUNTERCHARGING	K AW N T ER CH AA R JH IH NG
COUNTERCHECK	K AW N T ER CH EH K
COUNTERCHECKED	K AW N T ER CH EH K T
COUNTERCHECKING	K AW N T ER CH EH K IH NG
COUNTERCHECKS	K AW N T ER CH EH K S
COUNTERCLAIM	K AW N T ER K L EY M
COUNTERCLAIMED	K AW N T ER K L EY M D
COUNTERCLAIMING	K AW N T ER K L EY M IH NG
COUNTERCLAIMS	K AW N T ER K L EY M Z
COUNTERCLOCKWISE	K AW N T ER K L AO K W AY Z
COUNTERCLOCKWISE(2)	K AW N ER K L AO K W AY Z
COUNTERCOMMERCIAL	K AW N T ER K AH M ER SH AH L
COUNTERCOMPLAINT	K AW N T ER K AH M P L EY N T
COUNTERCOMPLAINTS	K AW N T ER K AH M P L EY N T S
COUNTERCONDITIONING	K AW N T ER K AH N D IH SH AH N IH NG
COUNTERCONDITIONINGS	K AW N T ER K AH N D IH SH AH N IH NG Z
COUNTERCONSPIRACIES	K AW N T ER K AH N S P IH R AH S IY Z
COUNTERCONSPIRACY	K AW N T ER K AH N S P IH R AH S IY
COUNTERCONVENTION	K AW N T ER K AA N V AH N CH AH N
COUNTERCONVENTIONS	K AW N T ER K AA N V AH N CH AH N Z
COUNTERCOUNTERMEASURE	K AW N T ER K AW N T ER M EH ZH ER
COUNTERCOUNTERMEASURES	K AW N T ER K AW N T ER M EH ZH ER Z
COUNTERCOUP	K AW N T ER K UW
COUNTERCOUPS	K AW N T ER K UW Z
COUNTERCRIES	K AW N T ER K R AY Z
COUNTERCRITICISM	K AW N T ER K R IH T AH S IH Z AH M
COUNTERCRITICISMS	K AW N T ER K R IH T AH S IH Z AH M Z
COUNTERCRY	K AW N T ER K R AY
COUNTERCULTURAL	K AW N T ER K AH L CH ER AH L
COUNTERCULTURAL(2)	K AW N ER K AH L CH ER AH L
COUNTERCULTURALISM	K AW N T ER K AH L CH ER AH L IH Z AH M
COUNTERCULTURALISMS	K AW N T ER K AH L CH ER AH L IH Z AH M Z
COUNTERCULTURE	K AW N T ER K AH L CH ER
COUNTERCULTURE(2)	K AW N ER K AH L CH ER
COUNTERCULTURES	K AW N T ER K AH L CH ER Z
COUNTERCULTURIST	K AW N T ER K AH L CH ER IH S T
COUNTERCULTURISTS	K AW N T ER K AH L CH ER IH S T S
COUNTERCURRENT	K AW N T ER K ER AH N T
COUNTERCURRENTLY	K AW N T ER K ER AH N T L IY
COUNTERCURRENTS	K AW N T ER K ER AH N T S
COUNTERCYCLICAL	K AW N T ER S IH K L IH K AH L
COUNTERCYCLICALLY	K AW N T ER S IH K L IH K AH L IY
COUNTERDEMAND	K AW N T ER D IH M AE N D
COUNTERDEMANDS	K AW N T ER D IH M AE N D Z
COUNTERDEMONSTRATE	K AW N T ER D EH M AH N S T R AH T
COUNTERDEMONSTRATED	K AW N T ER D EH M AH N S T R EY T IH D
COUNTERDEMONSTRATES	K AW N T ER D EH M AH N S T R AH T S
COUNTERDEMONSTRATING	K AW N T ER D EH M AH N S T R EY T IH NG
COUNTERDEMONSTRATION	K AW N T ER D EH M AH N S T R EY SH AH N
COUNTERDEMONSTRATIONS	K AW N T ER D EH M AH N S T R EY SH AH N Z
COUNTERDEMONSTRATOR	K AW N T ER D EH M AH N S T R AH T ER
COUNTERDEMONSTRATORS	K AW N T ER D EH M AH N S T R AH T ER Z
COUNTERDEPLOYMENT	K AW N T ER D IH P L OY M AH N T
COUNTERDEPLOYMENTS	K AW N T ER D IH P L OY M AH N T S
COUNTERED	K AW N T ER D
COUNTERED(2)	K AW N ER D
COUNTEREDUCATIONAL	K AW N T ER EH JH AH K EY SH AH N AH L
COUNTEREFFORT	K AW N T ER EH F ER T
COUNTEREFFORTS	K AW N T ER EH F ER T S
COUNTERESPIONAGE	K AW N T ER EH S P IY AH N AA JH
COUNTERESPIONAGE(2)	K AW N ER EH S P Y AH N AA JH
COUNTERESPIONAGES	K AW N T ER EH S P IY AH N AA ZH IH Z
COUNTEREVIDENCE	K AW N T ER EH V AH D AH N S
COUNTEREVIDENCES	K AW N T ER EH V AH D AH N S IH Z
COUNTEREXAMPLE	K AW N T ER IH G Z AE M P AH L
COUNTEREXAMPLES	K AW N T ER IH G Z AE M P AH L Z
COUNTERFACTUAL	K AW N T ER F AE K CH AH W AH L
COUNTERFEIT	K AW N T ER F IH T
COUNTERFEIT(2)	K AW N ER F IH T
COUNTERFEITED	K AW N T ER F IH T IH D
COUNTERFEITED(2)	K AW N ER F IH T IH D
COUNTERFEITER	K AW N T ER F IH T ER
COUNTERFEITER(2)	K AW N ER F IH T ER
COUNTERFEITERS	K AW N T ER F IH T ER Z
COUNTERFEITERS(2)	K AW N ER F IH T ER Z
COUNTERFEITING	K AW N T ER F IH T IH NG
COUNTERFEITING(2)	K AW N ER F IH T IH NG
COUNTERFEITS	K AW N T ER F IH T S
COUNTERFEITS(2)	K AW N ER F IH T S
COUNTERFIRE	K AW N T ER F AY ER
COUNTERFIRED	K AW N T ER F AY ER D
COUNTERFIRES	K AW N T ER F AY ER Z
COUNTERFIRING	K AW N T ER F AY ER IH NG
COUNTERFLOW	K AW N T ER F L OW
COUNTERFLOWS	K AW N T ER F L OW Z
COUNTERFOIL	K AW N T ER F OY L
COUNTERFOILS	K AW N T ER F OY L Z
COUNTERFORCE	K AW N T ER F AO R S
COUNTERFORCES	K AW N T ER F AO R S IH Z
COUNTERGOVERNMENT	K AW N T ER G AH V ER N M AH N T
COUNTERGOVERNMENTS	K AW N T ER G AH V ER N M AH N T S
COUNTERGUERILLA	K AW N T ER G AH R IH L AH
COUNTERGUERILLAS	K AW N T ER G AH R IH L AH Z
COUNTERGUERRILLA	K AW N T ER G AH R IH L AH
COUNTERGUERRILLAS	K AW N T ER G AH R IH L AH Z
COUNTERHYPOTHESES	K AW N T ER HH AY P AA TH AH S IY Z
COUNTERHYPOTHESIS	K AW N T ER HH AY P AA TH AH S AH S
COUNTERIMAGE	K AW N T ER IH M IH JH
COUNTERIMAGES	K AW N T ER IH M IH JH IH Z
COUNTERINCENTIVE	K AW N T ER IH N S EH N T IH V
COUNTERINCENTIVES	K AW N T ER IH N S EH N T IH V Z
COUNTERINFLATION	K AW N T ER IH N F L EY SH AH N
COUNTERINFLATIONARY	K AW N T ER IH N F L EY SH AH N EH R IY
COUNTERINFLUENCE	K AW N T ER IH N F L UW AH N S
COUNTERINFLUENCED	K AW N T ER IH N F L UW AH N S T
COUNTERINFLUENCES	K AW N T ER IH N F L UW AH N S IH Z
COUNTERINFLUENCING	K AW N T ER IH N F L UW AH N S IH NG
COUNTERING	K AW N T ER IH NG
COUNTERING(2)	K AW N ER IH NG
COUNTERINSTANCE	K AW N T ER IH N S T AH N S
COUNTERINSTANCES	K AW N T ER IH N S T AH N S IH Z
COUNTERINSTITUTION	K AW N T ER IH N S T AH T UW SH AH N
COUNTERINSTITUTIONS	K AW N T ER IH N S T AH T UW SH AH N Z
COUNTERINSURGENCIES	K AW N T ER IH N S ER JH AH N S IY Z
COUNTERINSURGENCIES(2)	K AW N ER IH N S ER JH AH N S IY Z
COUNTERINSURGENCY	K AW N T ER IH N S ER JH AH N S IY
COUNTERINSURGENCY(2)	K AW N ER IH N S ER JH AH N S IY
COUNTERINSURGENT	K AW N T ER IH N S ER JH AH N T
COUNTERINSURGENTS	K AW N T ER IH N S ER JH AH N T S
COUNTERINTELLIGENCE	K AW N T ER IH N T EH L IH JH AH N S
COUNTERINTELLIGENCE(2)	K AW N ER IH N T EH L IH JH AH N S
COUNTERINTELLIGENCES	K AW N T ER IH N T EH L AH JH AH N S IH Z
COUNTERINTERPRETATION	K AW N T ER IH N T ER P R AH T EY SH AH N
COUNTERINTERPRETATIONS	K AW N T ER IH N T ER P R AH T EY SH AH N Z
COUNTERINTUITIVE	K AW N T ER IH N T UW AH T IH V
COUNTERINTUITIVELY	K AW N T ER IH N T UW AH T IH V L IY
COUNTERION	K AW N T ER IY AH N
COUNTERIONS	K AW N T ER IY AH N Z
COUNTERIRRITANT	K AW N T ER IH R AH T AH N T
COUNTERIRRITANTS	K AW N T ER IH R AH T AH N T S
COUNTERMAN	K AW N T ER M AE N
COUNTERMAND	K OW AH N T AH R M AH N D
COUNTERMANDED	K OW AH N T AH R M AE N D AH D
COUNTERMANDING	K OW AH N T AH R M AE N D AH NG
COUNTERMANDS	K OW AH N T AH R M AH N D Z
COUNTERMARCH	K AW N T ER M AA R CH
COUNTERMARCHED	K AW N T ER M AA R CH T
COUNTERMARCHES	K AW N T ER M AA R CH IH Z
COUNTERMARCHING	K AW N T ER M AA R CH IH NG
COUNTERMEASURE	K AW N T ER M EH ZH ER
COUNTERMEASURES	K AW N T ER M EH ZH ER Z
COUNTERMELODIES	K AW N T ER M EH L AH D IY Z
COUNTERMELODY	K AW N T ER M EH L AH D IY
COUNTERMEMO	K AW N T ER M EH M OW
COUNTERMEMOS	K AW N T ER M EH M OW Z
COUNTERMEN	K OW AH N T ER M AH N
COUNTERMINE	K AW N T ER M AY N
COUNTERMINED	K AW N T ER M AY N D
COUNTERMINES	K AW N T ER M AY N Z
COUNTERMINING	K AW N T ER M AY N IH NG
COUNTERMOBILIZATION	K AW N T ER M OW B AH L AH Z EY SH AH N
COUNTERMOBILIZATIONS	K AW N T ER M OW B AH L AH Z EY SH AH N Z
COUNTERMOVE	K AW N T ER M UW V
COUNTERMOVED	K AW N T ER M UW V D
COUNTERMOVEMENT	K AW N T ER M UW V M AH N T
COUNTERMOVEMENTS	K AW N T ER M UW V M AH N T S
COUNTERMOVES	K AW N T ER M UW V Z
COUNTERMOVING	K AW N T ER M UW V IH NG
COUNTERMYTH	K AW N T ER M IH TH
COUNTERMYTHS	K AW N T ER M IH TH S
COUNTEROFFENSIVE	K AW N T ER AO F EH N S IH V
COUNTEROFFENSIVES	K AW N T ER AO F EH N S IH V Z
COUNTEROFFER	K AW N T ER AO F ER
COUNTEROFFERS	K AW N T ER AO F ER Z
COUNTERORDER	K AW N T ER AO R D ER
COUNTERORDERED	K AW N T ER AO R D ER D
COUNTERORDERING	K AW N T ER AO R D ER IH NG
COUNTERORDERS	K AW N T ER AO R D ER Z
COUNTERPANE	K AW N T ER P EY N
COUNTERPANES	K AW N T ER P EY N Z
COUNTERPART	K AW N T ER P AA R T
COUNTERPARTS	K AW N T ER P AA R T S
COUNTERPETITION	K AW N T ER P AH T IH SH AH N
COUNTERPETITIONED	K AW N T ER P AH T IH SH AH N D
COUNTERPETITIONING	K AW N T ER P AH T IH SH AH N IH NG
COUNTERPETITIONS	K AW N T ER P AH T IH SH AH N Z
COUNTERPICKET	K AW N T ER P IH K AH T
COUNTERPICKETED	K AW N T ER P IH K AH T IH D
COUNTERPICKETING	K AW N T ER P IH K AH T IH NG
COUNTERPICKETS	K AW N T ER P IH K AH T S
COUNTERPLAN	K AW N T ER P L AE N
COUNTERPLANS	K AW N T ER P L AE N Z
COUNTERPLAY	K AW N T ER P L EY
COUNTERPLAYER	K AW N T ER P L EY ER
COUNTERPLAYERS	K AW N T ER P L EY ER Z
COUNTERPLAYS	K AW N T ER P L EY Z
COUNTERPLEA	K AW N T ER P L IY
COUNTERPLEAS	K AW N T ER P L IY Z
COUNTERPLOT	K AW N T ER P L AA T
COUNTERPLOTS	K AW N T ER P L AA T S
COUNTERPLOTTED	K AW N T ER P L AA T IH D
COUNTERPLOTTING	K AW N T ER P L AA T IH NG
COUNTERPLOY	K OW AH N T AH R P L OW IY
COUNTERPLOYS	K OW AH N T AH R P L OY Z
COUNTERPOINT	K AW N T ER P OY N T
COUNTERPOINTED	K AW N T ER P OY N T IH D
COUNTERPOINTING	K AW N T ER P OY N T IH NG
COUNTERPOINTS	K AW N T ER P OY N T S
COUNTERPOISE	K AW N T ER P OY Z
COUNTERPOISED	K AW N T ER P OY Z D
COUNTERPOISES	K AW N T ER P OY Z IH Z
COUNTERPOISING	K AW N T ER P OY Z IH NG
COUNTERPOSE	K AW N T ER P OW Z
COUNTERPOSED	K AW N T ER P OW Z D
COUNTERPOSES	K AW N T ER P OW Z IH Z
COUNTERPOSING	K AW N T ER P OW Z IH NG
COUNTERPOWER	K AW N T ER P AW ER
COUNTERPOWERS	K AW N T ER P AW ER Z
COUNTERPRESSURE	K AW N T ER P R EH SH ER
COUNTERPRESSURES	K AW N T ER P R EH SH ER Z
COUNTERPRODUCTIVE	K AW N T ER P R AH D AH K T IH V
COUNTERPRODUCTIVE(2)	K AW N ER P R AH D AH K T IH V
COUNTERPROGRAMMING	K AW N T ER P R OW G R AE M IH NG
COUNTERPROGRAMMINGS	K AW N T ER P R OW G R AE M IH NG Z
COUNTERPROJECT	K AW N T ER P R AA JH EH K T
COUNTERPROJECTS	K AW N T ER P R AA JH EH K T S
COUNTERPROPAGANDA	K AW N T ER P R AA P AH G AE N D AH
COUNTERPROPAGANDAS	K AW N T ER P R AA P AH G AE N D AH Z
COUNTERPROPOSAL	K AW N T ER P R AH P OW Z AH L
COUNTERPROPOSALS	K AW N T ER P R AH P OW Z AH L Z
COUNTERPROTEST	K AW N T ER P R OW T EH S T
COUNTERPROTESTS	K AW N T ER P R OW T EH S T S
COUNTERPUNCH	K AW N T ER P AH N CH
COUNTERPUNCHED	K AW N T ER P AH N CH T
COUNTERPUNCHER	K AW N T ER P AH N CH ER
COUNTERPUNCHERS	K AW N T ER P AH N CH ER Z
COUNTERPUNCHES	K AW N T ER P AH N CH IH Z
COUNTERPUNCHING	K AW N T ER P AH N CH IH NG
COUNTERQUESTION	K AW N T ER K W EH S CH AH N
COUNTERQUESTIONED	K AW N T ER K W EH S CH AH N D
COUNTERQUESTIONING	K AW N T ER K W EH S CH AH N IH NG
COUNTERQUESTIONS	K AW N T ER K W EH S CH AH N Z
COUNTERRAID	K AW N T ER R EY D
COUNTERRAIDED	K AW N T ER R EY D IH D
COUNTERRAIDING	K AW N T ER R EY D IH NG
COUNTERRAIDS	K AW N T ER R EY D Z
COUNTERRALLIED	K AW N T ER AH L IY D
COUNTERRALLIES	K AW N T ER AH L IY Z
COUNTERRALLY	K AW N T ER AH L IY
COUNTERRALLYING	K AW N T ER AH L IY IH NG
COUNTERREACTION	K AW N T ER R IY AE K SH AH N
COUNTERREACTIONS	K AW N T ER R IY AE K SH AH N Z
COUNTERREFORM	K AW N T ER R IY F AO R M
COUNTERREFORMATION	K AW N T ER R EH F ER M EY SH AH N
COUNTERREFORMATIONS	K AW N T ER R EH F ER M EY SH AH N Z
COUNTERREFORMER	K AW N T ER R IY F AO R M ER
COUNTERREFORMERS	K AW N T ER R IY F AO R M ER Z
COUNTERREFORMS	K AW N T ER R IY F AO R M Z
COUNTERRESPONSE	K AW N T ER R IH S P AA N S
COUNTERRESPONSES	K AW N T ER R IH S P AA N S IH Z
COUNTERRETALIATION	K AW N T ER R IH T AE L IY EY SH AH N
COUNTERRETALIATIONS	K AW N T ER R IH T AE L IY EY SH AH N Z
COUNTERREVOLUTION	K AW N T ER R EH V AH L UW SH AH N
COUNTERREVOLUTIONARIES	K AW N T ER R EH V AH L UW SH AH N EH R IY Z
COUNTERREVOLUTIONARY	K AW N T ER R EH V AH L UW SH AH N EH R IY
COUNTERREVOLUTIONS	K AW N T ER R EH V AH L UW SH AH N Z
COUNTERS	K AW N T ER Z
COUNTERSCIENTIFIC	K AW N T ER S AY AH N T IH F IH K
COUNTERSHADING	K AW N T ER SH EY D IH NG
COUNTERSHADINGS	K AW N T ER SH EY D IH NG Z
COUNTERSHOT	K AW N T ER SH AA T
COUNTERSHOTS	K AW N T ER SH AA T S
COUNTERSIGN	K AW N T ER S AY N
COUNTERSIGNATURE	K AW N T ER S IH G N AH CH UH R
COUNTERSIGNATURES	K AW N T ER S IH G N AH CH UH R Z
COUNTERSIGNED	K AW N T ER S AY N D
COUNTERSIGNING	K AW N T ER S AY N IH NG
COUNTERSIGNS	K AW N T ER S AY N Z
COUNTERSINK	K AW N T ER S IH NG K
COUNTERSINKING	K AW N T ER S IH NG K IH NG
COUNTERSINKS	K AW N T ER S IH NG K S
COUNTERSNIPER	K AW N T ER S N AY P ER
COUNTERSNIPERS	K AW N T ER S N AY P ER Z
COUNTERSPELL	K AW N T ER S P EH L
COUNTERSPELLS	K AW N T ER S P EH L Z
COUNTERSPIES	K AW N T ER S P AY Z
COUNTERSPY	K AW N T ER S P AY
COUNTERSTAIN	K AW N T ER S T EY N
COUNTERSTAINED	K AW N T ER S T EY N D
COUNTERSTAINING	K AW N T ER S T EY N IH NG
COUNTERSTAINS	K AW N T ER S T EY N Z
COUNTERSTATE	K AW N T ER S T EY T
COUNTERSTATED	K AW N T ER S T EY T IH D
COUNTERSTATEMENT	K AW N T ER S T EY T M AH N T
COUNTERSTATEMENTS	K AW N T ER S T EY T M AH N T S
COUNTERSTATES	K AW N T ER S T EY T S
COUNTERSTATING	K AW N T ER S T EY T IH NG
COUNTERSTEP	K AW N T ER S T EH P
COUNTERSTEPPED	K AW N T ER S T EH P T
COUNTERSTEPPING	K AW N T ER S T EH P IH NG
COUNTERSTEPS	K AW N T ER S T EH P S
COUNTERSTRATEGIES	K AW N T ER S T R AE T AH JH IY Z
COUNTERSTRATEGIST	K OW AH N T AH R S T R AE T AH JH AH S T
COUNTERSTRATEGISTS	K OW AH N T AH R S T R AE T AH JH AH S T S
COUNTERSTRATEGY	K AW N T ER S T R AE T AH JH IY
COUNTERSTREAM	K AW N T ER S T R IY M
COUNTERSTREAMS	K AW N T ER S T R IY M Z
COUNTERSTRIKE	K AW N T ER S T R AY K
COUNTERSTRIKES	K AW N T ER S T R AY K S
COUNTERSTROKE	K AW N T ER S T R OW K
COUNTERSTROKES	K AW N T ER S T R OW K S
COUNTERSTYLE	K AW N T ER S T AY L
COUNTERSTYLES	K AW N T ER S T AY L Z
COUNTERSUE	K AW N T ER S UW
COUNTERSUED	K AW N T ER S UW D
COUNTERSUES	K AW N T ER S UW Z
COUNTERSUGGESTION	K AW N T ER S AH G JH EH S SH AH N
COUNTERSUGGESTIONS	K AW N T ER S AH G JH EH S SH AH N Z
COUNTERSUING	K AW N T ER S UW IH NG
COUNTERSUIT	K AW N T ER S UW T
COUNTERSUITS	K AW N T ER S UW T S
COUNTERSUNK	K AW N T ER S AH NG K
COUNTERSURVEILLANCE	K AW N T ER S ER V EY L AH N S
COUNTERSURVEILLANCES	K AW N T ER S ER V EY L AH N S IH Z
COUNTERTACTICS	K AW N T ER T AE K T IH K S
COUNTERTENDENCIES	K AW N T ER T EH N D AH N S IY Z
COUNTERTENDENCY	K AW N T ER T EH N D AH N S IY
COUNTERTENOR	K AW N T ER T EH N ER
COUNTERTENORS	K AW N T ER T EH N ER Z
COUNTERTERROR	K AW N T ER T EH R ER
COUNTERTERRORISM	K AW N T ER T EH R ER IH Z AH M
COUNTERTERRORISMS	K AW N T ER T EH R ER IH Z AH M Z
COUNTERTERRORIST	K AW N T ER T EH R ER IH S T
COUNTERTERRORISTS	K AW N T ER T EH R ER IH S T S
COUNTERTERRORS	K AW N T ER T EH R ER Z
COUNTERTHREAT	K AW N T ER TH R EH T
COUNTERTHREATS	K AW N T ER TH R EH T S
COUNTERTHRUST	K AW N T ER TH R AH S T
COUNTERTHRUSTS	K AW N T ER TH R AH S T S
COUNTERTOP	K AW N T ER T AA P
COUNTERTOPS	K AW N T ER T AA P S
COUNTERTRADE	K AW N T ER T R EY D
COUNTERTRADES	K AW N T ER T R EY D Z
COUNTERTRADITION	K AW N T ER T R AH D IH SH AH N
COUNTERTRADITIONS	K AW N T ER T R AH D IH SH AH N Z
COUNTERTRANSFERENCE	K AW N T ER T R AE N S F ER AH N S
COUNTERTRANSFERENCES	K AW N T ER T R AE N S F ER AH N S IH Z
COUNTERTREND	K AW N T ER T R EH N D
COUNTERTRENDS	K AW N T ER T R EH N D Z
COUNTERVAIL	K AW N T ER V EY L
COUNTERVAILED	K AW N T ER V EY L D
COUNTERVAILING	K AW N T ER V EY L IH NG
COUNTERVAILS	K AW N T ER V EY L Z
COUNTERVIEW	K AW N T ER V Y UW
COUNTERVIEWS	K AW N T ER V Y UW Z
COUNTERVIOLENCE	K AW N T ER V AY AH L AH N S
COUNTERVIOLENCES	K AW N T ER V AY AH L AH N S IH Z
COUNTERWEIGHT	K AW N T ER W EY T
COUNTERWEIGHTED	K AW N T ER W EY T IH D
COUNTERWEIGHTING	K AW N T ER W EY T IH NG
COUNTERWEIGHTS	K AW N T ER W EY T S
COUNTERWORLD	K AW N T ER W ER L D
COUNTERWORLDS	K AW N T ER W ER L D Z
COUNTESS	K AW N T AH S
COUNTESSES	K AW N T AH S IH Z
COUNTIAN	K OW AH N CH AH N
COUNTIANS	K OW AH N T AY AH N Z
COUNTIES	K AW N T IY Z
COUNTING	K AW N T IH NG
COUNTINGHOUSE	K AW N T IH NG HH AW S
COUNTINGHOUSES	K AW N T IH NG HH AW S IH Z
COUNTLESS	K AW N T L AH S
COUNTLESSLY	K AW N T L AH S L IY
COUNTRIES	K AH N T R IY Z
COUNTRIFIED	K OW AH N T R AH F AY D
COUNTRY	K AH N T R IY
COUNTRYFIED	K OW AH N T R AH F AY D
COUNTRYISH	K AH N T R IY IH SH
COUNTRYMAN	K AH N T R IY M AH N
COUNTRYMEN	K AH N T R IY M IH N
COUNTRYSEAT	K AH N T R IY S IY T
COUNTRYSEATS	K AH N T R IY S IY T S
COUNTRYSIDE	K AH N T R IY S AY D
COUNTRYSIDES	K AH N T R IY S AY D Z
COUNTRYWIDE	K AH N T R IY W AY D
COUNTRYWOMAN	K AH N T R IY W UH M AH N
COUNTRYWOMEN	K AH N T R IY W IH M AH N
COUNTS	K AW N T S
COUNTY	K AW N T IY
COUNTY(2)	K AW N IY
COUP	K UW
COUPE	K UW P
COUPED	K UW P EY D
COUPES	K UW P S
COUPING	K UW P EY IH NG
COUPLE	K AH P AH L
COUPLED	K AH P AH L D
COUPLEMENT	K AH P AH L M AH N T
COUPLEMENTS	K AH P AH L M AH N T S
COUPLER	K AH P L ER
COUPLERS	K AH P L ER Z
COUPLES	K AH P AH L Z
COUPLET	K UW L AH T
COUPLETS	K UW L AH T S
COUPLING	K AH P L IH NG
COUPLINGS	K AH P L IH NG Z
COUPON	K UW P AO N
COUPON(2)	K Y UW P AO N
COUPONING	K UW P AA N IH NG
COUPONING(2)	K Y UW P AA N IH NG
COUPONINGS	K UW P AA N IH NG Z
COUPONS	K UW P AO N Z
COUPONS(2)	K Y UW P AO N Z
COUPS	K UW Z
COURAGE	K ER IH JH
COURAGEOUS	K ER EY JH AH S
COURAGEOUSLY	K ER EY JH AH S L IY
COURAGEOUSNESS	K AH R EY JH AH S N AH S
COURAGEOUSNESSES	K AH R EY JH AH S N AH S IH Z
COURAGES	K ER IH JH IH Z
COURANT	K UH R AH N T
COURANTE	K OW Y UH R AH N T
COURANTES	K OW Y UH R AH N T S
COURANTO	K OW Y AH R AE N T OW
COURANTOES	K OW Y AH R AE N T OW Z
COURANTOS	K OW Y AH R AE N T AH Z
COURANTS	K OW Y UH R AH N T S
COURGETTE	K OW ER JH EH T
COURGETTES	K OW ER JH EH T S
COURIER	K ER IY ER
COURIERS	K ER IY ER Z
COURLAN	K OW AH R L AH N
COURLANS	K OW AH R L AH N Z
COURSE	K AO R S
COURSED	K OW R S T
COURSER	K AO R S ER
COURSERS	K OW R S ER Z
COURSES	K AO R S AH Z
COURSES(2)	K AO R S IH Z
COURSEWARE	K OW R S W EH R
COURSEWARES	K OW R S W EH R Z
COURSING	K AO R S IH NG
COURSINGS	K OW R S IH NG Z
COURT	K AO R T
COURTED	K AO R T IH D
COURTEOUS	K ER T IY AH S
COURTEOUSLY	K ER T IY AH S L IY
COURTEOUSNESS	K ER T IY AH S N AH S
COURTEOUSNESSES	K ER T IY AH S N AH S IH Z
COURTER	K AO R T ER
COURTERS	K OW R T ER Z
COURTESAN	K OW R T AH S AH N
COURTESANS	K OW R T AH S AH N Z
COURTESIED	K ER T AH S IY D
COURTESIES	K ER T AH S IY Z
COURTESY	K ER T AH S IY
COURTESYING	K ER T AH S IY IH NG
COURTHOUSE	K AO R T HH AW S
COURTHOUSES	K AO R T HH AW S IH Z
COURTIER	K AO R T IY ER
COURTIERS	K AO R T IY ER Z
COURTING	K AO R T IH NG
COURTLIER	K OW R T L IY ER
COURTLIEST	K OW R T L IY AH S T
COURTLINESS	K OW R T L IY N AH S
COURTLINESSES	K OW R T L IY N AH S IH Z
COURTLY	K AO R T L IY
COURTROOM	K AO R T R UW M
COURTROOMS	K AO R T R UW M Z
COURTS	K AO R T S
COURTSHIP	K AO R CH IH P
COURTSHIPS	K OW R T SH IH P S
COURTSIDE	K OW R T S AY D
COURTSIDES	K OW R T S AY D Z
COURTYARD	K AO R T Y AA R D
COURTYARDS	K AO R T Y AA R D Z
COUSCOUS	K OW AH S AH S
COUSCOUSES	K OW AH S AW Z AH Z
COUSIN	K AH Z AH N
COUSINAGE	K AH Z AH N IH JH
COUSINAGES	K AH Z AH N IH JH IH Z
COUSINHOOD	K AH Z AH N HH UH D
COUSINHOODS	K AH Z AH N HH UH D Z
COUSINLY	K AH Z AH N L IY
COUSINRIES	K AH Z AH N R IY Z
COUSINRY	K AH Z AH N R IY
COUSINS	K AH Z AH N Z
COUSINSHIP	K AH Z AH N SH IH P
COUSINSHIPS	K AH Z AH N SH IH P S
COUTEAU	K OW Y UW T IY UW
COUTEAUX	K OW Y UW T IY AH K S
COUTER	K OW Y UW T AH R
COUTERS	K OW Y UW T AH R Z
COUTH	K OW AH TH
COUTHER	K OW AH DH AH R
COUTHEST	K OW AH DH AH S T
COUTHIE	K OW AH TH AY
COUTHIER	K OW AH TH AY AH R
COUTHIEST	K OW AH TH AY AH S T
COUTHS	K OW AH TH S
COUTURE	K UW T UH R
COUTURES	K OW Y UW T Y AH R Z
COUTURIER	K UW T UH R IY ER
COUTURIERE	K OW Y UW T Y AH R IY R
COUTURIERES	K OW Y UW T Y AH R IY R Z
COUTURIERS	K UW T UH R IY ER Z
COUVADE	K OW Y AH V EY D
COUVADES	K OW Y AH V EY D Z
COVETOUS	K AH V AH T AH S
COVETOUSLY	K AH V AH T AH S L IY
COVETOUSNESS	K AH V AH T AH S N AH S
COVETOUSNESSES	K AH V AH T AH S N AH S IH Z
COYPOU	K OW Y P UW
COYPOUS	K OW Y P AH S
CRANKOUS	K R AE NG K AH S
CRAPULOUS	K R AE P Y AH L AH S
CREDULOUS	K R EH JH AH L AH S
CREDULOUSLY	K R EH JH AH L AH S L IY
CREDULOUSNESS	K R EH JH AH L AH S N AH S
CREDULOUSNESSES	K R EH JH AH L AH S N AH S IH Z
CRETINOUS	K R EH T AH N AH S
CRIBROUS	K R IH B R AH S
CRIMINOUS	K R IH M AH N AH S
CROSSCOURT	K R AO S K OW R T
CROUCH	K R AW CH
CROUCHED	K R AW CH T
CROUCHES	K R AW CH IH Z
CROUCHING	K R AW CH IH NG
CROUP	K R UW P
CROUPE	K R UW P
CROUPES	K R UW P S
CROUPIER	K R UW P IY EY
CROUPIERS	K R UW P IY EY Z
CROUPIEST	K R UW P AY AH S T
CROUPILY	K R UW P AH L IY
CROUPOUS	K R UW P AH S
CROUPS	K R UW P S
CROUPY	K R UW P IY
CROUSE	K R AW S
CROUSELY	K R AW Z L IY
CROUSTADE	K R AW S T EY D
CROUSTADES	K R AW S T EY D Z
CROUTON	K R AW T AH N
CROUTONS	K R AW T AH N Z
CRUCIFEROUS	K R UW S IH F AH R AH S
CRUSTACEOUS	K R AH S T EY SH AH S
CRYPTOGAMOUS	K R IH P T AA G AH M AH S
CUMBROUS	K AH M B R AH S
CUMBROUSLY	K AH M B R OW AH S L IY
CUMBROUSNESS	K AH M B R AW Z N AH S
CUMBROUSNESSES	K AH M B R AW Z N EH S AH Z
CUMULOUS	K Y UW M Y AH L AH S
CUPREOUS	K AH P R IY AH S
CUPRIFEROUS	K AH P R IH F AH R AH S
CUPROUS	K AH P R AH S
CURIOUS	K Y UH R IY AH S
CURIOUSER	K Y UH R IY AH S ER
CURIOUSEST	K Y UH R IY AH S AH S T
CURIOUSLY	K Y UH R IY AH S L IY
CURIOUSNESS	K Y UH R IY AH S N AH S
CURIOUSNESSES	K Y UH R IY AH S N AH S IH Z
CURVACEOUS	K ER V EY SH AH S
CURVACIOUS	K ER V AH S IY AH S
CUSTOMHOUSE	K AH S T AH M HH AW S
CUSTOMHOUSES	K AH S T AH M HH AW S IH Z
CUSTOMSHOUSE	K AH S T AH M Z HH AW S
CUSTOMSHOUSES	K AH S T AH M Z HH AW S IH Z
CUTANEOUS	K Y UW T EY N IY AH S
CUTANEOUSLY	K Y UW T AH N IY OW AH S L IY
CUTOUT	K AH T AW T
CUTOUTS	K AH T AW T S
CYMOUS	S AY M AH S
DANGEROUS	D EY N JH ER AH S
DANGEROUSLY	D EY N JH ER AH S L IY
DANGEROUSNESS	D EY N JH ER AH S N AH S
DANGEROUSNESSES	D EY N JH ER AH S N AH S IH Z
DEBOUCH	D AH B AW CH
DEBOUCHE	D AH B AW CH
DEBOUCHED	D AH B AW CH T
DEBOUCHES	D AH B AW CH AH Z
DEBOUCHING	D AH B AW CH AH NG
DEBOUCHMENT	D AH B AW CH M AH N T
DEBOUCHMENTS	D AH B AW CH M AH N T S
DECAPODOUS	D AH K AE P AH D AH S
DECIDUOUS	D IH S IH JH UW AH S
DECIDUOUSNESS	D AH S IH D Y UW AW Z N AH S
DECIDUOUSNESSES	D AH S IH D Y UW AW Z N EH S AH Z
DECKHOUSE	D EH K HH AW S
DECKHOUSES	D EH K HH AW S IH Z
DECLIVITOUS	D IH K L IH V AH T AH S
DECOLOUR	D IY K AH L ER
DECOLOURED	D IY K AH L ER D
DECOLOURING	D IY K AH L ER IH NG
DECOLOURS	D IY K AH L ER Z
DECOMPOUND	D IY K AH M P AW N D
DECOROUS	D EH K ER AH S
DECOROUSLY	D EH K AH R AH S L IY
DECOROUSNESS	D EH K AH R AH S N AH S
DECOROUSNESSES	D EH K AH R AH S N AH S IH Z
DECOUPAGE	D IY K UW P EY IH JH
DECOUPAGED	D IY K UW P EY IH JH D
DECOUPAGES	D IY K UW P EY IH JH IH Z
DECOUPAGING	D IY K UW P EY IH JH IH NG
DECOUPLE	D IY K AH P AH L
DECOUPLED	D IY K AH P AH L D
DECOUPLES	D IY K AH P AH L Z
DECOUPLING	D IY K AH P L IH NG
DEERHOUND	D IH ER HH AW N D
DEERHOUNDS	D IH ER HH AW N D Z
DELETERIOUS	D EH L AH T IH R IY AH S
DELETERIOUSLY	D IY L EH T AH R IY AH S L IY
DELETERIOUSNESS	D IY L EH T AH R IY AH S N AH S
DELETERIOUSNESSES	D IY L EH T AH R IY AH S N AH S IH Z
DELICIOUS	D IH L IH SH AH S
DELICIOUSLY	D IH L IH SH AH SH L IY
DELICIOUSNESS	D IH L IH SH AH S N AH S
DELICIOUSNESSES	D IH L IH SH AH S N AH S IH Z
DELIRIOUS	D IH L IH R IY AH S
DELIRIOUSLY	D AH L AH R IY OW AH S L IY
DELIRIOUSNESS	D AH L IH R IY AW Z N AH S
DELIRIOUSNESSES	D AH L IH R IY AW Z N EH S AH Z
DELOUSE	D IY L AW Z
DELOUSED	D IY L AW Z D
DELOUSER	D IY L AW S ER
DELOUSERS	D IY L AW S ER Z
DELOUSES	D IY L AW S IH Z
DELOUSING	D IY L AW S IH NG
DEMEANOUR	D AH M IY N AH R
DEMEANOURS	D AH M AH N OW Y AH R Z
DEMOUNT	D IY M AW N T
DEMOUNTABLE	D IY M AW N T AH B AH L
DEMOUNTED	D IY M AW N T IH D
DEMOUNTING	D IY M AW N T IH NG
DEMOUNTS	D IY M AW N T S
DENOUEMENT	D EY N UW M AA N
DENOUEMENTS	D EY N UW M AA N Z
DENOUNCE	D IH N AW N S
DENOUNCED	D IH N AW N S T
DENOUNCEMENT	D IH N AW N S M AH N T
DENOUNCEMENTS	D IH N AW N S M AH N T S
DENOUNCER	D IH N AW N S ER
DENOUNCERS	D IH N AW N S ER Z
DENOUNCES	D IH N AW N S IH Z
DENOUNCING	D IH N AW N S IH NG
DENTULOUS	D EH N T Y AH L AH S
DESIROUS	D IH Z AY R AH S
DESIROUSLY	D IH Z AY ER AH S L IY
DESIROUSNESS	D IH Z AY ER AH S N AH S
DESIROUSNESSES	D IH Z AY ER AH S N AH S IH Z
DESKBOUND	D EH S K B AW N D
DESPITEOUS	D IH S P AY T AH S
DESPITEOUSLY	D IH S P AY T AH S L IY
DETOUR	D IH T UH R
DETOUR(2)	D IY T UH R
DETOURED	D IY T UH R D
DETOURING	D IY T UH R IH NG
DETOURS	D IH T UH R Z
DETOURS(2)	D IY T UH R Z
DEUTERANOMALOUS	D IY Y UW T AH R AH N AA M AH L AH S
DEVIOUS	D IY V IY AH S
DEVIOUSLY	D IY V IY AH S L IY
DEVIOUSNESS	D IY V IY AH S N AH S
DEVIOUSNESSES	D IY V IY AH S N AH S IH Z
DEVOUR	D IH V AW ER
DEVOURED	D IH V AW ER D
DEVOURER	D IH V AW ER ER
DEVOURERS	D IH V AW ER ER Z
DEVOURING	D IH V AW ER IH NG
DEVOURS	D IH V AW ER Z
DEVOUT	D IH V AW T
DEVOUTER	D IH V AW T ER
DEVOUTEST	D IH V AW T AH S T
DEVOUTLY	D IH V AW T L IY
DEVOUTNESS	D IH V AW T N AH S
DEVOUTNESSES	D IH V AW T N AH S IH Z
DEXTEROUS	D EH K S T ER AH S
DEXTEROUSLY	D EH K S T ER AH S L IY
DEXTEROUSNESS	D EH K S T ER AH S N AH S
DEXTEROUSNESSES	D EH K S T ER AH S N AH S IH Z
DEXTROUS	D EH K S T R AH S
DHOURRA	D HH AH R AH
DHOURRAS	D HH AH R AH Z
DIADELPHOUS	D AY AH D EH L F AH S
DIADROMOUS	D AY AE D R AH M AH S
DIAMONDIFEROUS	D AY AH M AA N D IH F AH R AH S
DIAPHANOUS	D AY AE F AH N IH S
DIAPHANOUSLY	D AY AE F AH N AH S L IY
DIAPHANOUSNESS	D AY AE F AH N AH S N AH S
DIAPHANOUSNESSES	D AY AE F AH N AH S N AH S IH Z
DIATHERMANOUS	D AY AH TH AH R M AH N AH S
DIATOMACEOUS	D AY AH T AA M EY S AH S
DICHOGAMOUS	D AH CH AA G AH M AH S
DICHOTOMOUS	D AH CH AA T AH M AH S
DICHOTOMOUSLY	D IH CH AH T AA M OW AH S L IY
DICHOTOMOUSNESS	D AH CH AA T AH M AW Z N AH S
DICHOTOMOUSNESSES	D AH CH AA T AH M AW Z N EH S AH Z
DICLINOUS	D IH K L AH N AH S
DICOTYLEDONOUS	D IH K AH T AH L EH D AH N AH S
DICOUMARIN	D AH K AW M AH R AH N
DICOUMARINS	D AH K AW M AH R AH N Z
DICOUMAROL	D AH K AW M AH R AH L
DICOUMAROLS	D AH K AW M AH R AH L Z
DIDYMOUS	D IH D AH M AH S
DIECIOUS	D IY SH AH S
DIESTROUS	D IY S T R AH S
DIGAMOUS	D IH G AH M AH S
DIMEROUS	D AY M ER AH S
DIMORPHOUS	D AH M AO R F AH S
DIMOUT	D IH M AW T
DIMOUTS	D IH M AW T S
DIOECIOUS	D AY OW AH SH AH S
DIOICOUS	D AY OW IH S AH S
DIPTEROUS	D IH P T AH R AH S
DISADVANTAGEOUS	D IH S AE D V AE N T EY JH AH S
DISADVANTAGEOUSLY	D IH S AE D V AE N T EY JH AH S L IY
DISADVANTAGEOUSNESS	D IH S AE D V AE N T EY JH AH S N AH S
DISADVANTAGEOUSNESSES	D IH S AE D V AE N T EY JH AH S N AH S IH Z
DISASTROUS	D IH Z AE S T R AH S
DISASTROUSLY	D IH Z AE S T R AH S L IY
DISBOUND	D IH S B AW N D
DISCONTINUOUS	D IH S K AH N T IH N Y UW AH S
DISCONTINUOUSLY	D IH S K AH N T IH N Y UW AH S L IY
DISCOUNT	D IH S K AW N T
DISCOUNTABLE	D IH S K AW N T AH B AH L
DISCOUNTED	D IH S K AW N T IH D
DISCOUNTED(2)	D IH S K AW N IH D
DISCOUNTENANCE	D IH S K AW N T AH N AH N S
DISCOUNTENANCED	D IH S K AW N T AH N AH N S T
DISCOUNTENANCES	D IH S K AW N T AH N AH N S IH Z
DISCOUNTENANCING	D IH S K AW N T AH N AH N S IH NG
DISCOUNTER	D IH S K AW N T ER
DISCOUNTERS	D IH S K AW N T ER Z
DISCOUNTERS(2)	D IH S K AW N ER R Z
DISCOUNTING	D IH S K AW N T IH NG
DISCOUNTING(2)	D IH S K AW N IH NG
DISCOUNTS	D IH S K AW N T S
DISCOURAGE	D IH S K ER IH JH
DISCOURAGEABLE	D IH S K ER IH JH AH B AH L
DISCOURAGED	D IH S K ER IH JH D
DISCOURAGEMENT	D IH S K ER IH JH M AH N T
DISCOURAGEMENTS	D IH S K ER IH JH M AH N T S
DISCOURAGER	D IH S K ER IH JH ER
DISCOURAGERS	D IH S K ER IH JH ER Z
DISCOURAGES	D IH S K ER IH JH IH Z
DISCOURAGING	D IH S K ER IH JH IH NG
DISCOURAGINGLY	D IH S K ER IH JH IH NG L IY
DISCOURSE	D IH S K AO R S
DISCOURSED	D IH S K OW R S T
DISCOURSER	D IH S K OW R S ER
DISCOURSERS	D IH S K OW R S ER Z
DISCOURSES	D IH S K AO R S IH Z
DISCOURSING	D IH S K OW R S IH NG
DISCOURTEOUS	D IH S K ER T IY AH S
DISCOURTEOUSLY	D IH S K ER T IY AH S L IY
DISCOURTEOUSNESS	D IH S K ER T IY AH S N AH S
DISCOURTEOUSNESSES	D IH S K ER T IY AH S N AH S IH Z
DISCOURTESIES	D IH S K ER T AH S IY Z
DISCOURTESY	D IH S K ER T AH S IY
DISHARMONIOUS	D IH S HH AA R M OW N IY AH S
DISHCLOUT	D IH SH K L AW T
DISHCLOUTS	D IH SH K L AW T S
DISINGENUOUS	D IH S IH N JH EH N Y UW AH S
DISINGENUOUSLY	D AH S AH N JH EH N Y UW OW AH S L IY
DISINGENUOUSNESS	D IH S IH N JH EH N Y UW AH S N AH S
DISINGENUOUSNESSES	D AH S AH N JH EH N Y UW AW Z N EH S AH Z
DISMOUNT	D IH S M AW N T
DISMOUNTED	D IH S M AW N T IH D
DISMOUNTING	D IH S M AW N T IH NG
DISMOUNTS	D IH S M AW N T S
DISPITEOUS	D IH S P IH T IY AH S
DISPUTATIOUS	D IH S P Y UW T AH T IY AH S
DISPUTATIOUSLY	D IH S P Y UW T AH T IY AH S L IY
DISPUTATIOUSNESS	D IH S P Y UW T AH T IY AH S N AH S
DISPUTATIOUSNESSES	D IH S P Y UW T AH T IY AH S N AH S IH Z
DISSENTIOUS	D IH S EH N CH AH S
DISTICHOUS	D IH S T IH CH AH S
DIZYGOUS	D IH Z AH G AH S
DOGFOUGHT	D AO G F AO T
DOGHOUSE	D AO G HH AW S
DOGHOUSES	D AO G HH AW S IH Z
DOLLHOUSE	D AA L HH AW S
DOLLHOUSES	D AA L HH AW S IH Z
DOLOROUS	D OW L ER AH S
DOLOROUSLY	D OW L ER AH S L IY
DOLOROUSNESS	D OW L ER AH S N AH S
DOLOROUSNESSES	D OW L ER AH S N AH S IH Z
DOLOUR	D AA L AH R
DOLOURS	D AH L OW Y AH R Z
DORMOUSE	D AO R M AW S
DOUBLE	D AH B AH L
DOUBLED	D AH B AH L D
DOUBLEHEADER	D AH B AH L HH EH D ER
DOUBLEHEADERS	D AH B AH L HH EH D ER Z
DOUBLENESS	D AH B AH L N AH S
DOUBLENESSES	D AH B AH L N AH S IH Z
DOUBLER	D AH B AH L ER
DOUBLERS	D AH B AH L ER Z
DOUBLES	D AH B AH L Z
DOUBLESPEAK	D AH B AH L S P IY K
DOUBLESPEAKER	D AH B AH L S P IY K ER
DOUBLESPEAKERS	D AH B AH L S P IY K ER Z
DOUBLESPEAKS	D AH B AH L S P IY K S
DOUBLET	D AW B L AH T
DOUBLETHINK	D AH B AH L TH IH NG K
DOUBLETHINKS	D AH B AH L TH IH NG K S
DOUBLETON	D AH B AH L T AH N
DOUBLETONS	D AH B AH L T AH N Z
DOUBLETS	D AW B L AH T S
DOUBLING	D AH B AH L IH NG
DOUBLING(2)	D AH B L IH NG
DOUBLOON	D AH B L UW N
DOUBLOONS	D AH B L UW N Z
DOUBLURE	D AH B AH L Y ER
DOUBLURES	D AH B AH L Y ER Z
DOUBLY	D AH B L IY
DOUBT	D AW T
DOUBTABLE	D AW T AH B AH L
DOUBTED	D AW T IH D
DOUBTER	D AW T ER
DOUBTERS	D AW T ER Z
DOUBTFUL	D AW T F AH L
DOUBTFULLY	D AW T F AH L IY
DOUBTFULNESS	D AW T F AH L N AH S
DOUBTFULNESSES	D AW T F AH L N AH S IH Z
DOUBTING	D AW T IH NG
DOUBTINGLY	D AW T IH NG L IY
DOUBTLESS	D AW T L AH S
DOUBTLESSLY	D AW T L AH S L IY
DOUBTLESSNESS	D AW T L AH S N AH S
DOUBTLESSNESSES	D AW T L AH S N AH S IH Z
DOUBTS	D AW T S
DOUCE	D UW S
DOUCELY	D UW S L IY
DOUCEUR	D AW S AH R
DOUCEURS	D AW S IY Y AH R Z
DOUCHE	D UW SH
DOUCHED	D AW CH T
DOUCHES	D AW CH AH Z
DOUCHING	D AW CH AH NG
DOUGH	D OW
DOUGHBOY	D OW B OY
DOUGHBOYS	D OW B OY Z
DOUGHFACE	D OW F EY S
DOUGHFACES	D OW F EY S IH Z
DOUGHIER	D OW IY ER
DOUGHIEST	D OW IY AH S T
DOUGHLIKE	D OW L AY K
DOUGHNUT	D OW N AH T
DOUGHNUTLIKE	D OW N AH T L AY K
DOUGHNUTS	D OW N AH T S
DOUGHS	D OW Z
DOUGHT	D AO T
DOUGHTIER	D OW T IH ER
DOUGHTIEST	D OW T AY AH S T
DOUGHTILY	D OW T AY L IY
DOUGHTINESS	D OW T AY N AH S
DOUGHTINESSES	D OW T AY N AH S IH Z
DOUGHTY	D AO T IY
DOUGHY	D OW IY
DOUM	D AW M
DOUMA	D OW M AH
DOUMAS	D AW M AH Z
DOUMS	D AW M Z
DOUPIONI	D UW P IY AH N IY
DOUPIONIS	D UW AH P IY AH N IY Z
DOUR	D AW ER
DOUR(2)	D AW R
DOURA	D AH R AH
DOURAH	D AH R AH
DOURAHS	D AH R AH Z
DOURAS	D AH R AH Z
DOURER	D AW ER ER
DOUREST	D AW ER AH S T
DOURINE	D UW Y UH R AH N
DOURINES	D UW Y UH R AH N Z
DOURLY	D AW ER L IY
DOURNESS	D AW ER N AH S
DOURNESSES	D AW ER N AH S IH Z
DOUROUCOULI	D AH R AW K AW L IY
DOUROUCOULIS	D AH R AW K OW AH L AH S
DOUSE	D AW S
DOUSED	D AW S T
DOUSER	D AW S ER
DOUSERS	D AW S ER Z
DOUSES	D AW S IH Z
DOUSING	D AW S IH NG
DOUX	D AW K S
DOUZEPER	D AW Z IY P AH R
DOUZEPERS	D AW Z AH P AH R Z
DOWNCOURT	D AW N K OW R T
DOWNPOUR	D AW N P AO R
DOWNPOURS	D AW N P AO R Z
DOWNSPOUT	D AW N S P AW T
DOWNSPOUTS	D AW N S P AW T S
DREADNOUGHT	D R EH D N AO T
DREADNOUGHTS	D R EH D N AO T S
DROPOUT	D R AA P AW T
DROPOUTS	D R AA P AW T S
DROUGHT	D R AW T
DROUGHTIER	D R AW T IY ER
DROUGHTIEST	D R AW T IY AH S T
DROUGHTINESS	D R AW T IY N AH S
DROUGHTINESSES	D R AW T IY N AH S IH Z
DROUGHTS	D R AW T S
DROUGHTY	D R AW T IY
DROUK	D R AW K
DROUKED	D R AW K T
DROUKING	D R AW K AH NG
DROUKS	D R AW K S
DROUTH	D R AW TH
DROUTHIER	D R AW TH IY ER
DROUTHIEST	D R AW TH IY AH S T
DROUTHS	D R AW TH S
DROUTHY	D R AW TH IY
DRUPACEOUS	D R UW P AH S IY AH S
DUBIOUS	D UW B IY AH S
DUBIOUSLY	D UW B IY AH S L IY
DUBIOUSNESS	D UW B IY AH S N AH S
DUBIOUSNESSES	D UW B IY AH S N AH S IH Z
DUGOUT	D AH G AW T
DUGOUTS	D AH G AW T S
DUMBFOUND	D AH M F AW N D
DUMBFOUNDED	D AH M F AW N D IH D
DUMBFOUNDER	D AH M F AW N D ER
DUMBFOUNDERED	D AH M F AW N D ER D
DUMBFOUNDERING	D AH M F AW N D ER IH NG
DUMBFOUNDERS	D AH M F AW N D ER Z
DUMBFOUNDING	D AH M F AW N D IH NG
DUMBFOUNDS	D AH M F AW N D Z
DUMFOUND	D AH M F AW N D
DUMFOUNDED	D AH M F AW N D AH D
DUMFOUNDING	D AH M F AW N D AH NG
DUMFOUNDS	D AH M F AW N D Z
DUPLICITOUS	D UW P L IH S IH T AH S
DUPLICITOUSLY	D AH P L AH S IH T OW AH S L IY
DUTEOUS	D Y UW T IY AH S
DYVOUR	D IH V AH R
DYVOURS	D AH V OW Y AH R Z
EARTHBOUND	ER TH B AW N D
EASTBOUND	IY S T B AW N D
ECHINODERMATOUS	AH CH IH N AH D AH R M AH T AH S
ECOTOURISM	EH K AH T OW Y AH R IH Z AH M
ECOTOURISMS	AH K AA T AH R AH Z AH M Z
ECOTOURIST	EH K AH T OW Y AH R AH S T
ECOTOURISTS	AH K AA T AH R AH S T S
ECZEMATOUS	EH K Z EH M AH T AH S
EDACIOUS	AH D AH S IY AH S
EDEMATOUS	IH D EH M AH T AH S
EDENTULOUS	IY D EH N CH AH L AH S
EELPOUT	IY L P AW T
EELPOUTS	IY L P AW T S
EFFICACIOUS	EH F AH K EY SH AH S
EFFICACIOUSLY	EH F AH K EY SH AH S L IY
EFFICACIOUSNESS	EH F AH K EY SH AH S N AH S
EFFICACIOUSNESSES	EH F AH K EY SH AH S N AH S IH Z
EGREGIOUS	IH G R IY JH AH S
EGREGIOUSLY	IH G R IY JH AH S L IY
EGREGIOUSNESS	IH G R IY JH AH S N AH S
EGREGIOUSNESSES	IH G R IY JH AH S N AH S IH Z
ELECTROACOUSTIC	AH L EH K T R AH K AW S T AH K
ELECTROACOUSTICS	AH L EH K T R AH K AW S T AH S Z
ELKHOUND	EH L K HH AW N D
ELKHOUNDS	EH L K HH AW N D Z
ELYTROUS	AH L IH T R AH S
EMBOUCHURE	AA M B UH SH UH R
EMBOUCHURES	AA M B UH SH UH R Z
EMBOURGEOISEMENT	IH M B AH R JH IY OY Z M AH N T
EMBOURGEOISEMENTS	IH M B AH R JH IY OY S AH M AH N T S
EMPHYSEMATOUS	EH M F AH S IY M AH T AH S
EMULOUS	EH M Y AH L AH S
EMULOUSLY	EH M Y AH L AH S L IY
EMULOUSNESS	EH M Y AH L AH S N AH S
EMULOUSNESSES	EH M Y AH L AH S N AH S IH Z
ENAMOUR	AH N AE M AH R
ENAMOURED	AH N AH M OW Y AH R D
ENAMOURING	AH N AH M OW Y AH R AH NG
ENAMOURS	AH N AH M OW Y AH R Z
ENANTIOMORPHOUS	AH N AH N T AY AH M AO R F AH S
ENCOUNTER	IH N K AW N T ER
ENCOUNTER(2)	IH N K AW N ER
ENCOUNTERED	IH N K AW N T ER D
ENCOUNTERED(2)	IH N K AW N ER D
ENCOUNTERING	EH N K AW N T ER IH NG
ENCOUNTERING(2)	EH N K AW N ER IH NG
ENCOUNTERS	IH N K AW N T ER Z
ENCOUNTERS(2)	IH N K AW N ER Z
ENCOURAGE	EH N K ER IH JH
ENCOURAGE(2)	IH N K ER AH JH
ENCOURAGED	EH N K ER IH JH D
ENCOURAGED(2)	IH N K ER AH JH D
ENCOURAGEMENT	EH N K ER IH JH M AH N T
ENCOURAGEMENTS	EH N K ER IH JH M AH N T S
ENCOURAGER	EH N K ER IH JH ER
ENCOURAGERS	EH N K ER IH JH ER Z
ENCOURAGES	EH N K ER IH JH IH Z
ENCOURAGES(2)	IH N K ER AH JH AH Z
ENCOURAGING	EH N K ER IH JH IH NG
ENCOURAGING(2)	IH N K ER AH JH IH NG
ENCOURAGINGLY	EH N K ER IH JH IH NG L IY
ENDEAVOUR	IH N D EH V ER
ENDEAVOURED	IH N D IY AH V OW Y AH R D
ENDEAVOURING	IH N D IY AH V OW Y AH R AH NG
ENDEAVOURS	IH N D IY AH V OW Y AH R Z
ENDOGAMOUS	EH N D AA G AH M AH S
ENDOGENOUS	EH N D AO JH EH N AH S
ENDOGENOUSLY	EH N D AA JH AH N AH S L IY
ENGINOUS	EH N JH AH N AH S
ENORMOUS	IH N AO R M AH S
ENORMOUS(2)	IH N AO R M IH S
ENORMOUS(3)	IY N AO R M AH S
ENORMOUS(4)	IY N AO R M IH S
ENORMOUSLY	IH N AO R M AH S L IY
ENORMOUSLY(2)	IY N AO R M AH S L IY
ENORMOUSNESS	IH N AO R M AH S N AH S
ENORMOUSNESSES	IH N AO R M AH S N AH S IH Z
ENOUGH	IH N AH F
ENOUGH(2)	IY N AH F
ENOUGHS	IH N AH F S
ENOUNCE	EH N AW N S
ENOUNCED	EH N AW N S T
ENOUNCES	EH N AW N S IH Z
ENOUNCING	EH N AW N S IH NG
ENSHROUD	IH N SH R AW D
ENSHROUDED	IH N SH R AW D AH D
ENSHROUDING	EH N SH R AW D IH NG
ENSHROUDS	EH N SH R AW D Z
ENSOUL	EH N S OW L
ENSOULED	EH N S OW L D
ENSOULING	EH N S OW L IH NG
ENSOULS	EH N S OW L Z
ENTEROCOELOUS	IH N T AH R AH K OW AH L AH S
ENTOMOPHAGOUS	IH N T AA M AH F EY JH AH S
ENTOMOPHILOUS	IH N T AA M AH F AY L AH S
ENTOURAGE	AA N T UH R AA ZH
ENTOURAGE(2)	AA N T ER AA ZH
ENTOURAGES	AA N T UH R AA ZH AH Z
ENTOURAGES(2)	AA N T ER AA ZH AH Z
ENVIOUS	EH N V IY AH S
ENVIOUSLY	EH N V IY AH S L IY
ENVIOUSNESS	EH N V IY AH S N AH S
ENVIOUSNESSES	EH N V IY AH S N AH S IH Z
ENWOUND	EH N W UW N D
EPIGEOUS	AH P IH JH IY AH S
EPIGONOUS	AH P IH G AH N AH S
EPIGYNOUS	AH P IH JH AH N AH S
EPIPHANOUS	AH P IH F AH N AH S
EPITHELIOMATOUS	EH P AH TH AH L IY AA M AH T AH S
EPONYMOUS	AH P AA N AH M AH S
ERICACEOUS	AH R IH S AH S IY AH S
EROGENOUS	AH R AA JH AH N AH S
ERRONEOUS	EH R OW N IY AH S
ERRONEOUS(2)	ER OW N IY AH S
ERRONEOUSLY	EH R OW N IY AH S L IY
ERRONEOUSNESS	IH R OW N IY AH S N AH S
ERRONEOUSNESSES	IH R OW N IY AH S N AH S IH Z
ERYTHEMATOUS	EH R AH TH EH M AH T AH S
ESPOUSAL	IH S P AW Z AH L
ESPOUSALS	IH S P AW Z AH L Z
ESPOUSE	IH S P AW Z
ESPOUSE(2)	IH S P AW S
ESPOUSED	IH S P AW Z D
ESPOUSED(2)	IH S P AW S T
ESPOUSER	IH S P AW Z ER
ESPOUSERS	IH S P AW Z ER Z
ESPOUSES	IH S P AW Z IH Z
ESPOUSES(2)	IH S P AW S IH Z
ESPOUSING	IH S P AW Z IH NG
ESPOUSING(2)	IH S P AW S IH NG
ESTROUS	EH S T R AH S
ETOUFFEE	AH T AW F IY IY
ETOUFFEES	AH T AW F IY Z
EUPHONIOUS	Y UW F OW N IY AH S
EUPHONIOUSLY	Y UW F AH N IY OW AH S L IY
EUPHONIOUSNESS	Y UW F OW N IY AW Z N AH S
EUPHONIOUSNESSES	Y UW F OW N IY AW Z N EH S AH Z
EUROKOUS	Y UW R AH K AH S
EURYTHERMOUS	Y UW R AH TH AH R M AH S
EXANTHEMATOUS	EH K S AE N TH AH M AH T AH S
EXCREMENTITIOUS	IH K S R AH M EH N T AH SH AH S
EXIGUOUS	IH G Z IH G Y AH W AH S
EXIGUOUSLY	IH G Z IH G W OW AH S L IY
EXIGUOUSNESS	IH G Z IH G W AW Z N AH S
EXIGUOUSNESSES	IH G Z IH G W AW Z N EH S AH Z
EXIMIOUS	IH G Z IH M IY AH S
EXOGAMOUS	EH K S AA G AH M AH S
EXOGENOUS	EH K S OW JH AH N AH S
EXOGENOUSLY	IH G Z AH JH EH N OW AH S L IY
EXPEDITIOUS	EH K S P AH D IH SH AH S
EXPEDITIOUSLY	EH K S P AH D IH SH AH S L IY
EXPEDITIOUSNESS	EH K S P AH D IH SH AH S N AH S
EXPEDITIOUSNESSES	EH K S P AH D IH SH AH S N AH S IH Z
EXPOUND	IH K S P AW N D
EXPOUNDED	IH K S P AW N D AH D
EXPOUNDER	IH K S P AW N D ER
EXPOUNDERS	IH K S P AW N D ER Z
EXPOUNDING	IH K S P AW N D IH NG
EXPOUNDS	IH K S P AW N D Z
EXTEMPORANEOUS	IH K S T EH M P AH R EY N IY AH S
EXTEMPORANEOUSLY	IH K S T EH M P AH R AH N IY OW AH S L IY
EXTEMPORANEOUSNESS	IH K S T AH M P AH R EY N IY AW Z N AH S
EXTEMPORANEOUSNESSES	IH K S T AH M P AH R EY N IY AW Z N EH S AH Z
EXTRANEOUS	EH K S T R EY N IY AH S
EXTRANEOUSLY	EH K S T R EY N IY AH S L IY
EXTRANEOUSNESS	EH K S T R EY N IY AH S N AH S
EXTRANEOUSNESSES	EH K S T R EY N IY AH S N AH S IH Z
FABULOUS	F AE B Y AH L AH S
FABULOUSLY	F AE B Y UW L AH S L IY
FABULOUSNESS	F AE B Y AH L AH S N AH S
FABULOUSNESSES	F AE B Y AH L AH S N AH S IH Z
FACETIOUS	F AH S IY SH AH S
FACETIOUSLY	F AH S IY SH AH S L IY
FACETIOUSNESS	F AH S IY SH AH S N AH S
FACETIOUSNESSES	F AH S IY SH AH S N AH S IH Z
FACTIOUS	F AE K T IY AH S
FACTIOUSLY	F AE K T IY AH S L IY
FACTIOUSNESS	F AE K T IY AH S N AH S
FACTIOUSNESSES	F AE K T IY AH S N AH S IH Z
FACTITIOUS	F AE K T IH SH AH S
FACTITIOUSLY	F AE K T AH T IY AH S L IY
FACTITIOUSNESS	F AE K T AH T IY AH S N AH S
FACTITIOUSNESSES	F AE K T AH T IY AH S N AH S IH Z
FADEOUT	F EY D AW T
FADEOUTS	F EY D AW T S
FAIRGROUND	F EH R G R AW N D
FAIRGROUNDS	F EH R G R AW N D Z
FAITOUR	F EY T AH R
FAITOURS	F EY T OW Y AH R Z
FALLACIOUS	F AH L EY SH AH S
FALLACIOUSLY	F AH L EY SH AH S L IY
FALLACIOUSNESS	F AH L EY SH AH S N AH S
FALLACIOUSNESSES	F AH L EY SH AH S N AH S IH Z
FALLOUT	F AO L AW T
FALLOUTS	F AO L AW T S
FAMOUS	F EY M AH S
FAMOUSLY	F EY M AH S L IY
FAMOUSNESS	F EY M AH S N AH S
FAMOUSNESSES	F EY M AH S N AH S IH Z
FANTABULOUS	F AE N T AE B Y AH L AH S
FARINACEOUS	F AA R IH N EY S AH S
FARMHOUSE	F AA R M HH AW S
FARMHOUSES	F AA R M HH AW S IH Z
FAROUCHE	F AH R AW CH
FARRAGINOUS	F AA R AE G IH N AH S
FASHIOUS	F AE SH AH S
FASTIDIOUS	F AE S T IH D IY AH S
FASTIDIOUSLY	F AE S T IH D IY AH S L IY
FASTIDIOUSNESS	F AE S T IH D IY AH S N AH S
FASTIDIOUSNESSES	F AE S T IH D IY AH S N AH S IH Z
FASTUOUS	F AE S T Y AH W AH S
FATUOUS	F AE CH AH W AH S
FATUOUSLY	F AE CH AH W AH S L IY
FATUOUSNESS	F AE CH AH W AH S N AH S
FATUOUSNESSES	F AE CH AH W AH S N AH S IH Z
FAUBOURG	F AH B OW R G
FAUBOURGS	F AO B AH R G Z
FAVOUR	F EY V ER
FAVOURED	F EY V ER D
FAVOURER	F EY V ER ER
FAVOURERS	F EY V ER ER Z
FAVOURING	F EY V ER IH NG
FAVOURS	F EY V ER Z
FELICITOUS	F IH L IH S AH T AH S
FELICITOUSLY	F IH L IH S AH T AH S L IY
FELICITOUSNESS	F IH L IH S AH T AH S N AH S
FELICITOUSNESSES	F IH L IH S AH T AH S N AH S IH Z
FELONIOUS	F EH L OW N IY AH S
FELONIOUSLY	F AH L OW N IY AH S L IY
FELONIOUSNESS	F AH L OW N IY AH S N AH S
FELONIOUSNESSES	F AH L OW N IY AH S N AH S IH Z
FEROCIOUS	F ER OW SH AH S
FEROCIOUSLY	F ER OW SH IH S L IY
FEROCIOUSNESS	F AH R OW SH AH S N AH S
FEROCIOUSNESSES	F AH R OW SH AH S N AH S IH Z
FERREOUS	F EH R IY AH S
FERRIFEROUS	F EH R IH F AH R AH S
FERROUS	F EH R AH S
FERRUGINOUS	F EH R UW JH AH N AH S
FERVOUR	F AH R V AH R
FERVOURS	F AH R V OW Y AH R Z
FEVEROUS	F IY V ER AH S
FIBROMATOUS	F IH B R AA M AH T AH S
FIBROUS	F AY B R AH S
FICTITIOUS	F IH K T IH SH AH S
FICTITIOUSLY	F IH K T IH SH AH S L IY
FICTITIOUSNESS	F IH K T IH SH AH S N AH S
FICTITIOUSNESSES	F IH K T IH SH AH S N AH S IH Z
FILAMENTOUS	F IH L AH M AH N T AH S
FIREHOUSE	F AY ER HH AW S
FIREHOUSES	F AY ER HH AW S IH Z
FISSIPAROUS	F IH S IH P AH R AH S
FISSIPAROUSNESS	F IH S IH P AH R AW Z N AH S
FISSIPAROUSNESSES	F IH S IH P AH R AW Z N EH S AH Z
FISTULOUS	F IH S T Y AH L AH S
FLAGITIOUS	F L AE G AH T IY AH S
FLAGITIOUSLY	F L AE G AH T IY AH S L IY
FLAGITIOUSNESS	F L AE G AH T IY AH S N AH S
FLAGITIOUSNESSES	F L AE G AH T IY AH S N AH S IH Z
FLAMEOUT	F L EY M AW T
FLAMEOUTS	F L EY M AW T S
FLANNELMOUTHED	F L AE N AH L M AW TH T
FLAVOUR	F L AE V AH R
FLAVOURED	F L AH V OW Y AH R D
FLAVOURING	F L AH V OW Y AH R AH NG
FLAVOURS	F L AH V OW Y AH R Z
FLAVOURY	F L AH V AW R IY
FLEXUOUS	F L EH K S Y AH W AH S
FLIRTATIOUS	F L ER T EY SH AH S
FLIRTATIOUSLY	F L ER T EY SH AH S L IY
FLIRTATIOUSNESS	F L ER T EY SH AH S N AH S
FLIRTATIOUSNESSES	F L ER T EY SH AH S N AH S IH Z
FLOPHOUSE	F L AA P HH AW S
FLOPHOUSES	F L AA P HH AW S IH Z
FLORIFEROUS	F L AH R IH F AH R AH S
FLORIFEROUSNESS	F L AH R IH F AH R AW Z N AH S
FLORIFEROUSNESSES	F L AH R IH F AH R AW Z N EH S AH Z
FLOUNCE	F L AW N S
FLOUNCED	F L AW N S T
FLOUNCES	F L AW N S IH Z
FLOUNCIER	F L AW N S IY ER
FLOUNCIEST	F L AW N S IY AH S T
FLOUNCING	F L AW N S IH NG
FLOUNCINGS	F L AW N S IH NG Z
FLOUNCY	F L AW N S IY
FLOUNDER	F L AW N D ER
FLOUNDERED	F L AW N D ER D
FLOUNDERING	F L AW N D ER IH NG
FLOUNDERS	F L AW N D ER Z
FLOUR	F L AW ER
FLOUR(2)	F L AW R
FLOURED	F L AW ER D
FLOURING	F L AW ER IH NG
FLOURISH	F L ER IH SH
FLOURISHED	F L ER IH SH T
FLOURISHER	F L ER IH SH ER
FLOURISHERS	F L ER IH SH ER Z
FLOURISHES	F L ER IH SH AH Z
FLOURISHES(2)	F L ER IH SH IH Z
FLOURISHING	F L ER IH SH IH NG
FLOURISHINGLY	F L ER IH SH IH NG L IY
FLOURLESS	F L AW ER L AH S
FLOURS	F L AW ER Z
FLOURY	F L AW ER IY
FLOUT	F L AW T
FLOUTED	F L AW T IH D
FLOUTER	F L AW T ER
FLOUTERS	F L AW T ER Z
FLOUTING	F L AW T IH NG
FLOUTS	F L AW T S
FLUOROURACIL	F L UW W AH R AH R AH S AH L
FLUOROURACILS	F L UW W AH R AH Y UH R AH S AH L Z
FOGBOUND	F AA G B AW N D
FOLDOUT	F OW L D AW T
FOLDOUTS	F OW L D AW T S
FOLIACEOUS	F OW L IY AH S IY AH S
FOLIOUS	F OW L IY AH S
FORAMINOUS	F AO R AH M AY N AH S
FORECOURT	F OW R K OW R T
FORECOURTS	F OW R K OW R T S
FOREGROUND	F AO R G R AW N D
FOREGROUNDED	F OW R G R AW N D IH D
FOREGROUNDING	F OW R G R AW N D IH NG
FOREGROUNDS	F OW R G R AW N D Z
FORETHOUGHT	F AO R TH AO T
FORETHOUGHTFUL	F OW R TH AO T F AH L
FORETHOUGHTFULLY	F OW R TH AO T F AH L IY
FORETHOUGHTFULNESS	F OW R TH AO T F AH L N AH S
FORETHOUGHTFULNESSES	F OW R TH AO T F AH L N AH S IH Z
FORETHOUGHTS	F OW R TH AO T S
FORTUITOUS	F AO R T UW IH T AH S
FORTUITOUSLY	F AO R T UW T OW AH S L IY
FORTUITOUSNESS	F AO R T AH T AW Z N AH S
FORTUITOUSNESSES	F AO R T AH T AW Z N EH S AH Z
FOSSILIFEROUS	F AA S AH L IH F ER AH S
FOU	F UW
FOUETTE	F AW EH T
FOUETTES	F AW EH T S
FOUGHT	F AO T
FOUGHTEN	F AO T AH N
FOUL	F AW L
FOULARD	F AW L AH R D
FOULARDS	F AW L AH R D Z
FOULBROOD	F AW L B R UW D
FOULBROODS	F AW L B R UW D Z
FOULED	F AW L D
FOULER	F AW L ER
FOULEST	F AW L AH S T
FOULING	F AW L IH NG
FOULINGS	F AW L IH NG Z
FOULLY	F AW L IY
FOULMOUTHED	F AW L M AW TH T
FOULNESS	F AW L N AH S
FOULNESSES	F AW L N AH S IH Z
FOULS	F AW L Z
FOUND	F AW N D
FOUNDATION	F AW N D EY SH AH N
FOUNDATIONAL	F AW N D EY SH AH N AH L
FOUNDATIONALLY	F AW N D EY SH AH N AH L IY
FOUNDATIONLESS	F AW N D EY SH AH N L AH S
FOUNDATIONS	F AW N D EY SH AH N Z
FOUNDED	F AW N D IH D
FOUNDER	F AW N D ER
FOUNDERED	F AW N D ER D
FOUNDERING	F AW N D ER IH NG
FOUNDERS	F AW N D ER Z
FOUNDING	F AW N D IH NG
FOUNDLING	F AW N D L IH NG
FOUNDLINGS	F AW N D L IH NG Z
FOUNDRIES	F AW N D R IY Z
FOUNDRY	F AW N D R IY
FOUNDS	F AW N D Z
FOUNT	F AW N T
FOUNTAIN	F AW N T AH N
FOUNTAINED	F AW N T AH N D
FOUNTAINHEAD	F AW N T AH N HH EH D
FOUNTAINHEADS	F AW N T AH N HH EH D Z
FOUNTAINING	F AW N T AH N IH NG
FOUNTAINS	F AW N T AH N Z
FOUNTS	F AW N T S
FOUR	F AO R
FOURCHEE	F AH R CH IY IY
FOURDRINIER	F AH R D R IH N AY AH R
FOURDRINIERS	F AH R D R AH N IY R Z
FOURFOLD	F AO R F OW L D
FOURGON	F AH R G AH N
FOURGONS	F AH R G AH N Z
FOURPLEX	F AH R P L AH K S
FOURPLEXES	F AH R P L AH K S
FOURRAGERE	F AH R EY JH AH R
FOURRAGERES	F AH R AH JH IY R Z
FOURS	F AO R Z
FOURSCORE	F OW R S K OW R
FOURSOME	F AO R S AH M
FOURSOMES	F OW R S AH M Z
FOURSQUARE	F AO R S K W EH R
FOURTEEN	F AO R T IY N
FOURTEENER	F OW R T IY N ER
FOURTEENERS	F OW R T IY N ER Z
FOURTEENS	F AO R T IY N Z
FOURTEENTH	F AO R T IY N TH
FOURTEENTHS	F OW R T IY N TH S
FOURTH	F AO R TH
FOURTHLY	F AO R TH L IY
FOURTHS	F AO R TH S
FOURTHS(2)	F AO R S
FOXHOUND	F AA K S HH AW N D
FOXHOUNDS	F AA K S HH AW N D Z
FRABJOUS	F R AE B AH S
FRACTIOUS	F R AE K SH AH S
FRACTIOUSLY	F R AE K SH AH S L IY
FRACTIOUSNESS	F R AE K SH AH S N AH S
FRACTIOUSNESSES	F R AE K SH AH S N AH S IH Z
FREAKOUT	F R IY K AW T
FREAKOUTS	F R IY K AW T S
FRIVOLOUS	F R IH V AH L AH S
FRIVOLOUSLY	F R IH V AH L AH S L IY
FRIVOLOUSNESS	F R IH V AH L AH S N AH S
FRIVOLOUSNESSES	F R IH V AH L AH S N AH S IH Z
FRONTCOURT	F R AH N T K OW R T
FRONTCOURTS	F R AH N T K OW R T S
FROUFROU	F R AW F R UW
FROUFROUS	F R AW F R AH S
FROUNCE	F R AW N S
FROUNCED	F R AW N S T
FROUNCES	F R AW N S AH Z
FROUNCING	F R AW N S AH NG
FROUZIER	F R AW Z AY AH R
FROUZIEST	F R AW Z AY AH S T
FROUZY	F R AW Z IY
FRUCTUOUS	F R AH K T Y AH W AH S
FRUGIVOROUS	F R UW JH IH V AH R AH S
FUCOUS	F Y UW K AH S
FUGACIOUS	F Y UW G AH S IY AH S
FULGUROUS	F UH L G Y AH R AH S
FULIGINOUS	F Y UW L IH JH AH N AH S
FULIGINOUSLY	F Y UW L AH JH IH N OW AH S L IY
FULLMOUTHED	F UH L M AW TH T
FULVOUS	F UH L V AH S
FUNGOUS	F AH N G AH S
FURIOUS	F Y UH R IY AH S
FURIOUSLY	F Y UH R IY AH S L IY
FURLOUGH	F ER L OW
FURLOUGHED	F ER L OW D
FURLOUGHING	F ER L OW IH NG
FURLOUGHS	F ER L OW Z
FUSCOUS	F AH S AH S
GADABOUT	G AE D AH B AW T
GADABOUTS	G AE D AH B AW T S
GALLINACEOUS	G AO L IH N EY S AH S
GALLOUS	G AO L AH S
GAMETOGENOUS	G EY M T AA G AH N AH S
GAMOPETALOUS	G AE M AH P EH T AH L AH S
GANGRENOUS	G AE N G R AH N AH S
GARNETIFEROUS	G AA R N AH T IH F AH R AH S
GARRULOUS	G EH R AH L AH S
GARRULOUSLY	G AE R AH L AH S L IY
GARRULOUSNESS	G AE R AH L AH S N AH S
GARRULOUSNESSES	G AE R AH L AH S N AH S IH Z
GASEOUS	G AE S IY AH S
GASEOUSNESS	G AE S IY AH S N AH S
GASEOUSNESSES	G AE S IY AH S N AH S IH Z
GASHOUSE	G AE S HH AW S
GASHOUSES	G AE SH AH S IH Z
GATEHOUSE	G EY T HH AW S
GATEHOUSES	G EY T HH AW S IH Z
GAZEHOUND	G EY Z HH AW N D
GAZEHOUNDS	G EY Z HH AW N D Z
GEEPOUND	JH IY P AW N D
GEEPOUNDS	JH IY P AW N D Z
GELATINOUS	JH AH L AE T AH N AH S
GELATINOUSLY	JH EH L AH T AY N AH S L IY
GELATINOUSNESS	JH EH L AH T AY N AH S N AH S
GELATINOUSNESSES	JH EH L AH T AY N AH S N AH S IH Z
GENEROUS	JH EH N ER AH S
GENEROUSLY	JH EH N ER AH S L IY
GENEROUSNESS	JH EH N ER AH S N AH S
GENEROUSNESSES	JH EH N ER AH S N AH S IH Z
GENITOURINARY	JH AH N IH T AH R AH N EH R IY
GEOSYNCHRONOUS	JH IY AH S IH NG K R AH N AH S
GHOUL	G UW L
GHOULIE	G UW L IY
GHOULIES	G UW L IY Z
GHOULISH	G UW L IH SH
GHOULISHLY	G UW L IH SH L IY
GHOULISHNESS	G UW L IH SH N AH S
GHOULISHNESSES	G UW L IH SH N AH S IH Z
GHOULS	G UW L Z
GIAOUR	JH AW ER
GIAOURS	JH AW ER Z
GIBBOUS	JH IH B AH S
GLABROUS	G L AE B R AH S
GLAMOROUS	G L AE M ER AH S
GLAMOROUSLY	G L AE M ER AH S L IY
GLAMOROUSNESS	G L AE M ER AH S N AH S
GLAMOROUSNESSES	G L AE M ER AH S N AH S IH Z
GLAMOUR	G L AE M ER
GLAMOURED	G L AE M ER D
GLAMOURING	G L AE M ER IH NG
GLAMOURIZE	G L AE M ER AY Z
GLAMOURIZED	G L AE M ER AY Z D
GLAMOURIZES	G L AE M ER AY Z IH Z
GLAMOURIZING	G L AE M ER AY Z IH NG
GLAMOURLESS	G L AE M ER L AH S
GLAMOUROUS	G L AE M ER AH S
GLAMOURS	G L AE M ER Z
GLASSHOUSE	G L AE S HH AW S
GLASSHOUSES	G L AE S HH AW S IH Z
GLAUCOUS	G L AO K AH S
GLAUCOUSNESS	G L AH K AW Z N AH S
GLAUCOUSNESSES	G L AH K AW Z N EH S AH Z
GLOBOUS	G L OW B AH S
GLORIOUS	G L AO R IY AH S
GLORIOUSLY	G L AO R IY AH S L IY
GLORIOUSNESS	G L OW R IY AH S N AH S
GLORIOUSNESSES	G L OW R IY AH S N AH S IH Z
GLOUT	G L AW T
GLOUTED	G L OW Y UW T AH D
GLOUTING	G L OW Y UW T AH NG
GLOUTS	G L OW Y UW T S
GLUTENOUS	G L AH T AH N AH S
GLUTINOUS	G L UW T AH N AH S
GLUTINOUSLY	G L UW T AH N AH S L IY
GLUTTONOUS	G L AH T AH N AH S
GLUTTONOUSLY	G L AH T AH N AH S L IY
GLUTTONOUSNESS	G L AH T AH N AH S N AH S
GLUTTONOUSNESSES	G L AH T AH N AH S N AH S IH Z
GOALMOUTH	G OW L M AW TH
GOALMOUTHS	G OW L M AW TH S
GOITROUS	G OY T ER AH S
GORGEOUS	G AO R JH AH S
GORGEOUSLY	G AO R JH AH S L IY
GORGEOUSNESS	G AO R JH AH S N AH S
GORGEOUSNESSES	G AO R JH AH S N AH S IH Z
GOUACHE	G AW AH CH
GOUACHES	G AW AH CH AH Z
GOUGE	G AW JH
GOUGED	G AW JH D
GOUGER	G AW JH ER
GOUGERS	G AW JH ER Z
GOUGES	G AW JH IH Z
GOUGING	G AW JH IH NG
GOULASH	G UW L AA SH
GOULASHES	G AW L AH SH AH Z
GOURAMI	G AH R AH M IY
GOURAMIES	G AH R AH M AY Z
GOURAMIS	G AH R AH M AH S
GOURD	G AO R D
GOURDE	G OW R D
GOURDES	G AH R D Z
GOURDS	G AO R D Z
GOURMAND	G AH R M AH N D
GOURMANDISE	G AH R M AH N D AY Z
GOURMANDISES	G AH R M AH N D AY Z AH Z
GOURMANDISM	G AH R M AH N D IH Z AH M
GOURMANDISMS	G AH R M AE N D AH Z AH M Z
GOURMANDIZE	G AH R M AH N D AY Z
GOURMANDIZED	G AH R M AH N D AY Z D
GOURMANDIZES	G AH R M AH N D AY Z AH Z
GOURMANDIZING	G AH R M AH N D AY Z AH NG
GOURMANDS	G AH R M AH N D Z
GOURMET	G UH R M EY
GOURMETS	G UH R M EY Z
GOUT	G AW T
GOUTIER	G AW T IY ER
GOUTIEST	G AW T IY AH S T
GOUTILY	G AW T IY L IY
GOUTS	G AW T S
GOUTY	G AW T IY
GRACIOUS	G R EY SH AH S
GRACIOUSLY	G R EY SH AH S L IY
GRACIOUSNESS	G R EY SH AH S N AH S
GRACIOUSNESSES	G R EY SH AH S N AH S IH Z
GRAMINEOUS	G R AH M IH N IY AH S
GRAMINIVOROUS	G R AE M IH N IH V ER AH S
GRANIVOROUS	G R AH N IH V AH R AH S
GRANULOMATOUS	G R AE N Y AH L AA M AH T AH S
GRATUITOUS	G R AH T UW AH T AH S
GRATUITOUSLY	G R AH T UW AH T AH S L IY
GRATUITOUSNESS	G R AH T UW AH T AH S N AH S
GRATUITOUSNESSES	G R AH T UW AH T AH S N AH S IH Z
GRAYOUT	G R EY AW T
GRAYOUTS	G R EY AW T S
GREENHOUSE	G R IY N HH AW S
GREENHOUSES	G R IY N HH AW S IH Z
GREENHOUSES(2)	G R IY N HH AW Z AH Z
GREGARIOUS	G R AH G EH R IY AH S
GREGARIOUSLY	G R IH G AE R IY AH S L IY
GREGARIOUSNESS	G R IH G AE R IY AH S N AH S
GREGARIOUSNESSES	G R IH G AE R IY AH S N AH S IH Z
GREYHOUND	G R EY HH AW N D
GREYHOUNDS	G R EY HH AW N D Z
GRIEVOUS	G R IY V AH S
GRIEVOUSLY	G R IY V AH S L IY
GRIEVOUSNESS	G R IY V AH S N AH S
GRIEVOUSNESSES	G R IY V AH S N AH S IH Z
GRISEOUS	G R IH Z IY AH S
GROUCH	G R AW CH
GROUCHED	G R AW CH T
GROUCHES	G R AW CH AH Z
GROUCHIER	G R AW CH AY AH R
GROUCHIEST	G R AW CH AY AH S T
GROUCHILY	G R AW CH AH L IY
GROUCHINESS	G R AW CH AH N AH S
GROUCHINESSES	G R AW CH AH N EH S AH Z
GROUCHING	G R AW CH AH NG
GROUCHY	G R AW CH IY
GROUND	G R AW N D
GROUNDBREAKER	G R AW N D B R EY K ER
GROUNDBREAKERS	G R AW N D B R EY K ER Z
GROUNDBREAKING	G R AW N D B R EY K IH NG
GROUNDBREAKING(2)	G R AW N B R EY K IH NG
GROUNDBURST	G R AW N D B ER S T
GROUNDBURSTS	G R AW N D B ER S T S
GROUNDED	G R AW N D IH D
GROUNDER	G R AW N D ER
GROUNDERS	G R AW N D ER Z
GROUNDFISH	G R AW N D F IH SH
GROUNDFISHES	G R AW N D F IH SH IH Z
GROUNDHOG	G R AW N D HH AA G
GROUNDHOGS	G R AW N D HH AA G Z
GROUNDING	G R AW N D IH NG
GROUNDINGS	G R AW N D IH NG Z
GROUNDLESS	G R AW N D L AH S
GROUNDLESSLY	G R AW N D L AH S L IY
GROUNDLESSNESS	G R AW N D L AH S N AH S
GROUNDLESSNESSES	G R AW N D L AH S N AH S IH Z
GROUNDLING	G R AW N D L IH NG
GROUNDLINGS	G R AW N D L IH NG Z
GROUNDMASS	G R AW N D M AE S
GROUNDMASSES	G R AW N D M AE S IH Z
GROUNDNUT	G R AW N D N AH T
GROUNDNUTS	G R AW N D N AH T S
GROUNDOUT	G R AW N D AW T
GROUNDOUTS	G R AW N D AW T S
GROUNDS	G R AW N D Z
GROUNDS(2)	G R AW N Z
GROUNDSEL	G R AW N D S AH L
GROUNDSELS	G R AW N D S AH L Z
GROUNDSHEET	G R AW N D SH IY T
GROUNDSHEETS	G R AW N D SH IY T S
GROUNDSKEEPER	G R AW N D S K IY P ER
GROUNDSKEEPERS	G R AW N D S K IY P ER Z
GROUNDSMAN	G R AW N D Z M AE N
GROUNDSMEN	G R AW N D Z M EH N
GROUNDSWELL	G R AW N D S W EH L
GROUNDSWELLS	G R AW N D S W EH L Z
GROUNDWATER	G R AW N D W AA T ER
GROUNDWATER(2)	G R AW N D W AO T ER
GROUNDWATERS	G R AW N D W AO T ER Z
GROUNDWOOD	G R AW N D W UH D
GROUNDWOODS	G R AW N D W UH D Z
GROUNDWORK	G R AW N D W ER K
GROUNDWORKS	G R AW N D W ER K S
GROUP	G R UW P
GROUPABLE	G R UW P AH B AH L
GROUPED	G R UW P T
GROUPER	G R UW P ER
GROUPERS	G R UW P ER Z
GROUPIE	G R UW P IY
GROUPIES	G R UW P IY Z
GROUPING	G R UW P IH NG
GROUPINGS	G R UW P IH NG Z
GROUPOID	G R UW P OY D
GROUPOIDS	G R UW P OY D Z
GROUPS	G R UW P S
GROUPTHINK	G R UW P TH IH NG K
GROUPTHINKS	G R UW P TH IH NG K S
GROUPUSCULE	G R UW P AH S Y UW L
GROUPUSCULES	G R UW P AH S Y UW L Z
GROUSE	G R AW S
GROUSED	G R AW S T
GROUSER	G R OW AH S AH R
GROUSERS	G R AW S AH R Z
GROUSES	G R AW S IH Z
GROUSING	G R AW S IH NG
GROUT	G R AW T
GROUTED	G R OW Y UW T AH D
GROUTER	G R OW Y UW T AH R
GROUTERS	G R AW T AH R Z
GROUTIER	G R AW T AY AH R
GROUTIEST	G R AW T AY AH S T
GROUTING	G R AW T IH NG
GROUTS	G R OW Y UW T S
GROUTY	G R AW T IY
GRUMOUS	G R UW M AH S
GUARDHOUSE	G AA R D HH AW S
GUARDHOUSES	G AA R D HH AW S IH Z
GUESTHOUSE	G EH S T HH AW S
GUESTHOUSES	G EH S T HH AW S IH Z
GUMMATOUS	G AH M AH T AH S
GUMMOUS	G AH M AH S
GUNFOUGHT	G AH N F AO T
GYMNOSPERMOUS	JH IH M N AA S AH R M AH S
GYNANDROUS	JH AH N AE N D R AH S
GYPSEOUS	JH IH P S IY AH S
GYPSIFEROUS	JH IH P S IH F AH R AH S
HALOGENOUS	HH AE L AH JH AH N AH S
HAMULOUS	HH AE M Y AH L AH S
HANDOUT	HH AE N D AW T
HANDOUTS	HH AE N D AW T S
HANDWROUGHT	HH AE N D R AO T
HANGOUT	HH AE NG AW T
HANGOUTS	HH AE NG AW T S
HARBOUR	HH AA R B ER
HARBOURED	HH AA R B OW Y AH R D
HARBOURING	HH AA R B OW Y AH R AH NG
HARBOURS	HH AA R B OW Y AH R Z
HARDBOUND	HH AA R D B AW N D
HARDMOUTHED	HH AA R D M AW TH T
HARMONIOUS	HH AA R M OW N IY AH S
HARMONIOUSLY	HH AA R M OW N IY AH S L IY
HARMONIOUSNESS	HH AA R M OW N IY AH S N AH S
HARMONIOUSNESSES	HH AA R M OW N IY AH S N AH S IH Z
HAVIOUR	HH EY V IY AH R
HAVIOURS	HH EY V IY OW Y AH R Z
HAZARDOUS	HH AE Z ER D AH S
HAZARDOUSLY	HH AE Z ER D AH S L IY
HAZARDOUSNESS	HH AE Z ER D AH S N AH S
HAZARDOUSNESSES	HH AE Z ER D AH S N AH S IH Z
HEADCOUNT	HH EH D K AW N T
HEADCOUNTS	HH EH D K AW N T S
HEBETUDINOUS	HH EH B AH T Y UW D AH N AH S
HEINOUS	HH EY N AH S
HEINOUSLY	HH IY N OW AH S L IY
HEINOUSNESS	HH IY N AW Z N AH S
HEINOUSNESSES	HH IY N AW Z N EH S AH Z
HELIOLATROUS	HH IY L IY AH L AE T R AH S
HELLACIOUS	HH EH L EY SH AH S
HELLACIOUSLY	HH EH L EY SH AH S L IY
HELLHOUND	HH EH L HH AW N D
HELLHOUNDS	HH EH L HH AW N D Z
HEMATOGENOUS	HH EH M AH T AA G AH N AH S
HEMATOPHAGOUS	HH AH M AE T AH F EY JH AH S
HEMIMETABOLOUS	HH EH M AH M AH T AE B AH L AH S
HEMIPTEROUS	HH AH M IH P T AH R AH S
HEMIZYGOUS	HH AH M IH Z AH G AH S
HENHOUSE	HH EH N HH AW S
HENHOUSES	HH EH N HH AW S IH Z
HERBACEOUS	ER B EY SH AH S
HERBIVOROUS	HH ER B IH V AO R AH S
HERBIVOROUS(2)	ER B IH V AO R AH S
HEREABOUT	HH IH R AH B AW T
HEREABOUTS	HH IH R AH B AW T S
HETEROCYSTOUS	HH AH T EH R AH S IH S T AH S
HETEROECIOUS	HH EH T AH R OW AH SH AH S
HETEROGAMOUS	HH EH T AH R AA G AH M AH S
HETEROGENEOUS	HH EH T ER AH JH IY N Y AH S
HETEROGENEOUSLY	HH EH T AH R AH JH IY N IY AH S L IY
HETEROGENEOUSNESS	HH EH T AH R AH JH IY N IY AH S N AH S
HETEROGENEOUSNESSES	HH EH T AH R AH JH IY N IY AH S N AH S IH Z
HETEROGENOUS	HH EH T AH R AA JH AH N AH S
HETEROLOGOUS	HH EH T AH R AA L AH G AH S
HETEROLOGOUSLY	HH EH T AH R AH L AA G OW AH S L IY
HETERONOMOUS	HH EH T AH R AA N AH M AH S
HETEROPHYLLOUS	HH AH T EH R AH F IH L AH S
HETEROPTEROUS	HH EH T AH R AA P T AH R AH S
HETEROSPOROUS	HH EH T ER AA S P ER AH S
HETEROZYGOUS	HH EH T ER AH Z AY G AH S
HICCOUGH	HH IH K AH P
HICCOUGHED	HH IH K AW D
HICCOUGHING	HH IH K AW AH NG
HICCOUGHS	HH IH K AH P S
HIDEBOUND	HH AY D B AW N D
HIDEOUS	HH IH D IY AH S
HIDEOUSLY	HH IH D IY AH S L IY
HIDEOUSNESS	HH IH D IY AH S N AH S
HIDEOUSNESSES	HH IH D IY AH S N AH S IH Z
HIDEOUT	HH AY D AW T
HIDEOUTS	HH AY D AW T S
HILARIOUS	HH IH L EH R IY AH S
HILARIOUSLY	HH IH L EH R IY AH S L IY
HILARIOUSNESS	HH IH L AE R IY AH S N AH S
HILARIOUSNESSES	HH IH L AE R IY AH S N AH S IH Z
HOLDOUT	HH OW L D AW T
HOLDOUTS	HH OW L D AW T S
HOLOMETABOLOUS	HH AA L AH M AH T AE B AH L AH S
HOMEBOUND	HH OW M B AW N D
HOMOGAMOUS	HH OW M OW G EY M AH S
HOMOGENEOUS	HH OW M AH JH IY N IY AH S
HOMOGENEOUSLY	HH OW M AH JH IY N IY AH S L IY
HOMOGENEOUSNESS	HH OW M AH JH IY N IY AH S N AH S
HOMOGENEOUSNESSES	HH OW M AH JH IY N IY AH S N AH S IH Z
HOMOGENOUS	HH AH M AA JH AH N AH S
HOMOIOUSIAN	HH AH M OY OW AH S IY AH N
HOMOIOUSIANS	HH AA M OY AW S IY AH N Z
HOMOLOGOUS	HH AA M AA L AH G AH S
HOMONYMOUS	HH AH M AA N AH M AH S
HOMONYMOUSLY	HH AA M AH N IH M OW AH S L IY
HOMOOUSIAN	HH AA M UW AH S IY AH N
HOMOOUSIANS	HH AA M UW UW S IY AH N Z
HOMOPHONOUS	HH OW M OW F OW N AH S
HOMOPTEROUS	HH AH M AA P T AH R AH S
HOMOSPOROUS	HH OW M OW S P AO R AH S
HOMOZYGOUS	HH OW M OW Z AY G AH S
HOMOZYGOUSLY	HH OW M OW Z AY G AH S L IY
HONOUR	AA N ER
HONOURABLE	AA N ER AH B AH L
HONOURED	AA N ER D
HONOURER	AA N ER ER
HONOURERS	AA N ER ER Z
HONOURING	AA N ER IH NG
HONOURS	AA N ER Z
HOREHOUND	HH AA R HH AW N D
HOREHOUNDS	HH AO R AH HH AW N D Z
HORNPOUT	HH AO R N P AW T
HORNPOUTS	HH AO R N P AW T S
HORRENDOUS	HH AO R EH N D AH S
HORRENDOUSLY	HH AO R EH N D AH S L IY
HOTHOUSE	HH AA T HH AW S
HOTHOUSES	HH AA T HH AW S IH Z
HOUDAH	HH AW D AH
HOUDAHS	HH AW D AH Z
HOUND	HH AW N D
HOUNDED	HH AW N D IH D
HOUNDER	HH AW N D ER
HOUNDERS	HH AW N D ER Z
HOUNDING	HH AW N D IH NG
HOUNDS	HH AW N D Z
HOUR	AW ER
HOUR(2)	AW R
HOURGLASS	AW ER G L AE S
HOURGLASSES	AW ER G L AE S IH Z
HOURI	HH AH R IY
HOURIS	AW ER IY Z
HOURLY	AW R L IY
HOURS	AW ER Z
HOURS(2)	AW R Z
HOUSE	HH AW S
HOUSEBOAT	HH AW S B OW T
HOUSEBOATER	HH AW S B OW T ER
HOUSEBOATERS	HH AW S B OW T ER Z
HOUSEBOATS	HH AW S B OW T S
HOUSEBOUND	HH AW S B AW N D
HOUSEBOY	HH AW S B OY
HOUSEBOYS	HH AW S B OY Z
HOUSEBREAK	HH AW S B R EY K
HOUSEBREAKER	HH AW S B R EY K ER
HOUSEBREAKERS	HH AW S B R EY K ER Z
HOUSEBREAKING	HH AW S B R EY K IH NG
HOUSEBREAKINGS	HH AW S B R EY K IH NG Z
HOUSEBREAKS	HH AW S B R EY K S
HOUSEBROKE	HH AW S B R OW K
HOUSEBROKEN	HH AW S B R OW K AH N
HOUSECARL	HH AW S K AA R L
HOUSECARLS	HH AW S K AA R L Z
HOUSECLEAN	HH AW S K L IY N
HOUSECLEANED	HH AW S K L IY N D
HOUSECLEANING	HH AW S K L IY N IH NG
HOUSECLEANINGS	HH AW S K L IY N IH NG Z
HOUSECLEANS	HH AW S K L IY N Z
HOUSECOAT	HH AW S K OW T
HOUSECOATS	HH AW S K OW T S
HOUSED	HH AW Z D
HOUSEDRESS	HH AW S D R EH S
HOUSEDRESSES	HH AW S D R EH S IH Z
HOUSEFATHER	HH AW S F AA DH ER
HOUSEFATHERS	HH AW S F AA DH ER Z
HOUSEFLIES	HH AW S F L AY Z
HOUSEFLY	HH AW S F L AY
HOUSEFRONT	HH AW S F R AH N T
HOUSEFRONTS	HH AW S F R AH N T S
HOUSEFUL	HH AW S F AH L
HOUSEFULS	HH AW S F AH L Z
HOUSEGUEST	HH AW S G EH S T
HOUSEGUESTS	HH AW S G EH S T S
HOUSEHOLD	HH AW S HH OW L D
HOUSEHOLDER	HH AW S HH OW L D ER
HOUSEHOLDERS	HH AW S HH OW L D ER Z
HOUSEHOLDS	HH AW S HH OW L D Z
HOUSEHUSBAND	HH AW S HH AH Z B AH N D
HOUSEHUSBANDS	HH AW S HH AH Z B AH N D Z
HOUSEKEEP	HH AW S K IY P
HOUSEKEEPER	HH AW S K IY P ER
HOUSEKEEPERS	HH AW S K IY P ER Z
HOUSEKEEPING	HH AW S K IY P IH NG
HOUSEKEEPINGS	HH AW S K IY P IH NG Z
HOUSEKEEPS	HH AW S K IY P S
HOUSEKEPT	HH AW S K EH P T
HOUSEL	HH AW S AH L
HOUSELED	HH AW S L EH D
HOUSELEEK	HH AW S AH L IY K
HOUSELEEKS	HH AW S AH L IY K S
HOUSELESS	HH AW S L AH S
HOUSELESSNESS	HH AW S L AH S N AH S
HOUSELESSNESSES	HH AW S L AH S N AH S IH Z
HOUSELIGHTS	HH AW S L AY T S
HOUSELING	HH AW S L IH NG
HOUSELLED	HH AW S AH L D
HOUSELLING	HH AW S EH L AH NG
HOUSELS	HH AW S AH L Z
HOUSEMAID	HH AW S M EY D
HOUSEMAIDS	HH AW S M EY D Z
HOUSEMAN	HH AW S M AH N
HOUSEMASTER	HH AW S M AE S T ER
HOUSEMASTERS	HH AW S M AE S T ER Z
HOUSEMATE	HH AW S M EY T
HOUSEMATES	HH AW S M EY T S
HOUSEMEN	HH AW S M EH N
HOUSEMOTHER	HH AW S M AH DH ER
HOUSEMOTHERS	HH AW S M AH DH ER Z
HOUSEPAINTER	HH AW S P EY N T ER
HOUSEPAINTERS	HH AW S P EY N T ER Z
HOUSEPARENT	HH AW S P AE R AH N T
HOUSEPARENTS	HH AW S P AE R AH N T S
HOUSEPERSON	HH AW S P ER S AH N
HOUSEPERSONS	HH AW S P ER S AH N Z
HOUSEPLANT	HH AW S P L AE N T
HOUSEPLANTS	HH AW S P L AE N T S
HOUSER	HH AW Z ER
HOUSEROOM	HH AW S R UW M
HOUSEROOMS	HH AW S R UW M Z
HOUSERS	HH AW S ER Z
HOUSES	HH AW S AH Z
HOUSES(2)	HH AW S IH Z
HOUSESAT	HH AW S AE T
HOUSESIT	HH AW S IH T
HOUSESITS	HH AW S IH T S
HOUSESITTING	HH AW S IH T IH NG
HOUSETOP	HH AW S T AA P
HOUSETOPS	HH AW S T AA P S
HOUSETRAIN	HH AW S T R EY N
HOUSETRAINED	HH AW S T R EY N D
HOUSETRAINING	HH AW S T R EY N IH NG
HOUSETRAINS	HH AW S T R EY N Z
HOUSEWARES	HH AW S W EH R Z
HOUSEWARMING	HH AW S W AA M IH NG
HOUSEWARMINGS	HH AW S W AO R M IH NG Z
HOUSEWIFE	HH AW S W AY F
HOUSEWIFELINESS	HH AW S W AY F L IY N AH S
HOUSEWIFELINESSES	HH AW S W AY F L IY N AH S IH Z
HOUSEWIFELY	HH AW S W AY F L IY
HOUSEWIFERIES	HH AW S W AY F AH R IY Z
HOUSEWIFERY	HH AW S W AY F AH R IY
HOUSEWIFEY	HH AW S W AY F IY
HOUSEWIVES	HH AW S W AY V Z
HOUSEWORK	HH AW S W ER K
HOUSEWORKS	HH AW S W ER K S
HOUSING	HH AW Z IH NG
HOUSINGS	HH AW Z IH NG Z
HUGEOUS	HH Y UW JH AH S
HUGEOUSLY	HH Y UW JH AH S L IY
HUMONGOUS	HH Y UW M AO NG G AH S
HUMOROUS	HH Y UW M ER AH S
HUMOROUSLY	HH Y UW M ER AH S L IY
HUMOROUSNESS	HH Y UW M ER AH S N AH S
HUMOROUSNESSES	HH Y UW M ER AH S N AH S IH Z
HUMOUR	HH Y UW M ER
HUMOURED	HH Y UW M ER D
HUMOURING	HH Y UW M ER IH NG
HUMOURS	HH Y UW M ER Z
HUMUNGOUS	HH Y UW M AH N G AH S
HYDROGENOUS	HH AY D R AH JH AH N AH S
HYDROUS	HH AY D R AH S
HYGROPHILOUS	HH IH G R AH F AY L AH S
HYMENOPTEROUS	HH AY M AH N AA P T ER AH S
HYPERAROUSAL	HH AY P ER AH R AW Z AH L
HYPERAROUSALS	HH AY P ER AH R AW Z AH L Z
HYPERCAUTIOUS	HH AY P ER K AO SH AH S
HYPERCONSCIOUS	HH AY P ER K AA N SH AH S
HYPERCONSCIOUSNESS	HH AY P ER K AA N SH AH S N AH S
HYPERCONSCIOUSNESSES	HH AY P ER K AA N SH AH S N AH S IH Z
HYPERFASTIDIOUS	HH AY P ER F AE S T IH D IY AH S
HYPOGEOUS	HH AH P OW JH IY AH S
HYPOGYNOUS	HH AH P AA JH AH N AH S
ICEBOUND	AY S B AW N D
ICEHOUSE	AY S HH AW S
ICEHOUSES	AY S HH AW S IH Z
ICHOROUS	IH CH AH R AH S
ICHTHYOPHAGOUS	IH CH TH AY AH F EY JH AH S
IDOLATROUS	AY D AA L AH T R AH S
IDOLATROUSLY	IH D AH L AE T R OW AH S L IY
IDOLATROUSNESS	AH D AA L AH T R AW Z N AH S
IDOLATROUSNESSES	IH D AH L AE T R AW Z N EH S AH Z
IDONEOUS	AH D OW N IY AH S
IGNEOUS	IH G N IY AH S
IGNOMINIOUS	IH G N AH M IH N IY AH S
IGNOMINIOUSLY	IH G N AH M AH N IY OW AH S L IY
IGNOMINIOUSNESS	IH G N AH M IH N IY AW Z N AH S
IGNOMINIOUSNESSES	IH G N AH M IH N IY AW Z N EH S AH Z
ILLUSTRIOUS	IH L AH S T R IY AH S
ILLUSTRIOUSLY	IH L AH S T R IY AH S L IY
ILLUSTRIOUSNESS	IH L AH S T R IY AH S N AH S
ILLUSTRIOUSNESSES	IH L AH S T R IY AH S N AH S IH Z
IMPECUNIOUS	IH M P EH K Y UW N IY AH S
IMPECUNIOUSLY	IH M P EH K Y AH N IY OW AH S L IY
IMPECUNIOUSNESS	IH M P AH K Y UW N IY AW Z N AH S
IMPECUNIOUSNESSES	IH M P AH K Y UW N IY AW Z N EH S AH Z
IMPERIOUS	IH M P IH R IY AH S
IMPERIOUSLY	IH M P IH R IY AH S L IY
IMPERIOUSNESS	IH M P IH R IY AH S N AH S
IMPERIOUSNESSES	IH M P IH R IY AH S N AH S IH Z
IMPERVIOUS	IH M P ER V IY AH S
IMPERVIOUSLY	IH M P ER V IY AH S L IY
IMPERVIOUSNESS	IH M P ER V IY AH S N AH S
IMPERVIOUSNESSES	IH M P ER V IY AH S N AH S IH Z
IMPETIGINOUS	IH M P AH T IH JH AH N AH S
IMPETUOUS	IH M P EH CH W AH S
IMPETUOUSLY	IH M P EH CH AH W AH S L IY
IMPETUOUSNESS	IH M P EH CH AH W AH S N AH S
IMPETUOUSNESSES	IH M P EH CH AH W AH S N AH S IH Z
IMPIOUS	IH M P AY AH S
IMPIOUSLY	IH M P AY AH S L IY
IMPOROUS	IH M P OW R AH S
IMPOUND	IH M P AW N D
IMPOUNDED	IH M P AW N D IH D
IMPOUNDING	IH M P AW N D IH NG
IMPOUNDMENT	IH M P AW N D M AH N T
IMPOUNDMENTS	IH M P AW N D M AH N T S
IMPOUNDS	IH M P AW N D Z
INAUSPICIOUS	IH N AW S P IH SH IH S
INAUSPICIOUSLY	IH N AO S P IH SH AH S L IY
INAUSPICIOUSNESS	IH N AO S P IH SH AH S N AH S
INAUSPICIOUSNESSES	IH N AO S P IH SH AH S N AH S IH Z
INBOUND	IH N B AW N D
INBOUNDED	IH N B AW N D IH D
INBOUNDING	IH N B AW N D IH NG
INBOUNDS	IH N B AW N D Z
INCAUTIOUS	IH N K AO SH AH S
INCAUTIOUSLY	IH N K AO SH AH S L IY
INCAUTIOUSNESS	IH N K AO SH AH S N AH S
INCAUTIOUSNESSES	IH N K AO SH AH S N AH S IH Z
INCESTUOUS	IH N S EH S CH W AH S
INCESTUOUSLY	IH N S EH S CH AH W AH S L IY
INCESTUOUSNESS	IH N S EH S CH AH W AH S N AH S
INCESTUOUSNESSES	IH N S EH S CH AH W AH S N AH S IH Z
INCOMMODIOUS	IH N K AH M OW D IY AH S
INCOMMODIOUSLY	IH N K AH M OW D IY AH S L IY
INCOMMODIOUSNESS	IH N K AH M OW D IY AH S N AH S
INCOMMODIOUSNESSES	IH N K AH M OW D IY AH S N AH S IH Z
INCONGRUOUS	IH NG K AO NG R UW AH S
INCONGRUOUSLY	IH NG K AO NG R UW AH S L IY
INCONGRUOUSNESS	IH N K AA NG G R AH W AH S N AH S
INCONGRUOUSNESSES	IH N K AA NG G R AH W AH S N AH S IH Z
INCONSPICUOUS	IH NG K AA N S P IH K W AH S
INCONSPICUOUSLY	IH N K AH N S P IH K Y AH W AH S L IY
INCONSPICUOUSNESS	IH N K AH N S P IH K Y AH W AH S N AH S
INCONSPICUOUSNESSES	IH N K AH N S P IH K Y AH W AH S N AH S IH Z
INCREDULOUS	IH N K R EH JH AH L AH S
INCREDULOUSLY	IH N K R EH JH AH L AH S L IY
INCURIOUS	IH N K Y UH R IY AH S
INCURIOUSLY	IH N K Y UH R IY AH S L IY
INCURIOUSNESS	IH N K Y UH R IY AH S N AH S
INCURIOUSNESSES	IH N K Y UH R IY AH S N AH S IH Z
INDECOROUS	IH N D EH K AH R AH S
INDECOROUSLY	IH N D EH K AH R AH S L IY
INDECOROUSNESS	IH N D EH K AH R AH S N AH S
INDECOROUSNESSES	IH N D EH K AH R AH S N AH S IH Z
INDEVOUT	IH N D IH V AW T
INDIGENOUS	IH N D IH JH AH N AH S
INDIGENOUSLY	IH N D IH JH AH N AH S L IY
INDIGENOUSNESS	IH N D IH JH AH N AH S N AH S
INDIGENOUSNESSES	IH N D IH JH AH N AH S N AH S IH Z
INDUSTRIOUS	IH N D AH S T R IY AH S
INDUSTRIOUSLY	IH N D AH S T R IY AH S L IY
INDUSTRIOUSNESS	IH N D AH S T R IY AH S N AH S
INDUSTRIOUSNESSES	IH N D AH S T R IY AH S N AH S IH Z
INEFFICACIOUS	IH N EH F AH K EY SH AH S
INEFFICACIOUSLY	IH N EH F AH K EY SH AH S L IY
INEFFICACIOUSNESS	IH N EH F AH K EY SH AH S N AH S
INEFFICACIOUSNESSES	IH N EH F AH K EY SH AH S N AH S IH Z
INFAMOUS	IH N F AH M AH S
INFAMOUSLY	IH N F AH M AH S L IY
INFECTIOUS	IH N F EH K SH AH S
INFECTIOUSLY	IH N F EH K SH AH S L IY
INFECTIOUSNESS	IH N F EH K SH AH S N AH S
INFECTIOUSNESSES	IH N F EH K SH AH S N AH S IH Z
INFELICITOUS	IH N F IH L IH S AH T AH S
INFELICITOUSLY	IH N F IH L IH S AH T AH S L IY
INFOUGHT	IH N F AO T
INGENIOUS	IH N JH IY N Y AH S
INGENIOUSLY	IH N JH IY N Y AH S L IY
INGENIOUSNESS	IH N JH IY N Y AH S N AH S
INGENIOUSNESSES	IH N JH IY N Y AH S N AH S IH Z
INGENUOUS	IH N JH EH N Y UW AH S
INGENUOUSLY	IH N JH EH N Y UW OW AH S L IY
INGENUOUSNESS	IH N JH EH N Y UW AW Z N AH S
INGENUOUSNESSES	IH N JH EH N Y UW AW Z N EH S AH Z
INGLORIOUS	IH N G L AO R IY AH S
INGLORIOUSLY	IH N G L OW R IY AH S L IY
INGLORIOUSNESS	IH N G L OW R IY AH S N AH S
INGLORIOUSNESSES	IH N G L OW R IY AH S N AH S IH Z
INGROUP	IH N G R UW P
INGROUPS	IH N G R UW P S
INHARMONIOUS	IH N HH AA R M OW N IY AH S
INHARMONIOUSLY	IH N HH AA R M OW N IY AH S L IY
INHARMONIOUSNESS	IH N HH AA R M OW N IY AH S N AH S
INHARMONIOUSNESSES	IH N HH AA R M OW N IY AH S N AH S IH Z
INHOMOGENEOUS	IH N HH OW M AH JH IY N IY AH S
INIQUITOUS	IH N IH K W AH T AH S
INIQUITOUSLY	IH N IH K W AH T AH S L IY
INIQUITOUSNESS	IH N IH K W AH T AH S N AH S
INIQUITOUSNESSES	IH N IH K W AH T AH S N AH S IH Z
INJUDICIOUS	IH N JH AH D IH SH AH S
INJUDICIOUSLY	IH N JH UH D IH SH AH S L IY
INJUDICIOUSNESS	IH N JH UH D IH SH AH S N AH S
INJUDICIOUSNESSES	IH N JH UH D IH SH AH S N AH S IH Z
INJURIOUS	IH N JH UH R IY AH S
INJURIOUSLY	IH N JH UH R IY AH S L IY
INJURIOUSNESS	IH N JH UH R IY AH S N AH S
INJURIOUSNESSES	IH N JH UH R IY AH S N AH S IH Z
INNOCUOUS	IH N AA K Y UW AH S
INNOCUOUSLY	IH N AA K Y UW OW AH S L IY
INNOCUOUSNESS	IH N AA K Y UW AW Z N AH S
INNOCUOUSNESSES	IH N AA K Y UW AW Z N EH S AH Z
INNUMEROUS	IH N UW M ER AH S
INPOUR	IH N P OW R
INPOURED	IH N P OW R D
INPOURING	IH N P OW R IH NG
INPOURINGS	IH N P OW R IH NG Z
INPOURS	IH N P OW R Z
INSALUBRIOUS	IH N S AH L UW B R IY AH S
INSECTIVOROUS	IH N S EH K T IH V ER AH S
INSIDIOUS	IH N S IH D IY AH S
INSIDIOUSLY	IH N S IH D IY AH S L IY
INSIDIOUSNESS	IH N S IH D IY AH S N AH S
INSIDIOUSNESSES	IH N S IH D IY AH S N AH S IH Z
INSOUCIANCE	IH N S UW S IY AH N S
INSOUCIANCE(2)	IH N S UW S Y AH N S
INSOUCIANCES	IH N S UW S IY AH N S IH Z
INSOUCIANT	IH N S UW S Y AH N T
INSOUCIANTLY	IH N S UW S IY AH N T L IY
INSOUL	IH N S OW L
INSOULED	IH N S OW L D
INSOULING	IH N S OW L IH NG
INSOULS	IH N S OW L Z
INSTANTANEOUS	IH N S T AH N T AE N IY AH S
INSTANTANEOUSLY	IH N S T AH N T AE N IY AH S L IY
INSTANTANEOUSNESS	IH N S T AH N T EY N IY AH S N AH S
INSTANTANEOUSNESSES	IH N S T AH N T EY N IY AH S N AH S IH Z
INSURMOUNTABLE	IH N S ER M AW N T AH B AH L
INSURMOUNTABLY	IH N S ER M AW N T AH B L IY
INTERBOROUGH	IH N T ER B ER OW
INTERBOROUGHS	IH N T ER B ER OW Z
INTERCOUNTRY	IH N T ER K AH N T R IY
INTERCOUNTY	IH N T ER K AW N T IY
INTERCOUPLE	IH N T ER K AH P AH L
INTERCOURSE	IH N T ER K AO R S
INTERCOURSE(2)	IH N ER K AO R S
INTERCOURSES	IH N T ER K OW R S IH Z
INTERGROUP	IH N T ER G R UW P
INTERMOUNTAIN	IH N T ER M AW N T IH N
INTERRELIGIOUS	IH N T ER R IH L IH JH AH S
INTERWROUGHT	IH N T ER R AO T
INTRACUTANEOUS	IH N T R AH K Y AH T EY N IY AH S
INTRACUTANEOUSLY	IH N T R AH K Y AH T AH N IY OW AH S L IY
INTRAVENOUS	IH N T R AH V IY N AH S
INTRAVENOUSES	IH N T R AH V AH N AW Z AH Z
INTRAVENOUSLY	IH N T R AE V AH N AH S L IY
INTRAVENOUSLY(2)	IH N T R AH V IY N AH S L IY
INVIDIOUS	IH N V IH D IY AH S
INVIDIOUSLY	IH N V AH D IY OW AH S L IY
INVIDIOUSNESS	IH N V IH D IY AW Z N AH S
INVIDIOUSNESSES	IH N V IH D IY AW Z N EH S AH Z
INWOUND	IH N W UW N D
IODOUS	AY AH D AH S
IRONBOUND	AY ER N B AW N D
IRRELIGIOUS	IH R IH L IH JH AH S
IRRELIGIOUSLY	IH R IH L IH JH AH S L IY
ISOCHRONOUS	AH S AA K R AH N AH S
ISOCHRONOUSLY	AH S AA K R AA N OW AH S L IY
ISOGAMOUS	AH S AA G AH M AH S
ISOMORPHOUS	IH S AH M AO R F AH S
JAILHOUSE	JH EY L HH AW S
JAILHOUSES	JH EY L HH AW S IH Z
JALOUSIE	JH AH L AW S AY
JALOUSIES	JH AE L AW S AY Z
JEALOUS	JH EH L AH S
JEALOUSIES	JH EH L AH S IY Z
JEALOUSLY	JH EH L AH S L IY
JEALOUSNESS	JH EH L AH S N IH S
JEALOUSNESSES	JH EH L AH S N AH S IH Z
JEALOUSY	JH EH L AH S IY
JOUAL	JH OW Y AH W AH
JOUALS	JH AW AH L Z
JOUK	JH AW K
JOUKED	JH AW K T
JOUKING	JH AW K AH NG
JOUKS	JH AW K S
JOULE	JH UW L
JOULES	JH UW L Z
JOUNCE	JH AW N S
JOUNCED	JH AW N S T
JOUNCES	JH AW N S AH Z
JOUNCIER	JH AW N S AY AH R
JOUNCIEST	JH AW N S AY AH S T
JOUNCING	JH AW N S AH NG
JOUNCY	JH AW N S IY
JOURNAL	JH ER N AH L
JOURNALESE	JH ER N AH L IY Z
JOURNALESES	JH ER N AH L IY Z IH Z
JOURNALISM	JH ER N AH L IH Z AH M
JOURNALISMS	JH ER N AH L IH Z AH M Z
JOURNALIST	JH ER N AH L AH S T
JOURNALIST(2)	JH ER N AH L IH S T
JOURNALISTIC	JH ER N AH L IH S T IH K
JOURNALISTICALLY	JH ER N AH L IH S T IH K AH L IY
JOURNALISTICALLY(2)	JH ER N AH L IH S T IH K L IY
JOURNALISTS	JH ER N AH L AH S T S
JOURNALISTS(2)	JH ER N AH L IH S T S
JOURNALIZE	JH ER N AH L AY Z
JOURNALIZED	JH ER N AH L AY Z D
JOURNALIZER	JH ER N AH L AY Z ER
JOURNALIZERS	JH ER N AH L AY Z ER Z
JOURNALIZES	JH ER N AH L AY Z IH Z
JOURNALIZING	JH ER N AH L AY Z IH NG
JOURNALS	JH ER N AH L Z
JOURNEY	JH ER N IY
JOURNEYED	JH ER N IY D
JOURNEYER	JH ER N IY ER
JOURNEYERS	JH ER N IY ER Z
JOURNEYING	JH ER N IY IH NG
JOURNEYMAN	JH ER N IY M AE N
JOURNEYMEN	JH ER N IY M EH N
JOURNEYS	JH ER N IY Z
JOURNEYWORK	JH ER N IY W ER K
JOURNEYWORKS	JH ER N IY W ER K S
JOUST	JH AW S T
JOUSTED	JH AW S T IH D
JOUSTER	JH AW S T ER
JOUSTERS	JH AW S T ER Z
JOUSTING	JH AW S T IH NG
JOUSTS	JH AW S T S
JOYOUS	JH OY AH S
JOYOUSLY	JH OY AH S L IY
JOYOUSNESS	JH OY AH S N AH S
JOYOUSNESSES	JH OY AH S N AH S IH Z
JUDICIOUS	JH UW D IH SH AH S
JUDICIOUSLY	JH UW D IH SH IH S L IY
JUDICIOUSNESS	JH UH D IH SH AH S N AH S
JUDICIOUSNESSES	JH UH D IH SH AH S N AH S IH Z
KABELJOU	K AH B EH L JH UW
KABELJOUS	K AH B EH L JH AH S
KERATINOUS	K AH R AE T AH N AH S
KHOUM	K HH AW M
KHOUMS	K HH AW M Z
KILOJOULE	K AH L AA JH OW UW L
KILOJOULES	K AH L AA JH OW AH L Z
KINKAJOU	K IH NG K AH JH UW
KINKAJOUS	K IH NG K AH JH AH S
KNOCKABOUT	N AA K AH B AW T
KNOCKABOUTS	N AA K AH B AW T S
KNOCKOUT	N AA K AW T
KNOCKOUTS	N AA K AW T S
KNOUT	N AW T
KNOUTED	N OW Y UW T AH D
KNOUTING	N OW Y UW T AH NG
KNOUTS	N OW Y UW T S
KOUMIS	K AW M AH S
KOUMISES	K AW M AY Z AH Z
KOUMISS	K AW M AH S
KOUMISSES	K AW M IH S AH Z
KOUMYS	K AW M AH Z
KOUMYSES	K AW M AY Z AH Z
KOUMYSS	K AW M AH S
KOUMYSSES	K AW M IH S AH Z
KOUPREY	K UW P R IY
KOUPREYS	K UW P R EY Z
KOUROI	K AH R OY
KOUROS	K AH R AH Z
KOUSSO	K AW S OW
KOUSSOS	K AW S AH Z
LABORIOUS	L AH B AO R IY AH S
LABORIOUSLY	L AH B AO R IY AH S L IY
LABORIOUSNESS	L AH B OW R IY AH S N AH S
LABORIOUSNESSES	L AH B OW R IY AH S N AH S IH Z
LABOUR	L EY B ER
LABOURED	L EY B ER D
LABOURER	L EY B ER ER
LABOURERS	L EY B ER ER Z
LABOURING	L EY B ER IH NG
LABOURS	L EY B ER Z
LACTEOUS	L AE K T IY AH S
LACTIFEROUS	L AE K T IH F AH R AH S
LAMINOUS	L AE M AH N AH S
LANGOUSTE	L AE N G AW S T
LANGOUSTES	L AE N G AW S T S
LANGOUSTINE	L AE N G AW S T AY N
LANGOUSTINES	L AE N G AW S T AY N Z
LANGUOROUS	L AE N G W AH R AH S
LANGUOROUSLY	L AE N G W AO R OW AH S L IY
LANUGINOUS	L AE N Y UW JH AH N AH S
LARCENOUS	L AA R S AH N AH S
LARCENOUSLY	L AA R S EH N OW AH S L IY
LARGEMOUTH	L AA R JH M AW TH
LARGEMOUTHS	L AA R JH M AW TH S
LASCIVIOUS	L AH S IH V IY AH S
LASCIVIOUSLY	L AH S IH V IY AH S L IY
LASCIVIOUSNESS	L AH S IH V IY AH S N AH S
LASCIVIOUSNESSES	L AH S IH V IY AH S N AH S IH Z
LAYABOUT	L EY AH B AW T
LAYABOUTS	L EY AH B AW T S
LAYOUT	L EY AW T
LAYOUTS	L EY AW T S
LECHEROUS	L EH CH ER AH S
LECHEROUSLY	L EH CH ER AH S L IY
LECHEROUSNESS	L EH CH ER AH S N AH S
LECHEROUSNESSES	L EH CH ER AH S N AH S IH Z
LEGUMINOUS	L IH G Y UW M AH N AH S
LEPIDOPTEROUS	L EH P AH D AA P T AH R AH S
LEPROMATOUS	L EH P R AA M AH T AH S
LEPROUS	L EH P R AH S
LEPROUSLY	L EH P R OW AH S L IY
LIBELLOUS	L AY B AH L AH S
LIBELOUS	L AY B EH L AH S
LIBIDINOUS	L AH B IH D AH N AH S
LIBIDINOUSLY	L IH B AH D IH N OW AH S L IY
LIBIDINOUSNESS	L AH B IH D AH N AW Z N AH S
LIBIDINOUSNESSES	L AH B IH D AH N AW Z N EH S AH Z
LICENTIOUS	L AY S EH N CH AH S
LICENTIOUSLY	L AY S AH N T IY AH S L IY
LICENTIOUSNESS	L AY S AH N T IY AH S N AH S
LICENTIOUSNESSES	L AY S AH N T IY AH S N AH S IH Z
LICHENOUS	L IH CH AH N AH S
LIGAMENTOUS	L IH G AH M AH N T AH S
LIGHTHOUSE	L AY T HH AW S
LIGHTHOUSES	L AY T HH AW S IH Z
LIGHTHOUSES(2)	L AY T HH AW Z AH Z
LIGNEOUS	L IH G N IY AH S
LIMOUSINE	L IH M AH Z IY N
LIMOUSINES	L IH M AH Z IY N Z
LIPOMATOUS	L AH P AA M AH T AH S
LITIGIOUS	L IH T IH JH AH S
LITIGIOUSLY	L IH T IH G IY AH S L IY
LITIGIOUSNESS	L IH T IH G IY AH S N AH S
LITIGIOUSNESSES	L IH T IH G IY AH S N AH S IH Z
LOBSCOUSE	L AA B S K AW S
LOBSCOUSES	L AA B S K AW S IH Z
LOCKOUT	L AA K AW T
LOCKOUTS	L AA K AW T S
LONGEVOUS	L AO NG IY V AH S
LONGHOUSE	L AO NG HH AW S
LONGHOUSES	L AO NG HH AW S IH Z
LOOKOUT	L UH K AW T
LOOKOUTS	L UH K AW T S
LOQUACIOUS	L OW K W EY SH AH S
LOQUACIOUSLY	L OW K W EY SH AH S L IY
LOQUACIOUSNESS	L OW K W EY SH AH S N AH S
LOQUACIOUSNESSES	L OW K W EY SH AH S N AH S IH Z
LOUCHE	L AW CH
LOUD	L AW D
LOUDEN	L AW D AH N
LOUDENED	L AW D AH N D
LOUDENING	L AW D AH N IH NG
LOUDENS	L AW D AH N Z
LOUDER	L AW D ER
LOUDEST	L AW D AH S T
LOUDISH	L AW D IH SH
LOUDLIER	L AW D L IY ER
LOUDLIEST	L AW D L IY AH S T
LOUDLY	L AW D L IY
LOUDMOUTH	L AW D M AW TH
LOUDMOUTHED	L AW D M AW TH T
LOUDMOUTHS	L AW D M AW TH S
LOUDNESS	L AW D N AH S
LOUDNESSES	L AW D N AH S IH Z
LOUDSPEAKER	L AW D S P IY K ER
LOUDSPEAKERS	L AW D S P IY K ER Z
LOUGH	L AW
LOUGHS	L AW Z
LOUIE	L UW IY
LOUIES	L AW AY Z
LOUIS	L UW IH S
LOUIS(2)	L UW IY
LOUNGE	L AW N JH
LOUNGED	L AW N JH D
LOUNGER	L AW N JH ER
LOUNGERS	L AW N JH ER Z
LOUNGES	L AW N JH IH Z
LOUNGEWEAR	L AW N JH W AE ER
LOUNGING	L AW N JH IH NG
LOUNGY	L AW N JH IY
LOUP	L UW P
LOUPE	L UW P
LOUPED	L UW P T
LOUPEN	L UW P AH N
LOUPES	L UW P S
LOUPING	L UW P AH NG
LOUPS	L UW P S
LOUR	L AW R
LOURED	L OW Y AH R D
LOURING	L OW Y AH R AH NG
LOURS	L OW Y AH R Z
LOURY	L UW R IY
LOUSE	L AW S
LOUSED	L AW Z D
LOUSES	L AW S IH Z
LOUSEWORT	L AW S UW AH R T
LOUSEWORTS	L AW S UW AH R T S
LOUSIER	L AW Z IY ER
LOUSIEST	L AW Z IY AH S T
LOUSILY	L AW Z IY L IY
LOUSINESS	L AW Z IY N AH S
LOUSINESSES	L AW Z IY N AH S IH Z
LOUSING	L AW S IH NG
LOUSY	L AW Z IY
LOUT	L AW T
LOUTED	L OW Y UW T AH D
LOUTING	L OW Y UW T AH NG
LOUTISH	L OW Y UW T AH SH
LOUTISHLY	L AW T IH SH L IY
LOUTISHNESS	L AW T IH SH N AH S
LOUTISHNESSES	L AW T IH SH N EH S AH Z
LOUTS	L AW T S
LOUVER	L UW V ER
LOUVERED	L UW V ER D
LOUVERS	L UW V ER Z
LOUVRE	L UW V R AH
LOUVRED	L UW V ER D
LOUVRES	L UW V ER Z
LUBRICIOUS	L UW B R AH K IY AH S
LUBRICIOUSLY	L UW B R AH K IY AH S L IY
LUBRICOUS	L UW B R AH K AH S
LUCIFEROUS	L UW S AH F ER AH S
LUDICROUS	L UW D AH K R AH S
LUDICROUSLY	L UW D AH K R AH S L IY
LUDICROUSNESS	L UW D AH K R AH S N AH S
LUDICROUSNESSES	L UW D AH K R AH S N AH S IH Z
LUGUBRIOUS	L UW G Y UW B R IY AH S
LUGUBRIOUSLY	L UW G AH B R IY OW AH S L IY
LUGUBRIOUSNESS	L UW G AH B R IY AW Z N AH S
LUGUBRIOUSNESSES	L UW G AH B R IY AW Z N EH S AH Z
LUMINIFEROUS	L UW M AH N IH F AH R AH S
LUMINOUS	L UW M AH N AH S
LUMINOUSLY	L UW M AH N AH S L IY
LUMINOUSNESS	L UW M AH N AH S N AH S
LUMINOUSNESSES	L UW M AH N AH S N AH S IH Z
LUPOUS	L UW P AH S
LUSCIOUS	L AH SH IH S
LUSCIOUSLY	L AH SH AH S L IY
LUSCIOUSNESS	L AH SH AH S N AH S
LUSCIOUSNESSES	L AH SH AH S N AH S IH Z
LUSTROUS	L AH S T R AH S
LUSTROUSLY	L AH S T ER AH S L IY
LUSTROUSNESS	L AH S T ER AH S N AH S
LUSTROUSNESSES	L AH S T ER AH S N AH S IH Z
LUTEOUS	L UW T AH S
LUXURIOUS	L AH G ZH ER IY AH S
LUXURIOUSLY	L AH G ZH UH R IY AH S L IY
LUXURIOUSNESS	L AH G ZH UH R IY AH S N AH S
LUXURIOUSNESSES	L AH G ZH UH R IY AH S N AH S IH Z
LYMPHOMATOUS	L IH M F AA M AH T AH S
MACROPTEROUS	M AE K R AA P T AH R AH S
MADHOUSE	M AE D HH AW S
MADHOUSES	M AE D HH AW S IH Z
MAGNANIMOUS	M AE G N AE N AH M AH S
MAGNANIMOUSLY	M AE G N AH N IH M OW AH S L IY
MAGNANIMOUSNESS	M AE G N AE N AH M AW Z N AH S
MAGNANIMOUSNESSES	M AE G N AE N AH M AW Z N EH S AH Z
MAHOUT	M AH HH AW T
MAHOUTS	M AE HH AH Y UW T S
MALARIOUS	M EY L EH R IY AH S
MALICIOUS	M AH L IH SH AH S
MALICIOUSLY	M AH L IH SH IH S L IY
MALICIOUSNESS	M AH L IH SH AH S N AH S
MALICIOUSNESSES	M AH L IH SH AH S N AH S IH Z
MALNOURISHED	M AE L N ER IH SH T
MALODOROUS	M AE L OW D ER AH S
MALODOROUSLY	M AE L OW D ER AH S L IY
MALODOROUSNESS	M AE L OW D ER AH S N AH S
MALODOROUSNESSES	M AE L OW D ER AH S N AH S IH Z
MANGANOUS	M AE N G AH N AH S
MANITOU	M AE N AH T UW
MANITOUS	M AE N AH T AH S
MARABOU	M EH R AH B UW
MARABOUS	M AA R AH B IY AH S
MARABOUT	M AA R AH B AW T
MARABOUTS	M AA R AH B AW T S
MARVELLOUS	M AA R V AH L AH S
MARVELOUS	M AA R V AH L AH S
MARVELOUSLY	M AA R V AH L AH S L IY
MARVELOUSNESS	M AA R V AH L AH S N AH S
MARVELOUSNESSES	M AA R V AH L AH S N AH S IH Z
MAVOURNEEN	M AH V OW R N IY AH N
MAVOURNEENS	M AE V AH R N IY N Z
MAZOURKA	M AH Z AH R K AH
MAZOURKAS	M AH Z AH R K AH Z
MEALYMOUTHED	M IY L IY M AW TH T
MEANDROUS	M IY N D R AH S
MEDICAMENTOUS	M EH D IH K AH M EH N T AH S
MEETINGHOUSE	M IY T IH NG HH AW S
MEETINGHOUSES	M IY T IH NG HH AW S IH Z
MELANOUS	M EH L AH N AH S
MELLIFLUOUS	M EH L IH F L Y AH W AH S
MELLIFLUOUSLY	M EH L AH F L UW W OW AH S L IY
MELLIFLUOUSNESS	M EH L IH F L AH W AW Z N AH S
MELLIFLUOUSNESSES	M EH L IH F L AH W AW Z N EH S AH Z
MELODIOUS	M AH L OW D IY AH S
MELODIOUSLY	M AH L OW D IY AH S L IY
MELODIOUSNESS	M AH L OW D IY AH S N AH S
MELODIOUSNESSES	M AH L OW D IY AH S N AH S IH Z
MEMBRANOUS	M EH M B R AH N AH S
MEMBRANOUSLY	M EH M B R EY N AH S L IY
MENDACIOUS	M EH N D EY SH AH S
MENDACIOUSLY	M EH N D EY SH AH S L IY
MENDACIOUSNESS	M EH N D EY SH AH S N AH S
MENDACIOUSNESSES	M EH N D EY SH AH S N AH S IH Z
MEOU	M IY UW
MEOUED	M IY AW D
MEOUING	M IY AW AH NG
MEOUS	M IY AH S
MERCUROUS	M AH R K Y AH R AH S
MERETRICIOUS	M EH R AH T R IH SH AH S
MERETRICIOUSLY	M EH R AH T R IH SH AH S L IY
MERETRICIOUSNESS	M EH R AH T R IH SH AH S N AH S
MERETRICIOUSNESSES	M EH R AH T R IH SH AH S N AH S IH Z
MERITORIOUS	M EH R AH T AO R IY AH S
MERITORIOUSLY	M EH R AH T OW R IY AH S L IY
MERITORIOUSNESS	M EH R AH T OW R IY AH S N AH S
MERITORIOUSNESSES	M EH R AH T OW R IY AH S N AH S IH Z
MERRYTHOUGHT	M EH R IY TH AO T
MERRYTHOUGHTS	M EH R IY TH AO T S
MESOPHYLLOUS	M EH S AH F IH L AH S
METALLIFEROUS	M EH T AH L AY F ER AH S
METHOUGHT	M EH TH AO T
METICULOUS	M AH T IH K Y AH L AH S
METICULOUSLY	M AH T IH K Y AH L AH S L IY
METICULOUSNESS	M AH T IH K Y AH L AH S N AH S
METICULOUSNESSES	M AH T IH K Y AH L AH S N AH S IH Z
MIAOU	M AY AH UW
MIAOUED	M AY AH AW D
MIAOUING	M AY AE AW AH NG
MIAOUS	M AY AH AH S
MICACEOUS	M AH K AH S IY AH S
MICROLEPIDOPTEROUS	M AY K R AH L EH P AH D AA P T AH R AH S
MICROPHYLLOUS	M AY K R AH F IH L AH S
MICROPOROUS	M AY K R OW P OW R AH S
MICROSPOROUS	M AY K R OW S P OW R AH S
MICROVILLOUS	M AY K R OW V IH L AH S
MIDCOURSE	M IH D K AO R S
MIGRAINOUS	M IH G R EY N AH S
MINICOURSE	M IH N IY K OW R S
MINICOURSES	M IH N IY K OW R S IH Z
MIRACULOUS	M ER AE K Y AH L AH S
MIRACULOUSLY	M ER AE K Y AH L AH S L IY
MIRACULOUSNESS	M AH R AE K Y AH L AH S N AH S
MIRACULOUSNESSES	M AH R AE K Y AH L AH S N AH S IH Z
MISBOUND	M IH S B AW N D
MISCELLANEOUS	M IH S AH L EY N IY AH S
MISCELLANEOUSLY	M IH S AH L EY N IY AH S L IY
MISCELLANEOUSNESS	M IH S AH L EY N IY AH S N AH S
MISCELLANEOUSNESSES	M IH S AH L EY N IY AH S N AH S IH Z
MISCHIEVOUS	M IH S CH AH V AH S
MISCHIEVOUSLY	M IH S CH AH V AH S L IY
MISCHIEVOUSNESS	M IH S CH AH V AH S N AH S
MISCHIEVOUSNESSES	M IH S CH AH V AH S N AH S IH Z
MISCOUNT	M IH S K AW N T
MISCOUNTED	M IH S K AW N T IH D
MISCOUNTING	M IH S K AW N T IH NG
MISCOUNTS	M IH S K AW N T S
MISDOUBT	M IH S D AW T
MISDOUBTED	M IH S D AW T IH D
MISDOUBTING	M IH S D AW T IH NG
MISDOUBTS	M IH S D AW T S
MISPRONOUNCE	M IH S P R AH N AW N S
MISPRONOUNCED	M IH S P R AH N AW N S T
MISPRONOUNCES	M IH S P R AH N AW N S IH Z
MISPRONOUNCING	M IH S P R AH N AW N S IH NG
MISROUTE	M IH S R UW T
MISROUTED	M IH S R UW T IH D
MISROUTES	M IH S R UW T S
MISROUTING	M IH S R UW T IH NG
MISSOUND	M IH S AW N D
MISSOUNDED	M IH S AW N D IH D
MISSOUNDING	M IH S AW N D IH NG
MISSOUNDS	M IH S AW N D Z
MISSOUT	M IH S AW T
MISSOUTS	M IH S AW T S
MISTHOUGHT	M IH S TH AO T
MISTOUCH	M IH S T AH CH
MISTOUCHED	M IH S T AH CH T
MISTOUCHES	M IH S T AH CH IH Z
MISTOUCHING	M IH S T AH CH IH NG
MOMENTOUS	M OW M EH N T AH S
MOMENTOUSLY	M OW M EH N T AH S L IY
MOMENTOUSNESS	M OW M EH N T AH S N AH S
MOMENTOUSNESSES	M OW M EH N T AH S N AH S IH Z
MONADELPHOUS	M AA N AH D EH L F AH S
MONECIOUS	M AH N IY SH AH S
MONESTROUS	M AH N EH S T R AH S
MONOCOTYLEDONOUS	M AA N OW K AA T IY L EH D AO N AH S
MONOECIOUS	M AH N OW AH SH AH S
MONOGAMOUS	M AH N AA G AH M AH S
MONOGAMOUSLY	M AH N AA G AH M AH S L IY
MONOGYNOUS	M AH N AA JH AH N AH S
MONOPHAGOUS	M AA N AH F EY JH AH S
MONOTONOUS	M AH N AA T AH N AH S
MONOTONOUSLY	M AH N AA T AH N AH S L IY
MONOTONOUSNESS	M AH N AA T AH N AH S N AH S
MONOTONOUSNESSES	M AH N AA T AH N AH S N AH S IH Z
MONOUNSATURATE	M AA N OW AH N S AE CH ER AH T
MONOUNSATURATED	M AA N OW AH N S AE CH ER EY T IH D
MONOUNSATURATES	M AA N OW AH N S AE CH ER AH T S
MONSTROUS	M AA N S T R AH S
MONSTROUSLY	M AA N S T R AH S L IY
MONSTROUSNESS	M AA N S T R AH S N AH S
MONSTROUSNESSES	M AA N S T R AH S N AH S IH Z
MOTHERHOUSE	M AH DH ER HH AW S
MOTHERHOUSES	M AH DH ER HH AW S IH Z
MOTORMOUTH	M OW T ER M AW TH
MOTORMOUTHS	M OW T ER M AW TH S
MOUCH	M AW CH
MOUCHED	M AW CH T
MOUCHES	M AW CH AH Z
MOUCHING	M AW CH AH NG
MOUCHOIR	M AW CH OY R
MOUCHOIRS	M AW CH OY R Z
MOUE	M AW
MOUES	M AW Z
MOUFFLON	M AW F L AH N
MOUFFLONS	M AW F L AH N Z
MOUFLON	M AW F L AH N
MOUFLONS	M AW F L AH N Z
MOUILLE	M AW AH L
MOUJIK	M AW JH AH K
MOUJIKS	M AW JH AH K S
MOULAGE	M OW AH L AH JH
MOULAGES	M OW UH L AH JH AH Z
MOULD	M OW L D
MOULDED	M OW L D IH D
MOULDER	M OW L D ER
MOULDERED	M OW L D ER D
MOULDERING	M OW L D ER IH NG
MOULDERS	M OW L D ER Z
MOULDIER	M OW L D IY ER
MOULDIEST	M OW L D IY AH S T
MOULDING	M OW L D IH NG
MOULDINGS	M OW L D IH NG Z
MOULDS	M OW L D Z
MOULDY	M OW L D IY
MOULIN	M UW L AE N
MOULINS	M AW L AH N Z
MOULT	M OW L T
MOULTED	M OW L T AH D
MOULTER	M OW L T AH R
MOULTERS	M OW L T AH R Z
MOULTING	M OW L T AH NG
MOULTS	M OW L T S
MOUND	M AW N D
MOUNDED	M AW N D IH D
MOUNDING	M AW N D IH NG
MOUNDS	M AW N D Z
MOUNT	M AW N T
MOUNTABLE	M AW N T AH B AH L
MOUNTAIN	M AW N T AH N
MOUNTAINEER	M AW N T IH N IH R
MOUNTAINEERING	M AW N T IH N IH R IH NG
MOUNTAINEERINGS	M AW N T AH N IH R IH NG Z
MOUNTAINEERS	M AW N T IH N IH R Z
MOUNTAINOUS	M AW N T AH N AH S
MOUNTAINOUSLY	M AW N T AH N AH S L IY
MOUNTAINOUSNESS	M AW N T AH N AH S N AH S
MOUNTAINOUSNESSES	M AW N T AH N AH S N AH S IH Z
MOUNTAINS	M AW N T AH N Z
MOUNTAINSIDE	M AW N T AH N S AY D
MOUNTAINSIDES	M AW N T AH N S AY D Z
MOUNTAINTOP	M AW N T AH N T AA P
MOUNTAINTOPS	M AW N T AH N T AA P S
MOUNTAINY	M AW N T AH N IY
MOUNTEBANK	M AW N T AH B AH NG K
MOUNTEBANKED	M AW N T AH B AH NG K T
MOUNTEBANKERIES	M AW N T AH B AE NG K AH R AY Z
MOUNTEBANKERY	M AW N T AH B AH NG K EH R IY
MOUNTEBANKING	M AW N T AH B AE NG K AH NG
MOUNTEBANKS	M AW N T AH B AH NG K S
MOUNTED	M AW N T AH D
MOUNTED(2)	M AW N T IH D
MOUNTED(3)	M AW N IH D
MOUNTER	M AW N T ER
MOUNTERS	M AW N T ER Z
MOUNTING	M AW N T IH NG
MOUNTINGS	M AW N T IH NG Z
MOUNTS	M AW N T S
MOURN	M AO R N
MOURNED	M AO R N D
MOURNER	M AO R N ER
MOURNERS	M AO R N ER Z
MOURNFUL	M AO R N F AH L
MOURNFULLER	M OW R N F AH L ER
MOURNFULLEST	M OW R N F AH L AH S T
MOURNFULLY	M OW R N F AH L IY
MOURNFULNESS	M OW R N F AH L N AH S
MOURNFULNESSES	M OW R N F AH L N AH S IH Z
MOURNING	M AO R N IH NG
MOURNINGLY	M OW R N IH NG L IY
MOURNINGS	M OW R N IH NG Z
MOURNS	M AO R N Z
MOUSE	M AW S
MOUSED	M AW S T
MOUSER	M AW Z ER
MOUSERS	M AW Z ER Z
MOUSES	M AW S IH Z
MOUSETRAP	M AW S T R AE P
MOUSETRAPPED	M AW S T R AE P T
MOUSETRAPPING	M AW S T R AE P IH NG
MOUSETRAPS	M AW S T R AE P S
MOUSEY	M AW S IY
MOUSIER	M AW S IY ER
MOUSIEST	M AW S IY AH S T
MOUSILY	M AW S IY L IY
MOUSINESS	M AW S IY N AH S
MOUSINESSES	M AW S IY N AH S IH Z
MOUSING	M AW S IH NG
MOUSINGS	M AW S IH NG Z
MOUSSAKA	M AW S AH K AH
MOUSSAKAS	M AW S AH K AH Z
MOUSSE	M UW S
MOUSSED	M AW S T
MOUSSELINE	M AW S AH L AY N
MOUSSELINES	M AW S AH L AY N Z
MOUSSES	M AW S AH Z
MOUSSING	M AW S AH NG
MOUSTACHE	M AH S T AE SH
MOUSTACHES	M AH S T AE SH IH Z
MOUSTACHIO	M AW S T AE CH IY OW
MOUSTACHIOS	M AW S T AE CH IY AH Z
MOUSY	M AW S IY
MOUTH	M AW TH
MOUTHBREEDER	M AW TH B R IY D ER
MOUTHBREEDERS	M AW TH B R IY D ER Z
MOUTHED	M AW DH D
MOUTHER	M AW TH ER
MOUTHERS	M AW TH ER Z
MOUTHFUL	M AW TH F UH L
MOUTHFULS	M AW TH F UH L Z
MOUTHIER	M AW TH IY ER
MOUTHIEST	M AW TH IY AH S T
MOUTHILY	M AW TH IY L IY
MOUTHING	M AW DH IH NG
MOUTHLIKE	M AW TH L AY K
MOUTHPART	M AW TH P AA R T
MOUTHPARTS	M AW TH P AA R T S
MOUTHPIECE	M AW TH P IY S
MOUTHPIECES	M AW TH P IY S IH Z
MOUTHS	M AW DH Z
MOUTHWASH	M AW TH W AA SH
MOUTHWASHES	M AW TH W AA SH IH Z
MOUTHWATERING	M AW TH W AO T ER IH NG
MOUTHWATERINGLY	M AW TH W AO T ER IH NG L IY
MOUTHY	M AW TH IY
MOUTON	M UW T AO N
MOUTONS	M AW T AH N Z
MUCILAGINOUS	M Y UW S AH L AE JH AH N AH S
MUCILAGINOUSLY	M Y UW S AH L AH JH IH N OW AH S L IY
MUCINOUS	M Y UW S AH N AH S
MUCOCUTANEOUS	M Y UW K AA K Y AH T EY N IY AH S
MUCOUS	M Y UW K AH S
MULTICOUNTY	M AH L T AY K AW N T IY
MULTICOURSE	M AH L T AY K OW R S
MULTICOURSES	M AH L T AY K OW R S IH Z
MULTIFARIOUS	M AH L T AY F EH R IY AH S
MULTIFARIOUSNESS	M AH L T AY F EH R IY AH S N AH S
MULTIFARIOUSNESSES	M AH L T AY F EH R IY AH S N AH S IH Z
MULTIGROUP	M AH L T AY G R UW P
MULTIPAROUS	M AH L T AY P EH R AH S
MULTIRELIGIOUS	M AH L T AY R IH L IH JH AH S
MULTISOURCE	M AH L T AY S OW R S
MULTITUDINOUS	M AH L T AH T UW D AH N AH S
MULTITUDINOUSLY	M AH L T AH T UW D AH N AH S L IY
MULTITUDINOUSNESS	M AH L T AH T UW D AH N AH S N AH S
MULTITUDINOUSNESSES	M AH L T AH T UW D AH N AH S N AH S IH Z
MURDEROUS	M ER D ER AH S
MURDEROUSLY	M ER D ER AH S L IY
MURDEROUSNESS	M ER D ER AH S N AH S
MURDEROUSNESSES	M ER D ER AH S N AH S IH Z
MURMUROUS	M ER M ER AH S
MURMUROUSLY	M ER M ER AH S L IY
MUSCLEBOUND	M AH S AH L B AW N D
MUTICOUS	M Y UW T IH K AH S
MUTINOUS	M Y UW T AH N AH S
MUTINOUSLY	M Y UW T AH N AH S L IY
MUTINOUSNESS	M Y UW T AH N AH S N AH S
MUTINOUSNESSES	M Y UW T AH N AH S N AH S IH Z
MYCETOMATOUS	M IH S AH T AA M AH T AH S
MYCETOPHAGOUS	M AH S EH T AH F EY JH AH S
MYCOPHAGOUS	M IH K AH F EY JH AH S
MYELOGENOUS	M AY AH L AA JH AH N AH S
MYELOMATOUS	M AY AH L AA M AH T AH S
MYOMATOUS	M AY AA M AH T AH S
MYRMECOPHILOUS	M AH R M EH K AH F AY L AH S
MYSTERIOUS	M IH S T IH R IY AH S
MYSTERIOUSLY	M IH S T IH R IY AH S L IY
MYSTERIOUSLY(2)	M IH S T IH R Y AH S L IY
MYSTERIOUSNESS	M IH S T IH R IY AH S N AH S
MYSTERIOUSNESSES	M IH S T IH R IY AH S N AH S IH Z
MYXEDEMATOUS	M IH K S AH D EH M AH T AH S
MYXOMATOUS	M IH K S AA M AH T AH S
NACREOUS	N AE K R IY AH S
NAUSEOUS	N AO SH AH S
NAUSEOUSLY	N AH S IY OW AH S L IY
NAUSEOUSNESS	N AO S IY AW Z N AH S
NAUSEOUSNESSES	N AO S IY AW Z N EH S AH Z
NEBULOUS	N EH B Y AH L AH S
NEBULOUSLY	N EH B Y AH L AH S L IY
NEBULOUSNESS	N EH B Y AH L AH S N AH S
NEBULOUSNESSES	N EH B Y AH L AH S N AH S IH Z
NECESSITOUS	N IH S EH S AH T AH S
NECESSITOUSLY	N IH S EH S AH T AH S L IY
NECESSITOUSNESS	N IH S EH S AH T AH S N AH S
NECESSITOUSNESSES	N IH S EH S AH T AH S N AH S IH Z
NECROPHAGOUS	N EH K R AH F EY JH AH S
NECTAROUS	N EH K T ER AH S
NEFARIOUS	N AH F EH R IY AH S
NEFARIOUSLY	N EH F AH R IY OW AH S L IY
NEIGHBOUR	N EY B ER
NEIGHBOURED	N EY B ER D
NEIGHBOURING	N EY B ER IH NG
NEIGHBOURS	N EY B ER Z
NERVOUS	N ER V AH S
NERVOUSLY	N ER V AH S L IY
NERVOUSNESS	N ER V AH S N AH S
NERVOUSNESSES	N ER V AH S N AH S IH Z
NEUROPTEROUS	N Y AH R AA P T AH R AH S
NEWFOUND	N UW F AW N D
NEWSGROUP	N UW Z G R UW P
NEWSGROUPS	N UW Z G R UW P S
NEWSHOUND	N UW Z HH AW N D
NEWSHOUNDS	N UW Z HH AW N D Z
NICKELIFEROUS	N IH K AH L IH F AH R AH S
NIDICOLOUS	N AH D IH K AH L AH S
NIDIFUGOUS	N IH D AH F Y UW G AH S
NIMIOUS	N IH M IY AH S
NIOBOUS	N AY AH B AH S
NITROGENOUS	N AY T R AA JH AH N AH S
NITROUS	N IH T R AH S
NIVEOUS	N IH V IY AH S
NOCUOUS	N AA K Y AH W AH S
NOCUOUSLY	N AA K Y UW OW AH S L IY
NODOUS	N OW D AH S
NODULOUS	N AA JH UW L AH S
NONACCOUNTABLE	N AA N AH K AW N T AH B AH L
NONAMBIGUOUS	N AA N AE M B IH G Y AH W AH S
NONAQUEOUS	N AA N EY K W IY AH S
NONAUTONOMOUS	N AH N AH T AA N AH M AH S
NONCANCEROUS	N AA N K AE N S ER AH S
NONCOMPOUND	N AA N K AH M P AW N D
NONCOMPOUNDS	N AA N K AH M P AW N D Z
NONCONSCIOUS	N AA N K AA N SH AH S
NONCONTAGIOUS	N AA N K AH N T EY JH AH S
NONCONTIGUOUS	N AA N K AH N T IH G Y AH W AH S
NONCONTINUOUS	N AA N K AH N T IH N Y UW AH S
NONCOUNTRIES	N AA N K AH N T R IY Z
NONCOUNTRY	N AA N K AH N T R IY
NONCOUNTY	N AA N K AW N T IY
NONDISCOUNT	N AA N D IH S K AW N T
NONFERROUS	N AA N F EH R AH S
NONFILAMENTOUS	N AA N F IH L AH M AH N T AH S
NONFRIVOLOUS	N AA N F R IH V AH L AH S
NONGASEOUS	N AA N G AE S IY AH S
NONGLAMOROUS	N AA N G L AE M ER AH S
NONGREGARIOUS	N AA N G R IH G AE R IY AH S
NONHAZARDOUS	N AA N HH AE Z ER D AH S
NONHOMOGENEOUS	N AA N HH OW M AH JH IY N IY AH S
NONHOMOLOGOUS	N AA N HH OW M OW L AA G AH S
NONHOUSING	N AA N HH AW Z IH NG
NONHOUSINGS	N AA N HH AW Z IH NG Z
NONINDIGENOUS	N AA N IH N D IH JH AH N AH S
NONINFECTIOUS	N AA N IH N F EH K SH AH S
NONINTERCOURSE	N AA N IH N T ER K OW R S
NONINTERCOURSES	N AA N IH N T ER K OW R S IH Z
NONLEGUMINOUS	N AA N L IH G Y UW M AH N AH S
NONLUMINOUS	N AA N L UW M AH N AH S
NONMONOGAMOUS	N AA N M AH N AA G AH M AH S
NONNITROGENOUS	N AA N AY T R AH JH AH N AH S
NONNUTRITIOUS	N AA N UH T R IH SH AH S
NONOBVIOUS	N AA N AA B V IY AH S
NONPOISONOUS	N AA N P OY Z AH N AH S
NONPOROUS	N AA N P OW R AH S
NONRECOURSE	N AA N R IY K OW R S
NONRELIGIOUS	N AA N R IH L IH JH AH S
NONROUTINE	N AA N R UW T IY N
NONROUTINES	N AA N R UW T IY N Z
NONSENSUOUS	N AA N S EH N CH AH W AH S
NONSERIOUS	N AA N S IH R IY AH S
NONSIMULTANEOUS	N AA N S AY M AH L T EY N IY AH S
NONSYNCHRONOUS	N AA N S IH NG K R AH N AH S
NONUNANIMOUS	N AA N Y UH N AE N AH M AH S
NONVENOMOUS	N AA N V EH N AH M AH S
NONVISCOUS	N AA N V IH S K AH S
NORTHBOUND	N AO R TH B AW N D
NOTORIOUS	N OW T AO R IY AH S
NOTORIOUSLY	N OW T AO R IY AH S L IY
NOUGAT	N AW G AH T
NOUGATS	N AW G EY T S
NOUGHT	N AO T
NOUGHTS	N AO T S
NOUMENA	N AW M AH N AH
NOUMENAL	N AW M AH N AH L
NOUMENON	N AW M AH N AH N
NOUN	N AW N
NOUNAL	N AW N AH L
NOUNALLY	N AW N AH L IY
NOUNLESS	N AW N L AH S
NOUNS	N AW N Z
NOURISH	N ER IH SH
NOURISHED	N ER IH SH T
NOURISHER	N ER IH SH ER
NOURISHERS	N ER IH SH ER Z
NOURISHES	N ER IH SH AH Z
NOURISHING	N ER IH SH IH NG
NOURISHMENT	N ER IH SH M AH N T
NOURISHMENTS	N ER IH SH M AH N T S
NOUS	N UW S
NOUSES	N AW Z AH Z
NOUVEAU	N UW V OW
NOUVELLE	N UW V EH L
NOXIOUS	N AA K SH AH S
NOXIOUSLY	N AA K SH AH S L IY
NOXIOUSNESS	N AA K SH AH S N AH S
NOXIOUSNESSES	N AA K SH AH S N AH S IH Z
NUBILOUS	N UW B AY L AH S
NULLIPAROUS	N AH L IH P AH R AH S
NUMEROUS	N UW M ER AH S
NUMEROUSLY	N UW M ER AH S L IY
NUMEROUSNESS	N UW M ER AH S N AH S
NUMEROUSNESSES	N UW M ER AH S N AH S IH Z
NUMINOUS	N UW M AH N AH S
NUMINOUSES	N UW M AH N AH S IH Z
NUMINOUSNESS	N UW M AH N AH S N AH S
NUMINOUSNESSES	N UW M AH N AH S N AH S IH Z
NUTHOUSE	N AH T HH AW S
NUTHOUSES	N AH T HH AW S IH Z
NUTRITIOUS	N UW T R IH SH AH S
NUTRITIOUSLY	N UH T R IH SH AH S L IY
NUTRITIOUSNESS	N UH T R IH SH AH S N AH S
NUTRITIOUSNESSES	N UH T R IH SH AH S N AH S IH Z
OASTHOUSE	OW S TH AW Z
OASTHOUSES	OW S TH AW Z AH Z
OBLIVIOUS	AH B L IH V IY AH S
OBLIVIOUSLY	AH B L IH V IY AH S L IY
OBLIVIOUSNESS	AH B L IH V IY AH S N AH S
OBLIVIOUSNESSES	AH B L IH V IY AH S N AH S IH Z
OBNOXIOUS	AA B N AA K SH AH S
OBNOXIOUSLY	AA B N AA K SH AH S L IY
OBNOXIOUSNESS	AA B N AA K SH AH S N AH S
OBNOXIOUSNESSES	AA B N AA K SH AH S N AH S IH Z
OBSEQUIOUS	AH B S IY K W IY AH S
OBSEQUIOUSLY	AH B S IY K W IY AH S L IY
OBSEQUIOUSNESS	AH B S IY K W IY AH S N AH S
OBSEQUIOUSNESSES	AH B S IY K W IY AH S N AH S IH Z
OBSTREPEROUS	AH B S T R EH P ER AH S
OBSTREPEROUSLY	AA B S T R AH P EH R OW AH S L IY
OBSTREPEROUSNESS	AA B S T R EH P AH R AW Z N AH S
OBSTREPEROUSNESSES	AA B S T R EH P AH R AW Z N EH S AH Z
OBVIOUS	AA B V IY AH S
OBVIOUSLY	AA B V IY AH S L IY
OBVIOUSNESS	AA B V IY AH S N AH S
OBVIOUSNESSES	AA B V IY AH S N AH S IH Z
OCHEROUS	OW K ER AH S
OCHREOUS	OW K ER AH S
OCHROUS	OW K ER AH S
ODIOUS	OW D IY AH S
ODIOUSLY	OW D IY AH S L IY
ODIOUSNESS	OW D IY AH S N AH S
ODIOUSNESSES	OW D IY AH S N AH S IH Z
ODORIFEROUS	AA D AH R IH F AH R AH S
NGULTRUM	N G AH L T R AH M
WRACK	R AE K
CAOUTCHOUC	K EY AW CH AW K
PTERANODON	T AH R AE N AH D AH N
SKA	S K AA
HAWED	HH AO D
MBIRA	M AH B IH R AH
