OUGH	UW
ABOUGHT	AH B AO T
AFORETHOUGHT	AH F AO R TH AA T
AFTERTHOUGHT	AE F T ER TH AA T
AFTERTHOUGHT(2)	AE F T ER TH AO T
AFTERTHOUGHTS	AE F T ER TH AA T S
AFTERTHOUGHTS(2)	AE F T ER TH AO T S
ALTHOUGH	AO L DH OW
BESOUGHT	B IH S AO T
BETHOUGHT	B IH TH AO T
BOROUGH	B ER OW
BOROUGHS	B ER OW Z
BOUGH	B AW
BOUGHED	B AW D
BOUGHPOT	B AW P AA T
BOUGHPOTS	B AW P AA T S
BOUGHS	B AW Z
BOUGHT	B AA T
BOUGHT(2)	B AO T
BOUGHTEN	B AO T AH N
BREAKTHROUGH	B R EY K TH R UW
BREAKTHROUGHS	B R EY K TH R UW Z
BROUGHAM	B R UW G AH M
BROUGHAMS	B R AW AH M Z
BROUGHT	B R AO T
CHOUGH	CH UW
CHOUGHS	CH AW Z
CLOUGH	K L AW
CLOUGHS	K L AW Z
COUGH	K AA F
COUGH(2)	K AO F
COUGHED	K AO F T
COUGHER	K AO F ER
COUGHERS	K AO F ER Z
COUGHING	K AA F IH NG
COUGHS	K AO F S
DOGFOUGHT	D AO G F AO T
DOUGH	D OW
DOUGHBOY	D OW B OY
DOUGHBOYS	D OW B OY Z
DOUGHFACE	D OW F EY S
DOUGHFACES	D OW F EY S IH Z
DOUGHIER	D OW IY ER
DOUGHIEST	D OW IY AH S T
DOUGHLIKE	D OW L AY K
DOUGHNUT	D OW N AH T
DOUGHNUTLIKE	D OW N AH T L AY K
DOUGHNUTS	D OW N AH T S
DOUGHS	D OW Z
DOUGHT	D AO T
DOUGHTIER	D OW T IH ER
DOUGHTIEST	D OW T AY AH S T
DOUGHTILY	D OW T AY L IY
DOUGHTINESS	D OW T AY N AH S
DOUGHTINESSES	D OW T AY N AH S IH Z
DOUGHTY	D AO T IY
DOUGHY	D OW IY
DREADNOUGHT	D R EH D N AO T
DREADNOUGHTS	D R EH D N AO T S
DROUGHT	D R AW T
DROUGHTIER	D R AW T IY ER
DROUGHTIEST	D R AW T IY AH S T
DROUGHTINESS	D R AW T IY N AH S
DROUGHTINESSES	D R AW T IY N AH S IH Z
DROUGHTS	D R AW T S
DROUGHTY	D R AW T IY
ENOUGH	IH N AH F
ENOUGH(2)	IY N AH F
ENOUGHS	IH N AH F S
FORETHOUGHT	F AO R TH AO T
FORETHOUGHTFUL	F OW R TH AO T F AH L
FORETHOUGHTFULLY	F OW R TH AO T F AH L IY
FORETHOUGHTFULNESS	F OW R TH AO T F AH L N AH S
FORETHOUGHTFULNESSES	F OW R TH AO T F AH L N AH S IH Z
FORETHOUGHTS	F OW R TH AO T S
FOUGHT	F AO T
FOUGHTEN	F AO T AH N
FURLOUGH	F ER L OW
FURLOUGHED	F ER L OW D
FURLOUGHING	F ER L OW IH NG
FURLOUGHS	F ER L OW Z
GUNFOUGHT	G AH N F AO T
HANDWROUGHT	HH AE N D R AO T
HICCOUGH	HH IH K AH P
HICCOUGHED	HH IH K AW D
HICCOUGHING	HH IH K AW AH NG
HICCOUGHS	HH IH K AH P S
INFOUGHT	IH N F AO T
INTERBOROUGH	IH N T ER B ER OW
INTERBOROUGHS	IH N T ER B ER OW Z
INTERWROUGHT	IH N T ER R AO T
LOUGH	L AW
LOUGHS	L AW Z
MERRYTHOUGHT	M EH R IY TH AO T
MERRYTHOUGHTS	M EH R IY TH AO T S
METHOUGHT	M EH TH AO T
MISTHOUGHT	M IH S TH AO T
NOUGHT	N AO T
NOUGHTS	N AO T S
OUGHT	AO T
OUGHTED	AO T IH D
OUGHTING	AO T IH NG
OUGHTS	AO T S
OUTBOUGHT	AW T B AO T
OUTFOUGHT	AW T F AO T
OUTTHOUGHT	AW T TH AO T
OUTWROUGHT	AW T R AO T
OVERBOUGHT	OW V ER B AO T
OVERTHOUGHT	OW V ER TH AO T
OVERWROUGHT	OW V ER R AO T
PLOUGH	P L AW
PLOUGH(2)	P L OW
PLOUGHED	P L AW D
PLOUGHER	P L AW AH R
PLOUGHERS	P L AW AH R Z
PLOUGHING	P L AW AH NG
PLOUGHS	P L AW Z
REBOUGHT	R IY B AO T
REFOUGHT	R IY F AO T
RESOUGHT	R IY S AO T
RETHOUGHT	R IY TH AO T
REWROUGHT	R IY R AO T
ROUGH	R AH F
ROUGHAGE	R AH F IH JH
ROUGHAGES	R AH F IH JH IH Z
ROUGHCAST	R AH F K AE S T
ROUGHCASTING	R AH F K AE S T IH NG
ROUGHCASTS	R AH F K AE S T S
ROUGHDRIED	R AH F D R AY D
ROUGHDRIES	R AH F D R AY Z
ROUGHDRY	R AH F D R AY
ROUGHDRYING	R AH F D R AY IH NG
ROUGHED	R AH F T
ROUGHEN	R AH F AH N
ROUGHENED	R AH F AH N D
ROUGHENING	R AH F AH N IH NG
ROUGHENS	R AH F AH N Z
ROUGHER	R AH F ER
ROUGHERS	R AH F ER Z
ROUGHEST	R AH F AH S T
ROUGHHEW	R AH F HH Y UW
ROUGHHEWED	R AH F HH Y UW D
ROUGHHEWING	R AH F HH Y UW IH NG
ROUGHHEWN	R AH F HH Y UW N
ROUGHHEWS	R AH F HH Y UW Z
ROUGHHOUSE	R AH F HH AW S
ROUGHHOUSED	R AH F AH S T
ROUGHHOUSES	R AH F AH S IH Z
ROUGHHOUSING	R AH F AH S IH NG
ROUGHING	R AH F IH NG
ROUGHISH	R AH F IH SH
ROUGHLEG	R AH F L EH G
ROUGHLEGS	R AH F L EH G Z
ROUGHLY	R AH F L IY
ROUGHNECK	R AH F N EH K
ROUGHNECKS	R AH F N EH K S
ROUGHNESS	R AH F N AH S
ROUGHNESSES	R AH F N AH S IH Z
ROUGHRIDER	R AH F R AY D ER
ROUGHRIDERS	R AH F R AY D ER Z
ROUGHS	R AH F S
ROUGHSHOD	R AH F SH AA D
SLOUGH	S L AH F
SLOUGHED	S L AH F T
SLOUGHIER	S L AH F IY ER
SLOUGHIEST	S L AH F IY AH S T
SLOUGHING	S L AH F IH NG
SLOUGHS	S L AH F S
SLOUGHY	S L AH F IY
SOUGH	S UW
SOUGHED	S AW D
SOUGHING	S AW AH NG
SOUGHS	S AW Z
SOUGHT	S AO T
SOURDOUGH	S AW ER D OW
SOURDOUGHS	S AW ER D OW Z
THOROUGH	TH ER OW
THOROUGH(2)	TH AO R OW
THOROUGHBASS	TH ER OW B EY S
THOROUGHBASSES	TH ER OW B EY S IH Z
THOROUGHBRACE	TH ER OW B R EY S
THOROUGHBRACES	TH ER OW B R EY S IH Z
THOROUGHBRED	TH ER OW B R EH D
THOROUGHBREDS	TH ER OW B R EH D Z
THOROUGHER	TH ER OW ER
THOROUGHEST	TH ER OW AH S T
THOROUGHFARE	TH ER OW F EH R
THOROUGHFARES	TH ER OW F EH R Z
THOROUGHGOING	TH ER OW G OW IH NG
THOROUGHLY	TH ER OW L IY
THOROUGHNESS	TH ER OW N AH S
THOROUGHNESSES	TH ER OW N AH S IH Z
THOROUGHPIN	TH ER OW P IH N
THOROUGHPINS	TH ER OW P IH N Z
THOROUGHWORT	TH AH R AW W AH R T
THOROUGHWORTS	TH AH R AW W AH R T S
THOUGH	DH OW
THOUGHT	TH AO T
THOUGHTFUL	TH AO T F AH L
THOUGHTFULLY	TH AO T F AH L IY
THOUGHTFULNESS	TH AO T F AH L N IH S
THOUGHTFULNESSES	TH AO T F AH L N AH S IH Z
THOUGHTLESS	TH AO T L AH S
THOUGHTLESSLY	TH AO T L AH S L IY
THOUGHTLESSNESS	TH AO T L AH S N AH S
THOUGHTLESSNESSES	TH AO T L AH S N AH S IH Z
THOUGHTS	TH AO T S
THOUGHTWAY	TH AO T W EY
THOUGHTWAYS	TH AO T W EY Z
THROUGH	TH R UW
THROUGHITHER	TH R AW AH DH AH R
THROUGHLY	TH R AW L IY
THROUGHOTHER	TH R AW AH DH AH R
THROUGHOUT	TH R UW AW T
THROUGHPUT	TH R UW P UH T
THROUGHPUTS	TH R AW P Y UW T S
THROUGHWAY	TH R UW W EY
THROUGHWAYS	TH R AW W EY Z
TOUGH	T AH F
TOUGHED	T AH F T
TOUGHEN	T AH F AH N
TOUGHENED	T AH F AH N D
TOUGHENING	T AH F AH N IH NG
TOUGHENS	T AH F AH N Z
TOUGHER	T AH F ER
TOUGHEST	T AH F AH S T
TOUGHIE	T AH F IY
TOUGHIES	T AH F IY Z
TOUGHING	T AH F IH NG
TOUGHISH	T AH F IH SH
TOUGHLY	T AH F L IY
TOUGHNESS	T AH F N AH S
TOUGHNESSES	T AH F N AH S IH Z
TOUGHS	T AH F S
TOUGHY	T AH F IY
TROUGH	T R AO F
TROUGHS	T R AO F S
UNBOUGHT	AH N B AO T
UNDERBOUGHT	AH N D ER B AO T
UNFOUGHT	AH N F AO T
UNROUGH	AH N R AH F
UNSOUGHT	AH N S AO T
UNTHOUGHT	AH N TH AO T
WHERETHROUGH	W AH R EH TH R UW
WROUGHT	R AO T
YARBOROUGH	Y AA R B ER OW
YARBOROUGHS	Y AA R B AH R AW Z
AFRAID	AH F R EY D
LYARD	L AY AH R D
EX	EH K S
UFOLOGICAL	Y UW F AA L AH JH IH S AH L
EOLIAN	IY OW L IY AH N
LWEI	L W IY
IRRADIANCE	IH R EY D IY AH N S
