OW	OW
OW(2)	AW
ACKNOWLEDGE	AE K N AA L IH JH
ACKNOWLEDGED	AE K N AA L IH JH D
ACKNOWLEDGEDLY	AE K N AA L IH JH AH D L IY
ACKNOWLEDGEMENT	AE K N AA L IH JH M AH N T
ACKNOWLEDGEMENTS	AE K N AA L IH JH M AH N T S
ACKNOWLEDGES	AE K N AA L IH JH IH Z
ACKNOWLEDGING	AE K N AA L IH JH IH NG
ACKNOWLEDGMENT	AE K N AA L IH JH M AH N T
ACKNOWLEDGMENTS	AE K N AA L IH JH M AH N T S
ADOWN	AH D AW N
ADVOWSON	AE D OW S AH N
ADVOWSONS	AE D OW S AH N Z
AFTERGLOW	AE F T ER G L OW
AFTERGLOWS	AE F T ER G L OW Z
AGLOW	AH G L OW
AIRFLOW	EH R F L OW
AIRFLOWS	EH R F L OW Z
AIRGLOW	EH R G L OW
AIRGLOWS	AH IH R G L OW Z
AIRPOWER	EH R P AW ER
AIRPOWERS	AH IH R P AW ER Z
AJOWAN	AE JH OW AH N
AJOWANS	AE JH OW AH N Z
ALLOW	AH L AW
ALLOWABLE	AH L AW AH B AH L
ALLOWABLY	AH L AW AH B L IY
ALLOWANCE	AH L AW AH N S
ALLOWANCED	AH L AW AH N S T
ALLOWANCES	AH L AW AH N S IH Z
ALLOWANCING	AH L AW AH N S IH NG
ALLOWED	AH L AW D
ALLOWEDLY	AH L AW AH D L IY
ALLOWING	AH L AW IH NG
ALLOWS	AH L AW Z
ALOW	AH L OW
ALPENGLOW	AE L P AH N G L OW
ALPENGLOWS	AE L P AH N G L OW Z
ANTIGROWTH	AE N T AY G R OW TH
ANYHOW	EH N IY HH AW
ARROW	AE R OW
ARROW(2)	EH R OW
ARROWED	AE R OW D
ARROWHEAD	AE R OW HH EH D
ARROWHEAD(2)	EH R OW HH EH D
ARROWHEADS	AE R OW HH EH D Z
ARROWHEADS(2)	EH R OW HH EH D Z
ARROWING	AE R OW IH NG
ARROWROOT	EH R OW R UW T
ARROWROOTS	AE R OW R UW T S
ARROWS	AE R OW Z
ARROWS(2)	EH R OW Z
ARROWWOOD	AE R OW W UH D
ARROWWOODS	AE R OW W UH D Z
ARROWWORM	AE R OW W ER M
ARROWWORMS	AE R OW W ER M Z
ARROWY	AE R OW IY
AUTOWORKER	AO T OW W ER K ER
AUTOWORKERS	AO T OW W ER K ER Z
AVOW	AH V AW
AVOWABLE	AH V AW AH B AH L
AVOWABLY	AH V AW AH B L IY
AVOWAL	AH V AW AH L
AVOWALS	AH V AW AH L Z
AVOWED	AH V AW D
AVOWEDLY	AH V AW AH D L IY
AVOWER	AH V AW ER
AVOWERS	AH V AW ER Z
AVOWING	AH V AW IH NG
AVOWS	AH V AW Z
BACKFLOW	B AE K F L OW
BACKFLOWS	B AE K F L OW Z
BARLOW	B AA R L OW
BARLOWS	B AA R L OW Z
BARROW	B AE R OW
BARROW(2)	B EH R OW
BARROWS	B AE R OW Z
BARROWS(2)	B EH R OW Z
BATFOWL	B AE T F AW L
BATFOWLED	B AE T F AW L D
BATFOWLING	B AE T F AW L IH NG
BATFOWLS	B AE T F AW L Z
BECLOWN	B IH K L AW N
BECLOWNED	B IH K L AW N D
BECLOWNING	B IH K L AW N IH NG
BECLOWNS	B IH K L AW N Z
BECOWARD	B IH K AW ER D
BECOWARDED	B IH K AW ER D IH D
BECOWARDING	B IH K AW ER D IH NG
BECOWARDS	B IH K AW ER D Z
BECROWD	B IH K R AW D
BECROWDED	B IH K R AW D IH D
BECROWDING	B IH K R AW D IH NG
BECROWDS	B IH K R AW D Z
BEDFELLOW	B EH D F EH L OW
BEDFELLOWS	B EH D F EH L OW Z
BEDGOWN	B EH D G AW N
BEDGOWNS	B EH D G AW N Z
BEFLOWER	B IH F L AW ER
BEFLOWERED	B IH F L AW ER D
BEFLOWERING	B IH F L AW ER IH NG
BEFLOWERS	B IH F L AW ER Z
BEHOWL	B IH HH AW L
BEHOWLED	B IH HH AW L D
BEHOWLING	B IH HH AW L IH NG
BEHOWLS	B IH HH AW L Z
BELLFLOWER	B EH L F L AW ER
BELLFLOWERS	B EH L F L AW ER Z
BELLOW	B EH L OW
BELLOWED	B EH L OW D
BELLOWER	B EH L OW ER
BELLOWERS	B EH L OW ER Z
BELLOWING	B EH L OW IH NG
BELLOWS	B EH L OW Z
BELOW	B IH L OW
BELOW(2)	B IY L OW
BELOWDECKS	B IH L OW D EH K S
BELOWGROUND	B IH L OW G R AW N D
BELOWS	B IH L OW Z
BESHADOW	B IH SH AE D OW
BESHADOWED	B IH SH AE D OW D
BESHADOWING	B IH SH AE D OW IH NG
BESHADOWS	B IH SH AE D OW Z
BESNOW	B IH S N OW
BESNOWED	B IH S N OW D
BESNOWING	B IH S N OW IH NG
BESNOWS	B IH S N OW Z
BESTOW	B IH S T OW
BESTOWAL	B IH S T OW AH L
BESTOWALS	B IH S T OW AH L Z
BESTOWED	B IH S T OW D
BESTOWING	B IH S T OW IH NG
BESTOWS	B IH S T OW Z
BESTROW	B EH S T R OW
BESTROWED	B EH S T R OW D
BESTROWING	B EH S T R OW IH NG
BESTROWN	B IH S T R OW N
BESTROWS	B EH S T R OW Z
BILLOW	B IH L OW
BILLOWED	B IH L OW D
BILLOWIER	B IH L OW IY ER
BILLOWIEST	B IH L OW IY AH S T
BILLOWING	B IH L OW IH NG
BILLOWS	B IH L OW Z
BILLOWY	B IH L OW IY
BLANKETFLOWER	B L AE NG K AH T F L AW ER
BLANKETFLOWERS	B L AE NG K AH T F L AW ER Z
BLOW	B L OW
BLOWBACK	B L OW B AE K
BLOWBACKS	B L OW B AE K S
BLOWBALL	B L OW B AO L
BLOWBALLS	B L OW B AO L Z
BLOWBY	B L OW B AY
BLOWBYS	B L OW B AY Z
BLOWDOWN	B L OW D AW N
BLOWDOWNS	B L OW D AW N Z
BLOWED	B L OW D
BLOWER	B L OW ER
BLOWERS	B L OW ER Z
BLOWFISH	B L OW F IH SH
BLOWFISHES	B L OW F IH SH IH Z
BLOWFLIES	B L OW F L AY Z
BLOWFLY	B L OW F L AY
BLOWGUN	B L OW G AH N
BLOWGUNS	B L OW G AH N Z
BLOWHARD	B L OW HH AA R D
BLOWHARDS	B L OW HH AA R D Z
BLOWHOLE	B L OW HH OW L
BLOWHOLES	B L OW HH OW L Z
BLOWIER	B L OW IY ER
BLOWIEST	B L OW IY AH S T
BLOWING	B L OW IH NG
BLOWJOB	B L OW JH AA B
BLOWJOBS	B L OW JH AA B Z
BLOWN	B L OW N
BLOWOFF	B L OW AO F
BLOWOFFS	B L OW AO F S
BLOWOUT	B L OW AW T
BLOWOUTS	B L OW AW T S
BLOWPIPE	B L OW P AY P
BLOWPIPES	B L OW P AY P S
BLOWS	B L OW Z
BLOWSED	B L OW Z D
BLOWSIER	B L OW Z IY ER
BLOWSIEST	B L OW Z IY AH S T
BLOWSILY	B L OW Z IY L IY
BLOWSY	B L OW Z IY
BLOWTORCH	B L OW T AO R CH
BLOWTORCHES	B L OW T AO R CH AH Z
BLOWTUBE	B L OW T UW B
BLOWTUBES	B L OW T UW B Z
BLOWUP	B L OW AH P
BLOWUPS	B L OW AH P S
BLOWY	B L OW IY
BLOWZED	B L OW Z D
BLOWZIER	B L OW Z AY AH R
BLOWZIEST	B L OW Z AY AH S T
BLOWZILY	B L OW Z AH L IY
BLOWZY	B L OW Z IY
BOOMTOWN	B UW M T AW N
BOOMTOWNS	B UW M T AW N Z
BORROW	B AA R OW
BORROWED	B AA R OW D
BORROWER	B AA R OW ER
BORROWERS	B AA R OW ER Z
BORROWING	B AA R OW IH NG
BORROWINGS	B AA R OW IH NG Z
BORROWS	B AA R OW Z
BOW	B AW
BOW(2)	B OW
BOWDLERISE	B OW D L AH R AY Z
BOWDLERISED	B OW D L AH R AH S T
BOWDLERISES	B OW D L AH R AY Z AH Z
BOWDLERISING	B OW D L AH R AY Z AH NG
BOWDLERIZATION	B OW D L AH R AH Z EY SH AH N
BOWDLERIZATIONS	B OW D L AH R AH Z EY T IY AH N Z
BOWDLERIZE	B OW D L AH R AY Z
BOWDLERIZED	B OW D L AH R AY Z D
BOWDLERIZER	B OW D L AH R AY Z AH R
BOWDLERIZERS	B OW D L EH R AH Z AH R Z
BOWDLERIZES	B OW D L AH R AY Z AH Z
BOWDLERIZING	B OW D L AH R AY Z AH NG
BOWED	B AW D
BOWED(2)	B OW D
BOWEL	B AW AH L
BOWELED	B AW AH L D
BOWELING	B AW AH L IH NG
BOWELLED	B AW AH L D
BOWELLESS	B AW AH L AH S
BOWELLING	B AW AH L IH NG
BOWELS	B AW AH L Z
BOWELS(2)	B AW L Z
BOWER	B AW ER
BOWERBIRD	B AW ER B ER D
BOWERBIRDS	B AW ER B ER D Z
BOWERED	B AW ER D
BOWERIES	B AW AH R IY Z
BOWERING	B AW ER IH NG
BOWERS	B AW ER Z
BOWERY	B AW ER IY
BOWFIN	B AW F IH N
BOWFINS	B AW F IH N Z
BOWFRONT	B AW F R AH N T
BOWHEAD	B AW HH EH D
BOWHEADS	B AW HH EH D Z
BOWING	B OW IH NG
BOWING(2)	B AW IH NG
BOWINGLY	B AW IH NG L IY
BOWINGS	B AW IH NG Z
BOWKNOT	B AW N AA T
BOWKNOTS	B AW N AA T S
BOWL	B OW L
BOWLDER	B OW L D AH R
BOWLDERS	B OW L D AH R Z
BOWLED	B OW L D
BOWLEG	B AW L EH G
BOWLEGGED	B OW L EH G D
BOWLEGS	B AW L EH G Z
BOWLER	B OW L ER
BOWLERS	B OW L ER Z
BOWLESS	B AW L AH S
BOWLFUL	B OW L F AH L
BOWLFULS	B OW L F AH L Z
BOWLIKE	B AW L AY K
BOWLINE	B OW L AY N
BOWLINES	B AW L AY N Z
BOWLING	B OW L IH NG
BOWLINGS	B AW L IH NG Z
BOWLLIKE	B OW L AY K
BOWLS	B OW L Z
BOWMAN	B OW M AH N
BOWMEN	B OW M AH N
BOWPOT	B AW P AA T
BOWPOTS	B AW P AA T S
BOWS	B AW Z
BOWS(2)	B OW Z
BOWSE	B OW S
BOWSED	B AW Z D
BOWSES	B AW Z IH Z
BOWSHOT	B AW SH AA T
BOWSHOTS	B AW SH AA T S
BOWSING	B AW Z IH NG
BOWSPRIT	B OW S R AH T
BOWSPRITS	B OW S R AH T S
BOWSTRING	B AW S T R IH NG
BOWSTRINGS	B AW S T R IH NG Z
BOWWOW	B AW W AW
BOWWOWED	B AW W AW D
BOWWOWING	B AW W AW IH NG
BOWWOWS	B AW W AW Z
BOWYER	B OW Y ER
BOWYERS	B AW IY ER Z
BRAINPOWER	B R EY N P AW ER
BRAINPOWERS	B R EY N P AW ER Z
BREAKDOWN	B R EY K D AW N
BREAKDOWNS	B R EY K D AW N Z
BRINGDOWN	B R IH NG D AW N
BRINGDOWNS	B R IH NG D AW N Z
BROW	B R AW
BROWBAND	B R AW B AE N D
BROWBANDS	B R AW B AE N D Z
BROWBEAT	B R AW B IY T
BROWBEATEN	B R AW B IY T AH N
BROWBEATING	B R AW B IY T IH NG
BROWBEATS	B R AW B IY T S
BROWED	B R AW D
BROWLESS	B R AW L AH S
BROWN	B R AW N
BROWNED	B R AW N D
BROWNER	B R AW N ER
BROWNEST	B R AW N IH S T
BROWNFIELD	B R AW N F IY L D
BROWNFIELDS	B R AW N F IY L D Z
BROWNIE	B R AW N IY
BROWNIER	B R AW N IY ER
BROWNIES	B R AW N IY Z
BROWNIEST	B R AW N IY AH S T
BROWNING	B R AW N IH NG
BROWNISH	B R AW N IH SH
BROWNNOSE	B R AW N OW Z
BROWNNOSED	B R AW N OW Z D
BROWNNOSER	B R AW N OW Z ER
BROWNNOSERS	B R AW N OW Z ER Z
BROWNNOSES	B R AW N OW Z IH Z
BROWNNOSING	B R AW N OW Z IH NG
BROWNOUT	B R AW N AW T
BROWNOUTS	B R AW N AW T S
BROWNS	B R AW N Z
BROWNSHIRT	B R AW N SH ER T
BROWNSHIRTS	B R AW N SH ER T S
BROWNSTONE	B R AW N S T OW N
BROWNSTONES	B R AW N S T OW N Z
BROWNY	B R AW N IY
BROWRIDGE	B R AW R IH JH
BROWRIDGES	B R AW R IH JH IH Z
BROWS	B R AW Z
BROWSE	B R AW Z
BROWSED	B R AW Z D
BROWSER	B R AW Z ER
BROWSERS	B R AW Z ER Z
BROWSES	B R AW Z IH Z
BROWSING	B R AW Z IH NG
BUNGALOW	B AH NG G AH L OW
BUNGALOWS	B AH NG G AH L OW Z
BURROW	B ER OW
BURROWED	B ER OW D
BURROWER	B ER OW ER
BURROWERS	B ER OW ER Z
BURROWING	B ER OW IH NG
BURROWS	B ER OW Z
CAHOW	K AE HH OW
CAHOWS	K AH HH OW Z
CALLOW	K AE L OW
CALLOWER	K AO L OW ER
CALLOWEST	K AO L OW AH S T
CALLOWNESS	K AO L OW N AH S
CALLOWNESSES	K AO L OW N AH S IH Z
CANDLEPOWER	K AE N D AH L P AW ER
CANDLEPOWERS	K AE N D AH L P AW ER Z
CARASSOW	K AH R AE S OW
CARASSOWS	K AH R AE S OW Z
CASSOWARIES	K AE S OW AH R AY Z
CASSOWARY	K AE S AH W EH R IY
CAULIFLOWER	K AA L AH F L AW ER
CAULIFLOWERET	K AO L AH F L OW AH R AH T
CAULIFLOWERETS	K AO L AH F L OW AH R AH T S
CAULIFLOWERS	K AO L IH F L AW ER Z
CHECKROW	CH EH K R OW
CHECKROWED	CH EH K R OW D
CHECKROWING	CH EH K R OW IH NG
CHECKROWS	CH EH K R OW Z
CHOW	CH AW
CHOWCHOW	CH AW CH AW
CHOWCHOWS	CH AW CH AW Z
CHOWDER	CH AW D ER
CHOWDERED	CH AW D ER D
CHOWDERHEAD	CH AW D ER HH EH D
CHOWDERHEADED	CH AW D ER HH EH D IH D
CHOWDERHEADS	CH AW D ER HH EH D Z
CHOWDERING	CH AW D ER IH NG
CHOWDERS	CH AW D ER Z
CHOWED	CH AW D
CHOWHOUND	CH AW HH AW N D
CHOWHOUNDS	CH AW HH AW N D Z
CHOWING	CH AW IH NG
CHOWS	CH AW Z
CHOWSE	CH OW S
CHOWSED	CH AW Z D
CHOWSES	CH AW Z IH Z
CHOWSING	CH AW Z IH NG
CHOWTIME	CH AW T AY M
CHOWTIMES	CH AW T AY M Z
CLAMPDOWN	K L AE M P D AW N
CLAMPDOWNS	K L AE M P D AW N Z
CLOSEDOWN	K L OW Z D AW N
CLOSEDOWNS	K L OW Z D AW N Z
CLOWDER	K L OW D AH R
CLOWDERS	K L OW D AH R Z
CLOWN	K L AW N
CLOWNED	K L AW N D
CLOWNERIES	K L AW N AH R IY Z
CLOWNERY	K L AW N AH R IY
CLOWNING	K L AW N IH NG
CLOWNISH	K L AW N IH SH
CLOWNISHLY	K L AW N IH SH L IY
CLOWNISHNESS	K L AW N IH SH N AH S
CLOWNISHNESSES	K L AW N IH SH N AH S IH Z
CLOWNS	K L AW N Z
COCKCROW	K AA K R OW
COCKCROWS	K AA K R OW Z
COMEDOWN	K AH M D AW N
COMEDOWNS	K AH M D AW N Z
CONEFLOWER	K OW N F L AW ER
CONEFLOWERS	K OW N F L AW ER Z
COOLDOWN	K UW L D AW N
COOLDOWNS	K UW L D AW N Z
CORNFLOWER	K AO R N F L AW ER
CORNFLOWERS	K AO R N F L AW ER Z
CORNROW	K AO R N R OW
CORNROWED	K AO R N R OW D
CORNROWING	K AO R N R OW IH NG
CORNROWS	K AO R N R OW Z
COUNTDOWN	K AW N T D AW N
COUNTDOWNS	K AW N T D AW N Z
COUNTERBLOW	K AW N T ER B L OW
COUNTERBLOWS	K AW N T ER B L OW Z
COUNTERFLOW	K AW N T ER F L OW
COUNTERFLOWS	K AW N T ER F L OW Z
COUNTERPOWER	K AW N T ER P AW ER
COUNTERPOWERS	K AW N T ER P AW ER Z
COW	K AW
COWAGE	K OW W EY JH
COWAGES	K OW W EY JH IH Z
COWARD	K AW ER D
COWARDICE	K AW ER D AH S
COWARDICES	K AW ER D AH S IH Z
COWARDLINESS	K AW ER D L IY N AH S
COWARDLINESSES	K AW ER D L IY N AH S IH Z
COWARDLY	K AW ER D L IY
COWARDS	K AW ER D Z
COWBANE	K AW B EY N
COWBANES	K AW B EY N Z
COWBELL	K AW B EH L
COWBELLS	K AW B EH L Z
COWBERRIES	K AW B EH R IY Z
COWBERRY	K AW B EH R IY
COWBIND	K AW B AY N D
COWBINDS	K AW B AY N D Z
COWBIRD	K AW B ER D
COWBIRDS	K AW B ER D Z
COWBOY	K AW B OY
COWBOYS	K AW B OY Z
COWCATCHER	K AW K AE CH ER
COWCATCHERS	K AW K AE CH ER Z
COWED	K AW D
COWEDLY	K AW AH D L IY
COWER	K AW ER
COWERED	K AW ER D
COWERING	K AW ER IH NG
COWERS	K AW ER Z
COWFISH	K AW F IH SH
COWFISHES	K AW F IH SH IH Z
COWFLAP	K AW F L AE P
COWFLAPS	K AW F L AE P S
COWFLOP	K AW F L AA P
COWFLOPS	K AW F L AA P S
COWGIRL	K AW G ER L
COWGIRLS	K AW G ER L Z
COWHAGE	K OW AH JH
COWHAGES	K OW AH JH AH Z
COWHAND	K AW HH AE N D
COWHANDS	K AW HH AE N D Z
COWHERB	K AW ER B
COWHERBS	K AW ER B Z
COWHERD	K AW HH ER D
COWHERDS	K AW HH ER D Z
COWHIDE	K AW HH AY D
COWHIDED	K AW HH AY D IH D
COWHIDES	K AW HH AY D Z
COWHIDING	K AW HH AY D IH NG
COWIER	K AW IY ER
COWIEST	K AW IY AH S T
COWING	K AW IH NG
COWINNER	K OW W IH N ER
COWINNERS	K OW W IH N ER Z
COWL	K AW L
COWLED	K AW L D
COWLICK	K AW L IH K
COWLICKS	K AW L IH K S
COWLING	K AW L IH NG
COWLINGS	K AW L IH NG Z
COWLS	K AW L Z
COWLSTAFF	K AW L S T AE F
COWLSTAFFS	K AW L S T AE F S
COWLSTAVES	K AW L S T EY V Z
COWMAN	K AW M AH N
COWMEN	K AW M EH N
COWORKER	K OW W ER K ER
COWORKERS	K OW W ER K ER Z
COWPAT	K AW P AE T
COWPATS	K AW P AE T S
COWPEA	K AW P IY
COWPEAS	K AW P IY Z
COWPIE	K AW P AY
COWPIES	K AW P AY Z
COWPLOP	K AW P L AA P
COWPLOPS	K AW P L AA P S
COWPOKE	K AW P OW K
COWPOKES	K AW P OW K S
COWPOX	K AW P AA K S
COWPOXES	K AW P AA K S IH Z
COWPUNCHER	K AW P AH N CH ER
COWPUNCHERS	K AW P AH N CH ER Z
COWRIE	K OW R AY
COWRIES	K AW R IY Z
COWRITE	K OW R AY T
COWRITES	K OW R AY T S
COWRITING	K OW R AY T IH NG
COWRITTEN	K OW R IH T AH N
COWROTE	K OW R OW T
COWRY	K OW R AY
COWS	K AW Z
COWSHED	K AW SH EH D
COWSHEDS	K AW SH EH D Z
COWSKIN	K AW S K IH N
COWSKINS	K AW S K IH N Z
COWSLIP	K AW S L IH P
COWSLIPS	K AW S L IH P S
COWY	K AW IY
CRACKDOWN	K R AE K D AW N
CRACKDOWNS	K R AE K D AW N Z
CROSSBOW	K R AO S B OW
CROSSBOWMAN	K R AO S B OW M AH N
CROSSBOWMEN	K R AO S B AW M EH N
CROSSBOWS	K R AO S B OW Z
CROSSTOWN	K R AO S T AW N
CROW	K R OW
CROWBAR	K R OW B AA R
CROWBARRED	K R OW B AA R D
CROWBARRING	K R OW B AA R IH NG
CROWBARS	K R OW B AA R Z
CROWBERRIES	K R OW B EH R IY Z
CROWBERRY	K R OW B EH R IY
CROWD	K R AW D
CROWDED	K R AW D AH D
CROWDED(2)	K R AW D IH D
CROWDEDNESS	K R AW D AH D N AH S
CROWDEDNESSES	K R AW D AH D N AH S IH Z
CROWDER	K R AW D ER
CROWDERS	K R AW D ER Z
CROWDIE	K R AW D IY
CROWDIES	K R AW D IY Z
CROWDING	K R AW D IH NG
CROWDS	K R AW D Z
CROWDY	K R AW D IY
CROWED	K R OW D
CROWER	K R OW ER
CROWERS	K R OW ER Z
CROWFEET	K R OW F IY T
CROWFOOT	K R OW F UH T
CROWFOOTS	K R OW F UH T S
CROWING	K R OW IH NG
CROWKEEPER	K R OW K IY P ER
CROWKEEPERS	K R OW K IY P ER Z
CROWN	K R AW N
CROWNED	K R AW N D
CROWNER	K R AW N ER
CROWNERS	K R AW N ER Z
CROWNET	K R OW N EH T
CROWNETS	K R OW N EH T S
CROWNING	K R AW N IH NG
CROWNLESS	K R AW N L AH S
CROWNS	K R AW N Z
CROWS	K R OW Z
CROWSTEP	K R OW S T EH P
CROWSTEPPED	K R OW S T EH P T
CROWSTEPS	K R OW S T EH P S
CUCKOOFLOWER	K AH K UW F L OW AH R
CUCKOOFLOWERS	K AH K UW F L OW AH R Z
CURASSOW	K Y AH R AE S OW
CURASSOWS	K Y AH R AE S OW Z
CUTDOWN	K AH T D AW N
CUTDOWNS	K AH T D AW N Z
DAYFLOWER	D EY F L AW ER
DAYFLOWERS	D EY F L AW ER Z
DAYGLOW	D EY G L OW
DAYGLOWS	D EY G L OW Z
DEATHBLOW	D EH TH B L OW
DEATHBLOWS	D EH TH B L OW Z
DECROWN	D IY K R AW N
DECROWNED	D IY K R AW N D
DECROWNING	D IY K R AW N IH NG
DECROWNS	D IY K R AW N Z
DEFLOWER	D IY F L AW ER
DEFLOWERED	D IY F L AW ER D
DEFLOWERER	D IY F L AW ER ER
DEFLOWERERS	D IY F L AW ER ER Z
DEFLOWERING	D IY F L AW ER IH NG
DEFLOWERS	D IY F L AW ER Z
DHOW	D HH OW
DHOWS	D AW Z
DISALLOW	D IH S AH L AW
DISALLOWANCE	D IH S AH L AW AH N S
DISALLOWANCES	D IH S AH L AW AH N S IH Z
DISALLOWED	D IH S AH L AW D
DISALLOWING	D IH S AH L AW IH NG
DISALLOWS	D IH S AH L AW Z
DISAVOW	D IH S AH V AW
DISAVOWABLE	D IH S AH V AW AH B AH L
DISAVOWAL	D IH S AH V AW AH L
DISAVOWALS	D IH S AH V AW AH L Z
DISAVOWED	D IH S AH V AW D
DISAVOWING	D IH S AH V AW IH NG
DISAVOWS	D IH S AH V AW Z
DISBOWEL	D IH S B AW AH L
DISBOWELED	D IH S B AW AH L D
DISBOWELING	D IH S B AW AH L IH NG
DISBOWELLED	D IH S B AW AH L D
DISBOWELLING	D IH S B AW AH L IH NG
DISBOWELS	D IH S B AW AH L Z
DISCROWN	D IH S K R AW N
DISCROWNED	D IH S K R AW N D
DISCROWNING	D IH S K R AW N IH NG
DISCROWNS	D IH S K R AW N Z
DISEMBOWEL	D IH S IH M B AW AH L
DISEMBOWELED	D IH S IH M B AW AH L D
DISEMBOWELING	D IH S IH M B AW AH L IH NG
DISEMBOWELLED	D IH S IH M B AW AH L D
DISEMBOWELLING	D IH S IH M B AW AH L IH NG
DISEMBOWELMENT	D IH S IH M B AW AH L M AH N T
DISEMBOWELMENTS	D IH S IH M B AW AH L M AH N T S
DISEMBOWELS	D IH S IH M B AW AH L Z
DISENDOW	D IH S EH N D AW
DISENDOWED	D IH S EH N D AW D
DISENDOWER	D IH S EH N D AW ER
DISENDOWERS	D IH S EH N D AW ER Z
DISENDOWING	D IH S EH N D AW IH NG
DISENDOWMENT	D IH S EH N D AW M AH N T
DISENDOWMENTS	D IH S EH N D AW M AH N T S
DISENDOWS	D IH S EH N D AW Z
DISHTOWEL	D IH SH T AW AH L
DISHTOWELS	D IH SH T AW AH L Z
DISOWN	D IH S OW N
DISOWNED	D IH S OW N D
DISOWNING	D IH S OW N IH NG
DISOWNMENT	D IH S OW N M AH N T
DISOWNMENTS	D IH S OW N M AH N T S
DISOWNS	D IH S OW N Z
DOW	D AW
DOWABLE	D AW AH B AH L
DOWAGER	D AW AH JH ER
DOWAGERS	D AW IH JH ER Z
DOWDIER	D AW D AY ER
DOWDIES	D AW D AY Z
DOWDIEST	D AW D AY AH S T
DOWDILY	D OW D AH L IY
DOWDINESS	D AW D AY N AH S
DOWDINESSES	D AW D AY N AH S IH Z
DOWDY	D AW D IY
DOWDYISH	D AW D AY IH SH
DOWED	D AW D
DOWEL	D AW AH L
DOWELED	D AW AH L D
DOWELING	D AW AH L IH NG
DOWELLED	D AW AH L D
DOWELLING	D AW AH L IH NG
DOWELS	D AW AH L Z
DOWER	D AW R
DOWERED	D AW ER D
DOWERIES	D AW AH R IY Z
DOWERING	D AW ER IH NG
DOWERS	D AW R Z
DOWERY	D AW AH R IY
DOWIE	D AW IY
DOWING	D AW IH NG
DOWITCHER	D UW W IH CH ER
DOWITCHERS	D UW W IH CH ER Z
DOWN	D AW N
DOWNBEAT	D AW N B IY T
DOWNBEATS	D AW N B IY T S
DOWNBURST	D AW N B ER S T
DOWNBURSTS	D AW N B ER S T S
DOWNCAST	D AW N K AE S T
DOWNCASTS	D AW N K AE S T S
DOWNCOME	D AW N K AH M
DOWNCOMES	D AW N K AH M Z
DOWNCOURT	D AW N K OW R T
DOWNDRAFT	D AW N D R AE F T
DOWNDRAFTS	D AW N D R AE F T S
DOWNED	D AW N D
DOWNER	D AW N ER
DOWNERS	D AW N ER Z
DOWNFALL	D AW N F AO L
DOWNFALLEN	D AW N F AE L AH N
DOWNFALLS	D AW N F AO L Z
DOWNFIELD	D AW N F IY L D
DOWNGRADE	D AW N G R EY D
DOWNGRADED	D AW N G R EY D AH D
DOWNGRADES	D AW N G R EY D Z
DOWNGRADING	D AW N G R EY D IH NG
DOWNHAUL	D AW N HH AO L
DOWNHAULS	D AW N HH AO L Z
DOWNHEARTED	D AW N HH AA R T IH D
DOWNHEARTEDLY	D AW N HH AA R T AH D L IY
DOWNHEARTEDNESS	D AW N HH AA R T AH D N AH S
DOWNHEARTEDNESSES	D AW N HH AA R T AH D N AH S IH Z
DOWNHILL	D AW N HH IH L
DOWNHILLER	D AW N HH IH L ER
DOWNHILLERS	D AW N HH IH L ER Z
DOWNHILLS	D AW N HH IH L Z
DOWNIER	D AW N IY ER
DOWNIEST	D AW N IY AH S T
DOWNING	D AW N IH NG
DOWNLAND	D AW N L AE N D
DOWNLANDS	D AW N L AE N D Z
DOWNLINK	D AW N L IH NG K
DOWNLINKS	D AW N L IH NG K S
DOWNLOAD	D AW N L OW D
DOWNLOADABLE	D AW N L OW D AH B AH L
DOWNLOADED	D AW N L OW D IH D
DOWNLOADING	D AW N L OW D IH NG
DOWNLOADS	D AW N L OW D Z
DOWNPIPE	D AW N P AY P
DOWNPIPES	D AW N P AY P S
DOWNPLAY	D AW N P L EY
DOWNPLAYED	D AW N P L EY D
DOWNPLAYING	D AW N P L EY IH NG
DOWNPLAYS	D AW N P L EY Z
DOWNPOUR	D AW N P AO R
DOWNPOURS	D AW N P AO R Z
DOWNRANGE	D AW N R EY N JH
DOWNRIGHT	D AW N R AY T
DOWNRIGHTLY	D AW N R AY T L IY
DOWNRIGHTNESS	D AW N R AY T N AH S
DOWNRIGHTNESSES	D AW N R AY T N AH S IH Z
DOWNRIVER	D AW N R IH V ER
DOWNS	D AW N Z
DOWNSCALE	D AW N S K EY L
DOWNSCALED	D AW N S K EY L D
DOWNSCALES	D AW N S K EY L Z
DOWNSCALING	D AW N S K EY L IH NG
DOWNSHIFT	D AW N SH IH F T
DOWNSHIFTED	D AW N SH IH F T IH D
DOWNSHIFTING	D AW N SH IH F T IH NG
DOWNSHIFTS	D AW N SH IH F T S
DOWNSIDE	D AW N S AY D
DOWNSIDES	D AW N S AY D Z
DOWNSIZE	D AW N S AY Z
DOWNSIZED	D AW N S AY Z D
DOWNSIZES	D AW N S AY Z IH Z
DOWNSIZING	D AW N S AY Z IH NG
DOWNSLIDE	D AW N S L AY D
DOWNSLIDES	D AW N S L AY D Z
DOWNSLOPE	D AW N S L OW P
DOWNSPOUT	D AW N S P AW T
DOWNSPOUTS	D AW N S P AW T S
DOWNSTAGE	D AW N S T EY JH
DOWNSTAGES	D AW N S T EY JH IH Z
DOWNSTAIRS	D AW N S T EH R Z
DOWNSTATE	D AW N S T EY T
DOWNSTATER	D AW N S T EY T ER
DOWNSTATERS	D AW N S T EY T ER Z
DOWNSTATES	D AW N S T EY T S
DOWNSTREAM	D AW N S T R IY M
DOWNSTROKE	D AW N S T R OW K
DOWNSTROKES	D AW N S T R OW K S
DOWNSWING	D AW N S W IH NG
DOWNSWINGS	D AW N S W IH NG Z
DOWNTICK	D AW N T IH K
DOWNTICKS	D AW N T IH K S
DOWNTIME	D AW N T AY M
DOWNTIMES	D AW N T AY M Z
DOWNTOWN	D AW N T AW N
DOWNTOWNER	D AW N T AW N ER
DOWNTOWNERS	D AW N T AW N ER Z
DOWNTOWNS	D AW N T AW N Z
DOWNTREND	D AW N T R EH N D
DOWNTRENDS	D AW N T R EH N D Z
DOWNTROD	D AW N T R AA D
DOWNTRODDEN	D AW N T R AA D AH N
DOWNTURN	D AW N T ER N
DOWNTURNS	D AW N T ER N Z
DOWNWARD	D AW N W ER D
DOWNWARDLY	D AW N W ER D L IY
DOWNWARDNESS	D AW N W ER D N AH S
DOWNWARDNESSES	D AW N W ER D N AH S IH Z
DOWNWARDS	D AW N W ER D Z
DOWNWASH	D AW N W AA SH
DOWNWASHES	D AW N W AA SH IH Z
DOWNWIND	D AW N W IH N D
DOWNY	D AW N IY
DOWRIES	D AW R IY Z
DOWRY	D AW R IY
DOWS	D AW Z
DOWSABEL	D AW Z AH B EH L
DOWSABELS	D AW Z AH B EH L Z
DOWSE	D AW S
DOWSED	D AW Z D
DOWSER	D AW Z ER
DOWSERS	D AW Z ER Z
DOWSES	D AW Z IH Z
DOWSING	D AW S IH NG
DRAWDOWN	D R AO D AW N
DRAWDOWNS	D R AO D AW N Z
DROWN	D R AW N
DROWND	D R OW N D
DROWNDED	D R OW N D AH D
DROWNDING	D R OW N D AH NG
DROWNDS	D R OW N D Z
DROWNED	D R AW N D
DROWNER	D R AW N ER
DROWNERS	D R AW N ER Z
DROWNING	D R AW N IH NG
DROWNINGS	D R AW N IH NG Z
DROWNS	D R AW N Z
DROWSE	D R AW Z
DROWSED	D R AW Z D
DROWSES	D R AW Z IH Z
DROWSIER	D R AW Z IY ER
DROWSIEST	D R AW Z IY AH S T
DROWSILY	D R AW Z IY L IY
DROWSINESS	D R AW Z IY N AH S
DROWSINESSES	D R AW Z IY N AH S IH Z
DROWSING	D R AW Z IH NG
DROWSY	D R AW Z IY
EIDERDOWN	IY D AH R D OW N
EIDERDOWNS	IY D AH R D OW N Z
ELBOW	EH L B OW
ELBOWED	EH L B OW D
ELBOWING	EH L B OW IH NG
ELBOWROOM	EH L B OW R UW M
ELBOWROOMS	EH L B OW R UW M Z
ELBOWS	EH L B OW Z
ELECTROWEAK	AH L EH K T R OW IY K
ELECTROWINNING	IH L EH K T R OW IH N IH NG
ELECTROWINNINGS	IH L EH K T R OW IH N IH NG Z
EMBOW	IH M B AW
EMBOWED	IH M B AW D
EMBOWEL	IH M B AW AH L
EMBOWELED	IH M B AW AH L D
EMBOWELING	IH M B AW AH L IH NG
EMBOWELLED	IH M B AW AH L D
EMBOWELLING	IH M B AW AH L IH NG
EMBOWELS	IH M B AW AH L Z
EMBOWER	IH M B AW ER
EMBOWERED	IH M B AW ER D
EMBOWERING	IH M B AW ER IH NG
EMBOWERS	IH M B AW ER Z
EMBOWING	IH M B AW IH NG
EMBOWS	IH M B AW Z
EMBROWN	IH M B R AW N
EMBROWNED	IH M B R AW N D
EMBROWNING	IH M B R AW N IH NG
EMBROWNS	IH M B R AW N Z
EMPOWER	IH M P AW ER
EMPOWERED	IH M P AW ER D
EMPOWERING	IH M P AW ER IH NG
EMPOWERMENT	IH M P AW ER M AH N T
EMPOWERMENTS	IH M P AW ER M AH N T S
EMPOWERS	IH M P AW ER Z
ENDOW	EH N D AW
ENDOWED	EH N D AW D
ENDOWER	EH N D AW ER
ENDOWERS	EH N D AW ER Z
ENDOWING	EH N D AW IH NG
ENDOWMENT	EH N D AW M AH N T
ENDOWMENTS	EH N D AW M AH N T S
ENDOWS	EH N D AW Z
ENOW	AH N OW
ENOWS	AH N OW Z
ERENOW	EH R AH N OW
ESCROW	EH S K R OW
ESCROWED	EH S K R OW D
ESCROWING	EH S R OW AH NG
ESCROWS	EH S R OW Z
EYEBROW	AY B R AW
EYEBROWS	AY B R AW Z
FACEDOWN	F EY S D AW N
FACEDOWNS	F EY S D AW N Z
FALLOW	F AE L OW
FALLOWED	F AE L OW D
FALLOWING	F AE L OW IH NG
FALLOWNESS	F AE L OW N AH S
FALLOWNESSES	F AE L OW N AH S IH Z
FALLOWS	F AE L OW Z
FARROW	F EH R OW
FARROWED	F AA R OW D
FARROWING	F AE R OW IH NG
FARROWS	F AA R OW Z
FELLOW	F EH L OW
FELLOWED	F EH L OW D
FELLOWING	F EH L OW IH NG
FELLOWLY	F EH L OW L IY
FELLOWMAN	F EH L OW M AE N
FELLOWMEN	F EH L OW M EH N
FELLOWS	F EH L OW Z
FELLOWSHIP	F EH L OW SH IH P
FELLOWSHIPED	F EH L OW SH IH P T
FELLOWSHIPING	F EH L OW SH IH P IH NG
FELLOWSHIPPED	F EH L OW SH IH P T
FELLOWSHIPPING	F EH L OW SH IH P IH NG
FELLOWSHIPS	F EH L OW SH IH P S
FENCEROW	F EH N S R OW
FENCEROWS	F EH N S R OW Z
FIREPOWER	F AY R P AW ER
FIREPOWERS	F AY ER P AW ER Z
FISHBOWL	F IH SH B OW L
FISHBOWLS	F IH SH B OW L Z
FLAMETHROWER	F L EY M TH R OW ER
FLAMETHROWERS	F L EY M TH R OW ER Z
FLOW	F L OW
FLOWAGE	F L OW IH JH
FLOWAGES	F L OW IH JH IH Z
FLOWCHART	F L OW CH AA R T
FLOWCHARTING	F L OW CH AA R T IH NG
FLOWCHARTINGS	F L OW CH AA R T IH NG Z
FLOWCHARTS	F L OW CH AA R T S
FLOWED	F L OW D
FLOWER	F L AW ER
FLOWERAGE	F L AW ER IH JH
FLOWERAGES	F L AW ER IH JH IH Z
FLOWERBED	F L AW ER B EH D
FLOWERBEDS	F L AW ER B EH D Z
FLOWERED	F L AW ER D
FLOWERER	F L AW ER ER
FLOWERERS	F L AW ER ER Z
FLOWERET	F L OW AH R AH T
FLOWERETS	F L OW AH R AH T S
FLOWERETTE	F L AW ER EH T
FLOWERETTES	F L AW ER EH T S
FLOWERFUL	F L AW ER F AH L
FLOWERIER	F L OW AH R IY ER
FLOWERIEST	F L OW AH R IY AH S T
FLOWERILY	F L OW AH R IY L IY
FLOWERINESS	F L OW AH R IY N AH S
FLOWERINESSES	F L OW AH R IY N AH S IH Z
FLOWERING	F L AW ER IH NG
FLOWERLESS	F L AW ER L AH S
FLOWERLIKE	F L AW ER L AY K
FLOWERPOT	F L AW ER P AA T
FLOWERPOTS	F L AW ER P AA T S
FLOWERS	F L AW ER Z
FLOWERY	F L AW ER IY
FLOWING	F L OW IH NG
FLOWINGLY	F L OW IH NG L IY
FLOWMETER	F L OW M IY T ER
FLOWMETERS	F L OW M IY T ER Z
FLOWN	F L OW N
FLOWS	F L OW Z
FLOWSTONE	F L OW S T OW N
FLOWSTONES	F L OW S T OW N Z
FLYBLOW	F L AY B L OW
FLYBLOWING	F L AY B L OW IH NG
FLYBLOWN	F L AY B L OW N
FLYBLOWS	F L AY B L OW Z
FOAMFLOWER	F OW M F L AW ER
FOAMFLOWERS	F OW M F L AW ER Z
FOGBOW	F AA G B AW
FOGBOWS	F AA G B AW Z
FOLLOW	F AA L OW
FOLLOWED	F AA L OW D
FOLLOWER	F AA L OW ER
FOLLOWERS	F AA L OW ER Z
FOLLOWERSHIP	F AA L OW ER SH IH P
FOLLOWERSHIPS	F AA L OW ER SH IH P S
FOLLOWING	F AA L OW IH NG
FOLLOWINGS	F AA L OW IH NG Z
FOLLOWS	F AA L OW Z
FOLLOWUP	F AA L OW AH P
FOLLOWUPS	F AA L OW AH P S
FOREKNOW	F OW R N OW
FOREKNOWING	F OW R N OW IH NG
FOREKNOWLEDGE	F OW R N AA L IH JH
FOREKNOWLEDGES	F OW R N AA L IH JH IH Z
FOREKNOWN	F OW R N OW N
FOREKNOWS	F OW R N OW Z
FORESHADOW	F AO R SH AE D OW
FORESHADOWED	F AO R SH AE D OW D
FORESHADOWER	F OW R SH AE D OW ER
FORESHADOWERS	F OW R SH AE D OW ER Z
FORESHADOWING	F AO R SH AE D OW IH NG
FORESHADOWS	F AO R SH AE D OW Z
FORESHOW	F OW R SH OW
FORESHOWED	F OW R SH OW D
FORESHOWING	F OW R SH OW IH NG
FORESHOWN	F OW R SH OW N
FORESHOWS	F OW R SH OW Z
FOWL	F AW L
FOWLED	F AW L D
FOWLER	F AW L ER
FOWLERS	F AW L ER Z
FOWLING	F AW L IH NG
FOWLINGS	F AW L IH NG Z
FOWLPOX	F AW L P AA K S
FOWLPOXES	F AW L P AA K S IH Z
FOWLS	F AW L Z
FROW	F R OW
FROWARD	F R OW AH R D
FROWARDLY	F R OW AA R D L IY
FROWARDNESS	F R OW AA R D N AH S
FROWARDNESSES	F R OW AA R D N EH S AH Z
FROWN	F R AW N
FROWNED	F R AW N D
FROWNER	F R AW N ER
FROWNERS	F R AW N ER Z
FROWNING	F R AW N IH NG
FROWNINGLY	F R AW N IH NG L IY
FROWNS	F R AW N Z
FROWS	F R OW Z
FROWSIER	F R OW S AY AH R
FROWSIEST	F R OW S AY AH S T
FROWST	F R OW S T
FROWSTED	F R OW S T AH D
FROWSTIER	F R OW S T AY AH R
FROWSTIEST	F R OW S T AY AH S T
FROWSTING	F R OW S T AH NG
FROWSTS	F R OW S T S
FROWSTY	F R OW S T IY
FROWSY	F R OW Z IY
FROWZIER	F R AW Z IY ER
FROWZIEST	F R AW Z IY AH S T
FROWZILY	F R AW Z IY L IY
FROWZY	F R AW Z IY
FURBELOW	F ER B IH L OW
FURBELOWED	F ER B IH L OW D
FURBELOWING	F ER B IH L OW IH NG
FURBELOWS	F ER B IH L OW Z
FURROW	F ER OW
FURROWED	F ER OW D
FURROWER	F ER OW ER
FURROWERS	F ER OW ER Z
FURROWING	F ER OW IH NG
FURROWS	F ER OW Z
FURROWY	F ER OW IY
GALLOWGLASS	G AE L OW G L AE S
GALLOWGLASSES	G AE L OW G L AE S IH Z
GALLOWS	G AE L OW Z
GALLOWSES	G AE L OW Z IH Z
GANGPLOW	G AE NG P L AW
GANGPLOWS	G AE NG P L AW Z
GILLYFLOWER	G IH L IY F L AW ER
GILLYFLOWERS	G IH L IY F L AW ER Z
GLASSBLOWER	G L AE S B L OW ER
GLASSBLOWERS	G L AE S B L OW ER Z
GLASSBLOWING	G L AE S B L OW IH NG
GLASSBLOWINGS	G L AE S B L OW IH NG Z
GLOBEFLOWER	G L OW B F L AW ER
GLOBEFLOWERS	G L OW B F L AW ER Z
GLOW	G L OW
GLOWED	G L OW D
GLOWER	G L AW ER
GLOWERED	G L AW ER D
GLOWERING	G L AW ER IH NG
GLOWERS	G L AW ER Z
GLOWFLIES	G L OW F L AY Z
GLOWFLY	G L OW F L AY
GLOWING	G L OW IH NG
GLOWINGLY	G L OW IH NG L IY
GLOWS	G L OW Z
GLOWWORM	G L OW W ER M
GLOWWORMS	G L OW W ER M Z
GODOWN	G OW D AW N
GODOWNS	G OW D AW N Z
GOWAN	G AW AH N
GOWANED	G OW W EY N D
GOWANS	G AW AH N Z
GOWANY	G OW W EY N IY
GOWD	G OW D
GOWDS	G OW D Z
GOWK	G OW K
GOWKS	G OW K S
GOWN	G AW N
GOWNED	G AW N D
GOWNING	G AW N IH NG
GOWNS	G AW N Z
GOWNSMAN	G AW N Z M AE N
GOWNSMEN	G AW N Z M EH N
GROW	G R OW
GROWABLE	G R OW AH B AH L
GROWER	G R OW ER
GROWERS	G R OW ER Z
GROWING	G R OW IH NG
GROWINGLY	G R OW IH NG L IY
GROWL	G R AW L
GROWLED	G R AW L D
GROWLER	G R AW L ER
GROWLERS	G R AW L ER Z
GROWLIER	G R OW L IY ER
GROWLIEST	G R OW L IY AH S T
GROWLINESS	G R OW L IY N AH S
GROWLINESSES	G R OW L IY N AH S IH Z
GROWLING	G R OW L IH NG
GROWLINGLY	G R AW L IH NG L IY
GROWLS	G R AW L Z
GROWLY	G R OW L IY
GROWN	G R OW N
GROWNUP	G R OW N AH P
GROWNUPS	G R OW N AH P S
GROWS	G R OW Z
GROWTH	G R OW TH
GROWTHIER	G R OW TH IY ER
GROWTHIEST	G R OW TH IY AH S T
GROWTHINESS	G R OW TH IY N AH S
GROWTHINESSES	G R OW TH IY N AH S IH Z
GROWTHS	G R OW TH S
GROWTHY	G R OW TH IY
GUNPOWDER	G AH N P AW D ER
GUNPOWDERS	G AH N P AW D ER Z
HALLOW	HH AE L OW
HALLOWED	HH AE L OW D
HALLOWER	HH AE L OW ER
HALLOWERS	HH AE L OW ER Z
HALLOWING	HH AE L OW IH NG
HALLOWS	HH AE L OW Z
HANDBARROW	HH AE N D B AE R OW
HANDBARROWS	HH AE N D B AE R OW Z
HANDBLOWN	HH AE N D B L OW N
HARROW	HH AE R OW
HARROWED	HH AE R OW D
HARROWER	HH AE R OW W ER
HARROWERS	HH AE R OW ER Z
HARROWING	HH EH R OW IH NG
HARROWS	HH AE R OW Z
HAYMOW	HH EY M AW
HAYMOWS	HH EY M AW Z
HEDGEROW	HH EH JH R OW
HEDGEROWS	HH EH JH R OW Z
HEREINBELOW	HH IY R IY N B AH L OW
HIGHBROW	HH AY B R AW
HIGHBROWED	HH AY B R AW D
HIGHBROWISM	HH AY B R AW IH Z AH M
HIGHBROWISMS	HH AY B R AW IH Z AH M Z
HIGHBROWS	HH AY B R AW Z
HOEDOWN	HH OW D AW N
HOEDOWNS	HH OW D AW N Z
HOLLOW	HH AA L OW
HOLLOWARE	HH AA L OW AH R
HOLLOWARES	HH AA L OW AH R Z
HOLLOWED	HH AA L OW D
HOLLOWER	HH AA L OW ER
HOLLOWEST	HH AA L OW AH S T
HOLLOWING	HH AA L OW IH NG
HOLLOWLY	HH AA L OW L IY
HOLLOWNESS	HH AA L OW N AH S
HOLLOWNESSES	HH AA L OW N AH S IH Z
HOLLOWS	HH AA L OW Z
HOLLOWWARE	HH AA L OW W EH R
HOLLOWWARES	HH AA L OW W EH R Z
HOMEGROWN	HH OW M G R OW N
HOMEOWNER	HH OW M OW N ER
HOMEOWNERS	HH OW M OW N ER Z
HOMETOWN	HH OW M T AW N
HOMETOWNS	HH OW M T AW N Z
HOOSEGOW	HH UW S AW
HOOSEGOWS	HH UW S AW Z
HOOSGOW	HH UW Z OW
HOOSGOWS	HH UW Z OW Z
HORSEPOWER	HH AO R S P AW ER
HORSEPOWERS	HH AO R S P AW ER Z
HOW	HH AW
HOWBEIT	HH OW B IY T
HOWDAH	HH OW D AH
HOWDAHS	HH OW D AH Z
HOWDIE	HH OW D AY
HOWDIED	HH OW D AY D
HOWDIES	HH OW D AY Z
HOWDY	HH AW D IY
HOWDYING	HH OW D AY AH NG
HOWE	HH AW
HOWES	HH AW Z
HOWEVER	HH AW EH V ER
HOWF	HH OW F
HOWFF	HH OW F
HOWFFS	HH OW F S
HOWFS	HH OW F S
HOWITZER	HH AW AH T S ER
HOWITZERS	HH AW AH T S ER Z
HOWK	HH AW K
HOWKED	HH OW K T
HOWKING	HH OW K AH NG
HOWKS	HH OW K S
HOWL	HH AW L
HOWLED	HH AW L D
HOWLER	HH AW L ER
HOWLERS	HH AW L ER Z
HOWLET	HH OW L AH T
HOWLETS	HH OW L AH T S
HOWLING	HH AW L IH NG
HOWLINGLY	HH AW L IH NG L IY
HOWLS	HH AW L Z
HOWS	HH AW Z
HOWSOEVER	HH OW S OW AH V AH R
HYDROPOWER	HH AY D R OW P AW R
HYDROPOWERS	HH IH D R AA P OW AH R Z
IMBOWER	IH M B AW ER
IMBOWERED	IH M B AW ER D
IMBOWERING	IH M B AW ER IH NG
IMBOWERS	IH M B AW ER Z
IMBROWN	IH M B R AW N
IMBROWNED	IH M B R AW N D
IMBROWNING	IH M B R AW N IH NG
IMBROWNS	IH M B R AW N Z
IMPOWER	IH M P AW ER
IMPOWERED	IH M P AW ER D
IMPOWERING	IH M P AW ER IH NG
IMPOWERS	IH M P AW ER Z
INDOW	IH N D AW
INDOWED	IH N D AW D
INDOWING	IH N D AW IH NG
INDOWS	IH N D AW Z
INFLOW	IH N F L OW
INFLOWS	IH N F L OW Z
INGROWING	IH N G R OW IH NG
INGROWN	IH N G R OW N
INGROWNNESS	IH N G R OW N AH S
INGROWNNESSES	IH N G R OW N AH S IH Z
INGROWTH	IH N G R OW TH
INGROWTHS	IH N G R OW TH S
INTERFLOW	IH N T ER F L OW
INTERGROWTH	IH N T ER G R OW TH
INTERGROWTHS	IH N T ER G R OW TH S
INTERROW	IH N T ER R OW
INTOWN	IH N T AW N
JOW	JH OW
JOWAR	JH OW AH R
JOWARS	JH OW AH R Z
JOWED	JH OW D
JOWING	JH OW AH NG
JOWL	JH AW L
JOWLED	JH AW L D
JOWLIER	JH AW L IY ER
JOWLIEST	JH AW L IY AH S T
JOWLS	JH AW L Z
JOWLY	JH AW L IY
JOWS	JH OW Z
KILOWATT	K IH L AH W AA T
KILOWATTS	K IH L AH W AA T S
KNOCKDOWN	N AA K D AW N
KNOCKDOWNS	N AA K D AW N Z
KNOW	N OW
KNOWABLE	N OW AH B AH L
KNOWER	N OW ER
KNOWERS	N OW ER Z
KNOWING	N OW IH NG
KNOWINGER	N OW IH NG ER
KNOWINGEST	N OW IH N JH EH S T
KNOWINGLY	N OW IH NG L IY
KNOWINGNESS	N OW IH NG N AH S
KNOWINGNESSES	N OW IH NG N AH S IH Z
KNOWINGS	N OW IH NG Z
KNOWLEDGE	N AA L AH JH
KNOWLEDGE(2)	N AA L IH JH
KNOWLEDGEABILITIES	N AA L IH JH AH B IH L AH T EH Z
KNOWLEDGEABILITY	N AA L IH JH AH B IH L AH T EH
KNOWLEDGEABLE	N AA L AH JH AH B AH L
KNOWLEDGEABLENESS	N AA L IH JH AH B AH L N AH S
KNOWLEDGEABLENESSES	N AA L IH JH AH B AH L N AH S IH Z
KNOWLEDGEABLY	N AA L IH JH AH B L IY
KNOWLEDGES	N AA L IH JH IH Z
KNOWN	N OW N
KNOWNS	N OW N Z
KNOWS	N OW Z
KOTOW	K AA T OW
KOTOWED	K AH T OW D
KOTOWER	K AA T OW AH R
KOTOWERS	K AA T OW AH R Z
KOTOWING	K AA T OW AH NG
KOTOWS	K AH T OW Z
KOWTOW	K AW T AW
KOWTOW(2)	K OW T OW
KOWTOWED	K OW T OW D
KOWTOWER	K OW T OW AH R
KOWTOWERS	K OW T OW AH R Z
KOWTOWING	K OW T OW AH NG
KOWTOWS	K OW T OW Z
LANDOWNER	L AE N D OW N ER
LANDOWNERS	L AE N D OW N ER Z
LANDOWNERSHIP	L AE N D OW N ER SH IH P
LANDOWNERSHIPS	L AE N D OW N ER SH IH P S
LANDOWNING	L AE N D OW N IH NG
LANDOWNINGS	L AE N D OW N IH NG Z
LAWNMOWER	L AO N M OW ER
LAWNMOWERS	L AO N M OW ER Z
LETDOWN	L EH T D AW N
LETDOWNS	L EH T D AW N Z
LOBBYGOW	L AA B AH G OW
LOBBYGOWS	L AA B AH G OW Z
LOCKDOWN	L AA K D AW N
LOCKDOWNS	L AA K D AW N Z
LOCOWEED	L AA K OW IY D
LOCOWEEDS	L AA K OW IY D Z
LONGBOW	L AO NG B OW
LONGBOWMAN	L AO NG B OW M AH N
LONGBOWMEN	L AO NG B AW M EH N
LONGBOWS	L AO NG B AW Z
LOOKDOWN	L UH K D AW N
LOOKDOWNS	L UH K D AW N Z
LOW	L OW
LOWBALL	L OW B AO L
LOWBALLED	L OW B AO L D
LOWBALLING	L OW B AO L IH NG
LOWBALLS	L OW B AO L Z
LOWBORN	L OW B AO R N
LOWBOY	L OW B OY
LOWBOYS	L OW B OY Z
LOWBRED	L OW B R EH D
LOWBROW	L OW B R AW
LOWBROWS	L OW B R AW Z
LOWDOWN	L OW D AW N
LOWDOWNS	L OW D AW N Z
LOWE	L OW
LOWED	L OW D
LOWER	L OW ER
LOWERCASE	L OW ER K EY S
LOWERCASED	L OW ER K EY S T
LOWERCASES	L OW ER K EY S IH Z
LOWERCASING	L OW ER K EY S IH NG
LOWERCLASSMAN	L OW ER K L AE S M AE N
LOWERCLASSMEN	L OW ER K L AE S M EH N
LOWERED	L OW ER D
LOWERING	L OW ER IH NG
LOWERMOST	L OW ER M OW S T
LOWERS	L OW ER Z
LOWERY	L AW ER IY
LOWES	L OW Z
LOWEST	L OW AH S T
LOWING	L OW IH NG
LOWINGS	L OW IH NG Z
LOWISH	L OW IH SH
LOWLAND	L OW L AE N D
LOWLANDER	L OW L AE N D ER
LOWLANDERS	L OW L AE N D ER Z
LOWLANDS	L OW L AE N D Z
LOWLIER	L OW L IY ER
LOWLIEST	L OW L IY AH S T
LOWLIFE	L OW L AY F
LOWLIFER	L OW L AY F ER
LOWLIFERS	L OW L AY F ER Z
LOWLIFES	L OW L AY F S
LOWLIGHT	L OW L AY T
LOWLIGHTS	L OW L AY T S
LOWLIHEAD	L OW L AH HH IY D
LOWLIHEADS	L OW L AH HH IY D Z
LOWLINESS	L OW L IY N AH S
LOWLINESSES	L OW L IY N AH S IH Z
LOWLIVES	L OW L IH V Z
LOWLY	L OW L IY
LOWN	L AW N
LOWNESS	L OW N AH S
LOWNESSES	L OW N AH S IH Z
LOWRIDER	L OW R AY D ER
LOWRIDERS	L OW R AY D ER Z
LOWS	L OW Z
LOWSE	L OW S
MALLOW	M AE L OW
MALLOWS	M AE L OW Z
MANPOWER	M AE N P AW ER
MANPOWERS	M AE N P AW ER Z
MARKDOWN	M AA R K D AW N
MARKDOWNS	M AA R K D AW N Z
MARROW	M EH R OW
MARROWBONE	M AE R OW B OW N
MARROWBONES	M AE R OW B OW N Z
MARROWED	M AE R OW D
MARROWFAT	M AE R OW F AE T
MARROWFATS	M AE R OW F AE T S
MARROWING	M AE R OW IH NG
MARROWS	M AE R OW Z
MARROWY	M AE R OW IY
MARSHMALLOW	M AA R SH M EH L OW
MARSHMALLOWS	M AA R SH M EH L OW Z
MARSHMALLOWY	M AA R SH M EH L OW IY
MAYFLOWER	M EY F L AW ER
MAYFLOWERS	M EY F L AW ER Z
MEADOW	M EH D OW
MEADOWLAND	M EH D OW L AE N D
MEADOWLANDS	M EH D OW L AE N D Z
MEADOWLARK	M EH D OW L AA R K
MEADOWLARKS	M EH D OW L AA R K S
MEADOWS	M EH D OW Z
MEADOWSWEET	M EH D OW S W IY T
MEADOWSWEETS	M EH D OW S W IY T S
MEADOWY	M EH D OW IY
MELLOW	M EH L OW
MELLOWED	M EH L OW D
MELLOWER	M EH L OW ER
MELLOWEST	M EH L OW AH S T
MELLOWING	M EH L OW IH NG
MELLOWLY	M EH L OW L IY
MELLOWNESS	M EH L OW N AH S
MELLOWNESSES	M EH L OW N AH S IH Z
MELLOWS	M EH L OW Z
MELTDOWN	M EH L T D AW N
MELTDOWNS	M EH L T D AW N Z
MEOW	M IY AW
MEOWED	M IY OW D
MEOWING	M IY OW AH NG
MEOWS	M IY OW Z
MIAOW	M AY AH OW
MIAOWED	M AY AH OW D
MIAOWING	M AY AE OW AH NG
MIAOWS	M AY AH OW Z
MICROWATT	M AY K R OW W AA T
MICROWATTS	M AY K R OW W AA T S
MICROWAVABLE	M AY K R OW W EY V AH B AH L
MICROWAVE	M AY K R AH W EY V
MICROWAVEABLE	M AY K R OW W EY V AH B AH L
MICROWAVED	M AY K R OW W EY V D
MICROWAVES	M AY K R OW W EY V Z
MICROWAVING	M AY K R AH W EY V IH NG
MICROWORLD	M AY K R OW W ER L D
MICROWORLDS	M AY K R OW W ER L D Z
MIDDLEBROW	M IH D AH L B R AW
MIDDLEBROWS	M IH D AH L B R AW Z
MIDTOWN	M IH D T AW N
MIDTOWNS	M IH D T AW N Z
MINDBLOWER	M AY N D B L OW ER
MINDBLOWERS	M AY N D B L OW ER Z
MINNOW	M IH N OW
MINNOWS	M IH N OW Z
MISGROW	M IH S G R OW
MISGROWING	M IH S G R OW IH NG
MISGROWN	M IH S G R OW N
MISGROWS	M IH S G R OW Z
MISKNOW	M IH S N OW
MISKNOWING	M IH S N OW IH NG
MISKNOWLEDGE	M IH S N AA L IH JH
MISKNOWLEDGES	M IH S N AA L IH JH IH Z
MISKNOWN	M IH S N OW N
MISKNOWS	M IH S N OW Z
MISTBOW	M IH S T B AW
MISTBOWS	M IH S T B AW Z
MISTHROW	M IH S TH R OW
MISTHROWING	M IH S TH R OW IH NG
MISTHROWN	M IH S TH R OW N
MISTHROWS	M IH S TH R OW Z
MOONBOW	M UW N B AW
MOONBOWS	M UW N B AW Z
MOONFLOWER	M UW N F L AW ER
MOONFLOWERS	M UW N F L AW ER Z
MOORFOWL	M UH R F AW L
MOORFOWLS	M UH R F AW L Z
MORROW	M AA R OW
MORROW(2)	M AO R OW
MORROWS	M AA R OW Z
MOW	M OW
MOWED	M OW D
MOWER	M OW ER
MOWERS	M OW ER Z
MOWING	M AW IH NG
MOWINGS	M AW IH NG Z
MOWN	M OW N
MOWS	M AW Z
MUDFLOW	M AH D F L OW
MUDFLOWS	M AH D F L OW Z
MULTIPOWER	M AH L T AY P AW ER
MULTITOWERED	M AH L T AY T AW ER D
NANOWATT	N AE N OW AH T
NANOWATTS	N AE N OW AH T S
NARROW	N EH R OW
NARROW(2)	N AE R OW
NARROWBAND	N AE R OW B AE N D
NARROWCASTING	N AE R OW K AE S T IH NG
NARROWCASTINGS	N AE R OW K AE S T IH NG Z
NARROWED	N EH R OW D
NARROWER	N EH R OW ER
NARROWEST	N EH R OW AH S T
NARROWING	N EH R OW IH NG
NARROWLY	N EH R OW L IY
NARROWNESS	N EH R OW N AH S
NARROWNESSES	N AE R OW N AH S IH Z
NARROWS	N EH R OW Z
NEWMOWN	N Y UW M OW N
NIGHTGLOW	N AY T G L OW
NIGHTGLOWS	N AY T G L OW Z
NIGHTGOWN	N AY T G AW N
NIGHTGOWNS	N AY T G AW N Z
NOHOW	N AA HH OW
NONFLOWERING	N AA N F L AW ER IH NG
NONGROWING	N AA N G R OW IH NG
NONGROWTH	N AA N G R OW TH
NONLANDOWNER	N AA N L AE N D OW N ER
NONLANDOWNERS	N AA N L AE N D OW N ER Z
NONOWNER	N AA N OW N ER
NONOWNERS	N AA N OW N ER Z
NONYELLOWING	N AA N Y EH L OW IH NG
NOW	N AW
NOWADAYS	N AW AH D EY Z
NOWAY	N OW EY IY
NOWAYS	N OW EY Z
NOWHERE	N OW W EH R
NOWHERE(2)	N OW HH W EH R
NOWHERES	N OW W EH ER Z
NOWHITHER	N OW HH AH DH AH R
NOWISE	N AH W AY Z
NOWNESS	N OW N AH S
NOWNESSES	N OW N EH S AH Z
NOWS	N AW Z
NOWT	N OW T
NOWTS	N OW T S
NUTBROWN	N AH T B R AW N
OUTCROW	AW T K R OW
OUTCROWED	AW T K R OW D
OUTCROWING	AW T K R OW IH NG
OUTCROWS	AW T K R OW Z
OUTFLOW	AW T F L OW
OUTFLOWED	AW T F L OW D
OUTFLOWING	AW T F L OW IH NG
OUTFLOWN	AW T F L OW N
OUTFLOWS	AW T F L OW Z
OUTFROWN	AW T F R AW N
OUTFROWNED	AW T F R AW N D
OUTFROWNING	AW T F R AW N IH NG
OUTFROWNS	AW T F R AW N Z
OUTGLOW	AW T G L OW
OUTGLOWED	AW T G L OW D
OUTGLOWING	AW T G L OW IH NG
OUTGLOWS	AW T G L OW Z
OUTGROW	AW T G R OW
OUTGROWING	AW T G R OW IH NG
OUTGROWN	AW T G R OW N
OUTGROWS	AW T G R OW Z
OUTGROWTH	AW T G R OW TH
OUTGROWTHS	AW T G R OW TH S
OUTHOWL	AW T HH AW L
OUTHOWLED	AW T HH AW L D
OUTHOWLING	AW T HH AW L IH NG
OUTHOWLS	AW T HH AW L Z
OUTPOWER	AW T P AW ER
OUTPOWERED	AW T P AW ER D
OUTPOWERING	AW T P AW ER IH NG
OUTPOWERS	AW T P AW ER Z
OUTROW	AW T R OW
OUTROWED	AW T R OW D
OUTROWING	AW T R OW IH NG
OUTROWS	AW T R OW Z
OUTTHROW	AW T TH R OW
OUTTHROWING	AW T TH R OW IH NG
OUTTHROWN	AW T TH R OW N
OUTTHROWS	AW T TH R OW Z
OUTTOWER	AW T AW ER
OUTTOWERED	AW T AW ER D
OUTTOWERING	AW T AW ER IH NG
OUTTOWERS	AW T AW ER Z
OVERBLOW	OW V ER B L OW
OVERBLOWING	OW V ER B L OW IH NG
OVERBLOWN	OW V ER B L OW N
OVERBLOWS	OW V ER B L OW Z
OVERBORROW	OW V ER B AA R OW
OVERBORROWED	OW V ER B AA R OW D
OVERBORROWING	OW V ER B AA R OW IH NG
OVERBORROWS	OW V ER B AA R OW Z
OVERBROWSE	OW V ER B R AW Z
OVERBROWSED	OW V ER B R AW Z D
OVERBROWSES	OW V ER B R AW Z IH Z
OVERBROWSING	OW V ER B R AW Z IH NG
OVERCROWD	OW V ER K R AW D
OVERCROWDED	OW V ER K R AW D IH D
OVERCROWDING	OW V ER K R AW D IH NG
OVERCROWDS	OW V ER K R AW D Z
OVERFLOW	OW V ER F L OW
OVERFLOWED	OW V ER F L OW D
OVERFLOWING	OW V ER F L OW IH NG
OVERFLOWN	OW V ER F L OW N
OVERFLOWS	OW V ER F L OW Z
OVERGROW	OW V ER G R OW
OVERGROWING	OW V ER G R OW W IH NG
OVERGROWN	OW V ER G R OW N
OVERGROWS	OW V ER G R OW Z
OVERGROWTH	OW V ER G R OW TH
OVERGROWTHS	OW V ER G R OW TH S
OVERPOWER	OW V ER P AW ER
OVERPOWERED	OW V ER P AW ER D
OVERPOWERING	OW V ER P AW R IH NG
OVERPOWERINGLY	OW V ER P AW ER IH NG L IY
OVERPOWERS	OW V ER P AW ER Z
OVERSHADOW	OW V ER SH AE D OW
OVERSHADOWED	OW V ER SH AE D OW D
OVERSHADOWING	OW V ER SH AE D OW IH NG
OVERSHADOWS	OW V ER SH AE D OW Z
OVERSLOW	OW V ER S L OW
OVERTHROW	OW V ER TH R OW
OVERTHROWING	OW V ER TH R OW IH NG
OVERTHROWN	OW V ER TH R OW N
OVERTHROWS	OW V ER TH R OW Z
OW	OW
OW(2)	AW
OWE	OW
OWED	OW D
OWES	OW Z
OWING	OW IH NG
OWL	AW L
OWLET	OW L AH T
OWLETS	OW L AH T S
OWLISH	AW L IH SH
OWLISHLY	AW L IH SH L IY
OWLISHNESS	AW L IH SH N AH S
OWLISHNESSES	AW L IH SH N AH S IH Z
OWLLIKE	AW L AY K
OWLS	AW L Z
OWN	OW N
OWNABLE	OW N AH B AH L
OWNED	OW N D
OWNER	OW N ER
OWNERS	OW N ER Z
OWNERSHIP	OW N ER SH IH P
OWNERSHIPS	OW N ER SH IH P S
OWNING	OW N IH NG
OWNS	OW N Z
OWSE	OW S
OWSEN	OW Z AH N
OXBOW	AA K S B OW
OXBOWS	AA K S B AW Z
PANDOWDIES	P AE N D AW D AY Z
PANDOWDY	P AE N D OW D IY
PASQUEFLOWER	P AE S W EH F L OW AH R
PASQUEFLOWERS	P AE S W EH F L OW AH R Z
PASSIONFLOWER	P AE SH AH N F L AW ER
PASSIONFLOWERS	P AE SH AH N F L AW ER Z
PASTEDOWN	P EY S T D AW N
PASTEDOWNS	P EY S T D AW N Z
PAULOWNIA	P AH L OW N IY AH
PAULOWNIAS	P AH L OW N IY AH Z
PEAFOWL	P IY F AW L
PEAFOWLS	P IY F AW L Z
PEEPSHOW	P IY P SH OW
PEEPSHOWS	P IY P SH OW Z
PHASEDOWN	F EY Z D AW N
PHASEDOWNS	F EY Z D AW N Z
PILLOW	P IH L OW
PILLOWCASE	P IH L OW K EY S
PILLOWCASES	P IH L OW K EY S IH Z
PILLOWED	P IH L OW D
PILLOWING	P IH L OW IH NG
PILLOWS	P IH L OW Z
PILLOWY	P IH L OW IY
PLAYDOWN	P L EY D AW N
PLAYDOWNS	P L EY D AW N Z
PLAYFELLOW	P L EY F EH L OW
PLAYFELLOWS	P L EY F EH L OW Z
PLOW	P L AW
PLOWABLE	P L AW AH B AH L
PLOWBACK	P L AW B AE K
PLOWBACKS	P L AW B AE K S
PLOWBOY	P L AW B OY
PLOWBOYS	P L AW B OY Z
PLOWED	P L AW D
PLOWER	P L AW ER
PLOWERS	P L AW ER Z
PLOWHEAD	P L AW HH EH D
PLOWHEADS	P L AW HH EH D Z
PLOWING	P L AW IH NG
PLOWLAND	P L AW L AE N D
PLOWLANDS	P L AW L AE N D Z
PLOWMAN	P L AW M AH N
PLOWMEN	P L AW M EH N
PLOWS	P L AW Z
PLOWSHARE	P L AW SH EY R
PLOWSHARES	P L AW SH EY R Z
POSTSHOW	P OW S T SH OW
POW	P AW
POWDER	P AW D ER
POWDERED	P AW D ER D
POWDERER	P AW D ER ER
POWDERERS	P AW D ER ER Z
POWDERING	P AW D ER IH NG
POWDERLESS	P AW D ER L AH S
POWDERLIKE	P AW D ER L AY K
POWDERS	P AW D ER Z
POWDERY	P AW D ER IY
POWER	P AW ER
POWERBOAT	P AW ER B OW T
POWERBOATS	P AW ER B OW T S
POWERBROKER	P AW ER B R OW K ER
POWERBROKERS	P AW ER B R OW K ER Z
POWERED	P AW ER D
POWERFUL	P AW ER F AH L
POWERFULLY	P AW ER F L IY
POWERHOUSE	P AW ER HH AW S
POWERHOUSES	P AW ER HH AW S IH Z
POWERING	P AW ER IH NG
POWERLESS	P AW ER L AH S
POWERLESSLY	P AW ER L AH S L IY
POWERLESSNESS	P AW ER L AH S N AH S
POWERLESSNESSES	P AW ER L AH S N AH S IH Z
POWERS	P AW ER Z
POWS	P OW Z
POWTER	P AW T ER
POWTERS	P OW T AH R Z
POWWOW	P AW W AW
POWWOWED	P OW W OW D
POWWOWING	P OW W OW AH NG
POWWOWS	P AW W AW Z
PRESHOW	P R IY SH OW
PRESHOWED	P R IY SH OW D
PRESHOWING	P R IY SH OW IH NG
PRESHOWN	P R IY SH OW N
PRESHOWS	P R IY SH OW Z
PROW	P R AW
PROWAR	P R OW W AO R
PROWER	P R AW ER
PROWESS	P R AW AH S
PROWESSES	P R AW AH S IH Z
PROWEST	P R OW W EH S T
PROWL	P R AW L
PROWLED	P R AW L D
PROWLER	P R AW L ER
PROWLERS	P R AW L ER Z
PROWLING	P R AW L IH NG
PROWLS	P R AW L Z
PROWS	P R AW Z
PUSHDOWN	P UH SH D AW N
PUSHDOWNS	P UH SH D AW N Z
PUTDOWN	P UH T D AW N
PUTDOWNS	P UH T D AW N Z
RAINBOW	R EY N B OW
RAINBOWLIKE	R EY N B AW L AY K
RAINBOWS	R EY N B OW Z
REAVOW	R IY AH V AW
REAVOWED	R IY AH V AW D
REAVOWING	R IY AH V AW IH NG
REAVOWS	R IY AH V AW Z
RECROWN	R IY K R AW N
RECROWNED	R IY K R AW N D
RECROWNING	R IY K R AW N IH NG
RECROWNS	R IY K R AW N Z
REDOWA	R AH D OW AH
REDOWAS	R AH D OW AH Z
REENDOW	R IY EH N D AW
REENDOWED	R IY EH N D AW D
REENDOWING	R IY EH N D AW IH NG
REENDOWS	R IY EH N D AW Z
REFLOW	R IY F L OW
REFLOWED	R IY F L OW D
REFLOWER	R IY F L AW ER
REFLOWERED	R IY F L AW ER D
REFLOWERING	R IY F L AW ER IH NG
REFLOWERS	R IY F L AW ER Z
REFLOWING	R IY F L OW IH NG
REFLOWN	R IY F L OW N
REFLOWS	R IY F L OW Z
REGLOW	R IY G L OW
REGLOWED	R IY G L OW D
REGLOWING	R IY G L OW IH NG
REGLOWS	R IY G L OW Z
REGROW	R IY G R OW
REGROWING	R IY G R OW IH NG
REGROWN	R IY G R OW N
REGROWS	R IY G R OW Z
REGROWTH	R IY G R OW TH
REGROWTHS	R IY G R OW TH S
RENOWN	R IH N AW N
RENOWNED	R IH N AW N D
RENOWNING	R IH N AW N IH NG
RENOWNS	R IH N AW N Z
REPOWER	R IY P AW ER
REPOWERED	R IY P AW ER D
REPOWERING	R IY P AW ER IH NG
REPOWERS	R IY P AW ER Z
RESHOW	R IY SH OW
RESHOWED	R IY SH OW D
RESHOWING	R IY SH OW IH NG
RESHOWN	R IY SH OW N
RESHOWS	R IY SH OW Z
RESOW	R IY S AW
RESOWED	R IY S AW D
RESOWING	R IY S AW IH NG
RESOWN	R IY S OW N
RESOWS	R IY S AW Z
ROADSHOW	R OW D SH OW
ROADSHOWS	R OW D SH OW Z
ROW	R OW
ROWABLE	R OW AH B AH L
ROWAN	R OW AH N
ROWANBERRIES	R OW AE N B EH R AY Z
ROWANBERRY	R OW AE N B EH R IY
ROWANS	R OW AH N Z
ROWBOAT	R OW B OW T
ROWBOATS	R OW B OW T S
ROWDIER	R AW D IY ER
ROWDIES	R AW D IY Z
ROWDIEST	R AW D IY AH S T
ROWDILY	R AW D IY L IY
ROWDINESS	R AW D IY N AH S
ROWDINESSES	R AW D IY N AH S IH Z
ROWDY	R AW D IY
ROWDYISH	R AW D IY IH SH
ROWDYISM	R AW D IY IH Z AH M
ROWDYISMS	R AW D IY IH Z AH M Z
ROWED	R OW D
ROWEL	R OW AH L
ROWELED	R OW IY L D
ROWELING	R OW IY L AH NG
ROWELLED	R OW AH L D
ROWELLING	R OW EH L AH NG
ROWELS	R OW AH L Z
ROWEN	R OW W AH N
ROWENS	R OW AH N Z
ROWER	R OW ER
ROWERS	R OW ER Z
ROWING	R OW IH NG
ROWINGS	R OW IH NG Z
ROWLOCK	R OW L AA K
ROWLOCKS	R OW L AA K S
ROWS	R OW Z
ROWTH	R OW TH
ROWTHS	R OW TH S
RUBDOWN	R AH B D AW N
RUBDOWNS	R AH B D AW N Z
RUNDOWN	R AH N D AW N
RUNDOWNS	R AH N D AW N Z
SADDLEBOW	S AE D AH L B AW
SADDLEBOWS	S AE D AH L B AW Z
SAFFLOWER	S AE F L AW ER
SAFFLOWERS	S AE F L OW AH R Z
SALCHOW	S AE L CH OW
SALCHOWS	S AE L CH OW Z
SALLOW	S AE L OW
SALLOWED	S AE L OW D
SALLOWER	S AE L OW ER
SALLOWEST	S AE L OW AH S T
SALLOWING	S AE L OW IH NG
SALLOWISH	S AE L OW IH SH
SALLOWLY	S AE L OW L IY
SALLOWNESS	S AE L OW N AH S
SALLOWNESSES	S AE L OW N AH S IH Z
SALLOWS	S AE L OW Z
SALLOWY	S AE L OW IY
SCARECROW	S K AE R K R OW
SCARECROWS	S K AE R K R OW Z
SCHOOLFELLOW	S K UW L F EH L OW
SCHOOLFELLOWS	S K UW L F EH L OW Z
SCOW	S K AW
SCOWDER	S K OW D AH R
SCOWDERED	S K OW D IY R D
SCOWDERING	S K OW D IY R AH NG
SCOWDERS	S K OW D AH R Z
SCOWED	S K OW D
SCOWING	S K OW AH NG
SCOWL	S K AW L
SCOWLED	S K AW L D
SCOWLER	S K AW L ER
SCOWLERS	S K AW L ER Z
SCOWLING	S K AW L IH NG
SCOWLINGLY	S K AW L IH NG L IY
SCOWLS	S K AW L Z
SCOWS	S K OW Z
SEAFOWL	S IY F AW L
SEAFOWLS	S IY F AW L Z
SEMIVOWEL	S EH M IY V AW AH L
SEMIVOWELS	S EH M IY V AW AH L Z
SEROW	S EH R OW
SEROWS	S AH R OW Z
SHADBLOW	SH AE D L OW
SHADBLOWS	SH AE D L OW Z
SHADOW	SH AE D OW
SHADOWBOX	SH AE D OW B AA K S
SHADOWBOXED	SH AE D OW B AA K S T
SHADOWBOXES	SH AE D OW B AA K S IH Z
SHADOWBOXING	SH AE D OW B AA K S IH NG
SHADOWED	SH AE D OW D
SHADOWER	SH AE D OW ER
SHADOWERS	SH AE D OW ER Z
SHADOWGRAPH	SH AE D OW G R AE F
SHADOWGRAPHIES	SH AE D OW G R AE F IY Z
SHADOWGRAPHS	SH AE D OW G R AE F S
SHADOWGRAPHY	SH AE D OW G R AE F IY
SHADOWIER	SH AE D OW IY ER
SHADOWIEST	SH AE D OW IY AH S T
SHADOWILY	SH AE D OW IY L IY
SHADOWINESS	SH AE D OW IY N AH S
SHADOWINESSES	SH AE D OW IY N AH S IH Z
SHADOWING	SH AE D OW IH NG
SHADOWLESS	SH AE D OW L AH S
SHADOWLIKE	SH AE D OW L AY K
SHADOWS	SH AE D OW Z
SHADOWY	SH AE D OW IY
SHAKEDOWN	SH EY K D AW N
SHAKEDOWNS	SH EY K D AW N Z
SHALLOW	SH AE L OW
SHALLOWED	SH AE L OW D
SHALLOWER	SH AE L OW ER
SHALLOWEST	SH AE L OW AH S T
SHALLOWING	SH AE L OW IH NG
SHALLOWLY	SH AE L OW L IY
SHALLOWNESS	SH AE L OW N AH S
SHALLOWNESSES	SH AE L OW N AH S IH Z
SHALLOWS	SH AE L OW Z
SHANTYTOWN	SH AE N T IY T AW N
SHANTYTOWNS	SH AE N T IY T AW N Z
SHIPOWNER	SH IH P OW N ER
SHIPOWNERS	SH IH P OW N ER Z
SHOPWINDOW	SH AA P W IH N D OW
SHOPWINDOWS	SH AA P W IH N D OW Z
SHOW	SH OW
SHOWABLE	SH OW AH B AH L
SHOWBIZ	SH OW B IH Z
SHOWBIZZES	SH OW B IH Z AH Z
SHOWBIZZY	SH OW B IH Z IY
SHOWBOAT	SH OW B OW T
SHOWBOATED	SH OW B OW T IH D
SHOWBOATING	SH OW B OW T IH NG
SHOWBOATS	SH OW B OW T S
SHOWBREAD	SH OW B R EH D
SHOWBREADS	SH OW B R EH D Z
SHOWCASE	SH OW K EY S
SHOWCASED	SH OW K EY S T
SHOWCASES	SH OW K EY S IH Z
SHOWCASING	SH OW K EY S IH NG
SHOWDOWN	SH OW D AW N
SHOWDOWNS	SH OW D AW N Z
SHOWED	SH OW D
SHOWER	SH AW ER
SHOWERED	SH AW ER D
SHOWERER	SH AW ER ER
SHOWERERS	SH AW ER ER Z
SHOWERHEAD	SH AW ER HH EH D
SHOWERHEADS	SH AW ER HH EH D Z
SHOWERING	SH AW ER IH NG
SHOWERLESS	SH AW ER L AH S
SHOWERS	SH AW ER Z
SHOWERY	SH OW AH R IY
SHOWGIRL	SH OW G ER L
SHOWGIRLS	SH OW G ER L Z
SHOWIER	SH OW IY ER
SHOWIEST	SH OW IY AH S T
SHOWILY	SH OW IY L IY
SHOWINESS	SH OW IY N AH S
SHOWINESSES	SH OW IY N AH S IH Z
SHOWING	SH OW IH NG
SHOWINGS	SH OW IH NG Z
SHOWMAN	SH OW M AH N
SHOWMANSHIP	SH OW M AH N SH IH P
SHOWMANSHIPS	SH OW M AE N SH IH P S
SHOWMEN	SH OW M EH N
SHOWN	SH OW N
SHOWOFF	SH OW AO F
SHOWOFFS	SH OW AO F S
SHOWPIECE	SH OW P IY S
SHOWPIECES	SH OW P IY S IH Z
SHOWPLACE	SH OW P L EY S
SHOWPLACES	SH OW P L EY S IH Z
SHOWRING	SH OW R IH NG
SHOWRINGS	SH OW R IH NG Z
SHOWROOM	SH OW R UH M
SHOWROOM(2)	SH OW R UW M
SHOWROOMS	SH OW R UW M Z
SHOWS	SH OW Z
SHOWSTOPPER	SH OW S T AA P ER
SHOWSTOPPERS	SH OW S T AA P ER Z
SHOWSTOPPING	SH OW S T AA P IH NG
SHOWTIME	SH OW T AY M
SHOWTIMES	SH OW T AY M Z
SHOWY	SH OW IY
SHUTDOWN	SH AH T D AW N
SHUTDOWNS	SH AH T D AW N Z
SIDESHOW	S AY D SH OW
SIDESHOWS	S AY D SH OW Z
SLOW	S L OW
SLOWDOWN	S L OW D AW N
SLOWDOWNS	S L OW D AW N Z
SLOWED	S L OW D
SLOWER	S L OW ER
SLOWEST	S L OW AH S T
SLOWING	S L OW IH NG
SLOWISH	S L OW IH SH
SLOWLY	S L OW L IY
SLOWNESS	S L OW N AH S
SLOWNESSES	S L OW N AH S IH Z
SLOWPOKE	S L OW P OW K
SLOWPOKES	S L OW P OW K S
SLOWS	S L OW Z
SLOWWORM	S L OW W ER M
SLOWWORMS	S L OW W ER M Z
SNOW	S N OW
SNOWBALL	S N OW B AO L
SNOWBALLED	S N OW B AO L D
SNOWBALLING	S N OW B AO L IH NG
SNOWBALLS	S N OW B AO L Z
SNOWBANK	S N OW B AE NG K
SNOWBANKS	S N OW B AE NG K S
SNOWBELL	S N OW B EH L
SNOWBELLS	S N OW B EH L Z
SNOWBELT	S N OW B EH L T
SNOWBELTS	S N OW B EH L T S
SNOWBERRIES	S N OW B EH R IY Z
SNOWBERRY	S N OW B EH R IY
SNOWBIRD	S N OW B ER D
SNOWBIRDS	S N OW B ER D Z
SNOWBLOWER	S N OW B L OW ER
SNOWBLOWERS	S N OW B L OW ER Z
SNOWBOARD	S N OW B AO R D
SNOWBOARDER	S N OW B AO R D ER
SNOWBOARDERS	S N OW B AO R D ER Z
SNOWBOARDING	S N OW B OW R D IH NG
SNOWBOARDINGS	S N OW B OW R D IH NG Z
SNOWBOARDS	S N OW B AO R D Z
SNOWBOUND	S N OW B AW N D
SNOWBRUSH	S N OW B R AH SH
SNOWBRUSHES	S N OW B R AH SH IH Z
SNOWBUSH	S N OW B UH SH
SNOWBUSHES	S N OW B UH SH IH Z
SNOWCAP	S N OW K AE P
SNOWCAPPED	S N OW K AE P T
SNOWCAPS	S N OW K AE P S
SNOWDRIFT	S N OW D R IH F T
SNOWDRIFTS	S N OW D R IH F T S
SNOWDROP	S N OW D R AA P
SNOWDROPS	S N OW D R AA P S
SNOWED	S N OW D
SNOWFALL	S N OW F AA L
SNOWFALLS	S N OW F AA L Z
SNOWFIELD	S N OW F IY L D
SNOWFIELDS	S N OW F IY L D Z
SNOWFLAKE	S N OW F L EY K
SNOWFLAKES	S N OW F L EY K S
SNOWIER	S N OW IY ER
SNOWIEST	S N OW IY AH S T
SNOWILY	S N OW IY L IY
SNOWINESS	S N OW IY N AH S
SNOWINESSES	S N OW IY N AH S IH Z
SNOWING	S N OW IH NG
SNOWLAND	S N OW L AE N D
SNOWLANDS	S N OW L AE N D Z
SNOWLESS	S N OW L AH S
SNOWLIKE	S N OW L AY K
SNOWMAKER	S N OW M EY K ER
SNOWMAKERS	S N OW M EY K ER Z
SNOWMAKING	S N OW M EY K IH NG
SNOWMAN	S N OW M AE N
SNOWMELT	S N OW M EH L T
SNOWMELTS	S N OW M EH L T S
SNOWMEN	S N OW M EH N
SNOWMOBILE	S N OW M OW B IY L
SNOWMOBILER	S N OW M OW B AH L ER
SNOWMOBILERS	S N OW M OW B AH L ER Z
SNOWMOBILES	S N OW M OW B IY L Z
SNOWMOBILING	S N OW M OW B AH L IH NG
SNOWMOBILINGS	S N OW M OW B AH L IH NG Z
SNOWMOBILIST	S N OW M OW B AH L IH S T
SNOWMOBILISTS	S N OW M OW B AH L IH S T S
SNOWMOLD	S N OW M OW L D
SNOWMOLDS	S N OW M OW L D Z
SNOWPACK	S N OW P AE K
SNOWPACKS	S N OW P AE K S
SNOWPLOW	S N OW P L AW
SNOWPLOWED	S N OW P L AW D
SNOWPLOWING	S N OW P L AW IH NG
SNOWPLOWS	S N OW P L AW Z
SNOWS	S N OW Z
SNOWSCAPE	S N OW S K EY P
SNOWSCAPES	S N OW S K EY P S
SNOWSHED	S N OW SH EH D
SNOWSHEDS	S N OW SH EH D Z
SNOWSHOE	S N OW SH UW
SNOWSHOED	S N OW SH UW D
SNOWSHOEING	S N OW SH UW IH NG
SNOWSHOER	S N OW SH UW ER
SNOWSHOERS	S N OW SH UW ER Z
SNOWSHOES	S N OW SH UW Z
SNOWSLIDE	S N OW S L AY D
SNOWSLIDES	S N OW S L AY D Z
SNOWSTORM	S N OW S T AO R M
SNOWSTORMS	S N OW S T AO R M Z
SNOWSUIT	S N OW S UW T
SNOWSUITS	S N OW S UW T S
SNOWY	S N OW IY
SOMEHOW	S AH M HH AW
SORROW	S AA R OW
SORROWED	S AA R OW D
SORROWER	S AA R OW ER
SORROWERS	S AA R OW ER Z
SORROWFUL	S AA R OW F AH L
SORROWFULLY	S AA R OW F AH L IY
SORROWFULNESS	S AA R OW F AH L N AH S
SORROWFULNESSES	S AA R OW F AH L N AH S IH Z
SORROWING	S AA R OW IH NG
SORROWS	S AA R OW Z
SOW	S AW
SOW(2)	S OW
SOWABLE	S AW AH B AH L
SOWANS	S OW AH N Z
SOWAR	S AW ER
SOWARS	S AW ER Z
SOWBELLIES	S AW B EH L IY Z
SOWBELLY	S AW B EH L IY
SOWBREAD	S AW B R EH D
SOWBREADS	S AW B R EH D Z
SOWCAR	S AW K AA R
SOWCARS	S AW K AA R Z
SOWED	S AW D
SOWED(2)	S OW D
SOWENS	S AW AH N Z
SOWER	S OW ER
SOWERS	S OW ER Z
SOWING	S OW IH NG
SOWN	S OW N
SOWS	S OW Z
SPARROW	S P EH R OW
SPARROWLIKE	S P AE R OW L AY K
SPARROWS	S P EH R OW Z
SPLASHDOWN	S P L AE SH D AW N
SPLASHDOWNS	S P L AE SH D AW N Z
STARFLOWER	S T AA R F L AW ER
STARFLOWERS	S T AA R F L AW ER Z
STOW	S T OW
STOWABLE	S T OW AH B AH L
STOWAGE	S T OW IH JH
STOWAGES	S T OW IH JH IH Z
STOWAWAY	S T OW AH W EY
STOWAWAYS	S T OW AH W EY Z
STOWED	S T OW D
STOWING	S T OW W IH NG
STOWP	S T OW P
STOWPS	S T OW P S
STOWS	S T OW Z
STRAWFLOWER	S T R AO F L AW ER
STRAWFLOWERS	S T R AO F L AW ER Z
STROW	S T R OW
STROWED	S T R OW D
STROWING	S T R OW AH NG
STROWN	S T R OW N
STROWS	S T R OW Z
STUCCOWORK	S T AH K OW W ER K
STUCCOWORKS	S T AH K OW W ER K S
SUNBOW	S AH N B AW
SUNBOWS	S AH N B AW Z
SUNDOWN	S AH N D AW N
SUNDOWNER	S AH N D AW N ER
SUNDOWNERS	S AH N D AW N ER Z
SUNDOWNS	S AH N D AW N Z
SUNFLOWER	S AH N F L AW ER
SUNFLOWERS	S AH N F L AW ER Z
SUNGLOW	S AH N G L OW
SUNGLOWS	S AH N G L OW Z
SUPERGROWTH	S UW P ER G R OW TH
SUPERGROWTHS	S UW P ER G R OW TH S
SUPERPOWER	S UW P ER P AW ER
SUPERPOWERED	S UW P ER P AW ER D
SUPERPOWERFUL	S UW P ER P AW ER F AH L
SUPERPOWERS	S UW P ER P AW ER Z
SUPERSHOW	S UW P ER SH OW
SUPERSHOWS	S UW P ER SH OW Z
SWALLOW	S W AA L OW
SWALLOW(2)	S W AO L OW
SWALLOWABLE	S W AA L OW AH B AH L
SWALLOWED	S W AA L OW D
SWALLOWER	S W AA L OW ER
SWALLOWERS	S W AA L OW ER Z
SWALLOWING	S W AA L OW IH NG
SWALLOWS	S W AA L OW Z
SWALLOWTAIL	S W AA L OW T EY L
SWALLOWTAILS	S W AA L OW T EY L Z
SWANSDOWN	S W AA N Z D AW N
SWANSDOWNS	S W AA N Z D AW N Z
TAKEDOWN	T EY K D AW N
TAKEDOWNS	T EY K D AW N Z
TALLOW	T AE L OW
TALLOWED	T AE L OW D
TALLOWING	T AE L OW IH NG
TALLOWS	T AE L OW Z
TALLOWY	T AE L OW IY
TEABOWL	T IY B OW L
TEABOWLS	T IY B OW L Z
TEARDOWN	T IH ER D AW N
TEARDOWNS	T IH ER D AW N Z
THINDOWN	TH IH N D AW N
THINDOWNS	TH IH N D AW N Z
THISTLEDOWN	TH IH S T L AH D OW N
THISTLEDOWNS	TH IH S T L AH D OW N Z
THOWLESS	TH OW L AH S
THROW	TH R OW
THROWAWAY	TH R OW AH W EY
THROWAWAYS	TH R OW AH W EY Z
THROWBACK	TH R OW B AE K
THROWBACKS	TH R OW B AE K S
THROWER	TH R OW ER
THROWERS	TH R OW ER Z
THROWING	TH R OW IH NG
THROWN	TH R OW N
THROWS	TH R OW Z
THROWSTER	TH R OW S T ER
THROWSTERS	TH R OW S T ER Z
THUNDERSHOWER	TH AH N D ER SH AW W ER
THUNDERSHOWERS	TH AH N D ER SH AW W ER Z
TOMORROW	T AH M AA R OW
TOMORROW(2)	T UW M AA R OW
TOMORROWS	T AH M AA R OW Z
TOMORROWS(2)	T UW M AA R OW Z
TOPMINNOW	T AA P M IH N OW
TOPMINNOWS	T AA P M IH N OW Z
TOUCHDOWN	T AH CH D AW N
TOUCHDOWNS	T AH CH D AW N Z
TOW	T OW
TOWAGE	T OW IH JH
TOWAGES	T OW IH JH IH Z
TOWARD	T AH W AO R D
TOWARD(2)	T AO R D
TOWARDLINESS	T AH W AO R D L IY N AH S
TOWARDLINESSES	T AH W AO R D L IY N AH S IH Z
TOWARDLY	T AH W AO R D L IY
TOWARDS	T AH W AO R D Z
TOWARDS(2)	T AO R D Z
TOWAWAY	T OW AH W EY
TOWAWAYS	T OW AH W EY Z
TOWBOAT	T OW B OW T
TOWBOATS	T OW B OW T S
TOWED	T OW D
TOWEL	T AW AH L
TOWEL(2)	T AW L
TOWELED	T AW AH L D
TOWELETTE	T AW AH L EH T
TOWELETTES	T AW AH L EH T S
TOWELING	T AW AH L IH NG
TOWELING(2)	T AW L IH NG
TOWELINGS	T AW AH L IH NG Z
TOWELLED	T AW AH L D
TOWELLING	T AW AH L IH NG
TOWELLINGS	T AW AH L IH NG Z
TOWELS	T AW AH L Z
TOWELS(2)	T AW L Z
TOWER	T AW ER
TOWERED	T AW ER D
TOWERIER	T OW AH R IY ER
TOWERIEST	T OW AH R IY AH S T
TOWERING	T AW ER IH NG
TOWERING(2)	T AW R IH NG
TOWERINGLY	T AW ER IH NG L IY
TOWERLIKE	T AW ER L AY K
TOWERS	T AW ER Z
TOWERY	T OW ER IY
TOWHEAD	T OW HH EH D
TOWHEADED	T OW HH EH D IH D
TOWHEADS	T OW HH EH D Z
TOWHEE	T OW IY IY
TOWHEES	T OW HH IY Z
TOWIE	T OW IY
TOWIES	T OW IY Z
TOWING	T OW IH NG
TOWLINE	T OW L AY N
TOWLINES	T OW L AY N Z
TOWMOND	T OW M AH N D
TOWMONDS	T OW M AH N D Z
TOWMONT	T OW M AH N T
TOWMONTS	T OW M AH N T S
TOWN	T AW N
TOWNEE	T AW N IY
TOWNEES	T AW N IY Z
TOWNFOLK	T AW N F OW K
TOWNHOME	T AW N HH OW M
TOWNHOMES	T AW N HH OW M Z
TOWNHOUSE	T AW N HH AW S
TOWNHOUSES	T AW N HH AW S IH Z
TOWNIE	T AW N IY
TOWNIES	T AW N IY Z
TOWNISH	T AW N IH SH
TOWNLESS	T AW N L AH S
TOWNLET	T AW N L AH T
TOWNLETS	T AW N L AH T S
TOWNS	T AW N Z
TOWNSCAPE	T AW N S K EY P
TOWNSCAPES	T AW N S K EY P S
TOWNSFOLK	T AW N Z F OW K
TOWNSHIP	T AW N SH IH P
TOWNSHIPS	T AW N SH IH P S
TOWNSMAN	T AW N Z M AH N
TOWNSMEN	T AW N Z M EH N
TOWNSPEOPLE	T AW N Z P IY P AH L
TOWNSWOMAN	T AW N Z W UH M AH N
TOWNSWOMEN	T AW N Z W IH M AH N
TOWNWEAR	T AW N W AE ER
TOWNY	T AW N IY
TOWPATH	T OW P AE TH
TOWPATHS	T OW P AE TH S
TOWROPE	T OW R OW P
TOWROPES	T OW R OW P S
TOWS	T OW Z
TOWY	T OW IY
TRICKLEDOWN	T R IH K AH L D AW N
TROW	T R OW
TROWED	T R OW D
TROWEL	T R AW W EH L
TROWELED	T R OW IY L D
TROWELER	T R OW IY L AH R
TROWELERS	T R OW AH L AH R Z
TROWELING	T R OW IY L AH NG
TROWELLED	T R OW AH L D
TROWELLING	T R OW EH L AH NG
TROWELS	T R OW AH L Z
TROWING	T R OW AH NG
TROWS	T R OW Z
TROWSERS	T R OW S AH R Z
TROWTH	T R OW TH
TROWTHS	T R OW TH S
TUMBLEDOWN	T AH M B AH L D AW N
TURNDOWN	T ER N D AW N
TURNDOWNS	T ER N D AW N Z
TWINFLOWER	T W IH N F L AW ER
TWINFLOWERS	T W IH N F L AW ER Z
ULTRALOW	AH L T R AH L OW
ULTRAPOWERFUL	AH L T R AH P AW ER F AH L
ULTRASLOW	AH L T R AH S L OW
UNACKNOWLEDGED	AH N AE K N AA L IH JH D
UNAVOWED	AH N AH V AW D
UNBEKNOWN	AH N B IH N OW N
UNBEKNOWN(2)	AH N B IY N OW N
UNBEKNOWNST	AH N B IY N OW N S T
UNBOWDLERIZED	AH N B OW D L AH R AY Z D
UNBOWED	AH N B OW D
UNBOWED(2)	AH N B AW D
UNCROWDED	AH N K R AW D IH D
UNCROWN	AH N K R AW N
UNCROWNED	AH N K R AW N D
UNCROWNING	AH N K R AW N IH NG
UNCROWNS	AH N K R AW N Z
UNDERFLOW	AH N D ER F L OW
UNDERFLOWS	AH N D ER F L OW Z
UNDERGROWTH	AH N D ER G R OW TH
UNDERGROWTHS	AH N D ER G R OW TH S
UNDERPOWERED	AH N D ER P AW ER D
UNDERTOW	AH N D ER T OW
UNDERTOWS	AH N D ER T OW Z
UNGOWNED	AH N G AW N D
UNHALLOW	AH N HH AE L OW
UNHALLOWED	AH N HH AE L OW D
UNHALLOWING	AH N HH AE L OW IH NG
UNHALLOWS	AH N HH AE L OW Z
UNKNOWABILITIES	AH N OW AH B IH L AH T EH Z
UNKNOWABILITY	AH N OW AH B IH L AH T EH
UNKNOWABLE	AH N N OW AH B AH L
UNKNOWING	AH N N OW IH NG
UNKNOWINGLY	AH N N OW IH NG L IY
UNKNOWINGS	AH N OW IH NG Z
UNKNOWLEDGEABLE	AH N AA L IH JH AH B AH L
UNKNOWN	AH N N OW N
UNKNOWNS	AH N OW N Z
UNMELLOW	AH N M EH L OW
UNMOWN	AH N M OW N
UNOWNED	AH N OW N D
UNPLOWED	AH N P L AW D
UNSHOWY	AH N SH OW IY
UNSOWED	AH N S AW D
UNSOWN	AH N S OW N
UNTOWARD	AH N T UW AO R D
UNTOWARD(2)	AH N T AH W AO R D
UNTOWARDLY	AH N T AH W AO R D L IY
UNTOWARDNESS	AH N T AH W AO R D N AH S
UNTOWARDNESSES	AH N T AH W AO R D N AH S IH Z
UPBOW	AH P B AW
UPBOWS	AH P B AW Z
UPFLOW	AH P F L OW
UPFLOWED	AH P F L OW D
UPFLOWING	AH P F L OW IH NG
UPFLOWS	AH P F L OW Z
UPGROW	AH P G R OW
UPGROWING	AH P G R OW IH NG
UPGROWN	AH P G R OW N
UPGROWS	AH P G R OW Z
UPGROWTH	AH P G R OW TH
UPGROWTHS	AH P G R OW TH S
UPTHROW	AH P TH R OW
UPTHROWING	AH P TH R OW IH NG
UPTHROWN	AH P TH R OW N
UPTHROWS	AH P TH R OW Z
UPTOWN	AH P T AW N
UPTOWNER	AH P T AW N ER
UPTOWNERS	AH P T AW N ER Z
UPTOWNS	AH P T AW N Z
VOW	V AW
VOWED	V AW D
VOWEL	V AW AH L
VOWELIZE	V AW AH L AY Z
VOWELIZED	V AW AH L AY Z D
VOWELIZES	V AW AH L AY Z IH Z
VOWELIZING	V AW AH L AY Z IH NG
VOWELS	V AW AH L Z
VOWELS(2)	V AW L Z
VOWER	V AW ER
VOWERS	V AW ER Z
VOWING	V AW IH NG
VOWLESS	V AW L AH S
VOWS	V AW Z
VROW	V R OW
VROWS	V R OW Z
WALLFLOWER	W AO L F L AW ER
WALLFLOWERS	W AO L F L AW ER Z
WALLOW	W AA L OW
WALLOWED	W AA L OW D
WALLOWER	W AA L OW ER
WALLOWERS	W AA L OW ER Z
WALLOWING	W AA L OW IH NG
WALLOWS	W AA L OW Z
WARPOWER	W AO R P AW ER
WARPOWERS	W AO R P AW ER Z
WASHBOWL	W AA SH B OW L
WASHBOWLS	W AA SH B OW L Z
WATCHTOWER	W AA CH T AW ER
WATCHTOWERS	W AA CH T AW ER Z
WATERFOWL	W AO T ER F AW L
WATERFOWLER	W AO T ER F AW L ER
WATERFOWLERS	W AO T ER F AW L ER Z
WATERFOWLING	W AO T ER F AW L IH NG
WATERFOWLINGS	W AO T ER F AW L IH NG Z
WATERFOWLS	W AO T ER F AW L Z
WATERPOWER	W AO T ER P AW ER
WATERPOWERS	W AO T ER P AW ER Z
WHEELBARROW	W IY L B EH R OW
WHEELBARROW(2)	HH W IY L B EH R OW
WHEELBARROWED	W IY L B AE R OW D
WHEELBARROWING	W IY L B AE R OW IH NG
WHEELBARROWS	W IY L B EH R OW Z
WHEELBARROWS(2)	HH W IY L B EH R OW Z
WHISTLEBLOWER	W IH S AH L B L OW ER
WHISTLEBLOWER(2)	HH W IH S AH L B L OW ER
WHISTLEBLOWERS	W IH S AH L B L OW ER Z
WHISTLEBLOWERS(2)	HH W IH S AH L B L OW ER Z
WHISTLEBLOWING	W IH S AH L B L OW IH NG
WHISTLEBLOWINGS	W IH S AH L B L OW IH NG Z
WHITLOW	W IH T L OW
WHITLOW(2)	HH W IH T L OW
WHITLOWS	W IH T L OW Z
WIDOW	W IH D OW
WIDOWED	W IH D OW D
WIDOWER	W IH D OW ER
WIDOWERHOOD	W IH D OW ER HH UH D
WIDOWERHOODS	W IH D OW ER HH UH D Z
WIDOWERS	W IH D OW ER Z
WIDOWHOOD	W IH D OW HH UH D
WIDOWHOODS	W IH D OW HH UH D Z
WIDOWING	W IH D OW IH NG
WIDOWS	W IH D OW Z
WILDFLOWER	W AY L D F L AW ER
WILDFLOWERS	W AY L D F L AW R Z
WILDFOWL	W AY L D F AW L
WILDFOWLER	W AY L D F AW L ER
WILDFOWLERS	W AY L D F AW L ER Z
WILDFOWLING	W AY L D F AW L IH NG
WILDFOWLINGS	W AY L D F AW L IH NG Z
WILDFOWLS	W AY L D F AW L Z
WILLOW	W IH L OW
WILLOWED	W IH L OW D
WILLOWER	W IH L OW ER
WILLOWERS	W IH L OW ER Z
WILLOWIER	W IH L OW IY ER
WILLOWIEST	W IH L OW IY AH S T
WILLOWING	W IH L OW IH NG
WILLOWLIKE	W IH L OW L AY K
WILLOWS	W IH L OW Z
WILLOWWARE	W IH L OW W EH R
WILLOWWARES	W IH L OW W EH R Z
WILLOWY	W IH L AH W IY
WILLPOWER	W IH L P AW ER
WILLPOWERS	W IH L P AW ER Z
WINDBLOWN	W IH N D B L OW N
WINDFLOWER	W IH N D F L AW ER
WINDFLOWERS	W IH N D F L AW ER Z
WINDOW	W IH N D OW
WINDOWED	W IH N D OW D
WINDOWING	W IH N D OW IH NG
WINDOWLESS	W IH N D OW L AH S
WINDOWPANE	W IH N D OW P EY N
WINDOWPANES	W IH N D OW P EY N Z
WINDOWS	W IH N D OW Z
WINDOWSILL	W IH N D OW S IH L
WINDOWSILLS	W IH N D OW S IH L Z
WINDROW	W IH N D R OW
WINDROWED	W IH N D R OW D
WINDROWING	W IH N D R OW IH NG
WINDROWS	W IH N D R OW Z
WINDTHROW	W IH N D TH R OW
WINDTHROWS	W IH N D TH R OW Z
WINEGROWER	W AY N G R OW ER
WINEGROWERS	W AY N G R OW ER Z
WINGBOW	W IH NG B AW
WINGBOWS	W IH NG B AW Z
WINNOW	W IH N OW
WINNOWED	W IH N OW D
WINNOWER	W IH N OW ER
WINNOWERS	W IH N OW ER Z
WINNOWING	W IH N OW IH NG
WINNOWS	W IH N OW Z
WOMANPOWER	W UH M AH N P AW ER
WOMANPOWERS	W UH M AH N P AW ER Z
WOW	W AW
WOWED	W AW D
WOWING	W AW IH NG
WOWS	W AW Z
WOWSER	W AW Z ER
WOWSERS	W AW Z ER Z
YARROW	Y AA R OW
YARROWS	Y AE R OW Z
YELLOW	Y EH L OW
YELLOWED	Y EH L OW D
YELLOWER	Y EH L OW ER
YELLOWEST	Y EH L OW IH S T
YELLOWFIN	Y EH L OW F IH N
YELLOWFINS	Y EH L OW F IH N Z
YELLOWHAMMER	Y EH L OW HH AE M ER
YELLOWHAMMERS	Y EH L OW HH AE M ER Z
YELLOWING	Y EH L OW IH NG
YELLOWISH	Y EH L OW IH SH
YELLOWLEGS	Y EH L OW L EH G Z
YELLOWLY	Y EH L OW L IY
YELLOWS	Y EH L OW Z
YELLOWTAIL	Y EH L OW T EY L
YELLOWTAILS	Y EH L OW T EY L Z
YELLOWTHROAT	Y EH L OW TH R OW T
YELLOWTHROATS	Y EH L OW TH R OW T S
YELLOWWARE	Y EH L OW W EH R
YELLOWWARES	Y EH L OW W EH R Z
YELLOWWOOD	Y EH L OW W UH D
YELLOWWOODS	Y EH L OW W UH D Z
YELLOWY	Y EH L OW IY
YOKEFELLOW	Y OW K F EH L OW
YOKEFELLOWS	Y OW K F EH L OW Z
YOW	Y AW
YOWE	Y OW
YOWED	Y OW D
YOWES	Y OW Z
YOWIE	Y OW AY
YOWIES	Y OW AY Z
YOWING	Y OW AH NG
YOWL	Y OW L
YOWLED	Y OW L D
YOWLER	Y OW L AH R
YOWLERS	Y OW L AH R Z
YOWLING	Y OW L AH NG
YOWLS	Y OW L Z
YOWS	Y OW Z
ZOWIE	Z OW AY
GUACAMOLE	G W AA K AH M OW L IY
ESS	EH S
SEL	S EH L
OLEO	OW L IY OW
FEAL	F IY AH L
FLAB	F L AE B
RYA	R AY AH
