OY	OY
AHOY	AH HH OY
ALLOY	AE L OY
ALLOYED	AE L OY D
ALLOYING	AE L OY IH NG
ALLOYS	AE L OY Z
AMBOYNA	AE M B OY N AH
AMBOYNAS	AE M B OY N AH Z
ANNOY	AH N OY
ANNOYANCE	AH N OY AH N S
ANNOYANCES	AH N OY AH N S IH Z
ANNOYED	AH N OY D
ANNOYER	AH N OY ER
ANNOYERS	AH N OY ER Z
ANNOYING	AH N OY IH NG
ANNOYINGLY	AH N OY IH NG L IY
ANNOYS	AH N OY Z
ANTIBOYCOTT	AE N T AY B OY K AA T
ANTIBOYCOTTS	AE N T AY B OY K AA T S
ANTIROYALIST	AE N T AY R OY AH L IH S T
ANTIROYALISTS	AE N T AY R OY AH L IH S T S
ANTIUNEMPLOYMENT	AE N T AY AH N IH M P L OY M AH N T
AROYNT	AH R OY N T
AROYNTED	AH R OY N T AH D
AROYNTING	AH R OY N T AH NG
AROYNTS	AH R OY N T S
ARROYO	ER OY OW
ARROYOS	AH R OY OW Z
ATEMOYA	AH T EH M OY AH
ATEMOYAS	AH T EH M OY AH Z
ATTABOY	AE T AH B OY
BATBOY	B AE T B OY
BATBOYS	B AE T B OY Z
BEACHBOY	B IY CH B OY
BEACHBOYS	B IY CH B OY Z
BELLBOY	B EH L B OY
BELLBOYS	B EH L B OY Z
BENZOYL	B IH N Z OY L
BENZOYLS	B IH N Z OY L Z
BLACKBOY	B L AE K B OY
BLACKBOYS	B L AE K B OY Z
BOY	B OY
BOYAR	B OW Y AA R
BOYARD	B OY AH R D
BOYARDS	B OY AH R D Z
BOYARISM	B OW Y AA R IH Z AH M
BOYARISMS	B OW Y AA R IH Z AH M Z
BOYARS	B OW Y AA R Z
BOYCHICK	B OY CH IH K
BOYCHICKS	B OY CH IH K S
BOYCHIK	B OY CH AH K
BOYCHIKS	B OY CH AH K S
BOYCOTT	B OY K AA T
BOYCOTTED	B OY K AA T IH D
BOYCOTTER	B OY K AA T ER
BOYCOTTERS	B OY K AA T ER Z
BOYCOTTING	B OY K AA T IH NG
BOYCOTTS	B OY K AA T S
BOYFRIEND	B OY F R EH N D
BOYFRIENDS	B OY F R EH N D Z
BOYHOOD	B OY HH UH D
BOYHOODS	B OY HH UH D Z
BOYISH	B OY IH SH
BOYISHLY	B OY IH SH L IY
BOYISHNESS	B OY IH SH N AH S
BOYISHNESSES	B OY IH SH N AH S IH Z
BOYLA	B OY L AH
BOYLAS	B OY L AH Z
BOYO	B OY OW
BOYOS	B OY AA S
BOYS	B OY Z
BOYSENBERRIES	B OY S EH N B EH R IY Z
BOYSENBERRY	B OY S EH N B EH R IY
BULLYBOY	B UH L IY B OY
BULLYBOYS	B UH L IY B OY Z
BUOY	B UW IY
BUOYAGE	B OY IH JH
BUOYAGES	B OY IH JH IH Z
BUOYANCE	B OY AH N S
BUOYANCES	B OY AH N S IH Z
BUOYANCIES	B OY AH N S IY Z
BUOYANCY	B OY AH N S IY
BUOYANT	B OY AH N T
BUOYANTLY	B OY AH N T L IY
BUOYED	B UW IY D
BUOYING	B OY IH NG
BUOYS	B UW IY Z
BUSBOY	B AH S B OY
BUSBOYS	B AH S B OY Z
CALLBOY	K AO L B OY
CALLBOYS	K AO L B OY Z
CALOYER	K AE L OY AH R
CALOYERS	K AE L OY AH R Z
CARBOY	K AA R B OY
CARBOYED	K AA R B OY D
CARBOYS	K AA R B OY Z
CHARPOY	CH AA R P OW IY
CHARPOYS	CH AA R P OY Z
CHATOYANCE	CH AE T OY AH N S
CHATOYANCES	CH AE T OY AE N S AH Z
CHATOYANCIES	CH AE T OY AE N S AY Z
CHATOYANCY	CH AE T OY AE N S IY
CHATOYANT	CH AE T OY AH N T
CHATOYANTS	CH AE T OY AH N T S
CHERIMOYA	CH AH R IH M OY AH
CHERIMOYAS	CH AH R IH M OY AH Z
CHIRIMOYA	CH AH R IH M OY AH
CHIRIMOYAS	CH AH R IH M OY AH Z
CHOIRBOY	K W AY ER B OY
CHOIRBOYS	K W AY ER B OY Z
CLAIRVOYANCE	K L EH R V OY AH N S
CLAIRVOYANCES	K L AE ER V OY AH N S IH Z
CLAIRVOYANT	K L EH R V OY AH N T
CLAIRVOYANTLY	K L AE ER V OY AH N T L IY
CLAIRVOYANTS	K L AE ER V OY AH N T S
CLOY	K L OY
CLOYED	K L OY D
CLOYING	K L OY IH NG
CLOYINGLY	K L OY IH NG L IY
CLOYS	K L OY Z
COCOYAM	K OW K AH Y AE M
COCOYAMS	K OW K AH Y AE M Z
COEMPLOY	K OW IH M P L OY
COEMPLOYED	K OW IH M P L OY IY D
COEMPLOYING	K OW IH M P L OY IY IH NG
COEMPLOYS	K OW IH M P L OY Z
CONVOY	K AA N V OY
CONVOYED	K AA N V OY D
CONVOYING	K AA N V OY IH NG
CONVOYS	K AA N V OY Z
COPYBOY	K AA P IY B OY
COPYBOYS	K AA P IY B OY Z
CORDUROY	K AO R D ER OY
CORDUROYED	K AO R D AH R OY D
CORDUROYING	K AO R D AH R OY IH NG
CORDUROYS	K AO R D AH R OY Z
COUNTERDEPLOYMENT	K AW N T ER D IH P L OY M AH N T
COUNTERDEPLOYMENTS	K AW N T ER D IH P L OY M AH N T S
COUNTERPLOY	K OW AH N T AH R P L OW IY
COUNTERPLOYS	K OW AH N T AH R P L OY Z
COWBOY	K AW B OY
COWBOYS	K AW B OY Z
COY	K OY
COYDOG	K OY D AO G
COYDOGS	K OY D AO G Z
COYED	K OY D
COYER	K OY ER
COYEST	K OY AH S T
COYING	K OY IH NG
COYISH	K OY IH SH
COYLY	K OY L IY
COYNESS	K OY N AH S
COYNESSES	K OY N AH S IH Z
COYOTE	K AY OW T IY
COYOTE(2)	K AY OW T
COYOTES	K AY OW T IY S
COYOTES(2)	K AY OW T S
COYOTILLO	K OW Y AH T IH L OW
COYOTILLOS	K OW Y AH T IH L AH Z
COYPOU	K OW Y P UW
COYPOUS	K OW Y P AH S
COYPU	K OW Y P UW
COYPUS	K OW Y P AH S
COYS	K OY Z
DECOY	D AH K OY
DECOYED	D IY K OY D
DECOYER	D IY K OY ER
DECOYERS	D IY K OY ER Z
DECOYING	D IY K OY IH NG
DECOYS	D IY K OY Z
DEPLOY	D IH P L OY
DEPLOYABLE	D IH P L OY AH B AH L
DEPLOYED	D IH P L OY D
DEPLOYING	D IH P L OY IH NG
DEPLOYMENT	D IH P L OY M AH N T
DEPLOYMENTS	D IH P L OY M AH N T S
DEPLOYS	D IH P L OY Z
DESTROY	D IH S T R OY
DESTROYED	D IH S T R OY D
DESTROYER	D IH S T R OY ER
DESTROYERS	D IH S T R OY ER Z
DESTROYING	D IH S T R OY IH NG
DESTROYS	D IH S T R OY Z
DISLOYAL	D IH S L OY AH L
DISLOYALLY	D IH S L OY AH L IY
DISLOYALTIES	D IH S L OY AH L T IY Z
DISLOYALTY	D IH S L OY AH L T IY
DOUGHBOY	D OW B OY
DOUGHBOYS	D OW B OY Z
DOYEN	D OY IH N
DOYENNE	D OY AH N
DOYENNES	D OY AH N Z
DOYENS	D OW IY AH N Z
DOYLEY	D OY L IY
DOYLEYS	D OY L EY Z
DOYLIES	D OW IY L IY Z
DOYLY	D OW IY L IY
EMPLOY	EH M P L OY
EMPLOY(2)	IH M P L OY
EMPLOYABILITIES	IH M P L OY IY AH B IH L AH T EH Z
EMPLOYABILITY	IH M P L OY IY AH B IH L AH T EH
EMPLOYABLE	EH M P L OY AH B AH L
EMPLOYABLES	IH M P L OY IY AH B AH L Z
EMPLOYE	IH M P L OY IY
EMPLOYED	EH M P L OY D
EMPLOYED(2)	IH M P L OY D
EMPLOYEE	EH M P L OY IY
EMPLOYEE(2)	IH M P L OY IY
EMPLOYEES	EH M P L OY IY Z
EMPLOYEES(2)	IH M P L OY IY Z
EMPLOYER	EH M P L OY ER
EMPLOYER(2)	IH M P L OY ER
EMPLOYERS	EH M P L OY ER Z
EMPLOYERS(2)	IH M P L OY ER Z
EMPLOYES	IH M P L OY IY Z
EMPLOYING	EH M P L OY IH NG
EMPLOYING(2)	IH M P L OY IH NG
EMPLOYMENT	EH M P L OY M AH N T
EMPLOYMENT(2)	IH M P L OY M AH N T
EMPLOYMENTS	EH M P L OY M AH N T S
EMPLOYMENTS(2)	IH M P L OY M AH N T S
EMPLOYS	EH M P L OY Z
EMPLOYS(2)	IH M P L OY Z
ENJOY	EH N JH OY
ENJOYABLE	EH N JH OY AH B AH L
ENJOYABLENESS	EH N JH OY AH B AH L N AH S
ENJOYABLENESSES	EH N JH OY AH B AH L N AH S IH Z
ENJOYABLY	EH N JH OY AH B L IY
ENJOYED	EH N JH OY D
ENJOYER	EH N JH OY ER
ENJOYERS	EH N JH OY ER Z
ENJOYING	EH N JH OY IH NG
ENJOYMENT	EH N JH OY M AH N T
ENJOYMENTS	EH N JH OY M AH N T S
ENJOYS	EH N JH OY Z
ENVOY	EH N V OY
ENVOY(2)	AA N V OY
ENVOYS	EH N V OY Z
ENVOYS(2)	AA N V OY Z
FLAMBOYANCE	F L AE M B OY AH N S
FLAMBOYANCES	F L AE M B OY AH N S IH Z
FLAMBOYANCIES	F L AE M B OY AH N S IY Z
FLAMBOYANCY	F L AE M B OY AH N S IY
FLAMBOYANT	F L AE M B OY AH N T
FLAMBOYANTLY	F L AE M B OY AH N T L IY
FLAMBOYANTS	F L AE M B OY AH N T S
FLYBOY	F L AY B OY
FLYBOYS	F L AY B OY Z
FOOTBOY	F UH T B OY
FOOTBOYS	F UH T B OY Z
FOY	F OY
FOYER	F OY ER
FOYERS	F OY ER Z
FOYS	F OW IY Z
GARGOYLE	G AA R G OY L
GARGOYLED	G AA R G OY L D
GARGOYLES	G AA R G OY L Z
GOY	G OY
GOYIM	G OY IH M
GOYISH	G OW IY IH SH
GOYS	G OW IY Z
GROYNE	G R OY N
GROYNES	G R OY N Z
HAUTBOY	HH AO T B OW IY
HAUTBOYS	HH AO T B OY Z
HIGHBOY	HH AY B OY
HIGHBOYS	HH AY B OY Z
HOBBLEDEHOY	HH AA B AH L D IY HH OW IY
HOBBLEDEHOYS	HH AA B AH L D IY HH OW IY Z
HOMEBOY	HH OW M B OY
HOMEBOYS	HH OW M B OY Z
HOUSEBOY	HH AW S B OY
HOUSEBOYS	HH AW S B OY Z
HOY	HH OY
HOYA	HH OY AH
HOYAS	HH OY AH Z
HOYDEN	HH OY D AH N
HOYDENED	HH OY D AH N D
HOYDENING	HH OY D AH N IH NG
HOYDENISH	HH OY D AH N IH SH
HOYDENS	HH OY D AH N Z
HOYLE	HH OY L
HOYLES	HH OY AH L Z
HOYS	HH OW IY Z
JOY	JH OY
JOYANCE	JH OY AH N S
JOYANCES	JH OY AH N S IH Z
JOYED	JH OY D
JOYFUL	JH OY F AH L
JOYFULLER	JH OY F AH L ER
JOYFULLEST	JH OY F AH L AH S T
JOYFULLY	JH OY F AH L IY
JOYFULNESS	JH OY F AH L N AH S
JOYFULNESSES	JH OY F AH L N AH S IH Z
JOYING	JH OY IH NG
JOYLESS	JH OY L AH S
JOYLESSLY	JH OY L AH S L IY
JOYLESSNESS	JH OY L AH S N AH S
JOYLESSNESSES	JH OY L AH S N AH S IH Z
JOYOUS	JH OY AH S
JOYOUSLY	JH OY AH S L IY
JOYOUSNESS	JH OY AH S N AH S
JOYOUSNESSES	JH OY AH S N AH S IH Z
JOYPOP	JH OY P AA P
JOYPOPPED	JH OY P AA P T
JOYPOPPER	JH OY P AA P ER
JOYPOPPERS	JH OY P AA P ER Z
JOYPOPPING	JH OY P AA P IH NG
JOYPOPS	JH OY P AA P S
JOYRIDDEN	JH OY R IH D AH N
JOYRIDE	JH OY R AY D
JOYRIDER	JH OY R AY D ER
JOYRIDERS	JH OY R AY D ER Z
JOYRIDES	JH OY R AY D Z
JOYRIDING	JH OY R AY D IH NG
JOYRIDINGS	JH OY R AY D IH NG Z
JOYRODE	JH OY R OW D
JOYS	JH OY Z
JOYSTICK	JH OY S T IH K
JOYSTICKS	JH OY S T IH K S
KILLJOY	K IH L JH OY
KILLJOYS	K IH L JH OY Z
LINKBOY	L IH NG K B OY
LINKBOYS	L IH NG K B OY Z
LOWBOY	L OW B OY
LOWBOYS	L OW B OY Z
LOYAL	L OY AH L
LOYALER	L OY AH L ER
LOYALEST	L OY AH L AH S T
LOYALISM	L OY AH L IH Z AH M
LOYALISMS	L OY AH L IH Z AH M Z
LOYALIST	L OY AH L IH S T
LOYALISTS	L OY AH L IH S T S
LOYALLY	L OY AH L IY
LOYALTIES	L OY AH L T IY Z
LOYALTY	L OY AH L T IY
MACCABOY	M AE K AE B OW IY
MACCABOYS	M AE K AH B OY Z
MACCOBOY	M AE K AA B OW IY
MACCOBOYS	M AE K AH B OY Z
MISEMPLOY	M IH S IH M P L OY
MISEMPLOYED	M IH S IH M P L OY IY D
MISEMPLOYING	M IH S IH M P L OY IY IH NG
MISEMPLOYMENT	M IH S IH M P L OY M AH N T
MISEMPLOYMENTS	M IH S IH M P L OY M AH N T S
MISEMPLOYS	M IH S IH M P L OY Z
MULTIEMPLOYER	M AH L T IY IH M P L OY ER
NEWSBOY	N UW Z B OY
NEWSBOYS	N UW Z B OY Z
NONEMPLOYEE	N AA N IH M P L OY IY IY
NONEMPLOYEES	N AA N IH M P L OY IY IY Z
NONEMPLOYMENT	N AA N IH M P L OY M AH N T
NONEMPLOYMENTS	N AA N IH M P L OY M AH N T S
NONROYAL	N AA N R OY AH L
NOYADE	N OY EY D
NOYADES	N OY EY D Z
OVERCOY	OW V ER K OY
OVERJOY	OW V ER JH OY
OVERJOYED	OW V ER JH OY D
OVERJOYING	OW V ER JH OY IH NG
OVERJOYS	OW V ER JH OY Z
OY	OY
OYER	OY ER
OYERS	OY AH R Z
OYES	OY Z
OYESSES	OY EH S AH Z
OYEZ	OY AH Z
OYSTER	OY S T ER
OYSTERCATCHER	OY S T ER K AE CH ER
OYSTERCATCHERS	OY S T ER K AE CH ER Z
OYSTERED	OY S T ER D
OYSTERER	OY S T ER ER
OYSTERERS	OY S T ER ER Z
OYSTERING	OY S T ER IH NG
OYSTERINGS	OY S T ER IH NG Z
OYSTERMAN	OY S T ER M AE N
OYSTERMEN	OY S T ER M EH N
OYSTERS	OY S T ER Z
PADUASOY	P AE D Y UW AE S OW IY
PADUASOYS	P AE D Y UW AH S OY Z
PAGEBOY	P EY JH B OY
PAGEBOYS	P EY JH B OY Z
PAPERBOY	P EY P ER B OY
PAPERBOYS	P EY P ER B OY Z
PENNYROYAL	P EH N IY R OY AH L
PENNYROYALS	P EH N IY R OY AH L Z
PLAYBOY	P L EY B OY
PLAYBOYS	P L EY B OY Z
PLOWBOY	P L AW B OY
PLOWBOYS	P L AW B OY Z
PLOY	P L OY
PLOYED	P L OY D
PLOYING	P L OY AH NG
PLOYS	P L OY Z
POSTBOY	P OW S T B OY
POSTBOYS	P OW S T B OY Z
POTBOY	P AA T B OY
POTBOYS	P AA T B OY Z
POYOU	P OY UW
POYOUS	P OY AH S
PREEMPLOYMENT	P R IY IH M P L OY M AH N T
PREEMPLOYMENTS	P R IY IH M P L OY M AH N T S
REDEPLOY	R IY D IH P L OY
REDEPLOYED	R IY D IH P L OY D
REDEPLOYING	R IY D IH P L OY IH NG
REDEPLOYMENT	R IY D IH P L OY M AH N T
REDEPLOYMENTS	R IY D IH P L OY M AH N T S
REDEPLOYS	R IY D IH P L OY Z
REEMPLOY	R IY IH M P L OY
REEMPLOYED	R IY IH M P L OY IY D
REEMPLOYING	R IY IH M P L OY IY IH NG
REEMPLOYMENT	R IY IH M P L OY M AH N T
REEMPLOYMENTS	R IY IH M P L OY M AH N T S
REEMPLOYS	R IY IH M P L OY Z
REENJOY	R IY EH N JH OY
REENJOYED	R IY EH N JH OY D
REENJOYING	R IY EH N JH OY IH NG
REENJOYS	R IY EH N JH OY Z
ROYAL	R OY AH L
ROYALISM	R OY AH L IH Z AH M
ROYALISMS	R OY AH L IH Z AH M Z
ROYALIST	R OY AH L IH S T
ROYALISTS	R OY AH L IH S T S
ROYALLY	R OY AH L IY
ROYALS	R OY AH L Z
ROYALTIES	R OY AH L T IY Z
ROYALTY	R OY AH L T IY
ROYSTER	R OY S T ER
ROYSTERED	R OW IY S T ER D
ROYSTERING	R OW IY S T ER IH NG
ROYSTERS	R OW IY S T ER Z
SAMOYED	S AH M OY D
SAMOYEDS	S AE M OY AH D Z
SAVELOY	S AH V EH L OW IY
SAVELOYS	S AE V AH L OY Z
SAVOY	S AH V OY
SAVOYS	S AH V OY Z
SCHOOLBOY	S K UW L B OY
SCHOOLBOYISH	S K UW L B OY IH SH
SCHOOLBOYS	S K UW L B OY Z
SEPOY	S EH P OW IY
SEPOYS	S AH P OY Z
SHAMOY	SH AE M OW IY
SHAMOYED	SH AH M OY D
SHAMOYING	SH AE M OY AH NG
SHAMOYS	SH AH M OY Z
SHOPBOY	SH AA P B OY
SHOPBOYS	SH AA P B OY Z
SHOYU	SH OY UW
SHOYUS	SH OY AH S
SLOYD	S L OY D
SLOYDS	S L OY D Z
SONOBUOY	S AH N AA B Y UW OW IY
SONOBUOYS	S AH N AA B Y UW OY Z
SOY	S OY
SOYA	S OY AH
SOYAS	S OY AH Z
SOYBEAN	S OY B IY N
SOYBEANS	S OY B IY N Z
SOYMILK	S OY M IH L K
SOYMILKS	S OY M IH L K S
SOYS	S OY Z
SOYUZ	S OY AH Z
SOYUZ(2)	S OY UW Z
SOYUZES	S OY UW Z AH Z
STROY	S T R OW IY
STROYED	S T R OY D
STROYER	S T R OY AH R
STROYERS	S T R OY AH R Z
STROYING	S T R OY AH NG
STROYS	S T R OY Z
SUBEMPLOYED	S AH B IH M P L OY IY D
SUBEMPLOYMENT	S AH B IH M P L OY M AH N T
SUBEMPLOYMENTS	S AH B IH M P L OY M AH N T S
SUPERALLOY	S UW P ER AE L OY
SUPERALLOYS	S UW P ER AE L OY Z
SUPERLOYALIST	S UW P ER L OY AH L IH S T
SUPERLOYALISTS	S UW P ER L OY AH L IH S T S
SURROYAL	S ER R OY AH L
SURROYALS	S ER R OY AH L Z
TALLBOY	T AO L B OY
TALLBOYS	T AO L B OY Z
TEAPOY	T IY P OW IY
TEAPOYS	T IY P OY Z
TEPOY	T EH P OW IY
TEPOYS	T AH P OY Z
TOMBOY	T AA M B OY
TOMBOYISH	T AA M B OY IH SH
TOMBOYISHNESS	T AA M B OY IH SH N AH S
TOMBOYISHNESSES	T AA M B OY IH SH N AH S IH Z
TOMBOYS	T AA M B OY Z
TOY	T OY
TOYED	T OY D
TOYER	T OY ER
TOYERS	T OY ER Z
TOYING	T OY IH NG
TOYISH	T OY IH SH
TOYLESS	T OY L AH S
TOYLIKE	T OY L AY K
TOYO	T OW Y OW
TOYON	T OY AO N
TOYONS	T OY AO N Z
TOYOS	T OY AA S
TOYS	T OY Z
TOYSHOP	T OY SH AA P
TOYSHOPS	T OY SH AA P S
TROY	T R OY
TROYS	T R OY Z
TUTOYED	T Y UW T OY D
TUTOYER	T Y UW T OY AH R
TUTOYERED	T Y UW T OY IY R D
TUTOYERING	T Y UW T OY IY R AH NG
TUTOYERS	T Y UW T OY AH R Z
ULTRAROYALIST	AH L T R AH R OY AH L IH S T
ULTRAROYALISTS	AH L T R AH R OY AH L IH S T S
UNALLOYED	AH N AE L OY D
UNCLOYED	AH N K L OY D
UNCLOYING	AH N K L OY IH NG
UNCONVOYED	AH N K AA N V OY D
UNCOY	AH N K OY
UNDEREMPLOYED	AH N D ER IH M P L OY D
UNDEREMPLOYMENT	AH N D ER IH M P L OY M AH N T
UNDEREMPLOYMENTS	AH N D ER IH M P L OY M AH N T S
UNEMPLOYABILITIES	AH N IH M P L OY IY AH B IH L AH T EH Z
UNEMPLOYABILITY	AH N IH M P L OY IY AH B IH L AH T EH
UNEMPLOYABLE	AH N IH M P L OY AH B AH L
UNEMPLOYABLES	AH N IH M P L OY IY AH B AH L Z
UNEMPLOYED	AH N EH M P L OY D
UNEMPLOYEDS	AH N IH M P L OY IY D Z
UNEMPLOYMENT	AH N IH M P L OY M AH N T
UNEMPLOYMENTS	AH N IH M P L OY M AH N T S
UNFLAMBOYANT	AH N F L AE M B OY AH N T
UNJOYFUL	AH N JH OY F AH L
VICEROY	V AY S R OY
VICEROYALTIES	V AY S R OY AH L T IY Z
VICEROYALTY	V AY S R OY AH L T IY
VICEROYS	V AY S R OY Z
VICEROYSHIP	V AY S R OY SH IH P
VICEROYSHIPS	V AY S R OY SH IH P S
VOYAGE	V OY AH JH
VOYAGED	V OY AH JH D
VOYAGED(2)	V OY IH JH D
VOYAGER	V OY AH JH ER
VOYAGER(2)	V OY IH JH ER
VOYAGERS	V OY IH JH ER Z
VOYAGES	V OY AH JH AH Z
VOYAGES(2)	V OY IH JH IH Z
VOYAGEUR	V W AA Y AA ZH ER
VOYAGEURS	V W AA Y AA ZH ER Z
VOYAGING	V OY IH JH IH NG
VOYEUR	V OY Y UW R
VOYEURISM	V OY Y UW R IH Z AH M
VOYEURISMS	V OY UW R AH Z AH M Z
VOYEURISTIC	V OY Y AH R IH S T IH K
VOYEURISTICALLY	V OY AH R IH S T AH K AE L IY
VOYEURS	V OY IY Y AH R Z
ZOYSIA	Z OY ZH IY AH
ZOYSIAS	Z OY S IY AH Z
DORKS	D AO R K S
FAROS	F AA R AA S
ICE	AY S
ESOPHAGEAL	EH S AH F IH JH IY AH L
ULPAN	AH L P AH N
AAH	AA
ERICA	EH R IH K AH
