PE	P IY
ABAMPERE	AH B AE M P AH R
ABAMPERES	AE B AH M P IY R Z
ACROPETAL	AE K R AA P AH T AH L
ACROPETALLY	AE K R AA P AH T AE L IY
AGAMOSPERMIES	AE G AH M AA S AH R M AY Z
AGAMOSPERMY	AE G AH M AA S AH R M IY
AGAPE	AH G EY P
AGAPEIC	AH G EY P IH K
AIRDROPPED	AH IH R D R AA P T
AIRSCAPE	AH IH R S K EY P
AIRSCAPES	AH IH R S K EY P S
AIRSPEED	EH R S P IY D
AIRSPEEDS	AH IH R S P IY D Z
ALIPED	AH L IH P T
ALIPEDS	AH L IH P T S
ALLOTROPE	AE L AH T R OW P
ALLOTROPES	AE L AH T R OW P S
ALLOTYPE	AE L AH T AY P
ALLOTYPES	AE L AH T AY P S
ALOPECIA	AE L AH P IY SH IY AH
ALOPECIAS	AE L AH P IY S IY AH Z
ALOPECIC	AE L AH P AH S AH K
ALPENGLOW	AE L P AH N G L OW
ALPENGLOWS	AE L P AH N G L OW Z
ALPENHORN	AE L P AH N HH AO R N
ALPENHORNS	AE L P AH N HH AO R N Z
ALPENSTOCK	AE L P AH N S T AA K
ALPENSTOCKS	AE L P AH N S T AA K S
AMBROTYPE	AE M B R AH T AY P
AMBROTYPES	AE M B R AH T AY P S
AMINOPEPTIDASE	AH M IY N OW P EH P T AH D EY Z
AMINOPEPTIDASES	AH M IY N OW P EH P T AH D EY Z IH Z
AMPERAGE	AE M P ER IH JH
AMPERAGES	AE M P EH R AH JH AH Z
AMPERE	AE M P ER
AMPERES	AE M P IY R Z
AMPEROMETRIC	AE M P EH R AH M AH T R AH K
AMPERSAND	AE M P ER S AE N D
AMPERSANDS	AE M P AH R S AH N D Z
AMYLOPECTIN	AE M AH L AH P EH K T AH N
AMYLOPECTINS	AE M AH L AH P EH K T AH N Z
ANAPEST	AH N AE P AH S T
ANAPESTIC	AH N AE P AH S T IH K
ANAPESTICS	AH N AE P AH S T IH K S
ANAPESTS	AH N AE P AH S T S
ANCHORPEOPLE	AE NG K ER P IY P AH L
ANCHORPERSON	AE NG K ER P ER S AH N
ANCHORPERSONS	AE NG K ER P ER S AH N Z
ANGIOSPERM	AE N JH IY AA S AH R M
ANGIOSPERMOUS	AE N JH IY AA S AH R M AH S
ANGIOSPERMS	AE N JH IY AA S AH R M Z
ANTECHAPEL	AE N T EH K AH P AH L
ANTECHAPELS	AE N T EH K AH P AH L Z
ANTELOPE	AE N T AH L OW P
ANTELOPES	AE N T AH L OW P S
ANTEPENDIA	AE N T AH P EH N D IY AH
ANTEPENDIUM	AE N T AH P EH N D IY AH M
ANTEPENDIUMS	AE N T AH P EH N D IY AH M Z
ANTEPENULT	AE N T EH P AH N AH L T
ANTEPENULTIMA	AE N T AH P AH N AH L T AH M AH
ANTEPENULTIMAS	AE N T AH P AH N AH L T AH M AH Z
ANTEPENULTIMATE	AE N T AH P AH N AH L T AH M EY T
ANTEPENULTIMATES	AE N T AH P AH N AH L T AH M EY T S
ANTEPENULTS	AE N T EH P AH N AH L T S
ANTETYPE	AE N T AH T AY P
ANTETYPES	AE N T AH T AY P S
ANTICOMPETITIVE	AE N T IH K AH M P EH T IH T IH V
ANTIHERPES	AE N T AH HH AH R P S
ANTIHYPERTENSIVE	AE N T AY HH AY P ER T EH N S IH V
ANTIHYPERTENSIVES	AE N T AY HH AY P ER T EH N S IH V Z
ANTIPERIODIC	AE N T AY P IH R IY AA D IH K
ANTIPERSONNEL	AE N T AY P ER S AH N EH L
ANTIPERSPIRANT	AE N T AY P ER S P AY R AH N T
ANTIPERSPIRANTS	AE N T AY P ER S P AY R AH N T S
ANTIPESTICIDE	AE N T AY P EH S T AH S AY D
ANTIPOPE	AE N T AY P OW P
ANTIPOPES	AE N T AY P OW P S
ANTIRAPE	AE N T AY R EY P
ANTISPECULATION	AE N T AY S P EH K Y AH L EY SH AH N
ANTISPECULATIVE	AE N T AY S P EH K Y AH L AH T IH V
ANTISPENDING	AE N T AY S P EH N D IH NG
ANTITYPE	AE N T AY T AY P
ANTITYPES	AE N T AY T AY P S
APE	EY P
APEAK	AH P IY K
APED	AH P EH D
APEEK	AH P IY K
APELIKE	EY P L AY K
APER	EY P ER
APERCU	AH P AH R K UW
APERCUS	AH P AH R K AH S
APERIENT	EY P AH R IY AH N T
APERIENTS	EY P AH R IY AH N T S
APERIES	EY P AH R IY Z
APERIODIC	AH P IH R IY AA D IH K
APERIODICALLY	AH P IH R IY AA D IH K AH L IY
APERIODICITIES	AH P IH R IY AH D IH S AH T IY Z
APERIODICITY	AH P IH R IY AH D IH S AH T IY
APERITIF	AH P EH R AH T IY F
APERITIFS	AH P EH R AH T AH F S
APERS	EY P ER Z
APERTURE	AE P ER CH ER
APERTURES	AE P AH CH UW R Z
APERY	EY P AH R IY
APES	EY P S
APETALIES	AH P EH T AH L IY Z
APETALOUS	AH P EH T AH L AH S
APETALY	AH P EH T AH L IY
APEX	EY P EH K S
APEXES	EY P EH K S IH Z
APOCOPE	AE P AH K OW P
APOCOPES	AE P AH K OW P S
APOSIOPESES	AH P OW S IY AH P IY Z AH Z
APOSIOPESIS	AH P OW S IY OW P AH S AH S
APOSIOPETIC	AE P AH S IY AH P AH T AH K
APPEAL	AH P IY L
APPEALABILITIES	AH P IY L AH B IH L AH T EH Z
APPEALABILITY	AH P IY L AH B IH L AH T EH
APPEALABLE	AH P IY L AH B AH L
APPEALED	AH P IY L D
APPEALER	AH P IY L ER
APPEALERS	AH P IY L ER Z
APPEALING	AH P IY L IH NG
APPEALINGLY	AH P IY L IH NG L IY
APPEALS	AH P IY L Z
APPEAR	AH P IH R
APPEARANCE	AH P IH R AH N S
APPEARANCES	AH P IH R AH N S AH Z
APPEARED	AH P IH R D
APPEARING	AH P IH R IH NG
APPEARS	AH P IH R Z
APPEASABLE	AH P IY Z AH B AH L
APPEASE	AH P IY Z
APPEASED	AH P IY Z D
APPEASEMENT	AH P IY Z M AH N T
APPEASEMENTS	AH P IY Z M AH N T S
APPEASER	AH P IY Z ER
APPEASERS	AH P IY Z ER Z
APPEASES	AH P IY Z IH Z
APPEASING	AH P IY Z IH NG
APPEL	AE P AH L
APPELLANT	AH P EH L AH N T
APPELLANTS	AH P EH L AH N T S
APPELLATE	AH P EH L IH T
APPELLATE(2)	AH P EH L EY T
APPELLATION	AE P AH L EY SH AH N
APPELLATIONS	AE P AH L EY SH AH N Z
APPELLATIVE	AH P EH L AH T IH V
APPELLATIVELY	AH P EH L AH T IH V L IY
APPELLATIVES	AH P EH L AH T IH V Z
APPELLEE	AH P EH L IY
APPELLEES	AH P EH L IY Z
APPELLOR	AH P EH L ER
APPELLORS	AH P EH L ER Z
APPELS	AE P AH L Z
APPEND	AH P EH N D
APPENDAGE	AH P EH N D IH JH
APPENDAGES	AH P EH N D IH JH IH Z
APPENDANT	AH P EH N D AH N T
APPENDANTS	AH P EH N D AH N T S
APPENDECTOMIES	AE P AH N D EH K T AH M IY Z
APPENDECTOMY	AE P IH N D EH K T AH M IY
APPENDED	AH P EH N D IH D
APPENDICECTOMIES	AE P EH N D AH S EH K T AH M AY Z
APPENDICECTOMY	AE P EH N D AH S EH K T AH M IY
APPENDICES	AH P EH N D IH K S IH Z
APPENDICITIS	AH P EH N D IH S AY T IH Z
APPENDICITISES	AH P EH N D IH K S AH T IY Z IH Z
APPENDICULAR	AE P EH N D IH S Y AH L AH R
APPENDING	AH P EH N D IH NG
APPENDIX	AH P EH N D IH K S
APPENDIXES	AH P EH N D IH K S IH Z
APPENDS	AH P EH N D Z
APPERCEIVE	AE P AH R S IY AH V
APPERCEIVED	AE P AH R S IY AH V D
APPERCEIVES	AE P AH R S IY AH V Z
APPERCEIVING	AE P AH R S IY AH V AH NG
APPERCEPTION	AE P AH R S EH P AH N
APPERCEPTIONS	AE P AH R S EH P T IY AH N Z
APPERCEPTIVE	AE P AH R S EH P T AH V
APPERTAIN	AE P AH R T EY N
APPERTAINED	AE P AH R T EY N D
APPERTAINING	AE P AH R T EY N AH NG
APPERTAINS	AE P AH R T EY N Z
APPESTAT	AE P EH S T AH T
APPESTATS	AE P AH S T EY T S
APPETENCE	AE P AH T AH N S
APPETENCES	AE P AH T EH N S AH Z
APPETENCIES	AE P AH T EH N S AY Z
APPETENCY	AE P AH T EH N S IY
APPETENT	AE P AH T AH N T
APPETISER	AE P EH T AH S AH R
APPETISERS	AE P EH T AH S AH R Z
APPETISING	AE P AH T AY Z AH NG
APPETITE	AE P AH T AY T
APPETITES	AE P AH T AY T S
APPETITIVE	AE P AH T AY T IH V
APPETIZER	AE P AH T AY Z ER
APPETIZERS	AE P AH T AY Z ER Z
APPETIZING	AE P IH T AY Z IH NG
APPETIZINGLY	AE P AH T AY Z IH NG L IY
ARCHETYPE	AA R K IH T AY P
ARCHETYPES	AA R K IH T AY P S
ARCHIPELAGIC	AA R K IH P AH L AH JH AH K
ARCHIPELAGO	AA R K AH P EH L AH G OW
ARCHIPELAGO(2)	AA R CH AH P AH L EY G OW
ARCHIPELAGOES	AA R K AH P EH L AH G OW Z
ARCHIPELAGOS	AA R K AH P EH L AH G OW Z
ARPEGGIATE	AA R P EH JH AY EY T
ARPEGGIATED	AA R P EH JH AY EY T AH D
ARPEGGIATES	AA R P EH JH AY EY T S
ARPEGGIATING	AA R P EH JH AY EY T AH NG
ARPEGGIO	AA R P EH JH IY OW
ARPEGGIOS	AA R P EH JH IY OW Z
ARPEN	AA R P AH N
ARPENS	AA R P AH N Z
ARPENT	AA R P AH N T
ARPENTS	AA R P AH N T S
ARTHROSCOPE	AA R TH R AH S OW P
ARTHROSCOPES	AA R TH R AH S OW P S
ARUSPEX	AH R AH S AH K S
ASLOPE	AH S L OW P
ASPECT	AE S P EH K T
ASPECTS	AE S P EH K T S
ASPECTUAL	AE S EH K T Y AH W AH
ASPEN	AE S P AH N
ASPENS	AE S P AH N Z
ASPER	AE S P ER
ASPERATE	AH Z P ER EY T
ASPERATED	AH Z P ER AH T EH D
ASPERATES	AH Z P ER EY T S
ASPERATING	AH Z P ER EY T IH NG
ASPERGES	AE S AH R JH AH Z
ASPERGILLA	AE S AH R JH IH L AH
ASPERGILLI	AE S AH R JH IH L IY
ASPERGILLOSES	AH Z P ER G IH L AA S IH Z
ASPERGILLOSIS	AH Z P ER G IH L AA S IY Z
ASPERGILLUM	AE S AH R JH IH L AH M
ASPERGILLUMS	AE S AH R JH IH L AH M Z
ASPERGILLUS	AE S AH R JH IH L AH S
ASPERITIES	AE S EH R AH T AY Z
ASPERITY	AH S P EH R IH T IY
ASPERS	AE S AH R Z
ASPERSE	AE S AH R S
ASPERSED	AE S AH R Z D
ASPERSER	AE S EH R Z AH R
ASPERSERS	AE S AH R S AH R Z
ASPERSES	AE S AH R S AH Z
ASPERSING	AH Z P ER S IH NG
ASPERSION	AH S P ER ZH AH N
ASPERSIONS	AH S P ER ZH AH N Z
ASPERSOR	AE S AH R S AH R
ASPERSORS	AE S AH R S AH R Z
ATTEMPER	AE T EH M P AH R
ATTEMPERED	AE T AH M P IY R D
ATTEMPERING	AE T AH M P IY R AH NG
ATTEMPERS	AE T EH M P AH R Z
AUDIOTAPE	AO D IY OW T EY P
AUDIOTAPES	AO D IY OW T EY P S
AUSPEX	AO S AH K S
AUTOTYPE	AO T OW T AY P
AUTOTYPES	AO T OW T AY P S
AZEOTROPE	EY Z IY AH T R OW P
AZEOTROPES	EY Z IY AH T R OW P S
AZOOSPERMIA	AE Z UW S AH R M IY AH
AZOOSPERMIAS	AE Z UW S AH R M IY AH Z
BACKDROPPED	B AE K D R AA P T
BACKPEDAL	B AE K P EH D AH L
BACKPEDALED	B AE K P EH D AH L D
BACKPEDALING	B AE K P EH D AH L IH NG
BACKPEDALING(2)	B AE K P EH D L IH NG
BACKPEDALLED	B AE K P EH D AH L D
BACKPEDALLING	B AE K P EH D AH L IH NG
BACKPEDALS	B AE K P EH D AH L Z
BACKSLAPPED	B AE K S L AE P T
BACKSLAPPER	B AE K S L AE P ER
BACKSLAPPERS	B AE K S L AE P ER Z
BACKSTOPPED	B AE K S T AA P T
BAGPIPE	B AE G P AY P
BAGPIPER	B AE G P AY P ER
BAGPIPERS	B AE G P AY P ER Z
BAGPIPES	B AE G P AY P S
BARHOPPED	B AA R HH AA P T
BARKEEPER	B AA R K IY P ER
BARKEEPERS	B AA R K IY P ER Z
BASIPETAL	B AH S IH P AH T AH L
BASIPETALLY	B AH S IH P AH T AE L IY
BATHYPELAGIC	B AH TH IH P AH L AH JH AH K
BEBOPPER	B IY B AA P ER
BEBOPPERS	B IY B AA P ER Z
BECAPPED	B IH K AE P T
BECARPET	B IH K AA R P AH T
BECARPETED	B IH K AA R P AH T IH D
BECARPETING	B IH K AA R P AH T IH NG
BECARPETS	B IH K AA R P AH T S
BECLASPED	B IH K L AE S P T
BEDIAPER	B IH D AY P ER
BEDIAPERED	B IH D AY P ER D
BEDIAPERING	B IH D AY P ER IH NG
BEDIAPERS	B IH D AY P ER Z
BEDRAPE	B IH D R EY P
BEDRAPED	B IH D R EY P T
BEDRAPES	B IH D R EY P S
BEEKEEPER	B IY K IY P ER
BEEKEEPERS	B IY K IY P ER Z
BEEPED	B IY P T
BEEPER	B IY P ER
BEEPERS	B IY P ER Z
BELEAPED	B IH L IY P T
BESPEAK	B IH S P IY K
BESPEAKING	B IH S P IY K IH NG
BESPEAKS	B IH S P IY K S
BESPECTACLED	B IH S P EH K T AH K AH L D
BETHUMPED	B IH TH AH M P T
BEWRAPPED	B IH R AE P T
BIBLIOPEGIC	B AY B L AY AH P AH JH AH K
BIBLIOPEGIES	B AY B L AY AA P AH JH AY Z
BIBLIOPEGIST	B AY B L AY AA P AH JH AH S T
BIBLIOPEGISTS	B AY B L AY AA P AH JH AH S T S
BIBLIOPEGY	B AY B L AY AA P AH JH IY
BIOSCOPE	B AY AA S K OW P
BIOSCOPES	B AY AA S K OW P S
BIOTOPE	B AY AH T OW P
BIOTOPES	B AY AH T OW P S
BIOTYPE	B AY AH T AY P
BIOTYPES	B AY AH T AY P S
BIPED	B AY P EH D
BIPEDAL	B AY P EH D AH L
BIPEDALISM	B AY P EH D AH L IH Z AH M
BIPEDALISMS	B AY P EH D AH L IH Z AH M Z
BIPEDALITIES	B AY P EH D AH L AH T IY Z
BIPEDALITY	B AY P EH D AH L AH T IY
BIPEDALLY	B AY P EH D AH L IY
BIPEDS	B AY P EH D Z
BIPROPELLANT	B AY P R OW P EH L AH N T
BIPROPELLANTS	B AY P R OW P EH L AH N T S
BISHOPED	B IH SH AH P T
BLACKTOPPED	B L AE K T AA P T
BLEEPED	B L IY P T
BLIPPED	B L IH P T
BLOOPED	B L UW P T
BLOOPER	B L UW P ER
BLOOPERS	B L UW P ER Z
BLOWPIPE	B L OW P AY P
BLOWPIPES	B L OW P AY P S
BLYPE	B L AY P
BLYPES	B L AY P S
BOLTROPE	B OW L T R OW P
BOLTROPES	B OW L T R OW P S
BONSPELL	B AA N S AH L
BONSPELLS	B AA N S AH L Z
BOOKKEEPER	B UH K K IY P ER
BOOKKEEPERS	B UH K K IY P ER Z
BOOTSTRAPPED	B UW T S T R AE P T
BOPEEP	B OW P IY P
BOPEEPS	B OW P IY P S
BOPPED	B AA P T
BOPPER	B AA P ER
BOPPERS	B AA P ER Z
BORESCOPE	B AO R S K OW P
BORESCOPES	B AO R S K OW P S
BRONCHOSCOPE	B R AA N K AH S K OW P
BRONCHOSCOPES	B R AO NG K AH S OW P S
BROOMRAPE	B R UW M R EY P
BROOMRAPES	B R UW M R EY P S
BULLPEN	B UH L P EH N
BULLPENS	B UH L P EH N Z
BULLWHIPPED	B UH L W IH P T
BUMPED	B AH M P T
BUMPER	B AH M P ER
BUMPERED	B AH M P ER D
BUMPERING	B AH M P ER IH NG
BUMPERS	B AH M P ER Z
BURPED	B AH R P T
BUSINESSPEOPLE	B IH Z N AH S P IY P AH L
BUSINESSPERSON	B IH Z N AH S P ER S AH N
BUSINESSPERSONS	B IH Z N AH S P ER S AH N Z
CALIPEE	K AE L AH P IY IY
CALIPEES	K AE L AH P IY Z
CALIPER	K AE L AH P ER
CALIPERED	K AE L AH P ER D
CALIPERING	K AE L AH P ER IH NG
CALIPERS	K AE L AH P ER Z
CALLIOPE	K AH L AY AH P IY
CALLIOPES	K AH L AY AH P IY Z
CALLIPEE	K AE L AH P IY IY
CALLIPEES	K AE L AH P IY Z
CALLIPER	K AE L AY P AH R
CALLIPERED	K AE L AH P IY R D
CALLIPERING	K AE L AH P IY R AH NG
CALLIPERS	K AE L AH P AH R Z
CALOTYPE	K AE L AH T AY P
CALOTYPES	K AE L AH T AY P S
CAMERAPERSON	K AE M R AH P ER S AH N
CAMERAPERSONS	K AE M R AH P ER S AH N Z
CAMPED	K AE M P T
CAMPER	K AE M P ER
CAMPERS	K AE M P ER Z
CAMPESINO	K AE M P EH S AH N OW
CAMPESINOS	K AE M P EH S IY N OW S
CAMPESTRAL	K AE M P EH S T R AH L
CANAPE	K AE N EY P
CANAPES	K AE N EY P S
CANTALOUPE	K AE N T AH L OW P
CANTALOUPES	K AE N T AH L OW P S
CAPE	K EY P
CAPED	K EY P T
CAPELAN	K AE P EY L AA N
CAPELANS	K AE P EY L AA N Z
CAPELET	K EY P L AH T
CAPELETS	K EY P L AH T S
CAPELIN	K AE P AH L AH N
CAPELINS	K AE P AH L AH N Z
CAPER	K EY P ER
CAPERCAILLIE	K AE P AH R K EY L AY
CAPERCAILLIES	K AH P AH R K EY L AY Z
CAPERCAILZIE	K AE P ER K EY L Z IY
CAPERCAILZIES	K AE P ER K EY L Z IY Z
CAPERED	K EY P ER D
CAPERER	K EY P ER ER
CAPERERS	K EY P ER ER Z
CAPERING	K EY P ER IH NG
CAPERS	K EY P ER Z
CAPES	K EY P S
CAPESKIN	K EY P S K IH N
CAPESKINS	K EY P S K IH N Z
CAPEWORK	K EY P W ER K
CAPEWORKS	K EY P W ER K S
CAPPED	K AE P T
CAPPELLETTI	K AA P EH L EH T IY
CAPPER	K AE P ER
CAPPERS	K EY P ER Z
CARBOXYPEPTIDASE	K AA R B AA K S IY P EH P T AH D EY Z
CARBOXYPEPTIDASES	K AA R B AA K S IY P EH P T AH D EY Z IH Z
CARDSHARPER	K AA R D SH AA R P ER
CARDSHARPERS	K AA R D SH AA R P ER Z
CARPED	K AA R P T
CARPEL	K AA R P AH L
CARPELLARY	K AA R P AH L EH R IY
CARPELLATE	K AA R P AH L EY T
CARPELS	K AA R P AH L Z
CARPENTER	K AA R P AH N T ER
CARPENTERED	K AA R P AH N T ER D
CARPENTERING	K AA R P AH N T ER IH NG
CARPENTERS	K AA R P AH N T ER Z
CARPENTRIES	K AA R P AH N T R IY Z
CARPENTRY	K AA R P AH N T R IY
CARPER	K AA R P ER
CARPERS	K AA R P ER Z
CARPET	K AA R P AH T
CARPETBAG	K AA R P AH T B AE G
CARPETBAGGER	K AA R P AH T B AE G ER
CARPETBAGGERIES	K AA R P AH T B AE G AH R IY Z
CARPETBAGGERS	K AA R P AH T B AE G ER Z
CARPETBAGGERY	K AA R P AH T B AE G AH R IY
CARPETBAGGING	K AA R P AH T B AE G IH NG
CARPETBAGS	K AA R P AH T B AE G Z
CARPETED	K AA R P AH T IH D
CARPETING	K AA R P AH T IH NG
CARPETINGS	K AA R P AH T IH NG Z
CARPETS	K AA R P AH T S
CARPETWEED	K AA R P AH T W IY D
CARPETWEEDS	K AA R P AH T W IY D Z
CARROTTOPPED	K AE R AH T AA P T
CARTOPPER	K AA R T AA P ER
CARTOPPERS	K AA R T AA P ER Z
CATCHPENNY	K AE CH P EH N IY
CATNAPER	K AE T N AE P ER
CATNAPERS	K AE T N AE P ER Z
CATNAPPED	K AE T N AE P T
CATNAPPER	K AE T N AE P ER
CATNAPPERS	K AE T N AE P ER Z
CENOSPECIES	S AH N AA S AH S AY Z
CENTIPEDE	S EH N T IH P IY D
CENTIPEDES	S EH N T AH P IY D Z
CENTRIPETAL	S EH N T R IH P AH T AH L
CENTRIPETALLY	S EH N T R AY P T AE L IY
CEPE	S IY P
CEPES	S IY P S
CEROTYPE	S EH R AH T AY P
CEROTYPES	S EH R AH T AY P S
CHAIRPERSON	CH EH R P ER S AH N
CHAIRPERSONS	CH EH ER P ER S AH N Z
CHAMPED	CH AE M P T
CHAMPER	CH AE M P ER
CHAMPERS	CH AE M P ER Z
CHAMPERTIES	CH AE M P ER T AY Z
CHAMPERTOUS	CH AE M P AH R T AH S
CHAMPERTY	CH AE M P EH R T IY
CHAPE	CH EY P
CHAPEAU	CH EY P IY UW
CHAPEAUS	CH EY P IY AH S
CHAPEAUX	CH EY P IY AH K S
CHAPEL	CH AE P AH L
CHAPELS	CH AE P AH L Z
CHAPERON	SH AE P AH R OW N
CHAPERONAGE	SH AE P AH R OW N IH JH
CHAPERONAGES	SH AE P AH R OW N IH JH IH Z
CHAPERONE	SH AE P ER OW N
CHAPERONED	SH AE P AH R OW N D
CHAPERONES	SH AE P ER OW N Z
CHAPERONING	SH AE P ER OW N IH NG
CHAPERONS	SH AE P AH R OW N Z
CHAPES	CH EY P S
CHAPPED	CH AE P T
CHEAPEN	CH IY P AH N
CHEAPENED	CH IY P AH N D
CHEAPENING	CH IY P AH N IH NG
CHEAPENS	CH IY P AH N Z
CHEAPER	CH IY P ER
CHEAPEST	CH IY P AH S T
CHEEPED	CH IY P T
CHEEPER	CH IY P AH R
CHEEPERS	CH IY P AH R Z
CHELIPED	CH AH L AY P T
CHELIPEDS	CH EH L AH P AH D Z
CHEMOTHERAPEUTIC	K EH M AH TH AH R EY P AH Y UW T AH K
CHEMOTHERAPEUTICALLY	K AH M AA TH AH R EY P Y UW T AH K AE L IY
CHEMOTHERAPEUTICS	K EH M AH TH AH R EY P AH Y UW T AH S Z
CHICKPEA	CH IH K P IY
CHICKPEAS	CH IH K P IY Z
CHIPPED	CH IH P T
CHIPPER	CH IH P ER
CHIPPERED	CH IH P ER D
CHIPPERING	CH IH P ER IH NG
CHIPPERS	CH IH P ER Z
CHIRPED	CH ER P T
CHIRPER	CH ER P ER
CHIRPERS	CH ER P ER Z
CHIRRUPED	CH AH R UW P T
CHOMPED	CH AA M P T
CHOMPER	CH AA M P AH R
CHOMPERS	CH AA M P AH R Z
CHOPPED	CH AA P T
CHOPPER	CH AA P ER
CHOPPERED	CH AA P ER D
CHOPPERING	CH AA P ER IH NG
CHOPPERS	CH AA P ER Z
CHUMPED	CH AH M P T
CIRCUMSPECT	S ER K AH M S P EH K T
CIRCUMSPECTION	S ER K AH M S P EH K SH AH N
CIRCUMSPECTIONS	S ER K AH M S P EH K SH AH N Z
CIRCUMSPECTLY	S ER K AH M S P EH K T L IY
CIRRIPED	S AH R AY P T
CIRRIPEDS	S AH R AH P AH D Z
CITYSCAPE	S IH T IY S K EY P
CITYSCAPES	S IH T IY S K EY P S
CLAMPED	K L AE M P T
CLAMPER	K L AE M P ER
CLAMPERS	K L AE M P ER Z
CLAPPED	K L AE P T
CLAPPER	K L AE P ER
CLAPPERCLAW	K L AE P ER K L AO
CLAPPERCLAWED	K L AE P ER K L AO D
CLAPPERCLAWING	K L AE P ER K L AO IH NG
CLAPPERCLAWS	K L AE P ER K L AO Z
CLAPPERS	K L AE P ER Z
CLASPED	K L AE S P T
CLASPER	K L AE S P ER
CLASPERS	K L AE S P ER Z
CLEPE	K L IY P
CLEPED	K L IY P T
CLEPES	K L IY P S
CLIPPED	K L IH P T
CLIPPER	K L IH P ER
CLIPPERS	K L IH P ER Z
CLODHOPPER	K L AA D HH AA P ER
CLODHOPPERS	K L AA D HH AA P ER Z
CLOMPED	K L AA M P T
CLOPPED	K L AA P T
CLOUDSCAPE	K L AW D S K EY P
CLOUDSCAPES	K L AW D S K EY P S
CLUMPED	K L AH M P T
CLUPEID	K L UW P IY D
CLUPEIDS	K L UW P IY D Z
CLUPEOID	K L UW P IY OY D
CLUPEOIDS	K L UW P IY OY D Z
CLYPEAL	K L AY P IY AH L
CLYPEATE	K L AY P IY EY T
CLYPEI	K L IH P IY
CLYPEUS	K L AY P IY AH S
COAPPEAR	K OW AH P IH ER
COAPPEARED	K OW AH P IH ER D
COAPPEARING	K OW AH P IH ER IH NG
COAPPEARS	K OW AH P IH ER Z
COCHAIRPERSON	K OW CH EH ER P ER S AH N
COCHAIRPERSONS	K OW CH EH ER P ER S AH N Z
CODEPENDENCE	K OW D IH P EH N D AH N S
CODEPENDENCES	K OW D IH P EH N D AH N S IH Z
CODEPENDENCIES	K OW D IH P EH N D AH N S IY Z
CODEPENDENCY	K OW D IH P EH N D AH N S IY
CODEPENDENT	K OW D IY P EH N D EH N T
CODEPENDENTS	K OW D IY P EH N D EH N T S
CODEVELOPED	K OW D IH V EH L AH P T
CODEVELOPER	K OW D IH V EH L AH P ER
CODEVELOPERS	K OW D IH V EH L AH P ER Z
COLLOTYPE	K AA L AH T AY P
COLLOTYPES	K AA L AH T AY P S
COMPED	K AH M P EH D
COMPEER	K AH M P IH ER
COMPEERED	K AH M P IH ER D
COMPEERING	K AH M P IH ER IH NG
COMPEERS	K AH M P IH ER Z
COMPEL	K AH M P EH L
COMPELLABLE	K AH M P EH L AH B AH L
COMPELLATION	K AH M P EH L EY SH AH N
COMPELLATIONS	K AH M P EH L EY SH AH N Z
COMPELLED	K AH M P EH L D
COMPELLING	K AH M P EH L IH NG
COMPELLINGLY	K AH M P EH L IH NG L IY
COMPELS	K AH M P EH L Z
COMPEND	K AH M P EH N D
COMPENDIA	K AA M P EH N D IY AH
COMPENDIOUS	K AH M P EH N D AY AH S
COMPENDIOUSLY	K AH M P EH N D AY AH S L IY
COMPENDIOUSNESS	K AH M P EH N D AY AH S N AH S
COMPENDIOUSNESSES	K AH M P EH N D AY AH S N AH S IH Z
COMPENDIUM	K AH M P EH N D IY AH M
COMPENDIUMS	K AH M P EH N D IY AH M Z
COMPENDS	K AH M P EH N D Z
COMPENSABILITIES	K AH M P EH N S AH B IH L AH T EH Z
COMPENSABILITY	K AH M P EH N S AH B IH L AH T EH
COMPENSABLE	K AH M P EH N S AH B AH L
COMPENSATE	K AA M P AH N S EY T
COMPENSATED	K AA M P AH N S EY T AH D
COMPENSATES	K AA M P AH N S EY T S
COMPENSATING	K AA M P AH N S EY T IH NG
COMPENSATION	K AA M P AH N S EY SH AH N
COMPENSATIONAL	K AH M P EH N S EY SH AH N AH L
COMPENSATIONS	K AA M P AH N S EY SH AH N Z
COMPENSATIVE	K AA M P AH N S EY T IH V
COMPENSATOR	K AA M P AH N S EY T ER
COMPENSATORS	K AA M P AH N S EY T ER Z
COMPENSATORY	K AH M P EH N S AH T AO R IY
COMPERE	K AA M P AH R
COMPERED	K AA M P IY R D
COMPERES	K AA M P IY R Z
COMPERING	K AA M P IY R AH NG
COMPETE	K AH M P IY T
COMPETED	K AH M P IY T IH D
COMPETENCE	K AA M P AH T IH N S
COMPETENCES	K AA M P AH T AH N S IH Z
COMPETENCIES	K AA M P AH T IH N S IY Z
COMPETENCY	K AA M P AH T IH N S IY
COMPETENT	K AA M P AH T IH N T
COMPETENTLY	K AA M P AH T IH N T L IY
COMPETES	K AH M P IY T S
COMPETING	K AH M P IY T IH NG
COMPETITION	K AA M P AH T IH SH AH N
COMPETITIONS	K AA M P AH T IH SH AH N Z
COMPETITIVE	K AH M P EH T AH T IH V
COMPETITIVE(2)	K AH M P EH T IH T IH V
COMPETITIVELY	K AH M P EH T IH T IH V L IY
COMPETITIVENESS	K AH M P EH T IH T IH V N IH S
COMPETITIVENESSES	K AH M P EH T AH T IH V N AH S IH Z
COMPETITOR	K AH M P EH T AH T ER
COMPETITOR(2)	K AH M P EH T IH T ER
COMPETITORS	K AH M P EH T AH T ER Z
COMPETITORS(2)	K AH M P EH T IH T ER Z
CONGRESSPEOPLE	K AA NG G R AH S P IY P AH L
CONGRESSPERSON	K AA NG G R AH S P ER S AH N
CONGRESSPERSONS	K AA NG G R AH S P ER S AH N Z
CONSPECIFIC	K AH N S P IH S IH F IH K
CONSPECIFICS	K AH N S P IH S IH F IH K S
CONSPECTUS	K AA N S EH K T AH S
CONSPECTUSES	K AA N S EH K T Y UW Z AH Z
COOPED	K UW P T
COOPER	K UW P ER
COOPERAGE	K UW P ER AH JH
COOPERAGES	K OW AA P ER IH JH IH Z
COOPERATE	K OW AA P ER EY T
COOPERATE(2)	K W AA P ER EY T
COOPERATED	K OW AA P ER EY T AH D
COOPERATED(2)	K W AA P ER EY T AH D
COOPERATES	K OW AA P ER EY T S
COOPERATING	K OW AA P ER EY T IH NG
COOPERATION	K OW AA P ER EY SH AH N
COOPERATION(2)	K W AA P ER EY SH AH N
COOPERATION(3)	K W AO P ER EY SH AH N
COOPERATIONIST	K OW AA P ER EY SH AH N IH S T
COOPERATIONISTS	K OW AA P ER EY SH AH N IH S T S
COOPERATIONS	K OW AA P ER EY SH AH N Z
COOPERATIONS(2)	K W AA P ER EY SH AH N Z
COOPERATIVE	K OW AA P ER EY T IH V
COOPERATIVELY	K OW AA P R AH T IH V L IY
COOPERATIVENESS	K OW AA P ER AH T IH V N AH S
COOPERATIVENESSES	K OW AA P ER AH T IH V N AH S IH Z
COOPERATIVES	K OW AA P R AH T IH V Z
COOPERATOR	K OW AA P ER AH T ER
COOPERATORS	K OW AA P ER AH T ER Z
COOPERED	K UW P ER D
COOPERIES	K OW AA P ER IY Z
COOPERING	K UW P ER IH NG
COOPERS	K UW P ER Z
COOPERY	K OW AA P ER IY
COPE	K OW P
COPECK	K OW P EH K
COPECKS	K OW P EH K S
COPED	K OW P T
COPEMATE	K OW P M EY T
COPEMATES	K OW P M EY T S
COPEN	K OW P AH N
COPENS	K OW P EH N Z
COPEPOD	K OW P AA D
COPEPODS	K OW P AA D Z
COPER	K OW P ER
COPERS	K OW P ER Z
COPES	K OW P S
COPESETIC	K OW P S EH T IH K
COPESTONE	K OW P S T OW N
COPESTONES	K OW P S T OW N Z
COPPED	K AA P T
COPPER	K AA P ER
COPPERAH	K AH P EH R AH
COPPERAHS	K AH P EH R AH Z
COPPERAS	K AH P EH R AH Z
COPPERASES	K AA P AH R EY Z AH Z
COPPERED	K AA P ER D
COPPERHEAD	K AA P ER HH EH D
COPPERHEADS	K AA P ER HH EH D Z
COPPERING	K AA P ER IH NG
COPPERPLATE	K AA P ER P L EY T
COPPERPLATES	K AA P ER P L EY T S
COPPERS	K AA P ER Z
COPPERSMITH	K AA P ER S M IH TH
COPPERSMITHS	K AA P ER S M IH TH S
COPPERY	K AA P ER IY
COPROSPERITIES	K OW P R AA S P EH R AH T IY Z
COPROSPERITY	K OW P R AA S P EH R AH T IY
COTYPE	K OW T AY P
COTYPES	K OW T AY P S
COUNTERPETITION	K AW N T ER P AH T IH SH AH N
COUNTERPETITIONED	K AW N T ER P AH T IH SH AH N D
COUNTERPETITIONING	K AW N T ER P AH T IH SH AH N IH NG
COUNTERPETITIONS	K AW N T ER P AH T IH SH AH N Z
COUNTERSNIPER	K AW N T ER S N AY P ER
COUNTERSNIPERS	K AW N T ER S N AY P ER Z
COUNTERSPELL	K AW N T ER S P EH L
COUNTERSPELLS	K AW N T ER S P EH L Z
COUNTERSTEPPED	K AW N T ER S T EH P T
COUPE	K UW P
COUPED	K UW P EY D
COUPES	K UW P S
COWPEA	K AW P IY
COWPEAS	K AW P IY Z
CRAFTSPEOPLE	K R AE F T S P IY P AH L
CRAFTSPEOPLE(2)	K R AE F S P IY P AH L
CRAFTSPERSON	K R AE F T S P ER S AH N
CRAFTSPERSONS	K R AE F T S P ER S AH N Z
CRAMPED	K R AE M P T
CRAPE	K R EY P
CRAPED	K R AE P T
CRAPES	K R EY P S
CRAPPED	K R AE P T
CRAPPER	K R AE P ER
CRAPPERS	K R AE P ER Z
CREEPER	K R IY P ER
CREEPERS	K R IY P ER Z
CREPE	K R EY P
CREPED	K R EY P T
CREPES	K R EY P S
CREPEY	K R EY P IY
CRIMPED	K R IH M P T
CRIMPER	K R IH M P AH R
CRIMPERS	K R IH M P AH R Z
CRIPE	K R AY P
CRIPES	K R AY P S
CRISPED	K R IH S P T
CRISPEN	K R IH S P AH N
CRISPENED	K R IH S P AH N D
CRISPENING	K R IH S P AH N IH NG
CRISPENS	K R IH S P AH N Z
CRISPER	K R IH S P ER
CRISPERS	K R IH S P ER Z
CRISPEST	K R IH S P AH S T
CROPPED	K R AA P T
CROPPER	K R AA P ER
CROPPERS	K R AA P ER Z
CROUPE	K R UW P
CROUPES	K R UW P S
CROWKEEPER	K R OW K IY P ER
CROWKEEPERS	K R OW K IY P ER Z
CROWSTEPPED	K R OW S T EH P T
CRUMPED	K R AH M P T
CRUMPET	K R AH M P AH T
CRUMPETS	K R AH M P AH T S
CRUPPER	K R AH P ER
CRUPPERS	K R AH P ER Z
CRYOSCOPE	K R AY AA S K OW P
CRYOSCOPES	K R AY AA S K OW P S
CUPEL	K Y UW P AH L
CUPELED	K Y UW P IY L D
CUPELER	K Y UW P IY L AH R
CUPELERS	K Y UW P AH L AH R Z
CUPELING	K Y UW P IY L AH NG
CUPELLATION	K Y UW P AH L EY SH AH N
CUPELLATIONS	K Y UW P AH L EY T IY AH N Z
CUPELLED	K Y UW P AH L D
CUPELLER	K Y UW P EH L AH R
CUPELLERS	K Y UW P EH L AH R Z
CUPELLING	K Y UW P EH L AH NG
CUPELS	K Y UW P AH L Z
CUPPED	K AH P T
CUPPER	K AH P ER
CUPPERS	K AH P ER Z
CURLPAPER	K ER L P EY P ER
CURLPAPERS	K ER L P EY P ER Z
CUSPED	K AH S P T
CYCLOPEAN	S AY K L AH P IY AH N
CYCLOPEDIA	S IH K L AH P IY D IY AH
CYCLOPEDIAS	S IH K L AH P IY D IY AH Z
CYCLOPEDIC	S IH K L AH P AH D AH K
CYCLOPES	S IH K L OW P S
CYPRIPEDIA	S IH P R AH P IY D IY AH
CYPRIPEDIUM	S IH P R AH P IY D IY AH M
CYPRIPEDIUMS	S IH P R AH P IY D IY AH M Z
CYSTOSCOPE	S IH S T AA S K OW P
CYSTOSCOPES	S IH S T AA S K OW P S
DAGUERREOTYPE	D AE G W EH R IY AH T AY P
DAGUERREOTYPED	D AE G W EH R IY AH T AY P T
DAGUERREOTYPES	D AE G W EH R IY AH T AY P S
DAMPED	D AE M P T
DAMPEN	D AE M P AH N
DAMPENED	D AE M P AH N D
DAMPENER	D AE M P AH N ER
DAMPENERS	D AE M P AH N ER Z
DAMPENING	D AE M P AH N IH NG
DAMPENING(2)	D AE M P N IH NG
DAMPENS	D AE M P AH N Z
DAMPER	D AE M P ER
DAMPERS	D AE M P ER Z
DAMPEST	D AE M P AH S T
DAPPED	D AE P T
DAPPER	D AE P ER
DAPPERER	D AE P ER ER
DAPPEREST	D AE P ER AH S T
DAPPERLY	D AE P ER L IY
DAPPERNESS	D AE P ER N AH S
DAPPERNESSES	D AE P ER N AH S IH Z
DECAMPED	D IY K AE M P T
DECOMPENSATE	D IY K AA M P AH N S EY T
DECOMPENSATED	D IY K AA M P AH N S EY T IH D
DECOMPENSATES	D IY K AA M P AH N S EY T S
DECOMPENSATING	D IY K AA M P AH N S EY T IH NG
DECOMPENSATION	D IY K AH M P EH N S EY SH AH N
DECOMPENSATIONS	D IY K AH M P EH N S EY SH AH N Z
DEEPEN	D IY P AH N
DEEPENED	D IY P AH N D
DEEPENER	D IY P AH N ER
DEEPENERS	D IY P AH N ER Z
DEEPENING	D IY P AH N IH NG
DEEPENS	D IY P AH N Z
DEEPER	D IY P ER
DEEPEST	D IY P AH S T
DEPAUPERATE	D IY P AO P ER AH T
DEPEND	D IH P EH N D
DEPENDABILITIES	D IH P EH N D AH B IH L AH T EH Z
DEPENDABILITY	D IH P EH N D AH B IH L IH T IY
DEPENDABLE	D IH P EH N D AH B AH L
DEPENDABLENESS	D IH P EH N D AH B AH L N AH S
DEPENDABLENESSES	D IH P EH N D AH B AH L N AH S IH Z
DEPENDABLY	D IY P EH N D AE B L IY
DEPENDANCE	D IY P EH N D AE N S
DEPENDANCES	D IY P EH N D AE N S IH Z
DEPENDANT	D IY P EH N D AH N T
DEPENDANTS	D IY P EH N D AH N T S
DEPENDED	D IH P EH N D AH D
DEPENDED(2)	D IH P EH N D IH D
DEPENDENCE	D IH P EH N D AH N S
DEPENDENCES	D IH P EH N D AH N S IH Z
DEPENDENCIES	D IH P EH N D AH N S IY Z
DEPENDENCY	D IH P EH N D AH N S IY
DEPENDENT	D IH P EH N D AH N T
DEPENDENTLY	D IY P EH N D EH N T L IY
DEPENDENTS	D IH P EH N D AH N T S
DEPENDING	D IH P EH N D IH NG
DEPENDS	D IH P EH N D Z
DEPERM	D AH P AH R M
DEPERMED	D AH P AH R M D
DEPERMING	D AH P AH R M AH NG
DEPERMS	D AH P AH R M Z
DEPERSONALIZATION	D IY P ER S AH N AH L AH Z EY SH AH N
DEPERSONALIZATIONS	D IY P ER S AH N AH L AH Z EY SH AH N Z
DEPERSONALIZE	D IY P ER S AH N AH L AY Z
DEPERSONALIZE(2)	D IY P ER S N AH L AY Z
DEPERSONALIZED	D IY P ER S AH N AH L AY Z D
DEPERSONALIZES	D IY P ER S AH N AH L AY Z IH Z
DEPERSONALIZING	D IY P ER S AH N AH L AY Z IH NG
DESPERADO	D EH S P ER AA D OW
DESPERADOES	D EH S P ER AA D OW Z
DESPERADOS	D EH S P AH R AA D OW Z
DESPERATE	D EH S P R IH T
DESPERATE(2)	D EH S P ER IH T
DESPERATELY	D EH S P ER AH T L IY
DESPERATELY(2)	D EH S P R AH T L IY
DESPERATENESS	D EH S P R AH T N AH S
DESPERATENESSES	D EH S P R AH T N AH S IH Z
DESPERATION	D EH S P ER EY SH AH N
DESPERATION(2)	D EH S P ER EY SH IH N
DESPERATIONS	D EH S P AH R EY SH AH N Z
DEUTERANOPE	D IY Y AH T EH R AH N OW P
DEUTERANOPES	D IY Y AH T EH R AH N OW P S
DEVELOPE	D IH V AH L OW P
DEVELOPED	D IH V EH L AH P T
DEVELOPER	D IH V EH L AH P ER
DEVELOPERS	D IH V EH L AH P ER Z
DEVELOPES	D IH V AH L OW P S
DEWLAPPED	D UW L AE P T
DIAPEDESES	D AY AE P AH D IY Z AH Z
DIAPEDESIS	D AY AH P IY D AH S AH S
DIAPER	D AY P ER
DIAPERED	D AY P ER D
DIAPERING	D AY P ER IH NG
DIAPERS	D AY AH P ER Z
DIAPERS(2)	D AY P ER Z
DICHROSCOPE	D IH K R AH S OW P
DICHROSCOPES	D IH K R AH S OW P S
DIDAPPER	D AH D AE P AH R
DIDAPPERS	D AH D AE P AH R Z
DIPEPTIDASE	D AH P EH P T AH D EY Z
DIPEPTIDASES	D AH P EH P T AH D EY Z AH Z
DIPEPTIDE	D IH P AH P T AY D
DIPEPTIDES	D IH P AH P T AY D Z
DIPPED	D IH P T
DIPPER	D IH P ER
DIPPERFUL	D IH P ER F AH L
DIPPERFULS	D IH P ER F AH L Z
DIPPERS	D IH P ER Z
DISAPPEAR	D IH S AH P IH R
DISAPPEAR(2)	D IH S AH P IY R
DISAPPEARANCE	D IH S AH P IH R AH N S
DISAPPEARANCE(2)	D IH S AH P IY R AH N S
DISAPPEARANCES	D IH S AH P IH R AH N S IH Z
DISAPPEARANCES(2)	D IH S AH P IY R AH N S IH Z
DISAPPEARED	D IH S AH P IH R D
DISAPPEARED(2)	D IH S AH P IY R D
DISAPPEARING	D IH S AH P IH R IH NG
DISAPPEARING(2)	D IH S AH P IY R IH NG
DISAPPEARS	D IH S AH P IH R Z
DISAPPEARS(2)	D IH S AH P IY R Z
DISPEL	D IH S P EH L
DISPELLED	D IH S P EH L D
DISPELLING	D IH S P EH L IH NG
DISPELS	D IH S P EH L Z
DISPEND	D IH S P EH N D
DISPENDED	D IH S P EH N D IH D
DISPENDING	D IH S P EH N D IH NG
DISPENDS	D IH S P EH N D Z
DISPENSABILITIES	D IH S P EH N S AH B IH L AH T EH Z
DISPENSABILITY	D IH S P EH N S AH B IH L AH T EH
DISPENSABLE	D IH S P EH N S AH B AH L
DISPENSARIES	D IH S P EH N S EH R IY Z
DISPENSARY	D IH S P EH N S ER IY
DISPENSARY(2)	D IH S P EH N S EH R IY
DISPENSATION	D IH S P AH N S EY SH AH N
DISPENSATIONAL	D IH S P EH N S EY SH AH N AH L
DISPENSATIONS	D IH S P EH N S EY SH AH N Z
DISPENSATORIES	D IH S P EH N S AH T OW R IY Z
DISPENSATORY	D IH S P EH N S AH T OW R IY
DISPENSE	D IH S P EH N S
DISPENSED	D IH S P EH N S T
DISPENSER	D IH S P EH N S ER
DISPENSERS	D IH S P EH N S ER Z
DISPENSES	D IH S P EH N S IH Z
DISPENSING	D IH S P EH N S IH NG
DISPEOPLE	D IH S P IY P AH L
DISPEOPLED	D IH S P IY P AH L D
DISPEOPLES	D IH S P IY P AH L Z
DISPEOPLING	D IH S P IY P AH L IH NG
DISPERSAL	D IH S P ER S AH L
DISPERSALS	D IH S P ER S AH L Z
DISPERSANT	D IH S P ER S AH N T
DISPERSANTS	D IH S P ER S AH N T S
DISPERSE	D IH S P ER S
DISPERSED	D IH S P ER S T
DISPERSEDLY	D IH S P ER S AH D L IY
DISPERSER	D IH S P ER S ER
DISPERSERS	D IH S P ER S ER Z
DISPERSES	D IH S P ER S IH Z
DISPERSIBLE	D IH S P ER S AH B AH L
DISPERSING	D IH S P ER S IH NG
DISPERSION	D IH S P ER ZH AH N
DISPERSIONS	D IH S P ER ZH AH N Z
DISPERSIVE	D IH S P ER S IH V
DISPERSIVELY	D IH S P ER S IH V L IY
DISPERSIVENESS	D IH S P ER S IH V N AH S
DISPERSIVENESSES	D IH S P ER S IH V N AH S IH Z
DISPERSOID	D IH S EH R Z OY D
DISPERSOIDS	D IH S AH R S OY D Z
DISRESPECT	D IH S R IH S P EH K T
DISRESPECTABILITIES	D IH S R IH S P EH K T AH B IH L AH T EH Z
DISRESPECTABILITY	D IH S R IH S P EH K T AH B IH L AH T EH
DISRESPECTABLE	D IH S R IH S P EH K T AH B AH L
DISRESPECTED	D IH S R IH S P EH K T IH D
DISRESPECTFUL	D IH S R IH S P EH K T F AH L
DISRESPECTFULLY	D IH S R IH S P EH K T F AH L IY
DISRESPECTFULNESS	D IH S R IH S P EH K T F AH L N AH S
DISRESPECTFULNESSES	D IH S R IH S P EH K T F AH L N AH S IH Z
DISRESPECTING	D IH S R IH S P EH K T IH NG
DISRESPECTS	D IH S R IH S P EH K T S
DISTEMPER	D IH S T EH M P ER
DISTEMPERATE	D IH S T EH M P ER AH T
DISTEMPERATURE	D IH S T EH M P ER AH CH ER
DISTEMPERATURES	D IH S T EH M P ER AH CH ER Z
DISTEMPERED	D IH S T EH M P ER D
DISTEMPERING	D IH S T EH M P ER IH NG
DISTEMPERS	D IH S T EH M P ER Z
DOGNAPED	D AO G N AE P T
DOGNAPER	D AO G N AE P ER
DOGNAPERS	D AO G N AE P ER Z
DOGNAPPED	D AO G N AE P T
DOGNAPPER	D AO G N AE P ER
DOGNAPPERS	D AO G N AE P ER Z
DOLLOPED	D AA L OW P T
DOORKEEPER	D AO R K IY P ER
DOORKEEPERS	D OW R K IY P ER Z
DOPE	D OW P
DOPED	D OW P T
DOPEHEAD	D OW P HH EH D
DOPEHEADS	D OW P HH EH D Z
DOPER	D OW P ER
DOPERS	D OW P ER Z
DOPES	D OW P S
DOPESTER	D OW P S T ER
DOPESTERS	D OW P S T ER Z
DOPEY	D OW P IY
DOPPELGANGER	D AA P EH L G AH NG AH R
DOPPELGANGERS	D AA P AH L G AE N JH AH R Z
DORPER	D AO R P AH R
DORPERS	D AO R P AH R Z
DOUBLESPEAK	D AH B AH L S P IY K
DOUBLESPEAKER	D AH B AH L S P IY K ER
DOUBLESPEAKERS	D AH B AH L S P IY K ER Z
DOUBLESPEAKS	D AH B AH L S P IY K S
DOUZEPER	D AW Z IY P AH R
DOUZEPERS	D AW Z AH P AH R Z
DOWNPIPE	D AW N P AY P
DOWNPIPES	D AW N P AY P S
DOWNSLOPE	D AW N S L OW P
DRAFTSPERSON	D R AE F T S P ER S AH N
DRAFTSPERSONS	D R AE F T S P ER S AH N Z
DRAGROPE	D R AE G R OW P
DRAGROPES	D R AE G R OW P S
DRAINPIPE	D R EY N P AY P
DRAINPIPES	D R EY N P AY P S
DRAPE	D R EY P
DRAPEABILITIES	D R EY P AH B IH L AH T EH Z
DRAPEABILITY	D R EY P AH B IH L AH T EH
DRAPEABLE	D R EY P AH B AH L
DRAPED	D R EY P T
DRAPER	D R EY P ER
DRAPERIES	D R EY P ER IY Z
DRAPERS	D R EY P ER Z
DRAPERY	D R EY P ER IY
DRAPES	D R EY P S
DRAPEY	D R EY P IY
DRIPPED	D R IH P T
DRIPPER	D R IH P ER
DRIPPERS	D R IH P ER Z
DROOPED	D R UW P T
DROPPED	D R AA P T
DROPPER	D R AA P ER
DROPPERFUL	D R AA P ER F AH L
DROPPERFULS	D R AA P ER F AH L Z
DROPPERS	D R AA P ER Z
DROPPERSFUL	D R AA P ER Z F AH L
DRUPE	D R UW P
DRUPELET	D R UW P L AH T
DRUPELETS	D R UW P AH L AH T S
DRUPES	D R UW P S
DUMPED	D AH M P T
DUMPER	D AH M P ER
DUMPERS	D AH M P ER Z
DUPE	D UW P
DUPED	D UW P T
DUPER	D UW P ER
DUPERIES	D UW P AH R IY Z
DUPERS	D UW P ER Z
DUPERY	D UW P AH R IY
DUPES	D UW P S
DUPPED	D AH P T
DYSPEPSIA	D IH S EH P S IY AH
DYSPEPSIAS	D IH S EH P S IY AH Z
DYSPEPSIES	D IH S EH P S AY Z
DYSPEPSY	D IH S EH P S IY
DYSPEPTIC	D IH S P EH P T IH K
DYSPEPTICALLY	D IH S P EH P T IH K AH L IY
DYSPEPTICS	D IH S P EH P T IH K S
EARTHPEA	ER TH P IY
EARTHPEAS	ER TH P IY Z
EAVESDROPPED	IY V EH Z D R AH P T
EAVESDROPPER	IY V EH Z D R AA P AH R
EAVESDROPPERS	IY V AH Z D R AA P AH R Z
ECOSPECIES	AH K AA S AH S AY Z
ECOTYPE	EH K AH T AY P
ECOTYPES	EH K AH T AY P S
ECTYPE	EH K T AY P
ECTYPES	EH K T AY P S
ELECTROSCOPE	AH L EH K T R AH S OW P
ELECTROSCOPES	AH L EH K T R AH S OW P S
ELECTROTYPE	AH L EH K T R AH T AY P
ELECTROTYPED	IH L EH K T R OW T IY P EH D
ELECTROTYPER	AH L EH K T R AH T AY P AH R
ELECTROTYPERS	EH L AH K T R AA T AH P AH R Z
ELECTROTYPES	AH L EH K T R AH T AY P S
ELOPE	IH L OW P
ELOPED	IH L OW P T
ELOPEMENT	IH L OW P M AH N T
ELOPEMENTS	IH L OW P M AH N T S
ELOPER	IH L OW P ER
ELOPERS	IH L OW P ER Z
ELOPES	IH L OW P S
EMPENNAGE	IH M P EH N IH JH
EMPENNAGES	IH M P EH N IH JH IH Z
EMPERIES	IH M P AH R Y S
EMPEROR	EH M P ER ER
EMPERORS	EH M P ER ER Z
EMPERORSHIP	EH M P ER ER SH IH P
EMPERORSHIPS	EH M P ER ER SH IH P S
EMPERY	EH M P AH R IY
ENCAMPED	IH N K AE M P T
ENCLASPED	EH N K L AE S P T
ENCYCLOPEDIA	IH N S AY K L AH P IY D IY AH
ENCYCLOPEDIA(2)	IH N S AY K L OW P IY D IY AH
ENCYCLOPEDIAS	IH N S AY K L AH P IY D IY AH Z
ENCYCLOPEDIAS(2)	IH N S AY K L OW P IY D IY AH Z
ENCYCLOPEDIC	IH N S AY K L AH P IY D IH K
ENCYCLOPEDIC(2)	IH N S AY K L OW P IY D IH K
ENCYCLOPEDICALLY	IH N S AY K L AH P IY D IH K AH L IY
ENCYCLOPEDISM	IH N S IH K L AH P AH D IH Z AH M
ENCYCLOPEDISMS	IH N S IH K L AA P AH D AH Z AH M Z
ENCYCLOPEDIST	IH N S AY K L AH P IY D AH S T
ENCYCLOPEDIST(2)	IH N S AY K L OW P IY D AH S T
ENCYCLOPEDISTS	IH N S IH K L AA P AH D AH S T S
ENDOPEPTIDASE	EH N D UW P EH P T AH D EY Z
ENDOPEPTIDASES	EH N D UW P EH P T AH D EY Z IH Z
ENDOPEROXIDE	EH N D OW P ER AA K S AY D
ENDOPEROXIDES	EH N D OW P ER AA K S AY D Z
ENDOSCOPE	EH N D OW S K OW P
ENDOSCOPES	EH N D UW S K OW P S
ENDOSPERM	EH N D AH S P ER M
ENDOSPERMS	EH N D AH S P ER M Z
ENDPAPER	EH N D P EY P ER
ENDPAPERS	EH N D P EY P ER Z
ENTRAPPED	IH N T R AE P T
ENVELOPE	EH N V AH L OW P
ENVELOPED	EH N V EH L AH P T
ENVELOPES	EH N V AH L OW P S
ENWRAPPED	EH N R AE P T
EPEE	IY P IY IY
EPEEIST	IY P IY AH S T
EPEEISTS	IY P IY AH S T S
EPEES	IY P IY Z
EPEIRIC	IY P IY R AH K
EPEIROGENIC	IY P IY R AH JH AH N AH K
EPEIROGENICALLY	IY P AH R AH JH EH N AH K AE L IY
EPEIROGENIES	IY P AH R AA JH AH N AY Z
EPEIROGENY	IY P AH R AA JH AH N IY
EPENDYMA	AH P EH N D AH M AH
EPENDYMAS	AH P EH N D AH M AH Z
EPENTHESES	EH P AH N TH IY Z AH Z
EPENTHESIS	AH P EH N DH AH S AH S
EPENTHETIC	AH P EH N TH AH T AH K
EPERGNE	EH P AH R N
EPERGNES	EH P AH R N Z
EPEXEGESES	AH P EH K S AH JH IY Z AH Z
EPEXEGESIS	EH P AH K S IY JH AH S AH S
EPEXEGETIC	AH P EH K S AH JH AH T AH K
EPEXEGETICAL	AH P EH K S EH JH AH T IH S AH L
EPEXEGETICALLY	AH P EH K S AH JH EH T AH K AE L IY
EPIDIASCOPE	AH P IH D IY AH S OW P
EPIDIASCOPES	AH P IH D IY AH S OW P S
EPIPELAGIC	AH P IH P AH L AH JH AH K
EPISCOPE	EH P AH S OW P
EPISCOPES	EH P AH S OW P S
EPITOPE	EH P IH T OW P
EPITOPES	EH P AH T OW P S
EPOPEE	EH P AH P IY IY
EPOPEES	EH P AH P IY Z
EQUIPPED	IH K W IH P T
EQUIPPER	IH K W IH P ER
EQUIPPERS	IH K W IH P ER Z
ERUMPENT	AH R AH M P AH N T
ERYSIPELAS	EH R AH S IH P AH L AH S
ERYSIPELASES	EH R AH S IH P AH L AH S IH Z
ESCALLOPED	EH S AH L OW P T
ESCALOPED	EH S AH L OW P T
ESCAPE	IH S K EY P
ESCAPED	IH S K EY P T
ESCAPEE	IH S K EY P IY
ESCAPEES	IH S K EY P IY Z
ESCAPEMENT	IH S K EY P M AH N T
ESCAPEMENTS	IH S K EY P M AH N T S
ESCAPER	IH S K EY P ER
ESCAPERS	IH S K EY P ER Z
ESCAPES	IH S K EY P S
ESCARPED	EH S AH R P T
ESPECIAL	AH S P EH SH AH L
ESPECIALLY	AH S P EH SH L IY
ESPECIALLY(2)	AH S P EH SH AH L IY
ESPERANCE	EH S AH R AH N S
ESPERANCES	EH S AH R AE N S AH Z
ESTOPPED	EH S T AH P T
ESTOPPEL	EH S T AA P AH L
ESTOPPELS	EH S T AA P AH L Z
ETAPE	AH T EY P
ETAPES	AH T EY P S
EUPEPSIA	Y UW P EH P S IY AH
EUPEPSIAS	Y UW P EH P S IY AH Z
EUPEPSIES	Y UW P EH P S AY Z
EUPEPSY	Y UW P EH P S IY
EUPEPTIC	Y UW P AH P T AH K
EXASPERATE	IH G Z AE S P ER EY T
EXASPERATED	IH G Z AE S P ER EY T IH D
EXASPERATEDLY	IH G Z AE S P AH R EY T AH D L IY
EXASPERATES	IH G Z AE S P AH R EY T S
EXASPERATING	IH G Z AE S P ER EY T IH NG
EXASPERATINGLY	IH G Z AE S P AH R EY T IH NG L IY
EXASPERATION	EH K S AE S P ER EY SH AH N
EXASPERATIONS	IH G Z AE S P AH R EY SH AH N Z
EXOPEPTIDASE	IH G Z AH P EH P T AH D EY Z
EXOPEPTIDASES	IH G Z AH P EH P T AH D EY Z AH Z
EXPECT	IH K S P EH K T
EXPECTABLE	IH K S P EH K T AH B AH L
EXPECTABLY	IH K S P EH K T AH B L IY
EXPECTANCE	IH K S P EH K T AH N S
EXPECTANCES	IH K S P EH K T AH N S IH Z
EXPECTANCIES	IH K S P EH K T AH N S IY Z
EXPECTANCY	IH K S P EH K T AH N S IY
EXPECTANT	IH K S P EH K T AH N T
EXPECTANTLY	IH K S P EH K T AH N T L IY
EXPECTANTS	IH K S P EH K T AH N T S
EXPECTATION	EH K S P EH K T EY SH AH N
EXPECTATIONAL	IH K S P EH K T EY SH AH N AH L
EXPECTATIONS	EH K S P EH K T EY SH AH N Z
EXPECTATIVE	IH K S P EH K T AH T IH V
EXPECTED	IH K S P EH K T AH D
EXPECTED(2)	IH K S P EH K T IH D
EXPECTEDLY	IH K S P EH K T AH D L IY
EXPECTEDNESS	IH K S P EH K T AH D N AH S
EXPECTEDNESSES	IH K S P EH K T AH D N AH S IH Z
EXPECTING	IH K S P EH K T IH NG
EXPECTORANT	IH K S P EH K T ER AH N T
EXPECTORANTS	IH K S P EH K T ER AH N T S
EXPECTORATE	IH K S P EH K T ER AH T
EXPECTORATED	IH K S P EH K T ER EY T IH D
EXPECTORATES	IH K S P EH K T ER AH T S
EXPECTORATING	IH K S P EH K T ER EY T IH NG
EXPECTORATION	IH K S P EH K T ER EY SH AH N
EXPECTORATIONS	IH K S P EH K T ER EY SH AH N Z
EXPECTS	IH K S P EH K T S
EXPECTS(2)	IH K S P EH K S
EXPEDIENCE	IH K S P IY D IY AH N S
EXPEDIENCES	IH K S P IY D IY AH N S IH Z
EXPEDIENCIES	IH K S P IY D IY AH N S IY Z
EXPEDIENCY	IH K S P IY D IY AH N S IY
EXPEDIENT	IH K S P IY D IY AH N T
EXPEDIENTIAL	IH K S P IY D IY AH N T IY AH L
EXPEDIENTLY	IH K S P IY D IY AH N T L IY
EXPEDIENTS	IH K S P IY D IY AH N T S
EXPEDITE	EH K S P IH D AY T
EXPEDITED	EH K S P IH D AY T IH D
EXPEDITER	EH K S P AH D AY T ER
EXPEDITERS	EH K S P AH D AY T ER Z
EXPEDITES	EH K S P AH D AY T S
EXPEDITING	EH K S P AH D AY T IH NG
EXPEDITION	EH K S P AH D IH SH AH N
EXPEDITIONARY	EH K S P AH D IH SH AH N EH R IY
EXPEDITIONS	EH K S P AH D IH SH AH N Z
EXPEDITIOUS	EH K S P AH D IH SH AH S
EXPEDITIOUSLY	EH K S P AH D IH SH AH S L IY
EXPEDITIOUSNESS	EH K S P AH D IH SH AH S N AH S
EXPEDITIOUSNESSES	EH K S P AH D IH SH AH S N AH S IH Z
EXPEDITOR	EH K S P AH D AY T ER
EXPEDITORS	EH K S P AH D AY T ER Z
EXPEL	IH K S P EH L
EXPELLABLE	IH K S P EH L AH B AH L
EXPELLED	IH K S P EH L D
EXPELLEE	IH K S P EH L IY
EXPELLEES	IH K S P EH L IY Z
EXPELLER	IH K S P EH L ER
EXPELLERS	IH K S P EH L ER Z
EXPELLING	IH K S P EH L IH NG
EXPELS	IH K S P EH L Z
EXPEND	IH K S P EH N D
EXPENDABILITIES	IH K S P EH N D AH B IH L AH T EH Z
EXPENDABILITY	IH K S P EH N D AH B IH L AH T EH
EXPENDABLE	IH K S P EH N D AH B AH L
EXPENDABLES	IH K S P EH N D AH B AH L Z
EXPENDED	IH K S P EH N D IH D
EXPENDER	IH K S P EH N D ER
EXPENDERS	IH K S P EH N D ER Z
EXPENDING	EH K S P EH N D IH NG
EXPENDITURE	IH K S P EH N D AH CH ER
EXPENDITURE(2)	IH K S P EH N D IH CH ER
EXPENDITURES	IH K S P EH N D AH CH ER Z
EXPENDITURES(2)	IH K S P EH N D IH CH ER Z
EXPENDS	IH K S P EH N D Z
EXPENSE	IH K S P EH N S
EXPENSED	IH K S P EH N S T
EXPENSES	IH K S P EH N S IH Z
EXPENSING	IH K S P EH N S IH NG
EXPENSIVE	IH K S P EH N S IH V
EXPENSIVELY	EH K S P EH N S IH V L IY
EXPENSIVENESS	EH K S P EH N S IH V N AH S
EXPENSIVENESSES	EH K S P EH N S IH V N AH S IH Z
EXPERIENCE	IH K S P IH R IY AH N S
EXPERIENCED	IH K S P IH R IY AH N S T
EXPERIENCES	IH K S P IH R IY AH N S IH Z
EXPERIENCING	IH K S P IH R IY AH N S IH NG
EXPERIENTIAL	EH K S P EH R IY EH N SH AH L
EXPERIENTIALLY	IH K S P IH R IY EH N CH AH L IY
EXPERIMENT	IH K S P EH R AH M AH N T
EXPERIMENTAL	IH K S P EH R IH M EH N T AH L
EXPERIMENTALISM	IH K S P EH R AH M EH N T AH L IH Z AH M
EXPERIMENTALISMS	IH K S P EH R AH M EH N T AH L IH Z AH M Z
EXPERIMENTALIST	IH K S P EH R AH M EH N T AH L IH S T
EXPERIMENTALISTS	IH K S P EH R AH M EH N T AH L IH S T S
EXPERIMENTALLY	IH K S P EH R AH M EH N T AH L IY
EXPERIMENTATION	IH K S P EH R AH M AH N T EY SH AH N
EXPERIMENTATIONS	IH K S P EH R AH M AH N T EY SH AH N Z
EXPERIMENTED	IH K S P EH R AH M AH N T AH D
EXPERIMENTER	IH K S P EH R AH M EH N T ER
EXPERIMENTERS	IH K S P EH R AH M EH N T ER Z
EXPERIMENTING	EH K S P EH R AH M EH N T IH NG
EXPERIMENTS	IH K S P EH R AH M AH N T S
EXPERT	EH K S P ER T
EXPERTED	EH K S P ER T IH D
EXPERTING	EH K S P ER T IH NG
EXPERTISE	EH K S P ER T IY Z
EXPERTISES	EH K S P ER T IY Z IH Z
EXPERTISM	EH K S P ER T IH Z AH M
EXPERTISMS	EH K S P ER T IH Z AH M Z
EXPERTIZE	EH K S P ER T AY Z
EXPERTIZED	EH K S P ER T AY Z D
EXPERTIZES	EH K S P ER T AY Z IH Z
EXPERTIZING	EH K S P ER T AY Z IH NG
EXPERTLY	EH K S P ER T L IY
EXPERTNESS	EH K S P ER T N AH S
EXPERTNESSES	EH K S P ER T N AH S IH Z
EXPERTS	EH K S P ER T S
EYEDROPPER	AY D R AA P ER
EYEDROPPERS	AY D R AA P ER Z
EYEOPENER	AY OW P AH N ER
EYEOPENERS	AY OW P AH N ER Z
EYEPOPPER	AY P AA P ER
EYEPOPPERS	AY P AA P ER Z
FELLOWSHIPED	F EH L OW SH IH P T
FELLOWSHIPPED	F EH L OW SH IH P T
FERROTYPE	F EH R AH T AY P
FERROTYPES	F EH R OW T AY P S
FETOSCOPE	F EH T AH S OW P
FETOSCOPES	F EH T AH S OW P S
FIBERSCOPE	F AY B ER S K OW P
FIBERSCOPES	F AY B ER S K OW P S
FIBRINOPEPTIDE	F IH B R AH N AA P AH P T AY D
FIBRINOPEPTIDES	F IH B R AH N AA P AH P T AY D Z
FIELDSTRIPPED	F IY L D S T R IH P T
FILLIPED	F IH L AH P T
FISSIPED	F IH S AY P T
FISSIPEDS	F IH S AH P AH D Z
FLAPPED	F L AE P T
FLAPPER	F L AE P ER
FLAPPERS	F L AE P ER Z
FLEAHOPPER	F L IY HH AA P ER
FLEAHOPPERS	F L IY HH AA P ER Z
FLIPPED	F L IH P T
FLIPPER	F L IH P ER
FLIPPERS	F L IH P ER Z
FLIPPEST	F L IH P AH S T
FLOPPED	F L AA P T
FLOPPER	F L AA P ER
FLOPPERS	F L AA P ER Z
FLUMPED	F L AH M P T
FLUOROSCOPE	F L UW ER AA S K OW P
FLUOROSCOPED	F L UW ER AA S K OW P T
FLUOROSCOPES	F L UW ER AA S K OW P S
FLYPAPER	F L AY P EY P ER
FLYPAPERS	F L AY P EY P ER Z
FLYSPECK	F L AY S P EH K
FLYSPECKED	F L AY S P EH K T
FLYSPECKING	F L AY S P EH K IH NG
FLYSPECKS	F L AY S P EH K S
FOOTROPE	F UH T R OW P
FOOTROPES	F UH T R OW P S
FOPPED	F AA P T
FOPPERIES	F AA P AH R IY Z
FOPPERY	F AA P AH R IY
FORCIPES	F AO R S AY P S
FOREPEAK	F OW R P IY K
FOREPEAKS	F OW R P IY K S
FORESPEAK	F OW R S P IY K
FORESPEAKING	F OW R S P IY K IH NG
FORESPEAKS	F OW R S P IY K S
FORSPENT	F AO R S P EH N T
FRAPPE	F R AE P
FRAPPED	F R AE P T
FRAPPES	F R AE P S
FRIPPERIES	F R IH P AH R AY Z
FRIPPERY	F R IH P AH R IY
FROGHOPPER	F R AA G HH AA P ER
FROGHOPPERS	F R AA G HH AA P ER Z
GALLINIPPER	G AE L AH N IH P AH R
GALLINIPPERS	G AE L AH N IH P AH R Z
GALLOPED	G AE L AH P T
GALLOPER	G AE L AH P ER
GALLOPERS	G AE L AH P ER Z
GALOPED	G AH L OW P T
GALVANOSCOPE	G AE L V AE N AA S K OW P
GALVANOSCOPES	G AE L V AE N AA S K OW P S
GAMEKEEPER	G EY M K IY P ER
GAMEKEEPERS	G EY M K IY P ER S
GAMOPETALOUS	G AE M AH P EH T AH L AH S
GANTELOPE	G AE N T AH L OW P
GANTELOPES	G AE N T AH L OW P S
GANTLOPE	G AE N T L OW P
GANTLOPES	G AE N T L OW P S
GAPE	G EY P
GAPED	G EY P T
GAPER	G EY P ER
GAPERS	G EY P ER Z
GAPES	G EY P S
GAPESEED	G EY P S IY D
GAPESEEDS	G EY P S IY D Z
GAPEWORM	G EY P W ER M
GAPEWORMS	G EY P W ER M Z
GAPPED	G AE P T
GASPED	G AE S P T
GASPER	G AE S P ER
GASPERS	G AE S P ER Z
GASTROSCOPE	G AE S T R AH S K OW P
GASTROSCOPES	G AE S T R AH S OW P S
GATEKEEPER	G EY T K IY P ER
GATEKEEPERS	G EY T K IY P ER Z
GAWPED	G AO P T
GAWPER	G AO P AH R
GAWPERS	G AO P AH R Z
GAZUMPED	G AE Z AH M P T
GAZUMPER	G AH Z AH M P AH R
GAZUMPERS	G AH Z AH M P AH R Z
GEDANKENEXPERIMENT	JH AH D AE NG K AH N EH K S EH R AH M AH N T
GEDANKENEXPERIMENTS	JH AH D AE NG K AH N AH K S EH R AH M AH N T S
GENOTYPE	JH EH N AH T AY P
GENOTYPES	JH EH N AH T AY P S
GENTLEPERSON	JH EH N T AH L P ER S AH N
GENTLEPERSONS	JH EH N T AH L P ER S AH N Z
GIFTWRAPPED	G IH F T R AE P T
GIMPED	G IH M P T
GIPPED	JH IH P T
GIPPER	G IH P ER
GIPPERS	JH IH P AH R Z
GLASSPAPER	G L AE S P EY P ER
GLASSPAPERED	G L AE S P EY P ER D
GLASSPAPERING	G L AE S P EY P ER IH NG
GLASSPAPERS	G L AE S P EY P ER Z
GLOPPED	G L AA P T
GLYCOPEPTIDE	G L AH K AA P AH P T AY D
GLYCOPEPTIDES	G L AH K AA P AH P T AY D Z
GOALKEEPER	G OW L K IY P ER
GOALKEEPERS	G OW L K IY P ER Z
GOSPEL	G AA S P AH L
GOSPEL(2)	G AO S P AH L
GOSPELER	G AA S P AH L ER
GOSPELERS	G AA S P AH L ER Z
GOSPELLER	G AA S P AH L ER
GOSPELLERS	G AA S P AH L ER Z
GOSPELS	G AA S P AH L Z
GOSSIPED	G AA S AH P T
GOSSIPER	G AA S AH P ER
GOSSIPERS	G AA S AH P ER Z
GOSSIPPED	G AA S AH P T
GRAPE	G R EY P
GRAPEFRUIT	G R EY P F R UW T
GRAPEFRUITS	G R EY P F R UW T S
GRAPELIKE	G R EY P L AY K
GRAPERIES	G R EY P AH R IY Z
GRAPERY	G R EY P AH R IY
GRAPES	G R EY P S
GRAPESHOT	G R EY P SH AA T
GRAPEVINE	G R EY P V AY N
GRAPEVINES	G R EY P V AY N Z
GRAPEY	G R EY P IY
GRASPED	G R AE S P T
GRASPER	G R AE S P ER
GRASPERS	G R AE S P ER Z
GRASSHOPPER	G R AE S HH AA P ER
GRASSHOPPERS	G R AE S HH AA P ER Z
GRAUPEL	G R AO P AH L
GRAUPELS	G R AO P AH L Z
GREENKEEPER	G R IY N K IY P ER
GREENKEEPERS	G R IY N K IY P ER Z
GREENSKEEPER	G R IY N Z K IY P ER
GREENSKEEPERS	G R IY N Z K IY P ER Z
GRIPE	G R AY P
GRIPED	G R AY P T
GRIPER	G R AY P ER
GRIPERS	G R AY P ER Z
GRIPES	G R AY P S
GRIPEY	G R AY P IY
GRIPPE	G R IH P
GRIPPED	G R IH P T
GRIPPER	G R IH P ER
GRIPPERS	G R IH P ER Z
GRIPPES	G R IH P S
GROPE	G R OW P
GROPED	G R OW P T
GROPER	G R OW P ER
GROPERS	G R OW P ER Z
GROPES	G R OW P S
GROUNDSKEEPER	G R AW N D S K IY P ER
GROUNDSKEEPERS	G R AW N D S K IY P ER Z
GROUPED	G R UW P T
GROUPER	G R UW P ER
GROUPERS	G R UW P ER Z
GRUMPED	G R AH M P T
GUIMPE	G UW M P
GUIMPES	G UW M P S
GULPED	G AH L P T
GULPER	G AH L P ER
GULPERS	G AH L P ER Z
GUNPAPER	G AH N P EY P ER
GUNPAPERS	G AH N P EY P ER Z
GUTTERSNIPE	G AH T ER S N AY P
GUTTERSNIPES	G AH T ER S N AY P S
GYMNOSPERM	JH IH M N AA S AH R M
GYMNOSPERMIES	JH IH M N AA S AH R M AY Z
GYMNOSPERMOUS	JH IH M N AA S AH R M AH S
GYMNOSPERMS	JH IH M N AA S AH R M Z
GYMNOSPERMY	JH IH M N AA S AH R M IY
GYPPED	JH IH P T
GYPPER	JH IH P ER
GYPPERS	JH IH P ER Z
GYROSCOPE	JH AY R AH S K OW P
GYROSCOPES	JH AY R AH S K OW P S
HAGIOSCOPE	HH EY JH IY AH S OW P
HAGIOSCOPES	HH EY JH IY AH S OW P S
HALFPENCE	HH AE L F AH N S
HALFPENNIES	HH AE F P EH N IY Z
HALFPENNY	HH AE F P EH N IY
HALOPERIDOL	HH EY L OW P ER AY D AH L
HALOPERIDOLS	HH EY L OW P ER AY D AH L Z
HAMPER	HH AE M P ER
HAMPERED	HH AE M P ER D
HAMPERER	HH AE M P ER ER
HAMPERERS	HH AE M P ER ER Z
HAMPERING	HH AE M P ER IH NG
HAMPERS	HH AE M P ER Z
HANAPER	HH AH N EY P AH R
HANAPERS	HH AE N AH P AH R Z
HANDICAPPED	HH AE N D IY K AE P T
HANDICAPPER	HH AE N D IY K AE P ER
HANDICAPPERS	HH AE N D IY K AE P ER Z
HANDYPERSON	HH AE N D IY P ER S AH N
HANDYPERSONS	HH AE N D IY P ER S AH N Z
HAPLOTYPE	HH AE P L AH T AY P
HAPLOTYPES	HH AE P L AH T AY P S
HAPPED	HH AE P T
HAPPEN	HH AE P AH N
HAPPENCHANCE	HH AE P AH N CH AE N S
HAPPENCHANCES	HH AE P AH N CH AE N S IH Z
HAPPENED	HH AE P AH N D
HAPPENING	HH AE P AH N IH NG
HAPPENING(2)	HH AE P N IH NG
HAPPENINGS	HH AE P AH N IH NG Z
HAPPENINGS(2)	HH AE P N IH NG Z
HAPPENS	HH AE P AH N Z
HAPPENSTANCE	HH AE P AH N S T AE N S
HAPPENSTANCES	HH AE P AH N S T AE N S IH Z
HARPED	HH AA R P T
HARPER	HH AA R P ER
HARPERS	HH AA R P ER Z
HARUSPEX	HH AH R AH S AH K S
HASPED	HH AE S P T
HEAPED	HH IY P T
HEDGEHOPPED	HH EH JH HH AA P T
HEDGEHOPPER	HH EH JH HH AA P ER
HEDGEHOPPERS	HH EH JH HH AA P ER Z
HELIOTROPE	HH IY L IY AH T R OW P
HELIOTROPES	HH IY L Y AH T R OW P S
HELPED	HH EH L P T
HELPER	HH EH L P ER
HELPERS	HH EH L P ER Z
HEMPEN	HH EH M P AH N
HENPECK	HH EH N P EH K
HENPECKED	HH EH N P EH K T
HENPECKING	HH EH N P EH K IH NG
HENPECKS	HH EH N P EH K S
HERPES	HH ER P IY Z
HERPESVIRUS	HH AH R P EH Z AH R AH S
HERPESVIRUSES	HH AH R P EH Z AH R UW Z AH Z
HERPETIC	HH AH R P AH T AH K
HERPETOLOGICAL	HH AH R P AH T AA L AH JH IH S AH L
HERPETOLOGIES	HH ER P AH T AA L AH JH IY Z
HERPETOLOGIST	HH AH R P AH T AA L AH JH AH S T
HERPETOLOGISTS	HH AH R P AH T AA L AH JH AH S T S
HERPETOLOGY	HH ER P AH T AA L AH JH IY
HESPERIDIA	HH EH S AH R IH D IY AH
HESPERIDIN	HH EH S EH R AH D AH N
HESPERIDINS	HH EH S EH R AH D AH N Z
HESPERIDIUM	HH EH S AH R IH D IY AH M
HICCUPED	HH IH K AH P T
HICCUPPED	HH IH K AH P T
HIPPED	HH IH P T
HIPPER	HH IH P ER
HIPPEST	HH IH P AH S T
HODOSCOPE	HH AA D AH S OW P
HODOSCOPES	HH AA D AH S OW P S
HOLOTYPE	HH AA L AH T AY P
HOLOTYPES	HH AA L AH T AY P S
HOLPEN	HH OW L P AH N
HONEYCREEPER	HH AH N IY K R IY P ER
HONEYCREEPERS	HH AH N IY K R IY P ER Z
HOOPED	HH UW P T
HOOPER	HH UW P ER
HOOPERS	HH UW P ER Z
HOPE	HH OW P
HOPED	HH OW P T
HOPEFUL	HH OW P F AH L
HOPEFULLY	HH OW P F AH L IY
HOPEFULNESS	HH OW P F AH L N IH S
HOPEFULNESSES	HH OW P F AH L N AH S IH Z
HOPEFULS	HH OW P F AH L Z
HOPELESS	HH OW P L AH S
HOPELESSLY	HH OW P L AH S L IY
HOPELESSNESS	HH OW P L AH S N AH S
HOPELESSNESSES	HH OW P L AH S N AH S IH Z
HOPER	HH OW P ER
HOPERS	HH OW P ER Z
HOPES	HH OW P S
HOPPED	HH AA P T
HOPPER	HH AA P ER
HOPPERS	HH AA P ER Z
HORNPIPE	HH AO R N P AY P
HORNPIPES	HH AO R N P AY P S
HOROSCOPE	HH AO R AH S K OW P
HOROSCOPES	HH AO R AH S K OW P S
HORSEWHIPPED	HH AO R S W IH P T
HORSEWHIPPER	HH AO R S W IH P ER
HORSEWHIPPERS	HH AO R S W IH P ER Z
HOSEPIPE	HH OW Z P AY P
HOSEPIPES	HH OW Z P AY P S
HOUSEKEEPER	HH AW S K IY P ER
HOUSEKEEPERS	HH AW S K IY P ER Z
HOUSEPERSON	HH AW S P ER S AH N
HOUSEPERSONS	HH AW S P ER S AH N Z
HUMPED	HH AH M P T
HYDROPEROXIDE	HH IH D R AH P EH R AH K S AY D
HYDROPEROXIDES	HH IH D R AH P EH R AH K S AY D Z
HYPE	HH AY P
HYPED	HH AY P T
HYPER	HH AY P ER
HYPERACID	HH AY P ER AE S AH D
HYPERACIDITIES	HH AY P ER AH S IH D AH T IY Z
HYPERACIDITY	HH AY P ER AH S IH D AH T IY
HYPERACTIVE	HH AY P ER AE K T IH V
HYPERACTIVES	HH AY P ER AE K T IH V Z
HYPERACTIVITIES	HH AY P ER AE K T IH V AH T IY Z
HYPERACTIVITY	HH AY P ER AE K T IH V IH T IY
HYPERACUITIES	HH AY P ER AH K Y UW AH T IY Z
HYPERACUITY	HH AY P ER AH K Y UW AH T IY
HYPERACUTE	HH AY P ER AH K Y UW T
HYPERAESTHESIA	HH AY P AH R EH S TH IY ZH IY AH
HYPERAESTHESIAS	HH AY P AH R EH S TH IY S IY AH Z
HYPERAESTHETIC	HH AY P ER EH S TH EH T IH K
HYPERAGGRESSIVE	HH AY P ER AH G R EH S IH V
HYPERALERT	HH AY P ER AH L ER T
HYPERALIMENTATION	HH AY P ER AH L AY M AH N T EY SH AH N
HYPERALIMENTATIONS	HH AY P ER AH L AY M AH N T EY SH AH N Z
HYPERARID	HH AY P ER AE R AH D
HYPERAROUSAL	HH AY P ER AH R AW Z AH L
HYPERAROUSALS	HH AY P ER AH R AW Z AH L Z
HYPERAWARE	HH AY P ER AH W EH R
HYPERAWARENESS	HH AY P ER AH W EH R N AH S
HYPERAWARENESSES	HH AY P ER AH W EH R N AH S IH Z
HYPERBARIC	HH AY P ER B AA R IH K
HYPERBARIC(2)	HH AY P ER B AE R IH K
HYPERBARICALLY	HH AY P ER B EH R IH K AH L IY
HYPERBOLA	HH AY P ER B AH L AH
HYPERBOLAE	HH AY P AH R B AA L IY
HYPERBOLAS	HH AY P AH R B AA L AH Z
HYPERBOLE	HH AY P ER B AH L IY
HYPERBOLES	HH AY P ER B AH L IY Z
HYPERBOLIC	HH AY P ER B AA L IH K
HYPERBOLICAL	HH AY P ER B AA L IH K AH L
HYPERBOLICALLY	HH AY P ER B AA L IH K AH L IY
HYPERBOLIST	HH AY P ER B AH L IY IH S T
HYPERBOLISTS	HH AY P ER B AH L IY IH S T S
HYPERBOLIZE	HH AY P ER B AH L IY AY Z
HYPERBOLIZED	HH AY P ER B AH L IY AY Z D
HYPERBOLIZES	HH AY P ER B AH L IY AY Z IH Z
HYPERBOLIZING	HH AY P ER B AH L IY AY Z IH NG
HYPERBOLOID	HH AY P ER B OW L OW AH D
HYPERBOLOIDAL	HH AY P ER B OW L OW AH D AH L
HYPERBOLOIDS	HH AY P ER B OW L OW AH D Z
HYPERBOREAN	HH AY P ER B AO R IY AH N
HYPERBOREANS	HH AY P AH R B AH R IY N Z
HYPERCALCEMIA	HH AY P AH R K AE L S IY M IY AH
HYPERCALCEMIAS	HH AY P AH R K AE L S IY M IY AH Z
HYPERCALCEMIC	HH AY P AH R K AE L S AH M AH K
HYPERCAPNIA	HH AY P AH R K AE P N IY AH
HYPERCAPNIAS	HH AY P AH R K AE P N IY AH Z
HYPERCAPNIC	HH AY P AH R K AE P N AH K
HYPERCATABOLISM	HH AY P AH R K AE T AH B AH L IH Z AH M
HYPERCATABOLISMS	HH AY P AH R K AH T AE B AH L AH Z AH M Z
HYPERCATALECTIC	HH AY P AH R K AE T AH L AH K T AH K
HYPERCATALEXES	HH AY P AH R K AE T AH L AH K S
HYPERCATALEXIS	HH AY P AH R K AE T AH L EH K S AH S
HYPERCAUTIOUS	HH AY P ER K AO SH AH S
HYPERCHARGE	HH AY P ER CH AA R JH
HYPERCHARGED	HH AY P ER CH AA R JH D
HYPERCHARGES	HH AY P ER CH AA R JH IH Z
HYPERCHOLESTEROLEMIA	HH AY P AH R CH AH L EH S T AH R AH L IY M IY AH
HYPERCHOLESTEROLEMIAS	HH AY P AH R CH AH L EH S T AH R AH L IY M IY AH Z
HYPERCHOLESTEROLEMIC	HH AY P AH R CH AA L AH S T EH R AH L AH M AH K
HYPERCIVILIZED	HH AY P ER S IH V AH L AY Z D
HYPERCOAGULABILITIES	HH AY P ER K OW AE G Y AH L AH B IH L AH T EH Z
HYPERCOAGULABILITY	HH AY P ER K OW AE G Y AH L AH B IH L AH T EH
HYPERCOAGULABLE	HH AY P ER K OW AE G Y AH L AH B AH L
HYPERCOMPETITIVE	HH AY P ER K AH M P EH T AH T IH V
HYPERCOMPLEX	HH AY P ER K AH M P L EH K S
HYPERCONCENTRATION	HH AY P ER K AA N S AH N T R EY SH AH N
HYPERCONCENTRATIONS	HH AY P ER K AA N S AH N T R EY SH AH N Z
HYPERCONSCIOUS	HH AY P ER K AA N SH AH S
HYPERCONSCIOUSNESS	HH AY P ER K AA N SH AH S N AH S
HYPERCONSCIOUSNESSES	HH AY P ER K AA N SH AH S N AH S IH Z
HYPERCORRECT	HH AY P ER K AH R EH K T
HYPERCORRECTION	HH AY P ER K AH R EH K SH AH N
HYPERCORRECTIONS	HH AY P ER K AH R EH K SH AH N Z
HYPERCORRECTLY	HH AY P ER K AH R EH K T L IY
HYPERCORRECTNESS	HH AY P ER K AH R EH K T N AH S
HYPERCORRECTNESSES	HH AY P ER K AH R EH K T N AH S IH Z
HYPERCRITIC	HH AY P ER K R IH T IH K
HYPERCRITICAL	HH AY P ER K R IH T IH K AH L
HYPERCRITICALLY	HH AY P ER K R IH T IH K AH L IY
HYPERCRITICISM	HH AY P ER K R IH T AH S IH Z AH M
HYPERCRITICISMS	HH AY P ER K R IH T AH S IH Z AH M Z
HYPERCRITICS	HH AY P ER K R IH T IH K S
HYPERCUBE	HH AY P ER K Y UW B
HYPERCUBES	HH AY P ER K Y UW B Z
HYPERDEVELOPMENT	HH AY P ER D IH V EH L AH P M AH N T
HYPERDEVELOPMENTS	HH AY P ER D IH V EH L AH P M AH N T S
HYPEREFFICIENT	HH AY P ER IH F IH SH AH N T
HYPEREMIA	HH AY P AH R IY M IY AH
HYPEREMIAS	HH AY P AH R IY M IY AH Z
HYPEREMIC	HH AY P AH R IY M IH K
HYPEREMOTIONAL	HH AY P ER IH M OW SH AH N AH L
HYPEREMOTIONALITIES	HH AY P ER IH M OW SH AH N AE L AH T IY Z
HYPEREMOTIONALITY	HH AY P ER IH M OW SH AH N AE L AH T IY
HYPERENDEMIC	HH AY P AH R AH N D IY M AH K
HYPERENERGETIC	HH AY P ER EH N ER JH EH T IH K
HYPERESTHESIA	HH AY P AH R EH S TH IY ZH IY AH
HYPERESTHESIAS	HH AY P AH R EH S TH IY S IY AH Z
HYPERESTHETIC	HH AY P ER EH S TH EH T IH K
HYPEREUTECTIC	HH AY P ER Y UH T EH K T IH K
HYPEREUTECTOID	HH AY P AH R Y UW T AH K T OY D
HYPEREXCITABILITIES	HH AY P ER IH K S AY T AH B IH L AH T EH Z
HYPEREXCITABILITY	HH AY P ER IH K S AY T AH B IH L AH T EH
HYPEREXCITABLE	HH AY P ER IH K S AY T AH B AH L
HYPEREXCITED	HH AY P ER IH K S AY T IH D
HYPEREXCITEMENT	HH AY P ER IH K S AY T M AH N T
HYPEREXCITEMENTS	HH AY P ER IH K S AY T M AH N T S
HYPEREXCRETION	HH AY P ER EH K S K R IY SH AH N
HYPEREXCRETIONS	HH AY P ER EH K S K R IY SH AH N Z
HYPEREXTEND	HH AY P ER IH K S T EH N D
HYPEREXTENDED	HH AY P ER IH K S T EH N D IH D
HYPEREXTENDING	HH AY P ER IH K S T EH N D IH NG
HYPEREXTENDS	HH AY P ER IH K S T EH N D Z
HYPEREXTENSION	HH AY P ER IH K S T EH N CH AH N
HYPEREXTENSIONS	HH AY P ER IH K S T EH N CH AH N Z
HYPERFASTIDIOUS	HH AY P ER F AE S T IH D IY AH S
HYPERFINE	HH AY P ER F AY N
HYPERFUNCTION	HH AY P ER F AH NG K SH AH N
HYPERFUNCTIONAL	HH AY P ER F AH NG K SH AH N AH L
HYPERFUNCTIONING	HH AY P ER F AH NG K SH AH N IH NG
HYPERFUNCTIONS	HH AY P ER F AH NG K SH AH N Z
HYPERGAMIES	HH AY P ER G EY M IY Z
HYPERGAMY	HH AY P ER G EY M IY
HYPERGLYCEMIA	HH AY P AH R G L AH S IY M IY AH
HYPERGLYCEMIAS	HH AY P AH R G L AH S IY M IY AH Z
HYPERGLYCEMIC	HH AY P AH R G L IH S AH M AH K
HYPERGOL	HH AY P AH R G AA L
HYPERGOLIC	HH AY P AH R G AA L AH K
HYPERGOLICALLY	HH AY P ER G OW L AY S AH L IY
HYPERGOLS	HH AY P AH R G AA L Z
HYPERHIDROSES	HH AY P ER HH IH D R OW Z IH Z
HYPERHIDROSIS	HH AY P ER HH IH D R OW Z IY Z
HYPERIMMUNE	HH AY P ER IH M Y UW N
HYPERIMMUNIZATION	HH AY P ER IH M Y UW N AH Z EY SH AH N
HYPERIMMUNIZATIONS	HH AY P ER IH M Y UW N AH Z EY SH AH N Z
HYPERIMMUNIZE	HH AY P ER IH M Y UW N AY Z
HYPERIMMUNIZED	HH AY P ER IH M Y UW N AY Z D
HYPERIMMUNIZES	HH AY P ER IH M Y UW N AY Z IH Z
HYPERIMMUNIZING	HH AY P ER IH M Y UW N AY Z IH NG
HYPERINFLATED	HH AY P ER IH N F L EY T IH D
HYPERINFLATION	HH AY P ER IH N F L EY SH AH N
HYPERINFLATIONARY	HH AY P ER IH N F L EY SH AH N EH R IY
HYPERINFLATIONS	HH AY P ER IH N F L EY SH AH N Z
HYPERINNERVATION	HH AY P ER IH N ER V EY SH AH N
HYPERINNERVATIONS	HH AY P ER IH N ER V EY SH AH N Z
HYPERINSULINISM	HH AY P ER IH N S AH L AH N IH Z AH M
HYPERINSULINISMS	HH AY P ER IH N S AH L AH N IH Z AH M Z
HYPERINTELLECTUAL	HH AY P ER IH N T AH L EH K CH AH W AH L
HYPERINTELLIGENT	HH AY P ER IH N T EH L AH JH AH N T
HYPERINTENSE	HH AY P ER IH N T EH N S
HYPERINVOLUTION	HH AY P ER IH N V AH L UW SH AH N
HYPERINVOLUTIONS	HH AY P ER IH N V AH L UW SH AH N Z
HYPERIRRITABILITIES	HH AY P ER IH R AH T AH B IH L AH T EH Z
HYPERIRRITABILITY	HH AY P ER IH R AH T AH B IH L AH T EH
HYPERIRRITABLE	HH AY P ER IH R AH T AH B AH L
HYPERKERATOSES	HH AY P AH R K EH R AH T OW Z AH Z
HYPERKERATOSIS	HH AY P AH R K AH R AH T OW S AH S
HYPERKERATOTIC	HH AY P AH R K EH R AH T AH T AH K
HYPERKINESES	HH AY P AH R K AH N IY Z AH Z
HYPERKINESIA	HH AY P AH R K AH N IY ZH IY AH
HYPERKINESIAS	HH AY P AH R K AH N IY S IY AH Z
HYPERKINESIS	HH AY P AH R K AY N AH S AH S
HYPERKINETIC	HH AY P ER K IH N EH T IH K
HYPERLINK	HH AY P ER L IH NG K
HYPERLINKED	HH AY P ER L IH NG K T
HYPERLINKING	HH AY P ER L IH NG K IH NG
HYPERLINKS	HH AY P ER L IH NG K S
HYPERLIPEMIA	HH AY P AH R L AH P IY M IY AH
HYPERLIPEMIAS	HH AY P AH R L AH P IY M IY AH Z
HYPERLIPEMIC	HH AY P AH R L IH P AH M AH K
HYPERLIPIDEMIA	HH AY P AH R L IH P AH D IY M IY AH
HYPERLIPIDEMIAS	HH AY P AH R L IH P AH D IY M IY AH Z
HYPERMANIA	HH AY P ER M EY N IY AH
HYPERMANIAS	HH AY P ER M EY N IY AH Z
HYPERMANIC	HH AY P ER M AE N IH K
HYPERMARKET	HH AY P ER M AA R K IH T
HYPERMARKETS	HH AY P ER M AA R K IH T S
HYPERMASCULINE	HH AY P ER M AE S K Y AH L AH N
HYPERMEDIA	HH AY P AH R M IY D IY AH
HYPERMEDIAS	HH AY P AH R M IY D IY AH Z
HYPERMETABOLIC	HH AY P ER M EH T AH B AA L IH K
HYPERMETABOLISM	HH AY P ER M AH T AE B AH L IH Z AH M
HYPERMETABOLISMS	HH AY P ER M AH T AE B AH L IH Z AH M Z
HYPERMETER	HH AY P ER M IY T ER
HYPERMETERS	HH AY P ER M IY T ER Z
HYPERMETRIC	HH AY P ER M EH T R IH K
HYPERMETRICAL	HH AY P ER M EH T R IH K AH L
HYPERMETROPIA	HH AY P AH R M EH T R OW P IY AH
HYPERMETROPIAS	HH AY P AH R M EH T R OW P IY AH Z
HYPERMETROPIC	HH AY P ER M EH T R OW P IH K
HYPERMNESIA	HH AY P AH R M N IY ZH IY AH
HYPERMNESIAS	HH AY P AH R M N IY S IY AH Z
HYPERMNESIC	HH IH P AH R M Z AH K
HYPERMOBILITIES	HH AY P ER M OW B IH L AH T IY Z
HYPERMOBILITY	HH AY P ER M OW B IH L AH T IY
HYPERMODERN	HH AY P ER M AA D ER N
HYPERMODERNIST	HH AY P ER M AA D ER N IH S T
HYPERMODERNISTS	HH AY P ER M AA D ER N IH S T S
HYPERMUTABILITIES	HH AY P ER M Y UW T AH B IH L AH T EH Z
HYPERMUTABILITY	HH AY P ER M Y UW T AH B IH L AH T EH
HYPERMUTABLE	HH AY P ER M Y UW T AH B AH L
HYPERNATIONALISTIC	HH AY P ER N AE SH AH N AH L IH S T IH K
HYPERON	HH AY P ER AO N
HYPERONS	HH AY P ER AO N Z
HYPEROPE	HH AY P AH R OW P
HYPEROPES	HH AY P AH R OW P S
HYPEROPIA	HH AY P ER OW P IY AA
HYPEROPIAS	HH AY P AH R OW P IY AH Z
HYPEROPIC	HH AY P AH R OW P AH K
HYPEROSTOSES	HH AY P AH R AA S T OW Z AH Z
HYPEROSTOSIS	HH AY P AH R AA S T OW S AH S
HYPEROSTOTIC	HH AY P ER AA S T OW T IH K
HYPERPARASITE	HH AY P ER P AE R AH S AY T
HYPERPARASITES	HH AY P ER P AE R AH S AY T S
HYPERPARASITIC	HH AY P ER P AE R AH S IH T IH K
HYPERPARASITISM	HH AY P ER P AE R AH S AY T IH Z AH M
HYPERPARASITISMS	HH AY P ER P AE R AH S AY T IH Z AH M Z
HYPERPARATHYROIDISM	HH AY P ER P AA R AH TH AY R OY D IH Z AH M
HYPERPARATHYROIDISMS	HH AY P ER P AA R AH TH AY R OY D IH Z AH M Z
HYPERPHAGIA	HH AY P AH R F EY JH IY AH
HYPERPHAGIAS	HH AY P AH R F EY JH IY AH Z
HYPERPHAGIC	HH AH P AH R F AH JH AH K
HYPERPHYSICAL	HH AY P ER F IH Z AH K AH L
HYPERPIGMENTATION	HH AY P ER P IH G M AH N T EY SH AH N
HYPERPIGMENTATIONS	HH AY P ER P IH G M AH N T EY SH AH N Z
HYPERPIGMENTED	HH AY P ER P IH G M AH N T IH D
HYPERPITUITARISM	HH AY P AH R P AH T UW T AH R IH Z AH M
HYPERPITUITARISMS	HH AY P AH R P AH T UW T AH R AH Z AH M Z
HYPERPITUITARY	HH AY P ER P AH T Y UW AH T EH R IY
HYPERPLANE	HH AY P ER P L EY N
HYPERPLANES	HH AY P ER P L EY N Z
HYPERPLASIA	HH AY P ER P L EY ZH IY AA
HYPERPLASIAS	HH AY P ER P L EY ZH AH Z
HYPERPLASTIC	HH AY P ER P L AE S T IH K
HYPERPLOID	HH IH P AH R P L OY D
HYPERPLOIDIES	HH AY P AH R P L OY D AY Z
HYPERPLOIDS	HH AY P AH R P L OY D Z
HYPERPLOIDY	HH AY P AH R P L OY D IY
HYPERPNEA	HH AY P AH R N IY
HYPERPNEAS	HH AY P AH R N IY Z
HYPERPNEIC	HH AY P AH R N IY AH K
HYPERPOLARIZATION	HH AY P ER P OW L ER AH Z EY SH AH N
HYPERPOLARIZATIONS	HH AY P ER P OW L ER AH Z EY SH AH N Z
HYPERPOLARIZE	HH AY P ER P OW L ER AY Z
HYPERPOLARIZED	HH AY P ER P OW L ER AY Z D
HYPERPOLARIZES	HH AY P ER P OW L ER AY Z IH Z
HYPERPOLARIZING	HH AY P ER P OW L ER AY Z IH NG
HYPERPRODUCER	HH AY P ER P R AH D UW S ER
HYPERPRODUCERS	HH AY P ER P R AH D UW S ER Z
HYPERPRODUCTION	HH AY P ER P R AA D AH K SH AH N
HYPERPRODUCTIONS	HH AY P ER P R AA D AH K SH AH N Z
HYPERPURE	HH AY P ER P Y UH R
HYPERPYREXIA	HH AY P AH R P AH R EH K S IY AH
HYPERPYREXIAS	HH AY P AH R P AH R EH K S IY AH Z
HYPERRATIONAL	HH AY P ER R AE SH AH N AH L
HYPERRATIONALITIES	HH AY P ER R AE SH AH N AE L AH T IY Z
HYPERRATIONALITY	HH AY P ER R AE SH AH N AE L AH T IY
HYPERREACTIVE	HH AY P ER R IY AE K T IH V
HYPERREACTIVITIES	HH AY P ER R IY AE K T IH V AH T IY Z
HYPERREACTIVITY	HH AY P ER R IY AE K T IH V AH T IY
HYPERREACTOR	HH AY P ER R IY AE K T ER
HYPERREACTORS	HH AY P ER R IY AE K T ER Z
HYPERREALISM	HH AY P ER R IY L IH Z AH M
HYPERREALISMS	HH AY P ER R IY L IH Z AH M Z
HYPERREALIST	HH AY P ER R IY L IH S T
HYPERREALISTIC	HH AY P ER R IY AH L IH S T IH K
HYPERRESPONSIVE	HH AY P ER R IH S P AA N S IH V
HYPERROMANTIC	HH AY P ER R OW M AE N T IH K
HYPERSALINE	HH AY P ER S EY L IY N
HYPERSALINITIES	HH AY P ER S EY L IY N AH T IY Z
HYPERSALINITY	HH AY P ER S EY L IY N AH T IY
HYPERSALIVATION	HH AY P ER S AE L AH V EY SH AH N
HYPERSALIVATIONS	HH AY P ER S AE L AH V EY SH AH N Z
HYPERSECRETION	HH AY P ER S IH K R IY SH AH N
HYPERSECRETIONS	HH AY P ER S IH K R IY SH AH N Z
HYPERSENSITIVE	HH AY P ER S EH N S IH T IH V
HYPERSENSITIVENESS	HH AY P ER S EH N S AH T IH V N AH S
HYPERSENSITIVENESSES	HH AY P ER S EH N S AH T IH V N AH S IH Z
HYPERSENSITIVITIES	HH AY P ER S EH N S AH T IH V AH T IY Z
HYPERSENSITIVITY	HH AY P ER S EH N S IH T IH V IH T IY
HYPERSENSITIZATION	HH AY P ER S EH N S AH T AH Z EY SH AH N
HYPERSENSITIZATIONS	HH AY P ER S EH N S AH T AH Z EY SH AH N Z
HYPERSENSITIZE	HH AY P ER S EH N S AH T AY Z
HYPERSENSITIZED	HH AY P ER S EH N S AH T AY Z D
HYPERSENSITIZES	HH AY P ER S EH N S AH T AY Z IH Z
HYPERSENSITIZING	HH AY P ER S EH N S AH T AY Z IH NG
HYPERSEXUAL	HH AY P ER S EH K SH AH W AH L
HYPERSEXUALITIES	HH AY P ER S EH K SH AH W AE L AH T IY Z
HYPERSEXUALITY	HH AY P ER S EH K SH AH W AE L AH T IY
HYPERSOMNOLENCE	HH AY P ER S AA M N AH L AH N S
HYPERSOMNOLENCES	HH AY P ER S AA M N AH L AH N S IH Z
HYPERSONIC	HH AY P ER S AA N IH K
HYPERSONICALLY	HH AY P ER S AA N IH K AH L IY
HYPERSPACE	HH AY P ER S P EY S
HYPERSPACES	HH AY P ER S P EY S IH Z
HYPERSTATIC	HH AY P ER S T AE T IH K
HYPERSTHENE	HH AY P AH R S TH IY N
HYPERSTHENES	HH AY P AH R S TH IY N Z
HYPERSTHENIC	HH AY P AH R S TH IY N AH K
HYPERSTIMULATE	HH AY P ER S T IH M Y AH L AH T
HYPERSTIMULATED	HH AY P ER S T IH M Y AH L EY T IH D
HYPERSTIMULATES	HH AY P ER S T IH M Y AH L AH T S
HYPERSTIMULATING	HH AY P ER S T IH M Y AH L EY T IH NG
HYPERSTIMULATION	HH AY P ER S T IH M Y AH L EY SH AH N
HYPERSTIMULATIONS	HH AY P ER S T IH M Y AH L EY SH AH N Z
HYPERSURFACE	HH AY P ER S ER F AH S
HYPERSURFACES	HH AY P ER S ER F AH S IH Z
HYPERSUSCEPTIBILITIES	HH AY P ER S AH S EH P T AH B IH L AH T IY Z
HYPERSUSCEPTIBILITY	HH AY P ER S AH S EH P T AH B IH L AH T IY
HYPERSUSCEPTIBLE	HH AY P ER S AH S EH P T AH B AH L
HYPERTENSE	HH AY P ER T EH N S
HYPERTENSION	HH AY P ER T EH N SH AH N
HYPERTENSIONS	HH AY P ER T EH N CH AH N Z
HYPERTENSIVE	HH AY P ER T EH N S IH V
HYPERTENSIVES	HH AY P ER T EH N S IH V Z
HYPERTEXT	HH AY P ER T EH K S T
HYPERTEXTS	HH AY P ER T EH K S T S
HYPERTHERMIA	HH AY P AH R TH AH R M IY AH
HYPERTHERMIAS	HH AY P AH R TH AH R M IY AH Z
HYPERTHERMIC	HH AY P ER TH ER M IH K
HYPERTHYROID	HH AY P ER TH AY R OY D
HYPERTHYROIDISM	HH AY P ER TH AY R OY D IH Z AH M
HYPERTHYROIDISMS	HH AY P ER TH AY R OY D IH Z AH M Z
HYPERTONIA	HH AY P AH R T OW N Y AH
HYPERTONIAS	HH AY P AH R T OW N Y AH Z
HYPERTONIC	HH AY P ER T AA N IH K
HYPERTONICITIES	HH AY P ER T AA N IH K AH T IY Z
HYPERTONICITY	HH AY P ER T AA N IH K AH T IY
HYPERTROPHIC	HH AY P ER T R OW F IH K
HYPERTROPHIED	HH AY P ER T R AH F IY D
HYPERTROPHIES	HH AY P ER T R AH F IY Z
HYPERTROPHY	HH AY P ER T R OW F IY
HYPERTROPHYING	HH AY P ER T R AH F IY IH NG
HYPERTYPICAL	HH AY P ER T IH P IH K AH L
HYPERURBANISM	HH AY P ER ER B AH N IH Z AH M
HYPERURBANISMS	HH AY P ER ER B AH N IH Z AH M Z
HYPERURICEMIA	HH AY P AH R Y UH R AH S IY M IY AH
HYPERURICEMIAS	HH AY P AH R Y UH R AH S IY M IY AH Z
HYPERVELOCITIES	HH AY P ER V AH L AA S AH T IY Z
HYPERVELOCITY	HH AY P ER V AH L AA S AH T IY
HYPERVENTILATE	HH AY P ER V EH N T AH L AH T
HYPERVENTILATED	HH AY P ER V EH N T AH L EY T IH D
HYPERVENTILATES	HH AY P ER V EH N T AH L AH T S
HYPERVENTILATING	HH AY P ER V EH N T AH L EY T IH NG
HYPERVENTILATION	HH AY P ER V EH N T AH L EY SH AH N
HYPERVENTILATIONS	HH AY P ER V EH N T AH L EY SH AH N Z
HYPERVIGILANCE	HH AY P ER V IH JH AH L AH N S
HYPERVIGILANCES	HH AY P ER V IH JH AH L AH N S IH Z
HYPERVIGILANT	HH AY P ER V IH JH AH L AH N T
HYPERVIRULENT	HH AY P ER V IH R AH L AH N T
HYPERVISCOSITIES	HH AY P ER V IH S K AA S AH T IY Z
HYPERVISCOSITY	HH AY P ER V IH S K AA S AH T IY
HYPERVITAMINOSES	HH AY P ER V AY T AH M AH N AA S IH Z
HYPERVITAMINOSIS	HH AY P ER V AY T AH M AH N AA S IY Z
HYPES	HH AY P S
ICONOSCOPE	AH K AA N AH S OW P
ICONOSCOPES	AH K AA N AH S OW P S
IMMUNOCOMPETENCE	IH M Y UW N AH K AA M P AH T AH N S
IMMUNOCOMPETENCES	IH M Y UW N AH K AA M P AH T EH N S AH Z
IMMUNOCOMPETENT	IH M Y UW N AH K AA M P AH T AH N T
IMMUNOTHERAPEUTIC	IH M Y UW N AH TH AH R EY P AH Y UW T AH K
IMPEACH	IH M P IY CH
IMPEACHABLE	IH M P IY CH AH B AH L
IMPEACHED	IH M P IY CH T
IMPEACHES	IH M P IY CH AH Z
IMPEACHING	IH M P IY CH IH NG
IMPEACHMENT	IH M P IY CH M AH N T
IMPEACHMENTS	IH M P IY CH M AH N T S
IMPEARL	IH M P ER L
IMPEARLED	IH M P ER L D
IMPEARLING	IH M P AE ER L IH NG
IMPEARLS	IH M P ER L Z
IMPECCABILITIES	IH M P EH K AH B IH L AH T EH Z
IMPECCABILITY	IH M P EH K AH B IH L AH T EH
IMPECCABLE	IH M P EH K AH B AH L
IMPECCABLY	IH M P EH K AH B L IY
IMPECUNIOSITIES	IH M P AH K Y AH N IY AA S AH T AY Z
IMPECUNIOSITY	IH M P EH K Y UW N IY AA Z AH T IY
IMPECUNIOUS	IH M P EH K Y UW N IY AH S
IMPECUNIOUSLY	IH M P EH K Y AH N IY OW AH S L IY
IMPECUNIOUSNESS	IH M P AH K Y UW N IY AW Z N AH S
IMPECUNIOUSNESSES	IH M P AH K Y UW N IY AW Z N EH S AH Z
IMPED	IH M P EH D
IMPEDANCE	IH M P IY D AH N S
IMPEDANCES	IH M P IY D AH N S IH Z
IMPEDE	IH M P IY D
IMPEDED	IH M P IY D IH D
IMPEDER	IH M P IY D ER
IMPEDERS	IH M P IY D ER Z
IMPEDES	IH M P IY D Z
IMPEDIMENT	IH M P EH D AH M AH N T
IMPEDIMENTA	IH M P EH D AH M EH N T AH
IMPEDIMENTS	IH M P EH D AH M AH N T S
IMPEDING	IH M P IY D IH NG
IMPEL	IH M P EH L
IMPELLED	IH M P EH L D
IMPELLER	IH M P EH L ER
IMPELLERS	IH M P EH L ER Z
IMPELLING	IH M P EH L IH NG
IMPELLOR	IH M P EH L ER
IMPELLORS	IH M P EH L ER Z
IMPELS	IH M P EH L Z
IMPEND	IH M P EH N D
IMPENDED	IH M P EH N D IH D
IMPENDENT	IH M P EH N D EH N T
IMPENDING	IH M P EH N D IH NG
IMPENDS	IH M P EH N D Z
IMPENETRABILITIES	IH M P EH N AH T R AH B IH L AH T EH Z
IMPENETRABILITY	IH M P EH N AH T R AH B IH L AH T EH
IMPENETRABLE	IH M P EH N AH T R AH B AH L
IMPENETRABLY	IH M P EH N AH T R AH B L IY
IMPENITENCE	IH M P EH N AH T AH N S
IMPENITENCES	IH M P EH N AH T EH N S AH Z
IMPENITENT	IH M P EH N AH T AH N T
IMPENITENTLY	IH M P EH N AH T EH N T L IY
IMPERATIVE	IH M P EH R AH T IH V
IMPERATIVELY	IH M P EH R AH T IH V L IY
IMPERATIVENESS	IH M P EH R AH T IH V N AH S
IMPERATIVENESSES	IH M P EH R AH T IH V N AH S IH Z
IMPERATIVES	IH M P EH R AH T IH V Z
IMPERATOR	IH M P ER EY T ER
IMPERATORIAL	IH M P ER AH T OW R IY AH L
IMPERATORS	IH M P ER EY T ER Z
IMPERCEIVABLE	IH M P ER S IY V AH B AH L
IMPERCEPTIBLE	IH M P ER S EH P T IH B AH L
IMPERCEPTIBLY	IH M P ER S EH P T IH B L IY
IMPERCEPTIVE	IH M P ER S EH P T IH V
IMPERCEPTIVENESS	IH M P ER S EH P T IH V N AH S
IMPERCEPTIVENESSES	IH M P ER S EH P T IH V N AH S IH Z
IMPERCIPIENCE	IH M P AH R S IH P IY AH N S
IMPERCIPIENCES	IH M P AH R S IH P IY EH N S AH Z
IMPERCIPIENT	IH M P AH R S IH P IY AH N T
IMPERFECT	IH M P ER F IH K T
IMPERFECTION	IH M P ER F EH K SH AH N
IMPERFECTIONS	IH M P ER F EH K SH AH N Z
IMPERFECTIVE	IH M P ER F AH K T IH V
IMPERFECTIVES	IH M P ER F AH K T IH V Z
IMPERFECTLY	IH M P ER F IH K T L IY
IMPERFECTNESS	IH M P ER F AH K T N AH S
IMPERFECTNESSES	IH M P ER F AH K T N AH S IH Z
IMPERFECTS	IH M P ER F AH K T S
IMPERFORATE	IH M P ER F AH R EY T
IMPERIA	IH M P IY R IY AH
IMPERIAL	IH M P IH R IY AH L
IMPERIALISM	IH M P IH R IY AH L IH Z AH M
IMPERIALISMS	IH M P IH R IY AH L IH Z AH M Z
IMPERIALIST	IH M P IH R IY AH L IH S T
IMPERIALISTIC	IH M P IY R IY AH L IH S T IH K
IMPERIALISTICALLY	IH M P IH R IY AH L IH S T IH K AH L IY
IMPERIALISTS	IH M P IH R IY AH L IH S T S
IMPERIALLY	IH M P IH R IY AH L IY
IMPERIALS	IH M P IH R IY AH L Z
IMPERIL	IH M P EH R AH L
IMPERILED	IH M P EH R AH L D
IMPERILING	IH M P EH R AH L IH NG
IMPERILLED	IH M P EH R AH L D
IMPERILLING	IH M P EH R AH L IH NG
IMPERILMENT	IH M P EH R AH L M AH N T
IMPERILMENTS	IH M P EH R AH L M AH N T S
IMPERILS	IH M P EH R AH L Z
IMPERIOUS	IH M P IH R IY AH S
IMPERIOUSLY	IH M P IH R IY AH S L IY
IMPERIOUSNESS	IH M P IH R IY AH S N AH S
IMPERIOUSNESSES	IH M P IH R IY AH S N AH S IH Z
IMPERISHABILITIES	IH M P EH R IH SH AH B IH L AH T EH Z
IMPERISHABILITY	IH M P EH R IH SH AH B IH L AH T EH
IMPERISHABLE	IH M P EH R IH SH AH B AH L
IMPERISHABLENESS	IH M P EH R IH SH AH B AH L N AH S
IMPERISHABLENESSES	IH M P EH R IH SH AH B AH L N AH S IH Z
IMPERISHABLES	IH M P EH R IH SH AH B AH L Z
IMPERISHABLY	IH M P EH R IH SH AH B L IY
IMPERIUM	IH M P AH R IY AH M
IMPERIUMS	IH M P AH R AY AH M Z
IMPERMANENCE	IH M P ER M AH N AH N S
IMPERMANENCES	IH M P ER M AH N AH N S IH Z
IMPERMANENCIES	IH M P ER M AH N AH N S IY Z
IMPERMANENCY	IH M P ER M AH N AH N S IY
IMPERMANENT	IH M P ER M AH N AH N T
IMPERMANENTLY	IH M P ER M AH N AH N T L IY
IMPERMEABILITIES	IH M P ER M IY AH B IH L AH T EH Z
IMPERMEABILITY	IH M P ER M IY AH B IH L AH T EH
IMPERMEABLE	IH M P ER M IY AH B AH L
IMPERMISSIBILITIES	IH M P ER M IH S AH B IH L AH T IY Z
IMPERMISSIBILITY	IH M P ER M IH S AH B IH L AH T IY
IMPERMISSIBLE	IH M P ER M IH S IH B AH L
IMPERMISSIBLY	IH M P ER M IH S AH B L IY
IMPERSONAL	IH M P ER S AH N AH L
IMPERSONALITIES	IH M P ER S AH N AE L AH T IY Z
IMPERSONALITY	IH M P ER S AH N AE L AH T IY
IMPERSONALIZATION	IH M P ER S AH N AH L AH Z EY SH AH N
IMPERSONALIZATIONS	IH M P ER S AH N AH L AH Z EY SH AH N Z
IMPERSONALIZE	IH M P ER S AH N AH L AY Z
IMPERSONALIZED	IH M P ER S AH N AH L AY Z D
IMPERSONALIZES	IH M P ER S AH N AH L AY Z IH Z
IMPERSONALIZING	IH M P ER S AH N AH L AY Z IH NG
IMPERSONALLY	IH M P ER S AH N AH L IY
IMPERSONATE	IH M P ER S AH N EY T
IMPERSONATED	IH M P ER S AH N EY T IH D
IMPERSONATES	IH M P ER S AH N EY T S
IMPERSONATING	IH M P ER S AH N EY T IH NG
IMPERSONATION	IH M P ER S AH N EY SH AH N
IMPERSONATIONS	IH M P ER S AH N EY SH AH N Z
IMPERSONATOR	IH M P ER S AH N EY T ER
IMPERSONATORS	IH M P ER S AH N EY T ER Z
IMPERTINENCE	IH M P ER T AH N AH N S
IMPERTINENCES	IH M P ER T AH N AH N S IH Z
IMPERTINENCIES	IH M P ER T AH N AH N S IY Z
IMPERTINENCY	IH M P ER T AH N AH N S IY
IMPERTINENT	IH M P ER T AH N AH N T
IMPERTINENTLY	IH M P ER T AH N AH N T L IY
IMPERTURBABILITIES	IH M P ER T ER B AH B IH L AH T EH Z
IMPERTURBABILITY	IH M P ER T ER B AH B IH L AH T EH
IMPERTURBABLE	IH M P ER T ER B AH B AH L
IMPERTURBABLY	IH M P ER T ER B AH B L IY
IMPERVIOUS	IH M P ER V IY AH S
IMPERVIOUSLY	IH M P ER V IY AH S L IY
IMPERVIOUSNESS	IH M P ER V IY AH S N AH S
IMPERVIOUSNESSES	IH M P ER V IY AH S N AH S IH Z
IMPETIGINOUS	IH M P AH T IH JH AH N AH S
IMPETIGO	IH M P EH T AH G OW
IMPETIGOS	IH M P EH T AH G AH Z
IMPETRATE	IH M P EH T R AH T
IMPETRATED	IH M P EH T R EY T IH D
IMPETRATES	IH M P EH T R AH T S
IMPETRATING	IH M P EH T R EY T IH NG
IMPETRATION	IH M P EH T R EY SH AH N
IMPETRATIONS	IH M P EH T R EY SH AH N Z
IMPETUOSITIES	IH M P EH T Y UW AA S AH T AY Z
IMPETUOSITY	IH M P EH T Y UW AA Z AH T IY
IMPETUOUS	IH M P EH CH W AH S
IMPETUOUSLY	IH M P EH CH AH W AH S L IY
IMPETUOUSNESS	IH M P EH CH AH W AH S N AH S
IMPETUOUSNESSES	IH M P EH CH AH W AH S N AH S IH Z
IMPETUS	IH M P AH T AH S
IMPETUSES	IH M P AH T AH S IH Z
IMPROPER	IH M P R AA P ER
IMPROPERLY	IH M P R AA P ER L IY
IMPROPERNESS	IH M P R AA P ER N AH S
IMPROPERNESSES	IH M P R AA P ER N AH S IH Z
INAPPEASABLE	IH N AH P IY Z AH B AH L
INAPPETENCE	AH N AE P AH T AH N S
INAPPETENCES	AH N AE P AH T EH N S AH Z
INCLASPED	IH N K L AE S P T
INCLIPPED	IH N K L IH P T
INCOMPETENCE	IH N K AA M P AH T AH N S
INCOMPETENCES	IH N K AA M P AH T AH N S IH Z
INCOMPETENCIES	IH N K AA M P AH T AH N S IY Z
INCOMPETENCY	IH N K AA M P AH T AH N S IY
INCOMPETENT	IH N K AA M P AH T AH N T
INCOMPETENTLY	IH N K AA M P AH T AH N T L IY
INCOMPETENTS	IH NG K AA M P AH T AH N T S
INDEPENDENCE	IH N D IH P EH N D AH N S
INDEPENDENCES	IH N D IH P EH N D AH N S IH Z
INDEPENDENCIES	IH N D IH P EH N D AH N S IY Z
INDEPENDENCY	IH N D IH P EH N D AH N S IY
INDEPENDENT	IH N D IH P EH N D AH N T
INDEPENDENTLY	IH N D IH P EH N D AH N T L IY
INDEPENDENTS	IH N D IH P EH N D AH N T S
INDISPENSABILITIES	IH N D IH S P EH N S AH B IH L AH T EH Z
INDISPENSABILITY	IH N D IH S P EH N S AH B IH L AH T EH
INDISPENSABLE	IH N D IH S P EH N S AH B AH L
INDISPENSABLENESS	IH N D IH S P EH N S AH B AH L N AH S
INDISPENSABLENESSES	IH N D IH S P EH N S AH B AH L N AH S IH Z
INDISPENSABLES	IH N D IH S P EH N S AH B AH L Z
INDISPENSABLY	IH N D IH S P EH N S AH B AH L IY
INEXPEDIENCE	IH N IH K S P IY D IY AH N S
INEXPEDIENCES	IH N IH K S P IY D IY AH N S IH Z
INEXPEDIENCIES	IH N IH K S P IY D IY AH N S IY Z
INEXPEDIENCY	IH N IH K S P IY D IY AH N S IY
INEXPEDIENT	IH N IH K S P IY D IY AH N T
INEXPEDIENTLY	IH N IH K S P IY D IY AH N T L IY
INEXPENSIVE	IH N IH K S P EH N S IH V
INEXPENSIVELY	IH N AH K S P EH N S IH V L IY
INEXPENSIVENESS	IH N EH K S P EH N S IH V N AH S
INEXPENSIVENESSES	IH N EH K S P EH N S IH V N AH S IH Z
INEXPERIENCE	IH N IH K S P IH R IY AH N S
INEXPERIENCED	IH N EH K S P IH R IY AH N S T
INEXPERIENCES	IH N IH K S P IH R IY AH N S IH Z
INEXPERT	IH N EH K S P ER T
INEXPERTLY	IH N EH K S P ER T L IY
INEXPERTNESS	IH N EH K S P ER T N AH S
INEXPERTNESSES	IH N EH K S P ER T N AH S IH Z
INEXPERTS	IH N EH K S P ER T S
INFRASPECIFIC	IH N F R AH S P IH S IH F IH K
INNKEEPER	IH N K IY P ER
INNKEEPERS	IH N K IY P ER Z
INOPERABLE	IH N AA P ER AH B AH L
INOPERATIVE	IH N AA P ER AH T IH V
INOPERATIVENESS	IH N AA P ER AH T IH V N AH S
INOPERATIVENESSES	IH N AA P ER AH T IH V N AH S IH Z
INOPERCULATE	AH N AH P AH R K Y AH L EY T
INOPERCULATES	AH N AH P AH R K Y AH L EY T S
INSCAPE	IH N S K EY P
INSCAPES	IH N S K EY P S
INSCULPED	IH N S AH L P T
INSPECT	IH N S P EH K T
INSPECTED	IH N S P EH K T IH D
INSPECTING	IH N S P EH K T IH NG
INSPECTION	IH N S P EH K SH AH N
INSPECTIONS	IH N S P EH K SH AH N Z
INSPECTIVE	IH N S P EH K T IH V
INSPECTOR	IH N S P EH K T ER
INSPECTORATE	IH N S P EH K T ER AH T
INSPECTORATES	IH N S P EH K T ER AH T S
INSPECTORS	IH N S P EH K T ER Z
INSPECTORSHIP	IH N S P EH K T ER SH IH P
INSPECTORSHIPS	IH N S P EH K T ER SH IH P S
INSPECTS	IH N S P EH K T S
INSUPERABLE	IH N S UW P AH R AH B AH L
INSUPERABLY	IH N S UW P AH R AH B L IY
INTEMPERANCE	IH N T EH M P ER AH N S
INTEMPERANCES	IH N T EH M P ER AH N S IH Z
INTEMPERATE	IH N T EH M P ER AH T
INTEMPERATELY	IH N T EH M P ER AH T L IY
INTEMPERATENESS	IH N T EH M P ER AH T N AH S
INTEMPERATENESSES	IH N T EH M P ER AH T N AH S IH Z
INTERCROPPED	IH N T ER K R AA P T
INTERDEPEND	IH N T ER D IH P EH N D
INTERDEPENDED	IH N T ER D IH P EH N D IH D
INTERDEPENDENCE	IH N T ER D AH P EH N D AH N S
INTERDEPENDENCES	IH N T ER D IH P EH N D AH N S IH Z
INTERDEPENDENCIES	IH N T ER D IH P EH N D AH N S IY Z
INTERDEPENDENCY	IH N T ER D IH P EH N D AH N S IY
INTERDEPENDENT	IH N T ER D IH P EH N D AH N T
INTERDEPENDENTLY	IH N T ER D IY P EH N D EH N T L IY
INTERDEPENDING	IH N T ER D IY P EH N D IH NG
INTERDEPENDS	IH N T ER D IH P EH N D Z
INTERLAPPED	IH N T ER L AE P T
INTERLOPE	IH N T ER L OW P
INTERLOPED	IH N T ER L OW P T
INTERLOPER	IH N T ER L OW P ER
INTERLOPERS	IH N T ER L OW P ER Z
INTERLOPES	IH N T ER L OW P S
INTEROPERABILITIES	IH N T ER AA P ER AH B IH L AH T EH Z
INTEROPERABILITY	IH N T ER AA P ER AH B IH L AH T EH
INTEROPERABLE	IH N T ER AA P ER AH B AH L
INTEROPERATIVE	IH N T ER AA P ER AH T IH V
INTEROPERATIVES	IH N T ER AA P ER AH T IH V Z
INTERPELLATE	IH N T ER P EH L AH T
INTERPELLATED	IH N T ER P EH L EY T IH D
INTERPELLATES	IH N T ER P EH L AH T S
INTERPELLATING	IH N T ER P EH L EY T IH NG
INTERPELLATION	IH N T ER P EH L EY SH AH N
INTERPELLATIONS	IH N T ER P EH L EY SH AH N Z
INTERPELLATOR	IH N T ER P EH L AH T ER
INTERPELLATORS	IH N T ER P EH L AH T ER Z
INTERPENETRATE	IH N T ER P EH N AH T R AH T
INTERPENETRATED	IH N T ER P EH N AH T R EY T IH D
INTERPENETRATES	IH N T ER P EH N AH T R AH T S
INTERPENETRATING	IH N T ER P EH N AH T R EY T IH NG
INTERPENETRATION	IH N T ER P EH N AH T R EY SH AH N
INTERPENETRATIONS	IH N T ER P EH N AH T R EY SH AH N Z
INTERPERCEPTUAL	IH N T ER P ER S EH P CH AH W AH L
INTERPERMEATE	IH N T ER P ER M IY AH T
INTERPERMEATED	IH N T ER P ER M IY EY T IH D
INTERPERMEATES	IH N T ER P ER M IY AH T S
INTERPERMEATING	IH N T ER P ER M IY EY T IH NG
INTERPERSONAL	IH N T ER P ER S AH N AH L
INTERPERSONALLY	IH N T ER P ER S AH N AH L IY
INTERSPECIES	IH N T ER S P IY SH IY Z
INTERSPECIFIC	IH N T ER S P IH S IH F IH K
INTERSPERSE	IH N T ER S P ER S
INTERSPERSED	IH N T ER S P ER S T
INTERSPERSES	IH N T ER S P ER S AH Z
INTERSPERSING	IH N T ER S P ER S IH NG
INTERSPERSION	IH N T ER S P ER ZH AH N
INTERSPERSIONS	IH N T ER S P ER ZH AH N Z
INTRAPERITONEAL	IH N T R AH P AH R AH T OW N IY AH L
INTRAPERITONEALLY	IH N T R AH P AH R IH T AH N IY L IY
INTRAPERSONAL	IH N T R AH P ER S AH N AH L
INTRASPECIES	IH N T R AH S P IY SH IY Z
INTRASPECIFIC	IH N T R AH S P AH S IH F AH K
INTROSPECT	IH N T R AH S P EH K T
INTROSPECTED	IH N T R AH S P EH K T IH D
INTROSPECTING	IH N T R AH S P EH K T IH NG
INTROSPECTION	IH N T R AH S P EH K SH AH N
INTROSPECTION(2)	IH N T R OW S P EH K SH AH N
INTROSPECTIONAL	IH N T R AH S P EH K SH AH N AH L
INTROSPECTIONISM	IH N T R AH S P EH K SH AH N IH Z AH M
INTROSPECTIONISMS	IH N T R AH S P EH K SH AH N IH Z AH M Z
INTROSPECTIONIST	IH N T R AH S P EH K SH AH N IH S T
INTROSPECTIONISTIC	IH N T R AH S P EH K SH AH N IH S T IH K
INTROSPECTIONISTS	IH N T R AH S P EH K SH AH N IH S T S
INTROSPECTIONS	IH N T R AH S P EH K SH AH N Z
INTROSPECTIVE	IH N T R AH S P EH K T IH V
INTROSPECTIVE(2)	IH N T R OW S P EH K T IH V
INTROSPECTIVELY	IH N T R AH S P EH K T IH V L IY
INTROSPECTIVENESS	IH N T R AH S P EH K T IH V N AH S
INTROSPECTIVENESSES	IH N T R AH S P EH K T IH V N AH S IH Z
INTROSPECTS	IH N T R AH S P EH K T S
INWRAPPED	IH N R AE P T
IPECAC	IH P AH K AH K
IPECACS	IH P AH K AH S
IPECACUANHA	AH P AH K AE K Y UW AE N HH AH
IPECACUANHAS	AH P AH K AE K Y UW AE N HH AH Z
IRREPEALABILITIES	IH R IH P IY L AH B IH L AH T EH Z
IRREPEALABILITY	IH R IH P IY L AH B IH L AH T EH
IRREPEALABLE	IH R IH P IY L AH B AH L
IRRESPECTIVE	IH R AH S P EH K T IH V
ISOTOPE	AY S AH T OW P
ISOTOPES	AY S AH T OW P S
ISOTYPE	IH S AH T AY P
ISOTYPES	IH S AH T AY P S
JACKANAPES	JH AE K AH N EY P S
JACKANAPESES	JH AE K AE N AH P IY Z AH Z
JALAPENO	HH AE L AH P IY N Y OW
JALAPENOS	HH AE L AH P IY N Y OW Z
JAPE	JH EY P
JAPED	JH EY P T
JAPER	JH EY P AH R
JAPERIES	JH AE P AH R AY Z
JAPERS	JH AE P AH R Z
JAPERY	JH EY P AH R IY
JAPES	JH EY P S
JASPER	JH AE S P ER
JASPERS	JH AE S P ER Z
JASPERWARE	JH AE S P ER W EH R
JASPERWARES	JH AE S P ER W EH R Z
JASPERY	JH AE S P ER IY
JAUPED	JH AO P T
JEEPED	JH IY P T
JEEPERS	JH IY P ER Z
JIMPER	JH IH M P AH R
JIMPEST	JH IH M P EH S T
JOYPOPPED	JH OY P AA P T
JOYPOPPER	JH OY P AA P ER
JOYPOPPERS	JH OY P AA P ER Z
JUMPED	JH AH M P T
JUMPER	JH AH M P ER
JUMPERS	JH AH M P ER Z
JUNIPER	JH UW N AH P ER
JUNIPERS	JH UW N IH P ER Z
JUPE	JH UW P
JUPES	JH UW P S
KALEIDOSCOPE	K AH L AY D AH S K OW P
KALEIDOSCOPES	K AH L AY D AH S K OW P S
KAPELLMEISTER	K AE P AH L M IY S T AH R
KAPELLMEISTERS	K AE P AH L M IY S T AH R Z
KARYOTYPE	K AE R AY AH T AY P
KARYOTYPED	K AE R AY AH T AY P T
KARYOTYPES	K AE R AY AH T AY P S
KEEPER	K IY P ER
KEEPERS	K IY P ER Z
KELPED	K EH L P T
KENSPECKLE	K EH N S P EH K AH L
KEPPED	K EH P T
KEPPEN	K EH P AH N
KIDNAPED	K IH D N AE P T
KIDNAPEE	K IH D N AE P IY
KIDNAPEES	K IH D N AE P IY Z
KIDNAPER	K IH D N AE P ER
KIDNAPERS	K IH D N AE P ER Z
KIDNAPPED	K IH D N AE P T
KIDNAPPEE	K IH D N AE P IY
KIDNAPPEES	K IH D N AE P IY Z
KIDNAPPER	K IH D N AE P ER
KIDNAPPERS	K IH D N AE P ER Z
KINESCOPE	K IH N AH S OW P
KINESCOPED	K IH N AH S OW P T
KINESCOPES	K IH N AH S OW P S
KINETOSCOPE	K AH N EH T AH S OW P
KINETOSCOPES	K AH N EH T AH S OW P S
KIPPED	K IH P T
KIPPEN	K IH P AH N
KIPPER	K IH P ER
KIPPERED	K IH P IY R D
KIPPERER	K IH P IY R AH R
KIPPERERS	K IH P AH R AH R Z
KIPPERING	K IH P IY R AH NG
KIPPERS	K IH P ER Z
KNAPPED	N AE P T
KNAPPER	N AE P ER
KNAPPERS	N AE P AH R Z
KNEECAPPED	N IY K AE P T
KNOPPED	N AA P T
KOPECK	K AA P AH K
KOPECKS	K AA P AH K S
KOPEK	K OW P AH K
KOPEKS	K OW P AH K S
LAGNAPPE	L AE G N AH P
LAGNAPPES	L AE G N AH P S
LAGNIAPPE	L AE G N IY AH P
LAGNIAPPES	L AE G N IY AH P S
LAMPED	L AE M P T
LAMPERS	L AE M P ER Z
LAMPERSES	L AE M P ER Z IH Z
LANDSCAPE	L AE N D S K EY P
LANDSCAPE(2)	L AE N S K EY P
LANDSCAPED	L AE N D S K EY P T
LANDSCAPER	L AE N D S K EY P ER
LANDSCAPERS	L AE N D S K EY P ER Z
LANDSCAPES	L AE N D S K EY P S
LANDSCAPES(2)	L AE N S K EY P S
LAPAROSCOPE	L AE P ER AA S K OW P
LAPAROSCOPES	L AE P ER AA S K OW P S
LAPEL	L AH P EH L
LAPELED	L AH P EH L D
LAPELLED	L AH P EH L D
LAPELS	L AH P EH L Z
LAPPED	L AE P T
LAPPER	L AE P ER
LAPPERED	L AE P ER D
LAPPERING	L AE P ER IH NG
LAPPERS	L AE P ER Z
LAPPET	L AE P AH T
LAPPETED	L AE P AH T IH D
LAPPETS	L AE P AH T S
LARRUPED	L AE R UW P T
LARRUPER	L AE R UW P AH R
LARRUPERS	L AE R UW P AH R Z
LARYNGOSCOPE	L AA R IH N G AH S K OW P
LARYNGOSCOPE(2)	L AA R IH N JH AH S K OW P
LARYNGOSCOPES	L AH R IH N G AH S OW P S
LAYPEOPLE	L EY P IY P AH L
LAYPERSON	L EY P ER S IH N
LAYPERSONS	L EY P ER S AH N Z
LEAFHOPPER	L IY F HH AA P ER
LEAFHOPPERS	L IY F HH AA P ER Z
LEAPED	L EH P T
LEAPED(2)	L IY P T
LEAPER	L IY P ER
LEAPERS	L IY P ER Z
LECTOTYPE	L EH K T AH T AY P
LECTOTYPES	L EH K T AH T AY P S
LEPER	L EH P ER
LEPERS	L EH P ER Z
LESPEDEZA	L EH S EH D AH Z AH
LESPEDEZAS	L EH S EH D AH Z AH Z
LEUKOPENIA	L UW K AH P IY N Y AH
LEUKOPENIAS	L UW K AH P IY N Y AH Z
LEUKOPENIC	L UW K AH P AH N AH K
LIMPED	L IH M P T
LIMPER	L IH M P ER
LIMPERS	L IH M P ER Z
LIMPEST	L IH M P AH S T
LIMPET	L IH M P AH T
LIMPETS	L IH M P AH T S
LIPE	L AY P
LIPPED	L IH P T
LIPPEN	L IH P AH N
LIPPENED	L IH P AH N D
LIPPENING	L IH P AH N IH NG
LIPPENS	L IH P AH N Z
LIPPER	L IH P ER
LIPPERED	L IH P ER D
LIPPERING	L IH P ER IH NG
LIPPERS	L IH P ER Z
LIRIPIPE	L IH R AH P AY P
LIRIPIPES	L IH R AH P AY P S
LISPED	L IH S P T
LISPER	L IH S P ER
LISPERS	L IH S P ER Z
LIVETRAPPED	L IH V T R AE P T
LOCKKEEPER	L AA K IY P ER
LOCKKEEPERS	L AA K IY P ER Z
LOGOTYPE	L AA G AH T AY P
LOGOTYPES	L AA G AH T AY P S
LOLLOPED	L AA L OW P T
LOOPED	L UW P T
LOOPER	L UW P ER
LOOPERS	L UW P ER Z
LOPE	L OW P
LOPED	L OW P T
LOPER	L OW P ER
LOPERS	L OW P ER Z
LOPES	L OW P S
LOPPED	L AA P T
LOPPER	L AA P ER
LOPPERED	L AA P ER D
LOPPERING	L AA P ER IH NG
LOPPERS	L AA P ER Z
LOUDSPEAKER	L AW D S P IY K ER
LOUDSPEAKERS	L AW D S P IY K ER Z
LOUPE	L UW P
LOUPED	L UW P T
LOUPEN	L UW P AH N
LOUPES	L UW P S
LUMPECTOMIES	L AH M P EH K T AH M IY Z
LUMPECTOMY	L AH M P EH K T AH M IY
LUMPED	L AH M P T
LUMPEN	L AH M P AH N
LUMPENPROLETARIAT	L AH M P AH N P R OW L AH T EH R IY AH T
LUMPENPROLETARIATS	L AH M P AH N P R OW L AH T EH R IY AH T S
LUMPENS	L AH M P AH N Z
LUMPER	L AH M P ER
LUMPERS	L AH M P ER Z
LYCANTHROPE	L IH K AH N TH R OW P
LYCANTHROPES	L IH K AH N TH R OW P S
LYCOPENE	L IH K AH P IY N
LYCOPENES	L IH K AH P IY N Z
MALAPERT	M AE L AH P ER T
MALAPERTLY	M AE L AH P ER T L IY
MALAPERTNESS	M AE L AH P ER T N AH S
MALAPERTNESSES	M AE L AH P ER T N AH S IH Z
MALAPERTS	M AE L AH P ER T S
MANROPE	M AE N R OW P
MANROPES	M AE N R OW P S
MAPPED	M AE P T
MAPPER	M AE P ER
MAPPERS	M AE P ER Z
MAXILLIPED	M AE K S AH L AY P T
MAXILLIPEDS	M AE K S AH L IH P AH D Z
MEPERIDINE	M AH P EH R AH D AY N
MEPERIDINES	M AH P EH R AH D AY N Z
MESOPELAGIC	M AH S AA P AH L AH JH AH K
METOPE	M AH T OW P
METOPES	M AH T OW P S
MICROAMPERE	M AY K R OW AE M P AH R
MICROAMPERES	M AY K R OW AE M P IY R Z
MICROPIPET	M AY K R AH P IH P AH T
MICROPIPETS	M AY K R AH P IH P AH T S
MICROPIPETTE	M AY K R OW P AY P EH T
MICROPIPETTES	M AY K R OW P AY P EH T S
MICROSCOPE	M AY K R AH S K OW P
MICROSCOPES	M AY K R AH S K OW P S
MICROSPECTROPHOTOMETER	M AY K R OW S P EH K T R OW F AH T AA M AH T ER
MICROSPECTROPHOTOMETERS	M AY K R OW S P EH K T R OW F AH T AA M AH T ER Z
MICROSPECTROPHOTOMETRIC	M AY K R OW S P EH K T R AH F OW T AH M EH T R IH K
MICROSPECTROPHOTOMETRIES	M AY K R OW S AH K T R AH F AH T AH M EH T R AY Z
MICROSPECTROPHOTOMETRY	M AY K R OW S EH K T R AA F AH T AH M EH T R IY
MILLEPED	M IH L IY P T
MILLEPEDS	M IH L AH P AH D Z
MILLIAMPERE	M IH L IY AE M P AH R
MILLIAMPERES	M IH L IY AH M P IY R Z
MILLIPED	M IH L IH P T
MILLIPEDE	M IH L AH P IY D
MILLIPEDES	M IH L AH P IY D Z
MILLIPEDS	M IH L IH P T S
MINESWEEPER	M AY N S W IY P ER
MINESWEEPERS	M AY N S W IY P ER Z
MISANTHROPE	M IH S AH N TH R OW P
MISANTHROPES	M IH S AH N TH R OW P S
MISDEVELOPED	M IH S D IH V EH L AH P T
MISPEN	M IH S P EH N
MISPENNED	M IH S P EH N D
MISPENNING	M IH S P EH N IH NG
MISPENS	M IH S P EH N Z
MISPERCEIVE	M IH S P ER S IY V
MISPERCEIVED	M IH S P ER S IY V D
MISPERCEIVES	M IH S P ER S IY V Z
MISPERCEIVING	M IH S P ER S IY V IH NG
MISPERCEPTION	M IH S P ER S EH P SH AH N
MISPERCEPTIONS	M IH S P ER S EH P SH AH N Z
MISSHAPE	M IH S SH EY P
MISSHAPED	M IH S SH EY P T
MISSHAPEN	M IH S SH EY P AH N
MISSHAPEN(2)	M IH S HH AE P AH N
MISSHAPENLY	M IH S SH EY P AH N L IY
MISSHAPES	M IH S SH EY P S
MISSPEAK	M IH S S P IY K
MISSPEAK(2)	M IH S P IY K
MISSPEAKING	M IH S P IY K IH NG
MISSPEAKS	M IH S P IY K S
MISSPELL	M IH S S P EH L
MISSPELL(2)	M IH S P EH L
MISSPELLED	M IH S S P EH L D
MISSPELLED(2)	M IH S P EH L D
MISSPELLING	M IH S S P EH L IH NG
MISSPELLING(2)	M IH S P EH L IH NG
MISSPELLINGS	M IH S P EH L IH NG Z
MISSPELLS	M IH S S P EH L Z
MISSPELLS(2)	M IH S P EH L Z
MISSPELT	M IH S P EH L T
MISSPEND	M IH S S P EH N D
MISSPEND(2)	M IH S P EH N D
MISSPENDING	M IH S S P EH N D IH NG
MISSPENDING(2)	M IH S P EH N D IH NG
MISSPENDS	M IH S P EH N D Z
MISSPENT	M IH S S P EH N T
MISSPENT(2)	M IH S P EH N T
MISSTOPPED	M IH S T AA P T
MISTYPE	M IH S T AY P
MISTYPED	M IH S T AY P T
MISTYPES	M IH S T AY P S
MONODISPERSE	M AA N OW D IH S P ER S
MONOPROPELLANT	M AA N OW P R OW P EH L AH N T
MONOPROPELLANTS	M AA N OW P R OW P EH L AH N T S
MONOSPECIFIC	M AA N OW S P IH S IH F IH K
MONOSPECIFICITIES	M AA N OW S P EH S AH F IH S AH T IY Z
MONOSPECIFICITY	M AA N OW S P EH S AH F IH S AH T IY
MONOTERPENE	M AH N AA T AH R P IY N
MONOTERPENES	M AH N AA T AH R P IY N Z
MONOTYPE	M AA N AH T AY P
MONOTYPES	M AA N OW T AY P S
MOONSCAPE	M UW N S K EY P
MOONSCAPES	M UW N S K EY P S
MOPE	M OW P
MOPED	M OW P T
MOPED(2)	M OW P EH D
MOPEDS	M OW P EH D Z
MOPER	M AA P ER
MOPERIES	M AA P AH R IY Z
MOPERS	M AA P ER Z
MOPERY	M AA P AH R IY
MOPES	M OW P S
MOPEY	M OW P IY
MOPPED	M AA P T
MOPPER	M AA P ER
MOPPERS	M AA P ER Z
MOPPET	M AA P EH T
MOPPETS	M AA P EH T S
MOUSETRAPPED	M AW S T R AE P T
MUCOPEPTIDE	M Y UW K AA P AH P T AY D
MUCOPEPTIDES	M Y UW K AA P AH P T AY D Z
MUDCAPPED	M AH D K AE P T
MUDSKIPPER	M AH D S K IH P ER
MUDSKIPPERS	M AH D S K IH P ER Z
MULTIHANDICAPPED	M AH L T AY HH AE N D IH K AE P T
MULTIPED	M AH L T AY P EH D
MULTIPEDS	M AH L T AY P EH D Z
MULTISPECIES	M AH L T AY S P IY SH IY Z
MULTISPECTRAL	M AH L T AY S P EH K T R AH L
MULTISPEED	M AH L T AY S P IY D
MUMPED	M AH M P EH D
MUMPER	M AH M P ER
MUMPERS	M AH M P AH R Z
MYOPE	M AY OW P
MYOPES	M AY OW P S
MYOSCOPE	M AY AH S OW P
MYOSCOPES	M AY AH S OW P S
NAPE	N EY P
NAPERIES	N AE P AH R IY Z
NAPERY	N AE P AH R IY
NAPES	N EY P S
NAPPE	N AE P
NAPPED	N AE P T
NAPPER	N AE P ER
NAPPERS	N AE P ER Z
NAPPES	N AE P S
NEOTYPE	N IY OW T AY P
NEOTYPES	N IY OW T AY P S
NEPENTHE	N EH P EH N TH IY
NEPENTHEAN	N AH P EH N DH IY AH N
NEPENTHES	N EH P AH N DH Z
NEPHOSCOPE	N EH F AH S OW P
NEPHOSCOPES	N EH F AH S OW P S
NEUROPEPTIDE	N Y AH R AA P AH P T AY D
NEUROPEPTIDES	N Y AH R AA P AH P T AY D Z
NEWSPAPER	N UW Z P EY P ER
NEWSPAPERED	N UW Z P EY P ER D
NEWSPAPERING	N UW Z P EY P ER IH NG
NEWSPAPERMAN	N UW Z P EY P ER M AE N
NEWSPAPERMEN	N UW Z P AE P ER M AH N
NEWSPAPERS	N UW Z P EY P ER Z
NEWSPAPERWOMAN	N UW Z P EY P ER W UH M AH N
NEWSPAPERWOMEN	N UW Z P EY P ER W IH M AH N
NEWSPEAK	N UW S P IY K
NEWSPEAKS	N UW S P IY K S
NEWSPEOPLE	N UW Z P IY P AH L
NEWSPERSON	N UW Z P ER S AH N
NEWSPERSONS	N UW Z P ER S AH N Z
NIGHTSCOPE	N AY T S K OW P
NIGHTSCOPES	N AY T S K OW P S
NINCOMPOOPERIES	N IH NG K AH M P UW P AH R AY Z
NINCOMPOOPERY	N IH NG K AA M P AH P EH R IY
NIPPED	N IH P T
NIPPER	N IH P ER
NIPPERS	N IH P ER Z
NONAPPEARANCE	N AA N AH P IH ER AH N S
NONAPPEARANCES	N AA N AH P IH ER AH N S IH Z
NONCOMPETITION	N AA N K AA M P AH T IH SH AH N
NONCOMPETITIVE	N AA N K AH M P EH T AH T IH V
NONCOMPETITOR	N AA N K AH M P EH T AH T ER
NONCOMPETITORS	N AA N K AH M P EH T AH T ER Z
NONCOOPERATION	N AA N K OW AA P ER EY SH AH N
NONCOOPERATIONIST	N AA N K OW AA P ER EY SH AH N IH S T
NONCOOPERATIONISTS	N AA N K OW AA P ER EY SH AH N IH S T S
NONCOOPERATIONS	N AA N K OW AA P ER EY SH AH N Z
NONCOOPERATIVE	N AA N K OW AA P ER AH T IH V
NONCOOPERATOR	N AA N K OW AA P ER AH T ER
NONCOOPERATORS	N AA N K OW AA P ER AH T ER Z
NONDEPENDENT	N AA N D IY P EH N D EH N T
NONDEPENDENTS	N AA N D IY P EH N D EH N T S
NONDISPERSIVE	N AA N D IH S P ER S IH V
NONEXPENDABLE	N AA N IH K S P EH N D AH B AH L
NONEXPERIMENTAL	N AA N IH K S P EH R AH M EH N T AH L
NONEXPERT	N AA N EH K S P ER T
NONEXPERTS	N AA N EH K S P ER T S
NONHANDICAPPED	N AA N HH AE N D IH K AE P T
NONHAPPENING	N AA N HH AE P AH N IH NG
NONHAPPENINGS	N AA N HH AE P AH N IH NG Z
NONINDEPENDENCE	N AA N IH N D IH P EH N D AH N S
NONINDEPENDENCES	N AA N IH N D IH P EH N D AH N S IH Z
NONOPERATIC	N AA N AA P AH R AE T IH K
NONOPERATING	N AA N AO P ER EY T IH NG
NONOPERATIONAL	N AA N AA P ER EY SH AH N AH L
NONOPERATIVE	N AA N AA P ER AH T IH V
NONPEAK	N AA N P IY K
NONPERFORMANCE	N AA N P ER F AO R M AH N S
NONPERFORMANCES	N AA N P ER F AO R M AH N S IH Z
NONPERFORMER	N AA N P ER F AO R M ER
NONPERFORMERS	N AA N P ER F AO R M ER Z
NONPERFORMING	N AA N P ER F AO R M IH NG
NONPERISHABLE	N AA N P EH R IH SH AH B AH L
NONPERISHABLES	N AA N P EH R IH SH AH B AH L Z
NONPERMISSIVE	N AA N P ER M IH S IH V
NONPERSISTENT	N AA N P ER S IH S T AH N T
NONPERSON	N AA N P ER S AH N
NONPERSONAL	N AA N P ER S AH N AH L
NONPERSONS	N AA N P ER S AH N Z
NONPETROLEUM	N AA N P AH T R OW L IY AH M
NONPETROLEUMS	N AA N P AH T R OW L IY AH M Z
NONSPEAKER	N AA N S P IY K ER
NONSPEAKERS	N AA N S P IY K ER Z
NONSPEAKING	N AA N S P IY K IH NG
NONSPECIALIST	N AA N S P EH SH AH L IH S T
NONSPECIALISTS	N AA N S P EH SH AH L IH S T S
NONSPECIFIC	N AA N S P AH S IH F IH K
NONSPECIFICALLY	N AA N S P IH S IH F IH K AH L IY
NONSPECTACULAR	N AA N S P EH K T AE K Y AH L ER
NONSPECULATIVE	N AA N S P EH K Y AH L AH T IH V
NONSPEECH	N AA N S P IY CH
NONSUPERIMPOSABLE	N AA N S UW P ER IH M P OW Z AH B AH L
NONSUPERVISORY	N AA N S UW P ER V AY Z AH R IY
NONTHERAPEUTIC	N AA N TH EH R AH P Y UW T IH K
NOPE	N OW P
NOTEPAPER	N OW T P EY P ER
NOTEPAPERS	N OW T P EY P ER Z
OBSTREPEROUS	AH B S T R EH P ER AH S
OBSTREPEROUSLY	AA B S T R AH P EH R OW AH S L IY
OBSTREPEROUSNESS	AA B S T R EH P AH R AW Z N AH S
OBSTREPEROUSNESSES	AA B S T R EH P AH R AW Z N EH S AH Z
OCTAPEPTIDE	AA K T AE P AH P T AY D
OCTAPEPTIDES	AA K T AE P AH P T AY D Z
OEDIPEAN	OW AH D AY P IY AH N
OILPAPER	OY L P EY P ER
OILPAPERS	OY L P EY P ER Z
OMNICOMPETENCE	AA M N AH K AA M P AH T AH N S
OMNICOMPETENCES	AA M N AH K AA M P AH T EH N S AH Z
OMNICOMPETENT	AA M N AH K AA M P AH T AH N T
OOSPERM	UW S AH R M
OOSPERMS	UW S AH R M Z
OPE	OW P
OPED	OW P T
OPEN	OW P AH N
OPENABILITIES	OW P AH N AH B IH L AH T EH Z
OPENABILITY	OW P AH N AH B IH L AH T EH
OPENABLE	OW P AH N AH B AH L
OPENCAST	OW P AH N K AE S T
OPENED	OW P AH N D
OPENER	OW P AH N ER
OPENERS	OW P AH N ER Z
OPENEST	OW P AH N AH S T
OPENHANDED	OW P AH N HH AE N D IH D
OPENHANDEDLY	OW P AH N HH AE N D AH D L IY
OPENHANDEDNESS	OW P AH N HH AE N D AH D N AH S
OPENHANDEDNESSES	OW P AH N HH AE N D AH D N AH S IH Z
OPENHEARTED	OW P AH N HH AA R T IH D
OPENHEARTEDLY	OW P AH N HH AA R T AH D L IY
OPENHEARTEDNESS	OW P AH N HH AA R T AH D N AH S
OPENHEARTEDNESSES	OW P AH N HH AA R T AH D N AH S IH Z
OPENING	OW P AH N IH NG
OPENINGS	OW P AH N IH NG Z
OPENLY	OW P AH N L IY
OPENMOUTHED	OW P AH N M AW TH T
OPENMOUTHEDLY	OW P AH N M AW TH AH D L IY
OPENMOUTHEDNESS	OW P AH N M AW TH AH D N AH S
OPENMOUTHEDNESSES	OW P AH N M AW TH AH D N AH S IH Z
OPENNESS	OW P AH N N AH S
OPENNESS(2)	OW P AH N AH S
OPENNESSES	OW P AH N AH S IH Z
OPENS	OW P AH N Z
OPENWORK	OW P AH N W ER K
OPENWORKS	OW P AH N W ER K S
OPERA	AA P R AH
OPERABILITIES	AA P ER AH B IH L AH T EH Z
OPERABILITY	AA P ER AH B IH L AH T EH
OPERABLE	AA P ER AH B AH L
OPERABLY	AA P ER AH B L IY
OPERAGOER	AA P R AH G OW ER
OPERAGOERS	AA P R AH G OW ER Z
OPERAGOING	AA P R AH G OW IH NG
OPERAGOINGS	AA P R AH G OW IH NG Z
OPERAND	AA P AH R AH N D
OPERANDS	AA P AH R AH N D Z
OPERANT	AA P ER AH N T
OPERANTLY	AA P ER AH N T L IY
OPERANTS	AA P ER AH N T S
OPERAS	AA P R AH Z
OPERATE	AA P ER EY T
OPERATE(2)	AO P ER EY T
OPERATED	AA P ER EY T AH D
OPERATES	AA P ER EY T S
OPERATIC	AA P ER AE T IH K
OPERATICALLY	AA P AH R AE T IH K AH L IY
OPERATICS	AA P AH R AE T IH K S
OPERATING	AA P ER EY T IH NG
OPERATING(2)	AO P ER EY T IH NG
OPERATION	AA P ER EY SH AH N
OPERATIONAL	AA P ER EY SH AH N AH L
OPERATIONALISM	AA P ER EY SH AH N AH L IH Z AH M
OPERATIONALISMS	AA P ER EY SH AH N AH L IH Z AH M Z
OPERATIONALIST	AA P ER EY SH AH N AH L IH S T
OPERATIONALISTIC	AA P ER EY SH AH N AH L IH S T IH K
OPERATIONALISTS	AA P ER EY SH AH N AH L IH S T S
OPERATIONALLY	AA P ER EY SH AH N AH L IY
OPERATIONALLY(2)	AA P ER EY SH N AH L IY
OPERATIONISM	AA P ER EY SH AH N IH Z AH M
OPERATIONISMS	AA P ER EY SH AH N IH Z AH M Z
OPERATIONIST	AA P ER EY SH AH N IH S T
OPERATIONISTS	AA P ER EY SH AH N IH S T S
OPERATIONS	AA P ER EY SH AH N Z
OPERATIVE	AA P ER AH T IH V
OPERATIVELY	AA P ER AH T IH V L IY
OPERATIVENESS	AA P ER AH T IH V N AH S
OPERATIVENESSES	AA P ER AH T IH V N AH S IH Z
OPERATIVES	AA P ER AH T IH V Z
OPERATOR	AA P ER EY T ER
OPERATORLESS	AA P ER AH T ER L AH S
OPERATORS	AA P ER EY T ER Z
OPERATORS(2)	AO P ER EY T ER Z
OPERCELE	AA P AH R S IY L
OPERCELES	AA P AH R S IY L Z
OPERCULA	AA P AH R K Y UW L AH
OPERCULAR	AH P AH R K Y AH L AH R
OPERCULARS	AA P AH R K Y UW L AH R Z
OPERCULATE	AH P AH R K Y AH L EY T
OPERCULATED	AH P AH R K Y AH L EY T AH D
OPERCULE	AA P AH R K Y UW L
OPERCULES	AA P AH R K Y UW L Z
OPERCULUM	AA P AH R K Y UW L AH M
OPERCULUMS	AA P AH R K Y UW L AH M Z
OPERETTA	AA P ER EH T AH
OPERETTAS	AA P ER EH T AH Z
OPERETTIST	AA P ER EH T IH S T
OPERETTISTS	AA P ER EH T IH S T S
OPERON	AA P AH R AH N
OPERONS	AA P AH R AH N Z
OPEROSE	AA P AH R OW Z
OPEROSELY	AA P AH R OW Z L IY
OPEROSENESS	AA P AH R OW Z N AH S
OPEROSENESSES	AA P AH R AA S AH N EH S AH Z
OPES	OW P S
OPHTHALMOSCOPE	AA F TH AE L M AH S K OW P
OPHTHALMOSCOPES	AA F TH AE L M AH S OW P S
ORTHOPEDIC	AO R TH AH P IY D IH K
ORTHOPEDICALLY	AO R TH AH P IY D IH K AH L IY
ORTHOPEDICS	AO R TH AH P IY D IH K S
ORTHOPEDIST	AO R TH AH P IY D AH S T
ORTHOPEDISTS	AO R TH AH P IY D AH S T S
OSCILLOSCOPE	AO S IH L AH S K OW P
OSCILLOSCOPES	AO S IH L AH S K OW P S
OTOSCOPE	AA T AH S OW P
OTOSCOPES	AA T AH S OW P S
OUTCAPER	AW T K EY P ER
OUTCAPERED	AW T K EY P ER D
OUTCAPERING	AW T K EY P ER IH NG
OUTCAPERS	AW T K EY P ER Z
OUTCOMPETE	AW T K AH M P IY T
OUTCOMPETED	AW T K AH M P IY T IH D
OUTCOMPETES	AW T K AH M P IY T S
OUTCOMPETING	AW T K AH M P IY T IH NG
OUTCROPPED	AW T K R AA P T
OUTDROPPED	AW T D R AA P T
OUTJUMPED	AW T JH AH M P T
OUTLEAPED	AW T L IY P T
OUTPERFORM	AW T P ER F AO R M
OUTPERFORMED	AW T P ER F AO R M D
OUTPERFORMING	AW T P ER F AO R M IH NG
OUTPERFORMS	AW T P ER F AO R M Z
OUTSCOOPED	AW T S K UW P T
OUTSPEAK	AW T S P IY K
OUTSPEAKING	AW T S P IY K IH NG
OUTSPEAKS	AW T S P IY K S
OUTSPED	AW T S P EH D
OUTSPEED	AW T S P IY D
OUTSPEEDED	AW T S P IY D IH D
OUTSPEEDING	AW T S P IY D IH NG
OUTSPEEDS	AW T S P IY D Z
OUTSPELL	AW T S P EH L
OUTSPELLED	AW T S P EH L D
OUTSPELLING	AW T S P EH L IH NG
OUTSPELLS	AW T S P EH L Z
OUTSPELT	AW T S P EH L T
OUTSPEND	AW T S P EH N D
OUTSPENDING	AW T S P EH N D IH NG
OUTSPENDS	AW T S P EH N D Z
OUTSPENT	AW T S P EH N T
OUTSTRIPPED	AW T S T R IH P T
OUTTRUMPED	AW T R AH M P T
OUTYELPED	AW T Y EH L P T
OVERCOMPENSATE	OW V ER K AA M P AH N S EY T
OVERCOMPENSATED	OW V ER K AA M P AH N S EY T IH D
OVERCOMPENSATES	OW V ER K AA M P AH N S EY T S
OVERCOMPENSATING	OW V ER K AA M P AH N S EY T IH NG
OVERCOMPENSATION	OW V ER K AA M P AH N S EY SH AH N
OVERCOMPENSATIONS	OW V ER K AA M P AH N S EY SH AH N Z
OVERCOMPENSATORY	OW V ER K AA M P AH N S EY T ER IY
OVERCROPPED	OW V ER K R AA P T
OVERDEPENDENCE	OW V ER D IH P EH N D AH N S
OVERDEPENDENCES	OW V ER D IH P EH N D AH N S IH Z
OVERDEPENDENT	OW V ER D IH P EH N D AH N T
OVERDEVELOPED	OW V ER D IH V EH L AH P T
OVEREQUIPPED	OW V ER IH K W IH P T
OVEREXPECTATION	OW V ER IH K S P EH K T EY SH AH N
OVEREXPECTATIONS	OW V ER IH K S P EH K T EY SH AH N Z
OVERHEAPED	OW V ER HH IY P T
OVERHOPE	OW V ER HH OW P
OVERHOPED	OW V ER HH OW P T
OVERHOPES	OW V ER HH OW P S
OVERHYPE	AA V AH R AY P
OVERHYPED	AA V AH R AY P T
OVERHYPES	AA V AH R AY P S
OVERLAPPED	OW V ER L AE P T
OVERLEAPED	OW V ER L IY P T
OVEROPERATE	OW V ER AA P ER AH T
OVEROPERATED	OW V ER AA P ER EY T IH D
OVEROPERATES	OW V ER AA P ER AH T S
OVEROPERATING	OW V ER AA P ER EY T IH NG
OVERPEDAL	OW V ER P EH D AH L
OVERPEDALED	OW V ER P EH D AH L D
OVERPEDALING	OW V ER P EH D AH L IH NG
OVERPEDALLED	OW V ER P EH D AH L D
OVERPEDALLING	OW V ER P EH D AH L IH NG
OVERPEDALS	OW V ER P EH D AH L Z
OVERPEOPLE	OW V ER P IY P AH L
OVERPEOPLED	OW V ER P IY P AH L D
OVERPEOPLES	OW V ER P IY P AH L Z
OVERPEOPLING	OW V ER P IY P AH L IH NG
OVERPERSUADE	OW V ER P ER S W EY D
OVERPERSUADED	OW V ER P ER S W EY D IH D
OVERPERSUADES	OW V ER P ER S W EY D Z
OVERPERSUADING	OW V ER P ER S W EY D IH NG
OVERPERSUASION	OW V ER P ER S W EY ZH AH N
OVERPERSUASIONS	OW V ER P ER S W EY ZH AH N Z
OVERPERT	OW V ER P ER T
OVERPUMPED	OW V ER P AH M P T
OVERRIPE	OW V ER R AY P
OVERSLIPPED	OW V ER S L IH P T
OVERSPECIALIZATION	OW V ER S P EH SH AH L AH Z EY SH AH N
OVERSPECIALIZATIONS	OW V ER S P EH SH AH L AH Z EY SH AH N Z
OVERSPECIALIZE	OW V ER S P EH SH AH L AY Z
OVERSPECIALIZED	OW V ER S P EH SH AH L AY Z D
OVERSPECIALIZES	OW V ER S P EH SH AH L AY Z IH Z
OVERSPECIALIZING	OW V ER S P EH SH AH L AY Z IH NG
OVERSPECULATE	OW V ER S P EH K Y AH L AH T
OVERSPECULATED	OW V ER S P EH K Y AH L EY T IH D
OVERSPECULATES	OW V ER S P EH K Y AH L AH T S
OVERSPECULATING	OW V ER S P EH K Y AH L EY T IH NG
OVERSPECULATION	OW V ER S P EH K Y AH L EY SH AH N
OVERSPECULATIONS	OW V ER S P EH K Y AH L EY SH AH N Z
OVERSPEND	OW V ER S P EH N D
OVERSPENDER	OW V ER S P EH N D ER
OVERSPENDERS	OW V ER S P EH N D ER Z
OVERSPENDING	OW V ER S P EH N D IH NG
OVERSPENDS	OW V ER S P EH N D Z
OVERSPENT	OW V ER S P EH N T
OVERSTEPPED	OW V ER S T EH P T
OVERSUPPED	OW V ER S AH P T
OVERTIPPED	OW V ER T IH P T
OVERTOPPED	OW V ER T AA P T
OVERTRUMPED	OW V ER T R AH M P T
OXPECKER	AA K S P EH K ER
OXPECKERS	AA K S P EH K ER Z
PALPEBRA	P AE L P EH B R AH
PALPEBRAE	P AE L P EH B R IY
PALPEBRAL	P AE L P EH B R AH L
PALPEBRAS	P AE L P EH B R AH Z
PAMPEAN	P AE M P IY AH N
PAMPEANS	P AE M P IY N Z
PAMPER	P AE M P ER
PAMPERED	P AE M P ER D
PAMPERER	P AE M P ER ER
PAMPERERS	P AE M P ER ER Z
PAMPERING	P AE M P ER IH NG
PAMPERO	P AE M P AH R OW
PAMPEROS	P AE M P ER AA S
PAMPERS	P AE M P ER Z
PANCYTOPENIA	P AE N S AH T AH P IY N Y AH
PANCYTOPENIAS	P AE N S AH T AH P IY N Y AH Z
PANLEUKOPENIA	P AE N L UW K AH P IY N Y AH
PANLEUKOPENIAS	P AE N L UW K AH P IY N Y AH Z
PANPIPE	P AE N P AY P
PANPIPES	P AE N P AY P S
PAPER	P EY P ER
PAPERBACK	P EY P ER B AE K
PAPERBACKED	P EY P ER B AE K T
PAPERBACKS	P EY P ER B AE K S
PAPERBOARD	P EY P ER B AO R D
PAPERBOARDS	P EY P ER B OW R D Z
PAPERBOUND	P EY P ER B AW N D
PAPERBOUNDS	P EY P ER B AW N D Z
PAPERBOY	P EY P ER B OY
PAPERBOYS	P EY P ER B OY Z
PAPERED	P EY P ER D
PAPERER	P EY P ER ER
PAPERERS	P EY P ER ER Z
PAPERGIRL	P EY P ER G ER L
PAPERGIRLS	P EY P ER G ER L Z
PAPERHANGER	P EY P ER HH AE NG ER
PAPERHANGERS	P EY P ER HH AE NG ER Z
PAPERHANGING	P EY P ER HH AE NG IH NG
PAPERHANGINGS	P EY P ER HH AE NG IH NG Z
PAPERINESS	P AE P AH R IY N AH S
PAPERINESSES	P AE P AH R IY N AH S IH Z
PAPERING	P EY P ER IH NG
PAPERLESS	P EY P ER L AH S
PAPERMAKER	P EY P ER M EY K ER
PAPERMAKERS	P EY P ER M EY K ER Z
PAPERMAKING	P AE P ER M EY K IH NG
PAPERMAKINGS	P EY P ER M EY K IH NG Z
PAPERS	P EY P ER Z
PAPERWEIGHT	P EY P ER W EY T
PAPERWEIGHTS	P EY P ER W EY T S
PAPERWORK	P EY P ER W ER K
PAPERWORKS	P EY P ER W ER K S
PAPERY	P EY P ER IY
PAPETERIE	P AE P AH T IY R AY
PAPETERIES	P AH P EH T AH R AY Z
PARADROPPED	P AA R AH D R AA P T
PARALLELEPIPED	P AH R AE L EH L AH P AY P T
PARALLELEPIPEDS	P AH R AE L AH L EH P AH P AH D Z
PARAPET	P EH R AH P EH T
PARAPETED	P AE R AH P AH T IH D
PARAPETS	P AE R AH P AH T S
PARATROOPER	P EH R AH T R UW P ER
PARATROOPERS	P EH R AH T R UW P ER Z
PAUPER	P AO P ER
PAUPERED	P AO P ER D
PAUPERING	P AO P ER IH NG
PAUPERISM	P AO P ER IH Z AH M
PAUPERISMS	P AO P ER IH Z AH M Z
PAUPERIZE	P AO P ER AY Z
PAUPERIZED	P AO P ER AY Z D
PAUPERIZES	P AO P ER AY Z IH Z
PAUPERIZING	P AO P ER AY Z IH NG
PAUPERS	P AO P ER Z
PE	P IY
PEA	P IY
PEACE	P IY S
PEACEABLE	P IY S AH B AH L
PEACEABLENESS	P IY S AH B AH L N AH S
PEACEABLENESSES	P IY S AH B AH L N AH S IH Z
PEACEABLY	P IY S AH B L IY
PEACED	P IY S T
PEACEFUL	P IY S F AH L
PEACEFULLER	P IY S F AH L ER
PEACEFULLEST	P IY S F AH L AH S T
PEACEFULLY	P IY S F AH L IY
PEACEFULNESS	P IY S F AH L N AH S
PEACEFULNESSES	P IY S F AH L N AH S IH Z
PEACEKEEPER	P IY S K IY P ER
PEACEKEEPERS	P IY S K IY P ER Z
PEACEKEEPING	P IY S K IY P IH NG
PEACEKEEPINGS	P IY S K IY P IH NG Z
PEACEMAKER	P IY S M EY K ER
PEACEMAKERS	P IY S M EY K ER Z
PEACEMAKING	P IY S M EY K IH NG
PEACEMAKINGS	P IY S M EY K IH NG Z
PEACENIK	P IY S N IH K
PEACENIKS	P IY S AH N AH K S
PEACES	P IY S IH Z
PEACETIME	P IY S T AY M
PEACETIMES	P IY S T AY M Z
PEACH	P IY CH
PEACHED	P IY CH T
PEACHER	P IY CH ER
PEACHERS	P IY CH ER Z
PEACHES	P IY CH AH Z
PEACHES(2)	P IY CH IH Z
PEACHIER	P IY CH IY ER
PEACHIEST	P IY CH IY AH S T
PEACHING	P IY CH IH NG
PEACHY	P IY CH IY
PEACING	P IY S IH NG
PEACOAT	P IY K OW T
PEACOATS	P IY K OW T S
PEACOCK	P IY K AA K
PEACOCKED	P IY K AA K T
PEACOCKIER	P IY K AA K IY ER
PEACOCKIEST	P IY K AA K IY AH S T
PEACOCKING	P IY K AA K IH NG
PEACOCKISH	P IY K AA K IH SH
PEACOCKS	P IY K AA K S
PEACOCKY	P IY K AA K IY
PEAFOWL	P IY F AW L
PEAFOWLS	P IY F AW L Z
PEAG	P IY G
PEAGE	P IY AH JH
PEAGES	P IY AH JH AH Z
PEAGS	P IY AH JH Z
PEAHEN	P IY HH EH N
PEAHENS	P IY HH EH N Z
PEAK	P IY K
PEAKED	P IY K T
PEAKEDNESS	P IY K AH D N AH S
PEAKEDNESSES	P IY K AH D N AH S IH Z
PEAKIER	P IY K IY ER
PEAKIEST	P IY K IY AH S T
PEAKING	P IY K IH NG
PEAKISH	P IY K IH SH
PEAKLESS	P IY K L AH S
PEAKLIKE	P IY K L AY K
PEAKS	P IY K S
PEAKY	P IY K IY
PEAL	P IY L
PEALED	P IY L D
PEALIKE	P IY L AY K
PEALING	P IY L IH NG
PEALS	P IY L Z
PEAN	P IY AH N
PEANS	P IY N Z
PEANUT	P IY N AH T
PEANUTS	P IY N AH T S
PEAR	P EH R
PEARL	P ER L
PEARLASH	P AE ER L AE SH
PEARLASHES	P AE ER L AE SH IH Z
PEARLED	P ER L D
PEARLER	P ER L ER
PEARLERS	P ER L ER Z
PEARLESCENCE	P AH R L EH S AH N S
PEARLESCENCES	P AH R L AH S EH N S AH Z
PEARLESCENT	P AH R L EH S AH N T
PEARLIER	P ER L IY ER
PEARLIEST	P ER L IY AH S T
PEARLING	P ER L IH NG
PEARLITE	P AH R L AY T
PEARLITES	P AH R L AY T S
PEARLITIC	P AE ER L IH T IH K
PEARLIZED	P ER L AY Z D
PEARLS	P ER L Z
PEARLY	P ER L IY
PEARMAIN	P AE ER M EY N
PEARMAINS	P AE ER M EY N Z
PEARS	P EH R Z
PEART	P ER T
PEARTER	P AH R T AH R
PEARTEST	P AE ER T EH S T
PEARTLY	P AH R T L IY
PEAS	P IY Z
PEASANT	P EH Z AH N T
PEASANTRIES	P EH Z AH N T R IY Z
PEASANTRY	P EH Z AH N T R IY
PEASANTS	P EH Z AH N T S
PEASCOD	P IY Z K AA D
PEASCODS	P IY Z K AA D Z
PEASE	P IY Z
PEASE(2)	P IY S
PEASECOD	P IY S AH K AH D
PEASECODS	P IY S AH K AH D Z
PEASEN	P IY S EH N
PEASES	P IY Z IH Z
PEASHOOTER	P IY SH UW T ER
PEASHOOTERS	P IY SH UW T ER Z
PEAT	P IY T
PEATIER	P IY T IH ER
PEATIEST	P IY T AY AH S T
PEATS	P IY EY T S
PEATY	P IY T IY
PEAVEY	P IY V IY
PEAVEYS	P IY V EY Z
PEAVIES	P IY V AY Z
PEAVY	P IY V IY
PEBBLE	P EH B AH L
PEBBLED	P EH B AH L D
PEBBLES	P EH B AH L Z
PEBBLIER	P EH B AH L IY ER
PEBBLIEST	P EH B AH L IY AH S T
PEBBLING	P EH B AH L IH NG
PEBBLY	P EH B AH L IY
PEC	P EH K
PECAN	P AH K AA N
PECAN(2)	P IY K AA N
PECAN(3)	P IH K AE N
PECANS	P IH K AE N Z
PECANS(2)	P IY K AA N Z
PECANS(3)	P AH K AA N Z
PECCABLE	P EH K AH B AH L
PECCADILLO	P EH K AH D IH L OW
PECCADILLOES	P EH K AH D IH L OW Z
PECCADILLOS	P EH K AH D IH L OW Z
PECCANCIES	P EH K AH N S IY Z
PECCANCY	P EH K AH N S IY
PECCANT	P EH K AH N T
PECCANTLY	P EH K AH N T L IY
PECCARIES	P EH K EH R IY Z
PECCARY	P EH K EH R IY
PECCAVI	P AH K AA W IY
PECCAVIS	P AH K AA W IY Z
PECH	P EH K
PECHAN	P EH CH AH N
PECHANS	P EH CH AH N Z
PECHED	P EH CH T
PECHING	P EH CH AH NG
PECHS	P EH CH S
PECK	P EH K
PECKED	P EH K T
PECKER	P EH K ER
PECKERS	P EH K ER Z
PECKERWOOD	P EH K ER W UH D
PECKERWOODS	P EH K ER W UH D Z
PECKIER	P EH K IY ER
PECKIEST	P EH K IY AH S T
PECKING	P EH K IH NG
PECKISH	P EH K IH SH
PECKS	P EH K S
PECKY	P EH K IY
PECORINI	P AH K AO R AH N IY
PECORINO	P AH K AO R AH N OW
PECORINOS	P AH K AO R AH N AH Z
PECS	P EH K S
PECTASE	P EH K T EY Z
PECTASES	P EH K T EY Z AH Z
PECTATE	P EH K T EY T
PECTATES	P EH K T EY T S
PECTEN	P EH K T AH N
PECTENS	P EH K T AH N Z
PECTIC	P EH K T IH K
PECTIN	P EH K T AH N
PECTIN(2)	P EH K T IH N
PECTINACEOUS	P EH K T AH N AH S IY AH S
PECTINATE	P EH K T AH N EY T
PECTINATION	P EH K T AH N EY SH AH N
PECTINATIONS	P EH K T AH N EY T IY AH N Z
PECTINES	P EH K T AY N Z
PECTINESTERASE	P EH K T AH N EH S T AH R EY Z
PECTINESTERASES	P EH K T AH N EH S T AH R EY Z AH Z
PECTINS	P EH K T AH N Z
PECTIZE	P EH K T AY Z
PECTIZED	P EH K T AY Z D
PECTIZES	P EH K T AY Z AH Z
PECTIZING	P EH K T AY Z AH NG
PECTORAL	P EH K T ER AH L
PECTORALS	P EH K T AH R AH L Z
PECULATE	P IY K Y AH L EY T
PECULATED	P IY K Y AH L EY T AH D
PECULATES	P IY K Y AH L EY T S
PECULATING	P IY K Y AH L EY T AH NG
PECULATION	P IY K Y AH L EY SH AH N
PECULATIONS	P EH K Y AH L EY T IY AH N Z
PECULATOR	P IY K Y AH L EY T AH R
PECULATORS	P EH K Y UW L AH T AH R Z
PECULIA	P EH K Y UW L Y AH
PECULIAR	P AH K Y UW L Y ER
PECULIAR(2)	P IH K Y UW L Y ER
PECULIARITIES	P IH K Y UW L IY EH R AH T IY Z
PECULIARITY	P IH K Y UW L IY EH R AH T IY
PECULIARLY	P IH K Y UW L Y ER L IY
PECULIARS	P IH K Y UW L Y ER Z
PECULIUM	P EH K Y UW L IY AH M
PECUNIARILY	P EH K Y AH N IY AE R AH L IY
PECUNIARY	P EH K Y UW N IY EH R IY
PED	P EH D
PEDAGOG	P EH D AH G AH G
PEDAGOGIC	P EH D AH G AA JH IH K
PEDAGOGICAL	P EH D AH G AA JH IH K AH L
PEDAGOGICALLY	P EH D AH G AA JH IH K AH L IY
PEDAGOGICS	P EH D AH G AA JH IH K S
PEDAGOGIES	P AH D AE G AH JH AY Z
PEDAGOGS	P EH D AH G AH G Z
PEDAGOGUE	P EH D AH G AA G
PEDAGOGUES	P EH D AH G AA G Z
PEDAGOGY	P EH D AH G OW JH IY
PEDAL	P EH D AH L
PEDALED	P EH D AH L D
PEDALFER	P AH D AE L F AH R
PEDALFERS	P AH D AE L F AH R Z
PEDALIER	P EH D AH L IY ER
PEDALIERS	P EH D AH L IY ER Z
PEDALING	P EH D AH L IH NG
PEDALING(2)	P EH D L IH NG
PEDALLED	P EH D AH L D
PEDALLING	P EH D AH L IH NG
PEDALO	P EH D AH L OW
PEDALOS	P EH D AH L AA S
PEDALS	P EH D AH L Z
PEDANT	P EH D AH N T
PEDANTIC	P AH D AE N T IH K
PEDANTICALLY	P AH D AE N T IH K AH L IY
PEDANTRIES	P EH D AH N T R IY Z
PEDANTRY	P EH D AH N T R IY
PEDANTS	P EH D AH N T S
PEDATE	P EH D AH T
PEDATELY	P EH D AH T L IY
PEDDLE	P EH D AH L
PEDDLED	P EH D AH L D
PEDDLER	P EH D L ER
PEDDLERIES	P EH D AH L AH R IY Z
PEDDLERS	P EH D L ER Z
PEDDLERY	P EH D AH L AH R IY
PEDDLES	P EH D AH L Z
PEDDLING	P EH D AH L IH NG
PEDDLING(2)	P EH D L IH NG
PEDERAST	P EH D AH R AH S T
PEDERASTIC	P EH D AH R AH S T AH K
PEDERASTIES	P EH D IH R AH Z T AY Z
PEDERASTS	P EH D AH R AH S T S
PEDERASTY	P EH D AH R AE S T IY
PEDES	P IY D Z
PEDESTAL	P EH D AH S T AH L
PEDESTALED	P EH D AH S T AH L D
PEDESTALING	P EH D AH S T AH L IH NG
PEDESTALLED	P EH D AH S T AH L D
PEDESTALLING	P EH D AH S T AH L IH NG
PEDESTALS	P EH D AH S T AH L Z
PEDESTRIAN	P AH D EH S T R IY AH N
PEDESTRIANISM	P AH D EH S T R IY AH N IH Z AH M
PEDESTRIANISMS	P AH D EH S T R IY AH N IH Z AH M Z
PEDESTRIANS	P AH D EH S T R IY AH N Z
PEDIATRIC	P IY D IY AE T R IH K
PEDIATRICIAN	P IY D IY AH T R IH SH AH N
PEDIATRICIANS	P IY D IY AH T R IH SH AH N Z
PEDIATRICS	P IY D IY AE T R IH K S
PEDIATRIST	P IY D IY AE T R AH S T
PEDIATRISTS	P IY D IY AE T R AH S T S
PEDICAB	P EH D AH K AH B
PEDICABS	P EH D AH K AH B Z
PEDICEL	P EH D AH S AH L
PEDICELLATE	P AH D IH S AH L EY T
PEDICELS	P EH D AH S AH L Z
PEDICLE	P EH D AH K AH L
PEDICLED	P EH D IH K L EH D
PEDICLES	P EH D AH K AH L Z
PEDICULATE	P IY D IH S AH L EY T
PEDICULATES	P IY D IH S AH L EY T S
PEDICULOSES	P AH D IH K Y AH L OW Z AH Z
PEDICULOSIS	P IY D IH S AH L OW S AH S
PEDICULOUS	P IY D IH S AH L AH S
PEDICURE	P EH D IH K Y ER
PEDICURE(2)	P EH D IH K Y AO R
PEDICURED	P EH D IH K Y ER D
PEDICURES	P EH D IH K Y ER Z
PEDICURES(2)	P EH D IH K Y AO R Z
PEDICURING	P EH D IH K Y ER IH NG
PEDICURIST	P EH D IH K Y ER IH S T
PEDICURISTS	P EH D IH K Y ER IH S T S
PEDIFORM	P EH D AH F AH R M
PEDIGREE	P EH D AH G R IY
PEDIGREED	P AH D IH G R IY D
PEDIGREES	P EH D AH G R IY Z
PEDIMENT	P EH D IY M AH N T
PEDIMENTAL	P EH D IY M AH N T AH L
PEDIMENTED	P EH D IY M AH N T IH D
PEDIMENTS	P EH D IY M AH N T S
PEDIPALP	P EH D AH P AH L P
PEDIPALPS	P EH D AH P AH L P S
PEDLAR	P EH D L AH R
PEDLARIES	P EH D L AH R AY Z
PEDLARS	P EH D L AH R Z
PEDLARY	P EH D L AH R IY
PEDLER	P EH D L AH R
PEDLERIES	P EH D L AH R AY Z
PEDLERS	P EH D L AH R Z
PEDLERY	P EH D L AH R IY
PEDOCAL	P EH D AH K AH L
PEDOCALIC	P EH D AH K AH L AH K
PEDOCALS	P EH D AH K AH L Z
PEDOGENESES	P AH D AA JH AH N IY Z AH Z
PEDOGENESIS	P EH D AH JH IY N AH S AH S
PEDOGENETIC	P AH D AA JH AH N AH T AH K
PEDOGENIC	P EH D AH JH AH N AH K
PEDOLOGIC	P EH D AH L AH JH AH K
PEDOLOGICAL	P AH D AA L AH JH IH S AH L
PEDOLOGIES	P EH D AA L AH JH IY Z
PEDOLOGIST	P EH D AA L AH JH AH S T
PEDOLOGISTS	P EH D AA L AH JH AH S T S
PEDOLOGY	P EH D AA L AH JH IY
PEDOMETER	P IY D AA M AH T AH R
PEDOMETERS	P AH D AA M AH T AH R Z
PEDOPHILE	P EH D OW F AY L
PEDOPHILE(2)	P EH D AH F IH L
PEDOPHILES	P EH D OW F AY L Z
PEDOPHILES(2)	P EH D AH F IH L Z
PEDOPHILIA	P EH D AH F IH L Y AH
PEDOPHILIAC	P EH D AH F IH L Y AE K
PEDOPHILIAS	P EH D AH F IH L Y AH Z
PEDOPHILIC	P EH D OW F IH L IH K
PEDRO	P EY D R OW
PEDROS	P EY D R OW Z
PEDS	P EH D Z
PEDUNCLE	P EH D AH NG K AH L
PEDUNCLED	P EH D AH NG K AH L D
PEDUNCLES	P EH D AH NG K AH L Z
PEDUNCULAR	P AH D AH NG K Y AH L AH R
PEDUNCULATE	P AH D AH NG K Y AH L EY T
PEDUNCULATED	P AH D AH NG K Y AH L EY T AH D
PEE	P IY
PEEBEEN	P IY B IY AH N
PEEBEENS	P IY B IY AH N Z
PEED	P IY D
PEEING	P IY IH NG
PEEK	P IY K
PEEKABOO	P IY K AH B UW
PEEKABOOS	P IY K AH B UW Z
PEEKED	P IY K T
PEEKING	P IY K IH NG
PEEKS	P IY K S
PEEL	P IY L
PEELABLE	P IY L AH B AH L
PEELED	P IY L D
PEELER	P IY L ER
PEELERS	P IY L ER Z
PEELING	P IY L IH NG
PEELINGS	P IY L IH NG Z
PEELS	P IY L Z
PEEN	P IY AH N
PEENED	P IY N D
PEENING	P IY N AH NG
PEENS	P IY N Z
PEEP	P IY P
PEEPED	P IY P T
PEEPER	P IY P ER
PEEPERS	P IY P ER Z
PEEPHOLE	P IY P HH OW L
PEEPHOLES	P IY P HH OW L Z
PEEPING	P IY P IH NG
PEEPS	P IY P S
PEEPSHOW	P IY P SH OW
PEEPSHOWS	P IY P SH OW Z
PEEPUL	P IY P AH L
PEEPULS	P IY P Y AH L Z
PEER	P IH R
PEERAGE	P IH R AH JH
PEERAGES	P IH ER IH JH IH Z
PEERED	P IH R D
PEERESS	P IH ER AH S
PEERESSES	P IH ER AH S IH Z
PEERIE	P IH ER IY
PEERIES	P IY R IY Z
PEERING	P IY R IH NG
PEERLESS	P IH R L IH S
PEERLESSLY	P IH ER L AH S L IY
PEERS	P IH R Z
PEERY	P IY R IY
PEES	P IY Z
PEESWEEP	P IY S W IY P
PEESWEEPS	P IY S W IY P S
PEETWEET	P IY T W IY T
PEETWEETS	P IY T W IY T S
PEEVE	P IY V
PEEVED	P IY V D
PEEVES	P IY V Z
PEEVING	P IY V AH NG
PEEVISH	P IY V IH SH
PEEVISHLY	P IY V IH SH L IY
PEEVISHNESS	P IY V IH SH N AH S
PEEVISHNESSES	P IY V IH SH N EH S AH Z
PEEWEE	P IY W IY
PEEWEES	P IY W IY Z
PEEWIT	P IY W IH T
PEEWITS	P IY W IH T S
PEG	P EH G
PEGBOARD	P EH G B AO R D
PEGBOARDS	P EH G B AO R D Z
PEGBOX	P EH G B AA K S
PEGBOXES	P EH G B AA K S IH Z
PEGGED	P EH G D
PEGGING	P EH G IH NG
PEGLESS	P EH G L AH S
PEGLIKE	P EH G L AY K
PEGMATITE	P EH G M AH T AY T
PEGMATITES	P EH G M AH T AY T S
PEGMATITIC	P EH G M AH T AH T AH K
PEGS	P EH G Z
PEH	P IY
PEHS	P EH Z
PEIGNOIR	P EY G N OY R
PEIGNOIRS	P EY G N OY R Z
PEIN	P IY N
PEINED	P IY N D
PEINING	P IY N AH NG
PEINS	P IY N Z
PEISE	P IY Z
PEISED	P IY AH S T
PEISES	P IY Z AH Z
PEISING	P IY Z AH NG
PEJORATIVE	P AH JH AO R AH T IH V
PEJORATIVELY	P AH JH AO R AH T AY V L IY
PEJORATIVES	P EH JH AH R EY T AH V Z
PEKAN	P IY K AH N
PEKANS	P EH K AH N Z
PEKE	P IY K
PEKES	P IY K S
PEKIN	P IY K AH N
PEKINS	P EH K AH N Z
PEKOE	P EH K OW
PEKOES	P AH K OW Z
PELAGE	P IY L AH JH
PELAGES	P IY L AH JH AH Z
PELAGIAL	P IY L AH JH AH L
PELAGIC	P AH L AE JH IH K
PELARGONIUM	P EH L AH R G OW N IY AH M
PELARGONIUMS	P EH L AH R G OW N IY AH M Z
PELE	P EH L EY
PELECYPOD	P AH L EH S AH P AH D
PELECYPODS	P AH L EH S AH P AH D Z
PELERINE	P EH L AH R AY N
PELERINES	P EH L AH R AY N Z
PELES	P IY L Z
PELF	P EH L F
PELFS	P EH L F S
PELICAN	P EH L AH K AH N
PELICANS	P EH L IH K AH N Z
PELISSE	P EH L AH S
PELISSES	P AH L IH S AH Z
PELITE	P AH L AY T
PELITES	P AH L AY T S
PELITIC	P EH L AH T AH K
PELLAGRA	P AH L AE G R AH
PELLAGRAS	P AH L EY G R AH Z
PELLAGRIN	P EH L AE G R AH N
PELLAGRINS	P EH L AE G R AH N Z
PELLAGROUS	P EH L AE G R AH S
PELLET	P EH L AH T
PELLETAL	P EH L AH T AH L
PELLETED	P EH L AH T AH D
PELLETED(2)	P EH L AH T IH D
PELLETING	P EH L AH T IH NG
PELLETISE	P EH L AH T AY Z
PELLETISED	P EH L AH T IY Z D
PELLETISES	P EH L AH T IY Z IH Z
PELLETISING	P EH L AH T IY Z IH NG
PELLETIZATION	P EH L AH T AH Z EY SH AH N
PELLETIZATIONS	P EH L AH T AH Z EY SH AH N Z
PELLETIZE	P EH L AH T AY Z
PELLETIZED	P EH L AH T AY Z D
PELLETIZER	P EH L AH T AY Z ER
PELLETIZERS	P EH L AH T AY Z ER Z
PELLETIZES	P EH L AH T AY Z IH Z
PELLETIZING	P EH L AH T AY Z IH NG
PELLETS	P EH L AH T S
PELLICLE	P EH L AH K AH L
PELLICLES	P EH L AH K AH L Z
PELLITORIES	P EH L IH T AH R AY Z
PELLITORY	P EH L AH T AO R IY
PELLMELL	P EH L M AH L
PELLMELLS	P EH L M AH L Z
PELLUCID	P EH L UW S AH D
PELLUCIDLY	P EH L AH S IH D L IY
PELMET	P EH L M AH T
PELMETS	P EH L M AH T S
PELON	P EH L AH N
PELORIA	P AH L AO R IY AH
PELORIAN	P AH L AO R IY AH N
PELORIAS	P AH L AO R IY AH Z
PELORIC	P EH L AH R AH K
PELORUS	P EH L AH R AH S
PELORUSES	P EH L AH R UW Z AH Z
PELOTA	P EH L AH T AH
PELOTAS	P EH L AH T AH Z
PELT	P EH L T
PELTAST	P EH L T AH S T
PELTASTS	P EH L T AH S T S
PELTATE	P EH L T AH T
PELTED	P EH L T IH D
PELTER	P EH L T ER
PELTERED	P EH L T ER D
PELTERING	P EH L T ER IH NG
PELTERS	P EH L T ER Z
PELTING	P EH L T IH NG
PELTRIES	P EH L T R IY Z
PELTRY	P EH L T R IY
PELTS	P EH L T S
PELVES	P EH L V Z
PELVIC	P EH L V IH K
PELVICS	P EH L V IH K S
PELVIS	P EH L V AH S
PELVISES	P EH L V AH S IH Z
PELYCOSAUR	P AH L IH K AH S AH R
PELYCOSAURS	P AH L IH K AH S EY Y AH R Z
PEMBINA	P EH M B IH N AH
PEMBINAS	P EH M B AH N AH Z
PEMICAN	P IY M IH S AH N
PEMICANS	P EH M AH K AH N Z
PEMMICAN	P EH M IH K AH N
PEMMICANS	P EH M IH K AH N Z
PEMOLINE	P EH M AH L AY N
PEMOLINES	P EH M AH L AY N Z
PEMPHIGUS	P EH M F AH G AH S
PEMPHIGUSES	P EH M F AH G Y UW Z AH Z
PEMPHIX	P EH M F AH K S
PEMPHIXES	P EH M F AH K S
PEN	P EH N
PENAL	P IY N AH L
PENALISE	P EH N AH L AY Z
PENALISED	P IY N AH L IY Z D
PENALISES	P IY N AH L IY Z IH Z
PENALISING	P IY N AH L IY Z IH NG
PENALITIES	P IY N AH L AH T IY Z
PENALITY	P IY N AH L AH T IY
PENALIZATION	P IY N AH L AH Z EY SH AH N
PENALIZATIONS	P IY N AH L AH Z EY SH AH N Z
PENALIZE	P EH N AH L AY Z
PENALIZE(2)	P IY N AH L AY Z
PENALIZED	P IY N AH L AY Z D
PENALIZES	P EH N AH L AY Z IH Z
PENALIZES(2)	P IY N AH L AY Z IH Z
PENALIZING	P IY N AH L AY Z IH NG
PENALLY	P IY N AH L IY
PENALTIES	P EH N AH L T IY Z
PENALTY	P EH N AH L T IY
PENANCE	P EH N AH N S
PENANCED	P EH N AH N S T
PENANCES	P EH N AH N S IH Z
PENANCING	P EH N AH N S IH NG
PENANG	P EH N AE NG
PENANGS	P EH N AH NG Z
PENATES	P EH N AH T S
PENCE	P EH N S
PENCEL	P EH N S AH L
PENCELS	P EH N S AH L Z
PENCHANT	P EH N CH AH N T
PENCHANTS	P EH N CH AH N T S
PENCIL	P EH N S AH L
PENCILED	P EH N S AH L D
PENCILER	P EH N S AH L ER
PENCILERS	P EH N S AH L ER Z
PENCILING	P EH N S AH L IH NG
PENCILINGS	P EH N S AH L IH NG Z
PENCILLED	P EH N S AH L D
PENCILLING	P EH N S AH L IH NG
PENCILLINGS	P EH N S AH L IH NG Z
PENCILS	P EH N S AH L Z
PEND	P EH N D
PENDANT	P EH N D AH N T
PENDANTS	P EH N D AH N T S
PENDED	P EH N D AH D
PENDENCIES	P EH N D EH N S AY Z
PENDENCY	P EH N D EH N S IY
PENDENT	P EH N D EH N T
PENDENTIVE	P EH N D EH N T IH V
PENDENTIVES	P EH N D EH N T IH V Z
PENDENTS	P EH N D EH N T S
PENDING	P EH N D IH NG
PENDS	P EH N D Z
PENDULAR	P EH N D Y AH L AH R
PENDULOUS	P EH N JH AH L AH S
PENDULOUSNESS	P EH N D Y AH L AW Z N AH S
PENDULOUSNESSES	P EH N D Y AH L AW Z N EH S AH Z
PENDULUM	P EH N JH AH L AH M
PENDULUMS	P EH N JH AH L AH M Z
PENEPLAIN	P EH N AH P L EY N
PENEPLAINS	P EH N AH P L EY N Z
PENEPLANE	P EH N AH P L EY N
PENEPLANES	P EH N AH P L EY N Z
PENES	P IY N Z
PENETRABILITIES	P EH N AH T R AH B IH L AH T EH Z
PENETRABILITY	P EH N AH T R AH B IH L AH T EH
PENETRABLE	P EH N AH T R AH B AH L
PENETRALIA	P EH N AH T R EY L Y AH
PENETRANCE	P EH N AH T R AH N S
PENETRANCES	P EH N AH T R AH N S IH Z
PENETRANT	P EH N AH T R AH N T
PENETRANTS	P EH N AH T R AH N T S
PENETRATE	P EH N AH T R EY T
PENETRATED	P EH N AH T R EY T AH D
PENETRATED(2)	P EH N AH T R EY T IH D
PENETRATES	P EH N AH T R EY T S
PENETRATING	P EH N AH T R EY T IH NG
PENETRATINGLY	P EH N AH T R AH T IH NG L IY
PENETRATION	P EH N AH T R EY SH AH N
PENETRATIONS	P EH N AH T R EY SH AH N Z
PENETRATIVE	P EH N AH T R AH T IH V
PENETROMETER	P EH N AH T R AA M AH T AH R
PENETROMETERS	P EH N AH T R AA M AH T AH R Z
PENGO	P EH NG G OW
PENGOS	P EH N G OW Z
PENGUIN	P EH NG G W AH N
PENGUINS	P EH NG G W AH N Z
PENHOLDER	P EH N HH OW L D ER
PENHOLDERS	P EH N HH OW L D ER Z
PENIAL	P EH N IY AH L
PENICIL	P EH N AH S AH L
PENICILLAMINE	P EH N IH K S D IH L AH M AY N
PENICILLAMINES	P EH N IH K S IH L AH M AY N Z
PENICILLATE	P EH N IH K S IH L AH T
PENICILLIA	P EH N AH S IH L IY AH
PENICILLIN	P EH N AH S IH L AH N
PENICILLINASE	P AH N AH S IH L AH N EY Z
PENICILLINASES	P AH N AH S IH L AH N EY Z AH Z
PENICILLINS	P EH N AH S IH L AH N Z
PENICILLIUM	P EH N AH S IH L IY AH M
PENICILLIUMS	P EH N AH S IH L IY AH M Z
PENICILS	P IY N IH S AH L Z
PENILE	P IY N AY L
PENINSULA	P AH N IH N S AH L AH
PENINSULAR	P AH N IH N S AH L ER
PENINSULAS	P AH N IH N S AH L AH Z
PENIS	P IY N IH S
PENISES	P IY N IH S IH Z
PENITENCE	P EH N AH T AH N S
PENITENCES	P EH N AH T EH N S AH Z
PENITENT	P EH N IH T IH N T
PENITENTIAL	P EH N AH T EH N CH AH L
PENITENTIALLY	P EH N AH T EH N T IY AE L IY
PENITENTIARIES	P EH N IH T EH N CH ER IY Z
PENITENTIARY	P EH N IH T EH N CH ER IY
PENITENTLY	P EH N AH T EH N T L IY
PENITENTS	P EH N AH T AH N T S
PENKNIFE	P EH N AY F
PENKNIVES	P EH N AY V Z
PENLIGHT	P EH N L AY T
PENLIGHTS	P EH N L AY T S
PENLITE	P EH N L AY T
PENLITES	P EH N L AY T S
PENMAN	P EH N M AH N
PENMANSHIP	P EH N M AE N SH IH P
PENMANSHIPS	P EH N M AE N SH IH P S
PENMEN	P EH N M EH N
PENNA	P EH N AH
PENNA(2)	P EH N S IH L V EY N Y AH
PENNAE	P EH N IY
PENNAME	P EH N EY M
PENNAMES	P EH N EY M Z
PENNANT	P EH N AH N T
PENNANTS	P EH N AH N T S
PENNATE	P EH N AH T
PENNATED	P EH N EY T IH D
PENNE	P EH N
PENNED	P EH N D
PENNER	P EH N ER
PENNERS	P EH N ER Z
PENNI	P EH N IY
PENNIA	P EH N IY AH
PENNIES	P EH N IY Z
PENNILESS	P EH N IY L AH S
PENNINE	P EH N AY N
PENNINES	P EH N AY N Z
PENNING	P EH N IH NG
PENNIS	P EH N IY Z
PENNON	P EH N AH N
PENNONCEL	P EH N AA N S AH L
PENNONCELS	P EH N AA N S AH L Z
PENNONED	P EH N OW N D
PENNONS	P EH N AH N Z
PENNY	P EH N IY
PENNYCRESS	P EH N IH K R AH S
PENNYCRESSES	P EH N IH K R EH S AH Z
PENNYROYAL	P EH N IY R OY AH L
PENNYROYALS	P EH N IY R OY AH L Z
PENNYWEIGHT	P EH N IY W EY T
PENNYWEIGHTS	P EH N IY W EY T S
PENNYWHISTLE	P EH N IY W IH S AH L
PENNYWHISTLES	P EH N IY W IH S AH L Z
PENNYWORT	P EH N AH W AH R T
PENNYWORTH	P EH N IY W ER TH
PENNYWORTHS	P EH N IY W ER TH S
PENNYWORTS	P EH N AH W AH R T S
PENOCHE	P EH N AH CH
PENOCHES	P EH N AH CH AH Z
PENOLOGICAL	P AH N AA L AH JH IH S AH L
PENOLOGIES	P EH N AA L AH JH IY Z
PENOLOGIST	P EH N AA L AH JH AH S T
PENOLOGISTS	P EH N AA L AH JH AH S T S
PENOLOGY	P IY N AA L AH JH IY
PENONCEL	P AH N AA N S AH L
PENONCELS	P AH N AA N S AH L Z
PENPOINT	P EH N P OY N T
PENPOINTS	P EH N P OY N T S
PENS	P EH N Z
PENSEE	P EH N S IY
PENSEES	P EH N S IY Z
PENSIL	P EH N S AH L
PENSILE	P EH N S AH L
PENSILS	P EH N S AH L Z
PENSION	P EH N SH AH N
PENSIONABLE	P EH N CH AH N AH B AH L
PENSIONARIES	P EH N CH AH N EH R IY Z
PENSIONARY	P EH N CH AH N EH R IY
PENSIONE	P EH N S IY OW N
PENSIONED	P EH N CH AH N D
PENSIONER	P EH N SH AH N ER
PENSIONERS	P EH N SH AH N ER Z
PENSIONES	P EH N S IY OW N Z
PENSIONING	P EH N CH AH N IH NG
PENSIONLESS	P EH N CH AH N L AH S
PENSIONS	P EH N SH AH N Z
PENSIVE	P EH N S IH V
PENSIVELY	P EH N S IH V L IY
PENSIVENESS	P EH N S IH V N AH S
PENSIVENESSES	P EH N S IH V N AH S IH Z
PENSTEMON	P EH N S T EH M AO N
PENSTEMONS	P EH N S T EH M AO N Z
PENSTER	P EH N S T ER
PENSTERS	P EH N S T ER Z
PENSTOCK	P EH N S T AA K
PENSTOCKS	P EH N S T AA K S
PENT	P EH N T
PENTACHLOROPHENOL	P EH N T AE K L AH R AA F AH N AH L
PENTACHLOROPHENOLS	P EH N T AE K L AH R AA F AH N AH L Z
PENTACLE	P EH N T AH K AH L
PENTACLES	P EH N T AH K AH L Z
PENTAD	P EH N T AH D
PENTADS	P EH N T AH D Z
PENTAGON	P EH N T IH G AA N
PENTAGON(2)	P EH N IH G AA N
PENTAGONAL	P EH N T IH G AA N AH L
PENTAGONALLY	P EH N T IH G AA N AH L IY
PENTAGONALS	P EH N T IH G AA N AH L Z
PENTAGONS	P EH N T IH G AA N Z
PENTAGONS(2)	P EH N IH G AA N Z
PENTAGRAM	P EH N T AE G R AE M
PENTAGRAMS	P EH N T AE G R AE M Z
PENTAHEDRA	P EH N T AH HH EH D R AH
PENTAHEDRAL	P EH N T AH HH EH D R AH L
PENTAHEDRON	P EH N T AH HH EH D R AH N
PENTAHEDRONS	P EH N T AH HH EH D R AH N Z
PENTAMEROUS	P EH N T EY M ER AH S
PENTAMETER	P EH N T AE M AH T AH R
PENTAMETERS	P EH N T AE M AH T AH R Z
PENTAMIDINE	P EH N T AE M IH D IY N
PENTAMIDINES	P EH N T AE M AH D AY N Z
PENTANE	P EH N T EY N
PENTANES	P EH N T EY N Z
PENTANGLE	P EH N T AE NG G AH L
PENTANGLES	P EH N T AE NG G AH L Z
PENTANOL	P EH N T AH N AH L
PENTANOLS	P EH N T AH N AH L Z
PENTAPEPTIDE	P EH N T AE P AH P T AY D
PENTAPEPTIDES	P EH N T AE P AH P T AY D Z
PENTAPLOID	P EH N T AH P L OY D
PENTAPLOIDIES	P EH N T AE P L OY D AY Z
PENTAPLOIDS	P EH N T AH P L OY D Z
PENTAPLOIDY	P EH N T AH P L OY D IY
PENTARCH	P EH N T AH R K
PENTARCHIES	P EH N T AA R K AY Z
PENTARCHS	P EH N T AH R K S
PENTARCHY	P EH N T AA R K IY
PENTATHLETE	P EH N T AH TH L IY T
PENTATHLETES	P EH N T AH TH L IY T S
PENTATHLON	P EH N T AE TH L AH N
PENTATHLONS	P EH N T AE TH L AH N Z
PENTATONIC	P EH N T AE T AO N IH K
PENTAVALENT	P EH N T AE V AH L AH N T
PENTAZOCINE	P EH N T AE Z AH S AY N
PENTAZOCINES	P EH N T AE Z AH S AY N Z
PENTENE	P EH N T IY N
PENTENES	P EH N T IY N Z
PENTHOUSE	P EH N T HH AW S
PENTHOUSES	P EH N T HH AW S IH Z
PENTLANDITE	P EH N T L AH N D AY T
PENTLANDITES	P EH N T L AH N D AY T S
PENTOBARBITAL	P EH N T AH B AA R B AH T AH L
PENTOBARBITALS	P EH N T AH B AA R B AH T AH L Z
PENTOBARBITONE	P EH N T AH B AA R B AH T OW N
PENTOBARBITONES	P EH N T AH B AA R B AH T OW N Z
PENTODE	P EH N T OW D
PENTODES	P EH N T OW D Z
PENTOMIC	P EH N T OW M IH K
PENTOSAN	P EH N T AH Z AH N
PENTOSANS	P EH N T AH S AH N Z
PENTOSE	P EH N T OW Z
PENTOSES	P EH N T OW Z AH Z
PENTOXIDE	P EH N T AH K S AY D
PENTOXIDES	P EH N T AH K S AY D Z
PENTSTEMON	P EH N T S T AH M AH N
PENTSTEMONS	P EH N T S T AH M AH N Z
PENTYL	P EH N T AH L
PENTYLENETETRAZOL	P EH N T IH L AH N AH T EH T R AH Z AH L
PENTYLENETETRAZOLS	P EH N T IH L AH N AH T EH T R AH Z AH L Z
PENTYLS	P EH N T AH L Z
PENUCHE	P EH N AH CH
PENUCHES	P EH N AH CH AH Z
PENUCHI	P EH N AH CH IY
PENUCHIS	P EH N AH CH AH S
PENUCHLE	P EH N AH K L
PENUCHLES	P EH N AH K L Z
PENUCKLE	P EH N AH K AH L
PENUCKLES	P EH N AH K AH L Z
PENULT	P EH N AH L T
PENULTIMA	P AH N AH L T AH M AH
PENULTIMAS	P AH N AH L T AH M AH Z
PENULTIMATE	P EH N AH L T AH M AH T
PENULTIMATELY	P IH N AH L T AH M AH T L IY
PENULTS	P EH N AH L T S
PENUMBRA	P IH N AH M B R AH
PENUMBRAE	P AH N AH M B R IY
PENUMBRAL	P AH N AH M B R AH L
PENUMBRAS	P AH N AH M B R AH Z
PENURIES	P EH N Y AH R IY Z
PENURIOUS	P EH N Y UW R IY AH S
PENURIOUSLY	P AH N UH R IY AH S L IY
PENURIOUSNESS	P AH N UH R IY AH S N AH S
PENURIOUSNESSES	P AH N UH R IY AH S N AH S IH Z
PENURY	P EH N Y UH R IY
PEON	P IY AH N
PEONAGE	P IY AH N AH JH
PEONAGES	P IY AA N AH JH AH Z
PEONES	P IY OW N Z
PEONIES	P IY AH N IY Z
PEONISM	P IY AH N IH Z AH M
PEONISMS	P IY AH N AH Z AH M Z
PEONS	P IY AH N Z
PEONY	P IY AH N IY
PEOPLE	P IY P AH L
PEOPLED	P IY P AH L D
PEOPLEHOOD	P IY P AH L HH UH D
PEOPLEHOODS	P IY P AH L HH UH D Z
PEOPLELESS	P IY P AH L AH S
PEOPLER	P IY P AH L ER
PEOPLERS	P IY P AH L ER Z
PEOPLES	P IY P AH L Z
PEOPLING	P IY P AH L IH NG
PEP	P EH P
PEPEROMIA	P EH P AH R OW M IY AH
PEPEROMIAS	P EH P AH R OW M IY AH Z
PEPERONI	P AH P EH R AH N IY
PEPERONIS	P EH P ER AO N IY Z
PEPLA	P EH P L AH
PEPLOS	P EH P L AH Z
PEPLOSES	P EH P L UW Z IH Z
PEPLUM	P EH P L AH M
PEPLUMED	P EH P L UW M D
PEPLUMS	P EH P L AH M Z
PEPLUS	P EH P L AH S
PEPLUSES	P EH P L UW Z AH Z
PEPO	P EH P OW
PEPONIDA	P AH P AA N AH D AH
PEPONIDAS	P AH P AA N AH D AH Z
PEPONIUM	P AH P OW N IY AH M
PEPONIUMS	P AH P OW N IY AH M Z
PEPOS	P EH P AA S
PEPPED	P EH P T
PEPPER	P EH P ER
PEPPERBOX	P EH P ER B AA K S
PEPPERBOXES	P EH P ER B AA K S IH Z
PEPPERCORN	P EH P ER K AO R N
PEPPERCORNS	P EH P ER K AO R N Z
PEPPERED	P EH P ER D
PEPPERER	P EH P ER ER
PEPPERERS	P EH P ER ER Z
PEPPERGRASS	P EH P ER G R AE S
PEPPERGRASSES	P EH P ER G R AE S IH Z
PEPPERINESS	P EH P AH R IY N AH S
PEPPERINESSES	P EH P AH R IY N AH S IH Z
PEPPERING	P EH P ER IH NG
PEPPERMINT	P EH P ER M IH N T
PEPPERMINTS	P EH P ER M IH N T S
PEPPERMINTY	P EH P ER M IH N T IY
PEPPERONI	P EH P ER OW N IY
PEPPERONIS	P EH P ER AO N IY Z
PEPPERS	P EH P ER Z
PEPPERTREE	P EH P ER T R IY
PEPPERTREES	P EH P ER T R IY Z
PEPPERY	P EH P AH R IY
PEPPIER	P EH P IY ER
PEPPIEST	P EH P IY AH S T
PEPPILY	P EH P IY L IY
PEPPINESS	P EH P IY N AH S
PEPPINESSES	P EH P IY N AH S IH Z
PEPPING	P EH P IH NG
PEPPY	P EH P IY
PEPS	P EH P S
PEPSIN	P EH P S IH N
PEPSINE	P EH P S AY N
PEPSINES	P EH P S AY N Z
PEPSINOGEN	P EH P S IH N AH JH AH N
PEPSINOGENS	P EH P S IH N AH JH AH N Z
PEPSINS	P EH P S IH N Z
PEPTIC	P EH P T IH K
PEPTICS	P EH P T AH S Z
PEPTID	P EH P T AH D
PEPTIDASE	P EH P T AH D EY Z
PEPTIDASES	P EH P T AH D EY Z IH Z
PEPTIDE	P EH P T AY D
PEPTIDES	P EH P T AY D Z
PEPTIDIC	P EH P T AY D IH K
PEPTIDOGLYCAN	P EH P T AH D AA G L AH K AH N
PEPTIDOGLYCANS	P EH P T AH D AA G L AH K AH N Z
PEPTIDS	P EH P T AH D Z
PEPTIZE	P EH P T AY Z
PEPTIZED	P EH P T AY Z D
PEPTIZER	P EH P T AY Z ER
PEPTIZERS	P EH P T AY Z ER Z
PEPTIZES	P EH P T AY Z IH Z
PEPTIZING	P EH P T AY Z IH NG
PEPTONE	P EH P T OW N
PEPTONES	P EH P T OW N Z
PEPTONIC	P EH P T AH N IH K
PER	P ER
PERACID	P ER AE S AH D
PERACIDS	P ER AE S AH D Z
PERADVENTURE	P ER AH D V EH N CH ER
PERADVENTURES	P ER AH D V EH N CH ER Z
PERAMBULATE	P ER AE M B Y AH L AH T
PERAMBULATED	P ER AE M B Y AH L EY T IH D
PERAMBULATES	P ER AE M B Y AH L AH T S
PERAMBULATING	P ER AE M B Y AH L EY T IH NG
PERAMBULATION	P ER AE M B Y AH L EY SH AH N
PERAMBULATIONS	P ER AE M B Y AH L EY SH AH N Z
PERAMBULATOR	P ER AE M B Y AH L AH T ER
PERAMBULATORS	P ER AE M B Y AH L AH T ER Z
PERAMBULATORY	P ER AE M B Y AH L AH T OW R IY
PERBORATE	P ER B AO R EY T
PERBORATES	P ER B AO R EY T S
PERCALE	P AH R K EY L
PERCALES	P AH R K EY L Z
PERCALINE	P AH R K AH L AY N
PERCALINES	P AH R K AH L AY N Z
PERCEIVABLE	P ER S IY V AH B AH L
PERCEIVABLY	P ER S IY V AH B L IY
PERCEIVE	P ER S IY V
PERCEIVED	P ER S IY V D
PERCEIVER	P ER S IY V ER
PERCEIVERS	P ER S IY V ER Z
PERCEIVES	P ER S IY V Z
PERCEIVING	P ER S IY V IH NG
PERCENT	P ER S EH N T
PERCENTAGE	P ER S EH N T AH JH
PERCENTAGE(2)	P ER S EH N AH JH
PERCENTAGE(3)	P ER S EH N T IH JH
PERCENTAGE(4)	P ER S EH N IH JH
PERCENTAGES	P ER S EH N T IH JH IH Z
PERCENTAGES(2)	P ER S EH N IH JH IH Z
PERCENTILE	P ER S EH N T AY L
PERCENTILES	P ER S EH N T AY L Z
PERCENTS	P ER S EH N T S
PERCEPT	P ER S EH P T
PERCEPTIBILITIES	P ER S EH P T AH B IH L AH T IY Z
PERCEPTIBILITY	P ER S EH P T AH B IH L AH T IY
PERCEPTIBLE	P ER S EH P T AH B AH L
PERCEPTIBLY	P ER S EH P T AH B L IY
PERCEPTION	P ER S EH P SH AH N
PERCEPTIONAL	P ER S EH P SH AH N AH L
PERCEPTIONS	P ER S EH P SH AH N Z
PERCEPTIVE	P ER S EH P T IH V
PERCEPTIVELY	P ER S EH P T IH V L IY
PERCEPTIVENESS	P ER S EH P T IH V N AH S
PERCEPTIVENESSES	P ER S EH P T IH V N AH S IH Z
PERCEPTIVITIES	P ER S EH P T IH V AH T IY Z
PERCEPTIVITY	P ER S EH P T IH V AH T IY
PERCEPTS	P ER S EH P T S
PERCEPTUAL	P ER S EH P CH AH W AH L
PERCEPTUALLY	P ER S EH P CH AH W AH L IY
PERCH	P ER CH
PERCHANCE	P ER CH AE N S
PERCHED	P ER CH T
PERCHER	P ER CH ER
PERCHERS	P ER CH ER Z
PERCHES	P ER CH IH Z
EOHIPPUS	IY OW HH IH P AH S
CHABLIS	SH AH B L IY
HM	HH AH M
EBULLIENCE	IH B UH L Y AH N S
DIKDIK	D IH K D AH K
VEAL	V IY L
IKAT	IH K AH T
