PH	P IY EY CH
ACALEPH	AE K AH L AH F
ACALEPHAE	AH K AE L AH F IY
ACALEPHE	AE K AH L AH F
ACALEPHES	AE K AH L AH F S
ACALEPHS	AE K AH L AH F S
ACANTHOCEPHALAN	AH K AE N TH AH S EH F AH L AH N
ACANTHOCEPHALANS	AH K AE N TH AH S EH F AH L AH N Z
ACEPHALOUS	AH S EH F AH L AH S
ACETAMINOPHEN	AH S IY T AH M IH N AH F AH N
ACETAMINOPHENS	AE S AH T AH M IH N AH F AH N Z
ACETOPHENETIDIN	AH S EH T AH F AH N EH T AH D AH N
ACETOPHENETIDINS	AH S EH T AH F AH N EH T AH D AH N Z
ACIDOPHIL	AH S IH D AH F AH L
ACIDOPHILE	AH S IH D AH F AY L
ACIDOPHILES	AH S IH D AH F AY L Z
ACIDOPHILIC	AH S IH D AH F AY L AH K
ACIDOPHILS	AH S IH D AH F AY L Z
ACROPHOBE	AE K R AH F OW B
ACROPHOBES	AE K R AH F OW B Z
ACROPHOBIA	AE K R AH F OW B IY AH
ACROPHOBIAS	AE K R AH F OW B IY AH Z
ACTINOMORPHIC	AE K T IH N AH M AH R F AH K
ACTINOMORPHIES	AE K T AH N AH M AO R F AY Z
ACTINOMORPHY	AE K T IH N AH M AO R F IY
ADENOHYPOPHYSEAL	AE D AH N AH HH IH P AH F IH Z IY AH L
ADENOHYPOPHYSES	AH D AH N AH HH IH P AH F AY Z AH Z
ADENOHYPOPHYSIAL	AE D AH N AH HH IH P AH F IH Z IY AH L
ADENOHYPOPHYSIS	AH D EH N AH HH AH P AA F AH S AH S
ADRENOCORTICOTROPHIC	AE D R AH N AH K AO R T AH K AA T R AH F AH K
ADRENOCORTICOTROPHIN	AE D R AH N AH K AO R T AH K AA T R AH F AH N
ADRENOCORTICOTROPHINS	AE D R AH N AH K AO R T AH K AA T R AH F AH N Z
AGORAPHOBE	AH G AO R AH F OW B
AGORAPHOBES	AH G AO R AH F OW B Z
AGORAPHOBIA	AH G AO R AH F OW B IY AH
AGORAPHOBIAS	AE G AH R AH F OW B IY AH Z
AGORAPHOBIC	AH G OW R AE P HH AA B IH K
AGORAPHOBICS	AH G OW R AE P HH AA B IH K S
AGRAPHA	AE G R AH F AH
AGRAPHIA	AE G R AE F IY AH
AGRAPHIAS	AE G R AE F IY AH Z
AGRAPHIC	AH G R AE F IH K
AILUROPHILE	EY L UH R AH F AY L
AILUROPHILE(2)	EY L UH R AH F AY AH L
AILUROPHILES	EY L UH R AH F AY L Z
AILUROPHOBE	EY L UH R AH F OW B
AILUROPHOBES	EY L UH R AH F OW B Z
AILUROPHOBIA	EY L AH R AH F OW B IY AH
AILUROPHOBIAS	EY L AH R AH F OW B IY AH Z
ALEPH	AA L AH F
ALEPHS	AE L AH F S
ALIPHATIC	AH L IH P HH EY T IH K
ALLELOMORPH	AE L EH L AH M AH R F
ALLELOMORPHIC	AE L EH L AH M AH R F AH K
ALLELOMORPHISM	AE L EH L AH M AH R F IH Z AH M
ALLELOMORPHISMS	AE L AH L AH M AO R F AH Z AH M Z
ALLELOMORPHS	AE L EH L AH M AH R F S
ALLOGRAPH	AE L AH G R AE F
ALLOGRAPHIC	AE L AA G R AH F AH K
ALLOGRAPHS	AE L AH G R AE F S
ALLOMORPH	AE L AH M AO R F
ALLOMORPHIC	AE L AH M AH R F AH K
ALLOMORPHISM	AE L AH M AH R F IH Z AH M
ALLOMORPHISMS	AE L AH M AO R F AH Z AH M Z
ALLOMORPHS	AE L AH M AO R F S
ALLOPHANE	AE L AH F EY N
ALLOPHANES	AE L AH F EY N Z
ALLOPHONE	AE L AH F OW N
ALLOPHONES	AE L AH F OW N Z
ALLOPHONIC	AE L AH F AA N IH K
ALPHA	AE L F AH
ALPHABET	AE L F AH B EH T
ALPHABETED	AE L F AH B EH T IH D
ALPHABETIC	AE L F AH B EH T IH K
ALPHABETICAL	AE L F AH B EH T IH K AH L
ALPHABETICALLY	AE L F AH B EH T IH K L IY
ALPHABETING	AE L F AH B EH T IH NG
ALPHABETIZATION	AE L F AH B EH T AH Z EY SH AH N
ALPHABETIZATIONS	AE L F AH B EH T AH Z EY SH AH N Z
ALPHABETIZE	AE L F AH B AH T AY Z
ALPHABETIZED	AE L F AH B AH T AY Z D
ALPHABETIZER	AE L F AH B EH T AY Z ER
ALPHABETIZERS	AE L F AH B EH T AY Z ER Z
ALPHABETIZES	AE L F AH B AH T AY Z IH Z
ALPHABETIZING	AE L F AH B AH T AY Z IH NG
ALPHABETS	AE L F AH B EH T S
ALPHAMERIC	AE L F AH M IH ER IH K
ALPHANUMERIC	AE L F AH N UW M EH R IH K
ALPHANUMERICAL	AE L F AH N UH M EH R IH K AH L
ALPHANUMERICALLY	AE L F AH N UH M EH R IH K AH L IY
ALPHANUMERICS	AE L F AH N UW M ER IH K S
ALPHAS	AE L F AH Z
ALPHORN	AE L P HH AO R N
ALPHORNS	AE L P HH AO R N Z
ALPHOSIS	AE L P HH OW Z IY Z
ALPHOSISES	AE L P HH OW Z IY Z IH Z
ALPHYL	AE L F AH L
ALPHYLS	AE L F AH L Z
AMINOPHYLLINE	AH M AH N AA F AH L AY N
AMINOPHYLLINES	AH M AH N AA F AH L AY N Z
AMORPHOUS	AH M AO R F AH S
AMORPHOUSLY	AH M AO R F AH S L IY
AMORPHOUSNESS	AH M AO R F AH S N AH S
AMORPHOUSNESSES	AH M AO R F AH S N AH S IH Z
AMPHETAMINE	AE M F EH T AH M IY N
AMPHETAMINES	AE M F EH T AH M IY N Z
AMPHIBIA	AE M F IH B IY AH
AMPHIBIAN	AE M F IH B IY AH N
AMPHIBIANS	AE M F IH B IY AH N Z
AMPHIBIOUS	AE M F IH B IY AH S
AMPHIBIOUSLY	AE M F IH B IY AH S L IY
AMPHIBIOUSNESS	AE M F IH B IY AH S N AH S
AMPHIBIOUSNESSES	AE M F IH B IY AH S N AH S IH Z
AMPHIBOLE	AE M F IH B OW L
AMPHIBOLES	AE M F AH B OW L Z
AMPHIBOLIES	AE M F IH B AH L AY Z
AMPHIBOLITE	AE M F IH B AH L AY T
AMPHIBOLITES	AE M F IH B AH L AY T S
AMPHIBOLOGIES	AE M F AH B AA L AH JH IY Z
AMPHIBOLOGY	AE M F AH B AA L AH JH IY
AMPHIBOLY	AE M F IH B AH L IY
AMPHIBRACH	AE M F IH B R AH CH
AMPHIBRACHIC	AE M F IH B R AH CH AH K
AMPHIBRACHS	AE M F IH B R AH CH S
AMPHICTYONIC	AE M F IH K T AY AH N AH K
AMPHICTYONIES	AE M F IH K T AY AH N AY Z
AMPHICTYONY	AE M F IH K T AY AH N IY
AMPHIDIPLOID	AE M F IH D AH P L OY D
AMPHIDIPLOIDIES	AE M F AH D IH P L OY D AY Z
AMPHIDIPLOIDS	AE M F IH D AH P L OY D Z
AMPHIDIPLOIDY	AE M F IH D AH P L OY D IY
AMPHIMACER	AE M F IH M AH S AH R
AMPHIMACERS	AE M F IH M AH S AH R Z
AMPHIMIXES	AE M F AH M AH K S
AMPHIMIXIS	AE M F AH M IH K S AH S
AMPHIOXI	AE M F IY AA K S IY
AMPHIOXUS	AE M F IY AA K S AH S
AMPHIOXUSES	AE M F IY AH K S Y UW Z AH Z
AMPHIPATHIC	AE M F AH P AH TH AH K
AMPHIPHILE	AE M F AH F AY L
AMPHIPHILES	AE M F AH F AY L Z
AMPHIPHILIC	AE M F AH F AY L AH K
AMPHIPLOID	AE M F AH P L OY D
AMPHIPLOIDIES	AE M F IH P L OY D AY Z
AMPHIPLOIDS	AE M F AH P L OY D Z
AMPHIPLOIDY	AE M F AH P L OY D IY
AMPHIPOD	AE M F AH P AH D
AMPHIPODS	AE M F AH P AH D Z
AMPHIPROSTYLE	AE M F IH P R AH S T AY L
AMPHIPROSTYLES	AE M F IH P R AH S T AY L Z
AMPHISBAENA	AE M F AH Z IY N AH
AMPHISBAENAE	AE M F AH Z IY N IY
AMPHISBAENAS	AE M F AH Z IY N AH Z
AMPHISBAENIC	AE M F AH Z IY N AH K
AMPHITHEATER	AE M F AH TH IY EY T ER
AMPHITHEATERS	AE M F AH TH IY EY T ER Z
AMPHITHEATRIC	AE M F AH TH IY T R AH K
AMPHITHEATRICAL	AE M F AH TH IY T R IH S AH L
AMPHITHEATRICALLY	AE M F AH TH IY T R AH K AE L IY
AMPHORA	AE M F ER AH
AMPHORAE	AE M F ER IY
AMPHORAL	AE M F AH R AH L
AMPHORAS	AE M F AH R AH Z
AMPHOTERIC	AE M F AH T AH R AH K
ANAGLYPH	AH N AE G L AH F
ANAGLYPHIC	AH N AE G L AH F AH K
ANAGLYPHS	AH N AE G L AH F S
ANALPHABET	AH N AE L F AH B AH T
ANALPHABETIC	AH N AE L F AH B AH T AH K
ANALPHABETICS	AH N AE L F AE B AH T AH S Z
ANALPHABETISM	AH N AE L F AH B AH T IH Z AH M
ANALPHABETISMS	AE N AH L F AE B AH T AH Z AH M Z
ANALPHABETS	AH N AE L F AH B AH T S
ANAMORPHIC	AE N AH M AH R F AH K
ANAPHASE	AE N AH F EY Z
ANAPHASES	AE N AH F EY Z AH Z
ANAPHASIC	AE N AH F AH Z AH K
ANAPHOR	AE N AH F AH R
ANAPHORA	AH N AE F ER AH
ANAPHORAS	AH N AE F AH R AH Z
ANAPHORIC	AE N AH F AH R AH K
ANAPHORICALLY	AE N AH F AO R AH K AE L IY
ANAPHORS	AE N AH F AH R Z
ANAPHRODISIAC	AH N AE F R AH D IH S IY AH K
ANAPHRODISIACS	AH N AE F R AH D IH S IY AH S
ANAPHYLACTIC	AH N AE F AH L AH K T AH K
ANAPHYLACTICALLY	AE N AH F AH L AE K T AH K AE L IY
ANAPHYLACTOID	AE N AH F IH L AH K T OY D
ANAPHYLAXES	AH N AE F AH L AH K S
ANAPHYLAXIS	AE N AH F AH L AE K S IH S
ANASTROPHE	AH N AE S T R AH F
ANASTROPHES	AH N AE S T R AH F S
ANEMOGRAPH	AE N AH M AA G R AH F
ANEMOGRAPHS	AE N AH M AA G R AH F S
ANEMOPHILOUS	AH N EH M AH F AY L AH S
ANENCEPHALIC	AE N EH N S EH F AE L IH K
ANENCEPHALIC(2)	AE N IH N S EH F AH L IH K
ANENCEPHALIES	AH N EH N S EH F AH L AY Z
ANENCEPHALY	AE N IH N S EH F AH L IY
ANGIOCARDIOGRAPHIC	AE N JH IY AH K AA R D IY AA G R AH F AH K
ANGIOCARDIOGRAPHIES	AE N JH IY AH K AA R D IY AA G R AH F AY Z
ANGIOCARDIOGRAPHY	AE N JH IY AH K AA R D IY AA G R AH F IY
ANGIOGRAPHIC	AE N JH IY AA G R AH F AH K
ANGIOGRAPHIES	AE N JH IY AA G R AH F AY Z
ANGIOGRAPHY	AE N JH IY AA G R AH F IY
ANGLOPHONE	AE N G L AH F OW N
ANOPHELES	AE N AH F IY L Z
ANOPHELINE	AH N AA F AH L AY N
ANOPHELINES	AH N AA F AH L AY N Z
ANTHOPHILOUS	AE N TH AH F AY L AH S
ANTHOPHYLLITE	AE N TH AA F AH L AY T
ANTHOPHYLLITES	AE N TH AA F AH L AY T S
ANTHROPOMORPH	AE N TH R AA P AH M AH R F
ANTHROPOMORPHIC	AE N TH R AH P AH M AO R F IH K
ANTHROPOMORPHICALLY	AE N TH R AH P AH M AO R F IH K AH L IY
ANTHROPOMORPHISM	AE N TH R AH P AH M AO R F IH Z AH M
ANTHROPOMORPHISMS	AE N TH R AH P AH M AO R F AH Z AH M Z
ANTHROPOMORPHIST	AE N TH R AA P AH M AO R F AH S T
ANTHROPOMORPHISTS	AE N TH R AH P AH M AO R F AH S T S
ANTHROPOMORPHIZATION	AE N TH R AH P AH M AO R F AH Z EY SH AH N
ANTHROPOMORPHIZATIONS	AE N TH R AH P AH M AO R F AH Z EY T IY AH N Z
ANTHROPOMORPHIZE	AE N TH R AH P AA M AH R F AY Z
ANTHROPOMORPHIZED	AE N TH R AH P AA M AH R F AY Z D
ANTHROPOMORPHIZES	AE N TH R AH P AA M AH R F AY Z AH Z
ANTHROPOMORPHIZING	AE N TH R AH P AA M AH R F AY Z AH NG
ANTHROPOMORPHS	AE N TH R AA P AH M AH R F S
ANTHROPOPHAGI	AE N TH R AH P AA F AH JH IY
ANTHROPOPHAGIES	AE N TH R AH P AA F AH JH AY Z
ANTHROPOPHAGOUS	AE N TH R AA P AH F EY JH AH S
ANTHROPOPHAGUS	AE N TH R AH P AA F AH JH AH S
ANTHROPOPHAGY	AE N TH R AH P AA F AH JH IY
ANTHROPOSOPHIES	AE N TH R AH P AA S AH F AY Z
ANTHROPOSOPHY	AE N TH R AH P AA S AH F IY
ANTIAPHRODISIAC	AE N T AY AE F R AH D IH S IY AH K
ANTIAPHRODISIACS	AE N T AY AE F R AH D IH S IY AH S
ANTIMETAPHYSICAL	AE N T AY M EH T AH F IH Z IH K AH L
ANTIPHLOGISTIC	AE N T AY F L AA JH AH S T AH K
ANTIPHON	AE N T IH F AA N
ANTIPHONAL	AE N T IH F AH N AH L
ANTIPHONALLY	AE N T IH F AH N AH L IY
ANTIPHONALS	AE N T IH F AH N AH L Z
ANTIPHONARIES	AE N T AY F OW N EH R IY Z
ANTIPHONARY	AE N T AY F OW N EH R IY
ANTIPHONIES	AE N T AY F OW N IY Z
ANTIPHONS	AE N T IH F AA N Z
ANTIPHONY	AE N T AY F OW N IY
ANTIPHRASES	AE N T AY F R EY Z IH Z
ANTIPHRASIS	AE N T AY F R EY Z IY Z
ANTIPORNOGRAPHIC	AE N T AY P AO R N AH G R AE F IH K
ANTIPORNOGRAPHY	AE N T AH P AO R N AA G R AH F IY
ANTISCHIZOPHRENIA	AE N T AY S IH Z AH F R IY N Y AH
ANTISCHIZOPHRENIC	AE N T AY S K IH T S AH F R EH N IH K
ANTISTROPHE	AE N T AY S T R OW F IY
ANTISTROPHES	AE N T AY S T R OW F IY Z
ANTISTROPHIC	AE N T AY S T R OW F IY IH K
ANTISTROPHICALLY	AE N T AY S T R OW F IY IH K AH L IY
ANTISYPHILITIC	AE N T AH S IH F AH L AH T AH K
ANTISYPHILITICS	AE N T AH S AH F IH L AH T AH S Z
ANTITYPHOID	AE N T AY T AY F OY D
AORTOGRAPHIC	EY AH R T AA G R AH F AH K
AORTOGRAPHIES	EY AH R T AA G R AH F AY Z
AORTOGRAPHY	EY AH R T AA G R AH F IY
APHAERESES	AE F AH R IY Z AH Z
APHAERESIS	AH F IY R AH S AH S
APHAERETIC	AH F IY R AH T AH K
APHAGIA	AH F EY JH IY AH
APHAGIAS	AH F EY JH IY AH Z
APHANITE	AE F AH N AY T
APHANITES	AE F AH N AY T S
APHANITIC	AE F AH N AH T AH K
APHASIA	AH F EY ZH AH
APHASIAC	AH F EY S IY AH K
APHASIACS	AH F EY S IY AH S
APHASIAS	AH F EY S IY AH Z
APHASIC	AH F EY Z IH K
APHASICS	AH F EY Z IH K S
APHELIA	AH F IY L Y AH
APHELIAN	AH F IY L IY AH N
APHELION	AH F IY L IY AH N
APHELIONS	AH F IY L IY AH N Z
APHERESES	AE F AH R IY Z AH Z
APHERESIS	AH F IH R AH S AH S
APHESES	AH F IY Z AH Z
APHESIS	AE F AH S AH S
APHETIC	AE F AH T AH K
APHETICALLY	AH F EH T AH K AE L IY
APHID	AE F IH D
APHID(2)	EY F IH D
APHIDES	AH F AY D Z
APHIDIAN	AH F IH D IY AH N
APHIDIANS	AH F IH D IY AH N Z
APHIDS	AE F IH D Z
APHIDS(2)	EY F IH D Z
APHIS	AE F AH S
APHOLATE	AE F AH L EY T
APHOLATES	AE F AH L EY T S
APHONIA	AH F OW N Y AH
APHONIAS	AH F OW N Y AH Z
APHONIC	AH F AA N IH K
APHONICS	AH F AA N IH K S
APHORISE	AE F AH R AY Z
APHORISED	AE F AH R AH S T
APHORISES	AE F AH R AY Z AH Z
APHORISING	AE F AH R AY Z AH NG
APHORISM	AE F ER IH Z AH M
APHORISMS	AE F ER IH Z AH M Z
APHORIST	AE F AH R AH S T
APHORISTIC	AE F AH R AH S T AH K
APHORISTICALLY	AE F AH R IH S T AH K AE L IY
APHORISTS	AE F AH R AH S T S
APHORIZE	AE F AH R AY Z
APHORIZED	AE F AH R AY Z D
APHORIZES	AE F AH R AY Z AH Z
APHORIZING	AE F AH R AY Z AH NG
APHOTIC	AE F AH T AH K
APHRODISIAC	AE F R OW D IY Z IY AE K
APHRODISIACAL	AE F R AH D AH S IY AH S AH L
APHRODISIACS	AE F R AH D IH S IY AH S
APHTHA	AE F TH AH
APHTHAE	AE F TH IY
APHTHOUS	AE F TH AH S
APHYLLIES	AH F IH L AY Z
APHYLLY	AH F IH L IY
APOCRYPHA	AH P AA K R AH F AH
APOCRYPHAL	AH P AA K R AH F AH L
APOCRYPHALLY	AH P AA K R AH F AH L IY
APOCRYPHALNESS	AH P AA K R AH F AH L N AH S
APOCRYPHALNESSES	AH P AA K R AH F AH L N AH S IH Z
APOMORPHINE	AH P AA M AH R F AY N
APOMORPHINES	AH P AA M AH R F AY N Z
APOPHONIES	AH P AA P HH OW N IY Z
APOPHONY	AH P AA P HH OW N IY
APOPHTHEGM	AH P AA F TH AH M
APOPHTHEGMS	AH P AA F TH AH M Z
APOPHYGE	AE P AH F AY JH
APOPHYGES	AE P AH F AY JH AH Z
APOPHYLLITE	AH P AA F AH L AY T
APOPHYLLITES	AH P AA F AH L AY T S
APOPHYSEAL	AE P AH F IH Z IY AH L
APOPHYSES	AE P AH F AY Z AH Z
APOPHYSIS	AH P AA F AH S AH S
APOSTROPHE	AH P AA S T R AH F IY
APOSTROPHES	AH P AA S T R AH F IY Z
APOSTROPHIC	AH P AA S T R AH F AH K
APOSTROPHISE	AH P AA S T R AH F AY Z
APOSTROPHISED	AH P AA S T R AH F AH S T
APOSTROPHISES	AH P AA S T R AH F AY Z AH Z
APOSTROPHISING	AH P AA S T R AH F AY Z AH NG
APOSTROPHIZE	AH P AA S T R AH F AY Z
APOSTROPHIZED	AH P AA S T R AH F AY Z D
APOSTROPHIZES	AH P AA S T R AH F AY Z AH Z
APOSTROPHIZING	AH P AA S T R AH F AY Z AH NG
ARSPHENAMINE	AA R S EH N AH M AY N
ARSPHENAMINES	AA R S EH N AH M AY N Z
ARTERIOGRAPHIC	AA R T IY R IY AA G R AH F AH K
ARTERIOGRAPHIES	AA R T IY R IY AA G R AH F AY Z
ARTERIOGRAPHY	AA R T IY R IY AA G R AH F IY
ASPHALT	AE S F AO L T
ASPHALTED	AE S F AO L T IH D
ASPHALTIC	AE S F AO L T IH K
ASPHALTING	AE S F AO L T IH NG
ASPHALTITE	AE S AH L T AY T
ASPHALTITES	AE S AH L T AY T S
ASPHALTS	AE S F AO L T S
ASPHALTUM	AE S AE L T AH M
ASPHALTUMS	AE S AE L T AH M Z
ASPHERIC	AH S F IH ER IH K
ASPHERICAL	AH S F IH ER IH K AH L
ASPHODEL	AE S AH D AH L
ASPHODELS	AE S AH D AH L Z
ASPHYXIA	AE S IH K S IY AH
ASPHYXIAS	AE S IH K S IY AH Z
ASPHYXIATE	AE S F IH K S IY EY T
ASPHYXIATED	AE S F IH K S IY EY T IH D
ASPHYXIATES	AE S F IH K S IY EY T S
ASPHYXIATING	AE S F IH K S IY EY T IH NG
ASPHYXIATION	AE S IH K S AY EY SH AH N
ASPHYXIATIONS	AE S IH K S IY EY T IY AH N Z
ASPHYXIES	AE S IH K S AY Z
ASPHYXY	AE S IH K S IY
ASTHENOSPHERE	AE S TH AH N AA S AH R
ASTHENOSPHERES	AE S TH EH N AH S IY R Z
ASTHENOSPHERIC	AE S TH AH N AA S AH R AH K
ASTROPHOTOGRAPH	AE S T R AH F AH T AA G R AH F
ASTROPHOTOGRAPHER	AE S T R AH F AH T AA G R AH F AH R
ASTROPHOTOGRAPHERS	AE S T R AH F AH T AA G R AH F AH R Z
ASTROPHOTOGRAPHIES	AE S T R AH F AH T AA G R AH F AY Z
ASTROPHOTOGRAPHS	AE S T R AH F AH T AA G R AH F S
ASTROPHOTOGRAPHY	AE S T R OW F AH T AA G R AH F IY
ASTROPHYSICAL	AH S T R OW F IY IY S IH K AH L
ASTROPHYSICALLY	AH S T R OW F IY IY S IH K AH L IY
ASTROPHYSICIST	AE S T R OW F IH S IH S IH S T
ASTROPHYSICISTS	AH S T R OW F IY IY S IH K IH S T S
ASTROPHYSICS	AE S T R OW F IH Z IH K S
ATMOSPHERE	AE T M AH S F IH R
ATMOSPHERED	AE T M AH S F IH ER D
ATMOSPHERES	AE T M AH S F IH ER Z
ATMOSPHERIC	AE T M AH S F EH R IH K
ATMOSPHERICALLY	AE T M AH S F IH ER IH K AH L IY
ATMOSPHERICS	AE T M AH S F EH R IH K S
ATROPHIA	AE T R AA F IY AH
ATROPHIAS	AE T R AA F IY AH Z
ATROPHIC	AH T R AA F IH K
ATROPHIED	AE T R AH F IY D
ATROPHIES	AE T R AH F IY Z
ATROPHY	AE T R AH F IY
ATROPHYING	AE T R AH F IY IH NG
AUDIOPHILE	AO D IY OW F IY L
AUDIOPHILES	AO D IY OW F IY L Z
AUTOBIOGRAPHER	AO T AH B AY AA G R AH F ER
AUTOBIOGRAPHERS	AO T OW B AY AA G R AH F ER Z
AUTOBIOGRAPHIC	AO T AH B AY AH G R AE F IH K
AUTOBIOGRAPHICAL	AO T AH B AY AH G R AE F IH K AH L
AUTOBIOGRAPHICALLY	AO T AH B AY AH G R AE F IH K AH L IY
AUTOBIOGRAPHIES	AO T AH B AY AA G R AH F IY Z
AUTOBIOGRAPHY	AO T AH B AY AA G R AH F IY
AUTOCEPHALIES	AO T AH S EH F AH L AY Z
AUTOCEPHALOUS	AO T AH S EH F AH L AH S
AUTOCEPHALY	AO T AH S EH F AH L IY
AUTOGRAPH	AO T AH G R AE F
AUTOGRAPHED	AO T AH G R AE F T
AUTOGRAPHIC	AO T AH G R AE F IH K
AUTOGRAPHICALLY	AO T AH G R AE F IH K AH L IY
AUTOGRAPHIES	AO T AH G R AE F IY Z
AUTOGRAPHING	AO T AH G R AE F IH NG
AUTOGRAPHS	AO T AH G R AE F S
AUTOGRAPHY	AO T AH G R AE F IY
AUTOMORPHISM	AO T OW M AO R F IH Z AH M
AUTOMORPHISMS	AO T OW M AO R F IH Z AH M Z
AUTORADIOGRAPH	AA T OW R EY D IY OW G R AE F
AUTORADIOGRAPHIC	AO T OW R EY D IY OW G R AE F IH K
AUTORADIOGRAPHIES	AO T OW R EY D IY AA G R AH F IY Z
AUTORADIOGRAPHS	AO T OW R EY D IY OW G R AE F S
AUTORADIOGRAPHY	AO T OW R EY D IY AA G R AH F IY
AUTOTROPH	AH T AA T R AH F
AUTOTROPHIC	AO T AH T R OW F IH K
AUTOTROPHICALLY	AH T AA T R AA F AH K AE L IY
AUTOTROPHIES	AO T OW T R OW F IY Z
AUTOTROPHS	AH T AA T R AH F S
AUTOTROPHY	AO T OW T R OW F IY
AUXOTROPH	AO K S AA T R AH F
AUXOTROPHIC	AO K S AA T R AH F AH K
AUXOTROPHIES	AO K S AA T R AH F AY Z
AUXOTROPHS	AO K S AA T R AH F S
AUXOTROPHY	AO K S AA T R AH F IY
BACTERIOCHLOROPHYLL	B AE K T IY R IY AH K L AO R AH F AH L
BACTERIOCHLOROPHYLLS	B AE K T IY R IY AH K L AO R AH F AH L Z
BACTERIOPHAGE	B AE K T AH R IY AH F AH JH
BACTERIOPHAGES	B AE K T AH R IY AA F AH JH AH Z
BACTERIOPHAGIES	B AE K T AH R IY AA F AH JH AY Z
BACTERIOPHAGY	B AE K T AH R IY AA F AH JH IY
BAROGRAPH	B AH R AA G R AH F
BAROGRAPHIC	B AH R AA G R AH F AH K
BAROGRAPHS	B AH R AA G R AH F S
BASOPHIL	B AE S AH F AH L
BASOPHILE	B AE S AH F AY L
BASOPHILES	B AE S AH F AY L Z
BASOPHILIA	B EY S AO F IH L IY AH
BASOPHILIAS	B AE S AH F IH L Y AH Z
BASOPHILIC	B EY S AO F IH L IH K
BASOPHILS	B AE S AH F AY L Z
BATHYSCAPH	B AH TH IH S AH F
BATHYSCAPHE	B AH TH IH S AH F
BATHYSCAPHES	B AH TH IH S AH F S
BATHYSCAPHS	B AH TH IH S AH F S
BATHYSPHERE	B EY DH IY S F IH ER
BATHYSPHERES	B EY DH IY S F IH ER Z
BATHYTHERMOGRAPH	B AE TH AH TH AH R M AA G R AH F
BATHYTHERMOGRAPHS	B AE TH AH TH AH R M AA G R AH F S
BENZOPHENONE	B IH N Z AA F AH N OW N
BENZOPHENONES	B IH N Z AA F AH N OW N Z
BIBLIOGRAPHER	B AY B L AY AA G R AH F AH R
BIBLIOGRAPHERS	B AY B L AY AA G R AH F AH R Z
BIBLIOGRAPHIC	B IH B L IY AH G R AE F IH K
BIBLIOGRAPHICAL	B IH B L IY AH G R AE F IH K AH L
BIBLIOGRAPHICALLY	B IH B L IY AH G R AE F IH K AH L IY
BIBLIOGRAPHIES	B IH B L IY AA G R AH F IY Z
BIBLIOGRAPHY	B IH B L IY AA G R AH F IY
BIBLIOPHILE	B IH B L IY AH F AY L
BIBLIOPHILES	B IH B L IY AH F AY L Z
BIBLIOPHILIC	B IH B L IY AH F AY L IH K
BIBLIOPHILIES	B IH B L IY AH F AY L IY Z
BIBLIOPHILISM	B IH B L IY AH F AY L IH Z AH M
BIBLIOPHILISMS	B IH B L IY AH F AY L IH Z AH M Z
BIBLIOPHILY	B IH B L IY AH F AY L IY
BIMORPH	B AY M AO R F
BIMORPHEMIC	B AY M AO R F IY M IH K
BIMORPHS	B AY M AO R F S
BIOGEOGRAPHER	B AY OW JH IY AA G R AH F AH R
BIOGEOGRAPHERS	B AY OW JH IY AA G R AH F AH R Z
BIOGEOGRAPHIC	B AY OW JH IY AA G R AH F AH K
BIOGEOGRAPHICAL	B AY OW JH IY AA G R AH F IH S AH L
BIOGEOGRAPHIES	B AY OW JH IY AA G R AH F AY Z
BIOGEOGRAPHY	B AY OW JH IY AA G R AH F IY
BIOGRAPHEE	B AY AA G R AH F IY IY
BIOGRAPHEES	B AY AA G R AH F IY Z
BIOGRAPHER	B AY AA G R AH F ER
BIOGRAPHERS	B AY AA G R AH F ER Z
BIOGRAPHIC	B AY AH G R AE F IH K
BIOGRAPHICAL	B AY AH G R AE F IH K AH L
BIOGRAPHICALLY	B AY AH G R AE F IH K AH L IY
BIOGRAPHIES	B AY AA G R AH F IY Z
BIOGRAPHY	B AY AA G R AH F IY
BIOMORPHIC	B AY AA M AH R F AH K
BIOPHYSICAL	B AY AA F AH Z IH S AH L
BIOPHYSICIST	B AY AA F AH Z IH S AH S T
BIOPHYSICISTS	B AY AH F IH S AH S AH S T S
BIOPHYSICS	B AY OW F IH S IH K S
BIOSPHERE	B AY OW S F IH R
BIOSPHERES	B AY OW S F IH R Z
BIOSPHERIC	B AY AA S AH R AH K
BIOSTRATIGRAPHIC	B AY AA S T R AH T IH G R AH F AH K
BIOSTRATIGRAPHIES	B AY AA S T R AH T IH G R AH F AY Z
BIOSTRATIGRAPHY	B AY AA S T R AH T IH G R AH F IY
BIPHASIC	B AY F EY Z IH K
BIPHENYL	B IH F AH N AH L
BIPHENYLS	B IH F AH N AH L Z
BLASPHEME	B L AE S F IY M
BLASPHEMED	B L AE S F IY M D
BLASPHEMER	B L AE S F IY M ER
BLASPHEMERS	B L AE S F IY M ER Z
BLASPHEMES	B L AE S F IY M Z
BLASPHEMIES	B L AE S F AH M IY Z
BLASPHEMING	B L AE S F IY M IH NG
BLASPHEMOUS	B L AE S F AH M AH S
BLASPHEMOUSLY	B L AE S F AH M AH S L IY
BLASPHEMOUSNESS	B L AE S F AH M AH S N AH S
BLASPHEMOUSNESSES	B L AE S F AH M AH S N AH S IH Z
BLASPHEMY	B L AE S F AH M IY
BLEPHAROPLAST	B L EH F AH R AA P L AH S T
BLEPHAROPLASTIES	B L EH F AH R AA P L AE S T AY Z
BLEPHAROPLASTS	B L EH F AH R AA P L AH S T S
BLEPHAROPLASTY	B L EH F AH R AH
BLEPHAROSPASM	B L EH F AH R AA S AH Z AH M
BLEPHAROSPASMS	B L EH F AH R AA S AH Z AH M Z
BOUSTROPHEDON	B AW S T R AA F AH D AH N
BOUSTROPHEDONIC	B AW S T R AA F AH D AH N AH K
BOUSTROPHEDONS	B AW S T R AA F AH D AH N Z
BRACHYCEPHALIC	B R AH CH IH S AH F AH L AH K
BRACHYCEPHALIES	B R AE CH AH S EH F AH L AY Z
BRACHYCEPHALY	B R AE CH AH S EH F AH L IY
BRYOPHYLLUM	B R AY AH F IH L AH M
BRYOPHYLLUMS	B R AY AH F IH L AH M Z
BRYOPHYTE	B R AY AH F AY T
BRYOPHYTES	B R AY AH F AY T S
BRYOPHYTIC	B R AY AH F AH T AH K
BUMPH	B AH M F
BUMPHS	B AH M F S
BUTYROPHENONE	B Y UW T AH R AA F AH N OW N
BUTYROPHENONES	B Y UW T AH R AA F AH N OW N Z
CACOGRAPHICAL	K AH K AA G R AH F IH S AH L
CACOGRAPHIES	K AH K AA G R AH F AY Z
CACOGRAPHY	K AH K AA G R AH F IY
CACOPHONIES	K AE K AA F AH N IY Z
CACOPHONOUS	K AE K AA F AH N AH S
CACOPHONOUSLY	K AE K AA F AH N AH S L IY
CACOPHONY	K AE K AA F AH N IY
CALIPH	K AE L AH F
CALIPHAL	K AE L AH F AH L
CALIPHATE	K AE L AH F AH T
CALIPHATES	K AE L AH F AH T S
CALIPHS	K AE L AH F S
CALLIGRAPHER	K AH L IH G R AH F ER
CALLIGRAPHERS	K AH L IH G R AH F ER Z
CALLIGRAPHIC	K AE L AH G R AE F IH K
CALLIGRAPHICALLY	K AE L IH G R AE F AH K AE L IY
CALLIGRAPHIES	K AH L IH G R AH F IY Z
CALLIGRAPHIST	K AE L IH G R AH F AH S T
CALLIGRAPHISTS	K AE L IH G R AH F AH S T S
CALLIGRAPHY	K AH L IH G R AH F IY
CAMPHENE	K AE M F IY N
CAMPHENES	K AE M F IY N Z
CAMPHINE	K AE M F AY N
CAMPHINES	K AE M F AY N Z
CAMPHIRE	K AE M P HH AY ER
CAMPHIRES	K AE M P HH AY ER Z
CAMPHOL	K AE M F AH L
CAMPHOLS	K AE M F AH L Z
CAMPHOR	K AE M F AH R
CAMPHORACEOUS	K AE M F AH R AH S IY AH S
CAMPHORATE	K AE M F AH R EY T
CAMPHORATED	K AE M F AH R EY T AH D
CAMPHORATES	K AE M F AH R EY T S
CAMPHORATING	K AE M F AH R EY T AH NG
CAMPHORS	K AE M F AH R Z
CANEPHOR	K AE N AH F AH R
CANEPHORS	K AE N AH F AH R Z
CAPH	K AE F
CAPHS	K AE F S
CARDIOGRAPH	K AA R D IY AA G R AH F
CARDIOGRAPHIC	K AA R D IY AA G R AH F AH K
CARDIOGRAPHIES	K AA R D IY AA G R AH F AY Z
CARDIOGRAPHS	K AA R D IY AA G R AH F S
CARDIOGRAPHY	K AA R D IY AA G R AH F IY
CARPOPHORE	K AA R P AH F AH R
CARPOPHORES	K AA R P AH F AH R Z
CARTOGRAPHER	K AA R T AA G R AH F AH R
CARTOGRAPHERS	K AA R T AA G R AH F AH R Z
CARTOGRAPHIC	K AA R T AA G R AH F AH K
CARTOGRAPHICAL	K AA R T AA G R AH F IH S AH L
CARTOGRAPHICALLY	K AA R T AA G R AE F AH K AE L IY
CARTOGRAPHIES	K AA R T AA G R AH F AY Z
CARTOGRAPHY	K AA R T AA G R AH F IY
CATAPHORA	K AH T AE F AH R AH
CATAPHORAS	K AH T AE F AH R AH Z
CATAPHORESES	K AH T AE F AH R IY Z AH Z
CATAPHORESIS	K AE T AH F AO R AH S AH S
CATAPHORETIC	K AH T AE F AH R AH T AH K
CATAPHORETICALLY	K AE T AH F AH R EH T AH K AE L IY
CATAPHORIC	K AE T AH F AH R AH K
CATASTROPHE	K AH T AE S T R AH F IY
CATASTROPHES	K AH T AE S T R AH F IY Z
CATASTROPHIC	K AE T AH S T R AA F IH K
CATASTROPHICALLY	K AE T AH S T R AA F IH K AH L IY
CATASTROPHISM	K AH T AE S T R AH F IY IH Z AH M
CATASTROPHISMS	K AH T AE S T R AH F IY IH Z AH M Z
CATASTROPHIST	K AH T AE S T R AH F IY IH S T
CATASTROPHISTS	K AH T AE S T R AH F IY IH S T S
CATCHPHRASE	K AE CH F R EY Z
CATCHPHRASES	K AE CH F R EY Z IH Z
CELLOPHANE	S EH L AH F EY N
CELLOPHANES	S EH L AH F EY N Z
CELLPHONE	S EH L F OW N
CELLPHONES	S EH L F OW N Z
CENOTAPH	S EH N AH T AH F
CENOTAPHS	S EH N AH T AH F S
CEPHALAD	S EH F AH L AH D
CEPHALEXIN	S EH F AH L EH K S AH N
CEPHALEXINS	S EH F AH L EH K S AH N Z
CEPHALIC	S EH F AH L AH K
CEPHALICALLY	S AH F AE L AH K AE L IY
CEPHALIN	S EH F AH L AH N
CEPHALINS	S EH F AH L AH N Z
CEPHALIZATION	S EH F AH L AH Z EY SH AH N
CEPHALIZATIONS	S EH F AH L AH Z EY T IY AH N Z
CEPHALOMETRIC	S AH F AE L AH M AH T R AH K
CEPHALOMETRIES	S EH F AH L AH M EH T R AY Z
CEPHALOMETRY	S EH F AH L AH M EH T R IY
CEPHALOPOD	S EH F AH L AH P AA D
CEPHALOPODS	S AH F AE L AH P AH D Z
CEPHALORIDINE	S AH F AH L AO R AH D AY N
CEPHALORIDINES	S AH F AH L AO R AH D AY N Z
CEPHALOSPORIN	S EH F AH L AO S P AO R IH N
CEPHALOSPORINS	S EH F AH L AA S AH R AH N Z
CEPHALOTHIN	S AH F AE L AH TH AH N
CEPHALOTHINS	S AH F AE L AH TH AH N Z
CEPHALOTHORACES	S EH F AH L AH TH AO R AH S AH Z
CEPHALOTHORAX	S EH F AH L AA TH AH R AH K S
CEPHALOTHORAXES	S EH F AH L AA TH AH R AH K S
CEPHEID	S AH F IY D
CEPHEIDS	S AH F IY D Z
CERIPH	S EH R AH F
CERIPHS	S EH R AH F S
CHAMAEPHYTE	CH AE M AH F AY T
CHAMAEPHYTES	CH AE M AH F AY T S
CHEMOAUTOTROPHIC	K EH M OW AH T AA T R AH F AH K
CHEMOAUTOTROPHIES	K EH M OW AH T AA T R AH F AY Z
CHEMOAUTOTROPHY	K EH M OW AH T AA T R AH F IY
CHEMOPROPHYLACTIC	K EH M AH P R AA F AH L AH K T AH K
CHEMOPROPHYLAXES	K EH M AH P R AA F AH L AH K S
CHEMOPROPHYLAXIS	K AH M AA P R AA F AH L AE K S AH S
CHIROGRAPHER	CH AH R AA G R AH F AH R
CHIROGRAPHERS	CH AH R AA G R AH F AH R Z
CHIROGRAPHIC	CH AH R AA G R AH F AH K
CHIROGRAPHICAL	CH AH R AA G R AH F IH S AH L
CHIROGRAPHIES	CH AH R AA G R AH F AY Z
CHIROGRAPHY	CH AH R AA G R AH F IY
CHLORAMPHENICOL	K L AO R AH M F EH N AH K AH L
CHLORAMPHENICOLS	K L AO R AH M F EH N AH K AH L Z
CHLOROPHYLL	K L AO R AH F IH L
CHLOROPHYLLOUS	K L AO R AH F IH L AH S
CHLOROPHYLLS	K L AO R AH F AH L Z
CHOLANGIOGRAPHIC	CH AH L AE N JH IY AA G R AH F AH K
CHOLANGIOGRAPHIES	CH AH L AE N JH IY AA G R AH F AY Z
CHOLANGIOGRAPHY	CH AH L AE N JH IY AA G R AH F IY
CHOPHOUSE	CH AA P HH AW S
CHOPHOUSES	CH AA P HH AW S IH Z
CHOREOGRAPH	K AO R IY AH G R AE F
CHOREOGRAPHED	K AO R IY AH G R AE F T
CHOREOGRAPHER	K AO R IY AA G R AH F ER
CHOREOGRAPHERS	K AO R IY AA G R AH F ER Z
CHOREOGRAPHIC	K AO R IY AH G R AE F IH K
CHOREOGRAPHICALLY	K OW R IY AH G R AE F IH K AH L IY
CHOREOGRAPHIES	K OW R IY AA G R AH F IY Z
CHOREOGRAPHING	K AO R IY AA G R AH F IH NG
CHOREOGRAPHING(2)	K AO R IY AH G R AE F IH NG
CHOREOGRAPHS	K OW R IY AH G R AE F S
CHOREOGRAPHY	K AO R IY AA G R AH F IY
CHOROGRAPHER	CH AH R AA G R AH F AH R
CHOROGRAPHERS	CH AH R AA G R AH F AH R Z
CHOROGRAPHIC	CH AH R AA G R AH F AH K
CHOROGRAPHIES	CH AH R AA G R AH F AY Z
CHOROGRAPHY	CH AH R AA G R AH F IY
CHROMATOGRAPH	K R AA M AH T AA G R AH F
CHROMATOGRAPHED	K R AA M AH T AA G R AH F T
CHROMATOGRAPHER	K R AA M AH T AA G R AH F AH R
CHROMATOGRAPHERS	K R AA M AH T AA G R AH F AH R Z
CHROMATOGRAPHIC	K R OW M AE T AH G R AE F IH K
CHROMATOGRAPHICALLY	K R OW M AE T AH G R AE F IH K AH L IY
CHROMATOGRAPHIES	K R OW M AH T AA G R AH F IY Z
CHROMATOGRAPHING	K R AA M AH T AA G R AH F AH NG
CHROMATOGRAPHS	K R AA M AH T AA G R AH F S
CHROMATOGRAPHY	K R OW M AH T AA G R AH F IY
CHROMATOPHORE	K R AH M AE T AH F AH R
CHROMATOPHORES	K R AH M AE T AH F AH R Z
CHROMOLITHOGRAPH	K R AA M AH L AH TH AA G R AH F
CHROMOLITHOGRAPHED	K R AA M AH L AH TH AA G R AH F T
CHROMOLITHOGRAPHER	K R AA M AH L AH TH AA G R AH F AH R
CHROMOLITHOGRAPHERS	K R AA M AH L AH TH AA G R AH F AH R Z
CHROMOLITHOGRAPHIC	K R AA M AH L AH TH AA G R AH F AH K
CHROMOLITHOGRAPHIES	K R AA M AH L AH TH AA G R AH F AY Z
CHROMOLITHOGRAPHING	K R AA M AH L AH TH AA G R AH F AH NG
CHROMOLITHOGRAPHS	K R AA M AH L AH TH AA G R AH F S
CHROMOLITHOGRAPHY	K R AA M AH L AH TH AA G R AH F IY
CHROMOPHIL	K R AA M AH F AH L
CHROMOPHOBE	K R AA M AH F OW B
CHROMOPHORE	K R AA M AH F AH R
CHROMOPHORES	K R AA M AH F AH R Z
CHROMOPHORIC	K R AA M AH F AH R AH K
CHROMOSPHERE	K R AH M AA S AH R
CHROMOSPHERES	K R AA M AH S IY R Z
CHROMOSPHERIC	K R AH M AA S AH R AH K
CHRONOGRAPH	K R AH N AA G R AH F
CHRONOGRAPHIC	K R AH N AA G R AH F AH K
CHRONOGRAPHIES	K R AH N AA G R AH F AY Z
CHRONOGRAPHS	K R AH N AA G R AH F S
CHRONOGRAPHY	K R AH N AA G R AH F IY
CHRYSOPHYTE	K R IH S AH F AY T
CHRYSOPHYTES	K R IH S AH F AY T S
CINEMATOGRAPH	S IH N AH M AH T AA G R AH F
CINEMATOGRAPHER	S IH N IH M AH T AA G R AH F ER
CINEMATOGRAPHERS	S IH N AH M AH T AA G R AH F AH R Z
CINEMATOGRAPHIC	S IH N AH M AH T AA G R AH F AH K
CINEMATOGRAPHICALLY	S AH N EH M AH T AA G R AE F AH K AE L IY
CINEMATOGRAPHIES	S IH N AH M AH T AA G R AH F AY Z
CINEMATOGRAPHS	S IH N AH M AH T AA G R AH F S
CINEMATOGRAPHY	S IH N IH M AH T AA G R AH F IY
CIPHER	S AY F ER
CIPHERED	S AY F ER D
CIPHERING	S AY F ER IH NG
CIPHERS	S AY F ER Z
CIPHERTEXT	S AY F ER T EH K S T
CIPHERTEXTS	S AY F ER T EH K S T S
CIPHONIES	S IH F AH N AY Z
CIPHONY	S IH F AH N IY
CLADOPHYLL	K L AE D AH F AH L
CLADOPHYLLA	K L AE D AH F IH L AH
CLADOPHYLLS	K L AE D AH F AH L Z
CLADOPHYLLUM	K L AE D AH F IH L AH M
CLAUSTROPHOBE	K L AO S T R AH F OW B
CLAUSTROPHOBES	K L AO S T R AH F OW B Z
CLAUSTROPHOBIA	K L AO S T R AH F OW B IY AH
CLAUSTROPHOBIAS	K L AO S T R AH F OW B IY AH Z
CLAUSTROPHOBIC	K L AO S T R AH F OW B IH K
CLAUSTROPHOBICALLY	K L AO S T R AH F AA B AH K AE L IY
CLOMIPHENE	K L AA M AH F IY N
CLOMIPHENES	K L AA M AH F IY N Z
COLIPHAGE	K OW L IH F AH JH
COLIPHAGES	K OW L IH F AH JH AH Z
COLOPHON	K OW L AA F AH N
COLOPHONIES	K OW L AA P HH OW N IY Z
COLOPHONS	K OW L AA F AH N Z
COLOPHONY	K OW L AA P HH OW N IY
COMPUTERPHOBE	K AA M P Y UW T AH R F OW B
COMPUTERPHOBES	K AA M P Y UW T AH R F OW B Z
COMPUTERPHOBIA	K AA M P Y UW T AH R F OW B IY AH
COMPUTERPHOBIAS	K AA M P Y UW T AH R F OW B IY AH Z
COMPUTERPHOBIC	K AA M P Y AH T AH R F AH B AH K
CONIDIOPHORE	K AH N AH D IY AH F AH R
CONIDIOPHORES	K AH N AH D IY AH F AH R Z
COPROPHAGIES	K AA P R AH F AH JH AY Z
COPROPHAGOUS	K AA P R AH F EY JH AH S
COPROPHAGY	K AA P R AA F AH JH IY
COPROPHILIA	K AA P R AH F IH L Y AH
COPROPHILIAC	K AA P R AH F IH L IY AH K
COPROPHILIACS	K AA P R AH F IH L IY AH S
COPROPHILIAS	K AA P R AH F IH L Y AH Z
COPROPHILOUS	K AA P R AH F AY L AH S
CORONAGRAPH	K AH R OW N AH G R AE F
CORONAGRAPHS	K AH R OW N AH G R AE F S
CORONOGRAPH	K OW R AH N AA G R AH F
CORONOGRAPHS	K OW R AH N AA G R AH F S
CORTICOTROPHIN	K AA R T AH K AA T R AH F AH N
CORTICOTROPHINS	K AA R T AH K AA T R AH F AH N Z
CORYPHAEI	K OW R IH F IY IY
CORYPHAEUS	K OW R IH F IY AH S
CORYPHEE	K OW R AH F IY IY
CORYPHEES	K OW R AH F IY Z
COSMOGRAPHER	K AA S M AA G R AH F AH R
COSMOGRAPHERS	K AA S M AA G R AH F AH R Z
COSMOGRAPHIC	K AA S M AA G R AH F AH K
COSMOGRAPHICAL	K AA S M AA G R AH F IH S AH L
COSMOGRAPHIES	K AA S M AA G R AH F AY Z
COSMOGRAPHY	K AA S M AA G R AH F IY
CRYOPHILIC	K R AY AH F AY L AH K
CRYPTOGRAPH	K R IH P T AA G R AH F
CRYPTOGRAPHER	K R IH P T AA G R AH F AH R
CRYPTOGRAPHERS	K R IH P T AA G R AH F AH R Z
CRYPTOGRAPHIC	K R IH P T AH G R AE F IH K
CRYPTOGRAPHICALLY	K R IH P T AH G R AE F IH K AH L IY
CRYPTOGRAPHIES	K R IH P T AA G R AH F AY Z
CRYPTOGRAPHS	K R IH P T AA G R AH F S
CRYPTOGRAPHY	K R IH P T AA G R AH F IY
CRYSTALLOGRAPHER	K R IH S T AH L AA G R AH F ER
CRYSTALLOGRAPHERS	K R IH S T AH L AA G R AH F ER Z
CRYSTALLOGRAPHIC	K R IH S T AH L OW G R AE F IH K
CRYSTALLOGRAPHICALLY	K R IH S T AH L OW G R AE F IH K AH L IY
CRYSTALLOGRAPHIES	K R IH S T AH L AA G R AH F IY Z
CRYSTALLOGRAPHY	K R IH S T AH L AA G R AH F IY
CTENOPHORAN	K T AH N AA F AH R AH N
CTENOPHORANS	K T AH N AA F AH R AH N Z
CTENOPHORE	K T EH N AH F AH R
CTENOPHORES	K T EH N AH F AH R Z
CYCADOPHYTE	S AH K AE D AH F AY T
CYCADOPHYTES	S AH K AE D AH F AY T S
CYCLOALIPHATIC	S IH K L OW L AH F AH T AH K
CYCLOPHOSPHAMIDE	S IH K L AH F AA S AH M AY D
CYCLOPHOSPHAMIDES	S IH K L AH F AA S AH M AY D Z
CYMOPHANE	S IH M AH F EY N
CYMOPHANES	S IH M AH F EY N Z
CYPHER	S AY F ER
CYPHERED	S AH F IY R D
CYPHERING	S AH F IY R AH NG
CYPHERS	S AY F ER Z
CYTOPHILIC	S IH T AH F AY L AH K
CYTOPHOTOMETRIC	S IH T AH F AA T AH M AH T R AH K
CYTOPHOTOMETRIES	S AH T AH F AH T AH M EH T R AY Z
CYTOPHOTOMETRY	S AH T AA F AH T AH M EH T R IY
DAPHNE	D AE F N IY
DAPHNES	D AE F N Z
DAPHNIA	D AE F N IY AH
DAPHNIAS	D AE F N IY AH Z
DAUPHIN	D AW F IH N
DAUPHINE	D AO F IY N
DAUPHINES	D AO F IY N Z
DAUPHINS	D AO F AH N Z
DECIPHER	D IH S AY F ER
DECIPHERABLE	D IY S AY F ER AH B AH L
DECIPHERED	D IH S AY F ER D
DECIPHERER	D IY S AY F ER ER
DECIPHERERS	D IY S AY F ER ER Z
DECIPHERING	D AH S AY F ER IH NG
DECIPHERMENT	D IY S AY F ER M AH N T
DECIPHERMENTS	D IY S AY F ER M AH N T S
DECIPHERS	D IY S AY F ER Z
DEEMPHASIZE	D IY EH M F AH S AY Z
DEEMPHASIZED	D IY EH M F AH S AY Z D
DEEMPHASIZES	D IY EH M F AH S AY Z IH Z
DEEMPHASIZING	D IY EH M F AH S AY Z IH NG
DELPHIC	D EH L F IH K
DELPHICALLY	D IH L F AH K AE L IY
DELPHINIUM	D IH L F IH N IY AH M
DELPHINIUMS	D IH L F IH N IY AH M Z
DEMOGRAPHER	D IH M AA G R AH F ER
DEMOGRAPHERS	D IH M AA G R AH F ER Z
DEMOGRAPHIC	D EH M AH G R AE F IH K
DEMOGRAPHICAL	D EH M AH G R AE F IH K AH L
DEMOGRAPHICALLY	D EH M AH G R AE F IH K L IY
DEMOGRAPHICS	D EH M AH G R AE F IH K S
DEMOGRAPHIES	D IH M AA G R AH F IY Z
DEMOGRAPHY	D IH M AA G R AH F IY
DEPHOSPHORYLATE	D IY F AA S F ER IY L EY T
DEPHOSPHORYLATED	D IY F AA S F ER IY L EY T IH D
DEPHOSPHORYLATES	D IY F AA S F ER IY L EY T S
DEPHOSPHORYLATING	D IY F AA S F ER IY L EY T IH NG
DEPHOSPHORYLATION	D IY F AA S F ER IY L EY SH AH N
DEPHOSPHORYLATIONS	D IY F AA S F ER IY L EY SH AH N Z
DERMATOGLYPHIC	D IH R M AH T AA G L AH F AH K
DERMATOGLYPHICS	D IH R M AH T AA G L AH F AH S Z
DERMATOPHYTE	D IH R M AE T AH F AY T
DERMATOPHYTES	D IH R M AE T AH F AY T S
DEXTROAMPHETAMINE	D IH Z T R OW M F EH T AH M AY N
DEXTROAMPHETAMINES	D IH Z T R OW M F EH T AH M AY N Z
DIADELPHOUS	D AY AH D EH L F AH S
DIAGRAPH	D AY AE G R AH F
DIAGRAPHS	D AY AE G R AH F S
DIAPHANEITIES	D AY AH F AH N AH T AY Z
DIAPHANEITY	D AY AH F AH N IY AH T IY
DIAPHANOUS	D AY AE F AH N IH S
DIAPHANOUSLY	D AY AE F AH N AH S L IY
DIAPHANOUSNESS	D AY AE F AH N AH S N AH S
DIAPHANOUSNESSES	D AY AE F AH N AH S N AH S IH Z
DIAPHONE	D AY AH F OW N
DIAPHONES	D AY AH F OW N Z
DIAPHONIES	D AY AE F AH N AY Z
DIAPHONY	D AY AE F AH N IY
DIAPHORASE	D AY AE F AH R EY Z
DIAPHORASES	D AY AE F AH R EY Z AH Z
DIAPHORESES	D AY AE F AH R IY Z AH Z
DIAPHORESIS	D AY AH F AO R AH S AH S
DIAPHORETIC	D AY AE F AH R AH T AH K
DIAPHORETICS	D AY AH F AO R AH T AH S Z
DIAPHRAGM	D AY AH F R AE M
DIAPHRAGMATIC	D AY AH F R AE M AH T IH K
DIAPHRAGMATICALLY	D AY AH F R AE M AH T IH K AH L IY
DIAPHRAGMS	D AY AH F R AE M Z
DIAPHYSEAL	D AY AH F IH Z IY AH L
DIAPHYSES	D AY AH F AY Z AH Z
DIAPHYSIAL	D AY AH F IH Z IY AH L
DIAPHYSIS	D AY AE F AH S AH S
DIASTROPHIC	D AY AE S T R AH F AH K
DIASTROPHICALLY	D AY AE S T R AA F AH K AE L IY
DIASTROPHISM	D AY AE S T R AH F IH Z AH M
DIASTROPHISMS	D AY AE S T R AH F AH Z AH M Z
DIENCEPHALA	D IY N S EH F AH L AH
DIENCEPHALIC	D IY N S AH F AH L AH K
DIENCEPHALON	D IY N S EH F AH L AH N
DIENCEPHALONS	D IY N S EH F AH L AH N Z
DIGRAPH	D IH G R AH F
DIGRAPHIC	D IH G R AH F AH K
DIGRAPHICALLY	D IH G R AE F AH K AE L IY
DIGRAPHS	D IH G R AH F S
DIMORPH	D IH M AH R F
DIMORPHIC	D AY M AO R F IH K
DIMORPHISM	D AY M AO R F IH Z AH M
DIMORPHISMS	D AH M AO R F AH Z AH M Z
DIMORPHOUS	D AH M AO R F AH S
DIMORPHS	D IH M AH R F S
DINITROPHENOL	D IH N AH T R AA F AH N AH L
DINITROPHENOLS	D IH N AH T R AA F AH N AH L Z
DIPHASE	D AH F EY Z
DIPHASIC	D IH F AH Z AH K
DIPHENHYDRAMINE	D AH F AH N HH IH D R AH M AY N
DIPHENHYDRAMINES	D AH F AH N HH IH D R AH M AY N Z
DIPHENYL	D IH F AH N AH L
DIPHENYLAMINE	D AH F AH N IH L AH M AY N
DIPHENYLAMINES	D AH F AH N IH L AH M AY N Z
DIPHENYLHYDANTOIN	D AH F AH N IH L HH IH D AH N T OY N
DIPHENYLHYDANTOINS	D AH F AH N IH L HH IH D AH N T OY N Z
DIPHENYLS	D IH F AH N AH L Z
DIPHOSGENE	D IH F AH Z IY N
DIPHOSGENES	D IH F AH Z IY N Z
DIPHOSPHATE	D IH F AH S EY T
DIPHOSPHATES	D IH F AH S EY T S
DIPHTHERIA	D IH F TH IH R IY AA
DIPHTHERIAL	D IH F TH IY R IY AH L
DIPHTHERIAS	D IH F TH IY R IY AH Z
DIPHTHERITIC	D IH F TH AH R AH T AH K
DIPHTHEROID	D IH F TH AH R OY D
DIPHTHEROIDS	D IH F TH AH R OY D Z
DIPHTHONG	D IH F TH AO NG
DIPHTHONGAL	D IH F TH AA N G AH L
DIPHTHONGIZATION	D IH F TH AA N JH AH Z EY SH AH N
DIPHTHONGIZATIONS	D IH F TH AA N JH AH Z EY T IY AH N Z
DIPHTHONGIZE	D IH F TH AH N JH AY Z
DIPHTHONGIZED	D IH F TH AH N JH AY Z D
DIPHTHONGIZES	D IH F TH AH N JH AY Z AH Z
DIPHTHONGIZING	D IH F TH AH N JH AY Z AH NG
DIPHTHONGS	D IH F TH AH NG Z
DIPHYLETIC	D IH F AH L AH T AH K
DIPHYODONT	D AH F AY AH D AH N T
DIPLOPHASE	D IH P L AH F EY Z
DIPLOPHASES	D IH P L AH F EY Z AH Z
DISCOGRAPHER	D IH S K OW G R AE F ER
DISCOGRAPHERS	D IH S K OW G R AE F ER Z
DISCOGRAPHIC	D IH S K OW G R AE F IH K
DISCOGRAPHICAL	D IH S K OW G R AE F IH K AH L
DISCOGRAPHIES	D IH S K OW G R AE F IY Z
DISCOGRAPHY	D IH S K AO G R AH F IY
DISCOPHILE	D IH S AH F AY L
DISCOPHILES	D IH S AH F AY L Z
DODECAPHONIC	D UW D IY K AE P HH OW N IH K
DODECAPHONICALLY	D UW D IY K AE P HH OW N IH K AH L IY
DODECAPHONIES	D UW D IY K AE P HH OW N IY Z
DODECAPHONIST	D UW D IY K AE P HH OW N IH S T
DODECAPHONISTS	D UW D IY K AE P HH OW N IH S T S
DODECAPHONY	D UW D IY K AE P HH OW N IY
DOLICHOCEPHALIC	D AA L AH CH AA S AH F AH L AH K
DOLICHOCEPHALIES	D AA L AH CH AH S EH F AH L AY Z
DOLICHOCEPHALY	D AA L AH CH AH S EH F AH L IY
DOLPHIN	D AA L F AH N
DOLPHINFISH	D AA L F AH N F IH SH
DOLPHINFISHES	D AA L F AH N F IH SH IH Z
DOLPHINS	D AA L F AH N Z
DROPHEAD	D R AA P HH EH D
DROPHEADS	D R AA P HH EH D Z
DROSOPHILA	D R AH S AA F AH L AH
DROSOPHILAE	D R AH S AA F AH L IY
DROSOPHILAS	D R AH S AA F AH L AH Z
DYSPHAGIA	D IH S EY JH IY AH
DYSPHAGIAS	D IH S EY JH IY AH Z
DYSPHASIA	D IH S EY ZH IY AH
DYSPHASIAS	D IH S EY S IY AH Z
DYSPHASIC	D IH S AH Z AH K
DYSPHASICS	D IH S AH Z AH S Z
DYSPHEMISM	D IH S AH M IH Z AH M
DYSPHEMISMS	D IH S AH M AH Z AH M Z
DYSPHEMISTIC	D IH S AH M AH S T AH K
DYSPHONIA	D IH S OW N Y AH
DYSPHONIAS	D IH S OW N Y AH Z
DYSPHORIA	D IH S AO R IY AH
DYSPHORIAS	D IH S AO R IY AH Z
DYSPHORIC	D IH S F AO R IH K
DYSTROPHIC	D IH S T R AH F AH K
DYSTROPHIES	D IH S T R AH F IY Z
DYSTROPHY	D IH S T R AH F IY
EARPHONE	IH R F OW N
EARPHONE(2)	IY R F OW N
EARPHONES	IH R F OW N Z
EARPHONES(2)	IY R F OW N Z
ECHOCARDIOGRAPHER	AH CH AH K AA R D IY AA G R AH F AH R
ECHOCARDIOGRAPHERS	AH CH AH K AA R D IY AA G R AH F AH R Z
ECHOCARDIOGRAPHIC	AH CH AH K AA R D IY AA G R AH F AH K
ECHOCARDIOGRAPHIES	AH CH AH K AA R D IY AA G R AH F AY Z
ECHOCARDIOGRAPHY	AH CH AH K AA R D IY AA G R AH F IY
ECOCATASTROPHE	EH K AH K AH T AE S T R AH F
ECOCATASTROPHES	EH K AH K AH T AE S T R AH F S
ECOPHYSIOLOGICAL	AH K AA F AH S IY AA L AH JH IH S AH L
ECOPHYSIOLOGIES	AH K AA F AH S IY AA L AH JH AY Z
ECOPHYSIOLOGY	AH K AA F AH S IY AA L AH JH IY
ECOSPHERE	AH K AA S AH R
ECOSPHERES	EH K AH S IY R Z
ECTOMORPH	EH K T AH M AH R F
ECTOMORPHIC	EH K T AH M AH R F AH K
ECTOMORPHS	EH K T AH M AH R F S
ECTOTROPHIC	EH K T AA T R AH F AH K
EDAPHIC	EH D AH F AH K
EDAPHICALLY	AH D AE F AH K AE L IY
ELAPHINE	EH L AH F AY N
ELECTROCARDIOGRAPH	IH L EH K T R OW K AA R D IY AH G R AE F
ELECTROCARDIOGRAPHIC	IH L EH K T R OW K AA R D IY AH G R AE F IH K
ELECTROCARDIOGRAPHICALLY	IH L EH K T R OW K AA R D IY AH G R AE F IH K AH L IY
ELECTROCARDIOGRAPHIES	IH L EH K T R OW K AA R D IY AH G R AE F IY Z
ELECTROCARDIOGRAPHS	IH L EH K T R OW K AA R D IY AH G R AE F S
ELECTROCARDIOGRAPHY	IH L EH K T R OW K AA R D IY AH G R AE F IY
ELECTROENCEPHALOGRAM	AH L AH K T R OW EH N S AH F AH L AA G R AH M
ELECTROENCEPHALOGRAMS	AH L AH K T R OW EH N S AH F AH L AA G R AH M Z
ELECTROENCEPHALOGRAPH	AH L AH K T R OW EH N S AH F AH L AA G R AH F
ELECTROENCEPHALOGRAPHER	AH L AH K T R OW EH N S AH F AH L AA G R AH F AH R
ELECTROENCEPHALOGRAPHERS	AH L AH K T R OW EH N S AH F AH L AA G R AH F AH R Z
ELECTROENCEPHALOGRAPHIC	AH L AH K T R OW EH N S AH F AH L AA G R AH F AH K
ELECTROENCEPHALOGRAPHICALLY	AH L AH K T R OW AH N S EH F AH L AA G R AE F AH K AE L IY
ELECTROENCEPHALOGRAPHIES	AH L AH K T R OW EH N S AH F AH L AA G R AH F AY Z
ELECTROENCEPHALOGRAPHS	AH L AH K T R OW EH N S AH F AH L AA G R AH F S
ELECTROENCEPHALOGRAPHY	AH L AH K T R OW EH N S AH F AH L AA G R AH F IY
ELECTROMYOGRAPH	AH L EH K T R AH M AY AA G R AH F
ELECTROMYOGRAPHIC	AH L EH K T R AH M AY AA G R AH F AH K
ELECTROMYOGRAPHICALLY	AH L AH K T R AA M AY AA G R AE F AH K AE L IY
ELECTROMYOGRAPHIES	AH L EH K T R AH M AY AA G R AH F AY Z
ELECTROMYOGRAPHS	AH L EH K T R AH M AY AA G R AH F S
ELECTROMYOGRAPHY	AH L EH K T R AH M AY AA G R AH F IY
ELECTROOCULOGRAPHIES	AH L AH K T R UH K Y AH L AA G R AH F AY Z
ELECTROOCULOGRAPHY	AH L AH K T R UH K Y AH L AA G R AH F IY
ELECTROPHEROGRAM	AH L EH K T R AH F AH R AA G R AH M
ELECTROPHEROGRAMS	AH L EH K T R AH F AH R AA G R AH M Z
ELECTROPHILE	AH L EH K T R AH F AY L
ELECTROPHILES	AH L EH K T R AH F AY L Z
ELECTROPHILIC	AH L EH K T R AH F AY L AH K
ELECTROPHILICITIES	AH L EH K T R AH F AH L IH S AH T AY Z
ELECTROPHILICITY	AH L EH K T R AH F AH L IH S AH T IY
ELECTROPHORESE	AH L EH K T R AA F AH R IY Z
ELECTROPHORESED	AH L EH K T R AH F AH R Z D
ELECTROPHORESES	AH L EH K T R AA F AH R IY Z AH Z
ELECTROPHORESING	AH L EH K T R AA F AH R IY Z AH NG
ELECTROPHORESIS	IH L EH K T R OW F AO R IH S IH S
ELECTROPHORETIC	EH L AH K T R AA F AH R AH T AH K
ELECTROPHORETICALLY	AH L EH K T R AH F AH R EH T AH K AE L IY
ELECTROPHORETOGRAM	IH L EH K T R OW F AH R EH T AH G R AE M
ELECTROPHORETOGRAMS	AH L AH K T R AA F AH R AH T AA G R AH M Z
ELECTROPHORI	EH L AH K T R AA F AH R IY
ELECTROPHORUS	IH L EH K T R AA F AH R AH S
ELECTROPHOTOGRAPHIC	AH L EH K T R AH F AH T AA G R AH F AH K
ELECTROPHOTOGRAPHIES	AH L EH K T R AH F AH T AA G R AH F AY Z
ELECTROPHOTOGRAPHY	AH L EH K T R AH F AH T AA G R AH F IY
ELECTROPHYSIOLOGIC	AH L EH K T R AH F AH S IY AH L AH JH AH K
ELECTROPHYSIOLOGICAL	AH L EH K T R AA F AH S IY AA L AH JH IH S AH L
ELECTROPHYSIOLOGICALLY	AH L AH K T R AH F IH S IY AH L AA JH AH K AE L IY
ELECTROPHYSIOLOGIES	AH L AH K T R AA F AH S IY AA L AH JH AY Z
ELECTROPHYSIOLOGIST	AH L EH K T R AA F AH S IY AA L AH JH AH S T
ELECTROPHYSIOLOGISTS	AH L AH K T R AA F AH S IY AA L AH JH AH S T S
ELECTROPHYSIOLOGY	AH L EH K T R AA F AH S IY AA L AH JH IY
ELECTRORETINOGRAPH	AH L AH K T R AO R AH T AH N AA G R AH F
ELECTRORETINOGRAPHIC	AH L AH K T R AO R AH T AH N AA G R AH F AH K
ELECTRORETINOGRAPHIES	AH L AH K T R AO R AH T AH N AA G R AH F AY Z
ELECTRORETINOGRAPHS	AH L AH K T R AO R AH T AH N AA G R AH F S
ELECTRORETINOGRAPHY	AH L AH K T R AO R AH T AH N AA G R AH F IY
ELEPHANT	EH L AH F AH N T
ELEPHANTIASES	AH L AH F AE N T IY EY Z AH Z
ELEPHANTIASIS	EH L IH F AH N T AY AH S IH S
ELEPHANTINE	EH L AH F AE N T IY N
ELEPHANTS	EH L AH F AH N T S
EMBRYOPHYTE	IH M B R AY AH F AY T
EMBRYOPHYTES	IH M B R AY AH F AY T S
EMPHASES	EH M F AH S IY Z
EMPHASIS	EH M F AH S IH S
EMPHASISE	IH M F AH S AY Z
EMPHASISED	EH M F AH S AH S T
EMPHASISES	EH M F AH S AH S IH Z
EMPHASISING	EH M F AH S AH S IH NG
EMPHASIZE	EH M F AH S AY Z
EMPHASIZED	EH M F AH S AY Z D
EMPHASIZES	EH M F AH S AY Z IH Z
EMPHASIZING	EH M F AH S AY Z IH NG
EMPHATIC	EH M F AE T IH K
EMPHATICALLY	EH M F AE T IH K AH L IY
EMPHYSEMA	EH M F AH Z IY M AH
EMPHYSEMAS	EH M F AH S IY M AH Z
EMPHYSEMATOUS	EH M F AH S IY M AH T AH S
EMPHYSEMIC	IH M F IH S AH M AH K
ENANTIOMORPH	AH N AH N T AY AA M AH R F
ENANTIOMORPHIC	AH N AH N T AY AA M AH R F AH K
ENANTIOMORPHISM	AH N AH N T AY AA M AH R F IH Z AH M
ENANTIOMORPHISMS	AH N AH N T AY AH M AO R F AH Z AH M Z
ENANTIOMORPHOUS	AH N AH N T AY AH M AO R F AH S
ENANTIOMORPHS	AH N AH N T AY AA M AH R F S
ENCEPHALA	IH N S EH F AH L AH
ENCEPHALITIC	IH N S EH F AH L AH T AH K
ENCEPHALITIDES	IH N S AH F AE L AH T AY D Z
ENCEPHALITIS	EH N S EH F AH L AY T AH S
ENCEPHALITOGEN	IH N S AH F AH L IH T AH JH AH N
ENCEPHALITOGENIC	IH N S EH F AH L IH T AH JH AH N AH K
ENCEPHALITOGENS	IH N S EH F AH L IH T AH JH AH N Z
ENCEPHALOGRAM	IH N S EH F AH L AA G R AH M
ENCEPHALOGRAMS	IH N S EH F AH L AA G R AH M Z
ENCEPHALOGRAPH	IH N S EH F AH L AA G R AH F
ENCEPHALOGRAPHIES	IH N S EH F AH L AA G R AH F AY Z
ENCEPHALOGRAPHS	IH N S EH F AH L AA G R AH F S
ENCEPHALOGRAPHY	IH N S EH F AH L AA G R AH F IY
ENCEPHALOMYELITIDES	IH N S AH F AH L AH M AY EH L AH T AY D Z
ENCEPHALOMYELITIS	IH N S EH F AH L AA M AY AH L AY T AH S
ENCEPHALOMYOCARDITIS	IH N S EH F AH L AH M AY AH K AH R D AY T AH S
ENCEPHALOMYOCARDITISES	IH N S AH F AH L AH M AY AH K AA R D AH T AY Z AH Z
ENCEPHALON	IH N S EH F AH L AH N
ENCEPHALOPATHIC	IH N S AH F AE L AH P AH TH AH K
ENCEPHALOPATHIES	IH N S AH F AH L AA P AH TH AY Z
ENCEPHALOPATHY	EH N S EH F AH L AO P AH TH IY
ENCIPHER	EH N S AY F ER
ENCIPHERED	EH N S AY F ER D
ENCIPHERER	EH N S AY F ER ER
ENCIPHERERS	EH N S AY F ER ER Z
ENCIPHERING	EH N S AY F ER IH NG
ENCIPHERMENT	EH N S AY F ER M AH N T
ENCIPHERMENTS	EH N S AY F ER M AH N T S
ENCIPHERS	EH N S AY F ER Z
ENDOLYMPH	EH N D UW L IH M F
ENDOLYMPHATIC	EH N D UW L IH M F AH T IH K
ENDOLYMPHS	EH N D UW L IH M F S
ENDOMORPH	EH N D UW M AO R F
ENDOMORPHIC	EH N D UW M AO R F IH K
ENDOMORPHIES	EH N D UW M AO R F IY Z
ENDOMORPHISM	EH N D UW M AO R F IH Z AH M
ENDOMORPHISMS	EH N D UW M AO R F IH Z AH M Z
ENDOMORPHS	EH N D UW M AO R F S
ENDOMORPHY	EH N D UW M AO R F IY
ENDOPHYTE	IH N D AH F AY T
ENDOPHYTES	IH N D AH F AY T S
ENDOPHYTIC	IH N D AA F AH T AH K
ENDORPHIN	EH N D AO R F IH N
ENDORPHINS	EH N D AO R F IH N Z
ENDOTROPHIC	IH N D AA T R AH F AH K
ENKEPHALIN	IH N K EH F AH L AH N
ENKEPHALINS	IH N K EH F AH L AH N Z
ENSPHERE	EH N S F IH ER
ENSPHERED	EH N S F IH ER D
ENSPHERES	EH N S F IH ER Z
ENSPHERING	EH N S F IH ER IH NG
ENTOMOPHAGOUS	IH N T AA M AH F EY JH AH S
ENTOMOPHILIES	IH N T AH M AA F AH L AY Z
ENTOMOPHILOUS	IH N T AA M AH F AY L AH S
ENTOMOPHILY	IH N T AH M AA F AH L IY
EOSINOPHIL	IY AH S IH N AH F AH L
EOSINOPHILIA	IY AO S IH N AH F IH L Y AH
EOSINOPHILIAS	IY AA S AH N AH F IH L Y AH Z
EOSINOPHILIC	IY AO S IH N AH F IH L IH K
EOSINOPHILS	IY AH S IH N AH F AY L Z
EPHA	EH F AH
EPHAH	EH F AH
EPHAHS	EH F AH Z
EPHAS	EH F AH Z
EPHEBE	AH F IY B
EPHEBES	AH F IY B Z
EPHEBI	EH F AH B IY
EPHEBIC	EH F AH B AH K
EPHEBOI	EH F AH B OY
EPHEBOS	EH F AH B AH Z
EPHEBUS	EH F AH B AH S
EPHEDRA	AH F EH D R AH
EPHEDRAS	AH F EH D R AH Z
EPHEDRIN	AH F EH D R AH N
EPHEDRINE	IH F EH D R IH N
EPHEDRINES	EH F AH D R AY N Z
EPHEDRINS	AH F EH D R AH N Z
EPHEMERA	AH F EH M AH R AH
EPHEMERAE	AH F EH M AH R IY
EPHEMERAL	IH F EH M ER AH L
EPHEMERALITIES	IH F EH M AH R AH L AH T IY Z
EPHEMERALITY	IH F EH M AH R AH L AH T IY
EPHEMERALLY	IH F EH M AH R AH L IY
EPHEMERALS	IH F EH M AH R AH L Z
EPHEMERAS	AH F EH M AH R AH Z
EPHEMERID	AH F EH M AH R AH D
EPHEMERIDES	AH F EH M AH R AY D Z
EPHEMERIDS	AH F EH M AH R AH D Z
EPHEMERIS	AH F EH M AH R AH S
EPHEMERON	AH F EH M AH R AH N
EPHOD	EH F AH D
EPHODS	EH F AH D Z
EPHOR	EH F AH R
EPHORAL	EH F AH R AH L
EPHORATE	EH F AH R EY T
EPHORATES	EH F AH R EY T S
EPHORI	EH F AH R IY
EPHORS	EH F AH R Z
EPIGRAPH	EH P AH G R AE F
EPIGRAPHER	EH P AH G R AE F ER
EPIGRAPHERS	EH P AH G R AE F ER Z
EPIGRAPHIC	EH P IH G R AE F IH K
EPIGRAPHICAL	EH P AH G R AE F IH K AH L
EPIGRAPHICALLY	EH P AH G R AE F IH K AH L IY
EPIGRAPHIES	EH P AH G R AE F IY Z
EPIGRAPHIST	EH P AH G R AE F IH S T
EPIGRAPHISTS	EH P AH G R AE F IH S T S
EPIGRAPHS	EH P AH G R AE F S
EPIGRAPHY	EH P AH G R AE F IY
EPINEPHRIN	EH P AH N EH F R AH N
EPINEPHRINE	AH P IH N AH F R AY N
EPINEPHRINES	AH P IH N AH F R AY N Z
EPINEPHRINS	EH P AH N EH F R AH N Z
EPIPHANIC	EH P AH F AH N AH K
EPIPHANIES	IH P IH F AH N IY Z
EPIPHANOUS	AH P IH F AH N AH S
EPIPHANY	IH P IH F AH N IY
EPIPHENOMENA	EH P AH F AH N AA M AH N AH
EPIPHENOMENAL	EH P AH F AH N AA M AH N AH L
EPIPHENOMENALISM	EH P AH F AH N AA M AH N AH L IH Z AH M
EPIPHENOMENALISMS	AH P IH F AH N AH M EH N AH L AH Z AH M Z
EPIPHENOMENALLY	EH P AH F AH N AA M AH N AE L IY
EPIPHENOMENON	EH P AH F AH N AA M AH N AH N
EPIPHRAGM	AH P IH F R AH M
EPIPHRAGMS	AH P IH F R AH M Z
EPIPHYSEAL	EH P AH F IH Z IY AH L
EPIPHYSES	EH P AH F AY Z AH Z
EPIPHYSIAL	EH P AH F IH Z IY AH L
EPIPHYSIS	IH P IH F AH S AH S
EPIPHYTE	EH P AH F AY T
EPIPHYTES	EH P AH F AY T S
EPIPHYTIC	EH P AH F AH T AH K
EPIPHYTICALLY	EH P AH F IH T AH K AE L IY
EPIPHYTISM	EH P AH F AH T IH Z AH M
EPIPHYTISMS	AH P IH F AH T AH Z AH M Z
EPIPHYTOLOGIES	EH P AH F AH T AA L AH JH AY Z
EPIPHYTOLOGY	EH P AH F AH T AA L AH JH IY
EPIPHYTOTIC	AH P IH F AH T AH T AH K
EPIPHYTOTICS	EH P AH F IH T AH T AH S Z
EPISTROPHE	AH P IH S T R AH F
EPISTROPHES	AH P IH S T R AH F S
EPITAPH	EH P AH T AE F
EPITAPHIAL	EH P AH T AE F IY AH L
EPITAPHIC	EH P AH T AE F IH K
EPITAPHS	EH P AH T AE F S
ERGOGRAPH	AH R G AA G R AH F
ERGOGRAPHS	AH R G AA G R AH F S
ERIOPHYID	IY R IY AA F AY AH D
ERIOPHYIDS	IY R IY AA F AY AH D Z
ESOPHAGEAL	EH S AH F IH JH IY AH L
ESOPHAGI	AH S AA F AH JH IY
ESOPHAGUS	IH S AA F AH G AH S
ESOPHAGUSES	AH S AA F AH G Y UW Z AH Z
ETHEPHON	EH TH AH F AH N
ETHEPHONS	EH TH AH F AH N Z
ETHNOGRAPHER	EH TH N AA G R AH F AH R
ETHNOGRAPHERS	EH TH N AA G R AH F AH R Z
ETHNOGRAPHIC	EH TH N AH G R AE F IH K
ETHNOGRAPHICAL	EH TH N AA G R AH F IH S AH L
ETHNOGRAPHICALLY	EH TH N AA G R AE F AH K AE L IY
ETHNOGRAPHIES	EH TH N AA G R AH F AY Z
ETHNOGRAPHY	EH TH N AA G R AH F IY
EUPHAUSIID	Y UW F AH S IY D
EUPHAUSIIDS	Y UW F AH S IY D Z
EUPHEMISE	Y UW F AH M AY Z
EUPHEMISED	Y UW F AH M AH S T
EUPHEMISES	Y UW F AH M AY Z AH Z
EUPHEMISING	Y UW F AH M AY Z AH NG
EUPHEMISM	Y UW F AH M IH Z AH M
EUPHEMISMS	Y UW F AH M IH Z AH M Z
EUPHEMIST	Y UW F AH M AH S T
EUPHEMISTIC	Y UW F AH M IH S T IH K
EUPHEMISTICALLY	Y UW F AH M IH S T IH K L IY
EUPHEMISTS	Y UW F AH M AH S T S
EUPHEMIZE	Y UW F AH M AY Z
EUPHEMIZED	Y UW F AH M AY Z D
EUPHEMIZER	Y UW F AH M AY Z AH R
EUPHEMIZERS	Y UW F EH M AH Z AH R Z
EUPHEMIZES	Y UW F AH M AY Z AH Z
EUPHEMIZING	Y UW F AH M AY Z AH NG
EUPHENIC	Y UW F AH N AH K
EUPHENICS	Y UW F AH N AH S Z
EUPHONIC	Y UW F AH N AH K
EUPHONICALLY	Y UW F AA N AH K AE L IY
EUPHONIES	Y UW F AH N AY Z
EUPHONIOUS	Y UW F OW N IY AH S
EUPHONIOUSLY	Y UW F AH N IY OW AH S L IY
EUPHONIOUSNESS	Y UW F OW N IY AW Z N AH S
EUPHONIOUSNESSES	Y UW F OW N IY AW Z N EH S AH Z
EUPHONIUM	Y UW F OW N IY AH M
EUPHONIUMS	Y UW F OW N IY AH M Z
EUPHONY	Y UW F AH N IY
EUPHORBIA	Y UW F AO R B IY AH
EUPHORBIAS	Y UW F AO R B IY AH Z
EUPHORIA	Y UW F AO R IY AH
EUPHORIANT	Y UW F AO R AY AH N T
EUPHORIANTS	Y UW F AO R IY AH N T S
EUPHORIAS	Y UH F OW R IY AH Z
EUPHORIC	Y UW F AO R IH K
EUPHORICALLY	Y UH F AO R IH K AH L IY
EUPHOTIC	Y UW F AH T AH K
EUPHRASIES	Y UW F R AH S AY Z
EUPHRASY	Y UW F R AH Z IY
EUPHROE	Y UW F R OW
EUPHROES	Y UW F R OW Z
EUPHUISM	Y UW F Y UW IH Z AH M
EUPHUISMS	Y UW F UW Z AH M Z
EUPHUIST	Y UW F Y UW AH S T
EUPHUISTIC	Y UW F UW S T AH K
EUPHUISTICALLY	Y UW F UW S T AH K AE L IY
EUPHUISTS	Y UW F UW S T S
EUTROPHIC	Y UW T R AH F AH K
EUTROPHICATION	Y UW T R AA F AH S EY SH AH N
EUTROPHICATIONS	Y UW T R AH F AH K EY T IY AH N Z
EUTROPHIES	Y UW T R AH F AY Z
EUTROPHY	Y UW T R AH F IY
EXOPHTHALMIC	IH G Z AA F TH AH M AH K
EXOPHTHALMOS	IH G Z AA F TH AE L M AH Z
EXOPHTHALMOSES	IH G Z AA F TH AH L M OW Z AH Z
EXOPHTHALMUS	IH G Z AA F TH AH M AH S
EXOPHTHALMUSES	IH G Z AA F TH AH L M Y UW Z AH Z
EXOSPHERE	IH G Z AA S AH R
EXOSPHERES	IH G Z AA S IY R Z
EXOSPHERIC	IH G Z AA S AH R AH K
FILMOGRAPHIES	F IH L M AA G R AH F AY Z
FILMOGRAPHY	F IH L M AA G R AH F IY
FLEXOGRAPHIC	F L EH K S AA G R AH F AH K
FLEXOGRAPHICALLY	F L EH K S AA G R AE F AH K AE L IY
FLEXOGRAPHIES	F L EH K S AA G R AH F AY Z
FLEXOGRAPHY	F L EH K S AA G R AH F IY
FLOPHOUSE	F L AA P HH AW S
FLOPHOUSES	F L AA P HH AW S IH Z
FLUOROGRAPHIC	F L UW W AH R AA G R AH F AH K
FLUOROGRAPHIES	F L UW W AH R AA G R AH F AY Z
FLUOROGRAPHY	F L UW W AH R AA G R AH F IY
FLUPHENAZINE	F L AH F EH N AH Z AY N
FLUPHENAZINES	F L AH F EH N AH Z AY N Z
FRANCOPHONE	F R AE NG K AH F OW N
GALUMPH	G AE L AH M F
GALUMPHED	G AE L AH M F T
GALUMPHING	G AH L AH M F AH NG
GALUMPHS	G AE L AH M F S
GAMETOPHORE	G AH M EH T AH F AH R
GAMETOPHORES	G AH M EH T AH F AH R Z
GAMETOPHYTE	G AH M IY T AH F AY T
GAMETOPHYTES	G AH M EH T AH F AY T S
GAMETOPHYTIC	G AH M EH T AH F AH T AH K
GASTROESOPHAGEAL	G AE S T R OW EH S AH F IH JH IY AH L
GEOGRAPHER	JH IY AA G R AH F ER
GEOGRAPHERS	JH IY AA G R AH F ER Z
GEOGRAPHIC	JH IY AH G R AE F IH K
GEOGRAPHICAL	JH IY AH G R AE F IH K AH L
GEOGRAPHICALLY	JH IY AH G R AE F IH K AH L IY
GEOGRAPHICALLY(2)	JH IY AH G R AE F IH K L IY
GEOGRAPHIES	JH IY AA G R AH F IY Z
GEOGRAPHY	JH IY AA G R AH F IY
GEOMORPHIC	JH IY AH M AH R F AH K
GEOMORPHOLOGICAL	JH IY AH M AO R F AA L AH JH IH S AH L
GEOMORPHOLOGIES	JH IY AH M AO R F AA L AH JH AY Z
GEOMORPHOLOGIST	JH IY AH M AO R F AA L AH JH AH S T
GEOMORPHOLOGISTS	JH IY AH M AH R F AA L AH JH AH S T S
GEOMORPHOLOGY	JH IY AH M AO R F AA L AH JH IY
GEOPHAGIES	JH IY AA F AH JH AY Z
GEOPHAGY	JH IY AA F AH JH IY
GEOPHONE	JH IY AH F OW N
GEOPHONES	JH IY AH F OW N Z
GEOPHYSICAL	JH IY OW F IH Z AH K AH L
GEOPHYSICALLY	JH IY AH F IH S AH K AE L IY
GEOPHYSICIST	JH IY AA F AH Z IH S AH S T
GEOPHYSICISTS	JH IY AH F IH S AH S AH S T S
GEOPHYSICS	JH IY AA F AH Z AH S Z
GEOPHYTE	JH IY AH F AY T
GEOPHYTES	JH IY AH F AY T S
GEOSTROPHIC	JH IY OW S T R AA F IH K
GEOSTROPHICALLY	JH IY AA S T R AA F AH K AE L IY
GERONTOMORPHIC	JH AH R AA N T AH M AH R F AH K
GLOMERULONEPHRITIDES	G L AH M AH R UW L AH N EH F R AH T AY D Z
GLOMERULONEPHRITIS	G L AA M AH R UW L AH N AH F R AY T AH S
GLOSSOGRAPHER	G L AA S AA G R AH F AH R
GLOSSOGRAPHERS	G L AA S AA G R AH F AH R Z
GLOSSOPHARYNGEAL	G L AA S AA F AH R IH N JH IY AH L
GLOSSOPHARYNGEALS	G L AA S AH F AE R AH N JH IY L Z
GLYPH	G L IH F
GLYPHIC	G L IH F AH K
GLYPHS	G L IH F S
GONADOTROPHIC	G AA N AH D AA T R AH F AH K
GONADOTROPHIN	G AA N AH D AA T R AH F AH N
GONADOTROPHINS	G AA N AH D AA T R AH F AH N Z
GONOPH	G AA N AH F
GONOPHORE	G AA N AH F AH R
GONOPHORES	G AA N AH F AH R Z
GONOPHS	G AA N AH F S
GOPHER	G OW F ER
GOPHERS	G OW F ER Z
GRAMOPHONE	G R AE M AH F OW N
GRAMOPHONES	G R AE M AH F OW N Z
GRANDNEPHEW	G R AE N D N EH F Y UW
GRANDNEPHEWS	G R AE N D N EH F Y UW Z
GRANOPHYRE	G R AE N AH F AY R
GRANOPHYRES	G R AE N AH F AY R Z
GRANOPHYRIC	G R AE N AH F AH R AH K
GRAPH	G R AE F
GRAPHED	G R AE F T
GRAPHEME	G R AH F IY M
GRAPHEMES	G R AH F IY M Z
GRAPHEMIC	G R AE F AH M AH K
GRAPHEMICALLY	G R AE F IH M AY S AH L IY
GRAPHEMICS	G R AE F AH M AH S Z
GRAPHIC	G R AE F IH K
GRAPHICAL	G R AE F IH K AH L
GRAPHICALLY	G R AE F IH K L IY
GRAPHICNESS	G R AE F IH K N AH S
GRAPHICNESSES	G R AE F IH K N AH S IH Z
GRAPHICS	G R AE F IH K S
GRAPHING	G R AE F IH NG
GRAPHITE	G R AE F AY T
GRAPHITES	G R AE F AY T S
GRAPHITIC	G R AE F AY T IH K
GRAPHITIZABLE	G R AE F AY T AY Z AH B AH L
GRAPHITIZATION	G R AE F AY T AH Z EY SH AH N
GRAPHITIZATIONS	G R AE F AY T AH Z EY SH AH N Z
GRAPHITIZE	G R AE F AY T AY Z
GRAPHITIZED	G R AE F AY T AY Z D
GRAPHITIZES	G R AE F AY T AY Z IH Z
GRAPHITIZING	G R AE F AY T AY Z IH NG
GRAPHOLECT	G R AE F AH L AH K T
GRAPHOLECTS	G R AE F AH L AH K T S
GRAPHOLOGICAL	G R AH F AA L AH JH IH S AH L
GRAPHOLOGIES	G R AE F AA L AH JH IY Z
GRAPHOLOGIST	G R AE F AA L AH JH AH S T
GRAPHOLOGISTS	G R AE F AA L AH JH AH S T S
GRAPHOLOGY	G R AH F AA L AH JH IY
GRAPHS	G R AE F S
GRUMPHIE	G R AH M F AY
GRUMPHIES	G R AH M F AY Z
GRUMPHY	G R AH M F IY
GRYPHON	G R IH F AH N
GRYPHONS	G R IH F AH N Z
GYMNOSOPHIST	JH IH M N AA S AH F AH S T
GYMNOSOPHISTS	JH IH M N AA S AH F AH S T S
GYNANDROMORPH	JH AH N AE N D R AH M AH R F
GYNANDROMORPHIC	JH AH N AE N D R AH M AH R F AH K
GYNANDROMORPHIES	JH AH N AE N D R AH M AO R F AY Z
GYNANDROMORPHISM	JH AH N AE N D R AH M AH R F IH Z AH M
GYNANDROMORPHISMS	JH AH N AE N D R AH M AO R F AH Z AH M Z
GYNANDROMORPHS	JH AH N AE N D R AH M AH R F S
GYNANDROMORPHY	JH AH N AE N D R AH M AO R F IY
GYNOPHORE	JH IH N AH F AH R
GYNOPHORES	JH IH N AH F AH R Z
GYPSOPHILA	JH IH P S AA F AH L AH
GYPSOPHILAS	JH IH P S AA F AH L AH Z
HAGIOGRAPHER	HH EY JH IY AA G R AH F AH R
HAGIOGRAPHERS	HH EY JH IY AA G R AH F AH R Z
HAGIOGRAPHIC	HH EY JH IY AA G R AH F AH K
HAGIOGRAPHICAL	HH EY JH IY AA G R AH F IH S AH L
HAGIOGRAPHIES	HH EY JH IY AA G R AH F AY Z
HAGIOGRAPHY	HH AE G IY AA G R AH F IY
HALOMORPHIC	HH EY L OW M AO R F IH K
HALOPHILE	HH AE L AH F AY L
HALOPHILES	HH AE L AH F AY L Z
HALOPHILIC	HH AE L AH F AY L AH K
HALOPHYTE	HH AE L AH F AY T
HALOPHYTES	HH AE L AH F AY T S
HALOPHYTIC	HH AE L AH F IH T IH K
HAPHAZARD	HH AE P HH AE Z ER D
HAPHAZARDLY	HH AE F AH Z ER D L IY
HAPHAZARDLY(2)	HH AE P HH AE Z ER D L IY
HAPHAZARDNESS	HH AE P HH AE Z ER D N AH S
HAPHAZARDNESSES	HH AE P HH AE Z ER D N AH S IH Z
HAPHAZARDRIES	HH AE P HH AE Z ER D R IY Z
HAPHAZARDRY	HH AE P HH AE Z ER D R IY
HAPHAZARDS	HH AE P HH AE Z ER D Z
HAPHTARA	HH AE F T AH R AH
HAPHTARAS	HH AE F T AH R AH Z
HAPHTAROT	HH AE F T AH R AH T
HAPHTAROTH	HH AE F T AH R AH TH
HARRUMPH	HH AE R AH M F
HARRUMPHED	HH AE R AH M F T
HARRUMPHING	HH AE R AH M F AH NG
HARRUMPHS	HH AE R AH M F S
HARUMPH	HH AE R AH M F
HARUMPHED	HH AE R AH M F T
HARUMPHING	HH AH R AH M F AH NG
HARUMPHS	HH AE R AH M F S
HEADPHONE	HH EH D F OW N
HEADPHONES	HH EH D F OW N Z
HEBEPHRENIA	HH EH B AH F R IY N Y AH
HEBEPHRENIAS	HH EH B AH F R IY N Y AH Z
HEBEPHRENIC	HH IY B AH F R EH N IH K
HEBEPHRENICS	HH IY B AH F R EH N IH K S
HECTOGRAPH	HH EH K T AH G R AE F
HECTOGRAPHED	HH EH K T AA G R AH F T
HECTOGRAPHING	HH EH K T AA G R AH F AH NG
HECTOGRAPHS	HH EH K T AA G R AH F S
HELIOGRAPH	HH IY L IY AA G R AH F
HELIOGRAPHED	HH IY L IY AA G R AH F T
HELIOGRAPHIC	HH IY L IY AA G R AH F AH K
HELIOGRAPHING	HH IY L IY AA G R AH F AH NG
HELIOGRAPHS	HH IY L IY AA G R AH F S
HEMATOPHAGOUS	HH AH M AE T AH F EY JH AH S
HEMATOPORPHYRIN	HH EH M AH T AH P AO R F AH R AH N
HEMATOPORPHYRINS	HH EH M AH T AH P AO R F AH R AH N Z
HEMIMORPHIC	HH EH M IH M AO R F IH K
HEMIMORPHISM	HH EH M AH M AH R F IH Z AH M
HEMIMORPHISMS	HH EH M AH M AO R F AH Z AH M Z
HEMISPHERE	HH EH M IH S F IH R
HEMISPHERES	HH EH M AH S F IH ER Z
HEMISPHERIC	HH EH M AH S F IH R IH K
HEMISPHERICAL	HH EH M AH S F IH R IH K AH L
HEMOLYMPH	HH EH M AH L AH M F
HEMOLYMPHS	HH EH M AH L AH M F S
HEMOPHILIA	HH IY M AH F IY L IY AH
HEMOPHILIAC	HH IY M AH F IH L IY AE K
HEMOPHILIAC(2)	HH IY M OW F IH L IY AE K
HEMOPHILIAC(3)	HH IY M AH F IH L Y AE K
HEMOPHILIAC(4)	HH IY M OW F IH L Y AE K
HEMOPHILIACS	HH IY M AH F IH L IY AE K S
HEMOPHILIAS	HH EH M AH F IH L Y AH Z
HEMOPHILIC	HH EH M AH F AY L AH K
HEMOPHILICS	HH EH M AH F AY L AH S Z
HERMAPHRODITE	HH ER M AE F R AH D AY T
HERMAPHRODITES	HH AH R M AE F R AH D AY T S
HERMAPHRODITIC	HH ER M AE F R AH D IH T IH K
HERMAPHRODITISM	HH AH R M AE F R AH D AH T IH Z AH M
HERMAPHRODITISMS	HH AH R M AH F R AA D AH T AH Z AH M Z
HETEROMORPHIC	HH AH T EH R AH M AH R F AH K
HETEROMORPHISM	HH AH T EH R AH M AH R F IH Z AH M
HETEROMORPHISMS	HH EH T AH R AH M AO R F AH Z AH M Z
HETEROPHIL	HH AH T EH R AH F AH L
HETEROPHILE	HH AH T EH R AH F AY L
HETEROPHONIES	HH EH T AH R AA F AH N AY Z
HETEROPHONY	HH EH T AH R AA F AH N IY
HETEROPHYLLIES	HH EH T AH R AH F IH L AY Z
HETEROPHYLLOUS	HH AH T EH R AH F IH L AH S
HETEROPHYLLY	HH AH T EH R AH F IH L IY
HETEROTROPH	HH EH T AH R AA T R AH F
HETEROTROPHIC	HH EH T ER AH T R AA F IH K
HETEROTROPHICALLY	HH EH T AH R AA T R AA F AH K AE L IY
HETEROTROPHIES	HH EH T AH R AA T R AH F AY Z
HETEROTROPHS	HH EH T AH R AA T R AH F S
HETEROTROPHY	HH EH T AH R AA T R AH F IY
HEXACHLOROPHENE	HH EH K S AH K L AO R AH F IY N
HEXACHLOROPHENES	HH EH K S AE K L AO R AH F IY N Z
HIEROGLYPH	HH AY R OW G L IH F
HIEROGLYPHIC	HH AY R OW G L IH F IH K
HIEROGLYPHICAL	HH IY R AA G L AH F IH S AH L
HIEROGLYPHICALLY	HH IY R AA G L IH F AH K AE L IY
HIEROGLYPHICS	HH AY R OW G L IH F IH K S
HIEROGLYPHS	HH AY R OW G L IH F S
HIEROPHANT	HH IY R AH F AH N T
HIEROPHANTIC	HH IY R AH F AH N T AH K
HIEROPHANTS	HH IY R AH F AH N T S
HISTOPHYSIOLOGIC	HH IH S T AH F AH S IY AH L AH JH AH K
HISTOPHYSIOLOGICAL	HH IH S T AA F AH S IY AA L AH JH IH S AH L
HISTOPHYSIOLOGIES	HH IH S T AA F AH S IY AA L AH JH AY Z
HISTOPHYSIOLOGY	HH IH S T AA F AH S IY AA L AH JH IY
HISTORIOGRAPHER	HH IH S T AH R IY AA G R AH F AH R
HISTORIOGRAPHERS	HH IH S T AH R IY AA G R AH F AH R Z
HISTORIOGRAPHIC	HH IH S T AH R IY AA G R AH F AH K
HISTORIOGRAPHICAL	HH IH S T AH R IY AA G R AH F IH S AH L
HISTORIOGRAPHICALLY	HH IH S T AO R IY AA G R AE F AH K AE L IY
HISTORIOGRAPHIES	HH IH S T OW R IY AA G R AH F IY Z
HISTORIOGRAPHY	HH IH S T AO R IY AA G R AH F IY
HOLOGRAPH	HH AH L AA G R AH F
HOLOGRAPHED	HH AH L AA G R AH F T
HOLOGRAPHER	HH AH L AA G R AH F AH R
HOLOGRAPHERS	HH AH L AA G R AH F AH R Z
HOLOGRAPHIC	HH AO L OW G R AE F IH K
HOLOGRAPHICALLY	HH AH L AA G R AE F AH K AE L IY
HOLOGRAPHIES	HH AH L AA G R AH F AY Z
HOLOGRAPHING	HH AH L AA G R AH F AH NG
HOLOGRAPHS	HH AH L AA G R AH F S
HOLOGRAPHY	HH AH L AA G R AH F IY
HOLOPHRASTIC	HH AH L AA F R AH S T AH K
HOLOPHYTIC	HH AA L AH F AH T AH K
HOMEOMORPHIC	HH OW M IY AH M AH R F AH K
HOMEOMORPHISM	HH OW M IY AH M AH R F IH Z AH M
HOMEOMORPHISMS	HH OW M IY AH M AO R F AH Z AH M Z
HOMOGRAPH	HH OW M OW G R AE F
HOMOGRAPHIC	HH OW M OW G R AE F IH K
HOMOGRAPHS	HH OW M OW G R AE F S
HOMOMORPHIC	HH OW M OW M AO R F IH K
HOMOMORPHISM	HH OW M OW M AO R F IH Z AH M
HOMOMORPHISMS	HH OW M OW M AO R F IH Z AH M Z
HOMOPHILE	HH AA M AH F AY L
HOMOPHOBE	HH AA M AH F OW B
HOMOPHOBES	HH AA M AH F OW B Z
HOMOPHOBIA	HH OW M AH F OW B IY AH
HOMOPHOBIAS	HH AA M AH F OW B IY AH Z
HOMOPHOBIC	HH OW M AH F OW B IH K
HOMOPHONE	HH OW M OW F OW N
HOMOPHONES	HH OW M OW F OW N Z
HOMOPHONIC	HH OW M OW F AA N IH K
HOMOPHONIES	HH OW M OW F OW N IY Z
HOMOPHONOUS	HH OW M OW F OW N AH S
HOMOPHONY	HH OW M OW F OW N IY
HOPHEAD	HH AA P HH EH D
HOPHEADS	HH AA P HH EH D Z
HUMPH	HH AH M F
HUMPHED	HH AH M F T
HUMPHING	HH AH M F AH NG
HUMPHS	HH AH M F S
HYDROCEPHALIC	HH IH D R AA S AH F AH L AH K
HYDROCEPHALICS	HH IH D R AH S EH F AH L AH S Z
HYDROCEPHALIES	HH IH D R AH S EH F AH L AY Z
HYDROCEPHALUS	HH IH D R AH S EH F AH L AH S
HYDROCEPHALUSES	HH IH D R AH S EH F AH L UW Z AH Z
HYDROCEPHALY	HH IH D R AH S EH F AH L IY
HYDROGRAPHER	HH IH D R AA G R AH F AH R
HYDROGRAPHERS	HH IH D R AA G R AH F AH R Z
HYDROGRAPHIC	HH AY D R AH G R AE F IH K
HYDROGRAPHIES	HH IH D R AA G R AH F AY Z
HYDROGRAPHY	HH IH D R AA G R AH F IY
HYDROMORPHIC	HH IH D R AH M AH R F AH K
HYDROPHANE	HH IH D R AH F EY N
HYDROPHANES	HH IH D R AH F EY N Z
HYDROPHILIC	HH AY D R AH F IH L IH K
HYDROPHILICITIES	HH AY D R AH F IH L IH K AH T IY Z
HYDROPHILICITY	HH AY D R AH F IH L IH K AH T IY
HYDROPHOBIA	HH AY D R AH F OW B IY AH
HYDROPHOBIAS	HH AY D R AH F OW B IY AH Z
HYDROPHOBIC	HH AY D R AH F OW B IH K
HYDROPHOBICITIES	HH AY D R AH F OW B IH K AH T IY Z
HYDROPHOBICITY	HH AY D R AH F OW B IH K AH T IY
HYDROPHONE	HH IH D R AH F OW N
HYDROPHONES	HH IH D R AH F OW N Z
HYDROPHYTE	HH IH D R AH F AY T
HYDROPHYTES	HH IH D R AH F AY T S
HYDROPHYTIC	HH IH D R AH F AH T AH K
HYDROSPHERE	HH IH D R AA S AH R
HYDROSPHERES	HH IH D R AH S IY R Z
HYDROSPHERIC	HH IH D R AA S AH R AH K
HYGROGRAPH	HH IH G R AA G R AH F
HYGROGRAPHS	HH IH G R AA G R AH F S
HYGROPHILOUS	HH IH G R AH F AY L AH S
HYGROPHYTE	HH IH G R AH F AY T
HYGROPHYTES	HH IH G R AH F AY T S
HYGROPHYTIC	HH IH G R AH F AH T AH K
HYPERPHAGIA	HH AY P AH R F EY JH IY AH
HYPERPHAGIAS	HH AY P AH R F EY JH IY AH Z
HYPERPHAGIC	HH AH P AH R F AH JH AH K
HYPERPHYSICAL	HH AY P ER F IH Z AH K AH L
HYPERTROPHIC	HH AY P ER T R OW F IH K
HYPERTROPHIED	HH AY P ER T R AH F IY D
HYPERTROPHIES	HH AY P ER T R AH F IY Z
HYPERTROPHY	HH AY P ER T R OW F IY
HYPERTROPHYING	HH AY P ER T R AH F IY IH NG
HYPHA	HH IH F AH
HYPHAE	HH AY F IY
HYPHAL	HH IH F AH L
HYPHEMIA	HH AH F IY M IY AH
HYPHEMIAS	HH AH F IY M IY AH Z
HYPHEN	HH AY F AH N
HYPHENATE	HH AY F AH N EY T
HYPHENATED	HH AY F AH N EY T IH D
HYPHENATES	HH AY F AH N EY T S
HYPHENATING	HH AY F AH N EY T IH NG
HYPHENATION	HH AY F AH N EY SH AH N
HYPHENATIONS	HH AY F AH N EY SH AH N Z
HYPHENED	HH AY F AH N D
HYPHENING	HH AY F AH N IH NG
HYPHENLESS	HH AY F AH N L AH S
HYPHENS	HH AY F AH N Z
HYPOMORPH	HH IH P AH M AH R F
HYPOMORPHIC	HH IH P AH M AH R F AH K
HYPOMORPHS	HH IH P AH M AH R F S
HYPOPHARYNGES	HH AH P AA F AH R IH N JH AH Z
HYPOPHARYNX	HH AH P AA F AH R AH NG K S
HYPOPHARYNXES	HH AH P AA F AH R AH NG K S
HYPOPHYSEAL	HH AY P AH F IH Z IY AH L
HYPOPHYSECTOMIES	HH IH P AH F AH S EH K T AH M AY Z
HYPOPHYSECTOMIZE	HH AH P AA F AH S EH K T AH M AY Z
HYPOPHYSECTOMIZED	HH AH P AA F AH S EH K T AH M AY Z D
HYPOPHYSECTOMIZES	HH AH P AA F AH S EH K T AH M AY Z AH Z
HYPOPHYSECTOMIZING	HH AH P AA F AH S EH K T AH M AY Z AH NG
HYPOPHYSECTOMY	HH IH P AH F AH S EH K T AH M IY
HYPOPHYSES	HH IH P AH F AY Z AH Z
HYPOPHYSIAL	HH IH P AH F IH Z IY AH L
HYPOPHYSIS	HH AH P AA F AH S AH S
ICHTHYOPHAGOUS	IH CH TH AY AH F EY JH AH S
ICONOGRAPHER	IH K AH N AA G R AH F AH R
ICONOGRAPHERS	IH K AH N AA G R AH F AH R Z
ICONOGRAPHIC	IH K AH N AA G R AH F AH K
ICONOGRAPHICAL	IH K AH N AA G R AH F IH S AH L
ICONOGRAPHICALLY	IH K AH N AA G R AE F AH K AE L IY
ICONOGRAPHIES	IH K AH N AA G R AH F AY Z
ICONOGRAPHY	AY K AH N AA G R AH F IY
IDEOGRAPH	IH D IY AA G R AH F
IDEOGRAPHIC	IH D IY AA G R AH F AH K
IDEOGRAPHICALLY	IH D IY AA G R AE F AH K AE L IY
IDEOGRAPHIES	IH D IY AA G R AH F AY Z
IDEOGRAPHS	IH D IY AA G R AH F S
IDEOGRAPHY	IH D IY AA G R AH F IY
IDIOGRAPHIC	IH D IY AA G R AH F AH K
IDIOMORPHIC	IH D IY AH M AO R F IH K
IMMUNOELECTROPHORESES	IH M Y UW N OW AH L EH K T R AA F AH R IY Z AH Z
IMMUNOELECTROPHORESIS	IH M Y AH N OW AH L EH K T R AH F AO R AH S AH S
IMMUNOELECTROPHORETIC	IH M Y AH N OW AH L AH K T R AA F AH R AH T AH K
IMMUNOELECTROPHORETICALLY	IH M Y UW N OW AH L EH K T R AH F AH R EH T AH K AE L IY
IMPHEE	IH M F IY IY
IMPHEES	IH M F IY Z
INDECIPHERABLE	IH N D IY S AY F ER AH B AH L
INDOPHENOL	IH N D AA F AH N AH L
INDOPHENOLS	IH N D AA F AH N AH L Z
INPHASE	IH N F EY Z
INSPHERE	IH N S F IH ER
INSPHERED	IH N S F IH ER D
INSPHERES	IH N S F IH ER Z
INSPHERING	IH N S F IH ER IH NG
INTERHEMISPHERIC	IH N T ER HH EH M AH S F IH R IH K
INTERPHALANGEAL	IH N T AH R F AH L AE N JH IY AH L
INTERPHASE	IH N T ER F EY Z
INTERPHASES	IH N T ER F EY Z IH Z
IODOPHOR	AY AA D AH F AH R
IODOPHORS	AY AA D AH F AH R Z
IONOPHORE	AY AA N AH F AH R
IONOPHORES	AY AA N AH F AH R Z
IONOSPHERE	AY AA N AO S F IY R
IONOSPHERES	AY AA N AH S F IH R Z
IONOSPHERIC	AY AA N AO S F EH R IH K
IONOSPHERICALLY	AY AA N AH S F IH R IH K AH L IY
IONTOPHORESES	AY AA N T AA F AH R IY Z AH Z
IONTOPHORESIS	AY AA N T AH F AO R AH S AH S
IONTOPHORETIC	AY AH N T AA F AH R AH T AH K
IONTOPHORETICALLY	AY AA N T AH F AH R EH T AH K AE L IY
ISOGRAPH	AH S AA G R AH F
ISOGRAPHS	AH S AA G R AH F S
ISOMORPH	IH S AH M AH R F
ISOMORPHIC	IH S AH M AH R F AH K
ISOMORPHICALLY	IH S AH M AO R F AH K AE L IY
ISOMORPHISM	AY S AH M AO R F IH Z AH M
ISOMORPHISMS	IH S AH M AO R F AH Z AH M Z
ISOMORPHOUS	IH S AH M AO R F AH S
ISOMORPHS	IH S AH M AH R F S
ISOPHOTAL	AH S AA F AH T AH L
ISOPHOTE	IH S AH F OW T
ISOPHOTES	IH S AH F OW T S
ITHYPHALLIC	IH TH AH F AH L AH K
JOSEPH	JH OW S AH F
JOSEPH(2)	JH OW Z AH F
JOSEPHS	JH OW S IH F S
JOSEPHS(2)	JH OW Z IH F S
KALIPH	K AE L AH F
KALIPHS	K AE L AH F S
KAPH	K AE F
KAPHS	K AE F S
KARYOLYMPH	K AH R AY AH L AH M F
KARYOLYMPHS	K AH R AY AH L AH M F S
KEPHALIN	K EH F AH L AH N
KEPHALINS	K EH F AH L AH N Z
KERATINOPHILIC	K EH R AH T IH N AH F AY L AH K
KHAPH	K HH AE F
KHAPHS	K HH AE F S
KLEPHT	K L EH F T
KLEPHTIC	K L EH F T AH K
KLEPHTS	K L EH F T S
KOPH	K AA F
KOPHS	K AA F S
KYMOGRAPH	K AH M AA G R AH F
KYMOGRAPHIC	K AH M AA G R AH F AH K
KYMOGRAPHIES	K AH M AA G R AH F AY Z
KYMOGRAPHS	K AH M AA G R AH F S
KYMOGRAPHY	K AH M AA G R AH F IY
KYPHOSES	K AH F OW Z AH Z
KYPHOSIS	K AH F OW S AH S
KYPHOTIC	K IH F AH T AH K
LAGOMORPH	L AE G AH M AH R F
LAGOMORPHS	L AE G AH M AH R F S
LEPTOCEPHALI	L EH P T AH S EH F AH L IY
LEPTOCEPHALUS	L EH P T AH S EH F AH L AH S
LEUKODYSTROPHIES	L UW K AH D IH S T R AH F AY Z
LEUKODYSTROPHY	L UW K AH D IH S T R AH F IY
LEXICOGRAPHER	L EH K S IH K AA G R AH F ER
LEXICOGRAPHERS	L EH K S IH K AA G R AH F ER Z
LEXICOGRAPHIC	L EH K S AH K AA G R AH F AH K
LEXICOGRAPHICAL	L EH K S AH K AA G R AH F IH S AH L
LEXICOGRAPHICALLY	L EH K S AH K AA G R AE F AH K AE L IY
LEXICOGRAPHIES	L EH K S AH K AA G R AH F AY Z
LEXICOGRAPHY	L EH K S AH K AA G R AH F IY
LIMITROPHE	L AH M IH T R AH F
LIPOPHILIC	L IH P AH F AY L AH K
LITHOGRAPH	L IH TH AH G R AE F
LITHOGRAPHED	L IH TH AH G R AE F T
LITHOGRAPHER	L IH TH AH G R AE F ER
LITHOGRAPHERS	L IH TH AH G R AE F ER Z
LITHOGRAPHIC	L IH TH AH G R AE F IH K
LITHOGRAPHICALLY	L IH TH AH G R AE F IH K AH L IY
LITHOGRAPHIES	L IH TH AH G R AE F IY Z
LITHOGRAPHING	L IH TH AH G R AE F IH NG
LITHOGRAPHS	L IH TH AH G R AE F S
LITHOGRAPHY	L AH TH AA G R AH F IY
LITHOPHANE	L IH TH AH F EY N
LITHOPHANES	L IH TH AH F EY N Z
LITHOPHYTE	L IH TH AH F AY T
LITHOPHYTES	L IH TH AH F AY T S
LITHOSPHERE	L AH TH AA S AH R
LITHOSPHERES	L IH TH AH S IY R Z
LITHOSPHERIC	L AH TH AA S AH R AH K
LOGOGRAPH	L AH G AA G R AH F
LOGOGRAPHIC	L AO G AH G R AE F IH K
LOGOGRAPHICALLY	L AH G AA G R AE F AH K AE L IY
LOGOGRAPHS	L AH G AA G R AH F S
LOGOGRIPH	L AH G AA G R AH F
LOGOGRIPHS	L AH G AA G R AH F S
LOOPHOLE	L UW P HH OW L
LOOPHOLED	L UW P HH OW L D
LOOPHOLES	L UW P HH OW L Z
LOOPHOLING	L UW P HH OW L IH NG
LOPHOPHORE	L AA F AH F AH R
LOPHOPHORES	L AA F AH F AH R Z
LUTEOTROPHIC	L UW T IY AA T R AH F AH K
LUTEOTROPHIN	L UW T IY AA T R AH F AH N
LUTEOTROPHINS	L UW T IY AA T R AH F AH N Z
LYMPH	L IH M F
LYMPHADENITIS	L IH M F EY D AH N AH T IY Z
LYMPHADENITISES	L IH M F EY D AH N AH T IY Z IH Z
LYMPHADENOPATHIES	L IH M F AH D AH N AA P AH TH AY Z
LYMPHADENOPATHY	L IH M F AH D EH N AH P AE TH IY
LYMPHANGIOGRAM	L IH M F AE N JH IY AA G R AH M
LYMPHANGIOGRAMS	L IH M F AE N JH IY AA G R AH M Z
LYMPHANGIOGRAPHIC	L IH M F AE N JH IY AA G R AH F AH K
LYMPHANGIOGRAPHIES	L IH M F AE N JH IY AA G R AH F AY Z
LYMPHANGIOGRAPHY	L IH M F AE N JH IY AA G R AH F IY
LYMPHATIC	L IH M F AE T IH K
LYMPHATICALLY	L IH M F AH T IH K AH L IY
LYMPHATICS	L IH M F AH T IH K S
LYMPHOBLAST	L IH M F AH B L AE S T
LYMPHOBLASTIC	L IH M F AH B L AE S T AH K
LYMPHOBLASTS	L IH M F AA B L AH S T S
LYMPHOCYTE	L IH M F AH S AY T
LYMPHOCYTES	L IH M F AH S AY T S
LYMPHOCYTIC	L IH M F AH S AY T IH K
LYMPHOCYTOSES	L IH M F AA S AH T OW Z AH Z
LYMPHOCYTOSIS	L IH M F AH S AH T OW S AH S
LYMPHOGRAM	L IH M F AA G R AH M
LYMPHOGRAMS	L IH M F AA G R AH M Z
LYMPHOGRANULOMA	L IH M F AA G R AH N Y UW L AH M AH
LYMPHOGRANULOMAS	L IH M F AA G R AH N Y UW L AH M AH Z
LYMPHOGRANULOMATA	L IH M F AH G R AE N Y AH L AA M AH T AH
LYMPHOGRANULOMATOSES	L IH M F AH G R AH N Y AH L AA M AH T OW Z AH Z
LYMPHOGRANULOMATOSIS	L IH M F AA G R AH N Y UW L AH M AH T OW S AH S
LYMPHOGRAPHIC	L IH M F AA G R AH F AH K
LYMPHOGRAPHIES	L IH M F AA G R AH F AY Z
LYMPHOGRAPHY	L IH M F AA G R AH F IY
LYMPHOID	L IH M F OY D
LYMPHOKINE	L IH M F AH K AY N
LYMPHOKINES	L IH M F AH K AY N Z
LYMPHOMA	L IH M F OW M AH
LYMPHOMAS	L IH M F OW M AH Z
LYMPHOMATA	L IH M F AA M AH T AH
LYMPHOMATOSES	L IH M F AA M AH T OW Z AH Z
LYMPHOMATOSIS	L IH M F AH M AH T OW S AH S
LYMPHOMATOUS	L IH M F AA M AH T AH S
LYMPHOSARCOMA	L IH M F AA S ER K OW M AH
LYMPHOSARCOMAS	L IH M F AA S ER K OW M AH Z
LYMPHOSARCOMATA	L IH M F AH S AH R K AA M AH T AH
LYMPHS	L IH M F S
LYOPHILE	L AY AH F AY L
LYOPHILED	L AY AH F AY L D
LYOPHILIC	L AY AH F AY L AH K
LYOPHILISE	L AY AA F AH L AY Z
LYOPHILISED	L AY AH F AY L AH S T
LYOPHILISES	L AY AA F AH L AY Z AH Z
LYOPHILISING	L AY AA F AH L AY Z AH NG
LYOPHILIZATION	L AY AA F AH L AY Z EY SH AH N
LYOPHILIZATIONS	L AY AA F AH L AY Z EY SH AH N Z
LYOPHILIZE	L AY AA F AH L AY Z
LYOPHILIZED	L AY AA F AH L AY Z D
LYOPHILIZER	L AY AA F AH L AY Z ER
LYOPHILIZERS	L AY AA F AH L AY Z ER Z
LYOPHILIZES	L AY AA F AH L AY Z IH Z
LYOPHILIZING	L AY AA F AH L AY Z IH NG
LYOPHOBIC	L AY AH F AH B AH K
MACROPHAGE	M AE K R OW F EY JH
MACROPHAGES	M AE K R OW F EY JH IH Z
MACROPHAGIC	M AE K R AH F EY JH IH K
MACROPHOTOGRAPH	M AE K R AH F AH T AA G R AH F
MACROPHOTOGRAPHIES	M AE K R AH F AH T AA G R AH F AY Z
MACROPHOTOGRAPHS	M AE K R AH F AH T AA G R AH F S
MACROPHOTOGRAPHY	M AE K R AH F AH T AA G R AH F IY
MACROPHYTE	M AE K R AH F AY T
MACROPHYTES	M AE K R AH F AY T S
MACROPHYTIC	M AE K R AH F AH T AH K
MAGNETOGRAPH	M AE G N AH T AA G R AH F
MAGNETOGRAPHS	M AE G N AH T AA G R AH F S
MAGNETOSPHERE	M AE G N AH T AA S AH R
MAGNETOSPHERES	M AE G N EH T AH S IY R Z
MAGNETOSPHERIC	M AE G N AH T AA S AH R AH K
MAMMOGRAPHIC	M AE M AA G R AH F AH K
MAMMOGRAPHIES	M AE M AA G R AH F AY Z
MAMMOGRAPHY	M AH M AA G R AH F IY
MASTIGOPHORAN	M AE S T AH G AA F AH R AH N
MASTIGOPHORANS	M AE S T AH G AA F AH R AH N Z
MEGAGAMETOPHYTE	M AH G AH G AH M EH T AH F AY T
MEGAGAMETOPHYTES	M AH G AH G AH M EH T AH F AY T S
MEGAPHONE	M EH G AH F OW N
MEGAPHONED	M EH G AH F OW N D
MEGAPHONES	M EH G AH F OW N Z
MEGAPHONIC	M EH G AH F AH N AH K
MEGAPHONING	M EH G AH F OW N AH NG
MEGASPOROPHYLL	M EH G AH S AO R AH F AH L
MEGASPOROPHYLLS	M EH G AH S AO R AH F AH L Z
MEGILPH	M EH JH AH L F
MEGILPHS	M EH JH AH L F S
MELANOPHORE	M AH L AE N AH F AH R
MELANOPHORES	M AH L AE N AH F AH R Z
MELLOPHONE	M EH L AH F OW N
MELLOPHONES	M EH L AH F OW N Z
MELPHALAN	M EH L F AH L AH N
MELPHALANS	M EH L F AH L AH N Z
MENINGOENCEPHALITIC	M AH N IH N G OW AH N S EH F AH L AH T AH K
MENINGOENCEPHALITIDES	M AH N AH N G OW AH N S AH F AE L AH T AY D Z
MENINGOENCEPHALITIS	M EH N IH N G OW EH N S EH F AH L AY T AH S
MEPHITIC	M EH F AH T AH K
MEPHITIS	M AH F AY T AH S
MEPHITISES	M EH F AH T AY Z AH Z
MEROMORPHIC	M EH R AH M AH R F AH K
MESENCEPHALA	M EH S AH N S EH F AH L AH
MESENCEPHALIC	M AH S EH N S AH F AH L AH K
MESENCEPHALON	M EH S AH N S EH F AH L AH N
MESOMORPH	M EH S AH M AH R F
MESOMORPHIC	M EH S AH M AH R F AH K
MESOMORPHIES	M EH S AH M AO R F AY Z
MESOMORPHS	M EH S AH M AH R F S
MESOMORPHY	M EH S AH M AO R F IY
MESONEPHRIC	M EH S AH N AH F R AH K
MESONEPHROI	M EH S AH N EH F R OY
MESONEPHROS	M EH S AH N EH F R AH Z
MESOPHYL	M EH S AH F AH L
MESOPHYLL	M EH S AH F AH L
MESOPHYLLIC	M EH S AH F AH L AH K
MESOPHYLLOUS	M EH S AH F IH L AH S
MESOPHYLLS	M EH S AH F AH L Z
MESOPHYLS	M EH S AH F AH L Z
MESOPHYTE	M EH S AH F AY T
MESOPHYTES	M EH S AH F AY T S
MESOPHYTIC	M EH S AH F AH T AH K
MESOSPHERE	M AH S AA S AH R
MESOSPHERES	M EH S AH S IY R Z
MESOSPHERIC	M AH S AA S AH R AH K
MESOTROPHIC	M AH S AA T R AH F AH K
METALLOGRAPHER	M EH T AH L AA G R AH F AH R
METALLOGRAPHERS	M EH T AH L AA G R AH F AH R Z
METALLOGRAPHIC	M EH T AH L AA G R AH F AH K
METALLOGRAPHICALLY	M AH T AE L AA G R AE F AH K AE L IY
METALLOGRAPHIES	M EH T AH L AA G R AH F AY Z
METALLOGRAPHY	M EH T AH L AA G R AH F IY
METALLOPHONE	M EH T AH L AA P HH OW N
METALLOPHONES	M EH T AH L AA P HH OW N Z
METAMORPHIC	M EH T AH M AO R F IH K
METAMORPHICALLY	M EH T AH M AO R F IH K AH L IY
METAMORPHISM	M EH T AH M AO R F IH Z AH M
METAMORPHISMS	M EH T AH M AO R F IH Z AH M Z
METAMORPHOSE	M EH T AH M AO R F OW Z
METAMORPHOSED	M EH T AH M AO R F OW Z D
METAMORPHOSES	M EH T AH M AO R F OW Z IH Z
METAMORPHOSING	M EH T AH M AO R F OW Z IH NG
METAMORPHOSIS	M EH T AH M AO R F AH S AH S
METANEPHRIC	M EH T AH N AH F R AH K
METANEPHROI	M EH T AH N EH F R OY
METANEPHROS	M EH T AH N EH F R AH Z
METAPHASE	M EH T AH F EY Z
METAPHASES	M EH T AH F EY Z IH Z
METAPHOR	M EH T AH F AO R
METAPHORIC	M EH T AH F AO R IH K
METAPHORICAL	M EH T AH F AO R IH K AH L
METAPHORICALLY	M EH T AH F AO R IH K L IY
METAPHORS	M EH T AH F AO R Z
METAPHOSPHATE	M EH T AH F AA S F EY T
METAPHOSPHATES	M EH T AH F AA S F EY T S
METAPHRASE	M EH T AH F R EY Z
METAPHRASES	M EH T AH F R EY Z IH Z
METAPHYSIC	M EH T AH F IH Z IH K
METAPHYSICAL	M EH T AH F IH Z IH K AH L
METAPHYSICALLY	M EH T AH F IH Z IH K AH L IY
METAPHYSICIAN	M EH T AH F AH Z IH SH AH N
METAPHYSICIANS	M EH T AH F AH Z IH SH AH N Z
METAPHYSICS	M EH T AH F IH Z IH K S
METENCEPHALA	M EH T AH N S EH F AH L AH
METENCEPHALIC	M AH T EH N S AH F AH L AH K
METENCEPHALON	M EH T AH N S EH F AH L AH N
METENCEPHALONS	M EH T AH N S EH F AH L AH N Z
METHAMPHETAMINE	M EH TH AE M F EH T AH M IY N
METHAMPHETAMINE(2)	M EH TH AE M F EH T AH M AY N
METHAMPHETAMINES	M AH TH AE M F EH T AH M AY N Z
METHYLNAPHTHALENE	M AH TH AH L N AE F TH AH L IY N
METHYLNAPHTHALENES	M AH TH AH L N AE F TH AH L IY N Z
METHYLPHENIDATE	M AH TH IH L F EH N AH D EY T
METHYLPHENIDATES	M AH TH IH L F EH N AH D EY T S
MICROBAROGRAPH	M AY K R AH B AH R AA G R AH F
MICROBAROGRAPHS	M AY K R AH B AH R AA G R AH F S
MICROCEPHALIC	M AY K R AH S EH F AH L AH K
MICROCEPHALICS	M AY K R AH S EH F AH L AH S Z
MICROCEPHALIES	M AY K R AH S EH F AH L AY Z
MICROCEPHALY	M AY K R AH S EH F AH L IY
MICROELECTROPHORESES	M AY K R OW AH L EH K T R AA F AH R IY Z AH Z
MICROELECTROPHORESIS	M AY K R OW IH L EH K T R AH F AH R IY S AH S
MICROELECTROPHORETIC	M AY K R OW EH L AH K T R AA F AH R AH T AH K
MICROELECTROPHORETICALLY	M AY K R OW AH L EH K T R AH F AH R EH T AH K AE L IY
MICROGRAPH	M AY K R OW G R AE F
MICROGRAPHED	M AY K R OW G R AE F T
MICROGRAPHIC	M AY K R OW G R AE F IH K
MICROGRAPHICALLY	M AY K R OW G R AE F IH K AH L IY
MICROGRAPHICS	M AY K R OW G R AE F IH K S
MICROGRAPHING	M AY K R OW G R AE F IH NG
MICROGRAPHS	M AY K R OW G R AE F S
MICROMORPHOLOGICAL	M AY K R OW M AO R F AH L AA JH IH K AH L
MICROMORPHOLOGIES	M AY K R OW M AO R F AA L AH JH IY Z
MICROMORPHOLOGY	M AY K R OW M AO R F AA L AH JH IY
MICROPHAGE	M IH K R AH F AH JH
MICROPHAGES	M IH K R AA F AH JH AH Z
MICROPHONE	M AY K R AH F OW N
MICROPHONES	M AY K R OW F OW N Z
MICROPHONIC	M AY K R OW F AA N IH K
MICROPHONICS	M AY K R OW F AA N IH K S
MICROPHOTOGRAPH	M AY K R OW F OW T AH G R AE F
MICROPHOTOGRAPHER	M AY K R OW F AH T AA G R AH F ER
MICROPHOTOGRAPHERS	M AY K R OW F AH T AA G R AH F ER Z
MICROPHOTOGRAPHIC	M AY K R OW F OW T AH G R AE F IH K
MICROPHOTOGRAPHIES	M AY K R OW F AH T AA G R AH F IY Z
MICROPHOTOGRAPHS	M AY K R OW F OW T AH G R AE F S
MICROPHOTOGRAPHY	M AY K R OW F AH T AA G R AH F IY
MICROPHOTOMETER	M AY K R OW F OW T OW M IY T ER
MICROPHOTOMETERS	M AY K R OW F OW T OW M IY T ER Z
MICROPHOTOMETRIC	M AY K R OW F OW T OW M EH T R IH K
MICROPHOTOMETRICALLY	M AY K R OW F OW T OW M EH T R IH K AH L IY
MICROPHOTOMETRIES	M AY K R OW F OW T OW M IY T ER IY Z
MICROPHOTOMETRY	M AY K R OW F OW T OW M IY T ER IY
MICROPHYLL	M AY K R AH F IH L
MICROPHYLLOUS	M AY K R AH F IH L AH S
MICROPHYLLS	M AY K R AH F IH L Z
MICROPHYSICAL	M AY K R OW F IH Z AH K AH L
MICROPHYSICALLY	M AY K R OW F IH Z AH K AH L IY
MICROPHYSICS	M AY K R OW F IH Z IH K S
MICRORADIOGRAPH	M AY K R OW R EY D IY OW G R AE F
MICRORADIOGRAPHIC	M AY K R OW R EY D IY OW G R AE F IH K
MICRORADIOGRAPHIES	M AY K R OW R EY D IY AA G R AH F IY Z
MICRORADIOGRAPHS	M AY K R OW R EY D IY OW G R AE F S
MICRORADIOGRAPHY	M AY K R OW R EY D IY AA G R AH F IY
MICROSPECTROPHOTOMETER	M AY K R OW S P EH K T R OW F AH T AA M AH T ER
MICROSPECTROPHOTOMETERS	M AY K R OW S P EH K T R OW F AH T AA M AH T ER Z
MICROSPECTROPHOTOMETRIC	M AY K R OW S P EH K T R AH F OW T AH M EH T R IH K
MICROSPECTROPHOTOMETRIES	M AY K R OW S AH K T R AH F AH T AH M EH T R AY Z
MICROSPECTROPHOTOMETRY	M AY K R OW S EH K T R AA F AH T AH M EH T R IY
MICROSPHERE	M AY K R OW S F IH ER
MICROSPHERES	M AY K R OW S F IH ER Z
MICROSPHERICAL	M AY K R OW S F IH ER IH K AH L
MICROSPOROPHYLL	M AY K R OW S AO R AH F AH L
MICROSPOROPHYLLS	M AY K R OW S AO R AH F AH L Z
MIMEOGRAPH	M IH M IY AH G R AE F
MIMEOGRAPHED	M IH M IY AA G R AH F T
MIMEOGRAPHING	M IH M IY AA G R AH F AH NG
MIMEOGRAPHS	M IH M IY AA G R AH F S
MISEMPHASES	M IH S EH M F AH S IY Z
MISEMPHASIS	M IH S EH M F AH S AH S
MISEMPHASIZE	M IH S EH M F AH S AY Z
MISEMPHASIZED	M IH S EH M F AH S AY Z D
MISEMPHASIZES	M IH S EH M F AH S AY Z IH Z
MISEMPHASIZING	M IH S EH M F AH S AY Z IH NG
MISPHRASE	M IH S F R EY Z
MISPHRASED	M IH S F R EY Z D
MISPHRASES	M IH S F R EY Z IH Z
MISPHRASING	M IH S F R EY Z IH NG
MONADELPHOUS	M AA N AH D EH L F AH S
MONOGRAPH	M AA N AH G R AE F
MONOGRAPHED	M AA N AH G R AE F T
MONOGRAPHIC	M AA N AH G R AE F IH K
MONOGRAPHING	M AA N AH G R AE F IH NG
MONOGRAPHS	M AA N AH G R AE F S
MONOMORPHEMIC	M AA N OW M AO R F IY M IH K
MONOMORPHIC	M AA N OW M AO R F IH K
MONOMORPHISM	M AA N OW M AO R F IH Z AH M
MONOMORPHISMS	M AA N OW M AO R F IH Z AH M Z
MONOPHAGIES	M AH N AA F AH JH AY Z
MONOPHAGOUS	M AA N AH F EY JH AH S
MONOPHAGY	M AH N AA F AH JH IY
MONOPHONIC	M AA N AH F AA N IH K
MONOPHONICALLY	M AA N AH F AA N IH K AH L IY
MONOPHONIES	M AA N OW F OW N IY Z
MONOPHONY	M AA N OW F OW N IY
MONOPHTHONG	M AH N AA F TH AH NG
MONOPHTHONGAL	M AH N AA F TH AA N G AH L
MONOPHTHONGS	M AH N AA F TH AH NG Z
MONOPHYLETIC	M AH N AA F AH L AH T AH K
MONOPHYLIES	M AH N AA F AH L AY Z
MONOPHYLY	M AH N AA F AH L IY
MORPH	M AO R F
MORPHACTIN	M AO R F AE K T IH N
MORPHACTINS	M AO R F AE K T IH N Z
MORPHALLAXES	M AO R F AO L AE K S IH Z
MORPHALLAXIS	M AO R F AO L AE K S AH S
MORPHED	M AO R F T
MORPHEME	M AO R F IY M
MORPHEMES	M AO R F IY M Z
MORPHEMIC	M AO R F IY M IH K
MORPHEMICALLY	M AO R F IY M IH K AH L IY
MORPHEMICS	M AO R F IY M IH K S
MORPHIA	M AO R F IY AH
MORPHIAS	M AO R F IY AH Z
MORPHIC	M AO R F IH K
MORPHIN	M AO R F AH N
MORPHINE	M AO R F IY N
MORPHINES	M AO R F IY N Z
MORPHING	M AO R F IH NG
MORPHINISM	M AO R F IY N IH Z AH M
MORPHINISMS	M AO R F IY N IH Z AH M Z
MORPHINS	M AO R F IH N Z
MORPHO	M AO R F OW
MORPHOGEN	M AO R F AH JH AH N
MORPHOGENESES	M AO R F AA JH AH N IY Z AH Z
MORPHOGENESIS	M AO R F AH JH EH N AH S AH S
MORPHOGENETIC	M AO R F AA JH AH N AH T AH K
MORPHOGENETICALLY	M AO R F AH JH AH N EH T AH K AE L IY
MORPHOGENIC	M AO R F AH JH AH N AH K
MORPHOGENS	M AO R F AH JH AH N Z
MORPHOLOGIC	M AO R F AH L AH JH AH K
MORPHOLOGICAL	M AO R F AH L AA JH IH K AH L
MORPHOLOGICALLY	M AO R F AH L AA JH IH K AH L IY
MORPHOLOGIES	M AO R F AA L AH JH IY Z
MORPHOLOGIST	M AO R F AA L AH JH AH S T
MORPHOLOGISTS	M AO R F AA L AH JH AH S T S
MORPHOLOGY	M AO R F AA L AH JH IY
MORPHOMETRIC	M AO R F AH M AH T R AH K
MORPHOMETRICALLY	M AO R F AH M EH T R AH K AE L IY
MORPHOMETRIES	M AO R F AH M EH T R AY Z
MORPHOMETRY	M AO R F AH M EH T R IY
MORPHOPHONEMICS	M AO R F OW F AH N IY M IH K S
MORPHOS	M AO R F AA S
MORPHS	M AO R F S
MULTIPHASE	M AH L T AY F EY Z
MULTIPHASIC	M AH L T AY F EY Z IH K
MULTIPHOTON	M AH L T AH F AA T AH N
MURPHIES	M ER F IY Z
MURPHY	M ER F IY
MYCETOPHAGOUS	M AH S EH T AH F EY JH AH S
MYCOPHAGIES	M AH K AA F AH JH AY Z
MYCOPHAGIST	M AH K AA F AH JH AH S T
MYCOPHAGISTS	M AH K AA F AH JH AH S T S
MYCOPHAGOUS	M IH K AH F EY JH AH S
MYCOPHAGY	M AH K AA F AH JH IY
MYCOPHILE	M IH K AH F AY L
MYCOPHILES	M IH K AH F AY L Z
MYELENCEPHALA	M AY AH L AH N S EH F AH L AH
MYELENCEPHALIC	M AY AH L EH N S AH F AH L AH K
MYELENCEPHALON	M AY AH L AH N S EH F AH L AH N
MYELENCEPHALONS	M AY AH L AH N S EH F AH L AH N Z
MYOGRAPH	M AY AA G R AH F
MYOGRAPHS	M AY AA G R AH F S
MYRMECOPHILE	M AH R M EH K AH F AY L
MYRMECOPHILES	M AH R M EH K AH F AY L Z
MYRMECOPHILOUS	M AH R M EH K AH F AY L AH S
MYTHOGRAPHER	M AH TH AA G R AH F AH R
MYTHOGRAPHERS	M AH TH AA G R AH F AH R Z
MYTHOGRAPHIES	M AH TH AA G R AH F AY Z
MYTHOGRAPHY	M AH TH AA G R AH F IY
NALORPHINE	N AE L AH R F AY N
NALORPHINES	N AE L AH R F AY N Z
NAPHTHA	N AE F TH AH
NAPHTHALENE	N AE F TH AH L IY N
NAPHTHALENES	N AE F TH AH L IY N Z
NAPHTHAS	N AE F TH AH Z
NAPHTHENE	N AE F TH IY N
NAPHTHENES	N AE F TH IY N Z
NAPHTHENIC	N AE F TH AH N AH K
NAPHTHOL	N AE F TH AH L
NAPHTHOLS	N AE F TH AH L Z
NAPHTHYL	N AE F TH AH L
NAPHTHYLAMINE	N AE F TH IH L AH M AY N
NAPHTHYLAMINES	N AE F TH IH L AH M AY N Z
NAPHTHYLS	N AE F TH AH L Z
NAPHTOL	N AE F T AH L
NAPHTOLS	N AE F T AH L Z
NASOPHARYNGEAL	N AH S AA F AH R IH N JH IY AH L
NASOPHARYNGES	N AH S AA F AH R IH N JH AH Z
NASOPHARYNX	N AH S AA F ER IH NG K S
NASOPHARYNXES	N AH S AA F AH R AH NG K S
NECROPHAGOUS	N EH K R AH F EY JH AH S
NECROPHILIA	N EH K R AH F IH L Y AH
NECROPHILIAC	N EH K R AH F IH L IY AH K
NECROPHILIACS	N EH K R AH F IH L IY AH S
NECROPHILIAS	N EH K R AH F IH L Y AH Z
NECROPHILIC	N EH K R AH F AY L AH K
NECROPHILISM	N EH K R AH F AH L IH Z AH M
NECROPHILISMS	N EH K R AA F AH L AH Z AH M Z
NEGROPHOBE	N EH G R AH F OW B
NEGROPHOBES	N EH G R AH F OW B Z
NEGROPHOBIA	N EH G R AH F OW B IY AH
NEGROPHOBIAS	N EH G R AH F OW B IY AH Z
NEMOPHILA	N AH M AA F AH L AH
NEMOPHILAS	N AH M AA F AH L AH Z
NEOMORPH	N IY OW M AO R F
NEOMORPHS	N IY OW M AO R F S
NEOPHILIA	N IY AH F IH L Y AH
NEOPHILIAC	N IY AH F IH L IY AH K
NEOPHILIACS	N IY AH F IH L IY AH S
NEOPHILIAS	N IY AH F IH L Y AH Z
NEOPHYTE	N IY AH F AY T
NEOPHYTES	N IY AH F AY T S
NEPHELINE	N EH F AH L AY N
NEPHELINES	N EH F AH L AY N Z
NEPHELINIC	N EH F AH L AH N AH K
NEPHELINITE	N AH F EH L AH N AY T
NEPHELINITES	N AH F EH L AH N AY T S
NEPHELINITIC	N AH F EH L AH N AH T AH K
NEPHELITE	N EH F AH L AY T
NEPHELITES	N EH F AH L AY T S
NEPHELOMETER	N EH F AH L AA M AH T AH R
NEPHELOMETERS	N EH F AH L AA M AH T AH R Z
NEPHELOMETRIC	N AH F EH L AH M AH T R AH K
NEPHELOMETRICALLY	N EH F AH L AH M EH T R AH K AE L IY
NEPHELOMETRIES	N EH F AH L AH M EH T R AY Z
NEPHELOMETRY	N EH F AH L AH M EH T R IY
NEPHEW	N EH F Y UW
NEPHEWS	N EH F Y UW Z
NEPHOSCOPE	N EH F AH S OW P
NEPHOSCOPES	N EH F AH S OW P S
NEPHRECTOMIES	N EH F R EH K T AH M AY Z
NEPHRECTOMIZE	N EH F R EH K T AH M AY Z
NEPHRECTOMIZED	N EH F R EH K T AH M AY Z D
NEPHRECTOMIZES	N EH F R EH K T AH M AY Z AH Z
NEPHRECTOMIZING	N EH F R EH K T AH M AY Z AH NG
NEPHRECTOMY	N EH F R EH K T AH M IY
NEPHRIC	N EH F R AH K
NEPHRIDIA	N EH F R IH D IY AH
NEPHRIDIAL	N EH F R IH D IY AH L
NEPHRIDIUM	N AH F R IH D IY AH M
NEPHRISM	N EH F R AH Z AH M
NEPHRISMS	N EH F R AH Z AH M Z
NEPHRITE	N EH F R AY T
NEPHRITES	N EH F R AY T S
NEPHRITIC	N EH F R AH T AH K
NEPHRITIDES	N EH F R AH T AY D Z
NEPHRITIS	N EH F R AY T AH S
NEPHROLOGIES	N EH F R AA L AH JH AY Z
NEPHROLOGIST	N EH F R AA L AH JH AH S T
NEPHROLOGISTS	N EH F R AA L AH JH AH S T S
NEPHROLOGY	N EH F R AA L AH JH IY
NEPHRON	N EH F R AA N
NEPHRONS	N EH F R AH N Z
NEPHROPATHIC	N EH F R AH P AH TH AH K
NEPHROPATHIES	N EH F R AA P AH TH AY Z
NEPHROPATHY	N EH F R AA P AH TH IY
NEPHROSES	N EH F R OW Z AH Z
NEPHROSIS	N AH F R OW S AH S
NEPHROSTOME	N EH F R AH S T OW M
NEPHROSTOMES	N EH F R AH S T OW M Z
NEPHROTIC	N EH F R AH T AH K
NEPHROTICS	N EH F R AH T AH S Z
NEPHROTOXIC	N EH F R AH T AH K S AH K
NEPHROTOXICITIES	N EH F R AH T AA K S IH S AH T AY Z
NEPHROTOXICITY	N EH F R AH T AA K S IH S AH T IY
NEUROHYPOPHYSEAL	N Y UH R AH HH IH P AH F IH Z IY AH L
NEUROHYPOPHYSES	N Y AH R AH HH IH P AH F AY Z AH Z
NEUROHYPOPHYSIAL	N Y UH R AH HH IH P AH F IH Z IY AH L
NEUROHYPOPHYSIS	N Y UH R AH HH AH P AA F AH S AH S
NEUROPHARMACOLOGIC	N Y UH R AH F AH R M AE K AH L AH JH AH K
NEUROPHARMACOLOGICAL	N Y UH R AH F AA R M AH K AA L AH JH IH S AH L
NEUROPHARMACOLOGIES	N Y AH R AH F AA R M AH K AA L AH JH AY Z
NEUROPHARMACOLOGIST	N Y UH R AH F AA R M AH K AA L AH JH AH S T
NEUROPHARMACOLOGISTS	N Y AH R AH F AA R M AH K AA L AH JH AH S T S
NEUROPHARMACOLOGY	N Y UH R AH F AA R M AH K AA L AH JH IY
NEUROPHYSIOLOGIC	N Y UH R AH F AH S IY AH L AH JH AH K
NEUROPHYSIOLOGICAL	N Y AH R AA F AH S IY AA L AH JH IH S AH L
NEUROPHYSIOLOGICALLY	N Y AH R AH F IH S IY AH L AA JH AH K AE L IY
NEUROPHYSIOLOGIES	N Y AH R AA F AH S IY AA L AH JH AY Z
NEUROPHYSIOLOGIST	N Y AH R AA F AH S IY AA L AH JH AH S T
NEUROPHYSIOLOGISTS	N Y AH R AA F AH S IY AA L AH JH AH S T S
NEUROPHYSIOLOGY	N Y AH R AA F AH S IY AA L AH JH IY
NEUTROPHIL	N UW T R AH F IH L
NEUTROPHILIC	N UW T R AH F IH L IH K
NEUTROPHILS	N UW T R AH F IH L Z
NOMOGRAPH	N AH M AA G R AH F
NOMOGRAPHIC	N AH M AA G R AH F AH K
NOMOGRAPHIES	N AH M AA G R AH F AY Z
NOMOGRAPHS	N AH M AA G R AH F S
NOMOGRAPHY	N AH M AA G R AH F IY
NONALPHABETIC	N AA N AE L F AH B EH T IH K
NONBIBLIOGRAPHIC	N AA N B IH B L IY AH G R AE F IH K
NONBIOGRAPHICAL	N AA N B AY AH G R AE F IH K AH L
NONEMPHATIC	N AA N IH M F AE T IH K
NONMETAPHORICAL	N AA N M EH T AH F AO R IH K AH L
NONPHILOSOPHER	N AA N F AH L AA S AH F ER
NONPHILOSOPHERS	N AA N F AH L AA S AH F ER Z
NONPHILOSOPHICAL	N AA N F IH L AH S AA F IH K AH L
NONPHONEMIC	N AA N F OW N IY M IH K
NONPHONETIC	N AA N F AH N EH T IH K
NONPHOSPHATE	N AA N F AA S F EY T
NONPHOSPHATES	N AA N F AA S F EY T S
NONPHOTOGRAPHIC	N AA N F OW T AH G R AE F IH K
NONPHYSICAL	N AA N F IH Z AH K AH L
NONPHYSICIAN	N AA N F AH Z IH SH AH N
NONPHYSICIANS	N AA N F AH Z IH SH AH N Z
NONSCHIZOPHRENIC	N AA N S K IH T S AH F R EH N IH K
NONSPHERICAL	N AA N S F IH ER IH K AH L
NOOSPHERE	N UW S AH R
NOOSPHERES	N UW S IY R Z
NOREPINEPHRINE	N AH R AH P IH N AH F R AY N
NOREPINEPHRINES	N AH R AH P IH N AH F R AY N Z
NUCLEOPHILE	N AH K L IY AH F AY L
NUCLEOPHILES	N AH K L IY AH F AY L Z
NUCLEOPHILIC	N AH K L IY AH F AY L AH K
NUCLEOPHILICALLY	N AH K L IY AH F IH L AH K AE L IY
NUCLEOPHILICITIES	N AH K L IY AH F AH L IH S AH T AY Z
NUCLEOPHILICITY	N AH K L IY AH F AH L IH S AH T IY
NYMPH	N IH M F
NYMPHA	N IH M F AH
NYMPHAE	N IH M F IY
NYMPHAL	N IH M F AH L
NYMPHALID	N IH M F AH L AH D
NYMPHALIDS	N IH M F AH L AH D Z
NYMPHEAN	N IH M F IY AH N
NYMPHET	N IH M F AH T
NYMPHETS	N IH M F AH T S
NYMPHETTE	N IH M F EH T
NYMPHETTES	N IH M F EH T S
NYMPHO	N IH M F OW
NYMPHOLEPSIES	N IH M F AH L EH P S AY Z
NYMPHOLEPSY	N IH M F AH L EH P S IY
NYMPHOLEPT	N IH M F AH L AH P T
NYMPHOLEPTIC	N IH M F AH L AH P T AH K
NYMPHOLEPTS	N IH M F AH L AH P T S
NYMPHOMANIA	N IH M F AH M EY N Y AH
NYMPHOMANIAC	N IH M F OW M EY N IY AE K
NYMPHOMANIACAL	N IH M F AH M EY N IY AE K AH L
NYMPHOMANIACS	N IH M F OW M EY N IY AE K S
NYMPHOMANIAS	N IH M F AH M EY N Y AH Z
NYMPHOS	N IH M F AA S
NYMPHS	N IH M F S
OCEANOGRAPHER	OW SH AH N AA G R AH F ER
OCEANOGRAPHERS	OW S AH N AA G R AH F AH R Z
OCEANOGRAPHIC	OW SH AH N AH G R AE F IH K
OCEANOGRAPHICAL	OW SH AH N AH G R AE F IH K AH L
OCEANOGRAPHICALLY	OW SH AH N AH G R AE F IH K AH L IY
OCEANOGRAPHIES	OW SH AH N AA G R AH F IY Z
OCEANOGRAPHY	OW SH AH N AA G R AH F IY
ODOGRAPH	AH D AA G R AH F
ODOGRAPHS	AH D AA G R AH F S
OENOPHILE	IY N AH F AY L
OENOPHILES	OW EH N AH F AY L Z
OESOPHAGI	OW AH S AA F AH JH IY
OESOPHAGUS	OW AH S AA F AH JH AH S
OLEOGRAPH	OW L IY AA G R AH F
OLEOGRAPHS	OW L IY AA G R AH F S
OLIGOPHAGIES	AA L AH G AA F AH JH AY Z
OLIGOPHAGOUS	AH L IH G AH F EY JH AH S
OLIGOPHAGY	AA L AH G AA F AH JH IY
OLIGOTROPHIC	AA L AH G AA T R AH F AH K
OMOPHAGIES	AH M AA F AH JH AY Z
OMOPHAGY	AH M AA F AH JH IY
OMPHALI	AA M F AH L IY
OMPHALOS	AA M F AH L AH Z
OMPHALOSES	AA M F AH L OW Z AH Z
OMPHALOSKEPSES	AA M F AH L AA S EH P S AH Z
OMPHALOSKEPSIS	AA M F AH L AA S EH P S AH S
ONYCHOPHORAN	AA N AH CH AA F AH R AH N
ONYCHOPHORANS	AA N AH CH AA F AH R AH N Z
OOMPH	UW M F
OOMPHS	UW M F S
OOPHORECTOMIES	UW F AH R EH K T AH M AY Z
OOPHORECTOMY	UW F AH R EH K T AH M IY
OOPHYTE	UW F AY T
OOPHYTES	UW F AY T S
OOPHYTIC	UW F AH T AH K
OOSPHERE	UW S AH R
OOSPHERES	UW S IY R Z
OPHIDIAN	AH F IH D IY AH N
OPHIDIANS	AH F IH D IY AH N Z
OPHITE	AH F AY T
OPHITES	AH F AY T S
OPHITIC	AA F AH T AH K
OPHIUROID	AH F AY Y AH R OY D
OPHIUROIDS	AA F IY AH R OY D Z
OPHTHALMIA	AA F TH AE L M IY AH
OPHTHALMIAS	AA F TH AE L M IY AH Z
OPHTHALMIC	AA F TH AE L M IH K
OPHTHALMOLOGIC	AA F TH AE L M AH L AH JH AH K
OPHTHALMOLOGICAL	AA F TH AE L M AA L AH JH IH S AH L
OPHTHALMOLOGICALLY	AA F TH AE L M AH L AA JH AH K AE L IY
OPHTHALMOLOGIES	AA F TH AE L M AA L AH JH AY Z
OPHTHALMOLOGIST	AA P TH AH M AA L AH JH IH S T
OPHTHALMOLOGIST(2)	AA F TH AH M AA L AH JH IH S T
OPHTHALMOLOGISTS	AA P TH AH M AA L AH JH IH S T S
OPHTHALMOLOGISTS(2)	AA P TH AH M AA L AH JH IH S
OPHTHALMOLOGISTS(3)	AA F TH AH M AA L AH JH IH S T S
OPHTHALMOLOGISTS(4)	AA F TH AH M AA L AH JH IH S
OPHTHALMOLOGY	AA P TH AH M AA L AH JH IY
OPHTHALMOLOGY(2)	AA F TH AH M AA L AH JH IY
OPHTHALMOSCOPE	AA F TH AE L M AH S K OW P
OPHTHALMOSCOPES	AA F TH AE L M AH S OW P S
OPHTHALMOSCOPIC	AA F TH AH L M AA S AH P AH K
OPHTHALMOSCOPIES	AA F TH AH L M AA S AH P AY Z
OPHTHALMOSCOPY	AA F TH AH L M AA S AH P IY
ORGANOPHOSPHATE	AO R G AH N AA F AH S EY T
ORGANOPHOSPHATES	AO R G AH N AA F AH S EY T S
ORGANOPHOSPHOROUS	AO R G AH N AH F AA S AH R AH S
ORGANOPHOSPHORUS	AO R G AH N AH F AA S AH R AH S
ORGANOPHOSPHORUSES	AO R G AH N AH F AA S AH R UW Z AH Z
OROGRAPHIC	AO R AH G R AE F IH K
OROGRAPHICAL	AH R AA G R AH F IH S AH L
OROGRAPHIES	AH R AA G R AH F AY Z
OROGRAPHY	AH R AA G R AH F IY
OROPHARYNGEAL	AH R AA F AH R IH N JH IY AH L
OROPHARYNGES	AH R AA F AH R IH N JH AH Z
OROPHARYNX	AH R AA F AH R AH NG K S
OROPHARYNXES	AH R AA F AH R AH NG K S
ORPHAN	AO R F AH N
ORPHANAGE	AO R F AH N AH JH
ORPHANAGES	AO R F AH N IH JH IH Z
ORPHANED	AO R F AH N D
ORPHANHOOD	AO R F AH N HH UH D
ORPHANHOODS	AO R F AH N HH UH D Z
ORPHANING	AO R F AH N IH NG
ORPHANS	AO R F AH N Z
ORPHIC	AO R F IH K
ORPHICAL	AO R F IH K AH L
ORPHICALLY	AO R F IH K AH L IY
ORPHREY	AO R F R IY
ORPHREYS	AO R F R EY Z
ORTHOGRAPHIC	AO R TH AH G R AE F IH K
ORTHOGRAPHICAL	AO R TH AH G R AE F IH K AH L
ORTHOGRAPHICALLY	AO R TH AH G R AE F IH K AH L IY
ORTHOGRAPHIES	AO R TH AA G R AH F IY Z
ORTHOGRAPHY	AO R TH AA G R AH F IY
ORTHOPHOSPHATE	AO R TH AH F AA S F EY T
ORTHOPHOSPHATES	AO R TH AH F AA S F EY T S
OSCILLOGRAPH	AA S AH L AA G R AH F
OSCILLOGRAPHIC	AA S AH L AA G R AH F AH K
OSCILLOGRAPHICALLY	AA S IH L AA G R AE F AH K AE L IY
OSCILLOGRAPHIES	AA S AH L AA G R AH F AY Z
OSCILLOGRAPHS	AA S AH L AA G R AH F S
OSCILLOGRAPHY	AA S AH L AA G R AH F IY
OUPH	UW F
OUPHE	UW F
OUPHES	UW F S
OUPHS	UW F S
OVEREMPHASES	OW V ER EH M F AH S IY Z
OVEREMPHASIS	OW V AH R EH M F AH S AH S
OVEREMPHASIZE	OW V ER EH M F AH S AY Z
OVEREMPHASIZED	OW V ER EH M F AH S AY Z D
OVEREMPHASIZES	OW V ER EH M F AH S AY Z IH Z
OVEREMPHASIZING	OW V ER EH M F AH S AY Z IH NG
OVEREMPHATIC	OW V ER IH M F AE T IH K
OVERSOPHISTICATED	OW V ER S AA F IH S T IH K EY T IH D
OXYPHENBUTAZONE	AA K S AH F AH N B Y UW T AH Z OW N
OXYPHENBUTAZONES	AA K S AH F AH N B Y UW T AH Z OW N Z
OXYPHIL	AA K S AH F AH L
OXYPHILE	AA K S AH F AY L
OXYPHILES	AA K S AH F AY L Z
OXYPHILIC	AA K S AH F AY L AH K
OXYPHILS	AA K S AH F AY L Z
OZONOSPHERE	AA Z AH N AA S AH R
OZONOSPHERES	AH Z AA N AH S IY R Z
PAEDOMORPHIC	P IY D AH M AH R F AH K
PAEDOMORPHISM	P IY D AH M AH R F IH Z AH M
PAEDOMORPHISMS	P IY D AH M AO R F AH Z AH M Z
PAEDOMORPHOSES	P IY D AA M AH R F OW Z AH Z
PAEDOMORPHOSIS	P IY D AH M AH R F OW S AH S
PALEOGEOGRAPHIC	P EY L IY OW JH IY AA G R AH F AH K
PALEOGEOGRAPHICAL	P EY L IY OW JH IY AA G R AH F IH S AH L
PALEOGEOGRAPHICALLY	P EY L IY OW JH IY AA G R AE F AH K AE L IY
PALEOGEOGRAPHIES	P EY L IY OW JH IY AA G R AH F AY Z
PALEOGEOGRAPHY	P EY L IY OW JH IY AA G R AH F IY
PALEOGRAPHER	P EY L IY AA G R AH F AH R
PALEOGRAPHERS	P EY L IY AA G R AH F AH R Z
PALEOGRAPHIC	P EY L IY AA G R AH F AH K
PALEOGRAPHICAL	P EY L IY AA G R AH F IH S AH L
PALEOGRAPHICALLY	P EY L IY AA G R AE F AH K AE L IY
PALEOGRAPHIES	P EY L IY AA G R AH F AY Z
PALEOGRAPHY	P EY L IY AA G R AH F IY
PAMPHLET	P AE M F L AH T
PAMPHLETEER	P AE M F L AH T IH R
PAMPHLETEERED	P AE M F L AH T IH R D
PAMPHLETEERING	P AE M F L AH T IH R IH NG
PAMPHLETEERS	P AE M F L AH T IH R Z
PAMPHLETS	P AE M F L AH T S
PANSOPHIES	P AE N S AH F AY Z
PANSOPHY	P AE N S AH F IY
PANTOGRAPH	P AE N T AA G R AH F
PANTOGRAPHIC	P AE N T AA G R AH F AH K
PANTOGRAPHS	P AE N T AA G R AH F S
PAPHIAN	P AE F IY AH N
PAPHIANS	P AE F IY AH N Z
PARAGRAPH	P AE R AH G R AE F
PARAGRAPH(2)	P EH R AH G R AE F
PARAGRAPHED	P AE R AH G R AE F T
PARAGRAPHER	P AE R AH G R AE F ER
PARAGRAPHERS	P AE R AH G R AE F ER Z
PARAGRAPHIC	P AE R AH G R AE F IH K
PARAGRAPHING	P AE R AH G R AE F IH NG
PARAGRAPHS	P AE R AH G R AE F S
PARAGRAPHS(2)	P EH R AH G R AE F S
PARANYMPH	P AA R AH N IH M F
PARANYMPHS	P AA R AH N IH M F S
PARAPH	P AE R AH F
PARAPHERNALIA	P EH R AH F AH N EY L Y AH
PARAPHRASABLE	P AE R AH F R EY Z AH B AH L
PARAPHRASE	P EH R AH F R EY Z
PARAPHRASED	P AE R AH F R EY Z D
PARAPHRASER	P AE R AH F R EY Z ER
PARAPHRASERS	P AE R AH F R EY Z ER Z
PARAPHRASES	P AE R AH F R EY Z IH Z
PARAPHRASING	P EH R AH F R EY Z IH NG
PARAPHRASTIC	P AH R AE F R AH S T AH K
PARAPHRASTICALLY	P AE R AH F R AE S T AH K AE L IY
PARAPHS	P AE R AH F S
PARAPHYSES	P AE R AH F AY Z AH Z
PARAPHYSIS	P AH R AE F AH S AH S
PARATYPHOID	P AA R AH T AY F OY D
PARATYPHOIDS	P AA R AH T AY F OY D Z
PATHOPHYSIOLOGIC	P AE TH AH F AH S IY AH L AH JH AH K
PATHOPHYSIOLOGICAL	P AH TH AA F AH S IY AA L AH JH IH S AH L
PATHOPHYSIOLOGIES	P AH TH AA F AH S IY AA L AH JH AY Z
PATHOPHYSIOLOGY	P AH TH AA F AH S IY AA L AH JH IY
PEDOPHILE	P EH D OW F AY L
PEDOPHILE(2)	P EH D AH F IH L
PEDOPHILES	P EH D OW F AY L Z
PEDOPHILES(2)	P EH D AH F IH L Z
PEDOPHILIA	P EH D AH F IH L Y AH
PEDOPHILIAC	P EH D AH F IH L Y AE K
PEDOPHILIAS	P EH D AH F IH L Y AH Z
PEDOPHILIC	P EH D OW F IH L IH K
PEEPHOLE	P IY P HH OW L
PEEPHOLES	P IY P HH OW L Z
PEMPHIGUS	P EH M F AH G AH S
PEMPHIGUSES	P EH M F AH G Y UW Z AH Z
PEMPHIX	P EH M F AH K S
PEMPHIXES	P EH M F AH K S
PENTACHLOROPHENOL	P EH N T AE K L AH R AA F AH N AH L
PENTACHLOROPHENOLS	P EH N T AE K L AH R AA F AH N AH L Z
PERILYMPH	P AH R IH L AH M F
PERILYMPHS	P AH R IH L AH M F S
PERIPHERAL	P ER IH F ER AH L
PERIPHERAL(2)	P ER IH F R AH L
PERIPHERALLY	P ER IH F ER AH L IY
PERIPHERALLY(2)	P ER IH F R AH L IY
PERIPHERALS	P ER IH F ER AH L Z
PERIPHERALS(2)	P ER IH F R AH L Z
PERIPHERIES	P AH R IH F ER IY Z
PERIPHERY	P ER IH F ER IY
PERIPHRASES	P AH R IH F R EY Z AH Z
PERIPHRASIS	P AH R IH F R AH S AH S
PERIPHRASTIC	P EH R AH F R AE S T IH K
PERIPHRASTICALLY	P EH R AH F R AE S T IH K AH L IY
PERIPHYTIC	P AH R IH F AH T AH K
PERIPHYTON	P AH R IH F AH T AH N
PERIPHYTONS	P AH R IH F AH T AH N Z
PERPHENAZINE	P AH R F EH N AH Z AY N
PERPHENAZINES	P AH R F EH N AH Z AY N Z
PETROGLYPH	P EH T R OW G L IH F
PETROGLYPHS	P EH T R OW G L IH F S
PETROGRAPHER	P EH T R AA G R AH F AH R
PETROGRAPHERS	P EH T R AA G R AH F AH R Z
PETROGRAPHIC	P EH T R AA G R AH F AH K
PETROGRAPHICAL	P EH T R AA G R AH F IH S AH L
PETROGRAPHICALLY	P EH T R AA G R AE F AH K AE L IY
PETROGRAPHIES	P EH T R AA G R AH F AY Z
PETROGRAPHY	P EH T R AA G R AH F IY
PHAETON	F IY T AH N
PHAETONS	F IY T AH N Z
PHAGE	F EY JH
PHAGES	F EY JH AH Z
PHAGOCYTE	F AE G AH S AY T
PHAGOCYTES	F AE G AH S AY T S
PHAGOCYTIC	F AE G AH S AY T IH K
PHAGOCYTIZE	F AE G AH S AY T AY Z
PHAGOCYTIZED	F AE G AH S AY T AY Z D
PHAGOCYTIZES	F AE G AH S AY T AY Z IH Z
PHAGOCYTIZING	F AE G AH S AY T AY Z IH NG
PHAGOCYTOSE	F AH G AA S AH T OW Z
PHAGOCYTOSED	F AH G AA S AH T OW Z D
PHAGOCYTOSES	F AH G AA S AH T OW Z AH Z
PHAGOCYTOSING	F AH G AA S AH T OW Z AH NG
PHAGOCYTOSIS	F AE G AH S AH T OW S AH S
PHAGOCYTOTIC	F AH G AA S AH T AH T AH K
PHALANGE	F AH L AE N JH
PHALANGE(2)	F AH L EY N JH
PHALANGEAL	F AH L AE N JH IY AH L
PHALANGER	F AE L AH NG AH R
PHALANGERS	F AH L AE N JH AH R Z
PHALANGES	F AH L AE N JH IY Z
PHALANGES(2)	F AH L EY N JH IH Z
PHALANSTERIES	F AH L AE N S T AH R AY Z
PHALANSTERY	F AE L AH N S T EH R IY
PHALANX	F EY L AE NG K S
PHALANXES	F EY L AE NG K S IH Z
PHALAROPE	F AE L AH R OW P
PHALAROPES	F AE L AH R OW P S
PHALLI	F AE L IY
PHALLIC	F AE L IH K
PHALLICALLY	F AE L AH K AE L IY
PHALLICISM	F AE L AH S IH Z AH M
PHALLICISMS	F AE L AH S AH Z AH M Z
PHALLISM	F AE L AH Z AH M
PHALLISMS	F AE L AH Z AH M Z
PHALLIST	F AE L AH S T
PHALLISTS	F AE L AH S T S
PHALLOCENTRIC	F AE L AH S AH N T R AH K
PHALLUS	F AE L AH S
PHALLUSES	F AE L UW Z AH Z
PHANEROGAM	F AH N EH R AH G AH M
PHANEROGAMS	F AH N EH R AH G AH M Z
PHANEROPHYTE	F AH N EH R AH F AY T
PHANEROPHYTES	F AH N EH R AH F AY T S
PHANTASIED	F AE N T AH S IY D
PHANTASIES	F AE N T AH S IY Z
PHANTASM	F AE N T AE Z AH M
PHANTASMA	F AE N T AE Z M AH
PHANTASMAGORIA	F AE N T AE Z M AH G AO R IY AH
PHANTASMAGORIAS	F AE N T AE Z M AH G AO R IY AH Z
PHANTASMAGORIC	F AE N T AE Z M AH G AH R AH K
PHANTASMAGORICAL	F AE N T AE Z M AE G AH R IH S AH L
PHANTASMAL	F AE N T AE Z M AH L
PHANTASMATA	F AE N T AE Z M AH T AH
PHANTASMIC	F AE N T AH Z M AH K
PHANTASMS	F AE N T AH Z AH M Z
PHANTAST	F AE N T AH S T
PHANTASTS	F AE N T AH S T S
PHANTASY	F AE N T AH S IY
PHANTASYING	F AE N T AH S IY IH NG
PHANTOM	F AE N T AH M
PHANTOM(2)	F AE N AH M
PHANTOMLIKE	F AE N T AH M L AY K
PHANTOMS	F AE N T AH M Z
PHANTOMS(2)	F AE N AH M Z
PHARAOH	F EH R OW
PHARAOH(2)	F EY R OW
PHARAOHS	F EH R OW Z
PHARAOHS(2)	F EY R OW Z
PHARAONIC	F EH R AH AA N IH K
PHARISAIC	F AE R AH S EY AH K
PHARISAICAL	F AH R IH S EY IH S AH L
PHARISAICALLY	F AE R AH S AH K AE L IY
PHARISAICALNESS	F AE R AH S AH K AE L N AH S
PHARISAICALNESSES	F AE R AH S AH K AE L N EH S AH Z
PHARISAISM	F AE R IH S EY IH Z AH M
PHARISAISMS	F AE R AH S EY Z AH M Z
PHARISEE	F AE R AH Z IY IY
PHARISEES	F AE R AH Z IY Z
PHARMACEUTICAL	F AA R M AH S UW T IH K AH L
PHARMACEUTICALLY	F AA R M AH S UW T IH K AH L IY
PHARMACEUTICALS	F AA R M AH S UW T IH K AH L Z
PHARMACIES	F AA R M AH S IY Z
PHARMACIST	F AA R M AH S IH S T
PHARMACISTS	F AA R M AH S IH S T S
PHARMACODYNAMIC	F AA R M AH K AA D AH N AH M AH K
PHARMACODYNAMICALLY	F AA R M AE K AH D AH N AE M AH K AE L IY
PHARMACODYNAMICS	F AA R M AH K AH D IH N AH M AH S Z
PHARMACOGNOSIES	F AA R M AH K AA G N AH S AY Z
PHARMACOGNOSTIC	F AA R M AH K AA G N AH S T AH K
PHARMACOGNOSTICAL	F AA R M AH K AA G N AA S T IH S AH L
PHARMACOGNOSY	F AA R M AH K AA G N AH Z IY
PHARMACOKINETIC	F AA R M AH K AA K AH N AH T AH K
PHARMACOKINETICS	F AA R M AH K AH K IH N AH T AH S Z
PHARMACOLOGIC	F AA R M AH K AH L AA JH IH K
PHARMACOLOGICAL	F AA R M AH K AH L AA JH IH K AH L
PHARMACOLOGICALLY	F AA R M AH K AH L AA JH IH K AH L IY
PHARMACOLOGIES	F AA R M AH K AA L AH JH AY Z
PHARMACOLOGIST	F AA R M AH K AA L AH JH IH S T
PHARMACOLOGISTS	F AA R M AH K AA L AH JH IH S T S
PHARMACOLOGY	F AA R M AH K AA L AH JH IY
PHARMACOPEIA	F AA R M AH K OW P IY AH
PHARMACOPEIAL	F AA R M AH K AH P IY IY AH L
PHARMACOPEIAS	F AA R M AH K OW P IY AH Z
PHARMACOPOEIA	F AA R M AH K AH P IY AH
PHARMACOPOEIAL	F AA R M AH K AA P OW EH IY AH L
PHARMACOPOEIAS	F AA R M AH K AH P IY AH Z
PHARMACOTHERAPIES	F AA R M AH K AH TH EH R AH P AY Z
PHARMACOTHERAPY	F AA R M AH K AH TH EH R AH P IY
PHARMACY	F AA R M AH S IY
PHAROS	F EH R OW Z
PHAROSES	F AH R OW Z AH Z
PHARYNGEAL	F AH R IH N JH IY AH L
PHARYNGES	F AH R IH N JH AH Z
PHARYNGITIDES	F AH R IH N JH AH T AY D Z
PHARYNGITIS	F AE R AH N JH AY T AH S
PHARYNX	F EH R IH NG K S
PHARYNXES	F AE R AH NG K S
PHASE	F EY Z
PHASEAL	F EY Z AH L
PHASED	F EY Z D
PHASEDOWN	F EY Z D AW N
PHASEDOWNS	F EY Z D AW N Z
PHASEOUT	F EY Z AW T
PHASEOUTS	F EY Z AW T S
PHASES	F EY Z AH Z
PHASES(2)	F EY Z IH Z
PHASIC	F EY Z IH K
PHASING	F EY Z IH NG
PHASIS	F EY Z IY Z
PHASMID	F AE Z M AH D
PHASMIDS	F AE Z M AH D Z
PHAT	F AE T
PHATIC	F AE T AH K
PHATICALLY	F AE T AH K AE L IY
PHEASANT	F EH Z AH N T
PHEASANTS	F EH Z AH N T S
PHELLEM	F EH L AH M
PHELLEMS	F EH L AH M Z
PHELLODERM	F EH L AH D AH R M
PHELLODERMS	F EH L AH D AH R M Z
PHELLOGEN	F EH L AH JH AH N
PHELLOGENS	F EH L AH JH AH N Z
PHELONIA	F AH L OW N Y AH
PHELONION	F AH L OW N IY AH N
PHELONIONS	F AH L OW N IY AH N Z
PHENACAINE	F EH N AH K EY N
PHENACAINES	F EH N AH K EY N Z
PHENACETIN	F AH N AE S AH T AH N
PHENACETINS	F AH N AE S AH T AH N Z
PHENACITE	F EH N AH S AY T
PHENACITES	F EH N AH S AY T S
PHENAKITE	F EH N AH K AY T
PHENAKITES	F EH N AH K AY T S
PHENANTHRENE	F EH N AH N TH R IY N
PHENANTHRENES	F EH N AH N TH R IY N Z
PHENATE	F IY N EY T
PHENATES	F IY N EY T S
PHENAZIN	F EH N AH Z AH N
PHENAZINE	F EH N AH Z AY N
PHENAZINES	F EH N AH Z AY N Z
PHENAZINS	F EH N AH Z AH N Z
PHENCYCLIDINE	F EH N S IH K L AH D AY N
PHENCYCLIDINES	F EH N S IH K L AH D AY N Z
PHENETIC	F EH N AH T AH K
PHENETICIST	F EH N AH T IH S AH S T
PHENETICISTS	F AH N EH T AH S AH S T S
PHENETICS	F EH N AH T AH S Z
PHENETOL	F EH N AH T AH L
PHENETOLS	F EH N AH T AH L Z
PHENIX	F EH N IH K S
PHENIXES	F EH N AH K S
PHENMETRAZINE	F EH N M EH T R AH Z AY N
PHENMETRAZINES	F EH N M EH T R AH Z AY N Z
PHENOBARBITAL	F EH N AH B AA R B AH T AH L
PHENOBARBITALS	F EH N AH B AA R B AH T AH L Z
PHENOBARBITONE	F AH N AH B AA R B AH T OW N
PHENOBARBITONES	F AH N AH B AA R B AH T OW N Z
PHENOCOPIES	F AH N AA K AH P AY Z
PHENOCOPY	F AH N AA K AH P IY
PHENOCRYST	F AH N AA K R AH S T
PHENOCRYSTIC	F AH N AA K R AH S T AH K
PHENOCRYSTS	F AH N AA K R AH S T S
PHENOL	F IY N AA L
PHENOL(2)	F EH N AH L
PHENOLATE	F EH N AH L EY T
PHENOLATED	F EH N AH L EY T AH D
PHENOLATES	F EH N AH L EY T S
PHENOLIC	F AH N AA L IH K
PHENOLICS	F EH N AH L AH S Z
PHENOLOGICAL	F AH N AA L AH JH IH S AH L
PHENOLOGICALLY	F EH N AH L AA JH AH K AE L IY
PHENOLOGIES	F AH N AA L AH JH AY Z
PHENOLOGY	F AH N AA L AH JH IY
PHENOLPHTHALEIN	F IY N AA L F TH EY L AH N
PHENOLPHTHALEIN(2)	F EH N AA L F TH EY L AH N
PHENOLPHTHALEINS	F AH N OW L F TH AH L IY N Z
PHENOLS	F EH N AH L Z
PHENOM	F EH N AH M
PHENOMENA	F AH N AA M AH N AH
PHENOMENAL	F AH N AA M AH N AH L
PHENOMENALISM	F IH N AA M AH N AH L IH Z AH M
PHENOMENALISMS	F IH N AA M AH N AH L IH Z AH M Z
PHENOMENALIST	F IH N AA M AH N AH L IH S T
PHENOMENALISTIC	F IH N AA M AH N AH L IH S T IH K
PHENOMENALISTICALLY	F IH N AA M AH N AH L IH S T IH K AH L IY
PHENOMENALISTS	F IH N AA M AH N AH L IH S T S
PHENOMENALLY	F AH N AA M AH N AH L IY
PHENOMENAS	F IH N AA M AH N AH Z
PHENOMENOLOGICAL	F IH N AA M AH N AH L AA JH IH K AH L
PHENOMENOLOGICALLY	F IH N AA M AH N AH L AA JH IH K AH L IY
PHENOMENOLOGIES	F EH N AH M AH N AA L AH JH AY Z
PHENOMENOLOGIST	F EH N AH M AH N AA L AH JH AH S T
PHENOMENOLOGISTS	F EH N AH M AH N AA L AH JH AH S T S
PHENOMENOLOGY	F AH N AA M AH N AA L AA G IY
PHENOMENON	F AH N AA M AH N AA N
PHENOMENONS	F IH N AA M AH N AA N Z
PHENOMS	F EH N AH M Z
PHENOTHIAZINE	F IY N OW TH AY AH Z IY N
PHENOTHIAZINES	F IY N OW TH AY AH Z IY N Z
PHENOTYPE	F IY N AH T AY P
PHENOTYPES	F IY N AH T AY P S
PHENOTYPIC	F IY N AH T IH P IH K
PHENOTYPICAL	F AH N AA T AH P IH S AH L
PHENOTYPICALLY	F EH N AH T IH P AH K AE L IY
PHENOXIDE	F EH N AH K S AY D
PHENOXIDES	F EH N AH K S AY D Z
PHENOXY	F AH N AA K S IY
PHENTOLAMINE	F EH N T AA L AH M AY N
PHENTOLAMINES	F EH N T AA L AH M AY N Z
PHENYL	F EH N AH L
PHENYLALANINE	F AH N AH L AE L AH N AY N
PHENYLALANINES	F AH N AH L AE L AH N AY N Z
PHENYLBUTAZONE	F AH N AH L B Y UW T AH Z OW N
PHENYLBUTAZONES	F AH N AH L B Y UW T AH Z OW N Z
PHENYLEPHRINE	F AH N IH L AH F R AY N
PHENYLEPHRINES	F AH N IH L AH F R AY N Z
PHENYLETHYLAMINE	F AH N AH L AH TH IH L AH M AY N
PHENYLETHYLAMINES	F AH N AH L AH TH IH L AH M AY N Z
PHENYLIC	F EH N AH L AH K
PHENYLKETONURIA	F AH N IH L K AH T AH N Y UH R IY AH
PHENYLKETONURIAS	F AH N IH L K AH T AH N Y UH R IY AH Z
PHENYLKETONURIC	F AH N IH L K AH T AA N Y AH R AH K
PHENYLKETONURICS	F AH N IH L K AH T AA N Y AH R AH S Z
PHENYLPROPANOLAMINE	F AH N AH L P R AH P AH N AA L AH M AY N
PHENYLPROPANOLAMINES	F AH N AH L P R AH P AH N AA L AH M AY N Z
PHENYLS	F EH N AH L Z
PHENYLTHIOCARBAMIDE	F AH N AH L TH IY AH K AA R B AH M AY D
PHENYLTHIOCARBAMIDES	F AH N AH L TH IY AH K AA R B AH M AY D Z
PHENYLTHIOUREA	F AH N IH L TH IY AH R IY AH
PHENYLTHIOUREAS	F AH N IH L TH IY AH R IY Z
PHENYTOIN	F EH N AH T OY N
PHENYTOINS	F EH N AH T OY N Z
PHEOCHROMOCYTOMA	F IY AA K R AH M AH S IH T AH M AH
PHEOCHROMOCYTOMAS	F IY AA K R AH M AH S IH T AH M AH Z
PHEOCHROMOCYTOMATA	F IY AH K R AA M AH S AH T AA M AH T AH
PHEROMONAL	F AH R AA M AH N AH L
PHEROMONE	F EH R AH M OW N
PHEROMONES	F EH R AH M OW N Z
PHEW	F Y UW
PHI	F AY
PHIAL	F AY AH L
PHIALS	F AY AH L Z
PHILABEG	F IH L AH B AH G
PHILABEGS	F IH L AH B AH G Z
PHILADELPHUS	F IH L AH D EH L F AH S
PHILADELPHUSES	F AH L AE D AH L F Y UW Z AH Z
PHILANDER	F AH L AE N D ER
PHILANDERED	F IH L AH N D IY R D
PHILANDERER	F AH L AE N D EH R ER
PHILANDERERS	F AH L AE N D EH R ER Z
PHILANDERING	F AY L AE N D ER IH NG
PHILANDERING(2)	F AH L AE N D ER IH NG
PHILANDERS	F AH L AE N D AH R Z
PHILANTHROPIC	F IH L AH N TH R AA P IH K
PHILANTHROPICAL	F IH L AH N TH R AA P IH K AH L
PHILANTHROPICALLY	F IH L AH N TH R AA P IH K AH L IY
PHILANTHROPIES	F AH L AE N TH R AH P IY Z
PHILANTHROPIST	F AH L AE N TH R AH P AH S T
PHILANTHROPIST(2)	F IH L AE N TH R AH P IH S T
PHILANTHROPISTS	F IH L AE N TH R AH P IH S T S
PHILANTHROPOID	F AH L AE N TH R AH P OY D
PHILANTHROPOIDS	F AH L AE N TH R AH P OY D Z
PHILANTHROPY	F IH L AE N TH R AH P IY
PHILATELIC	F IH L AH T EH L AH K
PHILATELICALLY	F IH L AH T EH L AH K AE L IY
PHILATELIES	F AH L AE T AH L AY Z
PHILATELIST	F IH L AE T AH L IH S T
PHILATELISTS	F AH L AE T AH L AH S T S
PHILATELY	F IH L AE T AH L IY
PHILHARMONIC	F IH L HH AA R M AA N IH K
PHILHARMONICS	F IH L HH AA R M AA N IH K S
PHILHELLENE	F IH L HH AH L IY N
PHILHELLENES	F IH L HH AH L IY N Z
PHILHELLENIC	F IH L HH EH L AH N AH K
PHILHELLENISM	F IH L HH EH L AH N IH Z AH M
PHILHELLENISMS	F IH L HH EH L AH N AH Z AH M Z
PHILHELLENIST	F IH L HH EH L AH N AH S T
PHILHELLENISTS	F IH L HH EH L AH N AH S T S
PHILIBEG	F IH L AH B AH G
PHILIBEGS	F IH L AH B AH G Z
PHILIPPIC	F IH L IH P IH K
PHILIPPICS	F AH L IH P AH S Z
PHILISTIA	F IH L IH S T IY AH
PHILISTINE	F IH L AH S T IY N
PHILISTINES	F IH L AH S T IY N Z
PHILISTINISM	F IH L AH S T IY N IH Z AH M
PHILISTINISMS	F IH L AH S T IY N IH Z AH M Z
PHILLUMENIST	F IH L UW M AH N AH S T
PHILLUMENISTS	F IH L UW M AH N AH S T S
PHILODENDRA	F IH L AH D EH N D R AH
PHILODENDRON	F IH L AH D EH N D R AH N
PHILODENDRONS	F IH L AH D EH N D R AH N Z
PHILOLOGICAL	F IH L AH L AA JH IH K AH L
PHILOLOGICALLY	F IH L AH L AA JH IH K AH L IY
PHILOLOGIES	F AH L AA L AH JH IY Z
PHILOLOGIST	F AH L AA L AH JH AH S T
PHILOLOGISTS	F AH L AA L AH JH AH S T S
PHILOLOGY	F AH L AA L AH JH IY
PHILOMEL	F IH L AH M AH L
PHILOMELS	F IH L AH M AH L Z
PHILOPROGENITIVE	F AH L AA P R AH JH EH N AH T AH V
PHILOPROGENITIVENESS	F AH L AH P R AH JH EH N AH T AY V N AH S
PHILOPROGENITIVENESSES	F AH L AH P R AA JH AH N AH T IH V AH N EH S AH Z
PHILOSOPHE	F IH L AH S AH F
PHILOSOPHER	F AH L AA S AH F ER
PHILOSOPHERS	F AH L AA S AH F ER Z
PHILOSOPHES	F IH L AH S AH F S
PHILOSOPHIC	F IH L AH S AA F IH K
PHILOSOPHICAL	F IH L AH S AA F IH K AH L
PHILOSOPHICALLY	F IH L AH S AA F IH K AH L IY
PHILOSOPHICALLY(2)	F IH L AH S AA F IH K L IY
PHILOSOPHIES	F AH L AA S AH F IY Z
PHILOSOPHISE	F AH L AA S AH F AY Z
PHILOSOPHISED	F AH L AA S AH F IY Z D
PHILOSOPHISES	F AH L AA S AH F IY Z IH Z
PHILOSOPHISING	F AH L AA S AH F IY Z IH NG
PHILOSOPHIZE	F AH L AA S AH F AY Z
PHILOSOPHIZED	F AH L AA S AH F AY Z D
PHILOSOPHIZER	F AH L AA S AH F AY Z ER
PHILOSOPHIZERS	F AH L AA S AH F AY Z ER Z
PHILOSOPHIZES	F AH L AA S AH F AY Z IH Z
PHILOSOPHIZING	F AH L AA S AH F AY Z IH NG
PHILOSOPHY	F AH L AA S AH F IY
PHILTER	F IH L T AH R
PHILTERED	F IH L T IY R D
PHILTERING	F IH L T IY R AH NG
PHILTERS	F IH L T AH R Z
PHILTRA	F IH L T R AH
PHILTRE	F IH L T AH R
PHILTRED	F IH L T AH R D
PHILTRES	F IH L T AH R Z
PHILTRING	F IH L T R AH NG
PHILTRUM	F IH L T R AH M
PHIMOSES	F AH M OW Z AH Z
PHIMOSIS	F AY M OW S AH S
PHIMOTIC	F IH M AH T AH K
PHIS	F AY Z
PHIZ	F IH Z
PHIZES	F AY Z AH Z
PHLEBITIDES	F L EH B AH T AY D Z
PHLEBITIS	F L AH B AY T IH S
PHLEBOGRAM	F L AH B AA G R AH M
PHLEBOGRAMS	F L AH B AA G R AH M Z
PHLEBOGRAPHIC	F L AH B AA G R AH F AH K
PHLEBOGRAPHIES	F L AH B AA G R AH F AY Z
PHLEBOGRAPHY	F L AH B AA G R AH F IY
PHLEBOLOGIES	F L AH B AA L AH JH AY Z
PHLEBOLOGY	F L AH B AA L AH JH IY
PHLEBOTOMIES	F L AH B AA T AH M AY Z
PHLEBOTOMIST	F L AH B AA T AH M AH S T
PHLEBOTOMISTS	F L AH B AA T AH M AH S T S
PHLEBOTOMY	F L AH B AA T AH M IY
PHLEGM	F L EH M
PHLEGMATIC	F L EH G M AE T IH K
PHLEGMATICALLY	F L EH G M AE T AH K AE L IY
PHLEGMIER	F L EH G M AY AH R
PHLEGMIEST	F L EH G M AY AH S T
PHLEGMS	F L EH M Z
PHLEGMY	F L EH M IY
PHLOEM	F L OW EH M
PHLOEMS	F L OW EH M Z
PHLOGISTIC	F L AA JH AH S T AH K
PHLOGISTON	F L AH JH IH S T AH N
PHLOGISTONS	F L AH JH IH S T AH N Z
PHLOGOPITE	F L AA G AH P AY T
PHLOGOPITES	F L AA G AH P AY T S
PHLOX	F L AA K S
PHLOXES	F L AA K S
PHOBIA	F OW B IY AH
PHOBIAS	F OW B IY AH Z
PHOBIC	F OW B IH K
PHOBICS	F AA B AH S Z
PHOCINE	F AH S AY N
PHOEBE	F IY B IY
PHOEBES	F OW AH B Z
PHOEBUS	F IY B AH S
PHOEBUSES	F OW AH B Y UW Z AH Z
PHOENIX	F IY N IH K S
PHOENIXES	F IY N IH K S IH Z
PHOENIXLIKE	F IY N IH K S L AY K
PHON	F AA N
PHONAL	F OW N AH L
PHONATE	F OW N AH T
PHONATED	F OW N EY T IH D
PHONATES	F OW N AH T S
PHONATING	F OW N EY T IH NG
PHONATION	F OW N EY SH AH N
PHONATIONS	F OW N EY SH AH N Z
PHONE	F OW N
PHONED	F OW N D
PHONEMATIC	F OW N IY M AH T IH K
PHONEME	F OW N IY M
PHONEMES	F OW N IY M Z
PHONEMIC	F AH N IY M IH K
PHONEMICALLY	F OW N IY M IH K AH L IY
PHONEMICIST	F OW N IY M IH K IH S T
PHONEMICISTS	F OW N IY M IH K IH S T S
PHONEMICS	F OW N IY M IH K S
PHONES	F OW N Z
PHONETIC	F AH N EH T IH K
PHONETICALLY	F AH N EH T IH K L IY
PHONETICIAN	F AA N AH T IH S IY AH N
PHONETICIANS	F AA N AH T IH S IY AH N Z
PHONETICS	F AH N EH T IH K S
PHONEY	F OW N IY
PHONEYED	F OW N IY D
PHONEYING	F OW N IY IH NG
PHONEYS	F OW N IY Z
PHONIC	F AA N IH K
PHONICALLY	F AA N IH K AH L IY
PHONICS	F AA N IH K S
PHONIED	F OW N IY D
PHONIER	F OW N IY ER
PHONIES	F OW N IY Z
PHONIEST	F OW N IY AH S T
PHONILY	F OW N IY L IY
PHONINESS	F OW N IY N AH S
PHONINESSES	F OW N IY N AH S IH Z
PHONING	F OW N IH NG
PHONO	F OW N OW
PHONOCARDIOGRAM	F AH N AH K AA R D IY AA G R AH M
PHONOCARDIOGRAMS	F AH N AH K AA R D IY AA G R AH M Z
PHONOCARDIOGRAPH	F AH N AH K AA R D IY AA G R AH F
PHONOCARDIOGRAPHIC	F AH N AH K AA R D IY AA G R AH F AH K
PHONOCARDIOGRAPHIES	F AH N AH K AA R D IY AA G R AH F AY Z
PHONOCARDIOGRAPHS	F AH N AH K AA R D IY AA G R AH F S
PHONOCARDIOGRAPHY	F AH N AH K AA R D IY AA G R AH F IY
PHONOGRAM	F AH N AA G R AH M
PHONOGRAMIC	F AH N AA G R AH M AH K
PHONOGRAMICALLY	F AH N AA G R AE M AH K AE L IY
PHONOGRAMMIC	F AH N AA G R AH M AH K
PHONOGRAMMICALLY	F AA N AH G R AE M AH K AE L IY
PHONOGRAMS	F AH N AA G R AH M Z
PHONOGRAPH	F OW N AH G R AE F
PHONOGRAPHER	F OW N AH G R AE F ER
PHONOGRAPHERS	F OW N AH G R AE F ER Z
PHONOGRAPHIC	F OW N AH G R AE F IH K
PHONOGRAPHICALLY	F OW N AH G R AE F IH K AH L IY
PHONOGRAPHIES	F OW N AH G R AE F IY Z
PHONOGRAPHS	F OW N AH G R AE F S
PHONOGRAPHY	F OW N AH G R AE F IY
PHONOLITE	F AA N AH L AY T
PHONOLITES	F AA N AH L AY T S
PHONOLOGIC	F OW N AH L AA JH IH K
PHONOLOGICAL	F OW N AH L AA JH IH K AH L
PHONOLOGICALLY	F OW N AH L AA JH IH K AH L IY
PHONOLOGIES	F OW N AA L AH JH IY Z
PHONOLOGIST	F OW N AA L AH JH AH S T
PHONOLOGISTS	F OW N AA L AH JH AH S T S
PHONOLOGY	F AH N AA L AH JH IY
PHONON	F AA N AH N
PHONONS	F AA N AH N Z
PHONOS	F AA N AH Z
PHONOTACTIC	F AA N AH T AH K T AH K
PHONOTACTICS	F AA N AH T AE K T AH S Z
PHONS	F AA N Z
PHONY	F OW N IY
PHONYING	F OW N IY IH NG
PHOOEY	F UW IY
PHORATE	F AH R EY T
PHORATES	F AH R EY T S
PHORONID	F AO R AH N AH D
PHORONIDS	F AO R AH N AH D Z
PHOSGENE	F AA Z JH IY N
PHOSGENES	F AA Z JH IY N Z
PHOSPHATASE	F AA S AH T EY Z
PHOSPHATASES	F AA S AH T EY Z AH Z
PHOSPHATE	F AA S F EY T
PHOSPHATES	F AA S F EY T S
PHOSPHATIC	F AA S F AE T IH K
PHOSPHATIDE	F AA S AH T AY D
PHOSPHATIDES	F AA S AH T AY D Z
PHOSPHATIDIC	F AA S F EY T AH D IH K
PHOSPHATIDYL	F AA S AE T AH D AH L
PHOSPHATIDYLCHOLINE	F AA S AH T AH D IH L CH AH L AY N
PHOSPHATIDYLCHOLINES	F AA S AH T AH D IH L CH AH L AY N Z
PHOSPHATIDYLETHANOLAMINE	F AA S AH T AH D AH L AH TH AH N AA L AH M AY N
PHOSPHATIDYLETHANOLAMINES	F AA S AH T AH D AH L AH TH AH N AA L AH M AY N Z
PHOSPHATIDYLS	F AA S AE T AH D AH L Z
PHOSPHATIZATION	F AA S F EY T AH Z EY SH AH N
PHOSPHATIZATIONS	F AA S F EY T AH Z EY SH AH N Z
PHOSPHATIZE	F AA S F EY T AY Z
PHOSPHATIZED	F AA S F EY T AY Z D
PHOSPHATIZES	F AA S F EY T AY Z IH Z
PHOSPHATIZING	F AA S F EY T AY Z IH NG
PHOSPHATURIA	F AA S AH T Y UH R IY AH
PHOSPHATURIAS	F AA S AH T Y UH R IY AH Z
PHOSPHENE	F AA S IY N
PHOSPHENES	F AA S IY N Z
PHOSPHID	F AA S AH D
PHOSPHIDE	F AA S F AY D
PHOSPHIDES	F AA S F AY D Z
PHOSPHIDS	F AA S AH D Z
PHOSPHIN	F AA S AH N
PHOSPHINE	F AA S F IY N
PHOSPHINES	F AA S F IY N Z
PHOSPHINS	F AA S AH N Z
PHOSPHITE	F AA S AY T
PHOSPHITES	F AA S AY T S
PHOSPHOCREATINE	F AA S AA K R AH T AY N
PHOSPHOCREATINES	F AA S AA K R AH T AY N Z
PHOSPHODIESTERASE	F AA S AH D IY S T AH R EY Z
PHOSPHODIESTERASES	F AA S AH D IY S T AH R EY Z AH Z
PHOSPHOENOLPYRUVATE	F AA S OW AH N OW L P AH R AH V EY T
PHOSPHOENOLPYRUVATES	F AA S OW AH N OW L P AH R AH V EY T S
PHOSPHOFRUCTOKINASE	F AA S AH F R AH K T AA K AH N EY Z
PHOSPHOFRUCTOKINASES	F AA S AH F R AH K T AA K AH N EY Z AH Z
PHOSPHOGLUCOMUTASE	F AA S AH G L AH K AA M Y AH T EY Z
PHOSPHOGLUCOMUTASES	F AA S AH G L AH K AA M Y AH T EY Z AH Z
PHOSPHOGLYCERALDEHYDE	F AA S AH G L AH S AH R AE L D AH HH AY D
PHOSPHOGLYCERALDEHYDES	F AA S AH G L AH S AH R AE L D AH HH AY D Z
PHOSPHOGLYCERATE	F AA S AA G L IH S AH R EY T
PHOSPHOGLYCERATES	F AA S AA G L IH S AH R EY T S
PHOSPHOKINASE	F AA S AA K AH N EY Z
PHOSPHOKINASES	F AA S AA K AH N EY Z AH Z
PHOSPHOLIPASE	F AA S AA L AH P EY Z
PHOSPHOLIPASES	F AA S AA L AH P EY Z AH Z
PHOSPHOLIPID	F AA S AA L AH P AH D
PHOSPHOLIPIDS	F AA S AA L AH P AH D Z
PHOSPHOMONOESTERASE	F AA S AH M AH N OW EH S T AH R EY Z
PHOSPHOMONOESTERASES	F AA S AH M AH N OW EH S T AH R EY Z AH Z
PHOSPHONIUM	F AA S OW N IY AH M
PHOSPHONIUMS	F AA S OW N IY AH M Z
PHOSPHOPROTEIN	F AA S AA P R AH T IY N
PHOSPHOPROTEINS	F AA S AA P R AH T IY N Z
PHOSPHOR	F AA S F AO R
PHOSPHORE	F AA S AH R
PHOSPHORES	F AA S AH R Z
PHOSPHORESCE	F AA S F AH R EH S
PHOSPHORESCED	F AA S F AH R EH S T
PHOSPHORESCENCE	F AA S F ER EH S AH N S
PHOSPHORESCENCES	F AA S F AH R EH S AH N S IH Z
PHOSPHORESCENT	F AA S F AH R EH S AH N T
PHOSPHORESCENTLY	F AA S F AH R EH S AH N T L IY
PHOSPHORESCES	F AA S F AH R EH S IH Z
PHOSPHORESCING	F AA S F AH R EH S IH NG
PHOSPHORIC	F AA S F ER IH K
PHOSPHORITE	F AA S F ER AY T
PHOSPHORITES	F AA S F ER AY T S
PHOSPHORITIC	F AA S AH R AH T AH K
PHOSPHOROLYSES	F AA S AO R AH L AY Z AH Z
PHOSPHOROLYSIS	F AA S AH R AA L AH S AH S
PHOSPHOROLYTIC	F AA S AO R AH L AH T AH K
PHOSPHOROUS	F AA S F ER AH S
PHOSPHORS	F AA S F AO R Z
PHOSPHORUS	F AA S F ER AH S
PHOSPHORUSES	F AA S F AH R AH S IH Z
PHOSPHORYL	F AA S AH R AH L
PHOSPHORYLASE	F AA S AO R AH L EY Z
PHOSPHORYLASES	F AA S AO R AH L EY Z AH Z
PHOSPHORYLATE	F AA S F ER IY L EY T
PHOSPHORYLATED	F AA S F ER IY L EY T IH D
PHOSPHORYLATES	F AA S F ER IY L EY T S
PHOSPHORYLATING	F AA S F ER IY L EY T IH NG
PHOSPHORYLATION	F AA S F ER IY L EY SH AH N
PHOSPHORYLATIONS	F AA S F ER IY L EY SH AH N Z
PHOSPHORYLATIVE	F AA S F ER IY L EY T IH V
PHOSPHORYLS	F AA S AH R AH L Z
PHOT	F AA T
PHOTIC	F AA T AH K
PHOTICALLY	F AA T AH K AE L IY
PHOTICS	F AA T AH S Z
PHOTO	F OW T OW
PHOTOAUTOTROPH	F AA T OW AH T AA T R AH F
PHOTOAUTOTROPHIC	F AA T OW AH T AA T R AH F AH K
PHOTOAUTOTROPHICALLY	F AH T OW AH T AA T R AA F AH K AE L IY
PHOTOAUTOTROPHS	F AA T OW AH T AA T R AH F S
PHOTOBIOLOGIC	F OW T OW B AY AH L AA JH IH K
PHOTOBIOLOGICAL	F OW T OW B AY AH L AA JH IH K AH L
PHOTOBIOLOGIES	F OW T OW B AY AA L AH JH IY Z
PHOTOBIOLOGIST	F OW T OW B AY AA L AH JH AH S T
PHOTOBIOLOGISTS	F OW T OW B AY AA L AH JH AH S T S
PHOTOBIOLOGY	F OW T OW B AY AA L AH JH IY
PHOTOCATHODE	F OW T OW K AE TH OW D
PHOTOCATHODES	F OW T OW K AE TH OW D Z
PHOTOCELL	F OW T OW S EH L
PHOTOCELLS	F OW T OW S EH L Z
PHOTOCHEMICAL	F OW T OW K EH M IH K AH L
PHOTOCHEMICALLY	F OW T OW K EH M IH K AH L IY
PHOTOCHEMIST	F OW T OW K EH M AH S T
PHOTOCHEMISTRIES	F OW T OW K EH M AH S T R IY Z
PHOTOCHEMISTRY	F OW T OW K EH M AH S T R IY
PHOTOCHEMISTS	F OW T OW K EH M AH S T S
PHOTOCHROMIC	F OW T OW K R OW M IH K
PHOTOCHROMISM	F OW T OW K R OW M IH Z AH M
PHOTOCHROMISMS	F OW T OW K R OW M IH Z AH M Z
PHOTOCOAGULATION	F OW T OW K OW AE G Y AH L EY SH AH N
PHOTOCOAGULATIONS	F OW T OW K OW AE G Y AH L EY SH AH N Z
PHOTOCOMPOSE	F OW T OW K AH M P OW Z
PHOTOCOMPOSED	F OW T OW K AH M P OW Z D
PHOTOCOMPOSER	F OW T OW K AH M P OW Z ER
PHOTOCOMPOSERS	F OW T OW K AH M P OW Z ER Z
PHOTOCOMPOSES	F OW T OW K AH M P OW Z IH Z
PHOTOCOMPOSING	F OW T OW K AH M P OW Z IH NG
PHOTOCOMPOSITION	F OW T OW K AA M P AH Z IH SH AH N
PHOTOCOMPOSITIONS	F OW T OW K AA M P AH Z IH SH AH N Z
PHOTOCONDUCTIVE	F OW T OW K AH N D AH K T IH V
PHOTOCONDUCTIVITIES	F OW T OW K AA N D AH K T IH V AH T IY Z
PHOTOCONDUCTIVITY	F OW T OW K AA N D AH K T IH V AH T IY
PHOTOCOPIED	F OW T OW K AA P IY D
PHOTOCOPIER	F OW T OW K AA P IY ER
PHOTOCOPIERS	F OW T OW K AA P IY ER Z
PHOTOCOPIES	F OW T OW K AA P IY Z
PHOTOCOPY	F OW T OW K AA P IY
PHOTOCOPYING	F OW T OW K AA P IY IH NG
PHOTOCURRENT	F OW T OW K ER AH N T
PHOTOCURRENTS	F OW T OW K ER AH N T S
PHOTODECOMPOSITION	F OW T OW D IY K AA M P AH Z IH SH AH N
PHOTODECOMPOSITIONS	F OW T OW D IY K AA M P AH Z IH SH AH N Z
PHOTODEGRADABLE	F OW T OW D IY G R EY D AH B AH L
PHOTODETECTOR	F OW T OW D IH T EH K T ER
PHOTODETECTORS	F OW T OW D IH T EH K T ER Z
PHOTODIODE	F AH T OW D IY OW D
PHOTODIODES	F AH T OW D IY OW D Z
PHOTODISINTEGRATE	F OW T OW D IH S IH N T AH G R AH T
PHOTODISINTEGRATED	F OW T OW D IH S IH N T AH G R EY T IH D
PHOTODISINTEGRATES	F OW T OW D IH S IH N T AH G R AH T S
PHOTODISINTEGRATING	F OW T OW D IH S IH N T AH G R EY T IH NG
PHOTODISINTEGRATION	F OW T OW D IH S IH N T AH G R EY SH AH N
PHOTODISINTEGRATIONS	F OW T OW D IH S IH N T AH G R EY SH AH N Z
PHOTODISSOCIATE	F OW T OW D IH S OW SH AH T
PHOTODISSOCIATED	F OW T OW D IH S OW SH EY T IH D
PHOTODISSOCIATES	F OW T OW D IH S OW SH AH T S
PHOTODISSOCIATING	F OW T OW D IH S OW SH EY T IH NG
PHOTODISSOCIATION	F OW T OW D IH S OW SH EY SH AH N
PHOTODISSOCIATIONS	F OW T OW D IH S OW SH EY SH AH N Z
PHOTODUPLICATE	F OW T OW D UW P L IH K AH T
PHOTODUPLICATED	F OW T OW D UW P L IH K EY T IH D
PHOTODUPLICATES	F OW T OW D UW P L IH K AH T S
PHOTODUPLICATING	F OW T OW D UW P L IH K EY T IH NG
PHOTODUPLICATION	F OW T OW D UW P L IH K EY SH AH N
PHOTODUPLICATIONS	F OW T OW D UW P L IH K EY SH AH N Z
PHOTODYNAMIC	F OW T OW D AY N AE M IH K
PHOTODYNAMICALLY	F OW T OW D AY N AE M IH K AH L IY
PHOTOED	F OW T OW D
PHOTOELECTRIC	F OW T OW IH L EH K T R IH K
PHOTOELECTRICALLY	F OW T OW IH L EH K T R IH K AH L IY
PHOTOELECTRON	F OW T AH W AH L EH K T R AA N
PHOTOELECTRONIC	F OW T AH W AH L EH K T R AA N IH K
PHOTOELECTRONS	F OW T AH W AH L EH K T R AA N Z
PHOTOEMISSION	F OW T OW IY M IH SH AH N
PHOTOEMISSIONS	F OW T OW IY M IH SH AH N Z
PHOTOEMISSIVE	F OW T OW IY M IH S IH V
PHOTOENGRAVE	F OW T OW AH N G R EY V
PHOTOENGRAVED	F OW T OW AH N G R EY V D
PHOTOENGRAVER	F OW T OW AH N G R EY V ER
PHOTOENGRAVERS	F OW T OW AH N G R EY V ER Z
PHOTOENGRAVES	F OW T OW AH N G R EY V Z
PHOTOENGRAVING	F OW T OW AH N G R EY V IH NG
PHOTOENGRAVINGS	F OW T OW AH N G R EY V IH NG Z
PHOTOEXCITATION	F OW T OW IH K S AY T EY SH AH N
PHOTOEXCITATIONS	F OW T OW IH K S AY T EY SH AH N Z
PHOTOEXCITED	F OW T OW IH K S AY T IH D
PHOTOFINISHER	F OW T OW F IH N IH SH ER
PHOTOFINISHERS	F OW T OW F IH N IH SH ER Z
PHOTOFINISHING	F OW T OW F IH N IH SH IH NG
PHOTOFINISHINGS	F OW T OW F IH N IH SH IH NG Z
PHOTOFLASH	F OW T OW F L AE SH
PHOTOFLASHES	F OW T OW F L AE SH IH Z
PHOTOFLOOD	F OW T OW F L AH D
PHOTOFLOODS	F OW T OW F L AH D Z
PHOTOFLUOROGRAPHIES	F AH T AH F L UW W AH R AA G R AH F AY Z
PHOTOFLUOROGRAPHY	F AH T AH F L UW W AH R AA G R AH F IY
PHOTOG	F AA T AH G
PHOTOGENIC	F OW T AH JH EH N IH K
PHOTOGENICALLY	F OW T AH JH EH N IH K AH L IY
PHOTOGEOLOGIC	F OW T OW JH IY AH L AA JH IH K
PHOTOGEOLOGICAL	F OW T OW JH IY AH L AA JH IH K AH L
PHOTOGEOLOGIES	F OW T OW JH IY AA L AH JH IY Z
PHOTOGEOLOGIST	F AA T AH JH IY AA L AH JH AH S T
PHOTOGEOLOGISTS	F AH T OW JH IY AA L AH JH AH S T S
PHOTOGEOLOGY	F OW T OW JH IY AA L AH JH IY
PHOTOGRAM	F OW T OW G R AE M
PHOTOGRAMMETRIC	F OW T OW G R AE M EH T R IH K
PHOTOGRAMMETRIES	F OW T OW G R AE M IY T ER IY Z
PHOTOGRAMMETRIST	F OW T OW G R AE M IY T ER IH S T
PHOTOGRAMMETRISTS	F OW T OW G R AE M IY T ER IH S T S
PHOTOGRAMMETRY	F OW T OW G R AE M IY T ER IY
PHOTOGRAMS	F OW T OW G R AE M Z
PHOTOGRAPH	F OW T AH G R AE F
PHOTOGRAPHED	F OW T AH G R AE F T
PHOTOGRAPHER	F AH T AA G R AH F ER
PHOTOGRAPHERS	F AH T AA G R AH F ER Z
PHOTOGRAPHIC	F OW T AH G R AE F IH K
PHOTOGRAPHICALLY	F OW T AH G R AE F IH K AH L IY
PHOTOGRAPHIES	F AH T AA G R AH F IY Z
PHOTOGRAPHING	F OW T AH G R AE F IH NG
PHOTOGRAPHS	F OW T AH G R AE F S
PHOTOGRAPHY	F AH T AA G R AH F IY
PHOTOGRAVURE	F OW T OW G R EY V Y ER
PHOTOGRAVURES	F OW T OW G R EY V Y ER Z
PHOTOGS	F AA T AH G Z
PHOTOINDUCED	F OW T OW IH N D UW S T
PHOTOINDUCTION	F OW T OW IH N D AH K SH AH N
PHOTOINDUCTIONS	F OW T OW IH N D AH K SH AH N Z
PHOTOINDUCTIVE	F OW T OW IH N D AH K T IH V
PHOTOING	F OW T OW IH NG
PHOTOINTERPRETATION	F OW T OW IH N T ER P R AH T EY SH AH N
PHOTOINTERPRETATIONS	F OW T OW IH N T ER P R AH T EY SH AH N Z
PHOTOINTERPRETER	F OW T OW IH N T ER P R AH T ER
PHOTOINTERPRETERS	F OW T OW IH N T ER P R AH T ER Z
PHOTOIONIZATION	F OW T OW IY AH N AH Z EY SH AH N
PHOTOIONIZATIONS	F OW T OW IY AH N AH Z EY SH AH N Z
PHOTOIONIZE	F OW T OW IY AH N AY Z
PHOTOIONIZED	F OW T OW IY AH N AY Z D
PHOTOIONIZES	F OW T OW IY AH N AY Z IH Z
PHOTOIONIZING	F OW T OW IY AH N AY Z IH NG
PHOTOJOURNALISM	F OW T OW JH ER N AH L IH Z AH M
PHOTOJOURNALISMS	F OW T OW JH ER N AH L IH Z AH M Z
PHOTOJOURNALIST	F OW T OW JH ER N AH L AH S T
PHOTOJOURNALISTIC	F OW T OW JH ER N AH L IH S T IH K
PHOTOJOURNALISTS	F OW T OW JH ER N AH L IH S T S
PHOTOKINESES	F AH T AA K AH N IY Z AH Z
PHOTOKINESIS	F AA T AH K AY N AH S AH S
PHOTOKINETIC	F OW T OW K AH N EH T IH K
PHOTOLITHOGRAPH	F OW T OW L IH TH AH G R AE F
PHOTOLITHOGRAPHED	F OW T OW L IH TH AH G R AE F T
PHOTOLITHOGRAPHIC	F OW T OW L IH TH AH G R AE F IH K
PHOTOLITHOGRAPHICALLY	F OW T OW L IH TH AH G R AE F IH K AH L IY
PHOTOLITHOGRAPHIES	F OW T OW L IH TH AH G R AE F IY Z
PHOTOLITHOGRAPHING	F OW T OW L IH TH AH G R AE F IH NG
PHOTOLITHOGRAPHS	F OW T OW L IH TH AH G R AE F S
PHOTOLITHOGRAPHY	F OW T OW L IH TH AH G R AE F IY
PHOTOLYSES	F OW T OW L IY Z IH Z
PHOTOLYSIS	F OW T OW L IY Z IY Z
PHOTOLYTIC	F AA T AH L AH T AH K
PHOTOLYTICALLY	F AA T AH L IH T AH K AE L IY
PHOTOLYZABLE	F AA T AH L IH Z AH B AH L
PHOTOLYZE	F AA T AH L AY Z
PHOTOLYZED	F AA T AH L AY Z D
PHOTOLYZES	F AA T AH L AY Z AH Z
PHOTOLYZING	F OW T OW L IY Z IH NG
PHOTOMAP	F OW T OW M AE P
PHOTOMAPPED	F OW T OW M AE P T
PHOTOMAPPING	F OW T OW M AE P IH NG
PHOTOMAPS	F OW T OW M AE P S
PHOTOMASK	F OW T OW M AE S K
PHOTOMASKS	F OW T OW M AE S K S
PHOTOMECHANICAL	F OW T OW M IH K AE N IH K AH L
PHOTOMECHANICALLY	F OW T OW M IH K AE N IH K AH L IY
PHOTOMETER	F AH T AA M IH T ER
PHOTOMETERS	F OW T OW M IY T ER Z
PHOTOMETRIC	F OW T OW M EH T R IH K
PHOTOMETRICALLY	F OW T OW M EH T R IH K AH L IY
PHOTOMETRIES	F OW T OW M IY T ER IY Z
PHOTOMETRY	F OW T OW M IY T ER IY
PHOTOMICROGRAPH	F OW T AH M AY K R AH G R AE F
PHOTOMICROGRAPHIC	F OW T AH M AY K R AH G R AE F IH K
PHOTOMICROGRAPHIES	F OW T AH M AY K R AA G R AH F IY Z
PHOTOMICROGRAPHS	F OW T AH M AY K R AH G R AE F S
PHOTOMICROGRAPHY	F OW T AH M AY K R AA G R AH F IY
PHOTOMONTAGE	F OW T OW M AA N T IY IH JH
PHOTOMONTAGES	F OW T OW M AA N T IY IH JH IH Z
PHOTOMORPHOGENESES	F AH T AH M AO R F AA JH AH N IY Z AH Z
PHOTOMORPHOGENESIS	F AH T AH M AO R F AH JH IY N AH S AH S
PHOTOMORPHOGENIC	F AA T AH M AO R F AH JH AH N AH K
PHOTOMOSAIC	F OW T OW M OW Z EY IH K
PHOTOMOSAICS	F OW T OW M OW Z EY IH K S
PHOTOMULTIPLIER	F OW T OW M AH L T AH P L AY ER
PHOTOMULTIPLIERS	F OW T OW M AH L T AH P L AY ER Z
PHOTOMURAL	F OW T OW M Y UH R AH L
PHOTOMURALS	F OW T OW M Y UH R AH L Z
PHOTON	F OW T AA N
PHOTONEGATIVE	F OW T OW N EH G AH T IH V
PHOTONIC	F AA T AH N AH K
PHOTONICS	F AA T AH N AH S Z
PHOTONS	F OW T AA N Z
PHOTONUCLEAR	F OW T OW N UW K L IY ER
PHOTOOXIDATION	F OW T OW AA K S AH D EY SH AH N
PHOTOOXIDATIONS	F OW T OW AA K S AH D EY SH AH N Z
PHOTOOXIDATIVE	F OW T OW AA K S AY D AH T IH V
PHOTOOXIDIZE	F OW T OW AA K S AY D AY Z
PHOTOOXIDIZED	F OW T OW AA K S AY D AY Z D
PHOTOOXIDIZES	F OW T OW AA K S AY D AY Z IH Z
PHOTOOXIDIZING	F OW T OW AA K S AY D AY Z IH NG
PHOTOPERIOD	F OW T OW P IH R IY AH D
PHOTOPERIODIC	F OW T OW P IH R IY AA D IH K
PHOTOPERIODICALLY	F OW T OW P IH R IY AA D IH K AH L IY
PHOTOPERIODISM	F OW T OW P IH R IY AH D IH Z AH M
PHOTOPERIODISMS	F OW T OW P IH R IY AH D IH Z AH M Z
PHOTOPERIODS	F OW T OW P IH R IY AH D Z
PHOTOPHASE	F OW T OW F EY Z
PHOTOPHASES	F OW T OW F EY Z IH Z
PHOTOPHOBIA	F AA T AH F OW B IY AH
PHOTOPHOBIAS	F AA T AH F OW B IY AH Z
PHOTOPHOBIC	F AA T AH F AH B AH K
PHOTOPHORE	F AA T AH F AH R
PHOTOPHORES	F AA T AH F AH R Z
PHOTOPHOSPHORYLATION	F OW T OW F AA S F ER IY L EY SH AH N
PHOTOPHOSPHORYLATIONS	F OW T OW F AA S F ER IY L EY SH AH N Z
PHOTOPIA	F AH T OW P IY AH
PHOTOPIAS	F AH T OW P IY AH Z
PHOTOPIC	F AA T AH P AH K
PHOTOPLAY	F OW T OW P L EY
PHOTOPLAYS	F OW T OW P L EY Z
PHOTOPOLARIMETER	F AA T AH P AA L AH R IH M AH T AH R
PHOTOPOLARIMETERS	F AH T AA P AH L AH R IH M AH T AH R Z
PHOTOPOLYMER	F OW T OW P AA L AH M ER
PHOTOPOLYMERS	F OW T OW P AA L AH M ER Z
PHOTOPOSITIVE	F OW T OW P AA Z AH T IH V
PHOTOPRODUCT	F OW T OW P R AA D AH K T
PHOTOPRODUCTION	F OW T OW P R AA D AH K SH AH N
PHOTOPRODUCTIONS	F OW T OW P R AA D AH K SH AH N Z
PHOTOPRODUCTS	F OW T OW P R AA D AH K T S
PHOTOREACTION	F OW T OW R IY AE K SH AH N
PHOTOREACTIONS	F OW T OW R IY AE K SH AH N Z
PHOTOREACTIVATING	F OW T OW R IY AE K T IH V EY T IH NG
PHOTOREACTIVATION	F OW T OW R IY AE K T IH V EY SH AH N
PHOTOREACTIVATIONS	F OW T OW R IY AE K T IH V EY SH AH N Z
PHOTORECEPTION	F OW T OW R IH S EH P SH AH N
PHOTORECEPTIONS	F OW T OW R IH S EH P SH AH N Z
PHOTORECEPTIVE	F OW T OW R IH S EH P T IH V
PHOTORECEPTOR	F AH T AO R AH S EH P T AH R
PHOTORECEPTORS	F AA T AH R AH S EH P T AH R Z
PHOTORECONNAISSANCE	F OW T OW R IH K AA N AH Z AH N S
PHOTORECONNAISSANCES	F OW T OW R IH K AA N AH Z AH N S IH Z
PHOTOREDUCE	F OW T OW R IH D UW S
PHOTOREDUCED	F OW T OW R IH D UW S T
PHOTOREDUCES	F OW T OW R IH D UW S IH Z
PHOTOREDUCING	F OW T OW R IH D UW S IH NG
PHOTOREDUCTION	F OW T OW R IY D AH K SH AH N
PHOTOREDUCTIONS	F OW T OW R IY D AH K SH AH N Z
PHOTOREPRODUCTION	F OW T OW R IY P R AA D AH K SH AH N
PHOTOREPRODUCTIONS	F OW T OW R IY P R AA D AH K SH AH N Z
PHOTORESIST	F OW T OW R IH Z IH S T
PHOTORESISTS	F OW T OW R IH Z IH S T S
PHOTORESPIRATION	F OW T OW R EH S P AH R EY SH AH N
PHOTORESPIRATIONS	F OW T OW R EH S P AH R EY SH AH N Z
PHOTOS	F OW T OW Z
PHOTOSENSITIVE	F OW T AH S EH N S AH T IH V
PHOTOSENSITIVITIES	F OW T AH S EH N S AH T IH V AH T IY Z
PHOTOSENSITIVITY	F OW T AH S EH N S AH T IH V AH T IY
PHOTOSENSITIZATION	F OW T OW S EH N S AH T AH Z EY SH AH N
PHOTOSENSITIZATIONS	F OW T OW S EH N S AH T AH Z EY SH AH N Z
PHOTOSENSITIZE	F OW T OW S EH N S AH T AY Z
PHOTOSENSITIZED	F OW T OW S EH N S AH T AY Z D
PHOTOSENSITIZER	F OW T OW S EH N S AH T AY Z ER
PHOTOSENSITIZERS	F OW T OW S EH N S AH T AY Z ER Z
PHOTOSENSITIZES	F OW T OW S EH N S AH T AY Z IH Z
PHOTOSENSITIZING	F OW T OW S EH N S AH T AY Z IH NG
PHOTOSET	F OW T OW S EH T
PHOTOSETS	F OW T OW S EH T S
PHOTOSETTER	F OW T OW S EH T ER
PHOTOSETTERS	F OW T OW S EH T ER Z
PHOTOSETTING	F OW T OW S EH T IH NG
PHOTOSPHERE	F OW T OW S F IH ER
PHOTOSPHERES	F OW T OW S F IH ER Z
PHOTOSPHERIC	F OW T OW S F IH ER IH K
PHOTOSTAT	F OW T OW Z T AE T
PHOTOSTATED	F OW T OW S T EY T IH D
PHOTOSTATIC	F OW T OW S T AE T IH K
PHOTOSTATING	F OW T OW S T EY T IH NG
PHOTOSTATS	F OW T OW Z T AE T S
PHOTOSTATTED	F OW T OW Z T AE T IH D
PHOTOSTATTING	F OW T OW Z T AE T IH NG
PHOTOSYNTHATE	F AH T AA S AH N TH EY T
PHOTOSYNTHATES	F AH T AA S AH N TH EY T S
PHOTOSYNTHESES	F AH T AA S AH N TH IY Z AH Z
PHOTOSYNTHESIS	F OW T OW S IH N TH AH S IH S
PHOTOSYNTHESIZE	F OW T OW S IH N TH AH S AY Z
PHOTOSYNTHESIZED	F OW T OW S IH N TH AH S AY Z D
PHOTOSYNTHESIZES	F OW T OW S IH N TH AH S AY Z IH Z
PHOTOSYNTHESIZING	F OW T OW S IH N TH AH S AY Z IH NG
PHOTOSYNTHETIC	F OW T OW S IH N TH EH T IH K
PHOTOSYNTHETICALLY	F OW T OW S IH N TH EH T IH K AH L IY
PHOTOSYSTEM	F OW T OW S IH S T AH M
PHOTOSYSTEMS	F OW T OW S IH S T AH M Z
PHOTOTACTIC	F OW T OW T AE K T IH K
PHOTOTACTICALLY	F OW T OW T AE K T IH K AH L IY
PHOTOTAXES	F OW T OW T AE K S IH Z
PHOTOTAXIS	F OW T AH T AE K S IH S
PHOTOTELEGRAPHIES	F OW T OW T AH L EH G R AH F IY Z
PHOTOTELEGRAPHY	F OW T OW T AH L EH G R AH F IY
PHOTOTOXIC	F OW T OW T AA K S IH K
PHOTOTOXICITIES	F OW T OW T AA K S IH K AH T IY Z
PHOTOTOXICITY	F OW T OW T AA K S IH K AH T IY
PHOTOTROPIC	F OW T OW T R AA P IH K
PHOTOTROPICALLY	F OW T OW T R AA P IH K AH L IY
PHOTOTROPISM	F AH T AA T R AH P IH Z AH M
PHOTOTROPISMS	F AH T AA T R AH P AH Z AH M Z
PHOTOTUBE	F OW T OW T UW B
PHOTOTUBES	F OW T OW T UW B Z
PHOTOTYPESETTER	F OW T OW T AY P S EH T ER
PHOTOTYPESETTERS	F OW T OW T AY P S EH T ER Z
PHOTOTYPESETTING	F OW T OW T AY P S EH T IH NG
PHOTOTYPESETTINGS	F OW T OW T AY P S EH T IH NG Z
PHOTOVOLTAIC	F OW T AH V OW L T EY IH K
PHOTOVOLTAICS	F OW T OW V OW L T EY IH K S
PHOTS	F AA T S
PHPHT	P IY EY CH P IY EY CH T
PHRAGMOPLAST	F R AE G M AA P L AH S T
PHRAGMOPLASTS	F R AE G M AA P L AH S T S
PHRASAL	F R EY Z AH L
PHRASALLY	F R EY Z AH L IY
PHRASE	F R EY Z
PHRASED	F R EY Z D
PHRASEMAKER	F R EY Z M EY K ER
PHRASEMAKERS	F R EY Z M EY K ER Z
PHRASEMAKING	F R EY Z M EY K IH NG
PHRASEMAKINGS	F R EY Z M EY K IH NG Z
PHRASEMONGER	F R EY Z M AH NG G ER
PHRASEMONGERING	F R EY Z M AH NG G ER IH NG
PHRASEMONGERINGS	F R EY Z M AH NG G ER IH NG Z
PHRASEMONGERS	F R EY Z M AH NG G ER Z
PHRASEOLOGICAL	F R EY S IY AA L AH JH IH S AH L
PHRASEOLOGIES	F R EY Z IY AA L AH JH IY Z
PHRASEOLOGIST	F R EY Z AA L AH JH AH S T
PHRASEOLOGISTS	F R EY Z AA L AH JH AH S T S
PHRASEOLOGY	F R EY Z IY AO L AO JH IY
PHRASES	F R EY Z AH Z
PHRASES(2)	F R EY Z IH Z
PHRASING	F R EY Z IH NG
PHRASINGS	F R EY Z IH NG Z
PHRATRAL	F R AE T R AH L
PHRATRIC	F R AE T R AH K
PHRATRIES	F R AE T R AY Z
PHRATRY	F R AE T R IY
PHREATIC	F R IY AH T AH K
PHREATOPHYTE	F R IY T AH F AY T
PHREATOPHYTES	F R IY T AH F AY T S
PHREATOPHYTIC	F R IY T AH F AH T AH K
PHRENETIC	F R EH N AH T AH K
PHRENIC	F R IY N AH K
PHRENOLOGICAL	F R AH N AA L AH JH IH S AH L
PHRENOLOGIES	F R AH N AA L AH JH AY Z
PHRENOLOGIST	F R AH N AA L AH JH AH S T
PHRENOLOGISTS	F R AH N AA L AH JH AH S T S
PHRENOLOGY	F R AH N AA L AH JH IY
PHRENSIED	F R EH N S AY D
PHRENSIES	F R EH N S AY Z
PHRENSY	F R EH N Z IY
PHRENSYING	F R EH N S AY AH NG
PHT	P IY EY CH T
PHTHALIC	F TH AE L AH K
PHTHALIN	F TH AE L AH N
PHTHALINS	F TH AE L AH N Z
PHTHALOCYANINE	F TH AH L AA S AY AH N AY N
PHTHALOCYANINES	F TH AH L AA S AY AH N AY N Z
PHTHISES	F TH AY Z AH Z
PHTHISIC	F TH IH Z AH K
PHTHISICAL	F TH AH Z IH S AH L
PHTHISICS	F TH IH Z AH S Z
PHTHISIS	F TH IH S AH S
PHUT	F AH T
PHUTS	F AH T S
PHYCOCYANIN	F IH K AH S AY AH N AH N
PHYCOCYANINS	F IH K AH S AY AH N AH N Z
PHYCOERYTHRIN	F IH K AH R IH TH R AH N
PHYCOERYTHRINS	F IH K AH R IH TH R AH N Z
PHYCOLOGICAL	F AH K AA L AH JH IH S AH L
PHYCOLOGIES	F AH K AA L AH JH AY Z
PHYCOLOGIST	F AH K AA L AH JH AH S T
PHYCOLOGISTS	F AH K AA L AH JH AH S T S
PHYCOLOGY	F AH K AA L AH JH IY
PHYCOMYCETE	F AH K AA M AH S IY T
PHYCOMYCETES	F AH K AA M AH S IY T S
PHYCOMYCETOUS	F IH K AH M IH S AH T AH S
PHYLA	F AY L AH
PHYLACTERIES	F AH L AE K T AH R AY Z
PHYLACTERY	F IH L AH K T EH R IY
PHYLAE	F IH L IY
PHYLAR	F AY L AH R
PHYLAXIS	F AH L AE K S AH S
PHYLAXISES	F IH L AH K S AY Z AH Z
PHYLE	F AY L
PHYLESES	F AH L IY Z AH Z
PHYLESIS	F AY L AH S AH S
PHYLESISES	F IH L AH S AY Z AH Z
PHYLETIC	F IH L AH T AH K
PHYLETICALLY	F AH L EH T AH K AE L IY
PHYLIC	F AY L AH K
PHYLLARIES	F IH L AH R AY Z
PHYLLARY	F IH L AH R IY
PHYLLITE	F IH L AY T
PHYLLITES	F IH L AY T S
PHYLLO	F IH L OW
PHYLLOCLADE	F IH L AH K L EY D
PHYLLOCLADES	F IH L AH K L EY D Z
PHYLLODE	F IH L OW D
PHYLLODES	F IH L OW D Z
PHYLLODIA	F IH L OW D IY AH
PHYLLODIUM	F IH L OW D IY AH M
PHYLLOID	F IH L OY D
PHYLLOIDS	F IH L OY D Z
PHYLLOME	F IH L OW M
PHYLLOMES	F IH L OW M Z
PHYLLOS	F IH L AH Z
PHYLLOTACTIC	F IH L AH T AH K T AH K
PHYLLOTAXES	F IH L AH T AH K S
PHYLLOTAXIES	F IH L AH T AE K S AY Z
PHYLLOTAXIS	F IH L AH T AE K S AH S
PHYLLOTAXY	F IH L AH T AE K S IY
PHYLLOXERA	F IH L AA K S AH R AH
PHYLLOXERAE	F IH L AA K S AH R IY
PHYLLOXERAS	F IH L AA K S AH R AH Z
PHYLOGENETIC	F AH L AA JH AH N AH T AH K
PHYLOGENETICALLY	F IH L AH JH AH N EH T AH K AE L IY
PHYLOGENIES	F AH L AA JH AH N AY Z
PHYLOGENY	F AY L AA JH AH N IY
PHYLON	F IH L AH N
PHYLUM	F AY L AH M
PHYSED	F AY Z D
PHYSEDS	F IH S AH D Z
PHYSES	F AY Z AH Z
PHYSIATRIST	F IH S IY AE T R AH S T
PHYSIATRISTS	F IH S IY AE T R AH S T S
PHYSIC	F AY Z AH K
PHYSICAL	F IH Z IH K AH L
PHYSICALISM	F IH Z AH K AH L IH Z AH M
PHYSICALISMS	F IH Z AH K AH L IH Z AH M Z
PHYSICALIST	F IH Z AH K AH L IH S T
PHYSICALISTIC	F IH Z AH K AH L IH S T IH K
PHYSICALISTS	F IH Z AH K AH L IH S T S
PHYSICALITIES	F IH Z AH K AH L AH T IY Z
PHYSICALITY	F IH Z AH K AH L AH T IY
PHYSICALLY	F IH Z IH K AH L IY
PHYSICALLY(2)	F IH Z IH K L IY
PHYSICALNESS	F IH Z AH K AH L N AH S
PHYSICALNESSES	F IH Z AH K AH L N AH S IH Z
PHYSICALS	F IH Z IH K AH L Z
PHYSICIAN	F AH Z IH SH AH N
PHYSICIANS	F AH Z IH SH AH N Z
PHYSICIANS(2)	F IH Z IH SH AH N Z
PHYSICIST	F IH Z IH S IH S T
PHYSICISTS	F IH Z IH S IH S T S
PHYSICKED	F IH S AH K T
PHYSICKING	F AH S IH K AH NG
PHYSICOCHEMICAL	F IH Z IH K OW K EH M IH K AH L
PHYSICOCHEMICALLY	F IH Z IH K OW K EH M IH K AH L IY
PHYSICS	F IH Z IH K S
PHYSIOCRATIC	F IH S IY AA K R AH T AH K
PHYSIOGNOMIC	F IH S IY AA G N AH M AH K
PHYSIOGNOMICAL	F IH S IY AA G N AH M IH S AH L
PHYSIOGNOMICALLY	F IH S IY AA G N AA M AH K AE L IY
PHYSIOGNOMIES	F IH Z IY AA G N AH M IY Z
PHYSIOGNOMY	F IH Z IY AA G N AH M IY
PHYSIOGRAPHER	F IH S IY AA G R AH F AH R
PHYSIOGRAPHERS	F IH S IY AA G R AH F AH R Z
PHYSIOGRAPHIC	F IH S IY AA G R AH F AH K
PHYSIOGRAPHICAL	F IH S IY AA G R AH F IH S AH L
PHYSIOGRAPHIES	F IH S IY AA G R AH F AY Z
PHYSIOGRAPHY	F IH S IY AA G R AH F IY
PHYSIOLOGIC	F IH Z IY AH L AE JH IH K
PHYSIOLOGICAL	F IH Z IY AH L AA JH IH K AH L
PHYSIOLOGICALLY	F IH Z IY AH L AA JH IH K L IY
PHYSIOLOGIES	F IH Z IY AA L AH JH IY Z
PHYSIOLOGIST	F IH Z IY AA L AH JH IH S T
PHYSIOLOGISTS	F IH S IY AA L AH JH AH S T S
PHYSIOLOGY	F IH Z IY AA L AH JH IY
PHYSIOPATHOLOGIC	F IH S IY AH P AE TH AH L AH JH AH K
PHYSIOPATHOLOGICAL	F AH S IY AH P AH TH AA L AH JH IH S AH L
PHYSIOPATHOLOGIES	F AH S IY AH P AH TH AA L AH JH AY Z
PHYSIOPATHOLOGY	F AH S IY AH P AH TH AA L AH JH IY
PHYSIOTHERAPIES	F IH S IY AH TH EH R AH P AY Z
PHYSIOTHERAPIST	F IH S IY AH TH EH R AH P AH S T
PHYSIOTHERAPISTS	F IH S IY AH TH EH R AH P AH S T S
PHYSIOTHERAPY	F IH S IY AH TH EH R AH P IY
PHYSIQUE	F AH Z IY K
PHYSIQUES	F AH Z IY K S
PHYSIS	F IH S AH S
PHYSOSTIGMINE	F AH S AA S T AH G M AY N
PHYSOSTIGMINES	F AH S AA S T AH G M AY N Z
PHYTANE	F AH T EY N
PHYTANES	F AH T EY N Z
PHYTOALEXIN	F IH T AH L EH K S AH N
PHYTOALEXINS	F IH T AH L EH K S AH N Z
PHYTOCHEMICAL	F AH T AA K AH M IH S AH L
PHYTOCHEMICALLY	F IH T AH K EH M AH K AE L IY
PHYTOCHEMIST	F AH T AA K AH M AH S T
PHYTOCHEMISTRIES	F IH T AH K AH M IH S T R AY Z
PHYTOCHEMISTRY	F AH T AA K AH M IH S T R IY
PHYTOCHEMISTS	F AH T AA K AH M AH S T S
PHYTOCHROME	F IH T AH K R OW M
PHYTOCHROMES	F IH T AH K R OW M Z
PHYTOFLAGELLATE	F AH T AA F L AE JH AH L EY T
PHYTOFLAGELLATES	F AH T AA F L AE JH AH L EY T S
PHYTOGEOGRAPHER	F AH T OW JH IY AA G R AH F AH R
PHYTOGEOGRAPHERS	F AH T OW JH IY AA G R AH F AH R Z
PHYTOGEOGRAPHIC	F AH T OW JH IY AA G R AH F AH K
PHYTOGEOGRAPHICAL	F AH T OW JH IY AA G R AH F IH S AH L
PHYTOGEOGRAPHICALLY	F AH T OW JH IY AA G R AE F AH K AE L IY
PHYTOGEOGRAPHIES	F AH T OW JH IY AA G R AH F AY Z
PHYTOGEOGRAPHY	F AY T OW JH IY AA G R AH F IY
PHYTOHEMAGGLUTININ	F AH T AA HH AH M AH G L UW T AH N AH N
PHYTOHEMAGGLUTININS	F AH T AA HH AH M AH G L UW T AH N AH N Z
PHYTOHORMONE	F AH T AA HH AH R M OW N
PHYTOHORMONES	F AH T AA HH AH R M OW N Z
PHYTOID	F AY T OY D
PHYTOL	F IH T AH L
PHYTOLS	F IH T AH L Z
PHYTON	F IH T AH N
PHYTONIC	F IH T AH N AH K
PHYTONS	F IH T AH N Z
PHYTOPATHOGEN	F IH T AH P AE TH AH JH AH N
PHYTOPATHOGENIC	F IH T AH P AE TH AH JH AH N AH K
PHYTOPATHOGENS	F IH T AH P AE TH AH JH AH N Z
PHYTOPATHOLOGICAL	F IH T AH P AH TH AA L AH JH IH S AH L
PHYTOPATHOLOGIES	F IH T AH P AH TH AA L AH JH AY Z
PHYTOPATHOLOGY	F IH T AH P AH TH AA L AH JH IY
PHYTOPHAGOUS	F IH T AH F EY JH AH S
PHYTOPLANKTER	F AH T AA P L AE NG K T AH R
PHYTOPLANKTERS	F IH T AH P L AE NG K T AH R Z
PHYTOPLANKTON	F AY T OW P L AE NG T AH N
PHYTOPLANKTONIC	F IH T AH P L AE NG K T AH N AH K
PHYTOPLANKTONS	F IH T AH P L AE NG K T AH N Z
PHYTOSOCIOLOGICAL	F IH T AH S AH S IY AA L AH JH IH S AH L
PHYTOSOCIOLOGIES	F AH T AH S AH S IY AA L AH JH AY Z
PHYTOSOCIOLOGY	F IH T AH S AH S IY AA L AH JH IY
PHYTOSTEROL	F AH T AA S T AH R AH L
PHYTOSTEROLS	F AH T AA S T AH R AH L Z
PHYTOTOXIC	F IH T AH T AH K S AH K
PHYTOTOXICITIES	F IH T AH T AA K S IH S AH T AY Z
PHYTOTOXICITY	F IH T AH T AA K S IH S AH T IY
PICTOGRAPH	P IH K T AA G R AH F
PICTOGRAPHIC	P IH K T AA G R AH F AH K
PICTOGRAPHIES	P IH K T AA G R AH F AY Z
PICTOGRAPHS	P IH K T AA G R AH F S
PICTOGRAPHY	P IH K T AA G R AH F IY
PICTUREPHONE	P IH K CH ER F OW N
PICTUREPHONES	P IH K CH ER F OW N Z
PLANISPHERE	P L AH N IH S AH R
PLANISPHERES	P L AE N AH S IY R Z
PLANISPHERIC	P L AH N IH S AH R AH K
PLANOGRAPHIC	P L AH N AA G R AH F AH K
PLANOGRAPHIES	P L AH N AA G R AH F AY Z
PLANOGRAPHY	P L AH N AA G R AH F IY
PLASMAPHERESES	P L AE Z M AE F AH R IY Z AH Z
PLASMAPHERESIS	P L AE Z M AH F IH R AH S AH S
PLEOMORPHIC	P L IY AH M AO F IH K
PLEOMORPHISM	P L IY AH M AO F IH Z M
PLEOMORPHISMS	P L IY AH M AO R F AH Z AH M Z
PLETHYSMOGRAPH	P L EH TH AH Z M AA G R AH F
PLETHYSMOGRAPHIC	P L EH TH AH Z M AA G R AH F AH K
PLETHYSMOGRAPHICALLY	P L AH TH IH Z M AA G R AE F AH K AE L IY
PLETHYSMOGRAPHIES	P L EH TH AH Z M AA G R AH F AY Z
PLETHYSMOGRAPHS	P L EH TH AH Z M AA G R AH F S
PLETHYSMOGRAPHY	P L EH TH AH Z M AA G R AH F IY
PNEUMATOPHORE	N Y UW M AE T AH F AH R
PNEUMATOPHORES	N Y UW M AE T AH F AH R Z
PNEUMOGRAPH	N Y UW M AA G R AH F
PNEUMOGRAPHS	N Y UW M AA G R AH F S
PODOPHYLLI	P AA D AH F IH L IY
PODOPHYLLIN	P AA D AH F IH L AH N
PODOPHYLLINS	P AA D AH F IH L AH N Z
PODOPHYLLUM	P AA D AH F IH L AH M
PODOPHYLLUMS	P AA D AH F IH L AH M Z
POGONOPHORAN	P AA G AH N AA F AH R AH N
POGONOPHORANS	P AA G AH N AA F AH R AH N Z
POLAROGRAPHIC	P AA L AH R AA G R AH F AH K
POLAROGRAPHICALLY	P AA L AH R AA G R AE F AH K AE L IY
POLAROGRAPHIES	P AA L AH R AA G R AH F AY Z
POLAROGRAPHY	P OW L ER AA G R AH F IY
POLYCHROMATOPHILIA	P AH L AH K R AA M AH T AH F IH L Y AH
POLYCHROMATOPHILIAS	P AH L AH K R AA M AH T AH F IH L Y AH Z
POLYCHROMATOPHILIC	P AA L AH K R AH M AE T AH F AY L AH K
POLYGRAPH	P AA L IY G R AE F
POLYGRAPHER	P OW L IY G R AE F ER
POLYGRAPHERS	P OW L IY G R AE F ER Z
POLYGRAPHIC	P OW L IY G R AE F IH K
POLYGRAPHIST	P OW L IY G R AE F IH S T
POLYGRAPHISTS	P OW L IY G R AE F IH S T S
POLYGRAPHS	P AA L IY G R AE F S
POLYMORPH	P AA L IY M AO R F
POLYMORPHIC	P AA L IY M AO R F IH K
POLYMORPHICALLY	P OW L IY M AO R F IH K AH L IY
POLYMORPHISM	P AA L IY M AO R F IH Z M
POLYMORPHISMS	P OW L IY M AO R F IH Z AH M Z
POLYMORPHONUCLEAR	P AH L AH M AO R F AH N AH K L IY AH R
POLYMORPHONUCLEARS	P AH L AH M AO R F AA N AH K L IY R Z
POLYMORPHOUS	P OW L IY M AO R F AH S
POLYMORPHOUSLY	P OW L IY M AO R F AH S L IY
POLYMORPHS	P OW L IY M AO R F S
POLYPHAGIA	P AA L AH F EY JH IY AH
POLYPHAGIAS	P AA L AH F EY JH IY AH Z
POLYPHAGIES	P AH L IH F AH JH AY Z
POLYPHAGOUS	P AA L AH F EY JH AH S
POLYPHAGY	P AH L IH F AH JH IY
POLYPHASE	P AA L IY F EY Z
POLYPHASIC	P OW L IY F EY Z IH K
POLYPHENOL	P AH L IH F AH N AH L
POLYPHENOLIC	P AH L IH F AH N AH L AH K
POLYPHENOLS	P AH L IH F AH N AH L Z
POLYPHILOPROGENITIVE	P AH L IH F AH L AA P R AH JH EH N AH T AH V
POLYPHONE	P OW L IY F OW N
POLYPHONES	P OW L IY F OW N Z
POLYPHONIC	P AA L IH F AA N IH K
POLYPHONICALLY	P OW L IY F AA N IH K AH L IY
POLYPHONIES	P OW L IY F OW N IY Z
POLYPHONOUS	P OW L IY F OW N AH S
POLYPHONOUSLY	P OW L IY F OW N AH S L IY
POLYPHONY	P AH L IH F AH N IY
POLYPHYLETIC	P AH L IH F AH L AH T AH K
POLYPHYLETICALLY	P AA L AH F AH L EH T AH K AE L IY
PORNOGRAPHER	P AO R N AA G R AH F ER
PORNOGRAPHERS	P AO R N AA G R AH F ER Z
PORNOGRAPHIC	P AO R N AH G R AE F IH K
PORNOGRAPHICALLY	P AO R N AH G R AE F IH K AH L IY
PORNOGRAPHIES	P AO R N AA G R AH F AY Z
PORNOGRAPHY	P AO R N AA G R AH F IY
PORPHYRIA	P AO R F IH R IY AH
PORPHYRIAS	P AO R F IH R IY AH Z
PORPHYRIES	P AO R F AH R AY Z
PORPHYRIN	P AO R F AH R AH N
PORPHYRINS	P AO R F AH R AH N Z
PORPHYRITIC	P AO R F ER IH T IH K
PORPHYROPSIN	P AO R F AH R AA P S AH N
PORPHYROPSINS	P AO R F AH R AA P S AH N Z
PORPHYRY	P AO R F ER IY
POSTENCEPHALITIC	P AA S T AH N S EH F AH L AH T AH K
PROCEPHALIC	P R OW S EH F AH L AH K
PRONEPHRA	P R OW N EH F R AH
PRONEPHRIC	P R OW N EH F R AH K
PRONEPHROI	P R OW N EH F R OY
PRONEPHROS	P R OW N EH F R AH Z
PROPHAGE	P R AA F AH JH
PROPHAGES	P R AA F AH JH AH Z
PROPHASE	P R OW F EY Z
PROPHASES	P R OW F EY Z IH Z
PROPHASIC	P R OW F EY Z IH K
PROPHECIES	P R AA F AH S IY Z
PROPHECY	P R AA F AH S IY
PROPHESIED	P R AA F AH S AY D
PROPHESIED(2)	P R AA F AH S IY D
PROPHESIER	P R AA F AH S AY ER
PROPHESIERS	P R AA F AH S AY ER Z
PROPHESIES	P R AA F AH S AY Z
PROPHESY	P R AA F AH S AY
PROPHESYING	P R AA F AH S AY IH NG
PROPHET	P R AA F AH T
PROPHETESS	P R AA F AH T AH S
PROPHETESSES	P R AA F AH T AH S IH Z
PROPHETHOOD	P R AA F AH T HH UH D
PROPHETHOODS	P R AA F AH T HH UH D Z
PROPHETIC	P R AH F EH T IH K
PROPHETICAL	P R AH F EH T IH K AH L
PROPHETICALLY	P R AH F EH T IH K AH L IY
PROPHETS	P R AA F AH T S
PROPHYLACTIC	P R AA F IH L AE K T IH K
PROPHYLACTIC(2)	P R OW F IH L AE K T IH K
PROPHYLACTICALLY	P R OW F AH L AE K T AH K AE L IY
PROPHYLACTICS	P R OW F AH L AE K T AH S Z
PROPHYLAXES	P R OW F IH L AH K S
PROPHYLAXIS	P R OW F AH L AE K S AH S
PROPOXYPHENE	P R OW P AA K S AH F IY N
PROPOXYPHENES	P R OW P AA K S AH F IY N Z
PROSENCEPHALA	P R OW S EH N S EH F AH L AH
PROSENCEPHALIC	P R OW S EH N S AH F AH L AH K
PROSENCEPHALON	P R OW S EH N S EH F AH L AH N
PROSOPOGRAPHICAL	P R OW S AH P AA G R AH F IH S AH L
PROSOPOGRAPHIES	P R OW S AH P AA G R AH F AY Z
PROSOPOGRAPHY	P R OW S AH P AA G R AH F IY
PROTOPHLOEM	P R OW T AA F L OW AH M
PROTOPHLOEMS	P R OW T AA F L OW AH M Z
PROTOPORPHYRIN	P R OW T AH P AO R F AH R AH N
PROTOPORPHYRINS	P R OW T AH P AO R F AH R AH N Z
PROTOTROPH	P R OW T AA T R AH F
PROTOTROPHIC	P R OW T AA T R AH F AH K
PROTOTROPHIES	P R OW T AA T R AH F AY Z
PROTOTROPHS	P R OW T AA T R AH F S
PROTOTROPHY	P R OW T AA T R AH F IY
PSEPHITE	S AH F AY T
PSEPHITES	S AH F AY T S
PSEPHOLOGICAL	S AH F AA L AH JH IH S AH L
PSEPHOLOGIES	S AH F AA L AH JH AY Z
PSEPHOLOGIST	S AH F AA L AH JH AH S T
PSEPHOLOGISTS	S AH F AA L AH JH AH S T S
PSEPHOLOGY	S AH F AA L AH JH IY
PSEUDEPIGRAPH	S UW D AH P IH G R AH F
PSEUDEPIGRAPHA	S UW D AH P IH G R AH F AH
PSEUDEPIGRAPHIES	S UW D AH P IH G R AH F AY Z
PSEUDEPIGRAPHON	S UW D AH P IH G R AH F AH N
PSEUDEPIGRAPHS	S UW D AH P IH G R AH F S
PSEUDEPIGRAPHY	S UW D AH P IH G R AH F IY
PSEUDOMORPH	S UW D OW M AO R F
PSEUDOMORPHIC	S UW D OW M AO R F IH K
PSEUDOMORPHISM	S UW D OW M AO R F IH Z AH M
PSEUDOMORPHISMS	S UW D OW M AO R F IH Z AH M Z
PSEUDOMORPHOUS	S UW D OW M AO R F AH S
PSEUDOMORPHS	S UW D OW M AO R F S
PSEUDOSOPHISTICATED	S UW D OW S AA F IH S T IH K EY T IH D
PSEUDOSOPHISTICATION	S UW D OW S AA F IH S T IH K EY SH AH N
PSEUDOSOPHISTICATIONS	S UW D OW S AA F IH S T IH K EY SH AH N Z
PSILOPHYTE	S IH L AH F AY T
PSILOPHYTES	S IH L AH F AY T S
PSILOPHYTIC	S IH L AH F AH T AH K
PSYCHOBIOGRAPHER	S AY K OW B AY AA G R AH F ER
PSYCHOBIOGRAPHERS	S AY K OW B AY AA G R AH F ER Z
PSYCHOBIOGRAPHICAL	S AY K OW B AY AH G R AE F IH K AH L
PSYCHOBIOGRAPHIES	S AY K OW B AY AA G R AH F IY Z
PSYCHOBIOGRAPHY	S AY K OW B AY AA G R AH F IY
PSYCHOGRAPH	S AY K OW G R AE F
PSYCHOGRAPHS	S AY K OW G R AE F S
PSYCHOPHARMACOLOGIC	S AY K OW F AA R M AH K AH L AA JH IH K
PSYCHOPHARMACOLOGICAL	S AY K OW F AA R M AH K AH L AA JH IH K AH L
PSYCHOPHARMACOLOGIES	S AY K AH F AA R M AH K AA L AH JH AY Z
PSYCHOPHARMACOLOGIST	S AY K AH F AA R M AH K AA L AH JH AH S T
PSYCHOPHARMACOLOGISTS	S AY K AH F AA R M AH K AA L AH JH AH S T S
PSYCHOPHARMACOLOGY	S AY K AH F AA R M AH K AA L AH JH IY
PSYCHOPHYSICAL	S AY K OW F IH Z AH K AH L
PSYCHOPHYSICALLY	S AY K OW F IH Z AH K AH L IY
PSYCHOPHYSICIST	S AY K OW F IH Z AH S AH S T
PSYCHOPHYSICISTS	S AY K OW F IH Z AH S AH S T S
PSYCHOPHYSICS	S AY K OW F IH Z IH K S
PSYCHOPHYSIOLOGIC	S AY K OW F IH Z IY AH L AE JH IH K
PSYCHOPHYSIOLOGICAL	S AY K OW F IH Z IY AH L AE JH IH K AH L
PSYCHOPHYSIOLOGICALLY	S AY K OW F IH Z IY AH L AE JH IH K AH L IY
PSYCHOPHYSIOLOGIES	S AY K OW F IH Z IY AA L AH JH IY Z
PSYCHOPHYSIOLOGIST	S AY K AH F AH S IY AA L AH JH AH S T
PSYCHOPHYSIOLOGISTS	S AY K AH F IH S IY AA L AH JH AH S T S
PSYCHOPHYSIOLOGY	S AY K OW F IH Z IY AA L AH JH IY
PSYCHROPHILIC	S AY K R AH F AY L AH K
PTERIDOPHYTE	T AH R IH D AH F AY T
PTERIDOPHYTES	T AH R IH D AH F AY T S
PYELONEPHRITIC	P AY AH L AH N EH F R AH T AH K
PYELONEPHRITIDES	P AY AH L AH N EH F R AH T AY D Z
PYELONEPHRITIS	P AY EH L AH N AH F R AY T AH S
PYROMORPHITE	P AH R AA M AH R F AY T
PYROMORPHITES	P AH R AA M AH R F AY T S
PYRONINOPHILIC	P IH R AH N IH N AH F AY L AH K
PYROPHORIC	P IH R AH F AH R AH K
PYROPHOSPHATE	P AY R OW F AA S F EY T
PYROPHOSPHATES	P AY R OW F AA S F EY T S
PYROPHYLLITE	P AH R AA F AH L AY T
PYROPHYLLITES	P AH R AA F AH L AY T S
QOPH	K AA F
QOPHS	K AA F S
QUADRAPHONIC	K W AA D R AH F AH N AH K
QUADRAPHONICS	K W AA D R AE F AH N AH S Z
QUADRIPHONIC	K W AA D R AH F AH N AH K
QUADRIPHONICS	K W AA D R IH F AH N AH S Z
RADIOAUTOGRAPH	R EY D IY OW AO T AH G R AE F
RADIOAUTOGRAPHIC	R EY D IY OW AO T AH G R AE F IH K
RADIOAUTOGRAPHIES	R EY D IY OW AO T AH G R AE F IY Z
RADIOAUTOGRAPHS	R EY D IY OW AO T AH G R AE F S
RADIOAUTOGRAPHY	R EY D IY OW AO T AH G R AE F IY
RADIOGRAPH	R EY D IY OW G R AE F
RADIOGRAPHED	R EY D IY OW G R AE F T
RADIOGRAPHIC	R EY D IY OW G R AE F IH K
RADIOGRAPHICALLY	R EY D IY OW G R AE F IH K AH L IY
RADIOGRAPHIES	R EY D IY AA G R AH F IY Z
RADIOGRAPHING	R EY D IY OW G R AE F IH NG
RADIOGRAPHS	R EY D IY OW G R AE F S
RADIOGRAPHY	R EY D IY AA G R AH F IY
RADIOPHARMACEUTICAL	R EY D IY OW F AA R M AH S UW T IH K AH L
RADIOPHARMACEUTICALS	R EY D IY OW F AA R M AH S UW T IH K AH L Z
RADIOPHONE	R EY D IY OW F OW N
RADIOPHONES	R EY D IY OW F OW N Z
RADIOPHOTO	R EY D IY OW F OW T OW
RADIOPHOTOS	R EY D IY OW F OW T OW Z
RADIOTELEGRAPH	R EY D IY OW T EH L AH G R AE F
RADIOTELEGRAPHIES	R EY D IY OW T AH L EH G R AH F IY Z
RADIOTELEGRAPHS	R EY D IY OW T EH L AH G R AE F S
RADIOTELEGRAPHY	R EY D IY OW T AH L EH G R AH F IY
RADIOTELEPHONE	R EY D IY OW T EH L AH F OW N
RADIOTELEPHONES	R EY D IY OW T EH L AH F OW N Z
RADIOTELEPHONIES	R EY D IY OW T EH L AH F OW N IY Z
RADIOTELEPHONY	R EY D IY OW T EH L AH F OW N IY
RALPH	R AE L F
RALPHED	R AE L F T
RALPHING	R AE L F AH NG
RALPHS	R AE L F S
RAPHAE	R AE F IY
RAPHE	R AE F
RAPHES	R AE F S
RAPHIA	R AE F IY AH
RAPHIAS	R AE F IY AH Z
RAPHIDE	R AE P HH AY D
RAPHIDES	R AE P HH AY D Z
RAPHIS	R AE F AH S
REAPHOOK	R IY P HH UH K
REAPHOOKS	R IY P HH UH K S
RECHOREOGRAPH	R IY K OW R IY AH G R AE F
RECHOREOGRAPHED	R IY K OW R IY AH G R AE F T
RECHOREOGRAPHING	R IY K OW R IY AH G R AE F IH NG
RECHOREOGRAPHS	R IY K OW R IY AH G R AE F S
RECHROMATOGRAPH	R IH K R AA M AH T AA G R AH F
RECHROMATOGRAPHED	R IH K R AA M AH T AA G R AH F T
RECHROMATOGRAPHIES	R IY K R OW M AH T AA G R AH F IY Z
RECHROMATOGRAPHING	R IH K R AA M AH T AA G R AH F AH NG
RECHROMATOGRAPHS	R IH K R AA M AH T AA G R AH F S
RECHROMATOGRAPHY	R IY K R OW M AH T AA G R AH F IY
REEMPHASES	R IY EH M F AH S IY Z
REEMPHASIS	R IY EH M F AH S AH S
REEMPHASIZE	R IY EH M F AH S AY Z
REEMPHASIZED	R IY EH M F AH S AY Z D
REEMPHASIZES	R IY EH M F AH S AY Z IH Z
REEMPHASIZING	R IY EH M F AH S AY Z IH NG
RENOGRAPHIC	R AH N AA G R AH F AH K
RENOGRAPHIES	R AH N AA G R AH F AY Z
RENOGRAPHY	R AH N AA G R AH F IY
REPHOTOGRAPH	R IY F OW T AH G R AE F
REPHOTOGRAPHED	R IY F OW T AH G R AE F T
REPHOTOGRAPHING	R IY F OW T AH G R AE F IH NG
REPHOTOGRAPHS	R IY F OW T AH G R AE F S
REPHRASE	R IY F R EY Z
REPHRASED	R IY F R EY Z D
REPHRASES	R IY F R EY Z IH Z
REPHRASING	R IY F R EY Z IH NG
REPROGRAPHER	R IY P R OW G R AE F ER
REPROGRAPHERS	R IY P R OW G R AE F ER Z
REPROGRAPHIC	R EH P R OW G R AE F IH K
REPROGRAPHICS	R EH P R OW G R AE F IH K S
REPROGRAPHIES	R IY P R OW G R AE F IY Z
REPROGRAPHY	R IY P R OW G R AE F IY
REUPHOLSTER	R IY AH P HH OW L S T ER
REUPHOLSTERED	R IY AH P HH OW L S T ER D
REUPHOLSTERING	R IY AH P HH OW L S T ER IH NG
REUPHOLSTERS	R IY AH P HH OW L S T ER Z
RHAPHAE	R AE F IY
RHAPHE	R AE F
RHAPHES	R AE F S
RHEOPHIL	R IY AH F AH L
RHINENCEPHALA	R IH N AH N S EH F AH L AH
RHINENCEPHALIC	R AH N EH N S AH F AH L AH K
RHINENCEPHALON	R IH N AH N S EH F AH L AH N
RHINENCEPHALONS	R IH N AH N S EH F AH L AH N Z
RHIZOSPHERE	R AH Z AA S AH R
RHIZOSPHERES	R IH Z AH S IY R Z
RHOMBENCEPHALA	R AA M B AH N S EH F AH L AH
RHOMBENCEPHALON	R AA M B AH N S EH F AH L AH N
RHYNCHOCEPHALIAN	R IH NG K AA S AH F EY L IY AH N
RHYNCHOCEPHALIANS	R IH NG K AH S AH F EY L IY AH N Z
ROENTGENOGRAPHIC	R OW EH N T JH AH N AA G R AH F AH K
ROENTGENOGRAPHICALLY	R OW EH N T JH AH N AA G R AE F AH K AE L IY
ROENTGENOGRAPHIES	R OW EH N T JH AH N AA G R AH F AY Z
ROENTGENOGRAPHY	R OW EH N T JH AH N AA G R AH F IY
SAMPHIRE	S AE M F AY R
SAMPHIRES	S AE M F AY R Z
SAPHEAD	S AE P HH EH D
SAPHEADED	S AE P HH EH D IH D
SAPHEADS	S AE P HH EH D Z
SAPHENA	S AE F AH N AH
SAPHENAE	S AE F AH N IY
SAPHENOUS	S AE P HH EH N AH S
SAPPHIC	S AE P AH K
SAPPHICS	S AE P AH S Z
SAPPHIRE	S AE F AY ER
SAPPHIRES	S AE F AY ER Z
SAPPHIRINE	S AE P AH R AY N
SAPPHISM	S AE P AH Z AH M
SAPPHISMS	S AE P AH Z AH M Z
SAPPHIST	S AE P AH S T
SAPPHISTS	S AE P AH S T S
SAPROPHAGOUS	S AE P R AH F EY JH AH S
SAPROPHYTE	S AE P R AH F AY T
SAPROPHYTES	S AE P R AH F AY T S
SAPROPHYTIC	S AE P R AH F AH T AH K
SAPROPHYTICALLY	S AE P R AH F IH T AH K AE L IY
SARCOPHAGI	S AA R K AA F AH JH IY
SARCOPHAGUS	S AA R K AA F AH G AH S
SARCOPHAGUSES	S AA R K AA F AH G Y UW Z AH Z
SAXOPHONE	S AE K S AH F OW N
SAXOPHONES	S AE K S AH F OW N Z
SAXOPHONIC	S AE K S AH F OW N IH K
SAXOPHONIST	S AE K S AH F OW N IH S T
SAXOPHONISTS	S AE K S AH F OW N IH S T S
SCAPHOID	S K AH F OY D
SCAPHOIDS	S K AH F OY D Z
SCARPH	S K AA R F
SCARPHED	S K AA R F T
MAIZE	M EY Z
LIEU	L UW
LIEU(2)	L Y UW
WHA	W AA
DUAL	D UW AH L
DUAL(2)	D UW L
OGHAM	AA AH M
HE	HH IY
EERIE	IH R IY
