RE	R EY
RE(2)	R IY
ABAMPERE	AH B AE M P AH R
ABAMPERES	AE B AH M P IY R Z
ABBREVIATE	AH B R IY V IY EY T
ABBREVIATED	AH B R IY V IY EY T IH D
ABBREVIATES	AH B R IY V IY EY T S
ABBREVIATING	AH B R IY V IY EY T IH NG
ABBREVIATION	AH B R IY V IY EY SH AH N
ABBREVIATIONS	AH B R IY V IY EY SH AH N Z
ABBREVIATOR	AH B R IY V IY EY T ER
ABBREVIATORS	AH B R IY V IY EY T ER Z
ABDUCTORES	AH B D AH K T OW R Z
ABHORRED	AH B HH AO R D
ABHORRENCE	AH B HH AO R AH N S
ABHORRENCES	AH B HH AO R AH N S IH Z
ABHORRENT	AE B HH AO R AH N T
ABHORRENTLY	AH B HH AO R AH N T L IY
ABHORRER	AH B HH AO R ER
ABHORRERS	AH B HH AO R ER Z
ABJURE	AE B Y AH R
ABJURED	AE B Y AH R D
ABJURER	AE B Y AH R AH R
ABJURERS	AE B AH R AH R Z
ABJURES	AE B Y AH R Z
ABREACT	AE B R IY AE K T
ABREACTED	AE B R IY AE K T IH D
ABREACTING	AE B R IY AE K T IH NG
ABREACTION	AE B R IY AE K SH AH N
ABREACTIONS	AE B R IY AE K SH AH N Z
ABREACTS	AE B R IY AE K T S
ABREAST	AH B R EH S T
ACCIACCATURE	AE K S IY AH K EY T Y AH R
ACCOUTERED	AH K UW T ER D
ACCOUTRE	AE K AW T AH R
ACCOUTRED	AE K AW T AH R D
ACCOUTREMENT	AH K UW T ER M AH N T
ACCOUTREMENTS	AH K UW T ER M AH N T S
ACCOUTRES	AE K AW T AH R Z
ACCREDIT	AH K R EH D IH T
ACCREDITABLE	AH K R EH D AH T AH B AH L
ACCREDITATION	AH K R EH D AH T EY SH AH N
ACCREDITATIONS	AH K R EH D AH T EY SH AH N Z
ACCREDITED	AH K R EH D IH T IH D
ACCREDITING	AH K R EH D AH T IH NG
ACCREDITS	AH K R EH D AH T S
ACCRETE	AH K R IY T
ACCRETED	AH K R IY T IH D
ACCRETES	AH K R IY T S
ACCRETING	AH K R IY T IH NG
ACCRETION	AH K R IY SH AH N
ACCRETIONARY	AH K R IY SH AH N EH R IY
ACCRETIONS	AH K R IY SH AH N Z
ACCRETIVE	AH K R IY T IH V
ACQUIRE	AH K W AY ER
ACQUIRED	AH K W AY ER D
ACQUIREMENT	AH K W AY ER M AH N T
ACQUIREMENTS	AH K W AY ER M AH N T S
ACQUIRER	AH K W AY ER ER
ACQUIRERS	AH K W AY ER ER Z
ACQUIRES	AH K W AY ER Z
ACRE	EY K ER
ACREAGE	EY K AH R IH JH
ACREAGE(2)	EY K R IH JH
ACREAGES	EY K ER IH JH IH Z
ACRED	EY K ER D
ACRES	EY K ER Z
ACTRESS	AE K T R AH S
ACTRESSES	AE K T R AH S IH Z
ACTRESSY	AE K T R AH S IY
ACUPRESSURE	AH K AH P R EH SH Y AH R
ACUPRESSURES	AH K AH P R EH SH Y AH R Z
ACUPUNCTURE	AE K Y UW P AH NG K CH ER
ACUPUNCTURES	AE K Y AH P AH NG K T Y AH R Z
ADDRESS	AE D R EH S
ADDRESSABILITIES	AH D R EH S AH B IH L AH T EH Z
ADDRESSABILITY	AH D R EH S AH B IH L AH T EH
ADDRESSABLE	AE D R EH S AH B AH L
ADDRESSED	AH D R EH S T
ADDRESSEE	AE D R EH S IY
ADDRESSEES	AH D R EH S IY Z
ADDRESSER	AH D R EH S ER
ADDRESSERS	AH D R EH S ER Z
ADDRESSES	AE D R EH S IH Z
ADDRESSING	AE D R EH S IH NG
ADDREST	AE D R EH S T
ADHERE	AH D HH IH R
ADHERED	AE D HH IH R D
ADHERENCE	AH D HH IH R AH N S
ADHERENCES	AE D HH IH ER AH N S IH Z
ADHEREND	AE D HH AH R AH N D
ADHERENDS	AE D HH AH R AH N D Z
ADHERENT	AH D HH IH R AH N T
ADHERENTLY	AE D HH IH ER AH N T L IY
ADHERENTS	AE D HH IH R AH N T S
ADHERER	AE D HH IH ER ER
ADHERERS	AE D HH IH ER ER Z
ADHERES	AH D HH IH R Z
ADJURE	AE JH Y AH R
ADJURED	AE JH Y AH R D
ADJURER	AE JH Y AH R AH R
ADJURERS	AE JH AH R AH R Z
ADJURES	AE JH Y AH R Z
ADMEASURE	AE D M IY ZH Y AH R
ADMEASURED	AE D M IY ZH Y AH R D
ADMEASUREMENT	AE D M AH S UH R M AH N T
ADMEASUREMENTS	AE D M AH S UH R AH M AH N T S
ADMEASURES	AE D M IY ZH Y AH R Z
ADMINISTERED	AH D M IH N IH S T ER D
ADMIRE	AE D M AY R
ADMIRED	AH D M AY ER D
ADMIRER	AE D M AY R ER
ADMIRERS	AH D M AY R ER Z
ADMIRES	AE D M AY R Z
ADMIXTURE	AE D M IH K S T Y AH R
ADMIXTURES	AE D M IH K S T Y AH R Z
ADORE	AH D AO R
ADORED	AH D AO R D
ADORER	AH D OW R ER
ADORERS	AH D OW R ER Z
ADORES	AH D AO R Z
ADRENAL	AH D R IY N AH L
ADRENALECTOMIES	AE D R AH N AH L EH K T AH M AY Z
ADRENALECTOMIZED	AE D R EH N AH L EH K T AH M AY Z D
ADRENALECTOMY	AE D R AH N AH L EH K T AH M IY
ADRENALINE	AH D R EH N AH L AH N
ADRENALINES	AE D R EH N AH L AY N Z
ADRENALIZED	AH D R IY N AH L AY Z D
ADRENALS	AH D R IY N AH L Z
ADRENERGIC	AE D R AH N AH R JH AH K
ADRENERGICALLY	AE D R AH N AH R JH AH K AE L IY
ADRENOCHROME	AE D R EH N AH K R OW M
ADRENOCHROMES	AE D R EH N AH K R OW M Z
ADRENOCORTICAL	AE D R EH N AH K AO R T IH S AH L
ADRENOCORTICOSTEROID	AE D R AH N AH K AO R T AH K AA S T AH R OY D
ADRENOCORTICOSTEROIDS	AE D R AH N AH K AH R T AH K AA S T AH R OY D Z
ADRENOCORTICOTROPHIC	AE D R AH N AH K AO R T AH K AA T R AH F AH K
ADRENOCORTICOTROPHIN	AE D R AH N AH K AO R T AH K AA T R AH F AH N
ADRENOCORTICOTROPHINS	AE D R AH N AH K AO R T AH K AA T R AH F AH N Z
ADRENOCORTICOTROPIC	AE D R AH N AH K AO R T AH K AA T R AH P AH K
ADRENOCORTICOTROPIN	AE D R AH N AH K AO R T AH K AA T R AH P AH N
ADRENOCORTICOTROPINS	AE D R AH N AH K AO R T AH K AA T R AH P AH N Z
ADULTERER	AH D AH L T ER ER
ADULTERERS	AH D AH L T ER ER Z
ADULTERESS	AH D AH L T ER AH S
ADULTERESSES	AH D AH L T ER AH S IH Z
ADVENTURE	AE D V EH N CH ER
ADVENTURE(2)	AH D V EH N CH ER
ADVENTURED	AH D V EH N CH ER D
ADVENTURER	AE D V EH N CH ER ER
ADVENTURER(2)	AH D V EH N CH ER ER
ADVENTURERS	AE D V EH N CH ER ER Z
ADVENTURERS(2)	AH D V EH N CH ER ER Z
ADVENTURES	AE D V EH N CH ER Z
ADVENTURESOME	AE D V EH N CH ER S AH M
ADVENTURESOMENESS	AH D V EH N CH ER S AH M N AH S
ADVENTURESOMENESSES	AH D V EH N CH ER S AH M N AH S IH Z
ADVENTURESS	AH D V EH N CH ER AH S
ADVENTURESSES	AH D V EH N CH ER AH S IH Z
AECIOSPORE	EH S IY AA S AH R
AECIOSPORES	EH S IY AA S AH R Z
AERENCHYMA	AH R EH NG K AH M AH
AERENCHYMAS	AH R EH NG K AH M AH Z
AERENCHYMATA	EH R AH NG K IH M AH T AH
AFEARED	AH F IH ER D
AFFAIRE	AH F EH R
AFFAIRES	AH F EH R Z
AFFERENT	AE F ER AH N T
AFFERENTLY	AE F AH R AH N T L IY
AFFERENTS	AE F AH R AH N T S
AFFOREST	AE F ER AH S T
AFFORESTATION	AE F ER AH S T EY SH AH N
AFFORESTATIONS	AE F ER AH S T EY SH AH N Z
AFFORESTED	AE F ER AH S T IH D
AFFORESTING	AE F ER AH S T IH NG
AFFORESTS	AE F ER AH S T S
AFIRE	AH F AY R
AFORE	AH F OW R
AFOREMENTIONED	AH F AO R M EH N SH AH N D
AFORESAID	AH F AO R S EH D
AFORETHOUGHT	AH F AO R TH AA T
AFREET	AE F R IY T
AFREETS	AE F R IY T S
AFRESH	AH F R EH SH
AFTERCARE	AE F T ER K EH R
AFTERCARES	AE F T ER K EH R Z
AFTEREFFECT	AE F T ER AH F EH K T
AFTEREFFECTS	AE F T ER AH F EH K T S
AGGREGATE	AE G R AH G AH T
AGGREGATE(2)	AE G R AH G EY T
AGGREGATED	AE G R AH G EY T AH D
AGGREGATELY	AE G R IH G AH T L IY
AGGREGATENESS	AE G R IH G AH T N AH S
AGGREGATENESSES	AE G R IH G AH T N AH S IH Z
AGGREGATES	AE G R AH G IH T S
AGGREGATES(2)	AE G R AH G EY T S
AGGREGATING	AE G R IH G AH T IH NG
AGGREGATION	AE G R AH G EY SH AH N
AGGREGATIONAL	AE G R IH G AH SH AH N AH L
AGGREGATIONS	AE G R IH G AH SH AH N Z
AGGREGATIVE	AE G R IH G AH T IH V
AGGREGATIVELY	AE G R IH G AH T IH V L IY
AGGRESS	AH G R EH S
AGGRESSED	AH G R EH S T
AGGRESSES	AH G R EH S IH Z
AGGRESSING	AH G R EH S IH NG
AGGRESSION	AH G R EH SH AH N
AGGRESSIONS	AH G R EH SH AH N Z
AGGRESSIVE	AH G R EH S IH V
AGGRESSIVELY	AH G R EH S IH V L IY
AGGRESSIVENESS	AH G R EH S IH V N AH S
AGGRESSIVENESSES	AH G R EH S IH V N AH S IH Z
AGGRESSIVITIES	AH G R EH S IH V AH T IY Z
AGGRESSIVITY	AH G R EH S IH V IH T IY
AGGRESSOR	AH G R EH S ER
AGGRESSORS	AH G R EH S ER Z
AGLARE	AH G L EH R
AGREE	AH G R IY
AGREEABILITIES	AH G R IY AH B IH L AH T EH Z
AGREEABILITY	AH G R IY AH B IH L AH T EH
AGREEABLE	AH G R IY AH B AH L
AGREEABLENESS	AH G R IY AH B AH L N AH S
AGREEABLENESSES	AH G R IY AH B AH L N AH S IH Z
AGREEABLY	AH G R IY AH B L IY
AGREED	AH G R IY D
AGREEING	AH G R IY IH NG
AGREEMENT	AH G R IY M AH N T
AGREEMENTS	AH G R IY M AH N T S
AGREES	AH G R IY Z
AGRESTAL	AE G R EH S T AH L
AGRESTIC	AE G R AH S T AH K
AGRICULTURE	AE G R IH K AH L CH ER
AGRICULTURES	AE G R IH K AH L CH ER Z
AGROFORESTER	AE G R AA F AH R EH S T AH R
AGROFORESTERS	AE G R AH F AH R EH S T AH R Z
AGROFORESTRIES	AE G R AH F AH R EH S T R AY Z
AGROFORESTRY	AE G R AA F AH R EH S T R IY
AIGRET	EY G R AH T
AIGRETS	EY G R AH T S
AIGRETTE	EY G R EH T
AIGRETTES	EY G R EH T S
AIRCREW	EH R K R UW
AIRCREWS	AH IH R K R UW Z
AIRED	EH R D
AIRER	EH R ER
AIRERS	EH R ER Z
AIREST	EH R AH S T
AIRFARE	EH R F EH R
AIRFARES	EH R F EH R Z
AIRFREIGHT	EH R F R EY T
AIRFREIGHTED	AH IH R F R EY T IH D
AIRFREIGHTING	AH IH R F R EY T IH NG
AIRFREIGHTS	AH IH R F R EY T S
AIRSCREW	AH IH R S K R UW
AIRSCREWS	AH IH R S K R UW Z
AIRSTREAM	AH IH R S T R IY M
AIRSTREAMS	AH IH R S T R IY M Z
ALBACORE	AE L B AH K AO R
ALBACORES	AE L B AH K OW R Z
ALBICORE	AE L B AH K AH R
ALBICORES	AE L B AH K AH R Z
ALFRESCO	AE L F R EH S K OW
ALLEGRETTO	AE L AH G R EH T OW
ALLEGRETTOS	AE L AH G R EH T AH Z
ALLURE	AH L UH R
ALLURED	AH L UH R D
ALLUREMENT	AH L UH R M AH N T
ALLUREMENTS	AH L UH R M AH N T S
ALLURER	AH L UH R ER
ALLURERS	AH L UH R ER Z
ALLURES	AH L UH R Z
ALONGSHORE	AH L AO NG SH OW R
ALREADY	AO L R EH D IY
ALREADY(2)	AO R EH D IY
ALTERED	AO L T ER D
ALTERER	AO L T ER ER
ALTERERS	AO L T ER ER Z
AMARELLE	AE M AH R AH L
AMARELLES	AE M AH R AH L Z
AMARETTI	AE M AH R EH T IY
AMARETTO	AE M AH R EH T OW
AMARETTOS	AE M AH R EH T AH Z
AMBASSADRESS	AE M B AE S AH D R AH S
AMBASSADRESSES	AE M B AE S AE D R EH S AH Z
AMORETTI	AE M AH R EH T IY
AMORETTO	AE M AH R EH T OW
AMORETTOS	AE M AH R EH T AH Z
AMPERE	AE M P ER
AMPERES	AE M P IY R Z
AMREETA	AE M R IY T AH
AMREETAS	AE M R IY T AH Z
ANACREONTIC	AH N AE K R IY AH N T AH K
ANACREONTICS	AH N AE K R IY AA N T AH S Z
ANCESTORED	AE N S EH S T ER D
ANCESTRESS	AE N S EH S T R AH S
ANCESTRESSES	AE N S EH S T R EH S AH Z
ANCHORED	AE NG K ER D
ANCHORESS	AE NG K ER AH S
ANCHORESSES	AE NG K ER AH S IH Z
ANCHORET	AE NG K AH R AH T
ANCHORETS	AE NG K AH R AH T S
ANCRESS	AE NG K R AH S
ANCRESSES	AE NG K R EH S AH Z
ANEARED	AH N IH ER D
ANGERED	AE NG G ER D
ANORECTIC	AE N AH R AH K T AH K
ANORECTICS	AE N AH R EH K T AH S Z
ANORETIC	AE N AH R AH T AH K
ANORETICS	AH N AO R AH T AH S Z
ANOREXIA	AE N ER EH K S IY AH
ANOREXIAS	AE N AH R EH K S IY AH Z
ANOREXIC	AE N ER EH K S IH K
ANOREXICS	AE N ER EH K S IH K S
ANOREXIES	AE N AH R EH K S AY Z
ANOREXIGENIC	AE N AH R EH K S AH JH AH N AH K
ANOREXY	AE N AH R EH K S IY
ANSWERED	AE N S ER D
ANSWERER	AE N S ER ER
ANSWERERS	AE N S ER ER Z
ANTIAGGRESSION	AE N T AY AH G R EH SH AH N
ANTIBUREAUCRATIC	AE N T AY B Y UH R AH K R AE T IH K
ANTICIGARETTE	AE N T AY S IH G AH R EH T
ANTICREATIVE	AE N T AY K R IY EY T IH V
ANTIDEPRESSANT	AE N T IY D IH P R EH S AH N T
ANTIDEPRESSANTS	AE N T AY D IH P R EH S AH N T S
ANTIDEPRESSANTS(2)	AE N T IY D IH P R EH S AH N T S
ANTIDEPRESSION	AE N T AY D IY P R EH SH AH N
ANTIDEPRESSIONS	AE N T AY D IY P R EH SH AH N Z
ANTIDESEGREGATION	AE N T AY D IY S EH G R IH G EY SH AH N
ANTIFORECLOSURE	AE N T AY F OW R K L OW ZH ER
ANTIFOREIGN	AE N T AY F AO R AH N
ANTIFOREIGNER	AE N T AY F AO R AH N ER
ANTIFREEZE	AE N T IY F R IY Z
ANTIFREEZES	AE N T AY F R IY Z IH Z
ANTIGLARE	AE N T AY G L EH R
ANTIMERE	AE N T AY M IH ER
ANTIMERES	AE N T AY M IH ER Z
ANTINATURE	AE N T AY N EY CH ER
ANTINATURES	AE N T AY N EY CH ER Z
ANTIPLEASURE	AE N T AY P L EH ZH ER
ANTIPLEASURES	AE N T AY P L EH ZH ER Z
ANTIPREDATOR	AE N T AY P R IY D EY T ER
ANTIPREDATORS	AE N T AY P R IY D EY T ER Z
ANTIPRESS	AE N T AY P R EH S
ANTIPROGRESSIVE	AE N T AY P R AA G R EH S IH V
ANTIPYRESES	AE N T AY P AY ER Z IH Z
ANTIPYRESIS	AE N T AY P AY ER Z IY Z
ANTIPYRETIC	AE N T AH P IH R AH T AH K
ANTIPYRETICS	AE N T AH P IH R AH T AH S Z
ANTIREALISM	AE N T AY R IY L IH Z AH M
ANTIREALISMS	AE N T AY R IY L IH Z AH M Z
ANTIREALIST	AE N T AY R IY L IH S T
ANTIREALISTS	AE N T AY R IY L IH S T S
ANTIRECESSION	AE N T AY R IY S EH SH AH N
ANTIRECESSIONARY	AE N T AY R IY S EH SH AH N EH R IY
ANTIRECESSIONS	AE N T AY R IY S EH SH AH N Z
ANTIRED	AE N T AY R EH D
ANTIREDUCTIONISM	AE N T AY R IY D AH K SH AH N IH Z AH M
ANTIREDUCTIONISMS	AE N T AY R IY D AH K SH AH N IH Z AH M Z
ANTIREDUCTIONIST	AE N T AY R IY D AH K SH AH N IH S T
ANTIREDUCTIONISTS	AE N T AY R IY D AH K SH AH N IH S T S
ANTIREFLECTION	AE N T AY R IH F L EH K SH AH N
ANTIREFLECTIVE	AE N T AY R IH F L EH K T IH V
ANTIREFORM	AE N T AY R IY F AO R M
ANTIREGULATORY	AE N T AY R EH G Y AH L AH T OW R IY
ANTIREJECTION	AE N T AY R IH JH EH K SH AH N
ANTIRELIGION	AE N T AY R IH L IH JH AH N
ANTIRELIGIOUS	AE N T AY R IH L IH JH AH S
ANTIREVOLUTIONARIES	AE N T AY R EH V AH L UW SH AH N EH R IY Z
ANTIREVOLUTIONARY	AE N T AY R EH V AH L UW SH AH N EH R IY
ANTISCHIZOPHRENIA	AE N T AY S IH Z AH F R IY N Y AH
ANTISCHIZOPHRENIC	AE N T AY S K IH T S AH F R EH N IH K
ANTISECRECY	AE N T AY S IY K R AH S IY
ANTISEGREGATION	AE N T AY S EH G R IH G EY SH AH N
ANTISEIZURE	AE N T AY S IY ZH ER
ANTISTRESS	AE N T AY S T R EH S
ANTITHEORETICAL	AE N T AY TH IY AH R EH T IH K AH L
ANTIWELFARE	AE N T AY W EH L F EH R
ANTLERED	AE N T L ER D
ANTRE	AE N T AH R
ANTRES	AE N T AH R Z
ANURESES	AE N Y AH R IY Z AH Z
ANURESIS	AE N Y UH R AH S AH S
ANURETIC	AE N Y AH R AH T AH K
ANYMORE	EH N IY M AO R
ANYWHERE	EH N IY W EH R
ANYWHERE(2)	EH N IY HH W EH R
ANYWHERES	EH N IY W EH ER Z
APAREJO	AH P AE R AH JH OW
APAREJOS	AH P AE R AH JH AH Z
APERTURE	AE P ER CH ER
APERTURES	AE P AH CH UW R Z
APHAERESES	AE F AH R IY Z AH Z
APHAERESIS	AH F IY R AH S AH S
APHAERETIC	AH F IY R AH T AH K
APHERESES	AE F AH R IY Z AH Z
APHERESIS	AH F IH R AH S AH S
APICULTURE	AE P AH K AH L T Y AH R
APICULTURES	AE P AH K AH L T Y AH R Z
APPAREL	AH P AE R AH L
APPARELED	AH P AE R AH L D
APPARELING	AH P AE R AH L IH NG
APPARELLED	AH P AE R AH L D
APPARELLING	AH P AE R AH L IH NG
APPARELS	AH P AE R AH L Z
APPARENT	AH P EH R AH N T
APPARENTLY	AH P EH R AH N T L IY
APPARENTNESS	AH P AE R AH N T N AH S
APPARENTNESSES	AH P AE R AH N T N AH S IH Z
APPEARED	AH P IH R D
APPRECIABLE	AH P R IY SH AH B AH L
APPRECIABLY	AH P R IY SH AH B L IY
APPRECIATE	AH P R IY SH IY EY T
APPRECIATED	AH P R IY SH IY EY T IH D
APPRECIATES	AH P R IY SH IY EY T S
APPRECIATING	AH P R IY SH IY EY T IH NG
APPRECIATION	AH P R IY SH IY EY SH AH N
APPRECIATIONS	AH P R IY SH IY EY SH AH N Z
APPRECIATIVE	AH P R IY SH IY EY T IH V
APPRECIATIVE(2)	AH P R IY SH Y AH T IH V
APPRECIATIVELY	AH P R IY SH IY EY T IH V L IY
APPRECIATIVELY(2)	AH P R IY SH Y AH T IH V L IY
APPRECIATIVENESS	AH P R IY SH IY EY T IH V N AH S
APPRECIATIVENESSES	AH P R IY SH IY EY T IH V N AH S IH Z
APPRECIATOR	AH P R IY SH IY EY T ER
APPRECIATORS	AH P R IY SH IY EY T ER Z
APPRECIATORY	AH P R IY SH IY EY T ER IY
APPREHEND	AE P R IH HH EH N D
APPREHENDED	AE P R IH HH EH N D AH D
APPREHENDING	AE P R IH HH EH N D IH NG
APPREHENDS	AE P R IH HH EH N D Z
APPREHENSIBLE	AE P R IH HH EH N S AH B AH L
APPREHENSIBLY	AE P R IH HH EH N S AH B L IY
APPREHENSION	AE P R IH HH EH N SH AH N
APPREHENSIONS	AE P R IH HH EH N SH AH N Z
APPREHENSIVE	AE P R IH HH EH N S IH V
APPREHENSIVE(2)	AE P R IY HH EH N S IH V
APPREHENSIVELY	AE P R IH HH EH N S IH V L IY
APPREHENSIVENESS	AE P R IH HH EH N S IH V N AH S
APPREHENSIVENESSES	AE P R IH HH EH N S IH V N AH S IH Z
APPRENTICE	AH P R EH N T AH S
APPRENTICE(2)	AH P R EH N T IH S
APPRENTICED	AH P R EH N T AH S T
APPRENTICES	AH P R EH N T AH S IH Z
APPRENTICESHIP	AH P R EH N T AH S SH IH P
APPRENTICESHIPS	AH P R EH N T AH S SH IH P S
APPRENTICING	AH P R EH N T AH S IH NG
APPRESSED	AE P R AH S T
APPRESSORIA	AE P R AH S AO R IY AH
APPRESSORIUM	AE P R AH S AO R IY AH M
APRES	AE P AH R Z
APYRETIC	AE P AH R AH T AH K
AQUACULTURE	AE K W AH K AH L CH ER
AQUACULTURES	AE K W AH K AH L CH ER Z
AQUARELLE	AE K W AH R AH L
AQUARELLES	AE K W AH R AH L Z
AQUARELLIST	AE K W AH R EH L AH S T
AQUARELLISTS	AE K W AH R EH L AH S T S
AQUICULTURE	AE K W AH K AH L T Y AH R
AQUICULTURES	AE K W AH K AH L T Y AH R Z
ARBOREAL	AA R B AO R IY AH L
ARBOREALLY	AA R B OW R IY AH L IY
ARBORED	AA R B ER D
ARBOREOUS	AA R B AO R IY AH S
ARBORES	AA R B AH R Z
ARBORESCENCE	AA R B AH R EH S AH N S
ARBORESCENCES	AA R B AH R AH S EH N S AH Z
ARBORESCENT	AA R B AH R EH S AH N T
ARBORETA	AA R B AO R AH T AH
ARBORETUM	AA R B ER IY T AH M
ARBORETUMS	AA R B AO R AH T AH M Z
ARBORICULTURE	AA R B AO R AH K AH L T Y AH R
ARBORICULTURES	AA R B AO R AH K AH L T Y AH R Z
ARBOURED	AA R B OW Y AH R D
ARCATURE	AA R K AH CH ER
ARCATURES	AA R K AH CH ER Z
ARCHITECTURE	AA R K AH T EH K CH ER
ARCHITECTURES	AA R K AH T EH K CH ER Z
ARE	AA R
ARE(2)	ER
AREA	EH R IY AH
AREAE	AE R IY
AREAL	AH R IY L
AREALLY	AH R IY AH L AY
AREAS	EH R IY AH Z
AREAWAY	AH R IY AH W EY
AREAWAYS	AH R IY AH W EY Z
ARECA	AE R AH K AH
ARECAS	AE R AH K AH Z
ARECOLINE	AH R IY K OW L AY N
ARECOLINES	AH R IY K OW L AY N Z
AREIC	AE R IY AH K
ARENA	ER IY N AH
ARENACEOUS	AE R AH N AH S IY AH S
ARENAS	ER IY N AH Z
ARENICOLOUS	AE R AH N IH K AH L AH S
ARENITE	AE R AH N AY T
ARENITES	AE R AH N AY T S
ARENOSE	AH R IY N OW Z
ARENOUS	AE R AH N AH S
AREOCENTRIC	AH R IY AH S AH N T R AH K
AREOLA	AH R IY AH L AH
AREOLAE	AH R IY AH L IY
AREOLAR	AH R IY AH L AH R
AREOLAS	AH R IY AH L AH Z
AREOLATE	AE R IY AH L EY T
AREOLE	AE R IY OW L
AREOLES	AE R IY OW L Z
AREOLOGIES	AH R IY AA L AH JH AY Z
AREOLOGY	AH R IY AA L AH JH IY
ARES	AA R Z
ARETE	AH R IY T
ARETES	AH R IY T S
ARETHUSA	AE R AH TH UW S AH
ARETHUSAS	AE R AH TH UW S AH Z
ARMATURE	AA R M AH CH ER
ARMATURED	AA R M AH CH ER D
ARMATURES	AA R M AH CH ER Z
ARMOIRE	AA M W AA R
ARMOIRES	AA M W AA R Z
ARMORED	AA R M ER D
ARMORER	AA R M ER ER
ARMORERS	AA R M ER ER Z
ARMOURED	AA R M ER D
ARMOURER	AA R M ER ER
ARMOURERS	AA R M ER ER Z
ARMREST	AA R M R EH S T
ARMRESTS	AA R M R EH S T S
ARMURE	AA R M Y ER
ARMURES	AA R M Y ER Z
ARREAR	AH R IH ER
ARREARAGE	ER IY R IH JH
ARREARAGES	ER IH R IH JH IH Z
ARREARS	ER IH R Z
ARREST	ER EH S T
ARRESTANT	AH R EH S T AH N T
ARRESTANTS	AH R EH S T AH N T S
ARRESTED	ER EH S T AH D
ARRESTED(2)	ER EH S T IH D
ARRESTEE	AH R EH S T IY
ARRESTEES	AH R EH S T IY Z
ARRESTER	AH R EH S T ER
ARRESTERS	AH R EH S T ER Z
ARRESTING	ER EH S T IH NG
ARRESTINGLY	AH R EH S T IH NG L IY
ARRESTMENT	AH R EH S T M AH N T
ARRESTMENTS	AH R EH S T M AH N T S
ARRESTOR	AH R EH S T ER
ARRESTORS	AH R EH S T ER Z
ARRESTS	ER EH S T S
ARTHROSPORE	AA R TH R AA S AH R
ARTHROSPORES	AA R TH R AA S AH R Z
ASCOSPORE	AH Z K OW S P OW R
ASCOSPORES	AH Z K OW S P OW R Z
ASHLARED	AE SH L AH R D
ASHLERED	AE SH L IY R D
ASHORE	AH SH AO R
ASPIRE	AH S P AY R
ASPIRED	AH S P AY R D
ASPIRER	AH S P AY ER ER
ASPIRERS	AH S P AY ER ER Z
ASPIRES	AH S P AY ER Z
ASSURE	AH SH UH R
ASSURED	AH SH UH R D
ASSUREDLY	AH SH UH R AH D L IY
ASSUREDNESS	AH SH UW R AH D N AH S
ASSUREDNESSES	AH SH UW R AH D N AH S IH Z
ASSUREDS	AH SH UW R D Z
ASSURER	AH SH UW R ER
ASSURERS	AH SH UW R ER Z
ASSURES	AH SH UH R Z
ASTHENOSPHERE	AE S TH AH N AA S AH R
ASTHENOSPHERES	AE S TH EH N AH S IY R Z
ATHEORETICAL	AH TH IY AH R EH T IH K AH L
ATMOSPHERE	AE T M AH S F IH R
ATMOSPHERED	AE T M AH S F IH ER D
ATMOSPHERES	AE T M AH S F IH ER Z
ATREMBLE	AH T R EH M B AH L
ATRESIA	AE T R IY ZH IY AH
ATRESIAS	AE T R IY S IY AH Z
ATTEMPERED	AE T AH M P IY R D
ATTIRE	AH T AY ER
ATTIRED	AH T AY R D
ATTIRES	AH T AY ER Z
AUBRETIA	AO B R IY SH IY AH
AUBRETIAS	AO B R IY T IY AH Z
AUGURED	AO G ER D
AUGURER	AO G ER ER
AUGURERS	AO G ER ER Z
AUREATE	AO R IY EY T
AUREI	AO R IY
AUREOLA	AH R IY AH L AH
AUREOLAE	AH R IY AH L IY
AUREOLAS	AH R IY AH L AH Z
AUREOLE	AA R IY OW L
AUREOLED	AO R IY OW L D
AUREOLES	AO R IY OW L Z
AUREOLING	AO R IY OW L AH NG
AURES	EY Y AH R Z
AUREUS	AO R IY AH S
AUROREAN	AH R AO R IY AH N
AUSTERE	AO S T IH R
AUSTERELY	AO S T IH R L IY
AUSTERENESS	AO S T IH ER N AH S
AUSTERENESSES	AO S T IH ER N AH S IH Z
AUSTERER	AO S T IH ER ER
AUSTEREST	AO S T IH ER AH S T
AUTHORED	AO TH ER D
AUTHORESS	AO TH ER AH S
AUTHORESSES	AO TH ER AH S IH Z
AUTOCORRELATION	AO T OW K AO R AH L EY SH AH N
AUTOCORRELATIONS	AO T OW K AO R AH L EY SH AH N Z
AVERRED	AE V AH R D
AVICULTURE	AE V AH K AH L T Y AH R
AVICULTURES	AE V AH K AH L T Y AH R Z
AVODIRE	AE V AH D AY R
AVODIRES	AE V AH D AY R Z
AWARE	AH W EH R
AWARENESS	AH W EH R N AH S
AWARENESSES	AH W EH R N AH S IH Z
AXLETREE	AE K S AH L T R IY
AXLETREES	AE K S AH L T R IY Z
AZURE	AE ZH ER
AZURES	AE Z Y AH R Z
BACCALAUREATE	B AE K AH L AO R IY AH T
BACCALAUREATES	B AE K AH L AO R IY EY T S
BACHELORETTE	B AE CH L ER EH T
BACHELORETTES	B AE CH L ER EH T S
BACKBREAKER	B AE K B R EY K ER
BACKBREAKERS	B AE K B R EY K ER Z
BACKBREAKING	B AE K B R EY K IH NG
BACKFIRE	B AE K F AY R
BACKFIRED	B AE K F AY ER D
BACKFIRES	B AE K F AY ER Z
BACKREST	B AE K R EH S T
BACKRESTS	B AE K R EH S T S
BACKSCATTERED	B AE K S K AE T ER D
BACKSTREET	B AE K S T R IY T
BACKSTREETS	B AE K S T R IY T S
BACKSTRETCH	B AE K S T R EH CH
BACKSTRETCHES	B AE K S T R EH CH IH Z
BACTEREMIA	B AE K T AH R IY M IY AH
BACTEREMIAS	B AE K T AH R IY M IY AH Z
BACTEREMIC	B AE K T AH R AH M AH K
BADGERED	B AE JH ER D
BALEFIRE	B EY L F AY ER
BALEFIRES	B EY L F AY ER Z
BANDORE	B AE N D OW R
BANDORES	B AE N D OW R Z
BANISTERED	B AE N AH S T ER D
BANNERED	B AE N ER D
BANNERET	B AE N AH R AH T
BANNERETS	B AE N AH R AH T S
BANNERETTE	B AE N ER EH T
BANNERETTES	B AE N ER EH T S
BANTERED	B AE N T ER D
BANTERER	B AE N T ER ER
BANTERERS	B AE N T ER ER Z
BARBERED	B AA R B ER D
BARBWIRE	B AA R B W AY ER
BARBWIRES	B AA R B W AY ER Z
BARE	B EH R
BAREBACK	B EH R B AE K
BAREBACKED	B EH R B AE K T
BAREBOAT	B EH R B OW T
BAREBOATS	B EH R B OW T S
BARED	B EH R D
BAREFACED	B EH R F EY S T
BAREFACEDLY	B EH R F EY S AH D L IY
BAREFACEDNESS	B EH R F EY S AH D N AH S
BAREFACEDNESSES	B EH R F EY S AH D N AH S IH Z
BAREFIT	B EH R F IH T
BAREFOOT	B EH R F UH T
BAREFOOTED	B AA R F UH T AH D
BAREGE	B AH R IY JH
BAREGES	B AH R IY JH AH Z
BAREHANDED	B EH R HH AE N D IH D
BAREHEAD	B EH R HH EH D
BAREHEADED	B EH R HH EH D IH D
BARELY	B EH R L IY
BARENESS	B EH R N AH S
BARENESSES	B EH R N AH S IH Z
BARER	B EH R ER
BARES	B EH R Z
BARESARK	B AE R AH S AH R K
BARESARKS	B AE R AH S AH R K S
BAREST	B EH R AH S T
BARORECEPTOR	B AH R AO R AH S EH P T AH R
BARORECEPTORS	B AE R AH R AH S EH P T AH R Z
BARRE	B EH R IY
BARRE(2)	B AA R
BARRED	B AA R D
BARREL	B AE R AH L
BARREL(2)	B EH R AH L
BARRELAGE	B AE R AH L IH JH
BARRELAGES	B AE R AH L IH JH IH Z
BARRELED	B AE R AH L D
BARRELED(2)	B EH R AH L D
BARRELFUL	B AE R AH L F AH L
BARRELFULS	B AE R AH L F AH L Z
BARRELHEAD	B AE R AH L HH EH D
BARRELHEADS	B AE R AH L HH EH D Z
BARRELHOUSE	B AE R AH L HH AW S
BARRELHOUSES	B AE R AH L HH AW S IH Z
BARRELING	B AE R AH L IH NG
BARRELING(2)	B EH R AH L IH NG
BARRELLED	B AE R AH L D
BARRELLING	B AE R AH L IH NG
BARRELS	B AE R AH L Z
BARRELS(2)	B EH R AH L Z
BARRELSFUL	B AE R AH L Z F AH L
BARREN	B AE R AH N
BARREN(2)	B EH R AH N
BARRENER	B AE R AH N ER
BARRENEST	B AE R AH N AH S T
BARRENLY	B AE R AH N L IY
BARRENNESS	B AE R AH N AH S
BARRENNESSES	B AE R AH N AH S IH Z
BARRENS	B AE R AH N Z
BARRES	B AA R Z
BARRET	B AE R IH T
BARRETOR	B AE R AH T AH R
BARRETORS	B AE R AH T AH R Z
BARRETRIES	B AA R IY T R AY Z
BARRETRY	B AA R IY T R AY
BARRETS	B AE R AH T S
BARRETTE	B ER EH T
BARRETTES	B AA R EH T S
BARTERED	B AA R T ER D
BARTERER	B AA R T IY R AH R
BARTERERS	B AA R T AH R AH R Z
BARWARE	B AA R W EH R
BARWARES	B AA R W EH R Z
BASIDIOSPORE	B AE S AH D IY AA S AH R
BASIDIOSPORES	B AE S AH D IY AA S AH R Z
BATHYSPHERE	B EY DH IY S F IH ER
BATHYSPHERES	B EY DH IY S F IH ER Z
BATTERED	B AE T ER D
BAYADERE	B EY EY D AH R
BAYADERES	B EY AH D IY R Z
BEARER	B EH R ER
BEARERS	B EH R ER Z
BEAVERED	B IY V ER D
BECLAMORED	B IH K L AE M ER D
BEDIAPERED	B IH D AY P ER D
BEDRENCH	B IH D R EH N CH
BEDRENCHED	B IH D R EH N CH T
BEDRENCHES	B IH D R EH N CH IH Z
BEDRENCHING	B IH D R EH N CH IH NG
BEDSORE	B EH D S OW R
BEDSORES	B EH D S OW R Z
BEDSPREAD	B EH D S P R EH D
BEDSPREADS	B EH D S P R EH D Z
BEEBREAD	B IY B R EH D
BEEBREADS	B IY B R EH D Z
BEFINGERED	B IH F IH NG G ER D
BEFLOWERED	B IH F L AW ER D
BEFORE	B IH F AO R
BEFORE(2)	B IY F AO R
BEFOREHAND	B IH F AO R HH AE N D
BEFORETIME	B IH F OW R T AY M
BEFRET	B IH F R EH T
BEFRETS	B IH F R EH T S
BEFRETTED	B IH F R EH T IH D
BEFRETTING	B IH F R EH T IH NG
BEGGARED	B EH G ER D
BEGLAMORED	B IH G L AE M ER D
BEGLAMOURED	B IH G L AE M ER D
BELABORED	B IH L EY B ER D
BELABOURED	B IH L EY B ER D
BELEAGUERED	B IH L IY G ER D
BELIQUORED	B IH L IH K ER D
BELLIGERENCE	B AH L IH JH ER AH N S
BELLIGERENCES	B AH L IH JH ER AH N S IH Z
BELLIGERENCIES	B AH L IH JH ER AH N S IY Z
BELLIGERENCY	B AH L IH JH ER AH N S IY
BELLIGERENT	B AH L IH JH ER AH N T
BELLIGERENTLY	B AH L IH JH ER AH N T L IY
BELLIGERENTS	B AH L IH JH ER AH N T S
BELVEDERE	B EH L V AH D IH R
BELVEDERE(2)	B EH L V IH D IH R
BELVEDERES	B EH L V AH D IH ER Z
BEMIRE	B AH M AY R
BEMIRED	B AH M AY R D
BEMIRES	B AH M AY R Z
BEMURMURED	B IH M ER M ER D
BENEFACTRESS	B AH N AH F AE K T R AH S
BENEFACTRESSES	B AH N AH F AE K T R EH S AH Z
BENZOAPYRENE	B IH N Z OW P AH R IY N
BENZOAPYRENES	B IH N Z OW P AH R IY N Z
BEREAVE	B ER IY V
BEREAVED	B ER IY V D
BEREAVEMENT	B ER IY V M AH N T
BEREAVEMENTS	B IH R IY V M AH N T S
BEREAVER	B IH R IY V ER
BEREAVERS	B IH R IY V ER Z
BEREAVES	B IH R IY V Z
BEREAVING	B IH R IY V IH NG
BEREFT	B ER EH F T
BERET	B EH R AH T
BERET(2)	B EH R EY T
BERETS	B EH R AH T S
BERETS(2)	B EH R EY Z
BERETTA	B ER EH T AH
BERETTAS	B ER EH T AH S
BERGERE	B IH R JH IH R
BERGERES	B IH R JH IY R Z
BERRETTA	B IH R EH T AH
BERRETTAS	B IH R EH T AH Z
BESCOURED	B IH S K AW ER D
BESCREEN	B IH S K R IY N
BESCREENED	B IH S K R IY N D
BESCREENING	B IH S K R IY N IH NG
BESCREENS	B IH S K R IY N Z
BESHIVERED	B IH SH IH V ER D
BESHREW	B IH SH R UW
BESHREWED	B IH SH R UW D
BESHREWING	B IH SH R UW IH NG
BESHREWS	B IH SH R UW Z
BESMEARED	B IH S M IH ER D
BESPATTERED	B IH S P AE T ER D
BESPREAD	B IH S P R EH D
BESPREADING	B IH S P R EH D IH NG
BESPREADS	B IH S P R EH D Z
BESPRENT	B EH S R AH N T
BESTIRRED	B IH S T ER D
BESTREW	B IH S T R UW
BESTREWED	B EH S T R IY W EH D
BESTREWING	B EH S T R IY W IH NG
BESTREWN	B IH S T R UW N
BESTREWS	B IH S T R UW Z
BETATTERED	B IH T AE T ER D
BETTERED	B EH T ER D
BEWARE	B IH W EH R
BEWARED	B IH W EH R D
BEWARES	B IH W EH R Z
BEWHISKERED	B IH W IH S K ER D
BEWILDERED	B IH W IH L D ER D
BEWILDEREDLY	B IH W IH L D ER AH D L IY
BEWILDEREDNESS	B IH W IH L D ER AH D N AH S
BEWILDEREDNESSES	B IH W IH L D ER AH D N AH S IH Z
BICKERED	B IH K ER D
BICKERER	B IH K ER ER
BICKERERS	B IH K ER ER Z
BICOLORED	B AY K AH L ER D
BIDIRECTIONAL	B AY D AH R EH K SH AH N AH L
BIDIRECTIONALLY	B AY D AH R EH K SH AH N AH L IY
BILLIONAIRE	B IH L Y AH N EH R
BILLIONAIRES	B IH L Y AH N EH R Z
BIOENGINEERED	B AY OW EH N JH AH N IH R D
BIOREACTOR	B AY OW R AE K T ER
BIOREACTORS	B AY OW R AE K T ER Z
BIOREGION	B AY AH R IY JH AH N
BIOREGIONAL	B AY AH R AH JH IY AH N AH L
BIOREGIONALISM	B AY AO R AH JH IY AH N AH L IH Z AH M
BIOREGIONALISMS	B AY AH R IY JH IY AA N AH L AH Z AH M Z
BIOREGIONALIST	B AY AH R AH JH IY AA N AH L AH S T
BIOREGIONALISTS	B AY AH R IY JH IY AA N AH L AH S T S
BIOREGIONS	B AY AH R IY JH IY AH N Z
BIOREMEDIATION	B AY OW R M IY D IY EY SH AH N
BIOREMEDIATIONS	B AY OW R M IY D IY EY SH AH N Z
BIOSPHERE	B AY OW S F IH R
BIOSPHERES	B AY OW S F IH R Z
BIPARENTAL	B AY P AH R EH N T AH L
BIPARENTALLY	B AY P AH R EH N T AH L IY
BIREFRINGENCE	B AY R IH F R IH N JH AH N S
BIREFRINGENCES	B AY R IH F R IH N JH AH N S IH Z
BIREFRINGENT	B AY R IY F R IH N JH AH N T
BIREME	B AY R IY M
BIREMES	B AY R IY M Z
BIRETTA	B AY R AH T AA
BIRETTAS	B AY R AH T AE Z
BIRRED	B AH R D
BIRRETTA	B AY R EH T AH
BIRRETTAS	B AY R EH T AH Z
BISTERED	B AY S T ER D
BISTRE	B AY S T AH R
BISTRED	B IY IH S T R EH D
BISTRES	B IH S T AH R Z
BITTERED	B IH T ER D
BITTERER	B IH T ER ER
BITTEREST	B IH T ER AH S T
BIZARRE	B AH Z AA R
BIZARRE(2)	B IH Z AA R
BIZARRELY	B AH Z AA R L IY
BIZARRENESS	B AH Z AA R N AH S
BIZARRENESSES	B AH Z AA R N AH S IH Z
BIZARRERIE	B AH Z AA R ER IY
BIZARRERIES	B AH Z AA R AH R IY Z
BIZARRES	B AH Z AA R Z
BLABBERED	B L AE B ER D
BLARE	B L EH R
BLARED	B L EH R D
BLARES	B L EH R Z
BLASTOMERE	B L AE S T OW M AH R
BLASTOMERES	B L AE S T AH M IY R Z
BLASTOPORE	B L AE S T AH P AH R
BLASTOPORES	B L AE S T AH P AH R Z
BLASTOSPORE	B L AE S T AA S P OW R
BLASTOSPORES	B L AE S T AA S P OW R Z
BLATHERED	B L AH TH IY R D
BLATHERER	B L AH TH IY R AH R
BLATHERERS	B L AE TH AH R AH R Z
BLATTERED	B L EY T ER D
BLEARED	B L IH ER D
BLETHERED	B L AH TH IY R D
BLINKERED	B L IH NG K ER D
BLISTERED	B L IH S T ER D
BLITHERED	B L AY TH ER D
BLOODRED	B L AH D R EH D
BLOODSTREAM	B L AH D S T R IY M
BLOODSTREAMS	B L AH D S T R IY M Z
BLUBBERED	B L AH B ER D
BLUNDERED	B L AH N D ER D
BLUNDERER	B L AH N D ER ER
BLUNDERERS	B L AH N D ER ER Z
BLURRED	B L ER D
BLUSTERED	B L AH S T ER D
BLUSTERER	B L AH S T ER ER
BLUSTERERS	B L AH S T ER ER Z
BOLIVARES	B AA L AH V AH R Z
BOLSTERED	B OW L S T ER D
BOLSTERER	B OW L S T ER ER
BOLSTERERS	B OW L S T ER ER Z
BONFIRE	B AA N F AY ER
BONFIRES	B AA N F AY ER Z
BOOKLORE	B UH K L OW R
BOOKLORES	B UH K L OW R Z
BOOKREST	B UH K R EH S T
BOOKRESTS	B UH K R EH S T S
BOOKSTORE	B UH K S T AO R
BOOKSTORES	B UH K S T AO R Z
BORDEREAU	B AO R D IY R IY UW
BORDEREAUX	B AO R D IY R IY AH K S
BORDERED	B AO R D ER D
BORDERER	B AO R D ER ER
BORDERERS	B AO R D ER ER Z
BORDURE	B AO R D Y AH R
BORDURES	B AO R D Y AH R Z
BORE	B AO R
BOREAL	B AO R AH L
BORECOLE	B AO R K OW L
BORECOLES	B AO R K OW L Z
BORED	B AO R D
BOREDOM	B AO R D AH M
BOREDOMS	B AO R D AH M Z
BOREEN	B AO R AH N
BOREENS	B AO R AH N Z
BOREHOLE	B AO R HH OW L
BOREHOLES	B AO R HH OW L Z
BORER	B AO R ER
BORERS	B AO R ER Z
BORES	B AO R Z
BORESCOPE	B AO R S K OW P
BORESCOPES	B AO R S K OW P S
BORESOME	B AO R S AH M
BOTHERED	B AA DH ER D
BOULDERED	B OW L D ER D
BOURREE	B AH R IY IY
BOURREES	B OW R IY Z
BOURTREE	B AH R T R IY IY
BOURTREES	B AH R T R IY Z
BOUTONNIERE	B AW T AH N IY R
BOUTONNIERES	B AW T AH N IY R Z
BOWERED	B AW ER D
BRAINCHILDREN	B R EY N CH IH L D R AH N
BRASSIERE	B R AH Z IH ER
BRASSIERES	B R AH Z IH ER Z
BRAVURE	B R EY V Y ER
BREACH	B R IY CH
BREACHED	B R IY CH T
BREACHER	B R IY CH ER
BREACHERS	B R IY CH ER Z
BREACHES	B R IY CH IH Z
BREACHING	B R IY CH IH NG
BREAD	B R EH D
BREADBASKET	B R EH D B AE S K AH T
BREADBASKETS	B R EH D B AE S K AH T S
BREADBOARD	B R EH D B OW R D
BREADBOARDED	B R EH D B OW R D IH D
BREADBOARDING	B R EH D B OW R D IH NG
BREADBOARDS	B R EH D B OW R D Z
BREADBOX	B R EH D B AA K S
BREADBOXES	B R EH D B AA K S IH Z
BREADCRUMB	B R EH D K R AH M
BREADCRUMBS	B R EH D K R AH M Z
BREADED	B R EH D IH D
BREADFRUIT	B R EH D F R UW T
BREADFRUITS	B R EH D F R UW T S
BREADING	B R EH D IH NG
BREADLINE	B R EH D L AY N
BREADLINES	B R EH D L AY N Z
BREADNUT	B R EH D N AH T
BREADNUTS	B R EH D N AH T S
BREADS	B R EH D Z
BREADSTICK	B R EH D S T IH K
BREADSTICKS	B R EH D S T IH K S
BREADSTUFF	B R EH D S T AH F
BREADSTUFFS	B R EH D S T AH F S
BREADTH	B R EH D TH
BREADTHS	B R EH D TH S
BREADTHWISE	B R EH D TH W AY Z
BREADWINNER	B R EH D W IH N ER
BREADWINNERS	B R EH D W IH N ER Z
BREADWINNING	B R EH D W IH N IH NG
BREADWINNINGS	B R EH D W IH N IH NG Z
BREADY	B R EH D IY
BREAK	B R EY K
BREAKABLE	B R EY K AH B AH L
BREAKABLES	B R EY K AH B AH L Z
BREAKAGE	B R EY K IH JH
BREAKAGES	B R EY K IH JH IH Z
BREAKAWAY	B R EY K AH W EY
BREAKAWAYS	B R EY K AH W EY Z
BREAKDOWN	B R EY K D AW N
BREAKDOWNS	B R EY K D AW N Z
BREAKER	B R EY K ER
BREAKERS	B R EY K ER Z
BREAKEVEN	B R EY K IY V AH N
BREAKEVENS	B R EY K IY V AH N Z
BREAKFAST	B R EH K F AH S T
BREAKFASTED	B R EH K F AH S T IH D
BREAKFASTER	B R EH K F AH S T ER
BREAKFASTERS	B R EH K F AH S T ER Z
BREAKFASTING	B R EH K F AH S T IH NG
BREAKFASTS	B R EH K F AH S T S
BREAKFRONT	B R EY K F R AH N T
BREAKFRONTS	B R EY K F R AH N T S
BREAKING	B R EY K IH NG
BREAKINGS	B R EY K IH NG Z
BREAKNECK	B R EY K N EH K
BREAKOUT	B R EY K AW T
BREAKOUTS	B R EY K AW T S
BREAKS	B R EY K S
BREAKSAWAY	B R EY K S AH W EY
BREAKTHROUGH	B R EY K TH R UW
BREAKTHROUGHS	B R EY K TH R UW Z
BREAKUP	B R EY K AH P
BREAKUPS	B R EY K AH P S
BREAKWATER	B R EY K W AO T ER
BREAKWATERS	B R EY K W AO T ER Z
BREAM	B R IY M
BREAMED	B R IY M D
BREAMING	B R IY M AH NG
BREAMS	B R IY M Z
BREAST	B R EH S T
BREASTBONE	B R EH S T B OW N
BREASTBONES	B R EH S T B OW N Z
BREASTED	B R EH S T AH D
BREASTED(2)	B R EH S T IH D
BREASTING	B R EH S T IH NG
BREASTPLATE	B R EH S T P L EY T
BREASTPLATES	B R EH S T P L EY T S
BREASTS	B R EH S T S
BREASTSTROKE	B R EH S T S T R OW K
BREASTSTROKER	B R EH S T S T R OW K ER
BREASTSTROKERS	B R EH S T S T R OW K ER Z
BREASTSTROKES	B R EH S T S T R OW K S
BREASTWORK	B R EH S T W ER K
BREASTWORKS	B R EH S T W ER K S
BREATH	B R EH TH
BREATHABILITIES	B R IY DH AH B IH L AH T EH Z
BREATHABILITY	B R IY DH AH B IH L AH T EH
BREATHABLE	B R IY DH AH B AH L
BREATHE	B R IY DH
BREATHED	B R IY DH D
BREATHER	B R IY DH ER
BREATHERS	B R IY DH ER Z
BREATHES	B R IY DH Z
BREATHIER	B R EH TH IY ER
BREATHIEST	B R EH TH IY AH S T
BREATHILY	B R EH TH IY L IY
BREATHINESS	B R EH TH IY N AH S
BREATHINESSES	B R EH TH IY N AH S IH Z
BREATHING	B R IY DH IH NG
BREATHINGS	B R IY DH IH NG Z
BREATHLESS	B R EH TH L AH S
BREATHLESSLY	B R EH TH L AH S L IY
BREATHLESSNESS	B R EH TH L AH S N AH S
BREATHLESSNESSES	B R EH TH L AH S N AH S IH Z
BREATHS	B R EH TH S
BREATHTAKING	B R EH TH T EY K IH NG
BREATHTAKINGLY	B R EH TH T EY K IH NG L IY
BREATHY	B R EH TH IY
BRECCIA	B R EH K S IY AH
BRECCIAL	B R EH K S IY AH L
BRECCIAS	B R EH K S IY AH Z
BRECCIATE	B R EH K S AY EY T
BRECCIATED	B R EH K S AY EY T AH D
BRECCIATES	B R EH K S AY EY T S
BRECCIATING	B R EH K S AY EY T AH NG
BRECCIATION	B R EH K S AY EY SH AH N
BRECCIATIONS	B R EH K S IY EY T IY AH N Z
BRECHAM	B R EH CH AH M
BRECHAMS	B R EH CH AH M Z
BRECHAN	B R EH CH AH N
BRECHANS	B R EH CH AH N Z
BRED	B R EH D
BREDE	B R IY D
BREDES	B R IY D Z
BREE	B R IY
BREECH	B R IY CH
BREECHBLOCK	B R IY CH B L AA K
BREECHBLOCKS	B R IY CH B L AA K S
BREECHCLOTH	B R IY CH K L AO TH
BREECHCLOTHS	B R IY CH K L AO TH S
BREECHCLOUT	B R IY CH K L AW T
BREECHCLOUTS	B R IY CH K L AW T S
BREECHED	B R IY CH T
BREECHES	B R IY CH IH Z
BREECHING	B R IY CH IH NG
BREECHINGS	B R IY CH IH NG Z
BREECHLOADER	B R IY CH L OW D ER
BREECHLOADERS	B R IY CH L OW D ER Z
BREED	B R IY D
BREEDER	B R IY D ER
BREEDERS	B R IY D ER Z
BREEDING	B R IY D IH NG
BREEDINGS	B R IY D IH NG Z
BREEDS	B R IY D Z
BREEKS	B R IY K S
BREES	B R IY Z
BREEZE	B R IY Z
BREEZED	B R IY Z D
BREEZELESS	B R IY Z L AH S
BREEZES	B R IY Z IH Z
BREEZEWAY	B R IY Z W EY
BREEZEWAYS	B R IY Z W EY Z
BREEZIER	B R IY Z IY ER
BREEZIEST	B R IY Z IY AH S T
BREEZILY	B R IY Z IY L IY
BREEZINESS	B R IY Z IY N AH S
BREEZINESSES	B R IY Z IY N AH S IH Z
BREEZING	B R IY Z IH NG
BREEZY	B R IY Z IY
BREGMA	B R EH G M AH
BREGMATA	B R EH G M AH T AH
BREGMATE	B R AH M EY T
BREMSSTRAHLUNG	B R EH M SH T R AA L AH NG
BREMSSTRAHLUNGS	B R EH M SH T R AA L AH NG Z
BREN	B R EH N
BRENS	B R EH N Z
BRENT	B R EH N T
BRENTS	B R EH N T S
BRETHREN	B R EH DH R AH N
BREVE	B R EH V
BREVES	B R EH V Z
BREVET	B R AH V EH T
BREVETCIES	B R AH V EH T S AY Z
BREVETCY	B R AH V EH T S IY
BREVETED	B R AH V EH T IH D
BREVETING	B R AH V EH T IH NG
BREVETS	B R AH V EH T S
BREVETTED	B R AH V EH T IH D
BREVETTING	B R AH V EH T IH NG
BREVIARIES	B R EH V IY EH R IY Z
BREVIARY	B R EH V IY EH R IY
BREVIER	B R EH V IY ER
BREVIERS	B R EH V IY ER Z
BREVITIES	B R EH V AH T IY Z
BREVITY	B R EH V AH T IY
BREW	B R UW
BREWAGE	B R UW IH JH
BREWAGES	B R UW IH JH IH Z
BREWED	B R UW D
BREWER	B R UW ER
BREWERIES	B R UW ER IY Z
BREWERIES(2)	B R UW R IY Z
BREWERS	B R UW ER Z
BREWERY	B R UW ER IY
BREWING	B R UW IH NG
BREWINGS	B R UW IH NG Z
BREWIS	B R UW IY Z
BREWISES	B R UW IY Z IH Z
BREWPUB	B R UW P AH B
BREWPUBS	B R UW P AH B Z
BREWS	B R UW Z
BROCHURE	B R OW SH UH R
BROCHURES	B R OW SH UH R Z
BROIDERED	B R OY D IY R D
BROKERED	B R OW K ER D
BROODMARE	B R UW D M EH R
BROODMARES	B R UW D M EH R Z
BROTHERED	B R AH DH ER D
BRUSHFIRE	B R AH SH F AY R
BRUSHFIRES	B R AH SH F AY R Z
BUCCANEERED	B AH K EY N AH R D
BUCKLERED	B AH K AH L ER D
BUCKMINSTERFULLERENE	B AH K M AH N S T AH R F UH L AH R IY N
BUCKMINSTERFULLERENES	B AH K M AH N S T AH R F UH L AH R IY N Z
BUFFERED	B AH F ER D
BUGGERED	B UH G ER D
BUMPERED	B AH M P ER D
BUNKERED	B AH NG K ER D
BUREAU	B Y UH R OW
BUREAUCRACIES	B Y UH R AA K R AH S IY Z
BUREAUCRACY	B Y UH R AA K R AH S IY
BUREAUCRAT	B Y UH R AH K R AE T
BUREAUCRAT(2)	B Y UH R OW K R AE T
BUREAUCRATESE	B Y UH R AH K R AE T IY Z
BUREAUCRATESES	B Y UH R OW K R EY T S IH Z
BUREAUCRATIC	B Y UH R AH K R AE T IH K
BUREAUCRATICALLY	B Y UH R AH K R AE T IH K AH L IY
BUREAUCRATISE	B Y AH R IY AH K R AH T AY Z
BUREAUCRATISED	B Y UH R AH K R AE T IY Z D
BUREAUCRATISES	B Y UH R AH K R AE T IY Z IH Z
BUREAUCRATISING	B Y UH R AH K R AE T IY Z IH NG
BUREAUCRATISM	B Y UH R AH K R AE T IH Z AH M
BUREAUCRATISMS	B Y UH R AH K R AE T IH Z AH M Z
BUREAUCRATIZATION	B Y UH R AH K R AE T AH Z EY SH AH N
BUREAUCRATIZATIONS	B Y UH R AH K R AE T AH Z EY SH AH N Z
BUREAUCRATIZE	B Y UH R AH K R AE T AY Z
BUREAUCRATIZED	B Y UH R AH K R AE T AY Z D
BUREAUCRATIZES	B Y UH R AH K R AE T AY Z IH Z
BUREAUCRATIZING	B Y UH R AH K R AE T AY Z IH NG
BUREAUCRATS	B Y UH R AH K R AE T S
BUREAUCRATS(2)	B Y UH R OW K R AE T S
BUREAUS	B Y UH R OW Z
BUREAUX	B Y UH R IY AH K S
BURET	B Y UH R AH T
BURETS	B Y UH R AH T S
BURETTE	B IY Y ER EH T
BURETTES	B IY Y ER EH T S
BURRED	B ER D
BURRER	B ER ER
BURRERS	B ER ER Z
BUSHFIRE	B UH SH F AY ER
BUSHFIRES	B UH SH F AY ER Z
BUTCHERED	B UH CH ER D
BUTTERED	B AH T ER D
BUTTERFINGERED	B AH T ER F IH NG G ER D
BUTTRESS	B AH T R AH S
BUTTRESSED	B AH T R AH S T
BUTTRESSES	B AH T R AH S AH Z
BUTTRESSES(2)	B AH T R AH S IH Z
BUTTRESSING	B AH T R AH S IH NG
BYRE	B AY R
BYRES	B AY R Z
BYSTREET	B AY S T R IY T
BYSTREETS	B AY S T R IY T S
CABARET	K AE B ER EY
CABARETS	K AE B ER EY Z
CABRESTA	K AE B R EH S T AH
CABRESTAS	K AE B R EH S T AH Z
CABRESTO	K AE B R EH S T OW
CABRESTOS	K AE B R EH S T AA S
CABRETTA	K AE B R EH T AH
CABRETTAS	K AE B R EH T AH Z
CACCIATORE	K AA CH AH T AO R IY
CADASTRE	K AH D AE S T AH R
CADASTRES	K AH D AE S T AH R Z
CADRE	K AE D R IY
CADRES	K AE D R IY Z
CAESAREAN	K EY S ER IY N
CAESAREANS	K EY S ER IY N Z
CALCAREOUS	K AE L K AE R IY AH S
CALCAREOUSLY	K AE L K AH R IY OW AH S L IY
CALENDARED	K AE L AH N D ER D
CALENDERED	K AE L AH N D IY R D
CALENDERER	K AE L AH N D IY R AH R
CALENDERERS	K AH L EH N D AH R AH R Z
CALENTURE	K AH L EH N T Y AH R
CALENTURES	K AH L EH N T Y AH R Z
CALIBRE	K AE L AH B ER
CALIBRED	K AE L AH B ER D
CALIBRES	K AE L AH B ER Z
CALIPERED	K AE L AH P ER D
CALLIPERED	K AE L AH P IY R D
CAMBERED	K AE M B IY ER D
CAMPFIRE	K AE M P F AY ER
CAMPFIRES	K AE M P F AY ER Z
CAMPHIRE	K AE M P HH AY ER
CAMPHIRES	K AE M P HH AY ER Z
CAMPOREE	K AE M P ER IY
CAMPOREES	K AE M P ER IY Z
CANDIDATURE	K AE N D AH D AH CH ER
CANDIDATURES	K AE N D AH D AH CH ER Z
CANEWARE	K EY N W EH R
CANEWARES	K EY N W EH R Z
CANKERED	K AE NG K ER D
CANTERED	K AE N T ER D
CANTILEVERED	K AE N T AH L IY V ER D
CAPERED	K EY P ER D
CAPERER	K EY P ER ER
CAPERERS	K EY P ER ER Z
CAPTURE	K AE P CH ER
CAPTURED	K AE P CH ER D
CAPTURER	K AE P CH ER ER
CAPTURERS	K AE P CH ER ER Z
CAPTURES	K AE P CH ER Z
CARABINIERE	K AH R AE B AH N IY R
CARBURET	K AA R B Y AH R AH T
CARBURETED	K AA R B Y ER EH T IH D
CARBURETING	K AA R B Y AH R IY T AH NG
CARBURETION	K AA R B Y ER IY SH AH N
CARBURETIONS	K AA R B Y AH R IY T IY AH N Z
CARBURETOR	K AA R B ER EY T ER
CARBURETORS	K AA R B ER EY T ER Z
CARBURETS	K AA R B Y AH R AH T S
CARBURETTED	K AA R B IY Y ER EH T IH D
CARBURETTER	K AA R B IY Y ER EH T ER
CARBURETTERS	K AA R B IY Y ER EH T ER Z
CARBURETTING	K AA R B IY Y ER EH T IH NG
CARBURETTOR	K AA R B IY Y ER EH T ER
CARBURETTORS	K AA R B IY Y ER EH T ER Z
CARDIORESPIRATORY	K AA R D IY AH R EH S AH R AH T AO R IY
CARE	K EH R
CARED	K EH R D
CAREEN	K ER IY N
CAREENED	K ER IY N D
CAREENER	K AH R IY N ER
CAREENERS	K AH R IY N ER Z
CAREENING	K ER IY N IH NG
CAREENS	K ER IY N Z
CAREER	K ER IH R
CAREERED	K AH R IH ER D
CAREERER	K AH R IH ER ER
CAREERERS	K AH R IH ER ER Z
CAREERING	K ER IH R IH NG
CAREERISM	K ER IY R IH Z AH M
CAREERISMS	K AH R IH ER IH Z AH M Z
CAREERIST	K ER IH R IH S T
CAREERISTS	K ER IH R IH S T S
CAREERS	K ER IH R Z
CAREFREE	K EH R F R IY
CAREFUL	K EH R F AH L
CAREFULLER	K EH R F AH L ER
CAREFULLEST	K EH R F AH L AH S T
CAREFULLY	K EH R F AH L IY
CAREFULNESS	K EH R F AH L N AH S
CAREFULNESSES	K EH R F AH L N AH S IH Z
CAREGIVER	K EH R G IH V ER
CAREGIVERS	K EH R G IH V ER Z
CAREGIVING	K EH R G IH V IH NG
CAREGIVINGS	K EH R G IH V IH NG Z
CARELESS	K EH R L EH S
CARELESSLY	K EH R L EH S L IY
CARELESSNESS	K EH R L EH S N AH S
CARELESSNESSES	K EH R L AH S N AH S IH Z
CARER	K EH R ER
CARERS	K EH R ER Z
CARES	K EH R Z
CARESS	K ER EH S
CARESSED	K ER EH S T
CARESSER	K AH R EH S ER
CARESSERS	K AH R EH S ER Z
CARESSES	K ER EH S IH Z
CARESSING	K ER EH S IH NG
CARESSINGLY	K AH R EH S IH NG L IY
CARESSIVE	K AH R EH S IH V
CARESSIVELY	K AH R EH S IH V L IY
CARET	K AE R AH T
CARETAKE	K EH R T EY K
CARETAKEN	K EH R T EY K AH N
CARETAKER	K EH R T EY K ER
CARETAKERS	K EH R T EY K ER Z
CARETAKES	K EH R T EY K S
CARETAKING	K EH R T EY K IH NG
CARETAKINGS	K EH R T EY K IH NG Z
CARETOOK	K EH R T UH K
CARETS	K AE R AH T S
CAREWORN	K EH R W OW R N
CAREX	K AE R AH K S
CARFARE	K AA R F EH R
CARFARES	K AA R F EH R Z
CARICATURE	K EH R IH K AH CH ER
CARICATURED	K EH R IH K AH CH ER D
CARICATURES	K EH R IH K AH CH ER Z
CARNIVORE	K AA R N IH V AO R
CARNIVORES	K AA R N AH V AO R Z
CARPENTERED	K AA R P AH N T ER D
CARPOPHORE	K AA R P AH F AH R
CARPOPHORES	K AA R P AH F AH R Z
CARPOSPORE	K AA R P AA S P OW R
CARPOSPORES	K AA R P AA S P OW R Z
CARREFOUR	K AA R IY F OW R
CARREFOURS	K AA R IY F OW R Z
CARREL	K AE R EH L
CARRELL	K AA R EY L
CARRELLS	K AE R AH L Z
CARRELS	K AE R AH L Z
CASEBEARER	K EY S B AE ER ER
CASEBEARERS	K EY S B AE ER ER Z
CASHIERED	K AE SH IH R D
CASHMERE	K AE ZH M IH R
CASHMERES	K AE ZH M IH R Z
CASIMERE	K AE S AH M AH R
CASIMERES	K AE S AH M IY R Z
CASIMIRE	K AE S AH M AY R
CASIMIRES	K AE S AH M AY R Z
CASSIMERE	K AE S AH M AH R
CASSIMERES	K AE S AH M IY R Z
CASTOREUM	K AE S T AO R IY AH M
CASTOREUMS	K AE S T AO R IY AH M Z
CATACHRESES	K AE T AH K R IY Z AH Z
CATACHRESIS	K AH T AE K R AH S AH S
CATACHRESTIC	K AH T AE K R AH S T AH K
CATACHRESTICAL	K AH T AE K R EH S T IH S AH L
CATACHRESTICALLY	K AE T AH K R EH S T AH K AE L IY
CATAPHORESES	K AH T AE F AH R IY Z AH Z
CATAPHORESIS	K AE T AH F AO R AH S AH S
CATAPHORETIC	K AH T AE F AH R AH T AH K
CATAPHORETICALLY	K AE T AH F AH R EH T AH K AE L IY
CATERCORNERED	K EY T ER K AO R N ER D
CATERED	K EY T ER D
CATERER	K EY T ER ER
CATERERS	K EY T ER ER Z
CATERESS	K EY T ER AH S
CATERESSES	K EY T ER AH S IH Z
CAULIFLOWERET	K AO L AH F L OW AH R AH T
CAULIFLOWERETS	K AO L AH F L OW AH R AH T S
CAVALIERED	K EY V AH L IY ER D
CAVIARE	K EY V IY AH R
CAVIARES	K EY V IY AH R Z
CEASEFIRE	S IY S F AY ER
CEASEFIRES	S IY S F AY ER Z
CEINTURE	S IY N T Y AH R
CEINTURES	S IY N T Y AH R Z
CELLARED	S EH L ER D
CELLARER	S EH L ER ER
CELLARERS	S EH L ER ER Z
CELLARET	S EH L AH R AH T
CELLARETS	S EH L AH R AH T S
CELLARETTE	S EH L ER EH T
CELLARETTES	S EH L ER EH T S
CENSORED	S EH N S ER D
CENSURE	S EH N SH ER
CENSURED	S EH N SH ER D
CENSURER	S EH N CH ER ER
CENSURERS	S EH N CH ER ER Z
CENSURES	S EH N CH ER Z
CENTARE	S EH N T AH R
CENTARES	S EH N T AH R Z
CENTAUREA	S EH N T AH Y UH R IY AH
CENTAUREAS	S EH N T AH Y UH R IY AH Z
CENTERED	S EH N T ER D
CENTEREDNESS	S EH N T ER AH D N AH S
CENTEREDNESSES	S EH N T ER AH D N AH S IH Z
CENTIARE	S EH N T IY AH R
CENTIARES	S EH N T IY AH R Z
CENTRE	S EH N T ER
CENTRED	S EH N T ER D
CENTRES	S EH N T ER Z
CENTROMERE	S EH N T R OW M AH R
CENTROMERES	S EH N T R AH M IY R Z
CERE	S IH R
CEREAL	S IH R IY AH L
CEREALS	S IH R IY AH L Z
CEREBELLA	S EH R AH B EH L AH
CEREBELLAR	S EH R AH B EH L AH R
CEREBELLUM	S EH R AH B EH L AH M
CEREBELLUMS	S EH R AH B EH L AH M Z
CEREBRA	S AH R EH B R AH
CEREBRAL	S EH R AH B R AH L
CEREBRAL(2)	S ER IY B R AH L
CEREBRALLY	S ER IY B R AH L IY
CEREBRALS	S EH R AH B R AH L Z
CEREBRATE	S EH R AH B R AH T
CEREBRATED	S EH R AH B R EY T IH D
CEREBRATES	S EH R AH B R AH T S
CEREBRATING	S EH R AH B R EY T IH NG
CEREBRATION	S EH R AH B R EY SH AH N
CEREBRATIONS	S EH R AH B R EY SH AH N Z
CEREBRIC	S EH R AH B R IH K
CEREBROSIDE	S AH R EH B R AH S AY D
CEREBROSIDES	S AH R EH B R AH S AY D Z
CEREBROSPINAL	S EH R AH B R AA S AH N AH L
CEREBROVASCULAR	S AH R EH B R AH V AE S Y AH L AH R
CEREBRUM	S AH R EH B R AH M
CEREBRUMS	S AH R EH B R AH M Z
CERECLOTH	S AH R EH K L AH TH
CERECLOTHS	S AH R EH K L AH TH S
CERED	S IY R D
CEREMENT	S IH R M AH N T
CEREMENTS	S EH R AH M AH N T S
CEREMONIAL	S EH R AH M OW N IY AH L
CEREMONIALISM	S EH R AH M OW N IY AH L IH Z AH M
CEREMONIALISMS	S EH R AH M OW N IY AH L IH Z AH M Z
CEREMONIALIST	S EH R AH M OW N IY AH L IH S T
CEREMONIALISTS	S EH R AH M OW N IY AH L IH S T S
CEREMONIALLY	S EH R AH M OW N IY AH L IY
CEREMONIALS	S EH R AH M OW N IY AH L Z
CEREMONIES	S EH R AH M OW N IY Z
CEREMONIOUS	S EH R AH M OW N IY AH S
CEREMONIOUSLY	S EH R AH M OW N IY AH S L IY
CEREMONIOUSNESS	S EH R AH M OW N IY AH S N AH S
CEREMONIOUSNESSES	S EH R AH M OW N IY AH S N AH S IH Z
CEREMONY	S EH R AH M OW N IY
CERES	S IH R IY Z
CEREUS	S IH R IY AH S
CEREUSES	S IY R IY AH Z AH Z
CESAREAN	S AH S AE R IY AH N
CESAREANS	S EH S AH R IY N Z
CHAFFERED	CH AE F ER D
CHAFFERER	CH AE F ER ER
CHAFFERERS	CH AE F ER ER Z
CHAIRED	CH EH R D
CHAMBERED	CH EY M B ER D
CHAMFERED	CH AE M F EH R D
CHANCRE	CH AE NG K AH R
CHANCRES	CH AE NG K AH R Z
CHANDELIERED	SH AE N D AH L IH ER D
CHANTERELLE	CH AE N T AH R AH L
CHANTERELLES	CH AE N T AH R AH L Z
CHAPAREJOS	CH AH P AE R AH JH AH Z
CHAPTERED	CH AE P T ER D
CHARACTERED	K AE R IH K T ER D
CHARE	CH AE R
CHARED	CH AA R D
CHARES	CH AE R Z
CHARRED	CH AA R D
CHARTERED	CH AA R T ER D
CHARTERER	CH AA R T ER ER
CHARTERERS	CH AA R T ER ER Z
CHARTREUSE	SH AA R T R UW Z
CHARTREUSE(2)	SH AA R T R UW S
CHARTREUSES	CH AA R T R IY Y UW S IH Z
CHATTERED	CH AE T ER D
CHATTERER	CH AE T ER ER
CHATTERERS	CH AE T ER ER Z
CHAUFFEURED	SH OW F ER D
CHAUSSURE	CH AO SH Y AH R
CHAUSSURES	CH AO SH Y AH R Z
CHECKERED	CH EH K ER D
CHECKREIN	CH EH K R EY N
CHECKREINS	CH EH K R EY N Z
CHEERED	CH IH R D
CHEERER	CH IH ER ER
CHEERERS	CH IH ER ER Z
CHEMORECEPTION	K AH M AO R AH S EH P AH N
CHEMORECEPTIONS	K EH M AH R AH S EH P T IY AH N Z
CHEMORECEPTIVE	K AH M AO R AH S EH P T AH V
CHEMORECEPTOR	K AH M AO R AH S EH P T AH R
CHEMORECEPTORS	K EH M AH R AH S EH P T AH R Z
CHEQUERED	CH EH K W IY R D
CHEVELURE	CH AH V EH L Y AH R
CHEVELURES	CH AH V EH L Y AH R Z
CHEVRE	CH EH V AH R
CHEVRES	CH EH V AH R Z
CHICKAREE	CH IH K ER IY
CHICKAREES	CH IH K ER IY Z
CHILDREN	CH IH L D R AH N
CHIMERE	CH IH M AH R
CHIMERES	CH AH M IY R Z
CHINAWARE	CH IH N AH W EH R
CHINAWARES	CH IH N AH W EH R Z
CHIPPERED	CH IH P ER D
CHIRRE	CH AH R
CHIRRED	CH AH R D
CHIRRES	CH AH R Z
CHITTERED	CH IH T IY R D
CHIVAREE	CH AY V ER IY
CHIVAREED	CH IH V AH R IY D
CHIVAREEING	CH AY V ER IY IH NG
CHIVAREES	CH AY V ER IY Z
CHLAMYDOSPORE	K L AE M AH D AA S AH R
CHLAMYDOSPORES	K L AE M AH D AA S AH R Z
CHLORELLA	K L AH R EH L AH
CHLORELLAS	K L AH R EH L AH Z
CHLORENCHYMA	K L AH R EH NG K AH M AH
CHLORENCHYMAS	K L AH R EH NG K AH M AH Z
CHLORENCHYMATA	K L AO R AH NG K IH M AH T AH
CHLOROPRENE	K L AO R AH P R IY N
CHLOROPRENES	K L AO R AH P R IY N Z
CHOIRED	K W AY ER D
CHOPPERED	CH AA P ER D
CHORE	CH AO R
CHOREA	CH AO R IY AH
CHOREAL	CH OW R AH L
CHOREAS	CH AH R IY Z
CHORED	CH OW R D
CHOREGI	CH AO R AH JH IY
CHOREGUS	CH AO R AH G AH S
CHOREGUSES	CH AO R AH G Y UW Z AH Z
CHOREIC	CH OW R IH K
CHOREIFORM	CH AH R IY F AH R M
CHOREMAN	CH OW R M AE N
CHOREMEN	CH OW R M EH N
CHOREOGRAPH	K AO R IY AH G R AE F
CHOREOGRAPHED	K AO R IY AH G R AE F T
CHOREOGRAPHER	K AO R IY AA G R AH F ER
CHOREOGRAPHERS	K AO R IY AA G R AH F ER Z
CHOREOGRAPHIC	K AO R IY AH G R AE F IH K
CHOREOGRAPHICALLY	K OW R IY AH G R AE F IH K AH L IY
CHOREOGRAPHIES	K OW R IY AA G R AH F IY Z
CHOREOGRAPHING	K AO R IY AA G R AH F IH NG
CHOREOGRAPHING(2)	K AO R IY AH G R AE F IH NG
CHOREOGRAPHS	K OW R IY AH G R AE F S
CHOREOGRAPHY	K AO R IY AA G R AH F IY
CHOREOID	CH AO R IY OY D
CHORES	CH AO R Z
CHOWDERED	CH AW D ER D
CHRESARD	K R EH S AH R D
CHRESARDS	K R EH S AH R D Z
CHRESTOMATHIES	K R EH S T AA M AH TH AY Z
CHRESTOMATHY	K R EH S T AA M AH TH IY
CHROMATOPHORE	K R AH M AE T AH F AH R
CHROMATOPHORES	K R AH M AE T AH F AH R Z
CHROMOMERE	K R AH M OW M AH R
CHROMOMERES	K R AA M AH M IY R Z
CHROMOPHORE	K R AA M AH F AH R
CHROMOPHORES	K R AA M AH F AH R Z
CHROMOSPHERE	K R AH M AA S AH R
CHROMOSPHERES	K R AA M AH S IY R Z
CHUNTERED	CH AH N T IY R D
CHURRED	CH AH R D
CHURRIGUERESQUE	CH AH R AH G W AH R EH S
CICOREE	S IH K AH R IY IY
CICOREES	S IH K AH R IY Z
CIGARET	S IH G AH R EH T
CIGARETS	S IH G AH R EH T S
CIGARETTE	S IH G AH R EH T
CIGARETTES	S IH G AH R EH T S
CINCTURE	S IH NG K T Y AH R
CINCTURED	S IH NG K T Y AH R D
CINCTURES	S IH NG K T Y AH R Z
CINDERED	S IH N D ER D
CINEREOUS	S AH N IY R IY AH S
CIPHERED	S AY F ER D
CIRCUMFERENCE	S ER K AH M F R AH N S
CIRCUMFERENCES	S ER K AH M F R AH N S IH Z
CIRCUMFERENTIAL	S ER K AH M F ER AH N T IY AH L
CIRE	S AY R
CIRES	S AY R Z
CITHREN	S IH TH R AH N
CITHRENS	S IH TH R AH N Z
CITREOUS	S IH T R IY AH S
CITRICULTURE	S IH T R AH K AH L T Y AH R
CITRICULTURES	S IH T R AH K AH L T Y AH R Z
CLABBERED	K L AE B IY R D
CLAMBERED	K L AE M B ER D
CLAMBERER	K L AE M B ER ER
CLAMBERERS	K L AE M B ER ER Z
CLAMORED	K L AE M ER D
CLAMORER	K L AE M ER ER
CLAMORERS	K L AE M ER ER Z
CLAMOURED	K L AH M OW Y AH R D
CLANGORED	K L AE NG ER D
CLANGOURED	K L AE N G OW Y ER D
CLARENCE	K L EH R AH N S
CLARENCES	K L AE R AH N S IH Z
CLARET	K L AE R AH T
CLARETS	K L AE R AH T S
CLATTERED	K L AE T ER D
CLATTERER	K L AE T ER ER
CLATTERERS	K L AE T ER ER Z
CLAVERED	K L AH V IY R D
CLAYMORE	K L EY M AO R
CLAYMORES	K L EY M AO R EY Z
CLAYWARE	K L EY W EH R
CLAYWARES	K L EY W EH R Z
CLEARED	K L IH R D
CLEARER	K L IH R ER
CLEARERS	K L IH ER ER Z
CLEAREST	K L IH R IH S T
CLERESTORIES	K L AH R EH S T AH R AY Z
CLERESTORY	K L IY R AH S T AO R IY
CLEVERER	K L EH V ER ER
CLEVEREST	K L EH V ER AH S T
CLINKERED	K L IH NG K ER D
CLITORECTOMIES	K L IH T AH R EH K T AH M AY Z
CLITORECTOMY	K L IH T AH R EH K T AH M IY
CLOBBERED	K L AA B ER D
CLOISTERED	K L OY S T ER D
CLOISTRESS	K L OY S T R AH S
CLOISTRESSES	K L OY S T R EH S AH Z
CLOSURE	K L OW ZH ER
CLOSURED	K L OW ZH ER D
CLOSURES	K L OW ZH ER Z
CLOTHESPRESS	K L OW DH Z P R EH S
CLOTHESPRESSES	K L OW DH Z P R EH S IH Z
CLOTURE	K L OW CH ER
CLOTURED	K L OW CH ER D
CLOTURES	K L OW CH ER Z
CLOURED	K L OW Y AH R D
CLUSTERED	K L AH S T ER D
CLUTTERED	K L AH T ER D
COADMIRE	K OW AH D M AY ER
COADMIRED	K OW AH D M AY ER D
COADMIRES	K OW AH D M AY ER Z
COANCHORED	K OW AE NG K ER D
COAPPEARED	K OW AH P IH ER D
COATDRESS	K OW T D R EH S
COATDRESSES	K OW T D R EH S IH Z
COAUTHORED	K OW AA TH ER D
COBELLIGERENT	K OW B AH L IH JH ER AH N T
COBELLIGERENTS	K OW B AH L IH JH ER AH N T S
COCHAIRED	K OW CH EH ER D
COCKERED	K AA K ER D
COCKEREL	K AA K EH R AH L
COCKERELS	K AA K EH R AH L Z
COCKSURE	K AA K SH UH R
COCKSURELY	K AA K SH UH R L IY
COCKSURENESS	K AA K SH UH R N AH S
COCKSURENESSES	K AA K SH UH R N AH S IH Z
COCREATE	K OW K R IY EY T
COCREATED	K OW K R IY EY T IH D
COCREATES	K OW K R IY EY T S
COCREATING	K OW K R IY EY T IH NG
COCREATOR	K OW K R IY EY T ER
COCREATORS	K OW K R IY EY T ER Z
COCULTURE	K OW K AH L CH ER
COCULTURED	K OW K AH L CH ER D
COCULTURES	K OW K AH L CH ER Z
CODIRECT	K OW D AH R EH K T
CODIRECTED	K OW D AH R EH K T IH D
CODIRECTING	K OW D AH R EH K T IH NG
CODIRECTION	K OW D AH R EH K SH AH N
CODIRECTIONS	K OW D AH R EH K SH AH N Z
CODIRECTOR	K OW D AH R EH K T ER
CODIRECTORS	K OW D AH R EH K T ER Z
CODIRECTS	K OW D AH R EH K T S
CODISCOVERED	K OW D IH S K AH V ER D
CODISCOVERER	K OW D IH S K OW V EH R ER
CODISCOVERERS	K OW D IH S K OW V EH R ER Z
COENAMORED	K OW AH N AE M AH R D
COENDURE	K OW EH N D Y UH R
COENDURED	K OW EH N D Y UH R D
COENDURES	K OW EH N D Y UH R Z
COENURE	K OW EH N Y AH R
COENURES	K OW EH N Y AH R Z
COERECT	K OW IH R EH K T
COERECTED	K OW IH R EH K T IH D
COERECTING	K OW IH R EH K T IH NG
COERECTS	K OW IH R EH K T S
COFEATURE	K OW F IY CH ER
COFEATURED	K OW F IY CH ER D
COFEATURES	K OW F IY CH ER Z
COFFERED	K AO F ER D
COFFRET	K AA F R EH T
COFFRETS	K AA F R EH T S
COHEIRESS	K OW EH R AH S
COHEIRESSES	K OW EH R AH S IH Z
COHERE	K OW HH IH R
COHERED	K OW HH IH R D
COHERENCE	K OW HH IH R AH N S
COHERENCES	K OW HH IH ER AH N S IH Z
COHERENCIES	K OW HH IH ER AH N S IY Z
COHERENCY	K OW HH IH ER AH N S IY
COHERENT	K OW HH IH R AH N T
COHERENTLY	K OW HH IY R AH N T L IY
COHERER	K OW HH IH ER ER
COHERERS	K OW HH IH ER ER Z
COHERES	K OW HH IH R Z
COIFFURE	K W AA F Y UH R
COIFFURED	K W AA F Y UH R D
COIFFURES	K W AA F Y UH R Z
COINFERRED	K OW IH N F ER D
COINHERE	K OW IH N HH IH ER
COINHERED	K OW IH N HH IH ER D
COINHERES	K OW IH N HH IH ER Z
COINSURE	K OW IH N SH UH R
COINSURED	K OW IH N SH UH R D
COINSURER	K OW IH N SH UH R ER
COINSURERS	K OW IH N SH UH R ER Z
COINSURES	K OW IH N SH UH R Z
COINTERRED	K OW IH N T ER R EH D
COISTREL	K OW IH S T R AH L
COISTRELS	K OW IH S T R AH L Z
COLLARED	K AA L ER D
COLLARET	K AA L AE R AH T
COLLARETS	K AA L AE R AH T S
COLORBRED	K AH L ER B R EH D
COLORECTAL	K OW L OW R EH K T AH L
COLORED	K AH L ER D
COLOREDS	K AA L ER AH D Z
COLORER	K AH L ER ER
COLORERS	K AH L ER ER Z
COLOURED	K AH L ER D
COLOURER	K AH L ER ER
COLOURERS	K AH L ER ER Z
COLURE	K OW L UH R
COLURES	K OW L UH R Z
COMFREY	K AH M F R IY
COMFREYS	K AA M F R EY Z
COMMANDEERED	K AA M AH N D IH R D
COMMISSIONAIRE	K AH M IH SH AH N AH AY ER
COMMISSIONAIRES	K AH M IH SH AH N AH AY ER Z
COMMISSURE	K AH M IH SH ER
COMMISSURES	K AH M IH SH ER Z
COMMIXTURE	K AH M IH K S CH ER
COMMIXTURES	K AH M IH K S CH ER Z
COMMODORE	K AA M AH D AO R
COMMODORES	K AA M AH D OW R Z
COMPADRE	K AA M P EY D AH R
COMPADRES	K AA M P EY D AH R Z
COMPARE	K AH M P EH R
COMPARED	K AH M P EH R D
COMPARER	K AH M P EH R ER
COMPARERS	K AH M P EH R ER Z
COMPARES	K AH M P EH R Z
COMPEERED	K AH M P IH ER D
COMPERE	K AA M P AH R
COMPERED	K AA M P IY R D
COMPERES	K AA M P IY R Z
COMPOSURE	K AH M P OW ZH ER
COMPOSURES	K AH M P OW ZH ER Z
COMPRADORE	K AA M P R AE D AH R
COMPRADORES	K AA M P R AE D AH R Z
COMPREHEND	K AA M P R IY HH EH N D
COMPREHENDED	K AA M P R IH HH EH N D IH D
COMPREHENDIBLE	K AA M P R IH HH EH N D AH B AH L
COMPREHENDING	K AA M P R IH HH EH N D IH NG
COMPREHENDS	K AA M P R IY HH EH N D Z
COMPREHENSIBILITIES	K AA M P R IH HH EH N S AH B IH L AH T IY Z
COMPREHENSIBILITY	K AA M P R IY HH EH N S AH B IH L AH T IY
COMPREHENSIBLE	K AA M P R IY HH EH N S AH B AH L
COMPREHENSIBLENESS	K AA M P R IH HH EH N S AH B AH L N AH S
COMPREHENSIBLENESSES	K AA M P R IH HH EH N S AH B AH L N AH S IH Z
COMPREHENSIBLY	K AA M P R IH HH EH N S AH B L IY
COMPREHENSION	K AA M P R IY HH EH N SH AH N
COMPREHENSIONS	K AA M P R IH HH EH N CH AH N Z
COMPREHENSIVE	K AA M P R IY HH EH N S IH V
COMPREHENSIVELY	K AA M P R IH HH EH N S IH V L IY
COMPREHENSIVENESS	K AA M P R IH HH EH N S IH V N AH S
COMPREHENSIVENESSES	K AA M P R IH HH EH N S IH V N AH S IH Z
COMPRESS	K AA M P R EH S
COMPRESS(2)	K AH M P R EH S
COMPRESSED	K AH M P R EH S T
COMPRESSEDLY	K AH M P R EH S AH D L IY
COMPRESSES	K AA M P R EH S AH Z
COMPRESSES(2)	K AH M P R EH S AH Z
COMPRESSES(3)	K AH M P R EH S IH Z
COMPRESSIBILITIES	K AH M P R EH S AH B IH L AH T IY Z
COMPRESSIBILITY	K AH M P R EH S AH B IH L AH T IY
COMPRESSIBLE	K AH M P R EH S AH B AH L
COMPRESSING	K AH M P R EH S IH NG
COMPRESSION	K AH M P R EH SH AH N
COMPRESSIONAL	K AH M P R EH SH AH N AH L
COMPRESSIONS	K AH M P R EH SH AH N Z
COMPRESSIVE	K AH M P R EH S IH V
COMPRESSIVELY	K AH M P R EH S IH V L IY
COMPRESSOR	K AH M P R EH S ER
COMPRESSORS	K AH M P R EH S ER Z
COMPUTERESE	K AA M P Y UW T AH R IY Z
COMPUTERESES	K AA M P Y UW T AH R IY Z AH Z
CONCENTERED	K AH N S EH N T ER D
CONCESSIONAIRE	K AH N S EH SH AH N EH R
CONCESSIONAIRES	K AH N S EH SH AH N EH R Z
CONCRESCENCE	K AH N K R EH S AH N S
CONCRESCENCES	K AH N K R EH S AH N S IH Z
CONCRESCENT	K AH N K R EH S AH N T
CONCRETE	K AH N K R IY T
CONCRETE(2)	K AA N K R IY T
CONCRETED	K AA N K R IY T IH D
CONCRETELY	K AA N K R IY T L IY
CONCRETENESS	K AA N K R IY T N AH S
CONCRETENESSES	K AA N K R IY T N AH S IH Z
CONCRETES	K AA N K R IY T S
CONCRETING	K AA N K R IY T IH NG
CONCRETION	K AA N K R IY SH AH N
CONCRETIONARY	K AA N K R IY SH AH N EH R IY
CONCRETIONS	K AA N K R IY SH AH N Z
CONCRETISM	K AA N K R IY T IH Z AH M
CONCRETISMS	K AA N K R IY T IH Z AH M Z
CONCRETIST	K AA N K R IY T IH S T
CONCRETISTS	K AA N K R IY T IH S T S
CONCRETIZATION	K AA N K R IY T AH Z EY SH AH N
CONCRETIZATIONS	K AA N K R IY T AH Z EY SH AH N Z
CONCRETIZE	K AA N K R IY T AY Z
CONCRETIZED	K AA N K R IY T AY Z D
CONCRETIZES	K AA N K R IY T AY Z IH Z
CONCRETIZING	K AA N K R IY T AY Z IH NG
CONCURRED	K AH N K ER D
CONCURRENCE	K AH N K ER AH N S
CONCURRENCES	K AH N K ER AH N S IH Z
CONCURRENCIES	K AH N K ER AH N S IY Z
CONCURRENCY	K AH N K ER AH N S IY
CONCURRENT	K AH N K ER AH N T
CONCURRENTLY	K AH N K ER AH N T L IY
CONCURRENTS	K AH N K ER AH N T S
CONDORES	K AA N D AO R Z
CONDOTTIERE	K AA N D AA T IY R
CONDUCTRESS	K AA N D AH K T R AH S
CONDUCTRESSES	K AA N D AH K T R EH S AH Z
CONFEREE	K AA N F ER IY
CONFEREES	K AA N F ER IY Z
CONFERENCE	K AA N F ER AH N S
CONFERENCE(2)	K AA N F R AH N S
CONFERENCES	K AA N F ER AH N S AH Z
CONFERENCES(2)	K AA N F R AH N S AH Z
CONFERENCING	K AA N F R AH N S IH NG
CONFERENCINGS	K AA N F AH R AH N S IH NG Z
CONFERENTIAL	K AH N F ER AH N T IY AH L
CONFERRED	K AH N F ER D
CONFERRENCE	K AH N F ER AH N S
CONFERRENCES	K AH N F ER AH N S IH Z
CONFERRER	K AH N F ER ER
CONFERRERS	K AH N F ER ER Z
CONFIGURE	K AH N F IH G Y ER
CONFIGURED	K AH N F IH G Y ER D
CONFIGURES	K AH N F IH G Y ER Z
CONFITURE	K AH N F IH CH ER
CONFITURES	K AH N F IH CH ER Z
CONFRERE	K AA N F R EH R
CONFRERES	K AA N F R EH R Z
CONGREGANT	K AA NG G R AH G AH N T
CONGREGANTS	K AA NG G R AH G AH N T S
CONGREGATE	K AA NG G R AH G EY T
CONGREGATED	K AA NG G R IH G EY T IH D
CONGREGATES	K AA NG G R IH G EY T S
CONGREGATING	K AA NG G R IH G EY T IH NG
CONGREGATION	K AA NG G R AH G EY SH AH N
CONGREGATIONAL	K AA NG G R AH G EY SH AH N AH L
CONGREGATIONALISM	K AA NG G R IH G EY SH AH N AH L IH Z AH M
CONGREGATIONALISMS	K AA NG G R IH G EY SH AH N AH L IH Z AH M Z
CONGREGATIONALIST	K AA NG G R IH G EY SH AH N AH L IH S T
CONGREGATIONALISTS	K AA NG G R IH G EY SH AH N AH L IH S T S
CONGREGATIONS	K AA NG G R AH G EY SH AH N Z
CONGREGATOR	K AA NG G R IH G EY T ER
CONGREGATORS	K AA NG G R IH G EY T ER Z
CONGRESS	K AA NG G R AH S
CONGRESSED	K AA NG G R AH S T
CONGRESSES	K AA NG G R AH S IH Z
CONGRESSING	K AA NG G R AH S IH NG
CONGRESSIONAL	K AH N G R EH SH AH N AH L
CONGRESSIONALLY	K AH N G R EH SH AH N AH L IY
CONGRESSIONALLY(2)	K AH N G R EH SH N AH L IY
CONGRESSMAN	K AA NG G R AH S M AH N
CONGRESSMEN	K AA NG G R AH S M IH N
CONGRESSPEOPLE	K AA NG G R AH S P IY P AH L
CONGRESSPERSON	K AA NG G R AH S P ER S AH N
CONGRESSPERSONS	K AA NG G R AH S P ER S AH N Z
CONGRESSWOMAN	K AA NG G R AH S W UH M AH N
CONGRESSWOMEN	K AA NG G R AH S W IH M IH N
CONIDIOPHORE	K AH N AH D IY AH F AH R
CONIDIOPHORES	K AH N AH D IY AH F AH R Z
CONJECTURE	K AH N JH EH K CH ER
CONJECTURE(2)	K AH N JH EH K SH ER
CONJECTURED	K AH N JH EH K CH ER D
CONJECTURER	K AH N JH EH K CH ER ER
CONJECTURERS	K AH N JH EH K CH ER ER Z
CONJECTURES	K AH N JH EH K CH ER Z
CONJECTURES(2)	K AH N JH EH K SH ER Z
CONJUNCTURE	K AH N JH AH NG K CH ER
CONJUNCTURES	K AH N JH AH NG K CH ER Z
CONJURE	K AA N JH ER
CONJURED	K AA N JH ER D
CONJURER	K AH N JH UH R ER
CONJURERS	K AH N JH UH R ER Z
CONJURES	K AA N JH ER Z
CONQUERED	K AA NG K ER D
CONQUISTADORES	K AA N K W IH S T AH D AH R Z
CONSERVATOIRE	K AA N S AH R V AH T OY R
CONSERVATOIRES	K AA N S AH R V AH T OY R Z
CONSIDERED	K AH N S IH D ER D
CONSIGLIERE	K AA N S IH G L IY R
CONSPIRE	K AH N S P AY ER
CONSPIRED	K AH N S P AY ER D
CONSPIRES	K AH N S P AY ER Z
CONTEXTURE	K AA N T EH K S CH ER
CONTEXTURES	K AA N T EH K S CH ER Z
CONTOURED	K AA N T UH R D
CONTRACTURE	K AA N T R AE K CH ER
CONTRACTURES	K AA N T R AE K CH ER Z
CONTREDANSE	K AA N T R EH D AH N S
CONTREDANSES	K AA N T R AH D AE N S AH Z
CONTRETEMPS	K AA N T R AH T EH M P S
COOKWARE	K UH K W EH R
COOKWARES	K UH K W EH R Z
COOPERED	K UW P ER D
COPARENT	K OW P AE R AH N T
COPARENTS	K OW P AE R AH N T S
COPARTNERED	K OW P AA R T N ER D
COPPERED	K AA P ER D
COPREMIA	K AA P R AH M AY AH
COPREMIAS	K AA P R AH M AY AH Z
COPREMIC	K AA P R IY M AH K
COPRESENT	K OW P R EH Z AH N T
COPRESENTED	K OW P R EH Z AH N T IH D
COPRESENTING	K OW P R EH Z AH N T IH NG
COPRESENTS	K OW P R EH Z AH N T S
COPRESIDENT	K OW P R EH Z AH D AH N T
COPRESIDENTS	K OW P R EH Z AH D AH N T S
COPYREAD	K AA P IY R IY D
COPYREADER	K AA P IY R IY D ER
COPYREADERS	K AA P IY R IY D ER Z
COPYREADING	K OW P AY ER EY D IH NG
COPYREADS	K AA P IY R IY D Z
CORE	K AO R
CORECIPIENT	K OW R IH S IH P IY AH N T
CORECIPIENTS	K OW R IH S IH P IY AH N T S
CORED	K OW R EH D
COREDEEM	K OW R IY D IY M
COREDEEMED	K OW R IY D IY M D
COREDEEMING	K OW R IY D IY M IH NG
COREDEEMS	K OW R IY D IY M Z
COREIGN	K OW R EY N
COREIGNS	K OW R EY N Z
CORELATE	K OW R IH L EY T
CORELATED	K OW R IH L EY T IH D
CORELATES	K OW R IH L EY T S
CORELATING	K OW R IH L EY T IH NG
CORELESS	K OW R L AH S
CORELIGIONIST	K OW R IH L IH JH AH N IH S T
CORELIGIONISTS	K OW R IH L IH JH AH N IH S T S
COREMIA	K OW R AH M AY AH
COREMIUM	K OW R AH M IY AH M
COREOPSIS	K OW R IY AA P S AH S
COREPRESSOR	K OW R IY P R EH S ER
COREPRESSORS	K OW R IY P R EH S ER Z
COREQUISITE	K OW R EH K W AH Z AH T
COREQUISITES	K OW R EH K W AH Z AH T S
CORER	K OW R ER
CORERS	K OW R ER Z
CORES	K AO R Z
CORESEARCHER	K OW R IY S ER CH ER
CORESEARCHERS	K OW R IY S ER CH ER Z
CORESIDENT	K OW R EH Z AH D AH N T
CORESIDENTIAL	K OW R EH Z AH D EH N CH AH L
CORESIDENTS	K OW R EH Z AH D AH N T S
CORESPONDENT	K AO R AH S P AA N D AH N T
CORESPONDENTS	K OW R IH S P AA N D AH N T S
CORKSCREW	K AO R K S K R UW
CORKSCREWED	K AO R K S K R UW D
CORKSCREWING	K AO R K S K R UW IH NG
CORKSCREWS	K AO R K S K R UW Z
CORNBREAD	K AO R N B R EH D
CORNBREADS	K AO R N B R EH D Z
CORNERED	K AO R N ER D
CORPOREAL	K AO R P OW R IY AH L
CORPOREALITIES	K AO R P OW R IY AE L AH T IY Z
CORPOREALITY	K AO R P OW R IY AE L AH T IY
CORPOREALLY	K AO R P OW R IY AH L IY
CORPOREALNESS	K AO R P OW R IY AH L N AH S
CORPOREALNESSES	K AO R P OW R IY AH L N AH S IH Z
CORPOREITIES	K AA R P AH R AH T AY Z
CORPOREITY	K AA R P AH R IY AH T IY
CORRECT	K ER EH K T
CORRECTABLE	K AH R EH K T AH B AH L
CORRECTED	K ER EH K T AH D
CORRECTED(2)	K ER EH K T IH D
CORRECTER	K AH R EH K T ER
CORRECTEST	K AH R EH K T AH S T
CORRECTING	K ER EH K T IH NG
CORRECTION	K ER EH K SH AH N
CORRECTIONAL	K ER EH K SH AH N AH L
CORRECTIONS	K ER EH K SH AH N Z
CORRECTITUDE	K AH R EH K T AH T UW D
CORRECTITUDES	K AH R EH K T AH T UW D Z
CORRECTIVE	K ER EH K T IH V
CORRECTIVELY	K AH R EH K T IH V L IY
CORRECTIVES	K AH R EH K T IH V Z
CORRECTLY	K ER EH K T L IY
CORRECTNESS	K ER EH K T N AH S
CORRECTNESSES	K AH R EH K T N AH S IH Z
CORRECTOR	K AH R EH K T ER
CORRECTORS	K AH R EH K T ER Z
CORRECTS	K ER EH K T S
CORRELATABLE	K AO R AH L EY T AH B AH L
CORRELATE	K AO R AH L EY T
CORRELATE(2)	K AO R AH L AH T
CORRELATED	K AO R AH L EY T AH D
CORRELATES	K AO R AH L AH T S
CORRELATES(2)	K AO R AH L EY T S
CORRELATING	K AO R AH L EY T IH NG
CORRELATION	K AO R AH L EY SH AH N
CORRELATIONAL	K AO R AH L EY SH AH N AH L
CORRELATIONS	K AO R AH L EY SH AH N Z
CORRELATIVE	K AH R EH L AH T IH V
CORRELATIVELY	K AH R EH L AH T IH V L IY
CORRELATIVES	K AH R EH L AH T IH V Z
CORRELATOR	K AO R AH L EY T ER
CORRELATORS	K AO R AH L EY T ER Z
CORRESPOND	K AO R AH S P AA N D
CORRESPONDED	K AO R AH S P AA N D IH D
CORRESPONDENCE	K AO R AH S P AA N D AH N S
CORRESPONDENCES	K AO R AH S P AA N D AH N S IH Z
CORRESPONDENCIES	K AO R AH S P AA N D AH N S IY Z
CORRESPONDENCY	K AO R AH S P AA N D AH N S IY
CORRESPONDENT	K AO R AH S P AA N D AH N T
CORRESPONDENTS	K AO R AH S P AA N D AH N T S
CORRESPONDING	K AO R AH S P AA N D IH NG
CORRESPONDINGLY	K AO R AH S P AA N D IH NG L IY
CORRESPONDS	K AO R AH S P AA N D Z
CORRESPONSIVE	K AA R EH S AA N Z AH V
CORROBOREE	K AH R AA B AH R IY
CORROBOREES	K AH R AA B AH R IY Z
CORSETIERE	K AA R S AH T IY R
CORSETIERES	K AA R S AH T IY R Z
COSHERED	K OW SH IY R D
COSPONSORED	K OW S P AA N S ER D
COSTARRED	K OW S T AA R D
COSTREL	K AA S T R EH L
COSTRELS	K AA S T R EH L Z
COTRANSFERRED	K OW T R AE N S F ER D
COTTERED	K AA T ER D
COUNTERAGGRESSION	K AW N T ER AH G R EH SH AH N
COUNTERAGGRESSIONS	K AW N T ER AH G R EH SH AH N Z
COUNTERCOUNTERMEASURE	K AW N T ER K AW N T ER M EH ZH ER
COUNTERCOUNTERMEASURES	K AW N T ER K AW N T ER M EH ZH ER Z
COUNTERCULTURE	K AW N T ER K AH L CH ER
COUNTERCULTURE(2)	K AW N ER K AH L CH ER
COUNTERCULTURES	K AW N T ER K AH L CH ER Z
COUNTERCURRENT	K AW N T ER K ER AH N T
COUNTERCURRENTLY	K AW N T ER K ER AH N T L IY
COUNTERCURRENTS	K AW N T ER K ER AH N T S
COUNTERED	K AW N T ER D
COUNTERED(2)	K AW N ER D
COUNTEREDUCATIONAL	K AW N T ER EH JH AH K EY SH AH N AH L
COUNTEREFFORT	K AW N T ER EH F ER T
COUNTEREFFORTS	K AW N T ER EH F ER T S
COUNTERESPIONAGE	K AW N T ER EH S P IY AH N AA JH
COUNTERESPIONAGE(2)	K AW N ER EH S P Y AH N AA JH
COUNTERESPIONAGES	K AW N T ER EH S P IY AH N AA ZH IH Z
COUNTEREVIDENCE	K AW N T ER EH V AH D AH N S
COUNTEREVIDENCES	K AW N T ER EH V AH D AH N S IH Z
COUNTEREXAMPLE	K AW N T ER IH G Z AE M P AH L
COUNTEREXAMPLES	K AW N T ER IH G Z AE M P AH L Z
COUNTERFIRE	K AW N T ER F AY ER
COUNTERFIRED	K AW N T ER F AY ER D
COUNTERFIRES	K AW N T ER F AY ER Z
COUNTERINTERPRETATION	K AW N T ER IH N T ER P R AH T EY SH AH N
COUNTERINTERPRETATIONS	K AW N T ER IH N T ER P R AH T EY SH AH N Z
COUNTERMEASURE	K AW N T ER M EH ZH ER
COUNTERMEASURES	K AW N T ER M EH ZH ER Z
COUNTERORDERED	K AW N T ER AO R D ER D
COUNTERPRESSURE	K AW N T ER P R EH SH ER
COUNTERPRESSURES	K AW N T ER P R EH SH ER Z
COUNTERREACTION	K AW N T ER R IY AE K SH AH N
COUNTERREACTIONS	K AW N T ER R IY AE K SH AH N Z
COUNTERREFORM	K AW N T ER R IY F AO R M
COUNTERREFORMATION	K AW N T ER R EH F ER M EY SH AH N
COUNTERREFORMATIONS	K AW N T ER R EH F ER M EY SH AH N Z
COUNTERREFORMER	K AW N T ER R IY F AO R M ER
COUNTERREFORMERS	K AW N T ER R IY F AO R M ER Z
COUNTERREFORMS	K AW N T ER R IY F AO R M Z
COUNTERRESPONSE	K AW N T ER R IH S P AA N S
COUNTERRESPONSES	K AW N T ER R IH S P AA N S IH Z
COUNTERRETALIATION	K AW N T ER R IH T AE L IY EY SH AH N
COUNTERRETALIATIONS	K AW N T ER R IH T AE L IY EY SH AH N Z
COUNTERREVOLUTION	K AW N T ER R EH V AH L UW SH AH N
COUNTERREVOLUTIONARIES	K AW N T ER R EH V AH L UW SH AH N EH R IY Z
COUNTERREVOLUTIONARY	K AW N T ER R EH V AH L UW SH AH N EH R IY
COUNTERREVOLUTIONS	K AW N T ER R EH V AH L UW SH AH N Z
COUNTERSIGNATURE	K AW N T ER S IH G N AH CH UH R
COUNTERSIGNATURES	K AW N T ER S IH G N AH CH UH R Z
COUNTERSTREAM	K AW N T ER S T R IY M
COUNTERSTREAMS	K AW N T ER S T R IY M Z
COUNTERTHREAT	K AW N T ER TH R EH T
COUNTERTHREATS	K AW N T ER TH R EH T S
COUNTERTRANSFERENCE	K AW N T ER T R AE N S F ER AH N S
COUNTERTRANSFERENCES	K AW N T ER T R AE N S F ER AH N S IH Z
COUNTERTREND	K AW N T ER T R EH N D
COUNTERTRENDS	K AW N T ER T R EH N D Z
COURSEWARE	K OW R S W EH R
COURSEWARES	K OW R S W EH R Z
COUTURE	K UW T UH R
COUTURES	K OW Y UW T Y AH R Z
COUTURIERE	K OW Y UW T Y AH R IY R
COUTURIERES	K OW Y UW T Y AH R IY R Z
COVERED	K AH V ER D
COVERER	K OW V EH R ER
COVERERS	K OW V EH R ER Z
COVERTURE	K AH V ER CH ER
COVERTURES	K AH V ER CH ER Z
COWERED	K AW ER D
CRACKLEWARE	K R AE K AH L W EH R
CRACKLEWARES	K R AE K AH L W EH R Z
CRANIOCEREBRAL	K R EY N IY AA S AH R EH B R AH L
CRANREUCH	K R AE N R UW CH
CRANREUCHS	K R AE N R UW CH S
CRATERED	K R EY T ER D
CREAK	K R IY K
CREAKED	K R IY K T
CREAKIER	K R IY K IY ER
CREAKIEST	K R IY K IY AH S T
CREAKILY	K R IY K IY L IY
CREAKINESS	K R IY K IY N AH S
CREAKINESSES	K R IY K IY N AH S IH Z
CREAKING	K R IY K IH NG
CREAKS	K R IY K S
CREAKY	K R IY K IY
CREAM	K R IY M
CREAMCUPS	K R IY M K AH P S
CREAMED	K R IY M D
CREAMER	K R IY M ER
CREAMERIES	K R IY M AH R IY Z
CREAMERS	K R IY M ER Z
CREAMERY	K R IY M ER IY
CREAMIER	K R IY M IY ER
CREAMIEST	K R IY M IY IH S T
CREAMILY	K R IY M IY L IY
CREAMINESS	K R IY M IY N AH S
CREAMINESSES	K R IY M IY N AH S IH Z
CREAMING	K R IY M IH NG
CREAMPUFF	K R IY M P AH F
CREAMPUFFS	K R IY M P AH F S
CREAMS	K R IY M Z
CREAMWARE	K R IY M W EH R
CREAMWARES	K R IY M W EH R Z
CREAMY	K R IY M IY
CREASE	K R IY S
CREASED	K R IY S T
CREASELESS	K R IY S L AH S
CREASER	K R IY S ER
CREASERS	K R IY S ER Z
CREASES	K R IY S IH Z
CREASIER	K R IY S IY ER
CREASIEST	K R IY S IY AH S T
CREASING	K R IY S IH NG
CREASY	K R IY S IY
CREATE	K R IY EY T
CREATED	K R IY EY T AH D
CREATED(2)	K R IY EY T IH D
CREATES	K R IY EY T S
CREATIN	K R IY T AH N
CREATINE	K R IY T AY N
CREATINES	K R IY T AY N Z
CREATING	K R IY EY T IH NG
CREATININE	K R IY T AH N AY N
CREATININES	K R IY T AH N AY N Z
CREATINS	K R IY T AH N Z
CREATION	K R IY EY SH AH N
CREATIONISM	K R IY EY SH AH N IH Z AH M
CREATIONISMS	K R IY EY SH AH N IH Z AH M Z
CREATIONIST	K R IY EY SH AH N IH S T
CREATIONISTS	K R IY EY SH AH N IH S T S
CREATIONS	K R IY EY SH AH N Z
CREATIVE	K R IY EY T IH V
CREATIVELY	K R IY EY T IH V L IY
CREATIVENESS	K R IY EY T IH V N AH S
CREATIVENESSES	K R IY EY T IH V N AH S IH Z
CREATIVITIES	K R IY EY T IH V AH T IY Z
CREATIVITY	K R IY EY T IH V AH T IY
CREATOR	K R IY EY T ER
CREATORS	K R IY EY T ER Z
CREATURAL	K R IY CH ER AH L
CREATURE	K R IY CH ER
CREATUREHOOD	K R IY CH ER HH UH D
CREATUREHOODS	K R IY CH ER HH UH D Z
CREATURELINESS	K R IY CH ER L IY N AH S
CREATURELINESSES	K R IY CH ER L IY N AH S IH Z
CREATURELY	K R IY CH ER L IY
CREATURES	K R IY CH ER Z
CRECHE	K R EH SH
CRECHES	K R EH SH AH Z
CREDAL	K R EH D AH L
CREDENCE	K R IY D AH N S
CREDENCES	K R EH D AH N S IH Z
CREDENDA	K R AH D EH N D AH
CREDENDUM	K R AH D EH N D AH M
CREDENT	K R EH D AH N T
CREDENTIAL	K R IH D EH N SH AH L
CREDENTIAL(2)	K R AH D EH N SH AH L
CREDENTIALED	K R AH D EH N SH AH L D
CREDENTIALING	K R IH D EH N CH AH L IH NG
CREDENTIALISM	K R IH D EH N CH AH L IH Z AH M
CREDENTIALISMS	K R IH D EH N CH AH L IH Z AH M Z
CREDENTIALLED	K R IH D EH N CH AH L D
CREDENTIALLING	K R IH D EH N CH AH L IH NG
CREDENTIALS	K R AH D EH N SH AH L Z
CREDENZA	K R AH D EH N Z AH
CREDENZAS	K R AH D EH N Z AH Z
CREDIBILITIES	K R EH D AH B IH L AH T IY Z
CREDIBILITY	K R EH D AH B IH L IH T IY
CREDIBLE	K R EH D AH B AH L
CREDIBLY	K R EH D AH B L IY
CREDIT	K R EH D AH T
CREDIT(2)	K R EH D IH T
CREDITABILITIES	K R EH D AH T AH B IH L AH T EH Z
CREDITABILITY	K R EH D AH T AH B IH L AH T EH
CREDITABLE	K R EH D AH T AH B AH L
CREDITABLENESS	K R EH D AH T AH B AH L N AH S
CREDITABLENESSES	K R EH D AH T AH B AH L N AH S IH Z
CREDITABLY	K R EH D AH T AH B L IY
CREDITED	K R EH D AH T AH D
CREDITED(2)	K R EH D IH T IH D
CREDITING	K R EH D AH T IH NG
CREDITOR	K R EH D AH T ER
CREDITOR(2)	K R EH D IH T ER
CREDITORS	K R EH D IH T ER Z
CREDITS	K R EH D IH T S
CREDITWORTHINESS	K R EH D IH T W ER DH IY N AH S
CREDITWORTHINESSES	K R EH D AH T W ER DH IY N AH S IH Z
CREDITWORTHY	K R EH D IH T W ER DH IY
CREDO	K R EY D OW
CREDO(2)	K R IY D OW
CREDOS	K R EY D OW Z
CREDULITIES	K R IH D UW L AH T IY Z
CREDULITY	K R IH D UW L AH T IY
CREDULOUS	K R EH JH AH L AH S
CREDULOUSLY	K R EH JH AH L AH S L IY
CREDULOUSNESS	K R EH JH AH L AH S N AH S
CREDULOUSNESSES	K R EH JH AH L AH S N AH S IH Z
CREED	K R IY D
CREEDAL	K R IY D AH L
CREEDS	K R IY D Z
CREEK	K R IY K
CREEKS	K R IY K S
CREEL	K R IY L
CREELED	K R IY L D
CREELING	K R IY L AH NG
CREELS	K R IY L Z
CREEP	K R IY P
CREEPAGE	K R IY P IH JH
CREEPAGES	K R IY P IH JH IH Z
CREEPER	K R IY P ER
CREEPERS	K R IY P ER Z
CREEPIE	K R IY P IY
CREEPIER	K R IY P IY ER
CREEPIES	K R IY P IY Z
CREEPIEST	K R IY P IY AH S T
CREEPILY	K R IY P IY L IY
CREEPINESS	K R IY P IY N IH S
CREEPINESSES	K R IY P IY N AH S IH Z
CREEPING	K R IY P IH NG
CREEPS	K R IY P S
CREEPY	K R IY P IY
CREESE	K R IY Z
CREESES	K R IY Z AH Z
CREESH	K R IY SH
CREESHED	K R IY SH T
CREESHES	K R IY SH AH Z
CREESHING	K R IY SH AH NG
CREMAINS	K R AH M EY N Z
CREMATE	K R IY M EY T
CREMATED	K R IY M EY T IH D
CREMATES	K R IY M EY T S
CREMATING	K R IY M EY T IH NG
CREMATION	K R IY M EY SH AH N
CREMATIONS	K R IY M EY SH AH N Z
CREMATOR	K R IY M EY T ER
CREMATORIA	K R IY M AH T AO R IY AH
CREMATORIES	K R IY M EY T ER IY Z
CREMATORIUM	K R IY M AH T AO R IY AH M
CREMATORIUMS	K R EH M AH T AO R IY AH M Z
CREMATORS	K R IY M EY T ER Z
CREMATORY	K R IY M EY T ER IY
CREME	K R IY M
CREMES	K R IY M Z
CRENATE	K R IY N EY T
CRENATED	K R IY N EY T AH D
CRENATION	K R IY N EY SH AH N
CRENATIONS	K R AH N EY T IY AH N Z
CRENEL	K R EH N AH L
CRENELATED	K R EH N AH L EY T AH D
CRENELATION	K R EH N AH L EY SH AH N
CRENELATIONS	K R EH N AH L EY T IY AH N Z
CRENELED	K R AH N IY L D
CRENELING	K R AH N IY L AH NG
CRENELLATED	K R EH N AH L EY T AH D
CRENELLATION	K R EH N AH L EY SH AH N
CRENELLATIONS	K R EH N AH L EY T IY AH N Z
CRENELLE	K R EH N AH L
CRENELLED	K R EH N AH L D
CRENELLES	K R EH N AH L Z
CRENELLING	K R AH N EH L AH NG
CRENELS	K R EH N AH L Z
CRENULATE	K R IY N Y AH L EY T
CRENULATED	K R IY N Y AH L EY T AH D
CRENULATION	K R IY N Y AH L EY SH AH N
CRENULATIONS	K R EH N Y AH L EY T IY AH N Z
CREODONT	K R IY AH D AH N T
CREODONTA	K R IY AH D AA N T AH
CREODONTS	K R IY AH D AH N T S
CREOLE	K R IY OW L
CREOLES	K R IY OW L Z
CREOLISE	K R IY AH L AY Z
CREOLISED	K R IY OW L IY Z D
CREOLISES	K R IY OW L IY Z IH Z
CREOLISING	K R IY OW L IY Z IH NG
CREOLIZATION	K R IY OW L AH Z EY SH AH N
CREOLIZATIONS	K R IY OW L AH Z EY SH AH N Z
CREOLIZE	K R IY OW L AY Z
CREOLIZED	K R IY OW L AY Z D
CREOLIZES	K R IY OW L AY Z IH Z
CREOLIZING	K R IY OW L AY Z IH NG
CREOSOL	K R IY AH S AH L
CREOSOLS	K R IY AH S AH L Z
CREOSOTE	K R IY AH S OW T
CREOSOTED	K R IY AH S OW T AH D
CREOSOTES	K R IY AH S OW T S
CREOSOTING	K R IY AH S OW T AH NG
CREPE	K R EY P
CREPED	K R EY P T
CREPES	K R EY P S
CREPEY	K R EY P IY
CREPIER	K R EY P IY ER
CREPIEST	K R EY P IY AH S T
CREPING	K R EY P IH NG
CREPITANT	K R EH P AH T AH N T
CREPITATE	K R EH P AH T EY T
CREPITATED	K R EH P AH T EY T AH D
CREPITATES	K R EH P AH T EY T S
CREPITATING	K R EH P AH T EY T AH NG
CREPITATION	K R EH P AH T EY SH AH N
CREPITATIONS	K R EH P AH T EY T IY AH N Z
CREPON	K R EH P AH N
CREPONS	K R EH P AH N Z
CREPT	K R EH P T
CREPUSCLE	K R EH P AH S AH L
CREPUSCLES	K R EH P AH S AH L Z
CREPUSCULAR	K R AH P AH S Y AH L AH R
CREPUSCULE	K R EH P AH S Y UW L
CREPUSCULES	K R EH P AH S Y UW L Z
CREPY	K R EY P IY
CRESCENDI	K R EH S EH N D IY
CRESCENDO	K R IH SH EH N D OW
CRESCENDOED	K R IH SH EH N D OW D
CRESCENDOES	K R IH SH EH N D OW Z
CRESCENDOING	K R IH SH EH N D OW IH NG
CRESCENDOS	K R IH SH EH N D OW Z
CRESCENT	K R EH S AH N T
CRESCENTIC	K R EH S AH N T IH K
CRESCENTS	K R EH S AH N T S
CRESCIVE	K R EH S IH V
CRESCIVELY	K R EH S IH V L IY
CRESOL	K R EH S AH L
CRESOLS	K R EH S AH L Z
CRESS	K R EH S
CRESSES	K R EH S AH Z
CRESSES(2)	K R EH S IH Z
CRESSET	K R EH S AH T
CRESSETS	K R EH S AH T S
CREST	K R EH S T
CRESTAL	K R EH S T AH L
CRESTED	K R EH S T IH D
CRESTFALLEN	K R EH S T F AO L AH N
CRESTFALLENLY	K R EH S T F AE L AH N L IY
CRESTFALLENNESS	K R EH S T F AE L AH N AH S
CRESTFALLENNESSES	K R EH S T F AE L AH N AH S IH Z
CRESTING	K R EH S T IH NG
CRESTINGS	K R EH S T IH NG Z
CRESTLESS	K R EH S T L AH S
CRESTS	K R EH S T S
CRESYL	K R EH S AH L
CRESYLIC	K R EH S AH L AH K
CRESYLS	K R EH S AH L Z
CRETIC	K R IY T AH K
CRETICS	K R IY T AH S Z
CRETIN	K R IY T AH N
CRETINISM	K R EH T AH N IH Z AH M
CRETINISMS	K R EH T AH N AH Z AH M Z
CRETINOUS	K R EH T AH N AH S
CRETINS	K R EH T AH N Z
CRETONNE	K R EH T AH N
CRETONNES	K R EH T AH N Z
CREVALLE	K R EH V AH L
CREVALLES	K R EH V AH L Z
CREVASSE	K R AH V AE S
CREVASSED	K R EH V AH S T
CREVASSES	K R AH V AE S AH Z
CREVASSING	K R AH V AE S AH NG
CREVICE	K R EH V AH S
CREVICED	K R EH V AH S T
CREVICES	K R EH V AH S IH Z
CREW	K R UW
CREWCUT	K R UW K AH T
CREWCUTS	K R UW K AH T S
CREWED	K R UW D
CREWEL	K R UW AH L
CREWELS	K R UW AH L Z
CREWELWORK	K R UW AH L W ER K
CREWELWORKS	K R UW AH L W ER K S
CREWING	K R UW IH NG
CREWLESS	K R UW L AH S
CREWMAN	K R UW M AH N
CREWMATE	K R UW M EY T
CREWMATES	K R UW M EY T S
CREWMEN	K R UW M IH N
CREWNECK	K R UW N EH K
CREWNECKS	K R UW N EH K S
CREWS	K R UW Z
CRISPBREAD	K R IH S P B R EH D
CRISPBREADS	K R IH S P B R EH D Z
CRORE	K R AO R
CRORES	K R AO R Z
CROSSBARRED	K R AO S B AA R D
CROSSBEARER	K R AO S B AE ER ER
CROSSBEARERS	K R AO S B AE ER ER Z
CROSSBRED	K R AO S B R EH D
CROSSBREDS	K R AO S B R EH D Z
CROSSBREED	K R AO S B R IY D
CROSSBREEDING	K R AO S B R IY D IH NG
CROSSBREEDS	K R AO S B R IY D Z
CROSSCURRENT	K R AO S K ER AH N T
CROSSCURRENTS	K R AO S K ER AH N T S
CROSSFIRE	K R AO S F AY R
CROSSFIRES	K R AO S F AY ER Z
CROSSTREES	K R AO S T R IY Z
CROWBARRED	K R OW B AA R D
CRYOPRESERVATION	K R AY AA P R EH S AH R V EY SH AH N
CRYOPRESERVATIONS	K R AY AA P R AH S AH R V EY T IY AH N Z
CRYOPRESERVE	K R AY AA P R AH S AH R V
CRYOPRESERVED	K R AY AA P R AH S AH R V D
CRYOPRESERVES	K R AY AA P R AH S AH R V Z
CRYOPRESERVING	K R AY AA P R AH S AH R V AH NG
CTENOPHORE	K T EH N AH F AH R
CTENOPHORES	K T EH N AH F AH R Z
CUBATURE	K Y UW B AH CH ER
CUBATURES	K Y UW B AH CH ER Z
CULTURE	K AH L CH ER
CULTURED	K AH L CH ER D
CULTURES	K AH L CH ER Z
CUMBERED	K AH M B ER D
CUMBERER	K AH M B ER ER
CUMBERERS	K AH M B ER ER Z
CUPBEARER	K AH P B AE ER ER
CUPBEARERS	K AH P B AE ER ER Z
CUPREOUS	K AH P R IY AH S
CURARE	K Y UW R AE R EY
CURARES	K Y UH R AH R Z
CURE	K Y UH R
CURED	K Y UH R D
CURELESS	K Y UH R L AH S
CURER	K Y UH R ER
CURERS	K Y UH R ER Z
CURES	K Y UH R Z
CURET	K Y UH R EH T
CURETS	K Y UH R EH T S
CURETTAGE	K Y UH R EH T IH JH
CURETTAGES	K Y UH R EH T IH JH IH Z
CURETTE	K Y UH R EH T
CURETTED	K Y UH R EH T IH D
CURETTEMENT	K Y UH R EH T M AH N T
CURETTEMENTS	K Y UH R EH T M AH N T S
CURETTES	K Y UH R EH T S
CURETTING	K Y UH R EH T IH NG
CURRED	K ER D
CURRENCIES	K ER AH N S IY Z
CURRENCY	K ER AH N S IY
CURRENT	K ER AH N T
CURRENT(2)	K ER N T
CURRENT(3)	K AA R AH N T
CURRENTLY	K ER AH N T L IY
CURRENTNESS	K ER AH N T N AH S
CURRENTNESSES	K ER AH N T N AH S IH Z
CURRENTS	K ER AH N T S
CURVATURE	K ER V AH CH ER
CURVATURES	K ER V AH CH UH R Z
CYLINDERED	S IH L AH N D ER D
CYNOSURE	S AH N AA ZH Y AH R
CYNOSURES	S AH N AA ZH Y AH R Z
CYPHERED	S AH F IY R D
CYPRES	S AY P AH R Z
CYPRESES	S IH P R IY Z AH Z
CYPRESS	S AY P R AH S
CYPRESS(2)	S AY P R IH S
CYPRESSES	S AY P R AH S IH Z
CYTODIFFERENTIATION	S AH T AH D IH F AH R EH N T AY EY SH AH N
CYTODIFFERENTIATIONS	S AH T AH D AH F AH R EH N T IY EY T IY AH N Z
CZAREVITCH	K Z AE R AH V AH CH
CZAREVITCHES	K Z AH R EH V AH CH AH Z
CZAREVNA	K Z AH R EH V N AH
CZAREVNAS	K Z AH R EH V N AH Z
DACKERED	D AE K IY R D
DAGGERED	D AE G ER D
DAGUERREOTYPE	D AE G W EH R IY AH T AY P
DAGUERREOTYPED	D AE G W EH R IY AH T AY P T
DAGUERREOTYPES	D AE G W EH R IY AH T AY P S
DAGUERREOTYPIES	D AE G W EH R IY AA T AH P AY Z
DAGUERREOTYPING	D AE G W EH R IY AH T AY P AH NG
DAGUERREOTYPIST	D AE G W EH R IY AA T AH P AH S T
DAGUERREOTYPISTS	D AE G W EH R IY AA T AH P AH S T S
DAGUERREOTYPY	D AE G W EH R IY AA T AH P IY
DAIKERED	D EY K IY R D
DANDERED	D AE N D IY R D
DANGERED	D EY N JH ER D
DAPPERER	D AE P ER ER
DAPPEREST	D AE P ER AH S T
DARE	D EH R
DARED	D EH R D
DAREDEVIL	D EH R D EH V AH L
DAREDEVILRIES	D EH R D EH V AH L R IY Z
DAREDEVILRY	D EH R D EH V AH L R IY
DAREDEVILS	D EH R D EH V AH L Z
DAREDEVILTRIES	D EH R D EH V AH L T R AY Z
DAREDEVILTRY	D EH R D EH V AH L T R AY
DAREFUL	D EH R F AH L
DARER	D EH R ER
DARERS	D EH R ER Z
DARES	D EH R Z
DARESAY	D EH R S EY
DASYURE	D AH S AY Y AH R
DASYURES	D AH S AY Y AH R Z
DAUNDERED	D AO N D IY R D
DAYBREAK	D EY B R EY K
DAYBREAKS	D EY B R EY K S
DAYDREAM	D EY D R IY M
DAYDREAMED	D EY D R IY M D
DAYDREAMER	D EY D R IY M ER
DAYDREAMERS	D EY D R IY M ER Z
DAYDREAMING	D EY D R IY M IH NG
DAYDREAMLIKE	D EY D R IY M L AY K
DAYDREAMS	D EY D R IY M Z
DAYDREAMT	D EY D R EH M T
DAYMARE	D EY M EH R
DAYMARES	D EY M EH R Z
DEAIRED	D IY EH R D
DEARER	D IH R ER
DEAREST	D IH R AH S T
DEBARRED	D IY B AA R D
DEBENTURE	D AH B EH N CH ER
DEBENTURES	D AH B EH N CH ER Z
DECARE	D IY K EH R
DECARES	D IY K EH R Z
DECENTERED	D IY S EH N T ER D
DECENTRE	D IY S EH N T ER
DECENTRED	D IY S EH N T ER D
DECENTRES	D IY S EH N T ER Z
DECEREBRATE	D IY S EH R AH B R AH T
DECEREBRATED	D IY S EH R AH B R EY T IH D
DECEREBRATES	D IY S EH R AH B R AH T S
DECEREBRATING	D IY S EH R AH B R EY T IH NG
DECEREBRATION	D IY S EH R AH B R EY SH AH N
DECEREBRATIONS	D IY S EH R AH B R EY SH AH N Z
DECIARE	D AH S AY AH R
DECIARES	D AH S AY AH R Z
DECIPHERED	D IH S AY F ER D
DECIPHERER	D IY S AY F ER ER
DECIPHERERS	D IY S AY F ER ER Z
DECLARE	D IH K L EH R
DECLARED	D IH K L EH R D
DECLARER	D IY K L AE R ER
DECLARERS	D IY K L AE R ER Z
DECLARES	D IH K L EH R Z
DECOLORED	D IY K AH L ER D
DECOLOURED	D IY K AH L ER D
DECOMPRESS	D IY K AH M P R EH S
DECOMPRESSED	D IY K AH M P R EH S T
DECOMPRESSES	D IY K AH M P R EH S IH Z
DECOMPRESSING	D IY K AH M P R EH S IH NG
DECOMPRESSION	D IY K AH M P R EH SH AH N
DECOMPRESSIONS	D IY K AH M P R EH SH AH N Z
DECREASE	D IH K R IY S
DECREASE(2)	D IY K R IY S
DECREASED	D IH K R IY S T
DECREASED(2)	D IY K R IY S T
DECREASES	D IH K R IY S AH Z
DECREASES(2)	D IH K R IY S IH Z
DECREASES(3)	D IY K R IY S IH Z
DECREASING	D IH K R IY S IH NG
DECREASING(2)	D IY K R IY S IH NG
DECREASINGLY	D IH K R IY S IH NG L IY
DECREE	D IH K R IY
DECREED	D IH K R IY D
DECREEING	D IH K R IY IH NG
DECREER	D EH K R IH R
DECREERS	D IH K R IH R Z
DECREES	D IH K R IY Z
DECREMENT	D EH K R AH M AH N T
DECREMENTAL	D EH K R AH M AH N T AH L
DECREMENTED	D EH K R AH M AH N T IH D
DECREMENTING	D EH K R AH M AH N T IH NG
DECREMENTS	D EH K R AH M AH N T S
DECREPIT	D AH K R EH P IH T
DECREPITATE	D IH K R EH P AH T EY T
DECREPITATED	D IH K R EH P AH T EY T AH D
DECREPITATES	D IH K R EH P AH T EY T S
DECREPITATING	D IH K R EH P AH T EY T AH NG
DECREPITATION	D IH K R EH P AH T EY SH AH N
DECREPITATIONS	D IH K R EH P AH T EY T IY AH N Z
DECREPITLY	D AH K R EH P IH T L IY
DECREPITUDE	D IY K R EY P AH T UW D
DECREPITUDES	D IY K R EY P AH T UW D Z
DECRESCENDO	D IY K R IH SH EH N D OW
DECRESCENDOS	D IY K R IH SH EH N D OW Z
DECRESCENT	D IY K R EH S AH N T
DECRETAL	D IH K R IY T AH L
DECRETALS	D IH K R EH T AH L Z
DECRETIVE	D IH K R IY T AH V
DECRETORY	D IH K R AH T AO R IY
DECURRENT	D IY K ER AH N T
DEDIFFERENTIATE	D IY D IH F AH R EH N CH IY AH T
DEDIFFERENTIATED	D IY D IH F AH R EH N CH IY EY T IH D
DEDIFFERENTIATES	D IY D IH F AH R EH N CH IY AH T S
DEDIFFERENTIATING	D IY D IH F AH R EH N CH IY EY T IH NG
DEDIFFERENTIATION	D IY D IH F AH R EH N CH IY EY SH AH N
DEDIFFERENTIATIONS	D IY D IH F AH R EH N CH IY EY SH AH N Z
DEFEATURE	D IH F IY CH ER
DEFEATURES	D IH F IY CH ER Z
DEFERENCE	D EH F ER AH N S
DEFERENCE(2)	D EH F R AH N S
DEFERENCES	D EH F AH R AH N S IH Z
DEFERENT	D EH F AH R AH N T
DEFERENTIAL	D EH F ER EH N CH AH L
DEFERENTIAL(2)	D EH F ER EH N SH AH L
DEFERENTIALLY	D EH F AH R AH N T IY AH L IY
DEFERENTS	D EH F AH R AH N T S
DEFERRED	D IH F ER D
DEFERRER	D IH F ER ER
DEFERRERS	D IH F ER ER Z
DEFLOWERED	D IY F L AW ER D
DEFLOWERER	D IY F L AW ER ER
DEFLOWERERS	D IY F L AW ER ER Z
DEFOREST	D IH F AO R AH S T
DEFORESTATION	D IH F AO R IH S T EY SH AH N
DEFORESTATIONS	D IY F AO R AH S T EY SH AH N Z
DEFORESTED	D IY F AO R AH S T IH D
DEFORESTING	D IY F AO R AH S T IH NG
DEFORESTS	D IY F AO R AH S T S
DEGREASE	D IY G R IY S
DEGREASED	D IY G R IY S T
DEGREASER	D IY G R IY S ER
DEGREASERS	D IY G R IY S ER Z
DEGREASES	D IY G R IY S IH Z
DEGREASING	D IY G R IY S IH NG
DEGREE	D IH G R IY
DEGREED	D IH G R IY D
DEGREES	D IH G R IY Z
DEGRESSIVE	D IH G R EH S AH V
DEGRESSIVELY	D IH G R EH S AY V L IY
DEKARE	D AH K AE R
DEKARES	D AH K AE R Z
DELFTWARE	D EH L F T W EH R
DELFTWARES	D IH L F T W AE R Z
DELIVERED	D IH L IH V ER D
DELIVERER	D IH L IH V ER ER
DELIVERERS	D IH L IH V ER ER Z
DELUSTERED	D IY L AH S T ER D
DEMERGERED	D IY M ER JH ER D
DEMIREP	D AH M IH R AH P
DEMIREPS	D AH M IH R AH P S
DEMURE	D IH M Y UH R
DEMURELY	D IH M Y UH R L IY
DEMURENESS	D IH M Y UH R N AH S
DEMURENESSES	D IH M Y UH R N AH S IH Z
DEMURER	D IH M Y UH R ER
DEMUREST	D IH M Y UH R AH S T
DEMURRED	D IH M ER D
DEMURRER	D IH M ER ER
DEMURRERS	D IH M ER ER Z
DENATURE	D IH N EY CH ER
DENATURED	D IH N EY CH ER D
DENATURES	D IY N EY CH ER Z
DENTURE	D EH N CH ER
DENTURES	D EH N CH ER Z
DEPARTURE	D IH P AA R CH ER
DEPARTURES	D IH P AA R CH ER Z
DEPLORE	D IH P L AO R
DEPLORED	D IH P L AO R D
DEPLORER	D IH P L OW R ER
DEPLORERS	D IH P L OW R ER Z
DEPLORES	D IH P L AO R Z
DEPRECATE	D EH P R AH K EY T
DEPRECATED	D EH P R AH K EY T AH D
DEPRECATES	D EH P R AH K EY T S
DEPRECATING	D EH P R AH K EY T IH NG
DEPRECATINGLY	D IY P R IY K EY T IH NG L IY
DEPRECATION	D IY P R IY K EY SH AH N
DEPRECATIONS	D IY P R IY K EY SH AH N Z
DEPRECATORILY	D EH P R IH K AH T OW R IY L IY
DEPRECATORY	D EH P R IH K AH T OW R IY
DEPRECIABLE	D IH P R IH SH AH B AH L
DEPRECIATE	D IH P R IY SH IY EY T
DEPRECIATED	D IH P R IY SH IY EY T IH D
DEPRECIATES	D IH P R IY SH IY EY T S
DEPRECIATING	D IH P R IY SH IY EY T IH NG
DEPRECIATINGLY	D IH P R IY SH IY EY T IH NG L IY
DEPRECIATION	D IH P R IY SH IY EY SH AH N
DEPRECIATIONS	D IH P R IY SH IY EY SH AH N Z
DEPRECIATIVE	D IH P R IY SH IY EY T IH V
DEPRECIATOR	D IH P R IY SH IY EY T ER
DEPRECIATORS	D IH P R IY SH IY EY T ER Z
DEPRECIATORY	D IH P R IY SH IY EY T ER IY
DEPREDATE	D EH P R AH D EY T
DEPREDATED	D EH P R AH D EY T IH D
DEPREDATES	D EH P R AH D EY T S
DEPREDATING	D EH P R AH D EY T IH NG
DEPREDATION	D EH P R AH D EY SH AH N
DEPREDATIONS	D EH P R AH D EY SH AH N Z
DEPREDATOR	D EH P R AH D EY T ER
DEPREDATORS	D EH P R AH D EY T ER Z
DEPREDATORY	D EH P R AH D EY T ER IY
DEPRESS	D IH P R EH S
DEPRESSANT	D IH P R EH S AH N T
DEPRESSANTS	D IH P R EH S AH N T S
DEPRESSED	D IH P R EH S T
DEPRESSES	D IH P R EH S AH Z
DEPRESSES(2)	D IH P R EH S IH Z
DEPRESSIBLE	D IY P R EH S AH B AH L
DEPRESSING	D IH P R EH S IH NG
DEPRESSINGLY	D IH P R EH S IH NG L IY
DEPRESSION	D IH P R EH SH AH N
DEPRESSIONS	D IH P R EH SH AH N Z
DEPRESSIVE	D IH P R EH S IH V
DEPRESSIVELY	D IY P R EH S IH V L IY
DEPRESSIVES	D IY P R EH S IH V Z
DEPRESSOR	D IY P R EH S ER
DEPRESSORS	D IY P R EH S ER Z
DEPRESSURIZATION	D IY P R EH SH ER AH Z EY SH AH N
DEPRESSURIZATIONS	D IY P R EH SH ER AH Z EY SH AH N Z
DEPRESSURIZE	D IH P R EH SH ER AY Z
DEPRESSURIZED	D IH P R EH SH ER AY Z D
DEPRESSURIZES	D IH P R EH SH ER AY Z IH Z
DEPRESSURIZING	D IH P R EH SH ER AY Z IH NG
DERE	D IY R IY
DEREALIZATION	D IY R IY L AH Z EY SH AH N
DEREALIZATIONS	D IY R IY L AH Z EY SH AH N Z
DEREGULATE	D IY R EH G Y AH L EY T
DEREGULATED	D IY R EH G Y AH L EY T IH D
DEREGULATES	D IY R EH G Y AH L AH T S
DEREGULATING	D IY R EH G Y AH L EY T IH NG
DEREGULATION	D IY R EH G Y AH L EY SH AH N
DEREGULATIONS	D IY R EH G Y AH L EY SH AH N Z
DERELICT	D EH R AH L IH K T
DERELICTION	D EH R AH L IH K SH AH N
DERELICTIONS	D EH R AH L IH K SH AH N Z
DERELICTS	D EH R AH L IH K T S
DERELICTS(2)	D EH R AH L IH K S
DEREPRESS	D IY R IY P R EH S
DEREPRESSED	D IY R IY P R EH S T
DEREPRESSES	D IY R IY P R EH S IH Z
DEREPRESSING	D IY R IY P R EH S IH NG
DEREPRESSION	D IY R IY P R EH SH AH N
DEREPRESSIONS	D IY R IY P R EH SH AH N Z
DERRIERE	D EH R IY EH ER
DERRIERES	D EH R IY EH ER Z
DESEGREGATE	D IH S EH G R AH G EY T
DESEGREGATED	D IH S EH G R IH G EY T IH D
DESEGREGATES	D IY S EH G R IH G EY T S
DESEGREGATING	D IY S EH G R IH G EY T IH NG
DESEGREGATION	D IH S EH G R AH G EY SH AH N
DESEGREGATION(2)	D IY S EH G R AH G EY SH AH N
DESEGREGATIONS	D IY S EH G R IH G EY SH AH N Z
DESILVERED	D IY S IH L V ER D
DESIRE	D IH Z AY ER
DESIRED	D IH Z AY ER D
DESIRER	D IH Z AY ER ER
DESIRERS	D IH Z AY ER ER Z
DESIRES	D IH Z AY ER Z
DESPAIRED	D IH S P EH R D
DESPAIRER	D IH S P EH R ER
DESPAIRERS	D IH S P EH R ER Z
DESUGARED	D IY SH UH G ER D
DESULFURED	D IY S AH L F ER D
DETERRED	D IH T ER D
DETERRENCE	D IH T ER AH N S
DETERRENCES	D IY T EH R AH N S IH Z
DETERRENT	D IH T ER R AH N T
DETERRENTLY	D IY T EH R AH N T L IY
DETERRENTS	D IH T ER AH N T S
DETERRER	D IY T EH R ER
DETERRERS	D IY T EH R ER Z
DETOURED	D IY T UH R D
DEVOURED	D IH V AW ER D
DEVOURER	D IH V AW ER ER
DEVOURERS	D IH V AW ER ER Z
DEWATERED	D IY W AO T ER D
DEWATERER	D IY W AO T ER ER
DEWATERERS	D IY W AO T ER ER Z
DIAERESES	D AY AH AH R IY Z AH Z
DIAERESIS	D AY AE IH R AH S AH S
DIAERETIC	D AY AE AH R AH T AH K
DIAPERED	D AY P ER D
DIAPHORESES	D AY AE F AH R IY Z AH Z
DIAPHORESIS	D AY AH F AO R AH S AH S
DIAPHORETIC	D AY AE F AH R AH T AH K
DIAPHORETICS	D AY AH F AO R AH T AH S Z
DIASPORE	D AY AE S AH R
DIASPORES	D AY AE S AH R Z
DIASTEREOISOMER	D AY AH S T IY R IY OY S AH M AH R
DIASTEREOISOMERIC	D AY AH S T IY R IY OY S AH M AH R AH K
DIASTEREOISOMERISM	D AY AH S T IY R IY OY S AH M AH R IH Z AH M
DIASTEREOISOMERISMS	D AY AH S T IY R IY OY S AA M AH R AH Z AH M Z
DIASTEREOISOMERS	D AY AH S T IY R IY OY S AH M AH R Z
DIASTEREOMER	D AY AH S T IY R IY OW M AH R
DIASTEREOMERIC	D AY AE S T AH R IY AH M AH R AH K
DIASTEREOMERS	D AY AE S T AH R IY AH M AH R Z
DICKERED	D IH K ER D
DIERESES	D IY R IY Z AH Z
DIERESIS	D IY R AH S AH S
DIERETIC	D IY R AH T AH K
DIFFERED	D IH F ER D
DIFFERENCE	D IH F ER AH N S
DIFFERENCE(2)	D IH F R AH N S
DIFFERENCED	D IH F ER AH N S T
DIFFERENCES	D IH F ER AH N S IH Z
DIFFERENCES(2)	D IH F R AH N S AH Z
DIFFERENCING	D IH F ER AH N S IH NG
DIFFERENT	D IH F ER AH N T
DIFFERENT(2)	D IH F R AH N T
DIFFERENTIA	D IH F AH R EH N CH IY AH
DIFFERENTIABILITIES	D IH F AH R EH N CH IY AH B IH L AH T EH Z
DIFFERENTIABILITY	D IH F AH R EH N CH IY AH B IH L AH T EH
DIFFERENTIABLE	D IH F AH R EH N CH IY AH B AH L
DIFFERENTIAE	D IH F AH R EH N T IY IY
DIFFERENTIAL	D IH F ER EH N SH AH L
DIFFERENTIALLY	D IH F AH R EH N CH AH L IY
DIFFERENTIALS	D IH F ER EH N SH AH L Z
DIFFERENTIATE	D IH F ER EH N SH IY EY T
DIFFERENTIATE(2)	D IH F ER EH N CH IY EY T
DIFFERENTIATED	D IH F ER EH N SH IY EY T IH D
DIFFERENTIATED(2)	D IH F ER EH N CH IY EY T AH D
DIFFERENTIATES	D IH F ER EH N SH IY EY T S
DIFFERENTIATES(2)	D IH F ER EH N CH IY EY T S
DIFFERENTIATING	D IH F ER EH N SH IY EY T IH NG
DIFFERENTIATING(2)	D IH F ER EH N CH IY EY T IH NG
DIFFERENTIATION	D IH F ER EH N SH IY EY SH AH N
DIFFERENTIATION(2)	D IH F ER EH N CH IY EY SH AH N
DIFFERENTIATIONS	D IH F AH R EH N CH IY EY SH AH N Z
DIFFERENTLY	D IH F R AH N T L IY
DIFFERENTLY(2)	D IH F ER EH N T L IY
DIFFERENTNESS	D IH F ER AH N T N AH S
DIFFERENTNESSES	D IH F ER AH N T N AH S IH Z
DIGRESS	D AY G R EH S
DIGRESSED	D AY G R EH S T
DIGRESSES	D AY G R EH S IH Z
DIGRESSING	D AY G R EH S IH NG
DIGRESSION	D AY G R EH SH AH N
DIGRESSIONAL	D AY G R EH SH AH N AH L
DIGRESSIONARY	D AY G R EH SH AH N EH R IY
DIGRESSIONS	D AY G R EH SH AH N Z
DIGRESSIVE	D AY G R EH S IH V
DIGRESSIVELY	D AY G R EH S IH V L IY
DIGRESSIVENESS	D AY G R EH S IH V N AH S
DIGRESSIVENESSES	D AY G R EH S IH V N AH S IH Z
DINNERWARE	D IH N ER W EH R
DINNERWARES	D IH N ER W EH R Z
DIOPTRE	D AY AA P T AH R
DIOPTRES	D AY AA P T AH R Z
DIRE	D AY R
DIRE(2)	D AY ER
DIRECT	D ER EH K T
DIRECT(2)	D AY R EH K T
DIRECT(3)	D IH R EH K T
DIRECTED	D ER EH K T AH D
DIRECTED(2)	D ER EH K T IH D
DIRECTED(3)	D AY R EH K T IH D
DIRECTED(4)	D IH R EH K T IH D
DIRECTEDNESS	D AH R EH K T AH D N AH S
DIRECTEDNESSES	D AH R EH K T AH D N AH S IH Z
DIRECTER	D AH R EH K T ER
DIRECTEST	D AH R EH K T AH S T
DIRECTING	D ER EH K T IH NG
DIRECTING(2)	D IY R EH K T IH NG
DIRECTING(3)	D AY R EH K T IH NG
DIRECTING(4)	D IH R EH K T IH NG
DIRECTION	D ER EH K SH AH N
DIRECTION(2)	D IY R EH K SH IH N
DIRECTION(3)	D AY R EH K SH IH N
DIRECTION(4)	D IH R EH K SH IH N
DIRECTIONAL	D ER EH K SH AH N AH L
DIRECTIONAL(2)	D IY R EH K SH IH N AH L
DIRECTIONAL(3)	D AY R EH K SH IH N AH L
DIRECTIONAL(4)	D IH R EH K SH IH N AH L
DIRECTIONALITIES	D AH R EH K SH AH N AH L AH T IY Z
DIRECTIONALITY	D AH R EH K SH AH N AH L AH T IY
DIRECTIONLESS	D ER EH K SH AH N L AH S
DIRECTIONLESS(2)	D IY R EH K SH IH N L AH S
DIRECTIONLESS(3)	D AY R EH K SH IH N L AH S
DIRECTIONLESS(4)	D IH R EH K SH IH N L AH S
DIRECTIONLESSNESS	D AH R EH K SH AH N L AH S N AH S
DIRECTIONLESSNESSES	D AH R EH K SH AH N L AH S N AH S IH Z
DIRECTIONS	D ER EH K SH AH N Z
DIRECTIONS(2)	D IY R EH K SH IH N Z
DIRECTIONS(3)	D AY R EH K SH IH N Z
DIRECTIONS(4)	D IH R EH K SH IH N Z
DIRECTIVE	D ER EH K T IH V
DIRECTIVE(2)	D IY R EH K T IH V
DIRECTIVE(3)	D AY R EH K T IH V
DIRECTIVE(4)	D IH R EH K T IH V
DIRECTIVES	D AY R EH K T IH V Z
DIRECTIVES(2)	D IY R EH K T IH V Z
DIRECTIVES(3)	D ER EH K T IH V Z
DIRECTIVES(4)	D IH R EH K T IH V Z
DIRECTIVITIES	D AH R EH K T IH V AH T IY Z
DIRECTIVITY	D AH R EH K T IH V AH T IY
DIRECTLY	D ER EH K T L IY
DIRECTLY(2)	D IY R EH K L IY
DIRECTLY(3)	D AY R EH K L IY
DIRECTLY(4)	D IH R EH K L IY
DIRECTNESS	D ER EH K T N AH S
DIRECTNESS(2)	D IY R EH K N AH S
DIRECTNESS(3)	D AY R EH K N AH S
DIRECTNESS(4)	D IH R EH K N AH S
DIRECTNESSES	D AH R EH K T N AH S IH Z
DIRECTOR	D ER EH K T ER
DIRECTOR(2)	D AY R EH K T ER
DIRECTOR(3)	D IY R EH K T ER
DIRECTOR(4)	D IH R EH K T ER
DIRECTORATE	D ER EH K T ER AH T
DIRECTORATE(2)	D AY R EH K T ER AH T
DIRECTORATE(3)	D IY R EH K T ER AH T
DIRECTORATE(4)	D IH R EH K T ER AH T
DIRECTORATES	D AH R EH K T ER AH T S
DIRECTORIAL	D ER EH K T AO R IY AH L
DIRECTORIAL(2)	D AY R EH K T AO R IY AH L
DIRECTORIAL(3)	D IY R EH K T AO R IY AH L
DIRECTORIAL(4)	D IH R EH K T AO R IY AH L
DIRECTORIES	D AY R EH K T ER IY Z
DIRECTORIES(2)	D ER EH K T ER IY Z
DIRECTORIES(3)	D IY R EH K T ER IY Z
DIRECTORIES(4)	D IH R EH K T ER IY Z
DIRECTORS	D ER EH K T ER Z
DIRECTORS(2)	D AY R EH K T ER Z
DIRECTORS(3)	D IY R EH K T ER Z
DIRECTORS(4)	D IH R EH K T ER Z
DIRECTORSHIP	D ER EH K T ER SH IH P
DIRECTORSHIP(2)	D AY R EH K T ER SH IH P
DIRECTORSHIP(3)	D IY R EH K T ER SH IH P
DIRECTORSHIP(4)	D IH R EH K T ER SH IH P
DIRECTORSHIPS	D ER EH K T ER SH IH P S
DIRECTORSHIPS(2)	D AY R EH K T ER SH IH P S
DIRECTORSHIPS(3)	D IY R EH K T ER SH IH P S
DIRECTORSHIPS(4)	D IH R EH K T ER SH IH P S
DIRECTORY	D ER EH K T ER IY
DIRECTORY(2)	D AY R EH K T ER IY
DIRECTORY(3)	D IY R EH K T ER IY
DIRECTORY(4)	D IH R EH K T ER IY
DIRECTRESS	D AH R EH K T R AH S
DIRECTRESSES	D AH R EH K T R EH S AH Z
DIRECTRICE	D AH R EH K T R AY S
DIRECTRICES	D AH R EH K T R AY S IH Z
DIRECTRIX	D AH R EH K T R AH K S
DIRECTRIXES	D AH R EH K T R AH K S
DIRECTS	D ER EH K T S
DIRECTS(2)	D AY R EH K T S
DIRECTS(3)	D IY R EH K T S
DIRECTS(4)	D IH R EH K T S
DIREFUL	D AY ER F AH L
DIREFULLY	D AY ER F AH L IY
DIRELY	D AY ER L IY
DIRENESS	D AY ER N AH S
DIRENESSES	D AY ER N AH S IH Z
DIRER	D AY ER ER
DIREST	D AY R AH S T
DISAGGREGATE	D IH S AE G R IH G AH T
DISAGGREGATED	D IH S AE G R IH G AH T IH D
DISAGGREGATES	D IH S AE G R IH G AH T S
DISAGGREGATING	D IH S AE G R IH G AH T IH NG
DISAGGREGATION	D IH S AE G R IH G AH SH AH N
DISAGGREGATIONS	D IH S AE G R IH G AH SH AH N Z
DISAGGREGATIVE	D IH S AE G R IH G AH T IH V
DISAGREE	D IH S AH G R IY
DISAGREEABLE	D IH S AH G R IY AH B AH L
DISAGREEABLENESS	D IH S AH G R IY AH B AH L N AH S
DISAGREEABLENESSES	D IH S AH G R IY AH B AH L N AH S IH Z
DISAGREEABLY	D IH S AH G R IY AH B L IY
DISAGREED	D IH S AH G R IY D
DISAGREEING	D IH S AH G R IY IH NG
DISAGREEMENT	D IH S AH G R IY M AH N T
DISAGREEMENTS	D IH S AH G R IY M AH N T S
DISAGREES	D IH S AH G R IY Z
DISAPPEARED	D IH S AH P IH R D
DISAPPEARED(2)	D IH S AH P IY R D
DISBARRED	D IH S B AA R D
DISCLOSURE	D IH S K L OW ZH ER
DISCLOSURES	D IH S K L OW ZH ER Z
DISCOLORED	D IH S K AH L ER D
DISCOMFITURE	D IH S K AH M F IH CH ER
DISCOMFITURES	D IH S K AH M F IH CH ER Z
DISCOMPOSURE	D IH S K AH M P OW ZH ER
DISCOMPOSURES	D IH S K AH M P OW ZH ER Z
DISCOVERED	D IH S K AH V ER D
DISCOVERER	D IH S K AH V AH R ER
DISCOVERERS	D IH S K AH V AH R ER Z
DISCREDIT	D IH S K R EH D AH T
DISCREDITABLE	D IH S K R EH D AH T AH B AH L
DISCREDITABLY	D IH S K R EH D AH T AH B L IY
DISCREDITED	D IH S K R EH D IH T IH D
DISCREDITING	D IH S K R EH D AH T IH NG
DISCREDITS	D IH S K R EH D AH T S
DISCREET	D IH S K R IY T
DISCREETER	D IH S K R IY T ER
DISCREETEST	D IH S K R IY T AH S T
DISCREETLY	D IH S K R IY T L IY
DISCREETNESS	D IH S K R IY T N AH S
DISCREETNESSES	D IH S K R IY T N AH S IH Z
DISCREPANCIES	D IH S K R EH P AH N S IY Z
DISCREPANCY	D IH S K R EH P AH N S IY
DISCREPANT	D IH S K R EH P AH N T
DISCREPANTLY	D IH S K R EH P AH N T L IY
DISCRETE	D IH S K R IY T
DISCRETELY	D IH S K R IY T L IY
DISCRETENESS	D IH S K R IY T N AH S
DISCRETENESSES	D IH S K R IY T N AH S IH Z
DISCRETION	D IH S K R EH SH AH N
DISCRETIONARY	D IH S K R EH SH AH N EH R IY
DISCRETIONS	D IH S K R EH SH AH N Z
DISENCUMBERED	D IH S EH N K AH M B ER D
DISFAVORED	D IH S F EY V ER D
DISFIGURE	D IH S F IH G Y ER
DISFIGURED	D IH S F IH G Y ER D
DISFIGUREMENT	D IH S F IH G Y ER M EH N T
DISFIGUREMENTS	D IH S F IH G Y ER M AH N T S
DISFIGURES	D IH S F IH G Y ER Z
DISHONORED	D IH S AA N ER D
DISHONORER	D IH S AA N ER ER
DISHONORERS	D IH S AA N ER ER Z
DISHWARE	D IH SH W EH R
DISHWARES	D IH SH W EH R Z
DISINTEREST	D IH S IH N T ER AH S T
DISINTERESTED	D IH S IH N T R IH S T IH D
DISINTERESTED(2)	D IH S IH N R IH S T IH D
DISINTERESTEDLY	D IH S IH N T R AH S T AH D L IY
DISINTERESTEDNESS	D IH S IH N T R AH S T AH D N AH S
DISINTERESTEDNESSES	D IH S IH N T R AH S T AH D N AH S IH Z
DISINTERESTING	D IH S IH N T R AH S T IH NG
DISINTERESTS	D IH S IH N T R AH S T S
DISINTERRED	D IH S IH N T ER R EH D
DISJUNCTURE	D IH S JH AH NG K CH ER
DISJUNCTURES	D IH S JH AH NG K CH ER Z
DISMEMBERED	D IH S M EH M B ER D
DISORDERED	D IH S AO R D ER D
DISORDEREDLY	D IH S AO R D ER AH D L IY
DISORDEREDNESS	D IH S AO R D ER AH D N AH S
DISORDEREDNESSES	D IH S AO R D ER AH D N AH S IH Z
DISPLEASURE	D IH S P L EH ZH ER
DISPLEASURES	D IH S P L EH ZH ER Z
DISPOSURE	D IH S P OW ZH ER
DISPOSURES	D IH S P OW ZH ER Z
DISPREAD	D IH S R IY AE D
DISPREADING	D IH S R IY EY D AH NG
DISPREADS	D IH S R IY AE D Z
DISREGARD	D IH S R IH G AA R D
DISREGARDED	D IH S R IH G AA R D IH D
DISREGARDFUL	D IH S R IH G AA R D F AH L
DISREGARDING	D IH S R IH G AA R D IH NG
DISREGARDS	D IH S R IH G AA R D Z
DISRELATED	D IH S R IH L EY T IH D
DISRELATION	D IH S R IY L EY SH AH N
DISRELATIONS	D IH S R IY L EY SH AH N Z
DISRELISH	D IH S R EH L IH SH
DISRELISHED	D IH S R EH L IH SH T
DISRELISHES	D IH S R EH L IH SH IH Z
DISRELISHING	D IH S R EH L IH SH IH NG
DISREMEMBER	D IH S R IH M EH M B ER
DISREMEMBERED	D IH S R IH M EH M B ER D
DISREMEMBERING	D IH S R IH M EH M B ER IH NG
DISREMEMBERS	D IH S R IH M EH M B ER Z
DISREPAIR	D IH S R IH P EH R
DISREPAIRS	D IH S R IH P EH R Z
DISREPUTABILITIES	D IH S R IH P Y UW T AH B IH L AH T EH Z
DISREPUTABILITY	D IH S R IH P Y UW T AH B IH L AH T EH
DISREPUTABLE	D IH S R EH P Y AH T AH B AH L
DISREPUTABLENESS	D IH S R EH P Y AH T AH B AH L N AH S
DISREPUTABLENESSES	D IH S R EH P Y AH T AH B AH L N AH S IH Z
DISREPUTABLY	D IH S R IH P Y UW T AH B L IY
DISREPUTE	D IH S R IH P Y UW T
DISREPUTES	D IH S R IH P Y UW T S
DISRESPECT	D IH S R IH S P EH K T
DISRESPECTABILITIES	D IH S R IH S P EH K T AH B IH L AH T EH Z
DISRESPECTABILITY	D IH S R IH S P EH K T AH B IH L AH T EH
DISRESPECTABLE	D IH S R IH S P EH K T AH B AH L
DISRESPECTED	D IH S R IH S P EH K T IH D
DISRESPECTFUL	D IH S R IH S P EH K T F AH L
DISRESPECTFULLY	D IH S R IH S P EH K T F AH L IY
DISRESPECTFULNESS	D IH S R IH S P EH K T F AH L N AH S
DISRESPECTFULNESSES	D IH S R IH S P EH K T F AH L N AH S IH Z
DISRESPECTING	D IH S R IH S P EH K T IH NG
DISRESPECTS	D IH S R IH S P EH K T S
DISSEVERED	D IH S EH V ER D
DISTEMPERATURE	D IH S T EH M P ER AH CH ER
DISTEMPERATURES	D IH S T EH M P ER AH CH ER Z
DISTEMPERED	D IH S T EH M P ER D
DISTRESS	D IH S T R EH S
DISTRESSED	D IH S T R EH S T
DISTRESSES	D IH S T R EH S IH Z
DISTRESSFUL	D IH S T R EH S F AH L
DISTRESSFULLY	D IH S T R EH S F AH L IY
DISTRESSFULNESS	D IH S T R EH S F AH L N AH S
DISTRESSFULNESSES	D IH S T R EH S F AH L N AH S IH Z
DISTRESSING	D IH S T R EH S IH NG
DISTRESSINGLY	D IH S T R EH S IH NG L IY
DITHERED	D AH TH IY R D
DITHERER	D AH TH IY R AH R
DITHERERS	D IH TH AH R AH R Z
DIURESES	D AY Y ER Z IH Z
DIURESIS	D AY Y ER Z IY Z
DIURETIC	D AY UW R EH T IH K
DIURETICALLY	D AY AH R EH T AH K AE L IY
DIURETICS	D AY UW R EH T IH K S
DIVESTITURE	D IH V EH S T IH CH ER
DIVESTITURE(2)	D AY V EH S T IH CH ER
DIVESTITURES	D IH V EH S T IH CH ER Z
DIVESTITURES(2)	D AY V EH S T IH CH ER Z
DOCTORED	D AA K T ER D
DOCTRINAIRE	D AA K T R AH N EH R
DOCTRINAIRES	D AA K T R AH N EH R Z
DODDERED	D AA D IY R D
DODDERER	D AA D IY R AH R
DODDERERS	D AA D AH R AH R Z
DOGEARED	D AA G IY R D
DOGGEREL	D AA G ER AH L
DOGGERELS	D AA JH AH R AH L Z
DOGGREL	D AA G R AH L
DOGGRELS	D AA G R AH L Z
DOMINEERED	D AA M AH N IH R D
DONNERED	D AA N ER D
DORE	D AO R
DOSSERET	D AA S AH R AH T
DOSSERETS	D AA S AH R AH T S
DOTTEREL	D AA T AH R AH L
DOTTERELS	D AA T AH R AH L Z
DOTTREL	D AA T R AH L
DOTTRELS	D AA T R AH L Z
DOUBLURE	D AH B AH L Y ER
DOUBLURES	D AH B AH L Y ER Z
DOURER	D AW ER ER
DOUREST	D AW ER AH S T
DOWERED	D AW ER D
DOWNSTREAM	D AW N S T R IY M
DOWNTREND	D AW N T R EH N D
DOWNTRENDS	D AW N T R EH N D Z
DRAWBORE	D R AO B AO R
DRAWBORES	D R AO B AO R Z
DREAD	D R EH D
DREADED	D R EH D IH D
DREADFUL	D R EH D F AH L
DREADFULLY	D R EH D F AH L IY
DREADFULNESS	D R EH D F AH L N AH S
DREADFULNESSES	D R EH D F AH L N AH S IH Z
DREADFULS	D R EH D F AH L Z
DREADING	D R EH D IH NG
DREADLOCK	D R EH D L AA K
DREADLOCKS	D R EH D L AA K S
DREADNOUGHT	D R EH D N AO T
DREADNOUGHTS	D R EH D N AO T S
DREADS	D R EH D Z
DREAM	D R IY M
DREAMED	D R IY M D
DREAMER	D R IY M ER
DREAMERS	D R IY M ER Z
DREAMFUL	D R IY M F AH L
DREAMFULLY	D R IY M F AH L IY
DREAMFULNESS	D R IY M F AH L N AH S
DREAMFULNESSES	D R IY M F AH L N AH S IH Z
DREAMIER	D R IY M IY ER
DREAMIEST	D R IY M IY AH S T
DREAMILY	D R IY M IY L IY
DREAMINESS	D R IY M IY N AH S
DREAMINESSES	D R IY M IY N AH S IH Z
DREAMING	D R IY M IH NG
DREAMLAND	D R IY M L AE N D
DREAMLANDS	D R IY M L AE N D Z
DREAMLESS	D R IY M L AH S
DREAMLESSLY	D R IY M L AH S L IY
DREAMLESSNESS	D R IY M L AH S N AH S
DREAMLESSNESSES	D R IY M L AH S N AH S IH Z
DREAMLIKE	D R IY M L AY K
DREAMS	D R IY M Z
DREAMT	D R EH M T
DREAMTIME	D R IY M T AY M
DREAMTIMES	D R IY M T AY M Z
DREAMWORLD	D R IY M W ER L D
DREAMWORLDS	D R IY M W ER L D Z
DREAMY	D R IY M IY
DREAR	D R IH ER
DREARIER	D R IH ER IY ER
DREARIES	D R IH ER IY Z
DREARIEST	D R IH ER IY AH S T
DREARILY	D R IH ER IY L IY
DREARINESS	D R IY R IY N AH S
DREARINESSES	D R IH ER IY N AH S IH Z
DREARS	D R IH ER Z
DREARY	D R IH R IY
DRECK	D R EH K
DRECKS	D R EH K S
DRECKY	D R EH K IY
DREDGE	D R EH JH
DREDGED	D R EH JH D
DREDGER	D R EH JH AH R
DREDGERS	D R EH JH AH R Z
DREDGES	D R EH JH AH Z
DREDGES(2)	D R EH JH IH Z
DREDGING	D R EH JH IH NG
DREDGINGS	D R EH JH AH NG Z
DREE	D R IY
DREED	D R IY D
DREEING	D R IY AH NG
DREES	D R IY Z
DREG	D R EH G
DREGGIER	D R EH G IY ER
DREGGIEST	D R EH G IY AH S T
DREGGISH	D R EH G IH SH
DREGGY	D R EH G IY
DREGS	D R EH G Z
DREICH	D R IY CH
DREIDEL	D R IY D AH L
DREIDELS	D R IY D AH L Z
DREIDL	D R IY D L
DREIDLS	D R IY D L Z
DREIGH	D R EY
DREK	D R EH K
DREKS	D R EH K S
DRENCH	D R EH N CH
DRENCHED	D R EH N CH T
DRENCHER	D R EH N CH ER
DRENCHERS	D R EH N CH ER Z
DRENCHES	D R EH N CH AH Z
DRENCHING	D R EH N CH IH NG
DRESS	D R EH S
DRESSAGE	D R EH S AA ZH
DRESSAGES	D R EH S IH JH IH Z
DRESSED	D R EH S T
DRESSER	D R EH S ER
DRESSERS	D R EH S ER Z
DRESSES	D R EH S AH Z
DRESSES(2)	D R EH S IH Z
DRESSIER	D R EH S IY ER
DRESSIEST	D R EH S IY AH S T
DRESSILY	D R EH S IY L IY
DRESSINESS	D R EH S IY N AH S
DRESSINESSES	D R EH S IY N AH S IH Z
DRESSING	D R EH S IH NG
DRESSINGS	D R EH S IH NG Z
DRESSMAKER	D R EH S M EY K ER
DRESSMAKERS	D R EH S M EY K ER Z
DRESSMAKING	D R EH S M EY K IH NG
DRESSMAKINGS	D R EH S M EY K IH NG Z
DRESSY	D R EH S IY
DREST	D R EH S T
DREW	D R UW
DRUGSTORE	D R AH G S T AO R
DRUGSTORES	D R AH G S T AO R Z
DRUMFIRE	D R AH M F AY ER
DRUMFIRES	D R AH M F AY ER Z
DULCIMORE	D AH L S AH M AH R
DULCIMORES	D AH L S AH M AH R Z
DUMBFOUNDERED	D AH M F AW N D ER D
DUNDREARIES	D AH N D R IH ER IY Z
DUNGAREE	D AH NG ER IY
DUNGAREES	D AH NG ER IY Z
DURE	D Y UH R
DURED	D Y UH R D
DURES	D Y UH R Z
DURESS	D UH R EH S
DURESSES	D UH R EH S IH Z
EAGERER	IY G ER ER
EAGEREST	IY G ER AH S T
EAGRE	IY G AH R
EAGRES	IY G AH R Z
EARED	IH R D
EARTHENWARE	ER TH AH N W EH R
EARTHENWARES	ER TH AH N W EH R Z
ECOFREAK	EH K AH F R IY K
ECOFREAKS	EH K AH F R IY K S
ECOSPHERE	AH K AA S AH R
ECOSPHERES	EH K AH S IY R Z
ECTOMERE	EH K T OW M AH R
ECTOMERES	EH K T AH M IY R Z
EDITRESS	AH D IH T R AH S
EDITRESSES	AH D IH T R EH S AH Z
EFFERENT	EH F ER AH N T
EFFERENTLY	EH F AH R EH N T L IY
EFFERENTS	EH F AH R AH N T S
EFFLORESCE	EH F L AH R EH S
EFFLORESCED	EH F L AH R EH S T
EFFLORESCENCE	EH F L AH R EH S AH N S
EFFLORESCENCES	EH F L AH R EH S AH N S IH Z
EFFLORESCENT	EH F L AH R EH S AH N T
EFFLORESCES	EH F L AH R EH S IH Z
EFFLORESCING	EH F L AH R EH S IH NG
EGLATERE	EH G L EY T AH R
EGLATERES	EH G L AH T IY R Z
EGREGIOUS	IH G R IY JH AH S
EGREGIOUSLY	IH G R IY JH AH S L IY
EGREGIOUSNESS	IH G R IY JH AH S N AH S
EGREGIOUSNESSES	IH G R IY JH AH S N AH S IH Z
EGRESS	IH G R EH S
EGRESSED	EH G R AH S T
EGRESSES	EH G R EH S AH Z
EGRESSING	EH G R EH S AH NG
EGRESSION	EH G R EH S IY AH N
EGRESSIONS	EH G R EH S IY AH N Z
EGRET	EH G R AH T
EGRETS	IY G R AH T S
EIRENIC	IY R AH N AH K
ELDRESS	EH L D R AH S
ELDRESSES	EH L D R EH S AH Z
ELECTIONEERED	IH L EH K SH AH N IH R D
ELECTIONEERER	IH L EH K SH AH N IH R ER
ELECTIONEERERS	IH L EH K SH AH N IH R ER Z
ELECTRESS	IH L EH K T R AH S
ELECTRESSES	IH L EH K T R AH S IH Z
ELECTRET	AH L EH K T R AH T
ELECTRETS	AH L EH K T R AH T S
ELECTROPHORESE	AH L EH K T R AA F AH R IY Z
ELECTROPHORESED	AH L EH K T R AH F AH R Z D
ELECTROPHORESES	AH L EH K T R AA F AH R IY Z AH Z
ELECTROPHORESING	AH L EH K T R AA F AH R IY Z AH NG
ELECTROPHORESIS	IH L EH K T R OW F AO R IH S IH S
ELECTROPHORETIC	EH L AH K T R AA F AH R AH T AH K
ELECTROPHORETICALLY	AH L EH K T R AH F AH R EH T AH K AE L IY
ELECTROPHORETOGRAM	IH L EH K T R OW F AH R EH T AH G R AE M
ELECTROPHORETOGRAMS	AH L AH K T R AA F AH R AH T AA G R AH M Z
ELECTRORETINOGRAM	AH L AH K T R AO R AH T AH N AA G R AH M
ELECTRORETINOGRAMS	AH L AH K T R AO R AH T AH N AA G R AH M Z
ELECTRORETINOGRAPH	AH L AH K T R AO R AH T AH N AA G R AH F
ELECTRORETINOGRAPHIC	AH L AH K T R AO R AH T AH N AA G R AH F AH K
ELECTRORETINOGRAPHIES	AH L AH K T R AO R AH T AH N AA G R AH F AY Z
ELECTRORETINOGRAPHS	AH L AH K T R AO R AH T AH N AA G R AH F S
ELECTRORETINOGRAPHY	AH L AH K T R AO R AH T AH N AA G R AH F IY
ELSEWHERE	EH L S W EH R
EMBARRED	IH M B AA R D
EMBITTERED	EH M B IH T ER D
EMBORDERED	IH M B AO R D ER D
EMBOUCHURE	AA M B UH SH UH R
EMBOUCHURES	AA M B UH SH UH R Z
EMBOWERED	IH M B AW ER D
EMBRASURE	IH M B R AE ZH Y AH R
EMBRASURES	IH M B R AE ZH Y AH R Z
EMBROIDERED	EH M B R OY D ER D
EMBROIDERER	EH M B R OY D ER ER
EMBROIDERERS	EH M B R OY D ER ER Z
EMIGRE	EH M AH G R EY
EMIGRES	EH M AH G R EY Z
EMPIRE	EH M P AY ER
EMPIRES	EH M P AY ER Z
EMPOWERED	IH M P AW ER D
EMPRESS	EH M P R EH S
EMPRESSEMENT	IH M P R IY S M EH N T
EMPRESSEMENTS	IH M P R IY S EH M AH N T S
EMPRESSES	IH M P R EH S IH Z
EMPYREAL	IH M P AY ER AH L
EMPYREAN	IH M P AY R IY AH N
EMPYREANS	IH M P AH R IY N Z
ENAMELWARE	IH N AE M AH L W EH R
ENAMELWARES	IH N AE M AH L W EH R Z
ENAMORED	EH N AE M ER D
ENAMOURED	AH N AH M OW Y AH R D
ENCHANTRESS	IH N CH AE N T R AH S
ENCHANTRESSES	IH N CH AE N T R EH S AH Z
ENCIPHERED	EH N S AY F ER D
ENCIPHERER	EH N S AY F ER ER
ENCIPHERERS	EH N S AY F ER ER Z
ENCLOSURE	EH N K L OW ZH ER
ENCLOSURE(2)	IH N K L OW ZH ER
ENCLOSURES	IH N K L OW ZH ER Z
ENCORE	AA N K AO R
ENCORED	AA N K OW R D
ENCORES	AA N K AO R Z
ENCOUNTERED	IH N K AW N T ER D
ENCOUNTERED(2)	IH N K AW N ER D
ENCUMBERED	EH N K AH M B ER D
ENDANGERED	EH N D EY N JH ER D
ENDANGERED(2)	IH N D EY N JH ER D
ENDARTERECTOMIES	IH N D AA R T AH R EH K T AH M AY Z
ENDARTERECTOMY	IH N D AA R T AH R EH K T AH M IY
ENDEARED	EH N D IY R D
ENDEAVORED	IH N D EH V ER D
ENDEAVOURED	IH N D IY AH V OW Y AH R D
ENDOSPORE	EH N D UW S P OW R
ENDOSPORES	EH N D UW S P OW R Z
ENDURE	EH N D Y UH R
ENDURE(2)	IH N D UH R
ENDURED	EH N D Y UH R D
ENDURED(2)	IH N D UH R D
ENDURES	EH N D Y UH R Z
ENDURES(2)	IH N D UH R Z
ENFETTERED	EH N F EH T ER D
ENFEVERED	EH N F IY V ER D
ENGENDERED	EH N JH EH N D ER D
ENGINEERED	EH N JH AH N IY R D
ENQUIRE	IH N K W AY ER
ENQUIRED	IH N K W AY ER D
ENQUIRES	IH N K W AY ER Z
ENRAPTURE	EH N R AE P CH ER
ENRAPTURED	EH N R AE P CH ER D
ENRAPTURES	EH N R AE P CH ER Z
ENREGISTER	EH N R EH JH AH S T ER
ENREGISTERED	EH N R EH JH AH S T ER D
ENREGISTERING	EH N R EH JH AH S T ER IH NG
ENREGISTERS	EH N R EH JH AH S T ER Z
ENSNARE	IH N S N EH R
ENSNARED	IH N S N EH R D
ENSNARER	EH N S N EH R ER
ENSNARERS	EH N S N EH R ER Z
ENSNARES	IH N S N EH R Z
ENSPHERE	EH N S F IH ER
ENSPHERED	EH N S F IH ER D
ENSPHERES	EH N S F IH ER Z
ENSURE	EH N SH UH R
ENSURE(2)	IH N SH UH R
ENSURED	EH N SH UH R D
ENSURED(2)	IH N SH UH R D
ENSURER	EH N SH UH R ER
ENSURERS	EH N SH UH R ER Z
ENSURES	EH N SH UH R Z
ENSURES(2)	IH N SH UH R Z
ENTABLATURE	EH N T EY B AH L AH CH ER
ENTABLATURES	EH N T EY B AH L AH CH ER Z
ENTERED	EH N T ER D
ENTERED(2)	EH N ER D
ENTERER	EH N T ER ER
ENTERERS	EH N T ER ER Z
ENTIRE	IH N T AY ER
ENTIRELY	IH N T AY ER L IY
ENTIRENESS	IH N T AY ER N AH S
ENTIRENESSES	IH N T AY ER N AH S IH Z
ENTIRES	IH N T AY ER Z
ENTIRETIES	IH N T AY R AH T IY Z
ENTIRETY	IH N T AY ER T IY
ENTREAT	EH N T R IY T
ENTREATED	EH N T R IY T IH D
ENTREATIES	EH N T R IY T IY Z
ENTREATING	EH N T R IY T IH NG
ENTREATINGLY	EH N T R IY T IH NG L IY
ENTREATMENT	EH N T R IY T M AH N T
ENTREATMENTS	EH N T R IY T M AH N T S
ENTREATS	EH N T R IY T S
ENTREATY	EH N T R IY T IY
ENTRECHAT	IH N T R EH CH AH T
ENTRECHATS	IH N T R AH CH EY T S
ENTRECOTE	IH N T R AH K OW T
ENTRECOTES	IH N T R AH K OW T S
ENTREE	AA N T R EY
ENTREES	AA N T R EY Z
ENTREMETS	IH N T R EH M AH T S
ENTRENCH	EH N T R EH N CH
ENTRENCHED	EH N T R EH N CH T
ENTRENCHED(2)	IH N T R EH N CH T
ENTRENCHES	EH N T R EH N CH IH Z
ENTRENCHING	EH N T R EH N CH IH NG
ENTRENCHMENT	EH N T R EH N CH M AH N T
ENTRENCHMENTS	EH N T R EH N CH M AH N T S
ENTREPOT	IH N T R EH P AH T
ENTREPOTS	IH N T R EH P AH T S
ENTREPRENEUR	AA N T R AH P R AH N ER
ENTREPRENEUR(2)	AA N T R AH P R AH N UH R
ENTREPRENEURIAL	AA N T R AH P R AH N ER IY AH L
ENTREPRENEURIALISM	EH N T R AH P R AH N UW R IY AH L IH Z AH M
ENTREPRENEURIALISMS	AA N T R AH P R AH N ER IY AH L IH Z AH M Z
ENTREPRENEURIALLY	AA N T R AH P R AH N ER IY AH L IY
ENTREPRENEURS	AA N T R AH P R AH N ER Z
ENTREPRENEURSHIP	AA N T R AH P R AH N ER SH IH P
ENTREPRENEURSHIPS	AA N T R AH P R AH N ER SH IH P S
ENTRESOL	IH N T R EH S AH L
ENTRESOLS	IH N T R EH S AH L Z
ENURE	EH N Y AH R
ENURED	EH N Y AH R D
ENURES	EH N Y AH R Z
ENURESES	IH N Y AH R IY Z AH Z
ENURESIS	IH N Y UH R AH S AH S
ENURESISES	IH N Y UH R AH S AY Z AH Z
ENURETIC	IH N Y AH R IY T AH K
ENURETICS	IH N Y AH R IY T AH S Z
ENWREATHE	EH N R IY DH
ENWREATHED	EH N R IY DH D
ENWREATHES	EH N R IY DH Z
ENWREATHING	EH N R IY DH IH NG
EPICURE	EH P IH K Y UH R
EPICUREAN	EH P AH K Y UH R IY AH N
EPICUREANISM	EH P IH K Y UH R IY AH N IH Z AH M
EPICUREANISMS	EH P IH K Y UH R IY AH N IH Z AH M Z
EPICUREANS	EH P IH K Y UH R IY AH N Z
EPICURES	EH P IH K Y UH R Z
EPIMERE	EH P AH M AH R
EPIMERES	EH P AH M IY R Z
ERASURE	IH R EY ZH ER
ERASURES	IH R EY ZH ER Z
ERE	EH R
ERECT	IH R EH K T
ERECTABLE	IH R EH K T AH B AH L
ERECTED	IH R EH K T AH D
ERECTED(2)	IH R EH K T IH D
ERECTER	IH R EH K T ER
ERECTERS	IH R EH K T ER Z
ERECTILE	AH R EH K T AH L
ERECTILITIES	AH R EH K T IH L AH T AY Z
ERECTILITY	AH R EH K T IH L AH T IY
ERECTING	IH R EH K T IH NG
ERECTION	IH R EH K SH AH N
ERECTIONS	IH R EH K SH AH N Z
ERECTIVE	IH R EH K T IH V
ERECTLY	IH R EH K T L IY
ERECTNESS	IH R EH K T N AH S
ERECTNESSES	IH R EH K T N AH S IH Z
ERECTOR	IH R EH K T ER
ERECTORS	IH R EH K T ER Z
ERECTS	IH R EH K T S
ERELONG	EH R AH L AH NG
EREMITE	EH R AH M AY T
EREMITES	EH R AH M AY T S
EREMITIC	EH R AH M AH T AH K
EREMITICAL	AH R EH M AH T IH S AH L
EREMITISM	EH R AH M AH T IH Z AH M
EREMITISMS	AH R EH M AH T AH Z AH M Z
EREMURI	AH R EH M Y AH R IY
EREMURUS	AH R EH M Y AH R AH S
ERENOW	EH R AH N OW
EREPSIN	AH R EH P S AH N
EREPSINS	AH R EH P S AH N Z
ERETHIC	EH R AH TH AH K
ERETHISM	EH R AH TH IH Z AH M
ERETHISMS	EH R AH TH AH Z AH M Z
EREWHILE	EH R UW AH L
EREWHILES	EH R UW AH L Z
ERRED	EH R D
ERYTHREMIA	EH R AH TH R IY M IY AH
ERYTHREMIAS	EH R AH TH R IY M IY AH Z
ESCRITOIRE	EH S K R AH T W AA R
ESCRITOIRES	EH S K R AH T W AA R Z
ESPALIERED	EH S AH L IY R D
ESPRESSO	EH S P R EH S OW
ESPRESSO(2)	EH K S P R EH S OW
ESPRESSOS	EH S P R EH S OW Z
ESPRESSOS(2)	EH K S P R EH S OW Z
ESQUIRE	EH S K W AY R
ESQUIRED	EH S K W AY ER D
ESQUIRES	EH S K W AY ER Z
ESTREAT	EH S T R IY T
ESTREATED	EH S T R IY EY T AH D
ESTREATING	EH S T R IY EY T AH NG
ESTREATS	EH S T R IY EY T S
ETAGERE	AH T EY JH AH R
ETAGERES	EH T AH JH IY R Z
ETHEREAL	IH TH IH R IY AH L
ETHEREALITIES	IH TH IH R IY AH L AH T IY Z
ETHEREALITY	IH TH IH R IY AH L AH T IY
ETHEREALIZATION	IH TH IH R IY AH L AH Z EY SH AH N
ETHEREALIZATIONS	IH TH IH R IY AH L AH Z EY SH AH N Z
ETHEREALIZE	IH TH IH R IY AH L AY Z
ETHEREALIZED	IH TH IH R IY AH L AY Z D
ETHEREALIZES	IH TH IH R IY AH L AY Z IH Z
ETHEREALIZING	IH TH IH R IY AH L AY Z IH NG
ETHEREALLY	IH TH IH R IY AH L IY
ETHEREALNESS	IH TH IH R IY AH L N AH S
ETHEREALNESSES	IH TH IH R IY AH L N AH S IH Z
EUCHRE	Y UW K ER
EUCHRED	Y UW K ER D
EUCHRES	Y UW K R Z
EUREKA	Y UH R IY K AH
EVERGREEN	EH V ER G R IY N
EVERGREENS	EH V ER G R IY N Z
EVERMORE	EH V ER M AO R
EVERYWHERE	EH V R IY W EH R
EVERYWHERE(2)	EH V R IY HH W EH R
EXCREMENT	EH K S K R AH M AH N T
EXCREMENTAL	IH K S R AH M EH N T AH L
EXCREMENTITIOUS	IH K S R AH M EH N T AH SH AH S
EXCREMENTS	IH K S R EH M AH N T S
EXCRESCENCE	EH K S K R EH S AH N S
EXCRESCENCES	EH K S K R EH S AH N S IH Z
EXCRESCENCIES	EH K S K R EH S AH N S IY Z
EXCRESCENCY	EH K S K R EH S AH N S IY
EXCRESCENT	EH K S K R EH S AH N T
EXCRESCENTLY	EH K S K R EH S AH N T L IY
EXCRETA	IH K S R EH T AH
EXCRETAL	EH K S K R IY T AH L
EXCRETE	IH K S K R IY T
EXCRETED	EH K S K R IY T IH D
EXCRETER	EH K S K R IY T ER
EXCRETERS	EH K S K R IY T ER Z
EXCRETES	EH K S K R IY T S
EXCRETING	EH K S K R IY T IH NG
EXCRETION	IH K S K R IY SH AH N
EXCRETIONS	EH K S K R IY SH AH N Z
EXCRETORY	EH K S K R AH T AO R IY
EXCURRENT	EH K S K ER AH N T
EXOSPHERE	IH G Z AA S AH R
EXOSPHERES	IH G Z AA S IY R Z
EXOSPORE	EH K S AA S P OW R
EXOSPORES	EH K S AA S P OW R Z
EXPENDITURE	IH K S P EH N D AH CH ER
EXPENDITURE(2)	IH K S P EH N D IH CH ER
EXPENDITURES	IH K S P EH N D AH CH ER Z
EXPENDITURES(2)	IH K S P EH N D IH CH ER Z
EXPIRE	IH K S P AY R
EXPIRED	IH K S P AY R D
EXPIRER	IH K S P AY ER ER
EXPIRERS	IH K S P AY ER ER Z
EXPIRES	IH K S P AY ER Z
EXPLORE	IH K S P L AO R
EXPLORED	IH K S P L AO R D
EXPLORER	IH K S P L AO R ER
EXPLORERS	IH K S P L AO R ER Z
EXPLORES	IH K S P L AO R Z
EXPOSURE	IH K S P OW ZH ER
EXPOSURES	IH K S P OW ZH ER Z
EXPRESS	IH K S P R EH S
EXPRESSAGE	IH K S P R EH S IH JH
EXPRESSAGES	IH K S P R EH S IH JH IH Z
EXPRESSED	IH K S P R EH S T
EXPRESSER	IH K S P R EH S ER
EXPRESSERS	IH K S P R EH S ER Z
EXPRESSES	IH K S P R EH S AH Z
EXPRESSES(2)	IH K S P R EH S IH Z
EXPRESSIBLE	IH K S P R EH S AH B AH L
EXPRESSING	IH K S P R EH S IH NG
EXPRESSION	IH K S P R EH SH AH N
EXPRESSIONAL	IH K S P R EH SH AH N AH L
EXPRESSIONISM	IH K S P R EH SH AH N IH Z AH M
EXPRESSIONISMS	IH K S P R EH SH AH N IH Z AH M Z
EXPRESSIONIST	IH K S P R EH SH AH N AH S T
EXPRESSIONISTIC	IH K S P R EH SH AH N IH S T IH K
EXPRESSIONISTICALLY	IH K S P R EH SH AH N IH S T IH K AH L IY
EXPRESSIONISTS	IH K S P R EH SH AH N IH S T S
EXPRESSIONLESS	IH K S P R EH SH AH N L IH S
EXPRESSIONLESSLY	IH K S P R EH SH AH N L AH S L IY
EXPRESSIONLESSNESS	IH K S P R EH SH AH N L AH S N AH S
EXPRESSIONLESSNESSES	IH K S P R EH SH AH N L AH S N AH S IH Z
EXPRESSIONS	IH K S P R EH SH AH N Z
EXPRESSIVE	IH K S P R EH S IH V
EXPRESSIVELY	IH K S P R EH S IH V L IY
EXPRESSIVENESS	IH K S P R EH S IH V N AH S
EXPRESSIVENESSES	IH K S P R EH S IH V N AH S IH Z
EXPRESSIVITIES	IH K S P R EH S IH V AH T IY Z
EXPRESSIVITY	EH K S P R AH S IH V IH T IY
EXPRESSLY	EH K S P R EH S L IY
EXPRESSMAN	IH K S P R EH S M AE N
EXPRESSMEN	IH K S P R EH S M EH N
EXPRESSO	IH K S P EH S OW
EXPRESSO(2)	EH K S P EH S OW
EXPRESSOS	IH K S P R EH S AA S
EXPRESSWAY	IH K S P R EH S W EY
EXPRESSWAYS	IH K S P R EH S W EY Z
EXTEMPORE	IH K S T EH M P AH R IY
EXTRACORPOREAL	EH K S T R AH K AO R P OW R IY AH L
EXTRACORPOREALLY	EH K S T R AH K AO R P OW R IY AH L IY
EXTRAORDINAIRE	EH K S T R AH AO R D IH N EH R
EXTRATERRESTRIAL	EH K S T R AH T ER EH S T R IY AH L
EXTRATERRESTRIALS	EH K S T R AH T ER EH S T R IY AH L Z
EXTREMA	IH K S T R IY M AH
EXTREME	IH K S T R IY M
EXTREMELY	IH K S T R IY M L IY
EXTREMENESS	IH K S T R IY M N AH S
EXTREMENESSES	IH K S T R IY M N AH S IH Z
EXTREMER	IH K S T R IY M ER
EXTREMES	IH K S T R IY M Z
EXTREMEST	IH K S T R IY M AH S T
EXTREMISM	IH K S T R EH M IH Z AH M
EXTREMISM(2)	IH K S T R IY M IH Z AH M
EXTREMISMS	IH K S T R IY M IH Z AH M Z
EXTREMIST	IH K S T R IY M IH S T
EXTREMISTS	IH K S T R IY M AH S T S
EXTREMITIES	EH K S T R EH M AH T IY Z
EXTREMITY	EH K S T R EH M AH T IY
EXTREMUM	IH K S T R EH M AH M
EYESORE	AY S AO R
EYESORES	AY S OW R Z
EYRE	EH R
EYRES	EY R Z
FACTORED	F AE K T ER D
FACTURE	F AE K CH ER
FACTURES	F AE K CH ER Z
FAILURE	F EY L Y ER
FAILURES	F EY L Y ER Z
FAIRED	F EH R D
FAIRER	F EH R ER
FAIREST	F EH R IH S T
FALTERED	F AA L T ER D
FALTERER	F AO L T ER ER
FALTERERS	F AO L T ER ER Z
FANFARE	F AE N F EH R
FANFARES	F AE N F EH R Z
FARE	F EH R
FARED	F EH R D
FARER	F EH R ER
FARERS	F EH R ER Z
FARES	F EH R Z
FAREWELL	F EH R W EH L
FAREWELLED	F AE ER W EH L D
FAREWELLING	F AE ER W EH L IH NG
FAREWELLS	F EH R W EH L Z
FARMERETTE	F AA R M ER EH T
FARMERETTES	F AA R M ER EH T S
FATHERED	F AA DH ER D
FAVORED	F EY V ER D
FAVORER	F EY V ER ER
FAVORERS	F EY V ER ER Z
FAVOURED	F EY V ER D
FAVOURER	F EY V ER ER
FAVOURERS	F EY V ER ER Z
FEARED	F IH R D
FEARER	F IH ER ER
FEARERS	F IH ER ER Z
FEATHERED	F EH DH ER D
FEATHEREDGE	F EH DH ER EH JH
FEATHEREDGED	F EH DH ER EH JH D
FEATHEREDGES	F EH DH ER EH JH IH Z
FEATHEREDGING	F EH DH ER EH JH IH NG
FEATURE	F IY CH ER
FEATURED	F IY CH ER D
FEATURELESS	F IY CH ER L AH S
FEATURES	F IY CH ER Z
FEATURETTE	F IY CH ER EH T
FEATURETTES	F IY CH ER EH T S
FELLMONGERED	F EH L M AH NG G ER D
FENDERED	F EH N D ER D
FENUGREEK	F EH N UW G R IY K
FENUGREEKS	F EH N Y AH G R IY K S
FERE	F IH R
FERES	F IY R Z
FERETORIES	F AH R EH T AH R AY Z
FERETORY	F EH R AH T AO R IY
FERREDOXIN	F EH R AH D AA K S AH N
FERREDOXINS	F EH R AH D AA K S AH N Z
FERREL	F EH R EH L
FERRELED	F EH R IY L D
FERRELING	F EH R IY L AH NG
FERRELLED	F EH R AH L D
FERRELLING	F EH R EH L AH NG
FERRELS	F EH R AH L Z
FERREOUS	F EH R IY AH S
FERRET	F EH R AH T
FERRETED	F EH R AH T AH D
FERRETED(2)	F EH R AH T IH D
FERRETER	F EH R AH T ER
FERRETERS	F EH R AH T ER Z
FERRETING	F EH R AH T IH NG
FERRETINGS	F EH R AH T IH NG Z
FERRETS	F EH R AH T S
FERRETY	F EH R AH T IY
FERROCONCRETE	F EH R OW K AA N K R IY T
FERROCONCRETES	F EH R OW K AA N K R IY T S
FESTERED	F EH S T ER D
FETTERED	F EH T ER D
FETTERER	F EH T ER ER
FETTERERS	F EH T ER ER Z
FEVERED	F IY V ER D
FIACRE	F AY AH K AH R
FIACRES	F AY AH K AH R Z
FIBERED	F AY B ER D
FIBRE	F AY B ER
FIBREBOARD	F AY B ER B AO R D
FIBREBOARDS	F IH B R AH B OW R D Z
FIBREFILL	F IH B R AH F AH L
FIBREFILLS	F IH B R AH F AH L Z
FIBREGLASS	F IH B R EH G L AH S
FIBREGLASSES	F IH B R EH G L AE S AH Z
FIBRES	F AY B AH R Z
FIELDFARE	F IY L D F EH R
FIELDFARES	F IY L D F EH R Z
FIGURE	F IH G Y ER
FIGURED	F IH G Y ER D
FIGUREHEAD	F IH G Y ER HH EH D
FIGUREHEADS	F IH G Y ER HH EH D Z
FIGURER	F IH G Y ER ER
FIGURERS	F IH G Y ER ER Z
FIGURES	F IH G Y ER Z
FILAGREE	F IH L AH G R IY IY
FILAGREED	F AH L AE G R IY D
FILAGREEING	F AH L AE G R IY AH NG
FILAGREES	F AH L AE G R IY Z
FILAREE	F AY L ER IY
FILAREES	F AY L ER IY Z
FILATURE	F AY L AH CH ER
FILATURES	F AY L AH CH ER Z
FILIBUSTERED	F IH L AH B AH S T ER D
FILIBUSTERER	F IH L AH B AH S T ER ER
FILIBUSTERERS	F IH L AH B AH S T ER ER Z
FILIGREE	F IH L AH G R IY
FILIGREED	F AH L IH G R IY D
FILIGREEING	F IH L AH G R IY IH NG
FILIGREES	F IH L AH G R IY Z
FILTERED	F IH L T ER D
FILTERER	F IH L T ER ER
FILTERERS	F IH L T ER ER Z
FINGERED	F IH NG G ER D
FINGERER	F IH NG G ER ER
FINGERERS	F IH NG G ER ER Z
FIORITURE	F AY AH R IH T Y AH R
FIRE	F AY ER
FIRE(2)	F AY R
FIREABLE	F AY ER AH B AH L
FIREARM	F AY ER AA R M
FIREARM(2)	F AY R AA R M
FIREARMS	F AY ER AA R M Z
FIREARMS(2)	F AY R AA R M Z
FIREBACK	F AY ER B AE K
FIREBACKS	F AY ER B AE K S
FIREBALL	F AY ER B AO L
FIREBALL(2)	F AY R B AO L
FIREBALLER	F AY ER B AO L ER
FIREBALLERS	F AY ER B AO L ER Z
FIREBALLING	F AY ER B AO L IH NG
FIREBALLS	F AY ER B AO L Z
FIREBALLS(2)	F AY R B AO L Z
FIREBASE	F AY ER B EY S
FIREBASES	F AY ER B EY S IH Z
FIREBIRD	F AY ER B ER D
FIREBIRDS	F AY ER B ER D Z
FIREBOAT	F AY ER B OW T
FIREBOATS	F AY ER B OW T S
FIREBOMB	F AY ER B AA M
FIREBOMB(2)	F AY R B AA M
FIREBOMBED	F AY R B AA M D
FIREBOMBING	F AY ER B AA M IH NG
FIREBOMBS	F AY R B AA M Z
FIREBOX	F AY ER B AA K S
FIREBOXES	F AY ER B AA K S IH Z
FIREBRAND	F AY ER B R AE N D
FIREBRANDS	F AY ER B R AE N D Z
FIREBRAT	F AH R EH B R AH T
FIREBRATS	F IH R AH B R EY T S
FIREBREAK	F AY ER B R EY K
FIREBREAKS	F AY ER B R EY K S
FIREBRICK	F AY ER B R IH K
FIREBRICKS	F AY ER B R IH K S
FIREBUG	F AY ER B AH G
FIREBUGS	F AY ER B AH G Z
FIRECLAY	F AY ER K L EY
FIRECLAYS	F AY ER K L EY Z
FIRECRACKER	F AY ER K R AE K ER
FIRECRACKERS	F AY ER K R AE K ER Z
FIRED	F AY ER D
FIREDAMP	F AY ER D AE M P
FIREDAMPS	F AY ER D AE M P S
FIREDOG	F AY ER D AO G
FIREDOGS	F AY ER D AO G Z
FIREDRAKE	F AY ER D R EY K
FIREDRAKES	F AY ER D R EY K S
FIREFANG	F AY ER F AE NG
FIREFANGED	F AY ER F AE NG D
FIREFANGING	F AY ER F AE NG IH NG
FIREFANGS	F AY ER F AE NG Z
FIREFIGHT	F AY R F AY T
FIREFIGHTER	F AY R F AY T ER
FIREFIGHTERS	F AY ER F AY T ER Z
FIREFIGHTING	F AY R F AY T IH NG
FIREFIGHTINGS	F AY ER F AY T IH NG Z
FIREFIGHTS	F AY R F AY T S
FIREFLIES	F AY ER F L AY Z
FIREFLY	F AY ER F L AY
FIREGUARD	F AY ER G AA R D
FIREGUARDS	F AY ER G AA R D Z
FIREHALL	F AY ER HH AO L
FIREHALLS	F AY ER HH AO L Z
FIREHOSE	F AY ER HH OW Z
FIREHOSES	F AY ER HH OW Z IH Z
FIREHOUSE	F AY ER HH AW S
FIREHOUSES	F AY ER HH AW S IH Z
FIRELESS	F AY ER L AH S
FIRELIGHT	F AY ER L AY T
FIRELIGHTS	F AY ER L AY T S
FIRELIT	F AY ER L IH T
FIRELOCK	F AY ER L AA K
FIRELOCKS	F AY ER L AA K S
FIREMAN	F AY R M AH N
FIREMANIC	F AY ER M AE N IH K
FIREMEN	F AY R M AH N
FIREPAN	F AY ER P AE N
FIREPANS	F AY ER P AE N Z
FIREPINK	F AY ER P IH NG K
FIREPINKS	F AY ER P IH NG K S
FIREPLACE	F AY ER P L EY S
FIREPLACED	F AY ER P L EY S T
FIREPLACES	F AY ER P L EY S AH Z
FIREPLACES(2)	F AY R P L EY S IH Z
FIREPLUG	F AY ER P L AH G
FIREPLUGS	F AY ER P L AH G Z
FIREPOT	F AY ER P AA T
FIREPOTS	F AY ER P AA T S
FIREPOWER	F AY R P AW ER
FIREPOWERS	F AY ER P AW ER Z
FIREPROOF	F AY ER P R UW F
FIREPROOFED	F AY ER P R UW F T
FIREPROOFING	F AY ER P R UW F IH NG
FIREPROOFS	F AY ER P R UW F S
FIRER	F AY ER ER
FIREROOM	F AY ER R UW M
FIREROOMS	F AY ER R UW M Z
FIRERS	F AY ER ER Z
FIRES	F AY ER Z
FIRES(2)	F AY R Z
FIRESIDE	F AY ER S AY D
FIRESIDES	F AY ER S AY D Z
FIRESTONE	F AY R S T OW N
FIRESTONES	F AY ER S T OW N Z
FIRESTORM	F AY R S T AO R M
FIRESTORMS	F AY ER S T AO R M Z
FIRETHORN	F AY ER TH AO R N
FIRETHORNS	F AY ER TH AO R N Z
FIRETRAP	F AY ER T R AE P
FIRETRAPS	F AY ER T R AE P S
FIREWALL	F AY R W AA L
FIREWALLED	F AY ER W AO L D
FIREWALLING	F AY ER W AO L IH NG
FIREWALLS	F AY ER W AO L Z
FIREWATER	F AY ER W AO T ER
FIREWATERS	F AY ER W AO T ER Z
FIREWEED	F AY ER W IY D
FIREWEEDS	F AY ER W IY D Z
FIREWOOD	F AY ER W UH D
FIREWOOD(2)	F AY R W UH D
FIREWOODS	F AY ER W UH D Z
FIREWORK	F AY R W ER K
FIREWORKS	F AY R W ER K S
FIREWORM	F AY ER W ER M
FIREWORMS	F AY ER W ER M Z
FIRMWARE	F ER M W EH R
FIRMWARES	F ER M W EH R Z
FISSURE	F IH SH ER
FISSURED	F IH SH ER D
FISSURES	F IH SH ER Z
FIXTURE	F IH K S CH ER
FIXTURES	F IH K S CH ER Z
FIXURE	F IH K SH ER
FIXURES	F IH K SH ER Z
FLARE	F L EH R
FLARED	F L EH R D
FLARES	F L EH R Z
FLAREUP	F L EH R AH P
FLAREUPS	F L EH R AH P S
FLATTERED	F L AE T ER D
FLATTERER	F L AE T ER ER
FLATTERERS	F L AE T ER ER Z
FLATWARE	F L AE T W EH R
FLATWARES	F L AE T W EH R Z
FLAVORED	F L EY V ER D
FLAVORER	F L EY V ER ER
FLAVORERS	F L EY V ER ER Z
FLAVOURED	F L AH V OW Y AH R D
FLEERED	F L IY R EH D
FLEXURE	F L EH K SH ER
FLEXURES	F L EH K SH ER Z
FLICHTERED	F L IH CH T IY R D
FLICKERED	F L IH K ER D
FLITTERED	F L IH T ER D
FLOORED	F L AO R D
FLOORER	F L OW R ER
FLOORERS	F L OW R ER Z
FLORENCE	F L AO R AH N S
FLORENCES	F L OW R AH N S IH Z
FLORESCENCE	F L AH R EH S AH N S
FLORESCENCES	F L AO R AH S EH N S AH Z
FLORESCENT	F L AH R EH S AH N T
FLORET	F L AO R AH T
FLORETS	F L AO R AH T S
FLORICULTURE	F L AO R AH K AH L T Y AH R
FLORICULTURES	F L AO R AH K AH L T Y AH R Z
FLOUNDERED	F L AW N D ER D
FLOURED	F L AW ER D
FLOWERED	F L AW ER D
FLOWERER	F L AW ER ER
FLOWERERS	F L AW ER ER Z
FLOWERET	F L OW AH R AH T
FLOWERETS	F L OW AH R AH T S
FLOWERETTE	F L AW ER EH T
FLOWERETTES	F L AW ER EH T S
FLUORENE	F L UW W AH R IY N
FLUORENES	F L UW W AH R IY N Z
FLUORESCE	F L UH R EH S
FLUORESCE(2)	F L AO R EH S
FLUORESCED	F L UH R EH S T
FLUORESCEIN	F L UH R EH S IY AH N
FLUORESCEINS	F L UH R EH S IY AH N Z
FLUORESCENCE	F L UH R EH S AH N S
FLUORESCENCES	F L UH R EH S AH N S IH Z
FLUORESCENT	F L UH R EH S AH N T
FLUORESCENT(2)	F L AO R EH S AH N T
FLUORESCENTS	F L UH R EH S AH N T S
FLUORESCENTS(2)	F L AO R EH S AH N T S
FLUORESCER	F L UH R EH S ER
FLUORESCERS	F L UH R EH S ER Z
FLUORESCES	F L UH R EH S IH Z
FLUORESCING	F L UH R EH S IH NG
FLUSTERED	F L AH S T ER D
FLUSTEREDLY	F L AH S T ER AH D L IY
FLUTTERED	F L AH T ER D
FLUTTERER	F L AH T ER ER
FLUTTERERS	F L AH T ER ER Z
FODDERED	F AA D ER D
FOLKLORE	F OW K L AO R
FOLKLORES	F OW K L OW R Z
FOOTREST	F UH T R EH S T
FOOTRESTS	F UH T R EH S T S
FOOTSORE	F UH T S OW R
FOOTSORENESS	F UH T S OW R N AH S
FOOTSORENESSES	F UH T S OW R N AH S IH Z
FORBEARER	F AO R B AE ER ER
FORBEARERS	F AO R B AE ER ER Z
FORBORE	F AO R B AO R
FORE	F AO R
FOREARM	F AO R AA R M
FOREARMED	F OW R AA R M D
FOREARMING	F OW R AA R M IH NG
FOREARMS	F AO R AA R M Z
FOREBAY	F OW R B EY
FOREBAYS	F OW R B EY Z
FOREBEAR	F AO R B EH R
FOREBEARS	F AO R B EH R Z
FOREBODE	F AO R B OW D
FOREBODED	F OW R B OW D IH D
FOREBODER	F OW R B OW D ER
FOREBODERS	F OW R B OW D ER Z
FOREBODES	F OW R B OW D Z
FOREBODIES	F OW R B AA D IY Z
FOREBODING	F AO R B OW D IH NG
FOREBODINGLY	F OW R B OW D IH NG L IY
FOREBODINGNESS	F OW R B OW D IH NG N AH S
FOREBODINGNESSES	F OW R B OW D IH NG N AH S IH Z
FOREBODINGS	F OW R B OW D IH NG Z
FOREBODY	F OW R B AA D IY
FOREBOOM	F OW R B UW M
FOREBOOMS	F OW R B UW M Z
FOREBRAIN	F AO R B R EY N
FOREBRAINS	F OW R B R EY N Z
FOREBY	F OW R B AY
FOREBYE	F AO R AH B AY
FORECADDIE	F OW R K EY D IY
FORECADDIES	F OW R K AE D IY Z
FORECAST	F AO R K AE S T
FORECASTABLE	F OW R K AE S T AH B AH L
FORECASTED	F AO R K AE S T IH D
FORECASTER	F AO R K AE S T ER
FORECASTERS	F AO R K AE S T ER Z
FORECASTING	F AO R K AE S T IH NG
FORECASTLE	F OW R K AE S AH L
FORECASTLES	F OW R K AE S AH L Z
FORECASTS	F AO R K AE S T S
FORECASTS(2)	F AO R K AE S
FORECHECK	F OW R CH EH K
FORECHECKED	F OW R CH EH K T
FORECHECKER	F OW R CH EH K ER
FORECHECKERS	F OW R CH EH K ER Z
FORECHECKING	F OW R CH EH K IH NG
FORECHECKS	F OW R CH EH K S
FORECLOSE	F AO R K L OW Z
FORECLOSED	F AO R K L OW Z D
FORECLOSES	F AO R K L OW Z IH Z
FORECLOSING	F AO R K L OW Z IH NG
FORECLOSURE	F AO R K L OW ZH ER
FORECLOSURES	F AO R K L OW ZH ER Z
FORECOURT	F OW R K OW R T
FORECOURTS	F OW R K OW R T S
FOREDATE	F OW R D EY T
FOREDATED	F OW R D EY T IH D
FOREDATES	F OW R D EY T S
FOREDATING	F OW R D EY T IH NG
FOREDECK	F OW R D EH K
FOREDECKS	F OW R D EH K S
FOREDID	F OW R D IH D
FOREDO	F OW R D UW
FOREDOES	F OW R D OW Z
FOREDOING	F OW R D OW IH NG
FOREDONE	F OW R D AH N
FOREDOOM	F OW R D UW M
FOREDOOMED	F OW R D UW M D
FOREDOOMING	F OW R D UW M IH NG
FOREDOOMS	F OW R D UW M Z
FOREFACE	F OW R F EY S
FOREFACES	F OW R F EY S IH Z
FOREFATHER	F AO R F AA DH ER
FOREFATHERS	F AO R F AA DH ER Z
FOREFEEL	F OW R F IY L
FOREFEELING	F OW R F IY L IH NG
FOREFEELS	F OW R F IY L Z
FOREFEET	F OW R F IY T
FOREFELT	F OW R F EH L T
FOREFEND	F OW R F EH N D
FOREFENDED	F OW R F EH N D IH D
FOREFENDING	F OW R F EH N D IH NG
FOREFENDS	F OW R F EH N D Z
FOREFINGER	F AO R F IH NG G ER
FOREFINGERS	F AO R F IH NG G ER Z
FOREFOOT	F AO R F UH T
FOREFRONT	F AO R F R AH N T
FOREFRONTS	F OW R F R AH N T S
FOREGATHER	F OW R G AE DH ER
FOREGATHERED	F OW R G AE DH ER D
FOREGATHERING	F OW R G AE DH ER IH NG
FOREGATHERS	F OW R G AE DH ER Z
FOREGO	F AO R G OW
FOREGOER	F OW R G OW ER
FOREGOERS	F OW R G OW ER Z
FOREGOES	F OW R G OW Z
FOREGOING	F AO R G OW IH NG
FOREGONE	F AO R G AO N
FOREGROUND	F AO R G R AW N D
FOREGROUNDED	F OW R G R AW N D IH D
FOREGROUNDING	F OW R G R AW N D IH NG
FOREGROUNDS	F OW R G R AW N D Z
FOREGUT	F OW R G AH T
FOREGUTS	F OW R G AH T S
FOREHAND	F AO R HH AE N D
FOREHANDED	F OW R HH AE N D IH D
FOREHANDEDLY	F OW R HH AE N D AH D L IY
FOREHANDEDNESS	F OW R HH AE N D AH D N AH S
FOREHANDEDNESSES	F OW R HH AE N D AH D N AH S IH Z
FOREHANDS	F AO R HH AE N D Z
FOREHEAD	F AO R HH EH D
FOREHEADS	F AO R HH EH D Z
FOREHOOF	F OW R HH UW F
FOREHOOFS	F OW R HH UW F S
FOREHOOVES	F OW R HH UW V Z
FOREIGN	F AO R AH N
FOREIGN(2)	F AA R AH N
FOREIGNER	F AO R AH N ER
FOREIGNER(2)	F AA R AH N ER
FOREIGNER(3)	F AO R N ER
FOREIGNER(4)	F AA R N ER
FOREIGNERS	F AO R AH N ER Z
FOREIGNERS(2)	F AA R AH N ER Z
FOREIGNERS(3)	F AO R N ER Z
FOREIGNERS(4)	F AA R N ER Z
FOREIGNISM	F AO R AH N IH Z AH M
FOREIGNISMS	F AO R AH N IH Z AH M Z
FOREIGNNESS	F AO R AH N AH S
FOREIGNNESSES	F AO R AH N AH S IH Z
FOREJUDGE	F OW R JH AH JH
FOREJUDGED	F OW R JH AH JH D
FOREJUDGES	F OW R JH AH JH IH Z
FOREJUDGING	F OW R JH AH JH IH NG
FOREKNEW	F OW R N UW
JUBA	JH UW B AH
IF	IH F
MUENSTER	M Y UW N S T ER
PE	P IY
BAKSHEESH	B AE K IY SH
NULL	N AH L
TEAHOUSE	T IY HH AW S
