SH	EH S
ABASH	AH B AE SH
ABASHED	AH B AE SH T
ABASHES	AH B AE SH IH Z
ABASHING	AH B AE SH IH NG
ABASHMENT	AH B AE SH M AH N T
ABASHMENTS	AH B AE SH M AH N T S
ABLUSH	AH B L AH SH
ABOLISH	AH B AA L IH SH
ABOLISHABLE	AH B AA L IH SH AH B AH L
ABOLISHED	AH B AA L IH SH T
ABOLISHER	AH B AA L IH SH ER
ABOLISHERS	AH B AA L IH SH ER Z
ABOLISHES	AH B AA L IH SH IH Z
ABOLISHING	AH B AA L IH SH IH NG
ABOLISHMENT	AH B AA L IH SH M AH N T
ABOLISHMENTS	AH B AA L IH SH M AH N T S
ACCOMPLISH	AH K AA M P L IH SH
ACCOMPLISHABLE	AH K AA M P L IH SH AH B AH L
ACCOMPLISHED	AH K AA M P L IH SH T
ACCOMPLISHER	AH K AA M P L IH SH ER
ACCOMPLISHERS	AH K AA M P L IH SH ER Z
ACCOMPLISHES	AH K AA M P L IH SH IH Z
ACCOMPLISHING	AH K AA M P L IH SH IH NG
ACCOMPLISHMENT	AH K AA M P L IH SH M AH N T
ACCOMPLISHMENTS	AH K AA M P L IH SH M AH N T S
ACCOUNTANTSHIP	AH K AW N T AH N T SH IH P
ACCOUNTANTSHIPS	AH K AW N T AH N T SH IH P S
ACQUAINTANCESHIP	AH K W EY N T AH N S SH IH P
ACQUAINTANCESHIPS	AH K W EY N T AH N S SH IH P S
ACTORISH	AE K T ER IH SH
ADMONISH	AE D M AA N IH SH
ADMONISHED	AH D M AA N IH SH T
ADMONISHER	AE D M AA N IH SH ER
ADMONISHERS	AE D M AA N IH SH ER Z
ADMONISHES	AE D M AA N IH SH IH Z
ADMONISHING	AE D M AA N IH SH IH NG
ADMONISHINGLY	AE D M AA N IH SH IH NG L IY
ADMONISHMENT	AE D M AA N IH SH M EH N T
ADMONISHMENTS	AE D M AA N IH SH M AH N T S
AFRESH	AH F R EH SH
AFTERSHAVE	AE F T ER SH EY V
AFTERSHAVES	AE F T ER SH EY V Z
AFTERSHOCK	AE F T ER SH AA K
AFTERSHOCKS	AE F T ER SH AA K S
AGUISH	EY G Y UW IH SH
AGUISHLY	EY G Y UW IH SH L IY
AIRBRUSH	AH IH R B R AH SH
AIRBRUSHED	AH IH R B R AH SH T
AIRBRUSHES	AH IH R B R AH SH IH Z
AIRBRUSHING	AH IH R B R AH SH IH NG
AIRMANSHIP	AH IH R M AE N SH IH P
AIRMANSHIPS	AH IH R M AE N SH IH P S
AIRSHED	AH IH R SH EH D
AIRSHEDS	AH IH R SH EH D Z
AIRSHIP	EH R SH IH P
AIRSHIPS	EH R SH IH P S
ALMSHOUSE	AE L M SH AW Z
ALMSHOUSES	AE L M SH AW Z AH Z
ALONGSHORE	AH L AO NG SH OW R
AMATEURISH	AE M AH CH ER IH SH
AMATEURISHLY	AE M AH T ER IH SH L IY
AMATEURISHNESS	AE M AH T ER IH SH N AH S
AMATEURISHNESSES	AE M AH T ER IH SH N AH S IH Z
AMBASSADORSHIP	AE M B AE S AH D ER SH IH P
AMBASSADORSHIPS	AE M B AE S AH D ER SH IH P S
AMBUSH	AE M B UH SH
AMBUSHED	AE M B UH SH T
AMBUSHER	AE M B UH SH ER
AMBUSHERS	AE M B UH SH ER Z
AMBUSHES	AE M B UH SH IH Z
AMBUSHING	AE M B UH SH IH NG
AMBUSHMENT	AE M B UH SH M AH N T
AMBUSHMENTS	AE M B UH SH M AH N T S
AMIDSHIP	AH M IH D SH IH P
AMIDSHIPS	AH M IH D SH IH P S
ANGELFISH	EY N JH AH L F IH SH
ANGELFISHES	EY N JH AH L F IH SH IH Z
ANGLERFISH	AE NG G AH L ER F IH SH
ANGLERFISHES	AE NG G AH L ER F IH SH IH Z
ANGUISH	AE NG G W IH SH
ANGUISHED	AE NG G W IH SH T
ANGUISHES	AE NG G W IH SH IH Z
ANGUISHING	AE NG G W IH SH IH NG
ANKUSH	AE NG K AH SH
ANKUSHES	AE NG K AH SH AH Z
ANTIBACKLASH	AE N T AY B AE K L AE SH
ANTICENSORSHIP	AE N T AY S EH N S ER SH IH P
ANTIESTABLISHMENT	AE N T AY IH S T AE B L IH SH M AH N T
ANTIFASHION	AE N T AY F AE SH AH N
ANTIFASHIONABLE	AE N T AY F AE SH AH N AH B AH L
ANTIFASHIONS	AE N T AY F AE SH AH N Z
ANTISHARK	AE N T AY SH AA R K
ANTISHIP	AE N T AY SH IH P
ANTISHOCK	AE N T AY SH AA K
ANTISHOPLIFTING	AE N T AY SH AA P L IH F T IH NG
ANTITARNISH	AE N T AY T AA R N IH SH
APISH	EY P IH SH
APISHLY	EY P IH SH L IY
APISHNESS	EY P IH SH N AH S
APISHNESSES	EY P IH SH N AH S IH Z
APOSTLESHIP	AH P AA S AH L SH IH P
APOSTLESHIPS	AH P AA S AH L SH IH P S
APPRENTICESHIP	AH P R EH N T AH S SH IH P
APPRENTICESHIPS	AH P R EH N T AH S SH IH P S
ARCHBISHOP	AA R CH B IH SH AH P
ARCHBISHOPRIC	AA R K B AH SH AH P R AH K
ARCHBISHOPRICS	AA R K B AH SH AA P R AH S Z
ARCHBISHOPS	AA R CH B IH SH AH P S
ARCHERFISH	AA R CH ER F IH SH
ARCHERFISHES	AA R CH ER F IH SH IH Z
ARHATSHIP	AA R HH AH T SH IH P
ARHATSHIPS	AA R HH AH T SH IH P S
ARSHIN	AA R SH AH N
ARSHINS	AA R SH AH N Z
ARTISANSHIP	AA R T AH Z AH N SH IH P
ARTISANSHIPS	AA R T AH Z AH N SH IH P S
ASH	AE SH
ASHAMED	AH SH EY M D
ASHAMEDLY	AH SH EY M AH D L IY
ASHCAN	AE SH K AE N
ASHCANS	AE SH K AE N Z
ASHED	AH SH EH D
ASHEN	AE SH AH N
ASHES	AE SH IH Z
ASHFALL	AE SH F AO L
ASHFALLS	AE SH F AO L Z
ASHIER	AH SH AY ER
ASHIEST	AH SH AY AH S T
ASHINESS	AH SH AY N AH S
ASHINESSES	AH SH AY N AH S IH Z
ASHING	AE SH IH NG
ASHLAR	AE SH L AH R
ASHLARED	AE SH L AH R D
ASHLARING	AE SH L AH R AH NG
ASHLARS	AE SH L AH R Z
ASHLER	AE SH L AH R
ASHLERED	AE SH L IY R D
ASHLERING	AE SH L IY R AH NG
ASHLERS	AE SH L AH R Z
ASHLESS	AE SH L AH S
ASHMAN	AE SH M AH N
ASHMEN	AE SH M EH N
ASHORE	AH SH AO R
ASHPLANT	AE SH P L AE N T
ASHPLANTS	AE SH P L AE N T S
ASHRAM	AE SH R AE M
ASHRAMS	AE SH R AE M Z
ASHTRAY	AE SH T R EY
ASHTRAYS	AE SH T R EY Z
ASHY	AE SH IY
ASPISH	AE S AH SH
ASSHOLE	AE S HH OW L
ASSHOLES	AE S HH OW L Z
ASSISTANTSHIP	AH S IH S T AH N T SH IH P
ASSISTANTSHIPS	AH S IH S T AH N T SH IH P S
ASSOCIATESHIP	AH S OW S IY AH T SH IH P
ASSOCIATESHIPS	AH S OW S IY AH T SH IH P S
ASTONISH	AH S T AA N IH SH
ASTONISHED	AH S T AA N IH SH T
ASTONISHES	AH S T AA N IH SH IH Z
ASTONISHING	AH S T AA N IH SH IH NG
ASTONISHINGLY	AH S T AA N IH SH IH NG L IY
ASTONISHMENT	AH S T AA N IH SH M AH N T
ASTONISHMENTS	AH S T AA N IH SH M AH N T S
ATHWARTSHIP	AH TH W AO R T SH IH P
ATHWARTSHIPS	AH TH W AO R T SH IH P S
ATTORNEYSHIP	AH T ER N IY SH IH P
ATTORNEYSHIPS	AH T ER N IY SH IH P S
AUTHORSHIP	AO TH ER SH IH P
AUTHORSHIPS	AO TH ER SH IH P S
AWASH	AH W AA SH
BABUSHKA	B AH B UH SH K AH
BABUSHKAS	B AH B UH SH K AH Z
BABYISH	B EY B IY IH SH
BACKLASH	B AE K L AE SH
BACKLASHED	B AE K L AE SH T
BACKLASHER	B AE K L AE SH ER
BACKLASHERS	B AE K L AE SH ER Z
BACKLASHES	B AE K L AE SH AH Z
BACKLASHING	B AE K L AE SH IH NG
BACKRUSH	B AE K R AH SH
BACKRUSHES	B AE K R AH SH IH Z
BACKSLASH	B AE K S L AE SH
BACKSLASHES	B AE K S L AE SH AH Z
BACKSPLASH	B AE K S P L AE SH
BACKSPLASHES	B AE K S P L AE SH IH Z
BACKWASH	B AE K W AA SH
BACKWASHED	B AE K W AA SH T
BACKWASHES	B AE K W AA SH IH Z
BACKWASHING	B AE K W AA SH IH NG
BAILIFFSHIP	B EY L AH F SH IH P
BAILIFFSHIPS	B EY L AH F SH IH P S
BAIRNISH	B AE AH R N AH SH
BAKESHOP	B EY K SH AA P
BAKESHOPS	B EY K SH AA P S
BAKSHEESH	B AE K IY SH
BAKSHEESHES	B AE K IY SH AH Z
BAKSHISH	B AE K AH SH
BAKSHISHED	B AE K AH SH T
BAKSHISHES	B AE K AH SH AH Z
BAKSHISHING	B AE K AH SH AH NG
BALDERDASH	B AO L D ER D AE SH
BALDERDASHES	B AO L D ER D AE SH IH Z
BALDISH	B AO L D IH SH
BANISH	B AE N IH SH
BANISHED	B AE N IH SH T
BANISHER	B AE N IH SH ER
BANISHERS	B AE N IH SH ER Z
BANISHES	B AE N IH SH IH Z
BANISHING	B AE N IH SH IH NG
BANISHMENT	B AE N IH SH M AH N T
BANISHMENTS	B AE N IH SH M AH N T S
BANSHEE	B AE N SH IY
BANSHEES	B AE N SH IY Z
BANSHIE	B AE N SH AY
BANSHIES	B AE N SH AY Z
BARBERSHOP	B AA R B ER SH AA P
BARBERSHOPS	B AA R B ER SH AA P S
BASH	B AE SH
BASHAW	B AH SH AO
BASHAWS	B AH SH AO Z
BASHED	B AE SH T
BASHER	B AE SH ER
BASHERS	B AE SH ER Z
BASHES	B AE SH IH Z
BASHFUL	B AE SH F AH L
BASHFULLY	B AE SH F AH L IY
BASHFULNESS	B AE SH F AH L N AH S
BASHFULNESSES	B AE SH F AH L N AH S IH Z
BASHING	B AE SH IH NG
BASHLYK	B AE SH L AH K
BASHLYKS	B AE SH L AH K S
BATFISH	B AE T F IH SH
BATFISHES	B AE T F IH SH IH Z
BATTLESHIP	B AE T AH L SH IH P
BATTLESHIPS	B AE T AH L SH IH P S
BEAMISH	B IY M IH SH
BEAMISHLY	B IY M IH SH L IY
BEARISH	B EH R IH SH
BEARISHLY	B EH R IH SH L IY
BEARISHNESS	B EH R IH SH N AH S
BEARISHNESSES	B AE ER IH SH N AH S IH Z
BEAUISH	B OW IH SH
BEDSHEET	B EH D SH IY T
BEDSHEETS	B EH D SH IY T S
BESHADOW	B IH SH AE D OW
BESHADOWED	B IH SH AE D OW D
BESHADOWING	B IH SH AE D OW IH NG
BESHADOWS	B IH SH AE D OW Z
BESHAME	B IH SH EY M
BESHAMED	B IH SH EY M D
BESHAMES	B IH SH EY M Z
BESHAMING	B IH SH EY M IH NG
BESHIVER	B IH SH IH V ER
BESHIVERED	B IH SH IH V ER D
BESHIVERING	B IH SH IH V ER IH NG
BESHIVERS	B IH SH IH V ER Z
BESHOUT	B IH SH AW T
BESHOUTED	B IH SH AW T IH D
BESHOUTING	B IH SH AW T IH NG
BESHOUTS	B IH SH AW T S
BESHREW	B IH SH R UW
BESHREWED	B IH SH R UW D
BESHREWING	B IH SH R UW IH NG
BESHREWS	B IH SH R UW Z
BESHROUD	B IH SH R AW D
BESHROUDED	B IH SH R AW D IH D
BESHROUDING	B IH SH R AW D IH NG
BESHROUDS	B IH SH R AW D Z
BIGGISH	B IH G IH SH
BIGSHOT	B IH G SH AA T
BIGSHOTS	B IH G SH AA T S
BILLFISH	B IH L F IH SH
BILLFISHES	B IH L F IH SH IH Z
BIPARTISANSHIP	B AY P AA R T AH Z AH N SH IH P
BIPARTISANSHIPS	B AY P AA R T AH Z AH N SH IH P S
BIRDSHOT	B ER D SH AA T
BIRDSHOTS	B ER D SH AA T S
BISHOP	B IH SH AH P
BISHOPED	B IH SH AH P T
BISHOPING	B IH SH AH P IH NG
BISHOPRIC	B AY SH AA P R AH K
BISHOPRICS	B IH SH AH P R IH K S
BISHOPS	B IH SH AH P S
BITTERBRUSH	B IH T ER B R AH SH
BITTERBRUSHES	B IH T ER B R AH SH IH Z
BITTERISH	B IH T ER IH SH
BLACKFISH	B L AE K F IH SH
BLACKFISHES	B L AE K F IH SH IH Z
BLACKISH	B L AE K IH SH
BLANDISH	B L AE N D IH SH
BLANDISHED	B L AE N D IH SH T
BLANDISHER	B L AE N D IH SH ER
BLANDISHERS	B L AE N D IH SH ER Z
BLANDISHES	B L AE N D IH SH IH Z
BLANDISHING	B L AE N D IH SH IH NG
BLANDISHMENT	B L AE N D IH SH M AH N T
BLANDISHMENTS	B L AE N D IH SH M AH N T S
BLEAKISH	B L IY K IH SH
BLEMISH	B L EH M IH SH
BLEMISHED	B L EH M IH SH T
BLEMISHES	B L EH M IH SH IH Z
BLEMISHING	B L EH M IH SH IH NG
BLIMPISH	B L IH M P IH SH
BLIMPISHLY	B L IH M P IH SH L IY
BLIMPISHNESS	B L IH M P IH SH N AH S
BLIMPISHNESSES	B L IH M P IH SH N AH S IH Z
BLINDFISH	B L AY N D F IH SH
BLINDFISHES	B L AY N D F IH SH IH Z
BLOCKISH	B L AA K IH SH
BLONDISH	B L AA N D IH SH
BLOODSHED	B L AH D SH EH D
BLOODSHEDS	B L AH D SH EH D Z
BLOODSHOT	B L AH D SH AA T
BLOWFISH	B L OW F IH SH
BLOWFISHES	B L OW F IH SH IH Z
BLUEFISH	B L UW F IH SH
BLUEFISHES	B L UW F IH SH IH Z
BLUEISH	B L UW IH SH
BLUESHIFT	B L UW SH IH F T
BLUESHIFTED	B L UW SH IH F T IH D
BLUESHIFTS	B L UW SH IH F T S
BLUISH	B L UW IH SH
BLUISHNESS	B L UW IH SH N AH S
BLUISHNESSES	B L UW IH SH N AH S IH Z
BLUSH	B L AH SH
BLUSHED	B L AH SH T
BLUSHER	B L AH SH ER
BLUSHERS	B L AH SH ER Z
BLUSHES	B L AH SH AH Z
BLUSHES(2)	B L AH SH IH Z
BLUSHFUL	B L AH SH F AH L
BLUSHING	B L AH SH IH NG
BLUSHINGLY	B L AH SH IH NG L IY
BOARFISH	B OW R F IH SH
BOARFISHES	B OW R F IH SH IH Z
BOARISH	B OW R IH SH
BOGGISH	B AO G IH SH
BOLSHEVISM	B OW L SH AH V IH Z AH M
BOLSHEVISMS	B OW L SH AH V IH Z AH M Z
BOLSHEVIZE	B OW L SH AH V AY Z
BOLSHEVIZED	B OW L SH AH V AY Z D
BOLSHEVIZES	B OW L SH AH V AY Z AH Z
BOLSHEVIZING	B OW L SH AH V AY Z AH NG
BOLSHIE	B OW L SH AY
BOLSHIES	B OW L SH AY Z
BOLSHY	B OW L SH IY
BOMBSHELL	B AA M SH EH L
BOMBSHELLS	B AA M SH EH L Z
BONEFISH	B OW N F IH SH
BONEFISHES	B OW N F IH SH IH Z
BONEFISHING	B OW N F IH SH IH NG
BONEFISHINGS	B OW N F IH SH IH NG Z
BOOBISH	B UW B IY IH SH
BOOKISH	B UH K IH SH
BOOKISHLY	B UH K IH SH L IY
BOOKISHNESS	B UH K IH SH N AH S
BOOKISHNESSES	B UH K IH SH N AH S IH Z
BOOKSHELF	B UH K SH EH L F
BOOKSHELVES	B UH K SH EH L V Z
BOOKSHOP	B UH K SH AA P
BOOKSHOPS	B UH K SH AA P S
BOORISH	B UH R IH SH
BOORISHLY	B UH R IH SH L IY
BOORISHNESS	B UH R IH SH N AH S
BOORISHNESSES	B UH R IH SH N AH S IH Z
BORSHT	B AO R SH T
BORSHTS	B AO R SH T S
BOSH	B AA SH
BOSHBOK	B AA SH B AH K
BOSHBOKS	B AA SH B AH K S
BOSHES	B AA SH AH Z
BOSHVARK	B AA SH V AH R K
BOSHVARKS	B AA SH V AH R K S
BOTTLEBRUSH	B AA T AH L B R AH SH
BOTTLEBRUSHES	B AA T AH L B R AH SH IH Z
BOUNDERISH	B AW N D ER IH SH
BOWSHOT	B AW SH AA T
BOWSHOTS	B AW SH AA T S
BOXFISH	B AA K S F IH SH
BOXFISHES	B AA K S F IH SH IH Z
BOYISH	B OY IH SH
BOYISHLY	B OY IH SH L IY
BOYISHNESS	B OY IH SH N AH S
BOYISHNESSES	B OY IH SH N AH S IH Z
BRACKISH	B R AE K IH SH
BRACKISHNESS	B R AE K IH SH N AH S
BRACKISHNESSES	B R AE K IH SH N AH S IH Z
BRAINISH	B R EY N IH SH
BRAINWASH	B R EY N W AA SH
BRAINWASHED	B R EY N W AA SH T
BRAINWASHER	B R EY N W AA SH ER
BRAINWASHERS	B R EY N W AA SH ER Z
BRAINWASHES	B R EY N W AA SH AH Z
BRAINWASHING	B R EY N W AA SH IH NG
BRAINWASHINGS	B R EY N W AA SH IH NG Z
BRANDISH	B R AE N D IH SH
BRANDISHED	B R AE N D IH SH T
BRANDISHES	B R AE N D IH SH IH Z
BRANDISHING	B R AE N D IH SH IH NG
BRASH	B R AE SH
BRASHER	B R AE SH ER
BRASHES	B R AE SH IH Z
BRASHEST	B R AE SH AH S T
BRASHIER	B R AE SH IY ER
BRASHIEST	B R AE SH IY AH S T
BRASHLY	B R AE SH L IY
BRASHNESS	B R AE SH N AH S
BRASHNESSES	B R AE SH N AH S IH Z
BRASHY	B R AE SH IY
BRASSISH	B R AE S IH SH
BRATTISH	B R AE T AH SH
BRINISH	B R AY N AH SH
BRINKMANSHIP	B R IH NG K M AH N SH IH P
BRINKMANSHIPS	B R IH NG K M AE N SH IH P S
BRINKSMANSHIP	B R IH NG K S M AH N SH IH P
BRINKSMANSHIPS	B R IH NG K S M AE N SH IH P S
BROADISH	B R AO D IH SH
BROADSHEET	B R AO D SH IY T
BROADSHEETS	B R AO D SH IY T S
BROGUISH	B R AA G Y UW AH SH
BROWNISH	B R AW N IH SH
BROWNSHIRT	B R AW N SH ER T
BROWNSHIRTS	B R AW N SH ER T S
BRUSH	B R AH SH
BRUSHABILITIES	B R AH SH AH B IH L AH T EH Z
BRUSHABILITY	B R AH SH AH B IH L AH T EH
BRUSHBACK	B R AH SH B AE K
BRUSHBACKS	B R AH SH B AE K S
BRUSHED	B R AH SH T
BRUSHER	B R AH SH ER
BRUSHERS	B R AH SH ER Z
BRUSHES	B R AH SH IH Z
BRUSHFIRE	B R AH SH F AY R
BRUSHFIRES	B R AH SH F AY R Z
BRUSHIER	B R AH SH IY ER
BRUSHIEST	B R AH SH IY AH S T
BRUSHING	B R AH SH IH NG
BRUSHLAND	B R AH SH L AE N D
BRUSHLANDS	B R AH SH L AE N D Z
BRUSHOFF	B R AH SH AO F
BRUSHOFFS	B R AH SH AO F S
BRUSHUP	B R AH SH AH P
BRUSHUPS	B R AH SH AH P S
BRUSHWOOD	B R AH SH W UH D
BRUSHWOODS	B R AH SH W UH D Z
BRUSHWORK	B R AH SH W ER K
BRUSHWORKS	B R AH SH W ER K S
BRUSHY	B R AH SH IY
BRUTISH	B R UW T IH SH
BRUTISHLY	B R UW T IH SH L IY
BRUTISHNESS	B R UW T IH SH N AH S
BRUTISHNESSES	B R UW T IH SH N AH S IH Z
BUCCANEERISH	B AH K EY N AH R AH SH
BUCKISH	B AH K IH SH
BUCKSHEE	B AH K IY IY
BUCKSHEES	B AH K IY Z
BUCKSHOT	B AH K SH AA T
BUCKSHOTS	B AH K SH AA T S
BUFFALOFISH	B AH F AH L OW F IH SH
BUFFALOFISHES	B AH F AH L OW F IH SH IH Z
BUFFOONISH	B AH F UW N IH SH
BUGSHA	B AH G SH AH
BUGSHAS	B AH G SH AH Z
BULLISH	B UH L IH SH
BULLISHLY	B UH L IH SH L IY
BULLISHNESS	B UH L IH SH N AH S
BULLISHNESSES	B UH L IH SH N AH S IH Z
BULLRUSH	B UH L R AH SH
BULLRUSHES	B UH L R AH SH IH Z
BULLSHIT	B UH L SH IH T
BULLSHITS	B UH L SH IH T S
BULLSHITTED	B UH L SH IH T IH D
BULLSHITTING	B UH L SH IH T IH NG
BULLSHOT	B UH L SH AA T
BULLSHOTS	B UH L SH AA T S
BULRUSH	B UH L R AH SH
BULRUSHES	B UH L R AH SH AH Z
BUMBERSHOOT	B AH M B IY ER SH UW T
BUMBERSHOOTS	B AH M B IY ER SH UW T S
BUMPKINISH	B AH M P K IH N IH SH
BUQSHA	B AH K AH
BUQSHAS	B AH K AH Z
BURNISH	B ER N IH SH
BURNISHED	B ER N IH SH T
BURNISHER	B ER N IH SH ER
BURNISHERS	B ER N IH SH ER Z
BURNISHES	B ER N IH SH IH Z
BURNISHING	B ER N IH SH IH NG
BURNISHINGS	B ER N IH SH IH NG Z
BUSH	B UH SH
BUSHBUCK	B UH SH B AH K
BUSHBUCKS	B UH SH B AH K S
BUSHED	B UH SH T
BUSHEL	B UH SH AH L
BUSHELED	B UH SH AH L D
BUSHELER	B UH SH AH L ER
BUSHELERS	B UH SH AH L ER Z
BUSHELING	B UH SH AH L IH NG
BUSHELLED	B UH SH AH L D
BUSHELLING	B UH SH AH L IH NG
BUSHELS	B UH SH AH L Z
BUSHER	B UH SH ER
BUSHERS	B UH SH ER Z
BUSHES	B UH SH AH Z
BUSHFIRE	B UH SH F AY ER
BUSHFIRES	B UH SH F AY ER Z
BUSHGOAT	B UH SH G OW T
BUSHGOATS	B UH SH G OW T S
BUSHIDO	B AH SH AH D OW
BUSHIDOS	B UH SH AH D AA S
BUSHIER	B UH SH IY ER
BUSHIEST	B UH SH IY AH S T
BUSHILY	B UH SH IY L IY
BUSHINESS	B UH SH IY N AH S
BUSHINESSES	B UH SH IY N AH S IH Z
BUSHING	B UH SH IH NG
BUSHINGS	B UH SH IH NG Z
BUSHLAND	B UH SH L AE N D
BUSHLANDS	B UH SH L AE N D Z
BUSHLESS	B UH SH L AH S
BUSHLIKE	B UH SH L AY K
BUSHMAN	B UH SH M AH N
BUSHMASTER	B UH SH M AE S T ER
BUSHMASTERS	B UH SH M AE S T ER Z
BUSHMEN	B UH SH M EH N
BUSHPIG	B UH SH P IH G
BUSHPIGS	B UH SH P IH G Z
BUSHRANGER	B UH SH R EY N JH ER
BUSHRANGERS	B UH SH R EY N JH ER Z
BUSHRANGING	B UH SH R EY N JH IH NG
BUSHRANGINGS	B UH SH R EY N JH IH NG Z
BUSHTIT	B UH SH T IH T
BUSHTITS	B UH SH T IH T S
BUSHWA	B AH SH W AH
BUSHWAH	B AH SH W AH
BUSHWAHS	B AH SH W AH Z
BUSHWAS	B AH SH W AH Z
BUSHWHACK	B UH SH W AE K
BUSHWHACKED	B UH SH W AE K T
BUSHWHACKER	B UH SH W AE K ER
BUSHWHACKERS	B UH SH W AE K ER Z
BUSHWHACKING	B UH SH W AE K IH NG
BUSHWHACKS	B UH SH W AE K S
BUSHY	B UH SH IY
BUTTERFISH	B AH T ER F IH SH
BUTTERFISHES	B AH T ER F IH SH IH Z
BUTTONBUSH	B AH T AH N B UH SH
BUTTONBUSHES	B AH T AH N B UH SH IH Z
CABOSHED	K AE B AH SH T
CADDISH	K EY D IH SH
CADDISHLY	K EY D IH SH L IY
CADDISHNESS	K EY D IH SH N AH S
CADDISHNESSES	K EY D IH SH N AH S IH Z
CADETSHIP	K AH D EH T SH IH P
CADETSHIPS	K AH D EH T SH IH P S
CALABASH	K AE L AH B AH SH
CALABASHES	K AH L AE B AH SH AH Z
CALASH	K AE L AH SH
CALASHES	K AE L AH SH AH Z
CALIPASH	K AE L AH P AH SH
CALIPASHES	K AH L IH P AH SH AH Z
CAMSHAFT	K AE M SH AE F T
CAMSHAFTS	K AE M SH AE F T S
CANDLEFISH	K AE N D AH L F IH SH
CANDLEFISHES	K AE N D AH L F IH SH IH Z
CAPTAINSHIP	K AE P T AH N SH IH P
CAPTAINSHIPS	K AE P T AH N SH IH P S
CARDINALSHIP	K AA R D AH N AH L SH IH P
CARDINALSHIPS	K AA R D AH N AH L SH IH P S
CARDSHARP	K AA R D SH AA R P
CARDSHARPER	K AA R D SH AA R P ER
CARDSHARPERS	K AA R D SH AA R P ER Z
CARDSHARPS	K AA R D SH AA R P S
CARLISH	K AA R L IH SH
CARTOONISH	K AA R T UW N IH SH
CARTOONISHLY	K AA R T UW N IH SH L IY
CARWASH	K AA R W AA SH
CARWASHES	K AA R W AA SH IH Z
CASH	K AE SH
CASHABLE	K AE SH AH B AH L
CASHAW	K AE SH AH
CASHAWS	K AE SH AH Z
CASHBOOK	K AE SH B UH K
CASHBOOKS	K AE SH B UH K S
CASHBOX	K AE SH B AA K S
CASHBOXES	K AE SH B AA K S IH Z
CASHED	K AE SH T
CASHES	K AE SH IH Z
CASHEW	K AE SH UW
CASHEWS	K AE SH UW Z
CASHIER	K AE SH IH R
CASHIERED	K AE SH IH R D
CASHIERING	K AE SH IY ER IH NG
CASHIERS	K AE SH IH R Z
CASHING	K AE SH IH NG
CASHLESS	K AE SH L AH S
CASHMERE	K AE ZH M IH R
CASHMERES	K AE ZH M IH R Z
CASHOO	K AE SH UW
CASHOOS	K AH SH UW Z
CATFISH	K AE T F IH SH
CATFISHES	K AE T F IH SH IH Z
CATTISH	K AE T IH SH
CAVEFISH	K EY V F IH SH
CAVEFISHES	K EY V F IH SH IH Z
CENSORSHIP	S EH N S ER SH IH P
CENSORSHIPS	S EH N S ER SH IH P S
CEORLISH	S IY AO R L AH SH
CHAIRMANSHIP	CH EH R M AH N SH IH P
CHAIRMANSHIPS	CH EH R M AH N SH IH P S
CHAMPIONSHIP	CH AE M P IY AH N SH IH P
CHAMPIONSHIPS	CH AE M P IY AH N SH IH P S
CHANCELLORSHIP	CH AE N S AH L ER SH IH P
CHANCELLORSHIPS	CH AE N S AH L ER SH IH P S
CHEAPISH	CH IY P IH SH
CHEAPISHLY	CH IY P IH SH L IY
CHERISH	CH EH R IH SH
CHERISHABLE	CH EH R IH SH AH B AH L
CHERISHED	CH EH R IH SH T
CHERISHER	CH EH R IH SH ER
CHERISHERS	CH EH R IH SH ER Z
CHERISHES	CH EH R IH SH IH Z
CHERISHING	CH EH R IH SH IH NG
CHICKENSHIT	CH IH K AH N SH IH T
CHICKENSHITS	CH IH K AH N SH IH T S
CHIEFSHIP	CH IY F SH IH P
CHIEFSHIPS	CH IY F SH IH P S
CHIEFTAINSHIP	CH IY F T AH N SH IH P
CHIEFTAINSHIPS	CH IY F T AH N SH IH P S
CHILDISH	CH AY L D IH SH
CHILDISHLY	CH AY L D IH SH L IY
CHILDISHNESS	CH AY L D IH SH N AH S
CHILDISHNESSES	CH AY L D IH SH N AH S IH Z
CHOUSH	CH AW SH
CHOUSHES	CH AW SH AH Z
CHUMSHIP	CH AH M SH IH P
CHUMSHIPS	CH AH M SH IH P S
CHURCHMANSHIP	CH ER CH M AE N SH IH P
CHURCHMANSHIPS	CH ER CH M AE N SH IH P S
CHURLISH	CH ER L IH SH
CHURLISHLY	CH AH R L IH SH L IY
CHURLISHNESS	CH AH R L IH SH N AH S
CHURLISHNESSES	CH AH R L IH SH N EH S AH Z
CITIZENSHIP	S IH T IH Z AH N SH IH P
CITIZENSHIPS	S IH T AH Z AH N SH IH P S
CLAMSHELL	K L AE M SH EH L
CLAMSHELLS	K L AE M SH EH L Z
CLANNISH	K L AE N IH SH
CLANNISHLY	K L AE N IH SH L IY
CLANNISHNESS	K L AE N IH SH N AH S
CLANNISHNESSES	K L AE N IH SH N AH S IH Z
CLASH	K L AE SH
CLASHED	K L AE SH T
CLASHER	K L AE SH ER
CLASHERS	K L AE SH ER Z
CLASHES	K L AE SH IH Z
CLASHING	K L AE SH IH NG
CLAYISH	K L EY IH SH
CLERKISH	K L ER K IH SH
CLERKSHIP	K L ER K SH IH P
CLERKSHIPS	K L ER K SH IH P S
CLEVERISH	K L EH V ER IH SH
CLIPSHEET	K L IH P SH IY T
CLIPSHEETS	K L IH P SH IY T S
CLIQUISH	K L IY K IH SH
CLIQUISHLY	K L IY K IH SH L IY
CLIQUISHNESS	K L IY K IH SH N AH S
CLIQUISHNESSES	K L IY K IH SH N AH S IH Z
CLODDISH	K L AA D IH SH
CLODDISHNESS	K L AA D IH SH N AH S
CLODDISHNESSES	K L AA D IH SH N AH S IH Z
CLOTHESHORSE	K L OW Z HH AO R S
CLOTHESHORSES	K L OW DH Z HH AO R S IH Z
CLOWNISH	K L AW N IH SH
CLOWNISHLY	K L AW N IH SH L IY
CLOWNISHNESS	K L AW N IH SH N AH S
CLOWNISHNESSES	K L AW N IH SH N AH S IH Z
CLUBBISH	K L AH B IH SH
CLUMPISH	K L AH M P IH SH
COALFISH	K OW L F IH SH
COALFISHES	K OW L F IH SH IH Z
COALSHED	K OW L SH EH D
COALSHEDS	K OW L SH EH D Z
COAUTHORSHIP	K OW AO TH ER SH IH P
COAUTHORSHIPS	K OW AO TH ER SH IH P S
COCKISH	K AA K IH SH
COCKLESHELL	K AA K L EH SH AH L
COCKLESHELLS	K AA K L EH SH AH L Z
COCKNEYISH	K AA K N EY AH SH
COCKSHIES	K AA K SH AY Z
COCKSHUT	K AA K SH AH T
COCKSHUTS	K AA K SH AH T S
COCKSHY	K AA K SH AY
CODFISH	K AA D F IH SH
CODFISHES	K AA D F IH SH IH Z
COHOSH	K OW HH AA SH
COHOSHES	K OW HH AA SH AH Z
COLDISH	K OW L D IH SH
COLLEAGUESHIP	K AA L IY G SH IH P
COLLEAGUESHIPS	K AA L IY G SH IH P S
COLLECTORSHIP	K AA L IH K T ER SH IH P
COLLECTORSHIPS	K AA L IH K T ER SH IH P S
COLLIESHANGIE	K AA L IY Z HH AE NG IY
COLLIESHANGIES	K AA L IY Z HH AE NG IY Z
COLTISH	K OW L T IH SH
COLTISHLY	K OW L T IH SH L IY
COLTISHNESS	K OW L T IH SH N AH S
COLTISHNESSES	K OW L T IH SH N AH S IH Z
COMMANDERSHIP	K AH M AE N D ER SH IH P
COMMANDERSHIPS	K AH M AE N D ER SH IH P S
COMMISSIONERSHIP	K AH M IH SH AH N ER SH IH P
COMMISSIONERSHIPS	K AH M IH SH AH N ER SH IH P S
COMPANIONSHIP	K AH M P AE N Y AH N SH IH P
COMPANIONSHIPS	K AH M P AE N Y AH N SH IH P S
COMPTROLLERSHIP	K AA M P T R OW L ER SH IH P
COMPTROLLERSHIPS	K AA M P T R OW L ER SH IH P S
COMRADESHIP	K AA M R AE D SH IH P
COMRADESHIPS	K AA M R AE D SH IH P S
CONNOISSEURSHIP	K AA N AH S ER SH IH P
CONNOISSEURSHIPS	K AA N AH S ER SH IH P S
CONSERVATORSHIP	K AH N S ER V AH T ER SH IH P
CONSERVATORSHIPS	K AH N S ER V AH T ER SH IH P S
CONSULSHIP	K AA N S AH L SH IH P
CONSULSHIPS	K AA N S AH L SH IH P S
CONSULTANTSHIP	K AH N S AH L T AH N T SH IH P
CONSULTANTSHIPS	K AH N S AH L T AH N T SH IH P S
CONSUMERSHIP	K AH N S UW M ER SH IH P
CONSUMERSHIPS	K AH N S UW M ER SH IH P S
CONTAINERSHIP	K AH N T EY N ER SH IH P
CONTAINERSHIPS	K AH N T EY N ER SH IH P S
CONTRADISTINGUISH	K AA N T R AH D IH S T IH NG G W IH SH
CONTRADISTINGUISHED	K AA N T R AH D IH S T IH NG G W IH SH T
CONTRADISTINGUISHES	K AA N T R AH D IH S T IH NG G W IH SH IH Z
CONTRADISTINGUISHING	K AA N T R AH D IH S T IH NG G W IH SH IH NG
CONTROLLERSHIP	K AH N T R OW L ER SH IH P
CONTROLLERSHIPS	K AH N T R OW L ER SH IH P S
COOKSHACK	K UH K SH AE K
COOKSHACKS	K UH K SH AE K S
COOKSHOP	K UH K SH AA P
COOKSHOPS	K UH K SH AA P S
COOLISH	K UW L IH SH
COPARTNERSHIP	K OW P AA R T N ER SH IH P
COPARTNERSHIPS	K OW P AA R T N ER SH IH P S
COPROPRIETORSHIP	K OW P R AH P R AY AH T ER SH IH P
COPROPRIETORSHIPS	K OW P R AH P R AY AH T ER SH IH P S
COPUBLISH	K OW P AH B L IH SH
COPUBLISHED	K OW P AH B L IH SH T
COPUBLISHER	K OW P AH B L IH SH ER
COPUBLISHERS	K OW P AH B L IH SH ER Z
COPUBLISHES	K OW P AH B L IH SH IH Z
COPUBLISHING	K OW P AH B L IH SH IH NG
COQUETTISH	K OW K EH T IH SH
COQUETTISHLY	K OW K EH T IH SH L IY
COQUETTISHNESS	K OW K EH T IH SH N AH S
COQUETTISHNESSES	K OW K EH T IH SH N AH S IH Z
COSH	K AA SH
COSHED	K OW SH EH D
COSHER	K AA SH AH R
COSHERED	K OW SH IY R D
COSHERING	K OW SH IY R AH NG
COSHERS	K OW SH EH R Z
COSHES	K AA SH AH Z
COSHING	K AA SH AH NG
COSPONSORSHIP	K OW S P AA N S ER SH IH P
COSPONSORSHIPS	K OW S P AA N S ER SH IH P S
COUNCILLORSHIP	K AW N S AH L ER SH IH P
COUNCILLORSHIPS	K AW N S AH L ER SH IH P S
COUNSELORSHIP	K AW N S AH L ER SH IH P
COUNSELORSHIPS	K AW N S AH L ER SH IH P S
COUNTERSHADING	K AW N T ER SH EY D IH NG
COUNTERSHADINGS	K AW N T ER SH EY D IH NG Z
COUNTERSHOT	K AW N T ER SH AA T
COUNTERSHOTS	K AW N T ER SH AA T S
COUNTRYISH	K AH N T R IY IH SH
COURTSHIP	K AO R CH IH P
COURTSHIPS	K OW R T SH IH P S
COUSINSHIP	K AH Z AH N SH IH P
COUSINSHIPS	K AH Z AH N SH IH P S
COWFISH	K AW F IH SH
COWFISHES	K AW F IH SH IH Z
COWSHED	K AW SH EH D
COWSHEDS	K AW SH EH D Z
COYISH	K OY IH SH
CRAFTSMANSHIP	K R AE F T S M AH N SH IH P
CRAFTSMANSHIP(2)	K R AE F S M AH N SH IH P
CRAFTSMANSHIPS	K R AE F T S M AE N SH IH P S
CRANKISH	K R AE NG K IH SH
CRANKSHAFT	K R AE NG K SH AE F T
CRANKSHAFTS	K R AE NG K SH AE F T S
CRAPSHOOT	K R AE P SH UW T
CRAPSHOOTER	K R AE P SH UW T ER
CRAPSHOOTERS	K R AE P SH UW T ER Z
CRAPSHOOTS	K R AE P SH UW T S
CRASH	K R AE SH
CRASHED	K R AE SH T
CRASHER	K R AE SH ER
CRASHERS	K R AE SH ER Z
CRASHES	K R AE SH IH Z
CRASHING	K R AE SH IH NG
CRASHINGLY	K R AE SH IH NG L IY
CRASHWORTHINESS	K R AE SH W ER DH IY N AH S
CRASHWORTHINESSES	K R AE SH W ER DH IY N AH S IH Z
CRASHWORTHY	K R AE SH W ER DH IY
CRAWFISH	K R AO F IH SH
CRAWFISHED	K R AO F AH SH T
CRAWFISHES	K R AO F AH SH AH Z
CRAWFISHING	K R AO F AH SH AH NG
CRAYFISH	K R EY F IH SH
CRAYFISHES	K R EY F AH SH AH Z
CREESH	K R IY SH
CREESHED	K R IY SH T
CREESHES	K R IY SH AH Z
CREESHING	K R IY SH AH NG
CROSSHAIR	K R AO S HH EH R
CROSSHAIRS	K R AO S HH EH R Z
CROSSHATCH	K R AO S HH AE CH
CROSSHATCHED	K R AO S HH AE CH T
CROSSHATCHES	K R AO S HH AE CH IH Z
CROSSHATCHING	K R AO S HH AE CH IH NG
CROSSHEAD	K R AO S HH EH D
CROSSHEADS	K R AO S HH EH D Z
CRUSH	K R AH SH
CRUSHABLE	K R AH SH AH B AH L
CRUSHED	K R AH SH T
CRUSHER	K R AH SH ER
CRUSHERS	K R AH SH ER Z
CRUSHES	K R AH SH IH Z
CRUSHING	K R AH SH IH NG
CRUSHINGLY	K R AH SH IH NG L IY
CRUSHPROOF	K R AH SH P R UW F
CUBBISH	K AH B IH SH
CUISH	K Y UW IH SH
CUISHES	K Y UW IH SH IH Z
CULTISH	K AH L T IH SH
CULTISHLY	K AH L T IH SH L IY
CULTISHNESS	K AH L T IH SH N AH S
CULTISHNESSES	K AH L T IH SH N AH S IH Z
CUMSHAW	K AH M SH AH
CUMSHAWS	K AH M SH AH Z
CURATORSHIP	K Y UH R AH T ER SH IH P
CURATORSHIPS	K Y UH R AH T ER SH IH P S
CURRISH	K ER IH SH
CURRISHLY	K ER IH SH L IY
CUSHAT	K AH SH AH T
CUSHATS	K AH SH EY T S
CUSHAW	K AH SH AH
CUSHAWS	K AH SH AH Z
CUSHIER	K AH SH AY AH R
CUSHIEST	K AH SH AY AH S T
CUSHILY	K AH SH AH L IY
CUSHION	K UH SH AH N
CUSHIONED	K UH SH AH N D
CUSHIONING	K UH SH AH N IH NG
CUSHIONING(2)	K UH SH N IH NG
CUSHIONLESS	K UH SH AH N L AH S
CUSHIONS	K UH SH AH N Z
CUSHIONY	K UH SH AH N IY
CUSHY	K UH SH IY
CUSTODIANSHIP	K AH S T OW D IY AH N SH IH P
CUSTODIANSHIPS	K AH S T OW D IY AH N SH IH P S
CUSTOMSHOUSE	K AH S T AH M Z HH AW S
CUSTOMSHOUSES	K AH S T AH M Z HH AW S IH Z
CUTTLEFISH	K AH T AH L F IH SH
CUTTLEFISHES	K AH T L EH F AH SH AH Z
DACHSHUND	D AA K S HH UH N D
DACHSHUNDS	D AA K S HH UH N T S
DAISHIKI	D EY SH AH K IY
DAISHIKIS	D EY AH S HH AY K IY Z
DAMPISH	D AE M P IH SH
DAMSELFISH	D AE M Z AH L F IH SH
DAMSELFISHES	D AE M Z AH L F IH SH IH Z
DANDYISH	D AE N D IY IH SH
DANDYISHLY	D AE N D IY IH SH L IY
DANISH	D EY N IH SH
DARKISH	D AA R K IH SH
DARSHAN	D AA R SH AH N
DARSHANS	D AA R SH AH N Z
DASH	D AE SH
DASHBOARD	D AE SH B AO R D
DASHBOARDS	D AE SH B AO R D Z
DASHED	D AE SH T
DASHEEN	D AE SH IY AH N
DASHEENS	D AH SH IY N Z
DASHER	D AE SH ER
DASHERS	D AE SH ER Z
DASHES	D AE SH IH Z
DASHI	D AE SH IY
DASHIER	D AE SH IY ER
DASHIEST	D AE SH IY AH S T
DASHIKI	D AH SH IY K IY
DASHIKIS	D AE SH AH K AH S
DASHING	D AE SH IH NG
DASHINGLY	D AE SH IH NG L IY
DASHIS	D AE SH IY Z
DASHPOT	D AE SH P AA T
DASHPOTS	D AE SH P AA T S
DASHY	D AE SH IY
DAYSHIFT	D EY SH IH F T
DAYSHIFTS	D EY SH IH F T S
DEAFISH	D EH F IH SH
DEALERSHIP	D IY L ER SH IH P
DEALERSHIPS	D IY L ER SH IH P S
DEALFISH	D IY L F IH SH
DEALFISHES	D IY L F IH SH IH Z
DEANSHIP	D IY N SH IH P
DEANSHIPS	D IY N SH IH P S
DEASH	D IY AE SH
DEASHED	D IY AH SH EH D
DEASHES	D IY AE SH IH Z
DEASHING	D IY AE SH IH NG
DEMOLISH	D IH M AA L IH SH
DEMOLISHED	D IH M AA L IH SH T
DEMOLISHER	D IH M AA L IH SH ER
DEMOLISHERS	D IH M AA L IH SH ER Z
DEMOLISHES	D IH M AA L IH SH AH Z
DEMOLISHING	D IH M AA L IH SH IH NG
DEMOLISHMENT	D IH M AA L IH SH M AH N T
DEMOLISHMENTS	D IH M AA L IH SH M AH N T S
DEPOLISH	D IY P AA L IH SH
DEPOLISHED	D IY P AA L IH SH T
DEPOLISHES	D IY P AA L IH SH IH Z
DEPOLISHING	D IY P AA L IH SH IH NG
DERVISH	D ER V IH SH
DERVISHES	D ER V IH SH IH Z
DESHABILLE	D AH SH AE B AH L
DESHABILLES	D AH SH AE B AH L Z
DEVILFISH	D EH V AH L F IH SH
DEVILFISHES	D EH V AH L F IH SH IH Z
DEVILISH	D EH V L IH SH
DEVILISHLY	D EH V AH L IH SH L IY
DEVILISHLY(2)	D EH V L IH SH L IY
DEVILISHNESS	D IY V IH L IH SH N AH S
DEVILISHNESSES	D IY V IH L IH SH N AH S IH Z
DICTATORSHIP	D IH K T EY T ER SH IH P
DICTATORSHIPS	D IH K T EY T ER SH IH P S
DILETTANTISH	D IH L AH T AA N T IH SH
DIMINISH	D IH M IH N IH SH
DIMINISHABLE	D AH M IH N IH SH AH B AH L
DIMINISHED	D IH M IH N IH SH T
DIMINISHES	D IH M IH N IH SH IH Z
DIMINISHING	D IH M IH N IH SH IH NG
DIMINISHMENT	D IH M IH N IH SH M AH N T
DIMINISHMENTS	D AH M IH N IH SH M AH N T S
DIRECTORSHIP	D ER EH K T ER SH IH P
DIRECTORSHIP(2)	D AY R EH K T ER SH IH P
DIRECTORSHIP(3)	D IY R EH K T ER SH IH P
DIRECTORSHIP(4)	D IH R EH K T ER SH IH P
DIRECTORSHIPS	D ER EH K T ER SH IH P S
DIRECTORSHIPS(2)	D AY R EH K T ER SH IH P S
DIRECTORSHIPS(3)	D IY R EH K T ER SH IH P S
DIRECTORSHIPS(4)	D IH R EH K T ER SH IH P S
DISCIPLESHIP	D IH S AY P AH L SH IH P
DISCIPLESHIPS	D IH S AY P AH L SH IH P S
DISESTABLISH	D IH S IH S T AE B L IH SH
DISESTABLISHED	D IH S IH S T AE B L IH SH T
DISESTABLISHES	D IH S IH S T AE B L IH SH IH Z
DISESTABLISHING	D IH S IH S T AE B L IH SH IH NG
DISESTABLISHMENT	D IH S IH S T AE B L IH SH M AH N T
DISESTABLISHMENTARIAN	D AH S EH S T AH B L IH SH M AH N T EH R IY AH N
DISESTABLISHMENTARIANS	D AH S AH S T AH B L IH SH M AH N T AE R IY AH N Z
DISESTABLISHMENTS	D IH S IH S T AE B L IH SH M AH N T S
DISFURNISH	D IH S F ER N IH SH
DISFURNISHED	D IH S F ER N IH SH T
DISFURNISHES	D IH S F ER N IH SH IH Z
DISFURNISHING	D IH S F ER N IH SH IH NG
DISFURNISHMENT	D IH S F ER N IH SH M AH N T
DISFURNISHMENTS	D IH S F ER N IH SH M AH N T S
DISH	D IH SH
DISHABILLE	D IH S AE B AH L
DISHABILLES	D IH S AE B AH L Z
DISHARMONIES	D IH S HH AA R M AH N IY Z
DISHARMONIOUS	D IH S HH AA R M OW N IY AH S
DISHARMONIZE	D IH S HH AA R M AO N AY Z
DISHARMONIZED	D IH S HH AA R M AO N AY Z D
DISHARMONIZES	D IH S HH AA R M AO N AY Z IH Z
DISHARMONIZING	D IH S HH AA R M AO N AY Z IH NG
DISHARMONY	D IH S HH AA R M AH N IY
DISHCLOTH	D IH SH K L AO TH
DISHCLOTHS	D IH SH K L AO TH S
DISHCLOUT	D IH SH K L AW T
DISHCLOUTS	D IH SH K L AW T S
DISHEARTEN	D IH S HH AA R T AH N
DISHEARTENED	D IH S HH AA R T AH N D
DISHEARTENING	D IH S HH AA R T AH N IH NG
DISHEARTENING(2)	D IH S HH AA R T N IH NG
DISHEARTENINGLY	D IH S HH AA R T AH N IH NG L IY
DISHEARTENMENT	D IH S HH AA R T AH N M AH N T
DISHEARTENMENTS	D IH S HH AA R T AH N M AH N T S
DISHEARTENS	D IH S HH AA R T AH N Z
DISHED	D IH SH T
DISHELM	D IH S HH EH L M
DISHELMED	D IH S HH EH L M D
DISHELMING	D IH S HH EH L M IH NG
DISHELMS	D IH S HH EH L M Z
DISHERIT	D IH S EH R AH T
DISHERITED	D IH S AH R AY T AH D
DISHERITING	D IH S AH R AY T AH NG
DISHERITS	D IH S EH R AH T S
DISHES	D IH SH AH Z
DISHES(2)	D IH SH IH Z
DISHEVEL	D IH SH EH V AH L
DISHEVELED	D IH SH EH V AH L D
DISHEVELING	D IH SH EH V AH L IH NG
DISHEVELLED	D IH SH EH V AH L D
DISHEVELLING	D IH SH EH V AH L IH NG
DISHEVELS	D IH SH EH V AH L Z
DISHFUL	D IH SH F AH L
DISHFULS	D IH SH F AH L Z
DISHIER	D IH SH IY ER
DISHIEST	D IH SH IY AH S T
DISHING	D IH SH IH NG
DISHLIKE	D IH SH L AY K
DISHONEST	D IH S AA N AH S T
DISHONESTIES	D IH S AA N AH S T IY Z
DISHONESTLY	D IH S AO N AH S T L IY
DISHONESTY	D IH S AA N AH S T IY
DISHONOR	D IH S AA N ER
DISHONORABLE	D IH S AA N ER AH B AH L
DISHONORABLENESS	D IH S AA N ER AH B AH L N AH S
DISHONORABLENESSES	D IH S AA N ER AH B AH L N AH S IH Z
DISHONORABLY	D IH S AA N ER AH B L IY
DISHONORED	D IH S AA N ER D
DISHONORER	D IH S AA N ER ER
DISHONORERS	D IH S AA N ER ER Z
DISHONORING	D IH S AA N ER IH NG
DISHONORS	D IH S AA N ER Z
DISHPAN	D IH SH P AE N
DISHPANS	D IH SH P AE N Z
DISHRAG	D IH SH R AE G
DISHRAGS	D IH SH R AE G Z
DISHTOWEL	D IH SH T AW AH L
DISHTOWELS	D IH SH T AW AH L Z
DISHWARE	D IH SH W EH R
DISHWARES	D IH SH W EH R Z
DISHWASHER	D IH SH W AA SH ER
DISHWASHERS	D IH SH W AA SH ER Z
DISHWATER	D IH SH W AO T ER
DISHWATERS	D IH SH W AO T ER Z
DISHY	D IH SH IY
DISRELISH	D IH S R EH L IH SH
DISRELISHED	D IH S R EH L IH SH T
DISRELISHES	D IH S R EH L IH SH IH Z
DISRELISHING	D IH S R EH L IH SH IH NG
DISTINGUISH	D IH S T IH NG G W IH SH
DISTINGUISHABILITIES	D IH S T IH NG G W IH SH AH B IH L AH T EH Z
DISTINGUISHABILITY	D IH S T IH NG G W IH SH AH B IH L AH T EH
DISTINGUISHABLE	D IH S T IH NG G W IH SH AH B AH L
DISTINGUISHABLY	D IH S T IH NG G W IH SH AH B L IY
DISTINGUISHED	D IH S T IH NG G W IH SH T
DISTINGUISHES	D IH S T IH NG G W IH SH IH Z
DISTINGUISHING	D IH S T IH NG G W IH SH IH NG
DISTRIBUTORSHIP	D IH S T R IH B Y UW T ER SH IH P
DISTRIBUTORSHIPS	D IH S T R IH B Y UW T ER SH IH P S
DOCTORSHIP	D AA K T ER SH IH P
DOCTORSHIPS	D AA K T ER SH IH P S
DOGESHIP	D AO G Z HH IH P
DOGESHIPS	D AO G Z HH IH P S
DOGFISH	D AO G F IH SH
DOGFISHES	D AO G F IH SH IH Z
DOGGISH	D AO G IH SH
DOGGISHLY	D AO G IH SH L IY
DOGGISHNESS	D AO G IH SH N AH S
DOGGISHNESSES	D AO G IH SH N AH S IH Z
DOLLISH	D AA L IH SH
DOLLISHLY	D AA L IH SH L IY
DOLLISHNESS	D AA L IH SH N AH S
DOLLISHNESSES	D AA L IH SH N AH S IH Z
DOLPHINFISH	D AA L F AH N F IH SH
DOLPHINFISHES	D AA L F AH N F IH SH IH Z
DOLTISH	D OW L T IH SH
DOLTISHLY	D OW L T IH SH L IY
DOLTISHNESS	D OW L T IH SH N AH S
DOLTISHNESSES	D OW L T IH SH N AH S IH Z
DONNISH	D AA N IH SH
DONNISHLY	D AA N IH SH L IY
DONNISHNESS	D AA N IH SH N AH S
DONNISHNESSES	D AA N IH SH N AH S IH Z
DOVISH	D OW V IH SH
DOVISH(2)	D AH V IH SH
DOVISHNESS	D AH V IH SH N AH S
DOVISHNESSES	D AH V IH SH N AH S IH Z
DOWDYISH	D AW D AY IH SH
DOWNSHIFT	D AW N SH IH F T
DOWNSHIFTED	D AW N SH IH F T IH D
DOWNSHIFTING	D AW N SH IH F T IH NG
DOWNSHIFTS	D AW N SH IH F T S
DOWNWASH	D AW N W AA SH
DOWNWASHES	D AW N W AA SH IH Z
DRAFFISH	D R AE F AH SH
DRAFTSMANSHIP	D R AE F T S M AH N SH IH P
DRAFTSMANSHIPS	D R AE F T S M AE N SH IH P S
DRAGONISH	D R AE G AH N IH SH
DRAMSHOP	D R AE M SH AA P
DRAMSHOPS	D R AE M SH AA P S
DRAWSHAVE	D R AO SH EY V
DRAWSHAVES	D R AO SH EY V Z
DREGGISH	D R EH G IH SH
DRIVESHAFT	D R AY V SH AE F T
DRIVESHAFTS	D R AY V SH AE F T S
DRONISH	D R OW N IH SH
DROPSHOT	D R AA P SH AA T
DROPSHOTS	D R AA P SH AA T S
DROSHKIES	D R AA SH AY Z
DROSHKY	D R AA SH IY
DROSHKYS	D R AA SH AH Z
DRUMFISH	D R AH M F IH SH
DRUMFISHES	D R AH M F IH SH IH Z
DRYISH	D R AY IH SH
DUDISH	D AH D IH SH
DUDISHLY	D AH D IH SH L IY
DUENNASHIP	D Y UW EH N AH SH IH P
DUENNASHIPS	D Y UW EH N AH SH AH P S
DULLISH	D AH L IH SH
DULLISHLY	D AH L IH SH L IY
DUMPISH	D AH M P IH SH
DUNCISH	D AH N S AH SH
DUSKISH	D AH S K IH SH
DWARFISH	D W AO R F IH SH
DWARFISHLY	D W AO R F IH SH L IY
DWARFISHNESS	D W AO R F IH SH N AH S
DWARFISHNESSES	D W AO R F IH SH N AH S IH Z
EARLSHIP	ER L SH IH P
EARLSHIPS	ER L SH IH P S
EARSHOT	IH R SH AA T
EARSHOT(2)	IY R SH AA T
EARSHOTS	IH ER SH AA T S
EARTHSHAKER	ER TH SH EY K ER
EARTHSHAKERS	ER TH SH EY K ER Z
EARTHSHAKING	ER TH SH EY K IH NG
EARTHSHAKINGLY	ER TH SH EY K IH NG L IY
EARTHSHINE	ER TH SH AY N
EARTHSHINES	ER TH SH AY N Z
EDITORSHIP	EH D AH T ER SH IH P
EDITORSHIPS	EH D AH T ER SH IH P S
EGGSHELL	EH G SH EH L
EGGSHELLS	EH G SH EH L Z
ELDERSHIP	EH L D ER SH IH P
ELDERSHIPS	EH L D ER SH IH P S
ELECTROFISHING	AH L EH K T R AA F AH SH AH NG
ELECTROFISHINGS	EH L AH K T R AA F AH SH AH NG Z
ELECTROSHOCK	IH L EH K T R OW SH AA K
ELECTROSHOCKS	AH L EH K T R AH SH AH K S
ELFISH	EH L F IH SH
ELFISHLY	EH L F IH SH L IY
ELVISH	EH L V AH SH
ELVISHLY	EH L V IH SH L IY
EMBELLISH	IH M B EH L IH SH
EMBELLISHED	EH M B EH L IH SH T
EMBELLISHER	IH M B EH L IH SH ER
EMBELLISHERS	IH M B EH L IH SH ER Z
EMBELLISHES	EH M B EH L IH SH AH Z
EMBELLISHING	EH M B EH L IH SH IH NG
EMBELLISHMENT	EH M B EH L IH SH M AH N T
EMBELLISHMENTS	IH M B EH L IH SH M AH N T S
EMPERORSHIP	EH M P ER ER SH IH P
EMPERORSHIPS	EH M P ER ER SH IH P S
ENCASH	EH N K AE SH
ENCASHABLE	EH N K AE SH AH B AH L
ENCASHED	EH N K AE SH T
ENCASHES	EH N K AE SH IH Z
ENCASHING	EH N K AE SH IH NG
ENCASHMENT	EH N K AE SH M AH N T
ENCASHMENTS	EH N K AE SH M AH N T S
ENGLISH	IH NG G L IH SH
ENGLISH(2)	IH NG L IH SH
ENGLISHED	IH NG G L IH SH T
ENGLISHES	IH NG G L IH SH IH Z
ENGLISHING	IH NG G L IH SH IH NG
ENMESH	EH N M EH SH
ENMESHED	EH N M EH SH T
ENMESHES	EH N M EH SH AH Z
ENMESHING	EH N M EH SH IH NG
ENMESHMENT	EH N M EH SH M AH N T
ENMESHMENTS	EH N M EH SH M AH N T S
ENRAVISH	EH N R EY V IH SH
ENRAVISHED	EH N R EY V IH SH T
ENRAVISHES	EH N R EY V IH SH IH Z
ENRAVISHING	EH N R EY V IH SH IH NG
ENSHEATH	EH N SH IY TH
ENSHEATHE	EH N SH IY DH
ENSHEATHED	EH N SH IY DH D
ENSHEATHES	EH N SH IY DH Z
ENSHEATHING	EH N SH IY DH IH NG
ENSHEATHS	EH N SH IY TH S
ENSHRINE	EH N SH R AY N
ENSHRINED	EH N SH R AY N D
ENSHRINEE	EH N SH R AY N IY
ENSHRINEES	EH N SH R AY N IY Z
ENSHRINEMENT	EH N SH R AY N M AH N T
ENSHRINEMENTS	EH N SH R AY N M AH N T S
ENSHRINES	EH N SH R AY N Z
ENSHRINING	EH N SH R AY N IH NG
ENSHROUD	IH N SH R AW D
ENSHROUDED	IH N SH R AW D AH D
ENSHROUDING	EH N SH R AW D IH NG
ENSHROUDS	EH N SH R AW D Z
ENTREPRENEURSHIP	AA N T R AH P R AH N ER SH IH P
ENTREPRENEURSHIPS	AA N T R AH P R AH N ER SH IH P S
ESTABLISH	IH S T AE B L IH SH
ESTABLISHABLE	IH S T AE B L IH SH AH B AH L
ESTABLISHED	IH S T AE B L IH SH T
ESTABLISHER	IH S T AE B L IH SH ER
ESTABLISHERS	IH S T AE B L IH SH ER Z
ESTABLISHES	IH S T AE B L IH SH IH Z
ESTABLISHING	IH S T AE B L IH SH IH NG
ESTABLISHMENT	IH S T AE B L IH SH M AH N T
ESTABLISHMENTARIAN	EH S T AH B L IH SH M AH N T EH R IY AH N
ESTABLISHMENTARIANISM	EH S T AH B L IH SH M AH N T AE R IY AH N IH Z AH M
ESTABLISHMENTARIANISMS	EH S T AH B L AH SH M EH N T AH R IY AH N AH Z AH M Z
ESTABLISHMENTARIANS	EH S T AH B L IH SH M AH N T AE R IY AH N Z
ESTABLISHMENTS	EH S T AE B L IH SH M AH N T S
ETHERISH	IY TH ER IH SH
EVANISH	EH V AH N AH SH
EVANISHED	EH V AH N AH SH T
EVANISHES	AH V AE N AH SH AH Z
EVANISHING	AH V AE N AH SH AH NG
EXECUTORSHIP	IH G Z EH K Y AH T ER SH IH P
EXECUTORSHIPS	IH G Z EH K Y AH T ER SH IH P S
EXTERNSHIP	EH K S T ER N SH IH P
EXTERNSHIPS	EH K S T ER N SH IH P S
EXTINGUISH	IH K S T IH NG G W IH SH
EXTINGUISHABLE	IH K S T IH NG G W IH SH AH B AH L
EXTINGUISHED	IH K S T IH NG G W IH SH T
EXTINGUISHER	IH K S T IH NG G W IH SH ER
EXTINGUISHERS	IH K S T IH NG G W IH SH ER Z
EXTINGUISHES	IH K S T IH NG G W IH SH IH Z
EXTINGUISHING	IH K S T IH NG G W IH SH IH NG
EXTINGUISHMENT	IH K S T IH NG G W IH SH M AH N T
EXTINGUISHMENTS	IH K S T IH NG G W IH SH M AH N T S
EYELASH	AY L AE SH
EYELASHES	AY L AE SH IH Z
EYESHADE	AY SH EY D
EYESHADES	AY SH EY D Z
EYESHOT	AY SH AA T
EYESHOTS	AY SH AA T S
EYEWASH	AY W AA SH
EYEWASHES	AY W AA SH IH Z
FACTORSHIP	F AE K T ER SH IH P
FACTORSHIPS	F AE K T ER SH IH P S
FADDISH	F AE D IH SH
FADDISHNESS	F AE D IH SH N AH S
FADDISHNESSES	F AE D IH SH N AH S IH Z
FAINTISH	F EY N T IH SH
FAINTISHNESS	F EY N T IH SH N AH S
FAINTISHNESSES	F EY N T IH SH N AH S IH Z
FAIRISH	F EH R IH SH
FAIRISHLY	F EH R IH SH L IY
FALLFISH	F AO L F IH SH
FALLFISHES	F AO L F IH SH IH Z
FAMISH	F EY M IH SH
FAMISHED	F AE M IH SH T
FAMISHES	F EY M IH SH IH Z
FAMISHING	F EY M IH SH IH NG
FAMISHMENT	F EY M IH SH M AH N T
FAMISHMENTS	F EY M IH SH M AH N T S
FASH	F AE SH
FASHED	F AE SH T
FASHES	F AE SH AH Z
FASHING	F AE SH AH NG
FASHION	F AE SH AH N
FASHIONABILITIES	F AE SH AH N AH B IH L AH T EH Z
FASHIONABILITY	F AE SH AH N AH B IH L AH T EH
FASHIONABLE	F AE SH AH N AH B AH L
FASHIONABLE(2)	F AE SH N AH B AH L
FASHIONABLENESS	F AE SH AH N AH B AH L N AH S
FASHIONABLENESSES	F AE SH AH N AH B AH L N AH S IH Z
FASHIONABLES	F AE SH AH N AH B AH L Z
FASHIONABLY	F AE SH AH N AH B L IY
FASHIONED	F AE SH AH N D
FASHIONER	F AE SH AH N ER
FASHIONERS	F AE SH AH N ER Z
FASHIONING	F AE SH AH N IH NG
FASHIONMONGER	F AE SH AH N M AH NG G ER
FASHIONMONGERS	F AE SH AH N M AH NG G ER Z
FASHIONS	F AE SH AH N Z
FASHIOUS	F AE SH AH S
FATSHEDERA	F AE T SH EH D IH R AH
FATSHEDERAS	F AE T SH EH D IH R AH Z
FATTISH	F AE T IH SH
FEEBLISH	F IY B AH L IH SH
FELDSHER	F EH L D SH AH R
FELDSHERS	F EH L D SH AH R Z
FELLOWSHIP	F EH L OW SH IH P
FELLOWSHIPED	F EH L OW SH IH P T
FELLOWSHIPING	F EH L OW SH IH P IH NG
FELLOWSHIPPED	F EH L OW SH IH P T
FELLOWSHIPPING	F EH L OW SH IH P IH NG
FELLOWSHIPS	F EH L OW SH IH P S
FETISH	F EH T IH SH
FETISHES	F EH T IH SH IH Z
FETISHISM	F EH T IH SH IH Z AH M
FETISHISMS	F EH T IH SH IH Z AH M Z
FETISHIST	F EH T IH SH IH S T
FETISHIST(2)	F EH T IH SH AH S T
FETISHISTIC	F EH T IH SH IH S T IH K
FETISHISTICALLY	F EH T IH SH IH S T IH K AH L IY
FETISHISTS	F EH T IH SH AH S T S
FETISHISTS(2)	F EH T IH SH IH S T S
FEVERISH	F IY V ER IH SH
FEVERISHLY	F EH V ER IH SH L IY
FEVERISHNESS	F IY V ER IH SH N AH S
FEVERISHNESSES	F IY V ER IH SH N AH S IH Z
FIENDISH	F IY N D IH SH
FIENDISHLY	F IY N D IH SH L IY
FIENDISHNESS	F IY N D IH SH N AH S
FIENDISHNESSES	F IY N D IH SH N AH S IH Z
FIFTYISH	F IH F T IY IH SH
FILEFISH	F AY L F IH SH
FILEFISHES	F AY L F IH SH IH Z
FINFISH	F IH N F IH SH
FINFISHES	F IH N F IH SH IH Z
FINISH	F IH N IH SH
FINISHED	F IH N IH SH T
FINISHER	F IH N IH SH ER
FINISHERS	F IH N IH SH ER Z
FINISHES	F IH N IH SH IH Z
FINISHING	F IH N IH SH IH NG
FISH	F IH SH
FISHABILITIES	F IH SH AH B IH L AH T EH Z
FISHABILITY	F IH SH AH B IH L AH T EH
FISHABLE	F IH SH AH B AH L
FISHBOLT	F IH SH B OW L T
FISHBOLTS	F IH SH B OW L T S
FISHBONE	F IH SH B OW N
FISHBONES	F IH SH B OW N Z
FISHBOWL	F IH SH B OW L
FISHBOWLS	F IH SH B OW L Z
FISHED	F IH SH T
FISHER	F IH SH ER
FISHERFOLK	F IH SH ER F OW K
FISHERIES	F IH SH ER IY Z
FISHERMAN	F IH SH ER M AE N
FISHERMAN(2)	F IH SH ER M AH N
FISHERMEN	F IH SH ER M IH N
FISHERS	F IH SH ER Z
FISHERWOMAN	F IH SH ER W UH M AH N
FISHERWOMEN	F IH SH ER W IH M AH N
FISHERY	F IH SH ER IY
FISHES	F IH SH AH Z
FISHES(2)	F IH SH IH Z
FISHEYE	F IH SH AY
FISHEYES	F IH SH AY Z
FISHGIG	F IH SH G IH G
FISHGIGS	F IH SH G IH G Z
FISHHOOK	F IH SH HH UH K
FISHHOOKS	F IH SH HH UH K S
FISHIER	F IH SH IY ER
FISHIEST	F IH SH IY AH S T
FISHILY	F IH SH IY L IY
FISHING	F IH SH IH NG
FISHINGS	F IH SH IH NG Z
FISHLESS	F IH SH L AH S
FISHLIKE	F IH SH L AY K
FISHLINE	F IH SH L AY N
FISHLINES	F IH SH L AY N Z
FISHMEAL	F IH SH M IY L
FISHMEALS	F IH SH M IY L Z
FISHMONGER	F IH SH M AA NG G ER
FISHMONGERS	F IH SH M AH NG G ER Z
FISHNET	F IH SH N EH T
FISHNETS	F IH SH N EH T S
FISHPLATE	F IH SH P L EY T
FISHPLATES	F IH SH P L EY T S
FISHPOLE	F IH SH P OW L
FISHPOLES	F IH SH P OW L Z
FISHPOND	F IH SH P AA N D
FISHPONDS	F IH SH P AA N D Z
FISHTAIL	F IH SH T EY L
FISHTAILED	F IH SH T EY L D
FISHTAILING	F IH SH T EY L IH NG
FISHTAILS	F IH SH T EY L Z
FISHWAY	F IH SH W EY
FISHWAYS	F IH SH W EY Z
FISHWIFE	F IH SH W AY F
FISHWIVES	F IH SH W AY V Z
FISHWORM	F IH SH W ER M
FISHWORMS	F IH SH W ER M Z
FISHY	F IH SH IY
FLAGSHIP	F L AE G SH IH P
FLAGSHIPS	F L AE G SH IH P S
FLASH	F L AE SH
FLASHBACK	F L AE SH B AE K
FLASHBACKS	F L AE SH B AE K S
FLASHBOARD	F L AE SH B OW R D
FLASHBOARDS	F L AE SH B OW R D Z
FLASHBULB	F L AE SH B AH L B
FLASHBULBS	F L AE SH B AH L B Z
FLASHCARD	F L AE SH K AA R D
FLASHCARDS	F L AE SH K AA R D Z
FLASHCUBE	F L AE SH K Y UW B
FLASHCUBES	F L AE SH K Y UW B Z
FLASHED	F L AE SH T
FLASHER	F L AE SH ER
FLASHERS	F L AE SH ER Z
FLASHES	F L AE SH IH Z
FLASHGUN	F L AE SH G AH N
FLASHGUNS	F L AE SH G AH N Z
FLASHIER	F L AE SH IY ER
FLASHIEST	F L AE SH IY AH S T
FLASHILY	F L AE SH IY L IY
FLASHINESS	F L AE SH IY N AH S
FLASHINESSES	F L AE SH IY N AH S IH Z
FLASHING	F L AE SH IH NG
FLASHINGS	F L AE SH IH NG Z
FLASHLAMP	F L AE SH L AE M P
FLASHLAMPS	F L AE SH L AE M P S
FLASHLIGHT	F L AE SH L AY T
FLASHLIGHTS	F L AE SH L AY T S
FLASHOVER	F L AE SH OW V ER
FLASHOVERS	F L AE SH OW V ER Z
FLASHTUBE	F L AE SH T UW B
FLASHTUBES	F L AE SH T UW B Z
FLASHY	F L AE SH IY
FLATFISH	F L AE T F IH SH
FLATFISHES	F L AE T F IH SH IH Z
FLATTISH	F L AE T IH SH
FLATWASH	F L AE T W AA SH
FLATWASHES	F L AE T W AA SH IH Z
FLEISHIG	F L IY SH AH G
FLEMISH	F L EH M IH SH
FLEMISHED	F L EH M AH SH T
FLEMISHES	F L EH M AH SH AH Z
FLEMISHING	F L EH M AH SH AH NG
FLESH	F L EH SH
FLESHED	F L EH SH T
FLESHER	F L EH SH ER
FLESHERS	F L EH SH ER Z
FLESHES	F L EH SH IH Z
FLESHIER	F L EH SH IY ER
FLESHIEST	F L EH SH IY AH S T
FLESHINESS	F L EH SH IY N AH S
FLESHINESSES	F L EH SH IY N AH S IH Z
FLESHING	F L EH SH IH NG
FLESHINGS	F L EH SH IH NG Z
FLESHLIER	F L EH SH L IY ER
FLESHLIEST	F L EH SH L IY AH S T
FLESHLY	F L EH SH L IY
FLESHMENT	F L EH SH M AH N T
FLESHMENTS	F L EH SH M AH N T S
FLESHPOT	F L EH SH P AA T
FLESHPOTS	F L EH SH P AA T S
FLESHY	F L EH SH IY
FLOURISH	F L ER IH SH
FLOURISHED	F L ER IH SH T
FLOURISHER	F L ER IH SH ER
FLOURISHERS	F L ER IH SH ER Z
FLOURISHES	F L ER IH SH AH Z
FLOURISHES(2)	F L ER IH SH IH Z
FLOURISHING	F L ER IH SH IH NG
FLOURISHINGLY	F L ER IH SH IH NG L IY
FLUSH	F L AH SH
FLUSHABLE	F L AH SH AH B AH L
FLUSHED	F L AH SH T
FLUSHER	F L AH SH ER
FLUSHERS	F L AH SH ER Z
FLUSHES	F L AH SH IH Z
FLUSHEST	F L AH SH AH S T
FLUSHING	F L AH SH IH NG
FLUSHNESS	F L AH SH N AH S
FLUSHNESSES	F L AH SH N AH S IH Z
FOGYISH	F OW G IY IH SH
FOLKISH	F OW K IH SH
FOLKISHNESS	F OW K IH SH N AH S
FOLKISHNESSES	F OW K IH SH N AH S IH Z
FOLKLORISH	F OW K L OW R IH SH
FOLLOWERSHIP	F AA L OW ER SH IH P
FOLLOWERSHIPS	F AA L OW ER SH IH P S
FOOLFISH	F UW L F IH SH
FOOLFISHES	F UW L F IH SH IH Z
FOOLISH	F UW L IH SH
FOOLISHER	F UW L IH SH ER
FOOLISHEST	F UW L IH SH AH S T
FOOLISHLY	F UW L IH SH L IY
FOOLISHNESS	F UW L IH SH N AH S
FOOLISHNESSES	F UW L IH SH N AH S IH Z
FOPPISH	F AA P IH SH
FOPPISHLY	F AA P IH SH L IY
FOPPISHNESS	F AA P IH SH N AH S
FOPPISHNESSES	F AA P IH SH N AH S IH Z
FOREMANSHIP	F OW R M AE N SH IH P
FOREMANSHIPS	F OW R M AE N SH IH P S
FORESHADOW	F AO R SH AE D OW
FORESHADOWED	F AO R SH AE D OW D
FORESHADOWER	F OW R SH AE D OW ER
FORESHADOWERS	F OW R SH AE D OW ER Z
FORESHADOWING	F AO R SH AE D OW IH NG
FORESHADOWS	F AO R SH AE D OW Z
FORESHANK	F OW R SH AE NG K
FORESHANKS	F OW R SH AE NG K S
FORESHEET	F OW R SH IY T
FORESHEETS	F OW R SH IY T S
FORESHOCK	F OW R SH AA K
FORESHOCKS	F OW R SH AA K S
FORESHORE	F OW R SH OW R
FORESHORES	F OW R SH OW R Z
FORESHORTEN	F OW R SH AO R T AH N
FORESHORTENED	F OW R SH AO R T AH N D
FORESHORTENING	F OW R SH AO R T AH N IH NG
FORESHORTENS	F OW R SH AO R T AH N Z
FORESHOW	F OW R SH OW
FORESHOWED	F OW R SH OW D
FORESHOWING	F OW R SH OW IH NG
FORESHOWN	F OW R SH OW N
FORESHOWS	F OW R SH OW Z
FORTYISH	F AO R T IY IH SH
FOXFISH	F AA K S F IH SH
FOXFISHES	F AA K S F IH SH IH Z
FRAMESHIFT	F R EY M SH IH F T
FRAMESHIFTS	F R EY M SH IH F T S
FREAKISH	F R IY K IH SH
FREAKISHLY	F R IY K IH SH L IY
FREAKISHNESS	F R IY K IH SH N AH S
FREAKISHNESSES	F R IY K IH SH N AH S IH Z
FRESH	F R EH SH
FRESHED	F R EH SH T
FRESHEN	F R EH SH AH N
FRESHENED	F R EH SH AH N D
FRESHENER	F R EH SH AH N ER
FRESHENER(2)	F R EH SH N ER
FRESHENERS	F R EH SH AH N ER Z
FRESHENERS(2)	F R EH SH N ER Z
FRESHENING	F R EH SH AH N IH NG
FRESHENING(2)	F R EH SH N IH NG
FRESHENS	F R EH SH AH N Z
FRESHER	F R EH SH ER
FRESHES	F R EH SH IH Z
FRESHEST	F R EH SH AH S T
FRESHET	F R EH SH AH T
FRESHETS	F R EH SH AH T S
FRESHING	F R EH SH IH NG
FRESHLY	F R EH SH L IY
FRESHMAN	F R EH SH M AH N
FRESHMEN	F R EH SH M IH N
FRESHNESS	F R EH SH N AH S
FRESHNESSES	F R EH SH N AH S IH Z
FRESHWATER	F R EH SH W AO T ER
FRESHWATERS	F R EH SH W AO T ER Z
FRIENDSHIP	F R EH N D SH IH P
FRIENDSHIPS	F R EH N D SH IH P S
FROGFISH	F R AA G F IH SH
FROGFISHES	F R AA G F IH SH IH Z
FROSH	F R AA SH
FRUMPISH	F R AH M P AH SH
FURBISH	F ER B IH SH
FURBISHED	F ER B IH SH T
FURBISHER	F ER B IH SH ER
FURBISHERS	F ER B IH SH ER Z
FURBISHES	F ER B IH SH AH Z
FURBISHING	F ER B IH SH IH NG
FURNISH	F ER N IH SH
FURNISHED	F ER N IH SH T
FURNISHER	F ER N IH SH ER
FURNISHERS	F ER N IH SH ER Z
FURNISHES	F ER N IH SH IH Z
FURNISHING	F ER N IH SH IH NG
FURNISHINGS	F ER N IH SH IH NG Z
GALOSH	G AH L AA SH
GALOSHE	G AE L AH SH
GALOSHED	G AE L AH SH T
GALOSHES	G AH L AA SH AH Z
GALOSHES(2)	G AH L AA SH IH Z
GAMASHES	G AE M AH SH AH Z
GAMESMANSHIP	G EY M Z M AH N SH IH P
GAMESMANSHIPS	G EY M Z M AE N SH IH P S
GANGSTERISH	G AE NG S T ER IH SH
GARFISH	G AA R F AH SH
GARFISHES	G AA R F AH SH AH Z
GARISH	G EH R IH SH
GARISHLY	G AE R IH SH L IY
GARISHNESS	G AE R IH SH N AH S
GARISHNESSES	G AE R IH SH N AH S IH Z
GARNISH	G AA R N IH SH
GARNISHED	G AA R N IH SH T
GARNISHEE	G AA R N AH SH IY IY
GARNISHEED	G AA R N AH SH IY D
GARNISHEEING	G AA R N IH SH IY AH NG
GARNISHEES	G AA R N AH SH IY Z
GARNISHES	G AA R N IH SH AH Z
GARNISHING	G AA R N AH SH AH NG
GARNISHMENT	G AA R N IH SH M AH N T
GARNISHMENTS	G AA R N IH SH M AH N T S
GASH	G AE SH
GASHED	G AE SH T
GASHER	G AE SH ER
GASHES	G AE SH AH Z
GASHEST	G AE SH AH S T
GASHING	G AE SH IH NG
GASHOLDER	G AE S HH OW L D ER
GASHOLDERS	G AE S HH OW L D ER Z
GASHOUSE	G AE S HH AW S
GASHOUSES	G AE SH AH S IH Z
GAWKISH	G AO K IH SH
GAWKISHLY	G AO K IH SH L IY
GAWKISHNESS	G AO K IH SH N AH S
GAWKISHNESSES	G AO K IH SH N AH S IH Z
GEARSHIFT	G IH ER SH IH F T
GEARSHIFTS	G IH ER SH IH F T S
GEISHA	G EY SH AH
GEISHAS	G IY SH AH Z
GENERALSHIP	JH EH N ER AH L SH IH P
GENERALSHIPS	JH EH N ER AH L SH IH P S
GHOULISH	G UW L IH SH
GHOULISHLY	G UW L IH SH L IY
GHOULISHNESS	G UW L IH SH N AH S
GHOULISHNESSES	G UW L IH SH N AH S IH Z
GIBBERISH	G IH B ER IH SH
GIBBERISHES	JH IH B EH R AH SH AH Z
GIRAFFISH	JH AH R AE F AH SH
GIRLISH	G ER L IH SH
GIRLISHLY	G ER L IH SH L IY
GIRLISHNESS	G ER L IH SH N AH S
GIRLISHNESSES	G ER L IH SH N AH S IH Z
GIRSH	JH AH R SH
GIRSHES	JH AH R SH AH Z
GLASSHOUSE	G L AE S HH AW S
GLASSHOUSES	G L AE S HH AW S IH Z
GLOBEFISH	G L OW B F IH SH
GLOBEFISHES	G L OW B F IH SH IH Z
GNASH	N AE SH
GNASHED	N AE SH T
GNASHES	N AE SH IH Z
GNASHING	N AE SH IH NG
GNOMISH	N OW M IH SH
GOATFISH	G OW T F IH SH
GOATFISHES	G OW T F IH SH IH Z
GOATISH	G OW T IH SH
GODSHIP	G AA D SH IH P
GODSHIPS	G AA D SH IH P S
GOLDFISH	G OW L D F IH SH
GOLDFISHES	G OW L D F IH SH IH Z
GOLOSH	G AA L AH SH
GOLOSHE	G AA L AH SH
GOLOSHES	G AA L AH SH AH Z
GOODISH	G UH D IH SH
GOOSEFISH	G UW S F IH SH
GOOSEFISHES	G UW S F IH SH IH Z
GOOSEFLESH	G UW S F L EH SH
GOOSEFLESHES	G UW S F L EH SH IH Z
GOSH	G AA SH
GOSHAWK	G AA S HH AO K
GOSHAWKS	G OW Z HH AO K S
GOULASH	G UW L AA SH
GOULASHES	G AW L AH SH AH Z
GOVERNORSHIP	G AH V ER N ER SH IH P
GOVERNORSHIPS	G AH V ER N ER SH IH P S
GOYISH	G OW IY IH SH
GRANTSMANSHIP	G R AE N T S M AE N SH IH P
GRANTSMANSHIPS	G R AE N T S M AE N SH IH P S
GRAPESHOT	G R EY P SH AA T
GRASSHOPPER	G R AE S HH AA P ER
GRASSHOPPERS	G R AE S HH AA P ER Z
GRAYFISH	G R EY F IH SH
GRAYFISHES	G R EY F IH SH IH Z
GRAYISH	G R EY IH SH
GREENISH	G R IY N IH SH
GREENISHNESS	G R IY N IH SH N AH S
GREENISHNESSES	G R IY N IH SH N AH S IH Z
GREENSHANK	G R IY N SH AE NG K
GREENSHANKS	G R IY N SH AE NG K S
GREYISH	G R EY IH SH
GROGSHOP	G R AA G SH AA P
GROGSHOPS	G R AA G SH AA P S
GROUNDFISH	G R AW N D F IH SH
GROUNDFISHES	G R AW N D F IH SH IH Z
GROUNDSHEET	G R AW N D SH IY T
GROUNDSHEETS	G R AW N D SH IY T S
GRUFFISH	G R AH F IH SH
GRUMPISH	G R AH M P AH SH
GRUSHIE	G R AH SH AY
GUARDIANSHIP	G AA R D IY AH N SH IH P
GUARDIANSHIPS	G AA R D IY AH N SH IH P S
GUILDSHIP	G IH L D SH IH P
GUILDSHIPS	G IH L D SH IH P S
GUITARFISH	G AH T AA R F IH SH
GUITARFISHES	G AH T AA R F IH SH IH Z
GUMSHOE	G AH M SH UW
GUMSHOED	G AH M SH UW D
GUMSHOEING	G AH M SH UW IH NG
GUMSHOES	G AH M SH UW Z
GUNSHIP	G AH N SH IH P
GUNSHIPS	G AH N SH IH P S
GUNSHOT	G AH N SH AA T
GUNSHOTS	G AH N SH AA T S
GURSH	G AH R SH
GURSHES	G AH R SH AH Z
GURUSHIP	G AH R UW SH IH P
GURUSHIPS	G AH R UW SH IH P S
GUSH	G AH SH
GUSHED	G AH SH T
GUSHER	G AH SH ER
GUSHERS	G AH SH ER Z
GUSHES	G AH SH IH Z
GUSHIER	G AH SH IY ER
GUSHIEST	G AH SH IY AH S T
GUSHILY	G AH SH IY L IY
GUSHINESS	G AH SH IY N AH S
GUSHINESSES	G AH SH IY N AH S IH Z
GUSHING	G AH SH IH NG
GUSHINGLY	G AH SH IH NG L IY
GUSHY	G AH SH IY
GUTTERSNIPISH	G AH T ER S N AY P IH SH
GYPSYISH	JH IH P S IY IH SH
HABERDASHER	HH AH B AH R D AH SH AH R
HABERDASHERIES	HH AE B ER D AE SH AH R IY Z
HABERDASHERS	HH AH B AH R D AH SH AH R Z
HABERDASHERY	HH AE B ER D AE SH ER IY
HAGBUSH	HH AE G AH SH
HAGBUSHES	HH AE G AH SH AH Z
HAGFISH	HH AE G F IH SH
HAGFISHES	HH AE G F AH SH AH Z
HAGGISH	HH AE G AH SH
HAIRBRUSH	HH EH R B R AH SH
HAIRBRUSHES	HH EH R B R AH SH IH Z
HANDCRAFTSMANSHIP	HH AE N D K R AE F T S M AE N SH IH P
HANDCRAFTSMANSHIPS	HH AE N D K R AE F T S M AE N SH IH P S
HANDSHAKE	HH AE N D SH EY K
HANDSHAKES	HH AE N D SH EY K S
HANDSHAKING	HH AE N D SH EY K IH NG
HANDSHAKINGS	HH AE N D SH EY K IH NG Z
HARDSHIP	HH AA R D SH IH P
HARDSHIPS	HH AA R D SH IH P S
HARSH	HH AA R SH
HARSHEN	HH AA R SH AH N
HARSHENED	HH AA R SH AH N D
HARSHENING	HH AA R SH AH N IH NG
HARSHENS	HH AA R SH AH N Z
HARSHER	HH AA R SH ER
HARSHEST	HH AA R SH AH S T
HARSHLY	HH AA R SH L IY
HARSHNESS	HH AA R SH N AH S
HARSHNESSES	HH AA R SH N AH S IH Z
HARTSHORN	HH AA R T S HH AO R N
HARTSHORNS	HH AA R T S HH AO R N Z
HASH	HH AE SH
HASHED	HH AE SH T
HASHEESH	HH AH SH IY SH
HASHEESHES	HH AH SH IY SH AH Z
HASHES	HH AE SH AH Z
HASHHEAD	HH AE SH HH EH D
HASHHEADS	HH AE SH HH EH D Z
HASHING	HH AE SH IH NG
HASHISH	HH AE SH IY SH
HASHISHES	HH AE SH IH SH IH Z
HAWKISH	HH AO K IH SH
HAWKISHLY	HH AO K IH SH L IY
HAWKISHNESS	HH AO K IH SH N AH S
HAWKISHNESSES	HH AO K IH SH N AH S IH Z
HAWKSHAW	HH AO K SH AO
HAWKSHAWS	HH AO K SH AO Z
HEADFISH	HH EH D F IH SH
HEADFISHES	HH EH D F IH SH IH Z
HEADMASTERSHIP	HH EH D M AE S T ER SH IH P
HEADMASTERSHIPS	HH EH D M AE S T ER SH IH P S
HEADSHIP	HH EH D SH IH P
HEADSHIPS	HH EH D SH IH P S
HEADSHRINKER	HH EH D SH R IH NG K ER
HEADSHRINKERS	HH EH D SH R IH NG K ER Z
HEATHENISH	HH IY DH AH N IH SH
HEATHENISHLY	HH IY DH AH N IH SH L IY
HEIMISH	HH IY M AH SH
HEIRSHIP	EH R SH IH P
HEIRSHIPS	EH R SH IH P S
HEISHI	HH IY SH IY
HELLISH	HH EH L IH SH
HELLISHLY	HH EH L IH SH L IY
HELLISHNESS	HH EH L IH SH N AH S
HELLISHNESSES	HH EH L IH SH N AH S IH Z
HELMSMANSHIP	HH EH L M Z M AE N SH IH P
HELMSMANSHIPS	HH EH L M Z M AE N SH IH P S
HIBAKUSHA	HH AH B AE K AH SH AH
HICKISH	HH IH K IH SH
HIGHBUSH	HH AY B UH SH
HIPPISH	HH IH P IH SH
HIPSHOT	HH IH P SH AA T
HOBBLEBUSH	HH AA B AH L B UH SH
HOBBLEBUSHES	HH AA B AH L B UH SH IH Z
HOCKSHOP	HH AA K SH AA P
HOCKSHOPS	HH AA K SH AA P S
HOGFISH	HH AA G F IH SH
HOGFISHES	HH AA G F IH SH IH Z
HOGGISH	HH AA G IH SH
HOGGISHLY	HH AA G IH SH L IY
HOGGISHNESS	HH AA G IH SH N AH S
HOGGISHNESSES	HH AA G IH SH N AH S IH Z
HOGSHEAD	HH AA G Z HH EH D
HOGSHEADS	HH AA G Z HH EH D Z
HOGWASH	HH AA G W AA SH
HOGWASHES	HH AA G W AA SH IH Z
HOODLUMISH	HH UW D L AH M IH SH
HORSEFLESH	HH AO R S F L EH SH
HORSEFLESHES	HH AO R S F L EH SH IH Z
HORSEMANSHIP	HH AO R S M AH N SH IH P
HORSEMANSHIPS	HH AO R S M AE N SH IH P S
HORSERADISH	HH AO R S R AE D IH SH
HORSERADISHES	HH AO R S ER EY D IH SH IH Z
HORSESHIT	HH AO R SH IH T
HORSESHITS	HH AO R S SH IH T S
HORSESHOD	HH AO R S SH AA D
HORSESHOE	HH AO R S SH UW
HORSESHOED	HH AO R S SH UW D
HORSESHOEING	HH AO R S SH UW IH NG
HORSESHOER	HH AO R S SH UW ER
HORSESHOERS	HH AO R S SH UW ER Z
HORSESHOES	HH AO R S SH UW Z
HOTSHOT	HH AA SH AA T
HOTSHOTS	HH AA SH AA T S
HOTTISH	HH AA T IH SH
HOYDENISH	HH OY D AH N IH SH
HUFFISH	HH AH F IH SH
HUNNISH	HH AH N AH SH
HUSH	HH AH SH
HUSHABY	HH AH SH AH B AY
HUSHED	HH AH SH T
HUSHEDLY	HH AH SH AH D L IY
HUSHES	HH AH SH IH Z
HUSHFUL	HH AH SH F AH L
HUSHING	HH AH SH IH NG
IMMESH	IH M EH SH
IMMESHED	IH M EH SH T
IMMESHES	IH M EH SH IH Z
IMMESHING	IH M EH SH IH NG
IMPERISHABILITIES	IH M P EH R IH SH AH B IH L AH T EH Z
IMPERISHABILITY	IH M P EH R IH SH AH B IH L AH T EH
IMPERISHABLE	IH M P EH R IH SH AH B AH L
IMPERISHABLENESS	IH M P EH R IH SH AH B AH L N AH S
IMPERISHABLENESSES	IH M P EH R IH SH AH B AH L N AH S IH Z
IMPERISHABLES	IH M P EH R IH SH AH B AH L Z
IMPERISHABLY	IH M P EH R IH SH AH B L IY
IMPISH	IH M P IH SH
IMPISHLY	IH M P IH SH L IY
IMPISHNESS	IH M P IH SH N AH S
IMPISHNESSES	IH M P IH SH N EH S AH Z
IMPOVERISH	IH M P AA V R IH SH
IMPOVERISHED	IH M P AA V R IH SH T
IMPOVERISHER	IH M P AA V R IH SH ER
IMPOVERISHERS	IH M P AA V R IH SH ER Z
IMPOVERISHES	IH M P AA V R IH SH AH Z
IMPOVERISHING	IH M P AA V R IH SH IH NG
IMPOVERISHMENT	IH M P AA V R IH SH M AH N T
IMPOVERISHMENTS	IH M P AA V R IH SH M AH N T S
INDISTINGUISHABILITIES	IH N D IH S T IH NG G W IH SH AH B IH L AH T EH Z
INDISTINGUISHABILITY	IH N D IH S T IH NG G W IH SH AH B IH L AH T EH
INDISTINGUISHABLE	IH N D IH S T IH NG G W IH SH AH B AH L
INDISTINGUISHABLENESS	IH N D IH S T IH NG G W IH SH AH B AH L N AH S
INDISTINGUISHABLENESSES	IH N D IH S T IH NG G W IH SH AH B AH L N AH S IH Z
INDISTINGUISHABLY	IH N D IH S T IH NG G W IH SH AH B L IY
INEXTINGUISHABLE	IH N IH K S T IH NG G W IH SH AH B AH L
INEXTINGUISHABLY	IH N IH K S T IH NG G W IH SH AH B L IY
INMESH	IH N M EH SH
INMESHED	IH N M EH SH T
INMESHES	IH N M EH SH IH Z
INMESHING	IH N M EH SH IH NG
INRUSH	IH N R AH SH
INRUSHES	IH N R AH SH IH Z
INSHEATH	IH N SH IY TH
INSHEATHED	IH N SH IY DH D
INSHEATHING	IH N SH IY DH IH NG
INSHEATHS	IH N SH IY TH S
INSHORE	IH N SH AO R
INSHRINE	IH N SH R AY N
INSHRINED	IH N SH R AY N D
INSHRINES	IH N SH R AY N Z
INSHRINING	IH N SH R AY N IH NG
INSPECTORSHIP	IH N S P EH K T ER SH IH P
INSPECTORSHIPS	IH N S P EH K T ER SH IH P S
INSTRUCTORSHIP	IH N S T R AH K T ER SH IH P
INSTRUCTORSHIPS	IH N S T R AH K T ER SH IH P S
INTERMESH	IH N T ER M EH SH
INTERMESHED	IH N T ER M EH SH T
INTERMESHES	IH N T ER M EH SH IH Z
INTERMESHING	IH N T ER M EH SH IH NG
INTERNSHIP	IH N T ER N SH IH P
INTERNSHIPS	IH N T ER N SH IH P S
INTERPARISH	IH N T ER P AE R IH SH
INTERRELATIONSHIP	IH N T ER R IY L EY SH AH N SH IH P
INTERRELATIONSHIPS	IH N T ER R IY L EY SH AH N SH IH P S
JACKFISH	JH AE K F IH SH
JACKFISHES	JH AE K F IH SH IH Z
JADISH	JH EY D IH SH
JADISHLY	JH EY D IH SH L IY
JARGONISH	JH AA R G AH N IH SH
JELLYFISH	JH EH L IY F IH SH
JELLYFISHES	JH EH L IY F IH SH IH Z
JEWFISH	JH UW F IH SH
JEWFISHES	JH UW F IH SH IH Z
JINGOISH	JH IH N G OW AH SH
JINRICKSHA	JH IH N R IH K AH
JINRICKSHAS	JH IH N R IH K AH Z
JINRIKISHA	JH IH N R IH K AH SH AH
JINRIKISHAS	JH IH N R IH K AH SH AH Z
JOSH	JH AA SH
JOSHED	JH AA SH T
JOSHER	JH AA SH AH R
JOSHERS	JH AA SH AH R Z
JOSHES	JH AA SH AH Z
JOSHING	JH AA SH AH NG
JUDGESHIP	JH AH JH SH IH P
JUDGESHIPS	JH AH JH SH IH P S
KADDISH	K AA D IH SH
KADDISHES	K AA D IH SH IH Z
KADDISHIM	K AE D AH SH AH M
KASHA	K AA SH AH
KASHAS	K AE SH AH Z
KASHER	K AE SH AH R
KASHERED	K AH SH IY R D
KASHERING	K AH SH IY R AH NG
KASHERS	K AE SH AH R Z
KASHMIR	K AE SH M IH R
KASHMIR(2)	K AE SH M IY R
KASHMIRS	K AE SH M AH R Z
KASHRUT	K AE SH R AH T
KASHRUTH	K AE SH R AH TH
KASHRUTHS	K AE SH R AH TH S
KASHRUTS	K AE SH R Y UW T S
KEESHOND	K IY SH AH N D
KEESHONDEN	K IY SH AA N D AH N
KEESHONDS	K IY SH AH N D Z
KIBOSH	K IH B AH SH
KIBOSHED	K IH B AH SH T
KIBOSHES	K IH B AH SH AH Z
KIBOSHING	K IH B AH SH AH NG
KICKSHAW	K IH K SH AO
KICKSHAWS	K IH K SH AO Z
KIDDISH	K IH D IH SH
KIDDUSH	K IH D AH SH
KIDDUSHES	K IH D AH SH AH Z
KIDDUSHIM	K IH D AH SH AH M
KILLIFISH	K IH L IH F IH SH
KILLIFISHES	K IH L IH F AH SH AH Z
KINGFISH	K IH NG F IH SH
KINGFISHER	K IH NG F IH SH ER
KINGFISHERS	K IH NG F IH SH ER Z
KINGFISHES	K IH NG F IH SH IH Z
KINGSHIP	K IH NG SH IH P
KINGSHIPS	K IH NG SH IH P S
KINSHIP	K IH N SH IH P
KINSHIPS	K IH N SH IH P S
KISHKA	K IH SH AH
KISHKAS	K IH SH AH Z
KISHKE	K IH SH
KISHKES	K IH SH S
KITTENISH	K IH T AH N IH SH
KITTENISHLY	K IH T AH N IH SH L IY
KITTENISHNESS	K IH T AH N IH SH N AH S
KITTENISHNESSES	K IH T AH N IH SH N AH S IH Z
KNAVISH	N EY V AH SH
KNAVISHLY	N AH V IH SH L IY
KNISH	N IH SH
KNISHES	N IH SH AH Z
KOSHER	K OW SH ER
KOSHERED	K OW SH ER D
KOSHERING	K OW SH ER IH NG
KOSHERS	K OW SH ER S
KURBASH	K AH R B AH SH
KURBASHED	K AH R B AH SH T
KURBASHES	K AH R B AH SH AH Z
KURBASHING	K AH R B AH SH AH NG
KWASHIORKOR	K W AA SH IY AO R K AH R
KWASHIORKORS	K W AA SH IY AO R K AH R Z
KYBOSH	K IH B AH SH
KYBOSHED	K IH B AH SH T
KYBOSHES	K IH B AH SH AH Z
KYBOSHING	K IH B AH SH AH NG
LADYFISH	L EY D IY F IH SH
LADYFISHES	L EY D IY F IH SH IH Z
LADYISH	L EY D IY IH SH
LADYSHIP	L EY D IY SH IH P
LADYSHIPS	L EY D IY SH IH P S
LAKESHORE	L EY K SH AO R
LAKESHORES	L EY K SH OW R Z
LAMPSHELL	L AE M P SH EH L
LAMPSHELLS	L AE M P SH EH L Z
LANDOWNERSHIP	L AE N D OW N ER SH IH P
LANDOWNERSHIPS	L AE N D OW N ER SH IH P S
LANGSHAN	L AE N G SH AH N
LANGSHANS	L AE N G SH AH N Z
LANGUISH	L AE NG G W IH SH
LANGUISHED	L AE NG G W IH SH T
LANGUISHER	L AE NG G W IH SH ER
LANGUISHERS	L AE NG G W IH SH ER Z
LANGUISHES	L AE NG G W IH SH IH Z
LANGUISHING	L AE NG G W IH SH IH NG
LANGUISHINGLY	L AE NG G W IH SH IH NG L IY
LANGUISHMENT	L AE NG G W IH SH M AH N T
LANGUISHMENTS	L AE NG G W IH SH M AH N T S
LARGISH	L AA R JH IH SH
LARKISH	L AA R K IH SH
LASH	L AE SH
LASHED	L AE SH T
LASHER	L AE SH ER
LASHERS	L AE SH ER Z
LASHES	L AE SH IH Z
LASHING	L AE SH IH NG
LASHINGS	L AE SH IH NG Z
LASHINS	L AE SH IH N Z
LASHKAR	L AE SH AH R
LASHKARS	L AE SH AH R Z
LATISH	L EY T IH SH
LAUREATESHIP	L AO R IY AH T SH IH P
LAUREATESHIPS	L AO R IY AH T SH IH P S
LAVISH	L AE V IH SH
LAVISHED	L AE V IH SH T
LAVISHER	L AE V IH SH ER
LAVISHERS	L AE V IH SH ER Z
LAVISHES	L AE V IH SH AH Z
LAVISHEST	L AE V IH SH AH S T
LAVISHING	L AE V IH SH IH NG
LAVISHLY	L AE V IH SH L IY
LAVISHNESS	L AE V IH SH N AH S
LAVISHNESSES	L AE V IH SH N AH S IH Z
LAZYISH	L EY Z IY IH SH
LEADERSHIP	L IY D ER SH IH P
LEADERSHIPS	L IY D ER SH IH P S
LEASH	L IY SH
LEASHED	L IY SH T
LEASHES	L IY SH IH Z
LEASHING	L IY SH IH NG
LECTURESHIP	L EH K CH ER SH IH P
LECTURESHIPS	L EH K CH ER SH IH P S
LEFTISH	L EH F T IH SH
LEGATESHIP	L EH G AH T SH IH P
LEGATESHIPS	L EH G AH T SH IH P S
LEGISLATORSHIP	L EH JH AH S L EY T ER SH IH P
LEGISLATORSHIPS	L EH JH AH S L EY T ER SH IH P S
LEISHMANIA	L IY SH M EY N Y AH
LEISHMANIAL	L IY SH M EY N IY AH L
LEISHMANIAS	L IY SH M EY N Y AH Z
LEISHMANIASES	L IY SH M EY N IY EY Z AH Z
LEISHMANIASIS	L IY SH M EY N Y AH S AH S
LEMONISH	L EH M AH N IH SH
LEPRECHAUNISH	L EH P R EH CH AH N AH SH
LIBRARIANSHIP	L AY B R EH R IY AH N SH IH P
LIBRARIANSHIPS	L AY B R EH R IY AH N SH IH P S
LICKERISH	L IH K ER IH SH
LICKERISHLY	L IH K ER IH SH L IY
LICKERISHNESS	L IH K ER IH SH N AH S
LICKERISHNESSES	L IH K ER IH SH N AH S IH Z
LIFEMANSHIP	L AY F M AE N SH IH P
LIFEMANSHIPS	L AY F M AE N SH IH P S
LIGHTISH	L AY T IH SH
LIGHTSHIP	L AY T SH IH P
LIGHTSHIPS	L AY T SH IH P S
LIONFISH	L AY AH N F IH SH
LIONFISHES	L AY AH N F IH SH IH Z
LISTENERSHIP	L IH S AH N ER SH IH P
LISTENERSHIPS	L IH S AH N ER SH IH P S
LITTLISH	L IH T AH L IH SH
LIVERISH	L IH V ER IH SH
LIVERISHNESS	L IH V ER IH SH N AH S
LIVERISHNESSES	L IH V ER IH SH N AH S IH Z
LONGISH	L AO NG IH SH
LONGSHIP	L AO NG SH IH P
LONGSHIPS	L AO NG SH IH P S
LONGSHOREMAN	L AO NG SH OW R M AE N
LONGSHOREMEN	L AO NG SH AO R M IH N
LONGSHORING	L AO NG SH OW R IH NG
LONGSHORINGS	L AO NG SH OW R IH NG Z
LORDSHIP	L AO R D SH IH P
LORDSHIPS	L AO R D SH IH P S
LOUDISH	L AW D IH SH
LOUTISH	L OW Y UW T AH SH
LOUTISHLY	L AW T IH SH L IY
LOUTISHNESS	L AW T IH SH N AH S
LOUTISHNESSES	L AW T IH SH N EH S AH Z
LOWISH	L OW IH SH
LUMPFISH	L AH M P F IH SH
LUMPFISHES	L AH M P F IH SH IH Z
LUMPISH	L AH M P IH SH
LUMPISHLY	L AH M P IH SH L IY
LUMPISHNESS	L AH M P IH SH N AH S
LUMPISHNESSES	L AH M P IH SH N AH S IH Z
LUNGFISH	L AH NG F IH SH
LUNGFISHES	L AH NG F IH SH IH Z
LUSH	L AH SH
LUSHED	L AH SH T
LUSHER	L AH SH ER
LUSHES	L AH SH IH Z
LUSHEST	L AH SH AH S T
LUSHING	L AH SH IH NG
LUSHLY	L AH SH L IY
LUSHNESS	L AH SH N AH S
LUSHNESSES	L AH SH N AH S IH Z
MACINTOSH	M AE K AH N T AO SH
MACINTOSHES	M AE K AH N T AO SH IH Z
MACKINTOSH	M AE K AH N T AA SH
MACKINTOSHES	M AE K AH N T AA SH IH Z
MADDISH	M AE D IH SH
MAHARISHI	M AH HH AE R AH SH IY
MAHARISHIS	M AH HH AE R AH SH AH S
MAIDISH	M EY D IH SH
MAINSHEET	M EY N SH IY T
MAINSHEETS	M EY N SH IY T S
MAKESHIFT	M EY K SH IH F T
MAKESHIFTS	M EY K SH IH F T S
MALNOURISHED	M AE L N ER IH SH T
MANAGERSHIP	M AE N IH JH ER SH IH P
MANAGERSHIPS	M AE N IH JH ER SH IH P S
MANNISH	M AE N IH SH
MANNISHLY	M AE N IH SH L IY
MANNISHNESS	M AE N IH SH N AH S
MANNISHNESSES	M AE N IH SH N AH S IH Z
MANTELSHELF	M AE N T AH L SH EH L F
MANTELSHELVES	M AE N T AH L SH EH L V Z
MARISH	M EH R IH SH
MARISHES	M EH R IH SH IH Z
MARKSMANSHIP	M AA R K S M AH N SH IH P
MARKSMANSHIPS	M AA R K S M AE N SH IH P S
MARSH	M AA R SH
MARSHAL	M AA R SH AH L
MARSHALCIES	M AA R SH AE L S AY Z
MARSHALCY	M AA R SH AE L S IY
MARSHALED	M AA R SH AH L D
MARSHALING	M AA R SH AH L IH NG
MARSHALL	M AA R SH AH L
MARSHALLED	M AA R SH AH L D
MARSHALLING	M AA R SH AH L IH NG
MARSHALLS	M AA R SH AO L Z
MARSHALS	M AA R SH AH L Z
MARSHALSHIP	M AA R SH AH L SH IH P
MARSHALSHIPS	M AA R SH AH L SH IH P S
MARSHES	M AA R SH AH Z
MARSHES(2)	M AA R SH IH Z
MARSHIER	M AA R SH IY ER
MARSHIEST	M AA R SH IY AH S T
MARSHINESS	M AA R SH IY N AH S
MARSHINESSES	M AA R SH IY N AH S IH Z
MARSHLAND	M AA R SH L AE N D
MARSHLANDS	M AA R SH L AE N D Z
MARSHMALLOW	M AA R SH M EH L OW
MARSHMALLOWS	M AA R SH M EH L OW Z
MARSHMALLOWY	M AA R SH M EH L OW IY
MARSHY	M AA R SH IY
MASH	M AE SH
MASHED	M AE SH T
MASHER	M AE SH ER
MASHERS	M AE SH ER Z
MASHES	M AE SH IH Z
MASHIE	M AE SH IY
MASHIES	M AE SH IY Z
MASHING	M AE SH IH NG
MASHY	M AE SH IY
MASTERSHIP	M AE S T ER SH IH P
MASTERSHIPS	M AE S T ER SH IH P S
MATESHIP	M EY T SH IH P
MATESHIPS	M EY T SH IH P S
MAWKISH	M AO K IH SH
MAWKISHLY	M AO K IH SH L IY
MAWKISHNESS	M AO K IH SH N AH S
MAWKISHNESSES	M AO K IH SH N AH S IH Z
MAYBUSH	M EY B UH SH
MAYBUSHES	M EY B UH SH IH Z
MEDIUMSHIP	M IY D IY AH M SH IH P
MEDIUMSHIPS	M IY D IY AH M SH IH P S
MEMBERSHIP	M EH M B ER SH IH P
MEMBERSHIPS	M EH M B ER SH IH P S
MENTORSHIP	M EH N T AO R SH IH P
MENTORSHIPS	M EH N T AO R SH IH P S
MESH	M EH SH
MESHED	M EH SH T
MESHES	M EH SH IH Z
MESHIER	M EH SH IY ER
MESHIEST	M EH SH IY AH S T
MESHING	M EH SH IH NG
MESHUGA	M AH SH UW G AH
MESHUGAH	M AH SH UW G AH
MESHUGGA	M AH SH AH G AH
MESHUGGAH	M AH SH AH G AH
MESHUGGE	M EH SH AH JH
MESHUGGENER	M IY Z HH AH G AH N ER
MESHUGGENERS	M IY Z HH AH G AH N ER Z
MESHWORK	M EH SH W ER K
MESHWORKS	M EH SH W ER K S
MESHY	M EH SH IY
MESSIAHSHIP	M AH S AY AH SH IH P
MESSIAHSHIPS	M AH S AY AH SH IH P S
MICROPUBLISHER	M AY K R OW P AH B L IH SH ER
MICROPUBLISHERS	M AY K R OW P AH B L IH SH ER Z
MICROPUBLISHING	M AY K R OW P AH B L IH SH IH NG
MICROPUBLISHINGS	M AY K R OW P AH B L IH SH IH NG Z
MIDRASH	M IH D R AE SH
MIDRASHIC	M IH D R AE SH IH K
MIDRASHIM	M IH D R AH SH AH M
MIDRASHOT	M IH D R AH SH AH T
MIDRASHOTH	M IH D R AH SH AH TH
MIDSHIP	M IH D SH IH P
MIDSHIPMAN	M IH D SH IH P M AH N
MIDSHIPMEN	M IH D SH IH P M EH N
MIDSHIPS	M IH D SH IH P S
MILKFISH	M IH L K F IH SH
MILKFISHES	M IH L K F IH SH IH Z
MILKSHAKE	M IH L K SH EY K
MILKSHAKES	M IH L K SH EY K S
MILKSHED	M IH L K SH EH D
MILKSHEDS	M IH L K SH EH D Z
MINISH	M IH N IH SH
MINISHED	M IH N IY SH EH D
MINISHES	M AY N IH SH IH Z
MINISHING	M AY N IH SH IH NG
MINXISH	M IH NG K S AH SH
MISHANDLE	M IH S HH AE N D AH L
MISHANDLED	M IH S HH AE N D AH L D
MISHANDLES	M IH S HH AE N D AH L Z
MISHANDLING	M IH S HH AE N D L IH NG
MISHANTER	M IH S AE N T AH R
MISHANTERS	M IH S AE N T AH R Z
MISHAP	M IH S HH AE P
MISHAPS	M IH S HH AE P S
MISHEAR	M IH S HH IY R
MISHEARD	M IH S HH ER D
MISHEARING	M IH S HH IH ER IH NG
MISHEARS	M IH S HH IH ER Z
MISHIT	M IH S HH IH T
MISHITS	M IH S HH IH T S
MISHITTING	M IH S HH IH T IH NG
MISHMASH	M IH SH M AE SH
MISHMASHES	M IH S M AE SH AH Z
MISHMOSH	M IH S M AA SH
MISHMOSHES	M IH S M AA SH AH Z
MISSHAPE	M IH S SH EY P
MISSHAPED	M IH S SH EY P T
MISSHAPEN	M IH S SH EY P AH N
MISSHAPEN(2)	M IH S HH AE P AH N
MISSHAPENLY	M IH S SH EY P AH N L IY
MISSHAPES	M IH S SH EY P S
MISSHAPING	M IH S SH EY P IH NG
MISSHOD	M IH S SH AA D
MOBBISH	M AA B IH SH
MODERATORSHIP	M AA D AH R AH T ER SH IH P
MODERATORSHIPS	M AA D AH R AH T ER SH IH P S
MODISH	M OW D IH SH
MODISHLY	M OW D IH SH L IY
MODISHNESS	M OW D IH SH N AH S
MODISHNESSES	M OW D IH SH N AH S IH Z
MONISH	M OW N AH SH
MONISHED	M AA N AH SH T
MONISHES	M AA N AH SH AH Z
MONISHING	M AA N AH SH AH NG
MONITORSHIP	M AA N AH T ER SH IH P
MONITORSHIPS	M AA N AH T ER SH IH P S
MONKEYSHINE	M AH NG K IY SH AY N
MONKEYSHINES	M AH NG K IY SH AY N Z
MONKFISH	M AH NG K F IH SH
MONKFISHES	M AH NG K F IH SH IH Z
MONKISH	M AH NG K IH SH
MONKSHOOD	M AH NG K S HH UH D
MONKSHOODS	M AH NG K S HH UH D Z
MOONFISH	M UW N F IH SH
MOONFISHES	M UW N F IH SH IH Z
MOONISH	M UW N IH SH
MOONISHLY	M UW N IH SH L IY
MOONSHINE	M UW N SH AY N
MOONSHINER	M UW N SH AY N ER
MOONSHINERS	M UW N SH AY N ER Z
MOONSHINES	M UW N SH AY N Z
MOONSHOT	M UW N SH AA T
MOONSHOTS	M UW N SH AA T S
MOORISH	M UH R IH SH
MOPISH	M AA P IH SH
MOPISHLY	M AA P IH SH L IY
MOSH	M AO SH
MOSHAV	M AA SH AH V
MOSHAVIM	M AA SH AH V AH M
MOSHED	M AA SH T
MOSHER	M OW ZH ER
MOSHERS	M AA SH AH R Z
MOSHES	M AA SH AH Z
MOSHING	M AA SH AH NG
MOUTHWASH	M AW TH W AA SH
MOUTHWASHES	M AW TH W AA SH IH Z
MUDFISH	M AH D F IH SH
MUDFISHES	M AH D F IH SH IH Z
MUGSHOT	M AH G SH AA T
MUGSHOTS	M AH G SH AA T S
MULISH	M Y UW L IH SH
MULISHLY	M Y UW L IH SH L IY
MULISHNESS	M Y UW L IH SH N AH S
MULISHNESSES	M Y UW L IH SH N AH S IH Z
MULTIFLASH	M AH L T AY F L AE SH
MUSH	M AH SH
MUSHED	M AH SH T
MUSHER	M AH SH ER
MUSHERS	M AH SH ER Z
MUSHES	M AH SH AH Z
MUSHIER	M AH SH AY AH R
MUSHIEST	M AH SH AY AH S T
MUSHILY	M AH SH AH L IY
MUSHINESS	M AH SH AH N AH S
MUSHINESSES	M AH SH AH N EH S AH Z
MUSHING	M AH SH AH NG
MUSHROOM	M AH SH R UW M
MUSHROOMED	M AH SH R UH M D
MUSHROOMING	M AH SH R UH M IH NG
MUSHROOMS	M AH SH R UW M Z
MUSHY	M AH SH IY
MUSICIANSHIP	M Y UW Z IH SH AH N SH IH P
MUSICIANSHIPS	M Y UH Z IH SH AH N SH IH P S
MUSQUASH	M AH S W AH SH
MUSQUASHES	M AH S W AH SH AH Z
MUTTONFISH	M AH T AH N F IH SH
MUTTONFISHES	M AH T AH N F IH SH IH Z
NABOBISH	N AE B AH B AH SH
NAILBRUSH	N EY L B R AH SH
NAILBRUSHES	N EY L B R AH SH IH Z
NEARSHORE	N IH ER SH OW R
NEBBISH	N EH B AH SH
NEBBISHES	N EH B AH SH AH Z
NEBBISHY	N EH B AH SH IY
NEEDLEFISH	N IY D AH L F IH SH
NEEDLEFISHES	N IY D AH L F IH SH IH Z
NERDISH	N AH R D AH SH
NEWISH	N UW IH SH
NEWSHAWK	N UW Z HH AO K
NEWSHAWKS	N UW Z HH AO K S
NEWSHOUND	N UW Z HH AW N D
NEWSHOUNDS	N UW Z HH AW N D Z
NIGHTMARISH	N AY T M EH R IH SH
NIGHTMARISHLY	N AY T M EH R IH SH L IY
NIGHTSHADE	N AY CH EY D
NIGHTSHADES	N AY T SH EY D Z
NIGHTSHIRT	N AY CH ER T
NIGHTSHIRTS	N AY CH ER T S
NINNYISH	N IH N AY AH SH
NOIRISH	N OY R AH SH
NONCASH	N AA N K AE SH
NONCRUSHABLE	N AA N K R AH SH AH B AH L
NONESTABLISHED	N AA N IH S T AE B L IH SH T
NONESTABLISHMENT	N AA N IH S T AE B L IH SH M AH N T
NONESTABLISHMENTS	N AA N IH S T AE B L IH SH M AH N T S
NONKOSHER	N AA N K OW SH ER
NONMEMBERSHIP	N AA N M EH M B ER SH IH P
NONMEMBERSHIPS	N AA N M EH M B ER SH IH P S
NONPARTISANSHIP	N AA N P AA R T AH Z AH N SH IH P
NONPARTISANSHIPS	N AA N P AA R T AH Z AH N SH IH P S
NONPERISHABLE	N AA N P EH R IH SH AH B AH L
NONPERISHABLES	N AA N P EH R IH SH AH B AH L Z
NONSHRINK	N AA N SH R IH NG K
NONSHRINKABLE	N AA N SH R IH NG K AH B AH L
NONVANISHING	N AA N V AE N IH SH IH NG
NOSH	N AA SH
NOSHED	N AA SH T
NOSHER	N AA SH AH R
NOSHERS	N AA SH AH R Z
NOSHES	N AA SH AH Z
NOSHING	N AA SH AH NG
NOURISH	N ER IH SH
NOURISHED	N ER IH SH T
NOURISHER	N ER IH SH ER
NOURISHERS	N ER IH SH ER Z
NOURISHES	N ER IH SH AH Z
NOURISHING	N ER IH SH IH NG
NOURISHMENT	N ER IH SH M AH N T
NOURISHMENTS	N ER IH SH M AH N T S
NOVELETTISH	N AA V AH L EH T IH SH
NUMBFISH	N AH M F IH SH
NUMBFISHES	N AH M F IH SH IH Z
NUNNISH	N AH N IH SH
NUTSHELL	N AH T SH EH L
NUTSHELLS	N AH T SH EH L Z
OAFISH	OW F IH SH
OAFISHLY	OW F IH SH L IY
OAFISHNESS	OW F IH SH N AH S
OAFISHNESSES	OW F IH SH N AH S IH Z
OARFISH	OW R F AH SH
OARFISHES	OW R F AH SH AH Z
OARSMANSHIP	OW R S M AH N SH IH P
OARSMANSHIPS	OW R S M AE N SH AH P S
ODDISH	AA D IH SH
OFFISH	AO F IH SH
OFFISHLY	AO F IH SH L IY
OFFISHNESS	AO F IH SH N AH S
OFFISHNESSES	AO F IH SH N AH S IH Z
OFFSHOOT	AO F SH UW T
OFFSHOOTS	AO F SH UW T S
OFFSHORE	AO F SH AO R
OGREISH	OW G ER IH SH
OGRISH	OW G ER IH SH
OGRISHLY	OW G ER IH SH L IY
OLDISH	OW L D IH SH
OMBUDSMANSHIP	AA M B AH D S M AH N SH IH P
OMBUDSMANSHIPS	AA M B AH D S M AE N SH AH P S
ONRUSH	AO N R AH SH
ONRUSHES	AO N R AH SH IH Z
ONRUSHING	AA N R AH SH IH NG
ONSHORE	AA N SH AO R
ORANGISH	AO R IH N JH IH SH
OUTBLUSH	AW T B L AH SH
OUTBLUSHED	AW T B L AH SH T
OUTBLUSHES	AW T B L AH SH IH Z
OUTBLUSHING	AW T B L AH SH IH NG
OUTDOORSMANSHIP	AW T D OW R Z M AE N SH IH P
OUTDOORSMANSHIPS	AW T D OW R Z M AE N SH IH P S
OUTFISH	AW T F IH SH
OUTFISHED	AW T F IH SH T
OUTFISHES	AW T F IH SH IH Z
OUTFISHING	AW T F IH SH IH NG
OUTGUSH	AW T G AH SH
OUTGUSHES	AW T G AH SH IH Z
OUTLANDISH	AW T L AE N D IH SH
OUTLANDISHLY	AW T L AE N D IH SH L IY
OUTLANDISHNESS	AW T L AE N D IH SH N AH S
OUTLANDISHNESSES	AW T L AE N D IH SH N AH S IH Z
OUTPUSH	AW T P UH SH
OUTPUSHED	AW T P UH SH T
OUTPUSHES	AW T P UH SH IH Z
OUTPUSHING	AW T P UH SH IH NG
OUTRUSH	AW T R AH SH
OUTRUSHED	AW T R AH SH T
OUTRUSHES	AW T R AH SH IH Z
OUTRUSHING	AW T R AH SH IH NG
OUTSHAME	AW T SH EY M
OUTSHAMED	AW T SH EY M D
OUTSHAMES	AW T SH EY M Z
OUTSHAMING	AW T SH EY M IH NG
OUTSHINE	AW CH AY N
OUTSHINED	AW T SH AY N D
OUTSHINES	AW CH AY N Z
OUTSHINING	AW CH AY N IH NG
OUTSHONE	AW T SH OW N
OUTSHOOT	AW T SH UW T
OUTSHOOTING	AW T SH UW T IH NG
OUTSHOOTS	AW T SH UW T S
OUTSHOT	AW T SH AA T
OUTSHOUT	AW T SH AW T
OUTSHOUTED	AW T SH AW T IH D
OUTSHOUTING	AW T SH AW T IH NG
OUTSHOUTS	AW T SH AW T S
OUTWASH	AW T W AA SH
OUTWASHES	AW T W AA SH IH Z
OUTWISH	AW T W IH SH
OUTWISHED	AW T W IH SH T
OUTWISHES	AW T W IH SH IH Z
OUTWISHING	AW T W IH SH IH NG
OVEREMBELLISH	OW V ER IH M B EH L IH SH
OVEREMBELLISHED	OW V ER IH M B EH L IH SH T
OVEREMBELLISHES	OW V ER IH M B EH L IH SH IH Z
OVEREMBELLISHING	OW V ER IH M B EH L IH SH IH NG
OVEREMBELLISHMENT	OW V ER IH M B EH L IH SH M AH N T
OVEREMBELLISHMENTS	OW V ER IH M B EH L IH SH M AH N T S
OVERFISH	OW V ER F IH SH
OVERFISHED	OW V ER F IH SH T
OVERFISHES	OW V ER F IH SH IH Z
OVERFISHING	OW V ER F IH SH IH NG
OVERLAVISH	OW V ER L AE V IH SH
OVERLORDSHIP	OW V ER L AO R D SH IH P
OVERLORDSHIPS	OW V ER L AO R D SH IH P S
OVERLUSH	OW V ER L AH SH
OVERNOURISH	OW V ER N ER IH SH
OVERNOURISHED	OW V ER N ER IH SH T
OVERNOURISHES	OW V ER N ER IH SH IH Z
OVERNOURISHING	OW V ER N ER IH SH IH NG
OVERRASH	OW V ER R AE SH
OVERSHADOW	OW V ER SH AE D OW
OVERSHADOWED	OW V ER SH AE D OW D
OVERSHADOWING	OW V ER SH AE D OW IH NG
OVERSHADOWS	OW V ER SH AE D OW Z
OVERSHIRT	OW V ER SH ER T
OVERSHIRTS	OW V ER SH ER T S
OVERSHOE	OW V ER SH UW
OVERSHOES	OW V ER SH UW Z
OVERSHOOT	OW V ER SH UW T
OVERSHOOTING	OW V ER SH UW T IH NG
OVERSHOOTS	OW V ER SH UW T S
OVERSHOT	OW V ER SH AA T
OVERSHOTS	OW V ER SH AA T S
OWLISH	AW L IH SH
OWLISHLY	AW L IH SH L IY
OWLISHNESS	AW L IH SH N AH S
OWLISHNESSES	AW L IH SH N AH S IH Z
OWNERSHIP	OW N ER SH IH P
OWNERSHIPS	OW N ER SH IH P S
PADDLEFISH	P AE D AH L F IH SH
PADDLEFISHES	P AE D AH L F IH SH IH Z
PADISHAH	P AE D AH SH AH
PADISHAHS	P AE D AH SH AH Z
PADSHAH	P AE D SH AA
PADSHAHS	P AE D SH AA Z
PAGANISH	P EY G AH N IH SH
PAINTBRUSH	P EY N T B R AH SH
PAINTBRUSHES	P EY N T B R AH SH IH S
PALISH	P EY L IH SH
PALSHIP	P AE L SH IH P
PALSHIPS	P AE L SH IH P S
PANFISH	P AE N F IH SH
PANFISHES	P AE N F IH SH IH Z
PARASHAH	P AA R AH SH AA
PARASHAHS	P AA R AH SH AA Z
PARASHIOTH	P AH R AE SH IY AH TH
PARASHOT	P AA R AH SH AA T
PARASHOTH	P AE R AH SH AH TH
PARFLESH	P AA R F L EH SH
PARFLESHES	P AA R F L EH SH IH Z
PARISH	P AE R IH SH
PARISH(2)	P EH R IH SH
PARISHES	P AE R IH SH IH Z
PARISHES(2)	P EH R IH SH IH Z
PARISHIONER	P ER IH SH AH N ER
PARISHIONERS	P ER IH SH AH N ER Z
PARTISANSHIP	P AA R T AH Z AH N SH IH P
PARTISANSHIPS	P AA R T AH Z AH N SH IH P S
PARTNERSHIP	P AA R T N ER SH IH P
PARTNERSHIPS	P AA R T N ER SH IH P S
PASH	P AE SH
PASHA	P AH SH AA
PASHA(2)	P AA SH AH
PASHADOM	P AA SH AH D AH M
PASHADOMS	P AA SH AH D AH M Z
PASHALIC	P AA Z HH EY L IH K
PASHALICS	P AA Z HH EY L IH K S
PASHALIK	P AE SH AH L AH K
PASHALIKS	P AE SH AH L AY K S
PASHAS	P AA SH AH Z
PASHED	P AE SH T
PASHES	P AE SH AH Z
PASHING	P AE SH AH NG
PASTORSHIP	P AE S T ER SH IH P
PASTORSHIPS	P AE S T ER SH IH P S
PAWNSHOP	P AO N SH AA P
PAWNSHOPS	P AO N SH AA P S
PEACOCKISH	P IY K AA K IH SH
PEAKISH	P IY K IH SH
PEARLASH	P AE ER L AE SH
PEARLASHES	P AE ER L AE SH IH Z
PEASHOOTER	P IY SH UW T ER
PEASHOOTERS	P IY SH UW T ER Z
PECKISH	P EH K IH SH
PEEPSHOW	P IY P SH OW
PEEPSHOWS	P IY P SH OW Z
PEEVISH	P IY V IH SH
PEEVISHLY	P IY V IH SH L IY
PEEVISHNESS	P IY V IH SH N AH S
PEEVISHNESSES	P IY V IH SH N EH S AH Z
PENMANSHIP	P EH N M AE N SH IH P
PENMANSHIPS	P EH N M AE N SH IH P S
PERISH	P EH R IH SH
PERISHABILITIES	P EH R IH SH AH B IH L AH T EH Z
PERISHABILITY	P EH R IH SH AH B IH L AH T EH
PERISHABLE	P EH R IH SH AH B AH L
PERISHABLES	P EH R IH SH AH B AH L Z
PERISHED	P EH R IH SH T
PERISHES	P EH R IH SH IH Z
PERISHING	P EH R IH SH IH NG
PERKISH	P ER K IH SH
PETTISH	P EH T IH SH
PETTISHLY	P EH T IH SH L IY
PETTISHNESS	P EH T IH SH N AH S
PETTISHNESSES	P EH T IH SH N AH S IH Z
PHOTOFINISHER	F OW T OW F IH N IH SH ER
PHOTOFINISHERS	F OW T OW F IH N IH SH ER Z
PHOTOFINISHING	F OW T OW F IH N IH SH IH NG
PHOTOFINISHINGS	F OW T OW F IH N IH SH IH NG Z
PHOTOFLASH	F OW T OW F L AE SH
PHOTOFLASHES	F OW T OW F L AE SH IH Z
PICAYUNISH	P IH K IY Y UW N IH SH
PIGFISH	P IH G F IH SH
PIGFISHES	P IH G F IH SH IH Z
PIGGISH	P IH G IH SH
PIGGISHLY	P IH G IH SH L IY
PIGGISHNESS	P IH G IH SH N AH S
PIGGISHNESSES	P IH G IH SH N AH S IH Z
PINCUSHION	P IH N K UH SH AH N
PINCUSHIONS	P IH N K UH SH AH N Z
PINFISH	P IH N F IH SH
PINFISHES	P IH N F IH SH IH Z
PINKISH	P IH NG K IH SH
PINKISHNESS	P IH NG K IH SH N AH S
PINKISHNESSES	P IH NG K IH SH N AH S IH Z
PIPEFISH	P AY P F IH SH
PIPEFISHES	P AY P F IH SH IH Z
PIROSHKI	P AH R AA SH IY
PISH	P IH SH
PISHED	P IH SH T
PISHES	P IH SH AH Z
PISHING	P IH SH AH NG
PISHOGE	P AH SH OW JH
PISHOGES	P AY Z HH AA G Z
PISHOGUE	P IH SH AH G
PISHOGUES	P IH SH AH G Z
PIXIEISH	P IH K S IY IH SH
PIXYISH	P IH K S AY AH SH
PLANISH	P L EY N IH SH
PLANISHED	P L EY N IH SH T
PLANISHER	P L EY N IH SH ER
PLANISHERS	P L EY N IH SH ER Z
PLANISHES	P L EY N IH SH IH Z
PLANISHING	P L EY N IH SH IH NG
PLASH	P L AE SH
PLASHED	P L AE SH T
PLASHER	P L AE SH AH R
PLASHERS	P L AE SH AH R Z
PLASHES	P L AE SH AH Z
PLASHIER	P L AE SH AY AH R
PLASHIEST	P L AE SH AY AH S T
PLASHING	P L AE SH AH NG
PLASHY	P L AE SH IY
PLATYFISH	P L EY T IY F IH SH
PLATYFISHES	P L EY T IY F IH SH IH Z
PLENISH	P L EH N IH SH
PLENISHED	P L EH N IH SH T
PLENISHES	P L EH N IH SH IH Z
PLENISHING	P L EH N IH SH IH NG
PLOWSHARE	P L AW SH EY R
PLOWSHARES	P L AW SH EY R Z
PLUMPISH	P L AH M P IH SH
PLUSH	P L AH SH
PLUSHER	P L AH SH ER
PLUSHES	P L AH SH IH Z
PLUSHEST	P L AH SH AH S T
PLUSHIER	P L AH SH IY ER
PLUSHIEST	P L AH SH IY AH S T
PLUSHILY	P L AH SH IY L IY
PLUSHINESS	P L AH SH IY N AH S
PLUSHINESSES	P L AH SH IY N AH S IH Z
PLUSHLY	P L AH SH L IY
PLUSHNESS	P L AH SH N AH S
PLUSHNESSES	P L AH SH N AH S IH Z
PLUSHY	P L AH SH IY
POISHA	P OY SH AH
POLISH	P AA L IH SH
POLISH(2)	P OW L IH SH
POLISHED	P AA L IH SH T
POLISHER	P AA L IH SH ER
POLISHERS	P AA L IH SH ER Z
POLISHES	P AA L IH SH IH Z
POLISHING	P AA L IH SH IH NG
POORISH	P UH R IH SH
POPISH	P OW P IH SH
POPISHLY	P OW P IH SH L IY
POSH	P AA SH
POSHER	P AA SH ER
POSHEST	P AA SH AH S T
POSHLY	P AA SH L IY
POSHNESS	P AA SH N AH S
POSHNESSES	P AA SH N AH S IH Z
POSTCRASH	P OW S T K R AE SH
POSTMASTERSHIP	P OW S T M AE S T ER SH IH P
POSTMASTERSHIPS	P OW S T M AE S T ER SH IH P S
POSTSHOW	P OW S T SH OW
POSTWORKSHOP	P OW S T W ER K SH AA P
POTASH	P AA T AE SH
POTASHES	P AA T AE SH IH Z
POTSHARD	P AA T SH AA R D
POTSHARDS	P AA T SH AA R D Z
POTSHERD	P AA T S HH ER D
POTSHERDS	P AA T S HH ER D Z
POTSHOT	P AA SH AA T
POTSHOTS	P AA CH AA T S
POTSHOTTING	P AA T SH AA T IH NG
PRAETORSHIP	P R IY T AH R SH IH P
PRAETORSHIPS	P R IY T AO R SH AH P S
PRANKISH	P R AE NG K IH SH
PRANKISHLY	P R AE NG K IH SH L IY
PRANKISHNESS	P R AE NG K IH SH N AH S
PRANKISHNESSES	P R AE NG K IH SH N AH S IH Z
PRECENTORSHIP	P R IY S EH N T ER SH IH P
PRECENTORSHIPS	P R IY S EH N T ER SH IH P S
PRECEPTORSHIP	P R IY S EH P T ER SH IH P
PRECEPTORSHIPS	P R IY S EH P T ER SH IH P S
PRECRASH	P R IY K R AE SH
PREESTABLISH	P R IY IH S T AE B L IH SH
PREESTABLISHED	P R IY IH S T AE B L IH SH T
PREESTABLISHES	P R IY IH S T AE B L IH SH IH Z
PREESTABLISHING	P R IY IH S T AE B L IH SH IH NG
PREFRESHMAN	P R IY F R EH SH M AE N
PREFRESHMEN	P R IY F R EH SH M EH N
PREMIERSHIP	P R EH M IH R SH IH P
PREMIERSHIPS	P R IH M IH ER SH IH P S
PREMONISH	P R IY M OW N AH SH
PREMONISHED	P R IY M AA N AH SH T
PREMONISHES	P R IY M AA N AH SH AH Z
PREMONISHING	P R IY M AA N AH SH AH NG
PRESHAPE	P R IY SH EY P
PRESHAPED	P R IY SH EY P T
PRESHAPES	P R IY SH EY P S
PRESHAPING	P R IY SH EY P IH NG
PRESHOW	P R IY SH OW
PRESHOWED	P R IY SH OW D
PRESHOWING	P R IY SH OW IH NG
PRESHOWN	P R IY SH OW N
PRESHOWS	P R IY SH OW Z
PRESHRANK	P R IY SH R AE NG K
PRESHRINK	P R IY SH R IH NG K
PRESHRINKING	P R IY SH R IH NG K IH NG
PRESHRINKS	P R IY SH R IH NG K S
PRESHRUNK	P R IY SH R AH NG K
PRESHRUNKEN	P R IY SH R AH NG K AH N
PRESIDENTSHIP	P R EH Z AH D AH N T SH IH P
PRESIDENTSHIPS	P R EH Z AH D AH N T SH IH P S
PRETTYISH	P R IH T IY IH SH
PREWASH	P R IY W AA SH
PREWASHED	P R IY W AA SH T
PREWASHES	P R IY W AA SH IH Z
PREWASHING	P R IY W AA SH IH NG
PRIGGISH	P R IH G AH SH
PRIGGISHLY	P R IH JH IH SH L IY
PRIGGISHNESS	P R IH JH IH SH N AH S
PRIGGISHNESSES	P R IH JH IH SH N EH S AH Z
PRIMATESHIP	P R AY M AH T SH IH P
PRIMATESHIPS	P R AY M AH T SH IH P S
PRINCESHIP	P R IH N S SH IH P
PRINCESHIPS	P R IH N S SH IH P S
PRINCIPALSHIP	P R IH N S AH P AH L SH IH P
PRINCIPALSHIPS	P R IH N S AH P AH L SH IH P S
PRIORSHIP	P R AY ER SH IH P
PRIORSHIPS	P R AY ER SH IH P S
PROCONSULSHIP	P R OW K AA N S AH L SH IH P
PROCONSULSHIPS	P R OW K AA N S AH L SH IH P S
PROCTORSHIP	P R AA K T ER SH IH P
PROCTORSHIPS	P R AA K T ER SH IH P S
PROFESSORSHIP	P R AH F EH S ER SH IH P
PROFESSORSHIPS	P R AH F EH S ER SH IH P S
PROPRIETORSHIP	P R AH P R AY AH T ER SH IH P
PROPRIETORSHIPS	P R AH P R AY AH T ER SH IH P S
PROTECTORSHIP	P R AH T EH K T ER SH IH P
PROTECTORSHIPS	P R AH T EH K T ER SH IH P S
PRUDISH	P R UW D IH SH
PRUDISHLY	P R UW D IH SH L IY
PRUDISHNESS	P R UW D IH SH N AH S
PRUDISHNESSES	P R UW D IH SH N AH S IH Z
PSHAW	SH AO
PSHAWED	SH AO D
PSHAWING	SH AO AH NG
PSHAWS	SH AO Z
PUBLISH	P AH B L IH SH
PUBLISHABLE	P AH B L IH SH AH B AH L
PUBLISHED	P AH B L IH SH T
PUBLISHER	P AH B L IH SH ER
PUBLISHERS	P AH B L IH SH ER Z
PUBLISHES	P AH B L IH SH AH Z
PUBLISHES(2)	P AH B L IH SH IH Z
PUBLISHING	P AH B L IH SH IH NG
PUBLISHINGS	P AH B L IH SH IH NG Z
PUCKISH	P AH K IH SH
PUCKISHLY	P AH K IH SH L IY
PUCKISHNESS	P AH K IH SH N AH S
PUCKISHNESSES	P AH K IH SH N AH S IH Z
PUGGISH	P AH G IH SH
PUNISH	P AH N IH SH
PUNISHABILITIES	P AH N IH SH AH B IH L AH T EH Z
PUNISHABILITY	P AH N IH SH AH B IH L AH T EH
PUNISHABLE	P AH N IH SH AH B AH L
PUNISHED	P AH N IH SH T
PUNISHER	P AH N IH SH ER
PUNISHERS	P AH N IH SH ER Z
PUNISHES	P AH N IH SH AH Z
PUNISHING	P AH N IH SH IH NG
PUNISHMENT	P AH N IH SH M AH N T
PUNISHMENTS	P AH N IH SH M AH N T S
PUNKISH	P AH NG K IH SH
PUPFISH	P AH P F IH SH
PUPFISHES	P AH P F IH SH IH Z
PUPPYISH	P AH P IY IH SH
PURPLISH	P ER P L IH SH
PUSH	P UH SH
PUSHBALL	P UH SH B AO L
PUSHBALLS	P UH SH B AO L Z
PUSHCART	P UH SH K AA R T
PUSHCARTS	P UH SH K AA R T S
PUSHCHAIR	P UH SH CH EH ER
PUSHCHAIRS	P UH SH CH EH ER Z
PUSHDOWN	P UH SH D AW N
PUSHDOWNS	P UH SH D AW N Z
PUSHED	P UH SH T
PUSHER	P UH SH ER
PUSHERS	P UH SH ER Z
PUSHES	P UH SH AH Z
PUSHES(2)	P UH SH IH Z
PUSHFUL	P UH SH F AH L
PUSHFULNESS	P UH SH F AH L N AH S
PUSHFULNESSES	P UH SH F AH L N AH S IH Z
PUSHIER	P UH SH IY ER
PUSHIEST	P UH SH IY AH S T
PUSHILY	P UH SH IY L IY
PUSHINESS	P UH SH IY N AH S
PUSHINESSES	P UH SH IY N AH S IH Z
PUSHING	P UH SH IH NG
PUSHOVER	P UH SH OW V ER
PUSHOVERS	P UH SH OW V ER Z
PUSHPIN	P UH SH P IH N
PUSHPINS	P UH SH P IH N Z
PUSHROD	P UH SH R AA D
PUSHRODS	P UH SH R AA D Z
PUSHUP	P UH SH AH P
PUSHUPS	P UH SH AH P S
PUSHY	P UH SH IY
PYGMYISH	P IH G M AY AH SH
QUACKISH	K W AE K IH SH
QUALMISH	K W AA M IH SH
QUALMISHLY	K W AA M IH SH L IY
QUALMISHNESS	K W AA M IH SH N AH S
QUALMISHNESSES	K W AA M IH SH N AH S IH Z
QUAMASH	K W AA M AH SH
QUAMASHES	K W AA M AH SH AH Z
QUASH	K W AO SH
QUASHED	K W AO SH T
QUASHER	K W AA SH ER
QUASHERS	K W AA SH ER Z
QUASHES	K W AA SH IH Z
QUASHING	K W AO SH IH NG
QUEENSHIP	K W IY N SH IH P
QUEENSHIPS	K W IY N SH IH P S
QUEERISH	K W IH ER IH SH
QUIPPISH	K W IH P IH SH
QUIRKISH	K W ER K IH SH
QURSH	K W R SH
QURSHES	K W R SH IH Z
QURUSH	K W R AH SH
QURUSHES	K W R AH SH AH Z
RABBITBRUSH	R AE B AH T B R AH SH
RABBITBRUSHES	R AE B AH T B R AH SH IH Z
RADISH	R AE D IH SH
RADISHES	R AE D IH SH IH Z
RAFFISH	R AE F IH SH
RAFFISHLY	R AE F IH SH L IY
RAFFISHNESS	R AE F IH SH N AH S
RAFFISHNESSES	R AE F IH SH N AH S IH Z
RAINWASH	R EY N W AA SH
RAINWASHED	R EY N W AA SH T
RAINWASHES	R EY N W AA SH IH Z
RAINWASHING	R EY N W AA SH IH NG
RAKISH	R EY K IH SH
RAKISHLY	R EY K IH SH L IY
RAKISHNESS	R EY K IH SH N AH S
RAKISHNESSES	R EY K IH SH N AH S IH Z
RAMMISH	R AE M IH SH
RAMSHACKLE	R AE M SH AE K AH L
RAMSHORN	R AE M Z HH AO R N
RAMSHORNS	R AE M Z HH AO R N Z
RANKISH	R AE NG K IH SH
RASH	R AE SH
RASHER	R AE SH ER
RASHERS	R AE SH ER Z
RASHES	R AE SH IH Z
RASHEST	R AE SH AH S T
RASHLIKE	R AE SH L AY K
RASHLY	R AE SH L IY
RASHNESS	R AE SH N AH S
RASHNESSES	R AE SH N AH S IH Z
RASPISH	R AE S P IH SH
RATFISH	R AE T F IH SH
RATFISHES	R AE T F IH SH IH Z
RATTISH	R AE T IH SH
RAVISH	R EY V IH SH
RAVISHED	R EY V IH SH T
RAVISHER	R EY V IH SH ER
RAVISHERS	R EY V IH SH ER Z
RAVISHES	R EY V IH SH IH Z
RAVISHING	R AE V IH SH IH NG
RAVISHINGLY	R EY V IH SH IH NG L IY
RAVISHMENT	R EY V IH SH M AH N T
RAVISHMENTS	R EY V IH SH M AH N T S
RAWISH	R AO IH SH
READERSHIP	R IY D ER SH IH P
READERSHIPS	R IY D ER SH IH P S
RECEIVERSHIP	R IH S IY V ER SH IH P
RECEIVERSHIP(2)	R IY S IY V ER SH IH P
RECEIVERSHIPS	R IH S IY V ER SH IH P S
RECTORSHIP	R EH K T ER SH IH P
RECTORSHIPS	R EH K T ER SH IH P S
REDDISH	R EH D IH SH
REDDISHNESS	R EH D IH SH N AH S
REDDISHNESSES	R EH D IH SH N AH S IH Z
REDFISH	R EH D F IH SH
REDFISHES	R EH D F IH SH IH Z
REDSHANK	R EH D SH AE NG K
REDSHANKS	R EH D SH AE NG K S
REDSHIFT	R EH D SH IH F T
REDSHIFTED	R EH D SH IH F T IH D
REDSHIFTS	R EH D SH IH F T S
REDSHIRT	R EH D SH ER T
REDSHIRTED	R EH D SH ER T IH D
REDSHIRTING	R EH D SH ER T IH NG
REDSHIRTS	R EH D SH ER T S
REESTABLISH	R IY IH S T AE B L IH SH
REESTABLISHED	R IY IH S T AE B L IH SH T
REESTABLISHES	R IY IH S T AE B L IH SH IH Z
REESTABLISHING	R IY IH S T AE B L IH SH IH NG
REESTABLISHMENT	R IY IH S T AE B L IH SH M AH N T
REESTABLISHMENTS	R IY IH S T AE B L IH SH M AH N T S
REFASHION	R IY F AE SH AH N
REFASHIONED	R IY F AE SH AH N D
REFASHIONING	R IY F AE SH AH N IH NG
REFASHIONS	R IY F AE SH AH N Z
REFINISH	R IY F IH N IH SH
REFINISHED	R IY F IH N IH SH T
REFINISHER	R IY F IH N IH SH ER
REFINISHERS	R IY F IH N IH SH ER Z
REFINISHES	R IY F IH N IH SH IH Z
REFINISHING	R IY F IH N IH SH IH NG
REFRESH	R IH F R EH SH
REFRESHED	R IY F R EH SH T
REFRESHEN	R IY F R EH SH AH N
REFRESHENED	R IY F R EH SH AH N D
REFRESHENING	R IY F R EH SH AH N IH NG
REFRESHENS	R IY F R EH SH AH N Z
REFRESHER	R IH F R EH SH ER
REFRESHERS	R IY F R EH SH ER Z
REFRESHES	R IH F R EH SH IH Z
REFRESHING	R IH F R EH SH IH NG
REFRESHINGLY	R IY F R EH SH IH NG L IY
REFRESHMENT	R AH F R EH SH M AH N T
REFRESHMENTS	R AH F R EH SH M AH N T S
REFURBISH	R IY F ER B IH SH
REFURBISHED	R IY F ER B IH SH T
REFURBISHER	R IY F ER B IH SH ER
REFURBISHERS	R IY F ER B IH SH ER Z
REFURBISHES	R IY F ER B IH SH IH Z
REFURBISHING	R IY F ER B IH SH IH NG
REFURBISHMENT	R IY F ER B IH SH M AH N T
REFURBISHMENTS	R IY F ER B IH SH M AH N T S
REFURNISH	R IY F ER N IH SH
REFURNISHED	R IY F ER N IH SH T
REFURNISHES	R IY F ER N IH SH IH Z
REFURNISHING	R IY F ER N IH SH IH NG
REHASH	R IY HH AE SH
REHASHED	R IY HH AE SH T
REHASHES	R IY HH AE SH IH Z
REHASHING	R IY HH AE SH IH NG
RELATIONSHIP	R IY L EY SH AH N SH IH P
RELATIONSHIPS	R IY L EY SH AH N SH IH P S
RELINQUISH	R IH L IH NG K W IH SH
RELINQUISH(2)	R IY L IH NG K W IH SH
RELINQUISHED	R IH L IH NG K W IH SH T
RELINQUISHED(2)	R IY L IH NG K W IH SH T
RELINQUISHES	R IH L IH NG K W IH SH IH Z
RELINQUISHING	R IY L IH NG K W IH SH IH NG
RELINQUISHMENT	R IH L IH NG K W IH SH M AH N T
RELINQUISHMENTS	R IH L IH NG K W IH SH M AH N T S
RELISH	R EH L IH SH
RELISHABLE	R EH L IH SH AH B AH L
RELISHED	R EH L IH SH T
RELISHES	R EH L IH SH AH Z
RELISHES(2)	R EH L IH SH IH Z
RELISHING	R EH L IH SH IH NG
REPLENISH	R IY P L EH N IH SH
REPLENISHABLE	R IY P L EH N IH SH AH B AH L
REPLENISHED	R IY P L EH N IH SH T
REPLENISHER	R IY P L EH N IH SH ER
REPLENISHERS	R IY P L EH N IH SH ER Z
REPLENISHES	R IY P L EH N IH SH IH Z
REPLENISHING	R IY P L EH N IH SH IH NG
REPLENISHMENT	R IH P L EH N IH SH M AH N T
REPLENISHMENTS	R IY P L EH N IH SH M AH N T S
REPOLISH	R IY P AA L IH SH
REPOLISHED	R IY P AA L IH SH T
REPOLISHES	R IY P AA L IH SH IH Z
REPOLISHING	R IY P AA L IH SH IH NG
REPUBLISH	R IY P AH B L IH SH
REPUBLISHED	R IY P AH B L IH SH T
REPUBLISHER	R IY P AH B L IH SH ER
REPUBLISHERS	R IY P AH B L IH SH ER Z
REPUBLISHES	R IY P AH B L IH SH IH Z
REPUBLISHING	R IY P AH B L IH SH IH NG
RESH	R EH SH
RESHAPE	R IY SH EY P
RESHAPED	R IY SH EY P T
RESHAPER	R IY SH EY P ER
RESHAPERS	R IY SH EY P ER Z
RESHAPES	R IY SH EY P S
RESHAPING	R IY SH EY P IH NG
RESHAVE	R IY SH EY V
RESHAVED	R IY SH EY V D
RESHAVEN	R IY SH EY V AH N
RESHAVES	R IY SH EY V Z
RESHAVING	R IY SH EY V IH NG
RESHES	R EH SH AH Z
RESHINE	R IY SH AY N
RESHINED	R IY SH AY N D
RESHINES	R IY SH AY N Z
RESHINGLE	R IY SH IH NG G AH L
RESHINGLED	R IY SH IH NG G AH L D
RESHINGLES	R IY SH IH NG G AH L Z
RESHINGLING	R IY SH IH NG G AH L IH NG
RESHINING	R IY SH AY N IH NG
RESHIP	R IY SH IH P
RESHIPPED	R IY SH IH P T
RESHIPPING	R IY SH IH P IH NG
RESHIPS	R IY SH IH P S
RESHOD	R IY SH AA D
RESHOE	R IY SH UW
RESHOEING	R IY SH UW IH NG
RESHOES	R IY SH UW Z
RESHONE	R IY SH OW N
RESHOOT	R IY SH UW T
RESHOOTING	R IY SH UW T IH NG
RESHOOTS	R IY SH UW T S
RESHOT	R IY SH AO T
RESHOW	R IY SH OW
RESHOWED	R IY SH OW D
RESHOWING	R IY SH OW IH NG
RESHOWN	R IY SH OW N
RESHOWS	R IY SH OW Z
RESHUFFLE	R IY SH AH F AH L
RESHUFFLED	R IY SH AH F AH L D
RESHUFFLES	R IY SH AH F AH L Z
RESHUFFLING	R IY SH AH F AH L IH NG
RESHUFFLING(2)	R IY SH AH F L IH NG
REWASH	R IY W AA SH
REWASHED	R IY W AA SH T
REWASHES	R IY W AA SH IH Z
REWASHING	R IY W AA SH IH NG
RIBBONFISH	R IH B AH N F IH SH
RIBBONFISHES	R IH B AH N F IH SH IH Z
RICKSHA	R IH K AH
RICKSHAS	R IH K AH Z
RICKSHAW	R IH K SH AO
RICKSHAWS	R IH K SH AO Z
RIDERSHIP	R AY D ER SH IH P
RIDERSHIPS	R AY D ER SH IH P S
RIKISHA	R IH K AH SH AH
RIKISHAS	R IH K AH SH AH Z
RIKSHAW	R IH K AH
RIKSHAWS	R IH K AH Z
RISHI	R IH SH IY
RISHIS	R IH SH AH S
ROADSHOW	R OW D SH OW
ROADSHOWS	R OW D SH OW Z
ROCKFISH	R AA K F IH SH
ROCKFISHES	R AA K F IH SH IH Z
ROCKSHAFT	R AA K SH AE F T
ROCKSHAFTS	R AA K SH AE F T S
ROGUISH	R OW G IH SH
ROGUISHLY	R OW G IH SH L IY
ROGUISHNESS	R OW G IH SH N AH S
ROGUISHNESSES	R OW G IH SH N AH S IH Z
ROMPISH	R AA M P IH SH
ROSEBUSH	R OW Z B UH SH
ROSEBUSHES	R OW Z B UH SH IH Z
ROSEFISH	R OW Z F IH SH
ROSEFISHES	R OW Z F IH SH IH Z
ROUGHISH	R AH F IH SH
ROUGHSHOD	R AH F SH AA D
ROUNDISH	R AW N D IH SH
ROWDYISH	R AW D IY IH SH
RUBBISH	R AH B IH SH
RUBBISHES	R AH B IH SH IH Z
RUBBISHY	R AH B IH SH IY
RULERSHIP	R UW L ER SH IH P
RULERSHIPS	R UW L ER SH IH P S
RUNTISH	R AH N T IH SH
RUSH	R AH SH
RUSHED	R AH SH T
RUSHEE	R AH SH IY
RUSHEES	R AH SH IY Z
RUSHER	R AH SH ER
RUSHERS	R AH SH ER Z
RUSHES	R AH SH AH Z
RUSHES(2)	R AH SH IH Z
RUSHIER	R AH SH IY ER
RUSHIEST	R AH SH IY AH S T
RUSHING	R AH SH IH NG
RUSHINGS	R AH SH IH NG Z
RUSHLIGHT	R AH SH L AY T
RUSHLIGHTS	R AH SH L AY T S
RUSHLIKE	R AH SH L AY K
RUSHY	R AH SH IY
RUTTISH	R AH T IH SH
RUTTISHLY	R AH T IH SH L IY
RUTTISHNESS	R AH T IH SH N AH S
RUTTISHNESSES	R AH T IH SH N AH S IH Z
SABLEFISH	S EY B AH L F IH SH
SABLEFISHES	S EY B AH L F IH SH IH Z
SAGANASH	S AE G AH N AH SH
SAGANASHES	S AH G AE N AH SH AH Z
SAGEBRUSH	S EY JH B R AH SH
SAGEBRUSHES	S EY JH B R AH SH IH Z
SAILFISH	S EY L F IH SH
SAILFISHES	S EY L F IH SH IH Z
SAINTSHIP	S EY N T SH IH P
SAINTSHIPS	S EY N T SH IH P S
SALESMANSHIP	S EY L Z M AH N SH IH P
SALESMANSHIPS	S EY L Z M AE N SH IH P S
SALLOWISH	S AE L OW IH SH
SALTBUSH	S AO L T B UH SH
SALTBUSHES	S AO L T B UH SH IH Z
SALTISH	S AO L T IH SH
SALTSHAKER	S AO L T SH EY K ER
SALTSHAKERS	S AO L T SH EY K ER Z
SAMSHU	S AE M SH UW
SAMSHUS	S AE M SH AH S
SANDFISH	S AE N D F IH SH
SANDFISHES	S AE N D F IH SH IH Z
SANDSHOE	S AE N D SH UW
SANDSHOES	S AE N D SH UW Z
SANSCULOTTISH	S AE N S Y AH L AA T AH SH
SASH	S AE SH
SASHAY	S AE SH EY
SASHAYED	S AE SH EY D
SASHAYING	S AE SH EY IH NG
SASHAYS	S AE SH EY Z
SASHED	S AE SH T
SASHES	S AE SH IH Z
SASHIMI	S AE SH AH M IY
SASHIMIS	S AE SH AH M AH S
SASHING	S AE SH IH NG
SAWFISH	S AO F IH SH
SAWFISHES	S AO F IH SH IH Z
SCAMPISH	S K AE M P AH SH
SCATTERSHOT	S K AE T ER SH AA T
SCENESHIFTER	S IY N SH IH F T ER
SCENESHIFTERS	S IY N SH IH F T ER Z
SCHOLARSHIP	S K AA L ER SH IH P
SCHOLARSHIPS	S K AA L ER SH IH P S
SCHOOLBOYISH	S K UW L B OY IH SH
SCHOOLMARMISH	S K UW L M AA R M IH SH
SCHOOLMASTERISH	S K UW L M AE S T ER IH SH
SCRIMSHANDER	S K R IH M Z HH AE N D ER
SCRIMSHANDERS	S K R IH M Z HH AE N D ER Z
SCRIMSHAW	S K R IH M SH AO
SCRIMSHAWED	S K R IH M SH AO D
SCRIMSHAWING	S K R IH M SH AO IH NG
SCRIMSHAWS	S K R IH M SH AO Z
SEAMANSHIP	S IY M AE N SH IH P
SEAMANSHIPS	S IY M AE N SH IH P S
SEASHELL	S IY SH EH L
SEASHELLS	S IY SH EH L Z
SEASHORE	S IY SH AO R
SEASHORES	S IY SH OW R Z
SECRETARYSHIP	S EH K R AH T EH R IY SH IH P
SECRETARYSHIPS	S EH K R AH T EH R IY SH IH P S
SELFISH	S EH L F IH SH
SELFISHLY	S EH L F IH SH L IY
SELFISHNESS	S EH L F IH SH N AH S
SELFISHNESSES	S EH L F IH SH N AH S IH Z
SEMIFINISHED	S EH M IY F IH N IH SH T
SEMIFINISHED(2)	S EH M AY F IH N IH SH T
SEMIFINISHED(3)	S EH M IH F IH N IH SH T
SEMISHRUBBY	S EH M IY SH R AH B IY
SENATORSHIP	S EH N AH T ER SH IH P
SENATORSHIPS	S EH N AH T ER SH IH P S
SERFISH	S ER F IH SH
SH	EH S
SHA	SH AA
SHABBIER	SH AE B IY ER
SHABBIEST	SH AE B IY AH S T
SHABBILY	SH AE B IY L IY
SHABBINESS	SH AE B IY N AH S
SHABBINESSES	SH AE B IY N AH S IH Z
SHABBY	SH AE B IY
SHACK	SH AE K
SHACKLE	SH AE K AH L
SHACKLEBONE	SH AE K AH L B OW N
SHACKLEBONES	SH AE K AH L B OW N Z
SHACKLED	SH AE K AH L D
SHACKLER	SH AE K AH L ER
SHACKLERS	SH AE K AH L ER Z
SHACKLES	SH AE K AH L Z
SHACKLING	SH AE K L IH NG
SHACKO	SH AE K OW
SHACKOES	SH AE K OW Z
SHACKOS	SH AE K AA S
SHACKS	SH AE K S
SHAD	SH AE D
SHADBERRIES	SH AE D EH R AY Z
SHADBERRY	SH AE D EH R IY
SHADBLOW	SH AE D L OW
SHADBLOWS	SH AE D L OW Z
SHADBUSH	SH AE D B UH SH
SHADBUSHES	SH AE D AH SH AH Z
SHADCHAN	SH AE D CH AH N
SHADCHANIM	SH AE D CH AH N AH M
SHADCHANS	SH AE D CH AH N Z
SHADDOCK	SH AE D AH K
SHADDOCKS	SH AE D AH K S
SHADE	SH EY D
SHADED	SH EY D IH D
SHADELESS	SH EY D L AH S
SHADER	SH EY D ER
SHADERS	SH EY D ER Z
SHADES	SH EY D Z
SHADFLIES	SH AE D F L AY Z
SHADFLY	SH AE D F L IY
SHADIER	SH EY D IY ER
SHADIEST	SH EY D IY AH S T
SHADILY	SH EY D IY L IY
SHADINESS	SH EY D IY N AH S
SHADINESSES	SH EY D IY N AH S IH Z
SHADING	SH EY D IH NG
SHADINGS	SH EY D IH NG Z
SHADOOF	SH AH D UW F
SHADOOFS	SH AH D UW F S
SHADOW	SH AE D OW
SHADOWBOX	SH AE D OW B AA K S
SHADOWBOXED	SH AE D OW B AA K S T
SHADOWBOXES	SH AE D OW B AA K S IH Z
SHADOWBOXING	SH AE D OW B AA K S IH NG
SHADOWED	SH AE D OW D
SHADOWER	SH AE D OW ER
SHADOWERS	SH AE D OW ER Z
SHADOWGRAPH	SH AE D OW G R AE F
SHADOWGRAPHIES	SH AE D OW G R AE F IY Z
SHADOWGRAPHS	SH AE D OW G R AE F S
SHADOWGRAPHY	SH AE D OW G R AE F IY
SHADOWIER	SH AE D OW IY ER
SHADOWIEST	SH AE D OW IY AH S T
SHADOWILY	SH AE D OW IY L IY
SHADOWINESS	SH AE D OW IY N AH S
SHADOWINESSES	SH AE D OW IY N AH S IH Z
SHADOWING	SH AE D OW IH NG
SHADOWLESS	SH AE D OW L AH S
SHADOWLIKE	SH AE D OW L AY K
SHADOWS	SH AE D OW Z
SHADOWY	SH AE D OW IY
SHADRACH	SH AE D R AH CH
SHADRACHS	SH AE D R AH CH S
SHADS	SH AE D Z
SHADUF	SH AE D AH F
SHADUFS	SH AE D AH F S
SHADY	SH EY D IY
SHAFT	SH AE F T
SHAFTED	SH AE F T IH D
SHAFTING	SH AE F T IH NG
SHAFTINGS	SH AE F T IH NG Z
SHAFTS	SH AE F T S
SHAG	SH AE G
SHAGBARK	SH AE G B AA R K
SHAGBARKS	SH AE G B AA R K S
SHAGGED	SH AE G D
SHAGGIER	SH AE G IY ER
SHAGGIEST	SH AE G IY AH S T
SHAGGILY	SH AE G IY L IY
SHAGGINESS	SH AE G IY N AH S
SHAGGINESSES	SH AE G IY N AH S IH Z
SHAGGING	SH AE G IH NG
SHAGGY	SH AE G IY
SHAGGYMANE	SH AE G IY M EY N
SHAGGYMANES	SH AE G IY M EY N Z
SHAGREEN	SH EY G R IY AH N
SHAGREENS	SH AE G R IY N Z
SHAGS	SH AE G Z
SHAH	SH AA
SHAHDOM	SH AA D AH M
SHAHDOMS	SH AA D AH M Z
SHAHS	SH AA Z
SHAIRD	SH AE AH R D
SHAIRDS	SH AE AH R D Z
SHAIRN	SH AE AH R N
SHAIRNS	SH AE AH R N Z
SHAITAN	SH EY T AH N
SHAITANS	SH EY T AH N Z
SHAKABLE	SH EY K AH B AH L
SHAKE	SH EY K
SHAKEABLE	SH EY K AH B AH L
SHAKEDOWN	SH EY K D AW N
SHAKEDOWNS	SH EY K D AW N Z
SHAKEN	SH EY K AH N
SHAKEOUT	SH EY K AW T
SHAKEOUTS	SH EY K AW T S
SHAKER	SH EY K ER
SHAKERS	SH EY K ER Z
SHAKES	SH EY K S
SHAKEUP	SH EY K AH P
SHAKEUPS	SH EY K AH P S
SHAKIER	SH EY K IY ER
SHAKIEST	SH EY K IY IH S T
SHAKILY	SH EY K IY L IY
SHAKINESS	SH EY K IY N AH S
SHAKINESSES	SH EY K IY N AH S IH Z
SHAKING	SH EY K IH NG
SHAKO	SH AE K OW
SHAKOES	SH AH K OW Z
SHAKOS	SH AE K AH Z
SHAKY	SH EY K IY
SHALE	SH EY L
SHALED	SH EY L D
SHALES	SH EY L Z
SHALEY	SH EY L IY
SHALIER	SH AE L AY AH R
SHALIEST	SH AE L AY AH S T
SHALL	SH AE L
SHALLOON	SH AE L UW N
SHALLOONS	SH AE L UW N Z
SHALLOP	SH AE L AH P
SHALLOPS	SH AE L AH P S
SHALLOT	SH AE L AH T
SHALLOTS	SH AE L AH T S
SHALLOW	SH AE L OW
SHALLOWED	SH AE L OW D
SHALLOWER	SH AE L OW ER
SHALLOWEST	SH AE L OW AH S T
SHALLOWING	SH AE L OW IH NG
SHALLOWLY	SH AE L OW L IY
SHALLOWNESS	SH AE L OW N AH S
SHALLOWNESSES	SH AE L OW N AH S IH Z
SHALLOWS	SH AE L OW Z
SHALOM	SH AH L OW M
SHALOMS	SH AA L OW M Z
SHALT	SH AE L T
SHALY	SH AE L IY
SHAM	SH AE M
SHAMABLE	SH EY M AH B AH L
SHAMAN	SH EY M AH N
SHAMANIC	SH AE M AH N AH K
SHAMANISM	SH EY M AH N IH Z M
SHAMANISMS	SH AE M AH N AH Z AH M Z
SHAMANIST	SH AE M AH N AH S T
SHAMANISTIC	SH AE M AH N AH S T AH K
SHAMANISTS	SH EY M AH N IH S T S
SHAMANS	SH EY M AH N Z
SHAMAS	SH AE M AH S
SHAMBLE	SH AE M B AH L
SHAMBLED	SH AE M B AH L D
SHAMBLES	SH AE M B AH L Z
SHAMBLING	SH AE M B AH L IH NG
SHAMBOLIC	SH AE M B AH L AH K
SHAME	SH EY M
SHAMED	SH EY M D
SHAMEFACED	SH EY M F EY S T
SHAMEFACEDLY	SH EY M F EY S AH D L IY
SHAMEFACEDNESS	SH EY M F EY S AH D N AH S
SHAMEFACEDNESSES	SH EY M F EY S AH D N AH S IH Z
SHAMEFAST	SH EY M F AE S T
SHAMEFUL	SH EY M F AH L
SHAMEFULLY	SH EY M F AH L IY
SHAMEFULNESS	SH EY M F AH L N AH S
SHAMEFULNESSES	SH EY M F AH L N AH S IH Z
SHAMELESS	SH EY M L AH S
SHAMELESSLY	SH EY M L AH S L IY
SHAMELESSNESS	SH EY M L AH S N AH S
SHAMELESSNESSES	SH EY M L AH S N AH S IH Z
SHAMES	SH EY M Z
SHAMING	SH EY M IH NG
SHAMMAS	SH AE M AH Z
SHAMMASH	SH AE M AE SH
SHAMMASHIM	SH AE M AH SH AH M
SHAMMASIM	SH AE M AH S AH M
SHAMMED	SH AE M D
SHAMMER	SH AE M ER
SHAMMERS	SH AE M ER Z
SHAMMES	SH AE M Z
SHAMMIED	SH AE M IY D
SHAMMIES	SH AE M IY Z
SHAMMING	SH AE M IH NG
SHAMMOS	SH AE M AH Z
SHAMMOSIM	SH AE M AH S AH M
SHAMMY	SH AE M IY
SHAMMYING	SH AE M IY IH NG
SHAMOIS	SH AE M OW AH S
SHAMOS	SH AE M AA S
SHAMOSIM	SH AE M AH S AH M
SHAMOY	SH AE M OW IY
SHAMOYED	SH AH M OY D
SHAMOYING	SH AE M OY AH NG
SHAMOYS	SH AH M OY Z
SHAMPOO	SH AE M P UW
SHAMPOOED	SH AE M P UW D
SHAMPOOER	SH AE M P UW ER
SHAMPOOERS	SH AE M P UW ER Z
SHAMPOOING	SH AE M P UW IH NG
SHAMPOOS	SH AE M P UW Z
SHAMROCK	SH AE M R AA K
SHAMROCKS	SH AE M R AA K S
SHAMS	SH AE M Z
SHAMUS	SH EY M AH S
SHAMUSES	SH AE M Y UW S IH Z
SHANDIES	SH AE N D AY Z
SHANDY	SH AE N D IY
SHANDYGAFF	SH AE N D AH G AH F
SHANDYGAFFS	SH AE N D AH G AH F S
SHANGHAI	SH AE NG HH AY
SHANGHAIED	SH AH N EY D
SHANGHAIER	SH AE N EY AH R
SHANGHAIERS	SH AE N EY AH R Z
SHANGHAIING	SH AE N EY AH NG
SHANGHAIS	SH AE N EY AH S
SHANK	SH AE NG K
SHANKED	SH AE NG K T
SHANKING	SH AE NG K IH NG
SHANKPIECE	SH AE NG K P IY S
SHANKPIECES	SH AE NG K P IY S IH Z
SHANKS	SH AE NG K S
SHANNIES	SH AE N AY Z
SHANNY	SH AE N IY
SHANTEY	SH AE N T IY
SHANTEYS	SH AE N T EY Z
SHANTI	SH AE N T IY
SHANTIES	SH AE N T IY Z
SHANTIH	SH AE N T IY
SHANTIHS	SH AE N T AH Z
SHANTIS	SH AE N T IY Z
SHANTUNG	SH AE N T AH NG
SHANTUNGS	SH AE N T AH NG Z
SHANTY	SH AE N T IY
SHANTYMAN	SH AE N T IY M AE N
SHANTYMEN	SH AE N T IY M EH N
SHANTYTOWN	SH AE N T IY T AW N
SHANTYTOWNS	SH AE N T IY T AW N Z
SHAPABLE	SH EY P AH B AH L
SHAPE	SH EY P
SHAPEABLE	SH EY P AH B AH L
SHAPED	SH EY P T
SHAPELESS	SH EY P L AH S
SHAPELESSLY	SH EY P L AH S L IY
SHAPELESSNESS	SH EY P L AH S N AH S
SHAPELESSNESSES	SH EY P L AH S N AH S IH Z
SHAPELIER	SH EY P L IY ER
SHAPELIEST	SH EY P L IY AH S T
SHAPELINESS	SH EY P L IY N AH S
SHAPELINESSES	SH EY P L IY N AH S IH Z
SHAPELY	SH EY P L IY
SHAPEN	SH EY P AH N
SHAPER	SH EY P ER
SHAPERS	SH EY P ER Z
SHAPES	SH EY P S
SHAPEUP	SH EY P AH P
SHAPEUPS	SH EY P AH P S
SHAPING	SH EY P IH NG
SHARABLE	SH EH R AH B AH L
SHARD	SH AA R D
SHARDS	SH AA R D Z
SHARE	SH EH R
SHAREABILITIES	SH EH R AH B IH L AH T EH Z
SHAREABILITY	SH EH R AH B IH L AH T EH
SHAREABLE	SH EH R AH B AH L
SHARECROP	SH EH R K R AA P
SHARECROPPED	SH EH R K R AA P T
SHARECROPPER	SH EH R K R AA P ER
SHARECROPPERS	SH EH R K R AA P ER Z
SHARECROPPING	SH EH R K R AA P IH NG
SHARECROPS	SH EH R K R AA P S
SHARED	SH EH R D
SHAREHOLDER	SH EH R HH OW L D ER
SHAREHOLDERS	SH EH R HH OW L D ER Z
SHARER	SH EH R ER
SHARERS	SH EH R ER Z
SHARES	SH EH R Z
SHAREWARE	SH EH R W EH R
SHAREWARES	SH EH R W EH R Z
SHARIF	SH ER IY F
SHARIFIAN	SH AH R IH F IY AH N
SHARIFS	SH AE R AH F S
SHARING	SH EH R IH NG
SHARK	SH AA R K
SHARKED	SH AA R K T
SHARKER	SH AA R K ER
SHARKERS	SH AA R K ER Z
SHARKING	SH AA R K IH NG
SHARKLIKE	SH AA R K L AY K
SHARKS	SH AA R K S
SHARKSKIN	SH AA R K S K IH N
SHARKSKINS	SH AA R K S K IH N Z
SHARN	SH AA R N
SHARNS	SH AA R N Z
SHARNY	SH AA R N IY
SHARP	SH AA R P
SHARPED	SH AA R P T
SHARPEN	SH AA R P AH N
SHARPENED	SH AA R P AH N D
SHARPENER	SH AA R P AH N ER
SHARPENERS	SH AA R P AH N ER Z
SHARPENING	SH AA R P AH N IH NG
SHARPENING(2)	SH AA R P N IH NG
SHARPENS	SH AA R P AH N Z
SHARPER	SH AA R P ER
SHARPERS	SH AA R P ER Z
SHARPEST	SH AA R P AH S T
SHARPIE	SH AA R P IY
SHARPIES	SH AA R P IY Z
SHARPING	SH AA R P IH NG
SHARPLY	SH AA R P L IY
SHARPNESS	SH AA R P N AH S
SHARPNESSES	SH AA R P N AH S IH Z
SHARPS	SH AA R P S
SHARPSHOOTER	SH AA R P SH UW T ER
SHARPSHOOTERS	SH AA R P SH UW T ER Z
SHARPSHOOTING	SH AA R P SH UW T IH NG
SHARPSHOOTINGS	SH AA R P SH UW T IH NG Z
SHARPY	SH AA R P IY
SHASHLICK	SH AE SH L AH K
SHASHLICKS	SH AE SH L AH K S
SHASHLIK	SH AA SH L IH K
SHASHLIKS	SH AE SH L AY K S
SHASLIK	SH AE Z L AH K
SHASLIKS	SH AE Z L AY K S
SHAT	SH AE T
SHATTER	SH AE T ER
SHATTERED	SH AE T ER D
SHATTERING	SH AE T ER IH NG
SHATTERINGLY	SH AE T ER IH NG L IY
SHATTERPROOF	SH AE T ER P R UW F
SHATTERS	SH AE T ER Z
SHAUGH	SH AO
SHAUGHS	SH AO Z
SHAUL	SH AO L
SHAULED	SH EY AH L D
SHAULING	SH EY AH L AH NG
SHAULS	SH EY AH L Z
SHAVABLE	SH EY V AH B AH L
SHAVE	SH EY V
SHAVED	SH EY V D
SHAVELING	SH EY V L IH NG
SHAVELINGS	SH EY V L IH NG Z
SHAVEN	SH EY V AH N
SHAVER	SH EY V ER
SHAVERS	SH EY V ER Z
SHAVES	SH EY V Z
SHAVETAIL	SH EY V T EY L
SHAVETAILS	SH EY V T EY L Z
SHAVIE	SH EY V IY
SHAVIES	SH EY V IY Z
SHAVING	SH EY V IH NG
SHAVINGS	SH EY V IH NG Z
SHAW	SH AO
SHAWED	SH AO D
SHAWING	SH AO IH NG
SHAWL	SH AO L
SHAWLED	SH AO L D
SHAWLING	SH AO L IH NG
SHAWLS	SH AO L Z
SHAWM	SH AO M
SHAWMS	SH AO M Z
SHAWN	SH AO N
SHAWS	SH AO Z
SHAY	SH EY
SHAYS	SH EY Z
SHAZAM	SH AE Z AH M
SHE	SH IY
SHEA	SH EY
SHEAF	SH IY F
SHEAFED	SH IY F T
SHEAFING	SH IY F IH NG
SHEAFLIKE	SH IY F L AY K
SHEAFS	SH IY F S
SHEAL	SH IY AH L
SHEALING	SH IY L AH NG
SHEALINGS	SH IY L AH NG Z
SHEALS	SH IY L Z
SHEAR	SH IH R
SHEARED	SH IH R D
SHEARER	SH IH R ER
SHEARERS	SH IH ER ER Z
SHEARING	SH IH R IH NG
SHEARINGS	SH IH ER IH NG Z
SHEARLING	SH IH ER L IH NG
SHEARLINGS	SH IH ER L IH NG Z
SHEARS	SH IY R Z
SHEARWATER	SH IH ER W AO T ER
SHEARWATERS	SH IH ER W AO T ER Z
SHEAS	SH IY Z
SHEATH	SH IY TH
SHEATHBILL	SH IY TH B IH L
SHEATHBILLS	SH IY TH B IH L Z
SHEATHE	SH IY DH
SHEATHED	SH IY DH D
SHEATHER	SH IY DH ER
SHEATHERS	SH IY DH ER Z
SHEATHES	SH IY DH Z
SHEATHING	SH IY DH IH NG
SHEATHINGS	SH IY DH IH NG Z
SHEATHS	SH IY TH S
SHEAVE	SH IY V
SHEAVED	SH IY V D
SHEAVES	SH IY V Z
SHEAVING	SH IY V AH NG
SHEBANG	SH EH B AH NG
SHEBANGS	SH EH B AH NG Z
SHEBEAN	SH IY B IY AH N
SHEBEANS	SH IY B IY N Z
SHEBEEN	SH IY B IY AH N
SHEBEENS	SH IY B IY N Z
SHED	SH EH D
SHEDABLE	SH EH D AH B AH L
SHEDDED	SH EH D IH D
SHEDDER	SH EH D ER
SHEDDERS	SH EH D ER Z
SHEDDING	SH EH D IH NG
SHEDLIKE	SH EH D L AY K
SHEDS	SH EH D Z
SHEEN	SH IY N
SHEENED	SH IY N D
SHEENEY	SH IY N IY
SHEENEYS	SH IY N EY Z
SHEENFUL	SH IY N F AH L
SHEENIE	SH IY N IY
SHEENIER	SH IY N IY ER
SHEENIES	SH IY N IY Z
SHEENIEST	SH IY N IY AH S T
SHEENING	SH IY N IH NG
SHEENS	SH IY N Z
SHEENY	SH IY N IY
SHEEP	SH IY P
SHEEPBERRIES	SH IY P B EH R IY Z
SHEEPBERRY	SH IY P B EH R IY
SHEEPCOT	SH IY P K AA T
SHEEPCOTE	SH IY P OW T
SHEEPCOTES	SH IY P OW T S
SHEEPCOTS	SH IY P K AA T S
SHEEPDOG	SH IY P D AO G
SHEEPDOGS	SH IY P D AO G Z
SHEEPFOLD	SH IY P F OW L D
SHEEPFOLDS	SH IY P F OW L D Z
SHEEPHERDER	SH IY P HH ER D ER
SHEEPHERDERS	SH IY P HH ER D ER Z
SHEEPHERDING	SH IY P HH ER D IH NG
SHEEPHERDINGS	SH IY P HH ER D IH NG Z
SHEEPISH	SH IY P IH SH
SHEEPISHLY	SH IY P IH SH L IY
SHEEPISHNESS	SH IY P IH SH N AH S
SHEEPISHNESSES	SH IY P IH SH N AH S IH Z
SHEEPLIKE	SH IY P L AY K
SHEEPMAN	SH IY P M AE N
SHEEPMEN	SH IY P M EH N
SHEEPSHANK	SH IY P SH AE NG K
SHEEPSHANKS	SH IY P SH AE NG K S
SHEEPSHEAD	SH IY P S HH EH D
SHEEPSHEADS	SH IY P S HH EH D Z
SHEEPSHEARER	SH IY P SH IH ER ER
SHEEPSHEARERS	SH IY P SH IH ER ER Z
SHEEPSHEARING	SH IY P SH IH ER IH NG
SHEEPSHEARINGS	SH IY P SH IH ER IH NG Z
SHEEPSKIN	SH IY P S K IH N
SHEEPSKINS	SH IY P S K IH N Z
SHEER	SH IH R
SHEERED	SH IH ER D
SHEERER	SH IY R ER
SHEEREST	SH IH ER AH S T
SHEERING	SH IH ER IH NG
SHEERLEGS	SH IH ER L EH G Z
SHEERLY	SH IH ER L IY
SHEERNESS	SH IH ER N AH S
SHEERNESSES	SH IH ER N AH S IH Z
SHEERS	SH IH ER Z
SHEESH	SH IY SH
SHEET	SH IY T
SHEETED	SH IY T IH D
SHEETER	SH IY T ER
SHEETERS	SH IY T ER Z
SHEETFED	SH IY T F EH D
SHEETING	SH IY T IH NG
SHEETINGS	SH IY T IH NG Z
SHEETLIKE	SH IY T L AY K
SHEETS	SH IY T S
SHEEVE	SH IY V
SHEEVES	SH IY V Z
SHEGETZ	SH EH JH AH T S
SHEIK	SH IY K
SHEIKDOM	SH IY K D AH M
SHEIKDOMS	SH IY K D AH M Z
SHEIKH	SH IY K
SHEIKHDOM	SH IY K
SHEIKHDOMS	SH IY K D AH M Z
SHEIKHS	SH IY K S
SHEIKS	SH IY K S
SHEILA	SH IY L AH
SHEILAS	SH IY L AH Z
SHEITAN	SH IY T AH N
SHEITANS	SH IY T AH N Z
SHEKEL	SH EH K AH L
SHEKELS	SH EH K AH L Z
SHELDRAKE	SH EH L D R EY K
SHELDRAKES	SH EH L D R EY K S
SHELDUCK	SH EH L D AH K
SHELDUCKS	SH EH L D AH K S
SHELF	SH EH L F
SHELFFUL	SH EH L F AH L
SHELFFULS	SH EH L F AH L Z
SHELFLIKE	SH EH L F L AY K
SHELL	SH EH L
SHELLAC	SH EH L AE K
SHELLACK	SH EH L AE K
SHELLACKED	SH EH L AE K D
SHELLACKING	SH EH L AE K IH NG
SHELLACKINGS	SH EH L AE K AH NG Z
SHELLACKS	SH EH L AH K S
SHELLACS	SH EH L AH S
SHELLBACK	SH EH L B AE K
SHELLBACKS	SH EH L B AE K S
SHELLCRACKER	SH EH L K R AE K ER
SHELLCRACKERS	SH EH L K R AE K ER Z
SHELLED	SH EH L D
SHELLER	SH EH L ER
SHELLERS	SH EH L ER Z
SHELLFIRE	SH EH L F AY ER
SHELLFIRES	SH EH L F AY ER Z
SHELLFISH	SH EH L F IH SH
SHELLFISHERIES	SH EH L F IH SH AH R IY Z
SHELLFISHERY	SH EH L F IH SH AH R IY
SHELLFISHES	SH EH L F IH SH IH Z
SHELLIER	SH EH L IY ER
SHELLIEST	SH EH L IY AH S T
SHELLING	SH EH L IH NG
SHELLPROOF	SH EH L P R UW F
SHELLS	SH EH L Z
SHELLSHOCKED	SH EH L SH AA K T
SHELLWORK	SH EH L W ER K
SHELLWORKS	SH EH L W ER K S
SHELLY	SH EH L IY
SHELTA	SH EH L T AH
SHELTAS	SH EH L T AH Z
SHELTER	SH EH L T ER
SHELTERBELT	SH EH L T ER B EH L T
SHELTERBELTS	SH EH L T ER B EH L T S
SHELTERED	SH EH L T ER D
SHELTERER	SH EH L T ER ER
SHELTERERS	SH EH L T ER ER Z
SHELTERING	SH EH L T ER IH NG
SHELTERLESS	SH EH L T ER L AH S
SHELTERS	SH EH L T ER Z
SHELTIE	SH EH L T AY
SHELTIES	SH EH L T AY Z
SHELTY	SH EH L T IY
SHELVE	SH EH L V
SHELVED	SH EH L V D
SHELVER	SH EH L V ER
SHELVERS	SH EH L V ER Z
SHELVES	SH EH L V Z
SHELVIER	SH EH L V IY ER
SHELVIEST	SH EH L V IY AH S T
SHELVING	SH EH L V IH NG
SHELVINGS	SH EH L V IH NG Z
SHELVY	SH EH L V IY
SHENANIGAN	SH AH N AE N IH G AH N
SHENANIGANS	SH AH N AE N IH G AH N Z
SHEND	SH EH N D
SHENDING	SH EH N D AH NG
SHENDS	SH EH N D Z
SHENT	SH EH N T
SHEOL	SH IY AH L
SHEOLS	SH IY AH L Z
SHEPHERD	SH EH P ER D
SHEPHERDED	SH EH P ER D IH D
SHEPHERDESS	SH EH P ER D AH S
SHEPHERDESSES	SH EH P ER D AH S IH Z
SHEPHERDING	SH EH P ER D IH NG
SHEPHERDS	SH EH P ER D Z
SHEQALIM	SH EH K AH L AH M
SHEQEL	SH EH K AH L
SHERBERT	SH ER B ER T
SHERBERTS	SH AH R B AH R T S
SHERBET	SH ER B AH T
SHERBETS	SH AH R B AH T S
SHERD	SH AH R D
SHERDS	SH AH R D Z
SHEREEF	SH IY R IY F
SHEREEFS	SH IY R IY F S
SHERGOTTITE	SH AH R G AH T AY T
SHERGOTTITES	SH AH R G AH T AY T S
SHERIF	SH EH R AH F
SHERIFF	SH EH R AH F
SHERIFF(2)	SH EH R IH F
SHERIFFDOM	SH EH R AH F D AH M
SHERIFFDOMS	SH EH R AH F D AH M Z
SHERIFFS	SH EH R AH F S
SHERIFS	SH EH R AH F S
SHERLOCK	SH ER L AA K
SHERLOCKS	SH ER L AA K S
SHEROOT	SH AH R UW T
SHEROOTS	SH AH R UW T S
SHERPA	SH AH R P AH
SHERPAS	SH AH R P AH Z
SHERRIES	SH EH R IY Z
SHERRIS	SH EH R IY Z
SHERRISES	SH EH R IY Z IH Z
SHERRY	SH EH R IY
SHES	SH IY Z
SHETLAND	SH EH T L AH N D
SHETLANDS	SH EH T L AH N D Z
SHEUCH	SH UW CH
SHEUCHS	SH UW CH S
SHEUGH	SH UW
SHEUGHS	SH UW Z
SHEW	SH UW
SHEWBREAD	SH UW B R IY D
SHEWBREADS	SH UW B R IY D Z
SHEWED	SH UW D
SHEWER	SH UW AH R
SHEWERS	SH UW AH R Z
SHEWING	SH UW AH NG
SHEWN	SH UW N
SHEWS	SH UW Z
SHH	EH S EY CH
SHIATSU	SH AY AE T S UW
SHIATSUS	SH AY EY T S AH S
SHIATZU	SH AY AE T S UW
SHIATZUS	SH AY AE T S AH S
SHIBAH	SH IH B AH
SHIBAHS	SH IH B AH Z
SHIBBOLETH	SH IH B AH L EH TH
SHIBBOLETHS	SH IH B AH L AH TH S
SHICKER	SH IH K AH R
SHICKERS	SH IH K AH R Z
SHICKSA	SH IH K S AH
SHICKSAS	SH IH K S AH Z
SHIED	SH AY D
SHIEL	SH IY L
SHIELD	SH IY L D
SHIELDED	SH IY L D IH D
SHIELDER	SH IY L D ER
SHIELDERS	SH IY L D ER Z
SHIELDING	SH IY L D IH NG
SHIELDS	SH IY L D Z
SHIELING	SH IY L AH NG
SHIELINGS	SH IY L AH NG Z
SHIELS	SH IY L Z
SHIER	SH AY ER
SHIERS	SH AY ER Z
SHIES	SH AY Z
SHIEST	SH AY AH S T
SHIFT	SH IH F T
SHIFTABLE	SH IH F T AH B AH L
SHIFTED	SH IH F T AH D
SHIFTED(2)	SH IH F T IH D
SHIFTER	SH IH F T ER
SHIFTERS	SH IH F T ER Z
SHIFTIER	SH IH F T IY ER
SHIFTIEST	SH IH F T IY AH S T
SHIFTILY	SH IH F T IY L IY
SHIFTINESS	SH IH F T IY N AH S
SHIFTINESSES	SH IH F T IY N AH S IH Z
SHIFTING	SH IH F T IH NG
SHIFTLESS	SH IH F T L IH S
SHIFTLESSLY	SH IH F T L AH S L IY
SHIFTLESSNESS	SH IH F T L AH S N AH S
SHIFTLESSNESSES	SH IH F T L AH S N AH S IH Z
SHIFTS	SH IH F T S
SHIFTY	SH IH F T IY
SHIGELLA	SH AH JH EH L AH
SHIGELLAE	SH AH JH EH L IY
SHIGELLAS	SH AH JH EH L AH Z
SHIGELLOSES	SH IH JH AH L OW Z AH Z
SHIGELLOSIS	SH IH JH AH L OW S AH S
SHIITAKE	SH IY T EY K
SHIITAKES	SH IY T EY K S
SHIKAR	SH AY K AH R
SHIKAREE	SH IH K AH R IY IY
SHIKAREES	SH IH K AH R IY Z
SHIKARI	SH IH K AH R IY
SHIKARIS	SH IH K AH R AH S
SHIKARRED	SH IH K AH R D
SHIKARRING	SH AH K AA R AH NG
SHIKARS	SH IH K AH R Z
SHIKKER	SH IH K AH R
SHIKKERS	SH IH K AH R Z
SHIKSA	SH IH K S AH
SHIKSAS	SH IH K S AH Z
SHIKSE	SH IH K S
SHIKSES	SH IH K S AH Z
SHILINGI	SH AH L IH N JH IY
SHILL	SH IH L
SHILLALA	SH IH L AH L AH
SHILLALAH	SH IH L AH L AH
SHILLALAHS	SH IH L AH L AH Z
SHILLALAS	SH IH L AH L AH Z
SHILLED	SH IH L D
SHILLELAGH	SH IH L AH L AH
SHILLELAGHS	SH IH L AH L AH Z
SHILLING	SH IH L IH NG
SHILLINGS	SH IH L IH NG Z
SHILLS	SH IH L Z
SHILPIT	SH IH L P AH T
SHILY	SH AY L IY
SHIM	SH IH M
SHIMMED	SH IH M D
SHIMMER	SH IH M ER
SHIMMERED	SH IH M ER D
SHIMMERING	SH IH M ER IH NG
SHIMMERS	SH IH M ER Z
SHIMMERY	SH IH M AH R IY
SHIMMIED	SH IH M IY D
SHIMMIES	SH IH M IY Z
SHIMMING	SH IH M IH NG
SHIMMY	SH IH M IY
SHIMMYING	SH IH M IY IH NG
SHIMS	SH IH M Z
SHIN	SH IH N
SHINBONE	SH IH N B OW N
SHINBONES	SH IH N B OW N Z
SHINDIES	SH IH N D AY Z
SHINDIG	SH IH N D IH G
SHINDIGS	SH IH N D IH G Z
SHINDY	SH AY N D IY
SHINDYS	SH IH N D AH Z
SHINE	SH AY N
SHINED	SH AY N D
SHINER	SH AY N ER
SHINERS	SH AY N ER Z
SHINES	SH AY N Z
SHINGLE	SH IH NG G AH L
SHINGLED	SH IH NG G AH L D
SHINGLER	SH IH NG L ER
SHINGLERS	SH IH NG G AH L ER Z
SHINGLES	SH IH NG G AH L Z
SHINGLING	SH IH NG G AH L IH NG
SHINGLY	SH IH NG G AH L IY
SHINIER	SH AY N IY ER
SHINIEST	SH AY N IY AH S T
SHINILY	SH AY N IY L IY
SHININESS	SH AY N IY N AH S
SHININESSES	SH AY N IY N AH S IH Z
SHINING	SH AY N IH NG
SHINLEAF	SH IH N L IY F
SHINLEAFS	SH IH N L IY F S
SHINLEAVES	SH IH N L IY V Z
SHINNED	SH IH N D
SHINNERIES	SH IH N AH R IY Z
SHINNERY	SH IH N AH R IY
SHINNEY	SH IH N IY
SHINNEYED	SH IH N EY D
SHINNEYING	SH IH N EY AH NG
SHINNEYS	SH IH N EY Z
SHINNIED	SH IH N IY D
SHINNIES	SH IH N IY Z
SHINNING	SH IH N IH NG
SHINNY	SH IH N IY
SHINNYING	SH IH N IY IH NG
SHINPLASTER	SH IH N P L AE S T ER
SHINPLASTERS	SH IH N P L AE S T ER Z
SHINS	SH IH N Z
SHINSPLINTS	SH IH N S P L IH N T S
SHINY	SH AY N IY
SHIP	SH IH P
SHIPBOARD	SH IH P B AO R D
SHIPBOARDS	SH IH P B OW R D Z
SHIPBORNE	SH IH P B AO R N
SHIPBUILDER	SH IH P B IH L D ER
SHIPBUILDERS	SH IH P B IH L D ER Z
SHIPBUILDING	SH IH P B IH L D IH NG
SHIPBUILDINGS	SH IH P B IH L D IH NG Z
SHIPFITTER	SH IH P F IH T ER
SHIPFITTERS	SH IH P F IH T ER Z
SHIPLAP	SH IH P L AE P
SHIPLAPS	SH IH P L AE P S
SHIPLOAD	SH IH P L OW D
SHIPLOADS	SH IH P L OW D Z
SHIPMAN	SH IH P M AH N
SHIPMASTER	SH IH P M AE S T ER
SHIPMASTERS	SH IH P M AE S T ER Z
SHIPMATE	SH IH P M EY T
SHIPMATES	SH IH P M EY T S
SHIPMEN	SH IH P M EH N
SHIPMENT	SH IH P M AH N T
SHIPMENTS	SH IH P M AH N T S
SHIPOWNER	SH IH P OW N ER
SHIPOWNERS	SH IH P OW N ER Z
SHIPPABLE	SH IH P AH B AH L
SHIPPED	SH IH P T
SHIPPEN	SH IH P AH N
SHIPPENS	SH IH P AH N Z
SHIPPER	SH IH P ER
SHIPPERS	SH IH P ER Z
SHIPPING	SH IH P IH NG
SHIPPINGS	SH IH P IH NG Z
SHIPPON	SH IH P AH N
SHIPPONS	SH IH P AH N Z
SHIPS	SH IH P S
SHIPSHAPE	SH IH P SH EY P
SHIPSIDE	SH IH P S AY D
SHIPSIDES	SH IH P S AY D Z
SHIPWAY	SH IH P W EY
SHIPWAYS	SH IH P W EY Z
SHIPWORM	SH IH P W ER M
SHIPWORMS	SH IH P W ER M Z
SHIPWRECK	SH IH P R EH K
SHIPWRECKED	SH IH P R EH K T
SHIPWRECKING	SH IH P R EH K IH NG
SHIPWRECKS	SH IH P R EH K S
SHIPWRIGHT	SH IH P R AY T
SHIPWRIGHTS	SH IH P R AY T S
SHIPYARD	SH IH P Y AA R D
SHIPYARDS	SH IH P Y AA R D Z
SHIRE	SH AY R
SHIRES	SH AY R Z
SHIRK	SH ER K
SHIRKED	SH ER K T
SHIRKER	SH ER K ER
SHIRKERS	SH ER K ER Z
SHIRKING	SH ER K IH NG
SHIRKS	SH ER K S
SHIRR	SH ER
SHIRRED	SH AH R D
SHIRRING	SH AH R AH NG
SHIRRINGS	SH AH R AH NG Z
SHIRRS	SH AH R Z
SHIRT	SH ER T
SHIRTDRESS	SH ER T D R EH S
SHIRTDRESSES	SH ER T D R EH S IH Z
SHIRTFRONT	SH ER T F R AH N T
SHIRTFRONTS	SH ER T F R AH N T S
SHIRTIER	SH ER T IY ER
SHIRTIEST	SH ER T IY AH S T
SHIRTING	SH ER T IH NG
SHIRTINGS	SH ER T IH NG Z
SHIRTLESS	SH ER T L AH S
SHIRTMAKER	SH ER T M EY K ER
SHIRTMAKERS	SH ER T M EY K ER Z
SHIRTS	SH ER T S
SHIRTSLEEVE	SH ER T S L IY V
SHIRTSLEEVED	SH ER T S L IY V D
SHIRTSLEEVES	SH ER T S L IY V Z
SHIRTTAIL	SH ER T EY L
SHIRTTAILS	SH ER T EY L Z
SHIRTWAIST	SH ER T W EY S T
SHIRTWAISTS	SH ER T W EY S T S
SHIRTY	SH ER T IY
SHIST	SH IH S T
SHISTS	SH IH S T S
SHIT	SH IH T
SHITAKE	SH AH T EY K
SHITAKES	SH AH T EY K S
SHITHEAD	SH IH T HH EH D
SHITHEADS	SH IH T HH EH D Z
SHITS	SH IH T
SHITTAH	SH IH T AH
SHITTAHS	SH IH T AH Z
SHITTED	SH IH T IH D
SHITTIER	SH IH T IY ER
SHITTIEST	SH IH T IY AH S T
SHITTIM	SH IH T AH M
SHITTIMS	SH IH T AH M Z
SHITTIMWOOD	SH IH T AH M W UW D
SHITTIMWOODS	SH IH T AH M W UW D Z
SHITTING	SH IH T IH NG
SHITTY	SH IH T IY
SHIV	SH IH V
SHIVA	SH IY V AH
SHIVAH	SH IH V AH
SHIVAHS	SH IH V AH Z
SHIVAREE	SH IH V AH R IY IY
SHIVAREED	SH IH V AH R IY D
SHIVAREEING	SH AH V AE R IY AH NG
SHIVAREES	SH IH V AH R IY Z
SHIVAS	SH IH V AH Z
SHIVE	SH AY V
SHIVER	SH IH V ER
SHIVERED	SH IH V ER D
SHIVERER	SH IH V ER ER
SHIVERERS	SH IH V ER ER Z
SHIVERING	SH IH V ER IH NG
SHIVERS	SH IH V ER Z
SHIVERY	SH IH V ER IY
SHIVES	SH AY V Z
SHIVS	SH IH V Z
SHKOTZIM	SH K AA T S AH M
SHLEMIEHL	SH L IY M IY L
SHLEMIEHLS	SH L IY M IY L Z
SHLEMIEL	SH L IY M IY L
SHLEMIELS	SH L IY M IY L Z
SHLEP	SH L EH P
SHLEPP	SH L EH P
SHLEPPED	SH L EH P T
SHLEPPING	SH L EH P AH NG
SHLEPPS	SH L EH P S
SHLEPS	SH L EH P S
SHLOCK	SH L AA K
SHLOCKS	SH L AA K S
JIAO	JH AY AH OW
RUANA	R UW W AH N AH
HUARACHE	HH Y UW ER EY K
AORIST	AH OW R IH S T
JO	JH OW
OGAM	AA G AH M
TMESES	T M IY Z AH Z
