TH	T IY EY CH
ABSINTH	AE B S AH N TH
ABSINTHE	AE B S IH N TH
ABSINTHES	AE B S IH N TH S
ABSINTHS	AE B S AH N TH S
ACANTHI	AH K AE N TH IY
ACANTHOCEPHALAN	AH K AE N TH AH S EH F AH L AH N
ACANTHOCEPHALANS	AH K AE N TH AH S EH F AH L AH N Z
ACANTHUS	AH K AE N DH AH S
ACANTHUSES	AH K AE N DH AH S IH Z
ACROLITH	AE K R AH L AH TH
ACROLITHS	AE K R AH L AH TH S
ADULTHOOD	AH D AH L T HH UH D
ADULTHOODS	AH D AH L T HH UH D Z
AEROLITH	EH R AH L AH TH
AEROLITHS	EH R AH L AH TH S
AEROTHERMODYNAMIC	EH R AH TH AH R M AA D AH N AH M AH K
AEROTHERMODYNAMICS	EH R AH TH AH R M AH D IH N AH M AH S Z
AESTHETE	EH S TH IY T
AESTHETES	EH S TH IY T S
AESTHETIC	EH S TH EH T IH K
AESTHETICAL	EH S TH EH T IH K AH L
AESTHETICALLY	EH S TH EH T IH K L IY
AESTHETICIAN	EH S TH AH T IH S IY AH N
AESTHETICIANS	EH S TH AH T IH S IY AH N Z
AESTHETICISM	EH S TH EH T IH K IH Z AH M
AESTHETICISMS	EH S TH EH T IH K IH Z AH M Z
AESTHETICIZE	EH S TH EH T IH K AY Z
AESTHETICIZED	EH S TH EH T IH K AY Z D
AESTHETICIZES	EH S TH EH T IH K AY Z IH Z
AESTHETICIZING	EH S TH EH T IH K AY Z IH NG
AESTHETICS	EH S TH EH T IH K S
AETHER	AH IY TH ER
AETHERIC	AH IY TH ER IH K
AETHERS	AH IY TH ER Z
AFORETHOUGHT	AH F AO R TH AA T
AFTERBIRTH	AE F T ER B ER TH
AFTERBIRTHS	AE F T ER B ER TH S
AFTERMATH	AE F T ER M AE TH
AFTERMATHS	AE F T ER M AE TH S
AFTERTHOUGHT	AE F T ER TH AA T
AFTERTHOUGHT(2)	AE F T ER TH AO T
AFTERTHOUGHTS	AE F T ER TH AA T S
AFTERTHOUGHTS(2)	AE F T ER TH AO T S
AGAPANTHUS	AE G AH P AE N TH AH S
AGAPANTHUSES	AH G AE P AH N TH UW Z AH Z
AGOROTH	AE G AH R AH TH
AILANTHUS	EY L AE N TH AH S
AILANTHUSES	EY L AH N TH UW Z AH Z
AIRTH	EH R TH
AIRTHED	EH R TH T
AIRTHING	AH IH R TH IH NG
AIRTHS	EH R TH S
AIRWORTHIER	EH R W ER DH IY ER
AIRWORTHIEST	EH R W ER DH IY AH S T
AIRWORTHINESS	EH R W ER DH IY N AH S
AIRWORTHINESSES	EH R W ER DH IY N AH S IH Z
AIRWORTHY	EH R W ER DH IY
ALGORITHM	AE L G ER IH DH AH M
ALGORITHMIC	AE L G AH R IH DH AH M IH K
ALGORITHMICALLY	AE L G AH R IH DH AH M IH K AH L IY
ALGORITHMS	AE L G ER IH DH AH M Z
ALIYOTH	EY L IY AY AH TH
ALLELOPATHIC	AE L EH L AH P AH TH AH K
ALLELOPATHIES	AE L AH L AA P AH TH AY Z
ALLELOPATHY	AE L AH L AA P AH TH IY
ALLETHRIN	AE L EH TH R AH N
ALLETHRINS	AE L EH TH R AH N Z
ALLOPATH	AE L AH P AH TH
ALLOPATHS	AE L AH P AH TH S
ALTAZIMUTH	AE L T AE Z AH M AH TH
ALTAZIMUTHS	AE L T AE Z AH M AH TH S
ALTHAEA	AE L TH IY AH
ALTHAEAS	AE L TH IY AH Z
ALTHEA	AE L TH IY AH
ALTHEAS	AE L TH IY AH Z
ALTHO	AE L TH OW
ALTHORN	AE L TH AH R N
ALTHORNS	AE L TH AH R N Z
ALTHOUGH	AO L DH OW
ALTOGETHER	AO L T AH G EH DH ER
ALTOGETHERS	AO L T AH G EH DH ER Z
AMARANTH	AE M ER AE N TH
AMARANTHINE	AH M AE R AH N TH AY N
AMARANTHS	AE M AH R AH N TH S
AMETHYST	AE M IH TH IH S T
AMETHYSTINE	AE M AH TH IH S T AH N
AMETHYSTS	AE M AH TH AH S T S
AMPHIPATHIC	AE M F AH P AH TH AH K
AMPHITHEATER	AE M F AH TH IY EY T ER
AMPHITHEATERS	AE M F AH TH IY EY T ER Z
AMPHITHEATRIC	AE M F AH TH IY T R AH K
AMPHITHEATRICAL	AE M F AH TH IY T R IH S AH L
AMPHITHEATRICALLY	AE M F AH TH IY T R AH K AE L IY
ANACOLUTHA	AE N AH K AA L AH TH AH
ANACOLUTHIC	AH N AE K AH L AH TH AH K
ANACOLUTHICALLY	AE N AH K AH L AH TH AH K AE L IY
ANACOLUTHON	AE N AH K AA L AH TH AH N
ANACOLUTHONS	AE N AH K AA L AH TH AH N Z
ANAESTHESIA	AE N IH S TH IY ZH IY AH
ANAESTHESIAS	AE N AH S TH IY ZH AH Z
ANAESTHETIC	AE N AH S TH EH T IH K
ANAESTHETICS	AE N AH S TH EH T IH K S
ANATHEMA	AH N AE TH AH M AH
ANATHEMAS	AH N AE TH AH M AH Z
ANATHEMATA	AE N AH TH EH M AH T AH
ANATHEMATIZE	AE N AH TH EH M AH T AY Z
ANATHEMATIZED	AE N AH TH EH M AH T AY Z D
ANATHEMATIZES	AE N AH TH EH M AH T AY Z AH Z
ANATHEMATIZING	AE N AH TH EH M AH T AY Z AH NG
ANESTHESIA	AE N IH S TH IY ZH IY AH
ANESTHESIAS	AE N AH S TH IY S IY AH Z
ANESTHESIOLOGIES	AH N AH S TH AH S IY AA L AH JH AY Z
ANESTHESIOLOGIST	AE N AH S TH IY Z IY AA L AH JH IH S T
ANESTHESIOLOGISTS	AE N AH S TH IY Z IY AA L AH JH IH S T S
ANESTHESIOLOGISTS(2)	AE N AH S TH IY Z IY AA L AH JH IH S
ANESTHESIOLOGY	AE N AH S TH IY Z IY AA L AH JH IY
ANESTHETIC	AE N AH S TH EH T IH K
ANESTHETICALLY	AE N AH S TH EH T IH K AH L IY
ANESTHETICS	AE N AH S TH EH T IH K S
ANESTHETIST	AH N EH S TH EH T IH S T
ANESTHETISTS	AH N EH S TH AH T AH S T S
ANESTHETIZE	AH N EH S TH AH T AY Z
ANESTHETIZED	AH N EH S TH AH T AY Z D
ANESTHETIZES	AH N EH S TH AH T AY Z IH Z
ANESTHETIZING	AH N EH S TH AH T AY Z IH NG
ANETHOL	AE N AH TH AH L
ANETHOLE	AH N EH T HH OW L
ANETHOLES	AH N EH T HH OW L Z
ANETHOLS	AE N AH TH AH L Z
ANORTHIC	AH N AO R TH IH K
ANORTHITE	AE N AO R TH AY T
ANORTHITES	AE N AH R TH AY T S
ANORTHITIC	AH N AO R TH AH T AH K
ANORTHOSITE	AH N AO R TH AH S AY T
ANORTHOSITES	AH N AO R TH AH S AY T S
ANORTHOSITIC	AH N AO R TH AH S AH T AH K
ANOTHER	AH N AH DH ER
ANTHELIA	AE N TH IY L Y AH
ANTHELICES	AE N TH AH L AH S
ANTHELION	AE N TH IY L IY AH N
ANTHELIONS	AE N TH IY L IY AH N Z
ANTHELIX	AE N TH AH L AH K S
ANTHELIXES	AE N TH AH L AH K S
ANTHELMINTIC	AE N TH EH L M AH N T AH K
ANTHELMINTICS	AE N TH EH L M IH N T AH S Z
ANTHEM	AE N TH AH M
ANTHEMED	AE N TH AH M D
ANTHEMIA	AE N TH IY M IY AH
ANTHEMING	AE N TH AH M IH NG
ANTHEMION	AE N TH AH M IY AH N
ANTHEMS	AE N TH AH M Z
ANTHER	AE N DH AH R
ANTHERAL	AE N TH AH R AH L
ANTHERID	AE N TH AH R AH D
ANTHERIDIA	AE N TH AH R IH D IY AH
ANTHERIDIAL	AE N TH AH R IH D IY AH L
ANTHERIDIUM	AE N TH AH R IH D IY AH M
ANTHERIDS	AE N TH AH R AH D Z
ANTHERS	AE N TH AH R Z
ANTHESES	AE N TH IY Z AH Z
ANTHESIS	AE N DH AH S AH S
ANTHILL	AE N T HH IH L
ANTHILLS	AE N T HH IH L Z
ANTHOCYAN	AE N TH AA S AY AH N
ANTHOCYANIN	AE N TH AH S AY AH N AH N
ANTHOCYANINS	AE N TH AH S AY AH N AH N Z
ANTHOCYANS	AE N TH AA S AY AH N Z
ANTHODIA	AE N TH OW D IY AH
ANTHODIUM	AE N TH OW D IY AH M
ANTHOID	AE N T HH OW AH D
ANTHOLOGICAL	AE N TH AA L AH JH IH S AH L
ANTHOLOGIES	AE N TH AO L AH JH IY Z
ANTHOLOGIST	AE N TH AO L AH G IH S T
ANTHOLOGISTS	AE N TH AO L AH G IH S T S
ANTHOLOGIZE	AE N TH AA L AH JH AY Z
ANTHOLOGIZED	AE N TH AA L AH JH AY Z D
ANTHOLOGIZER	AE N TH AA L AH JH AY Z AH R
ANTHOLOGIZERS	AE N TH AH L AA JH AH Z AH R Z
ANTHOLOGIZES	AE N TH AA L AH JH AY Z AH Z
ANTHOLOGIZING	AE N TH AA L AH JH AY Z AH NG
ANTHOLOGY	AE N TH AO L AH JH IY
ANTHOPHILOUS	AE N TH AH F AY L AH S
ANTHOPHYLLITE	AE N TH AA F AH L AY T
ANTHOPHYLLITES	AE N TH AA F AH L AY T S
ANTHOZOAN	AE N TH AA Z OW AH N
ANTHOZOANS	AE N TH AH Z OW N Z
ANTHRACENE	AE N TH R AH S IY N
ANTHRACENES	AE N TH R AH S IY N Z
ANTHRACES	AE N TH R AH S AH Z
ANTHRACITE	AE N TH R AH S AY T
ANTHRACITES	AE N TH R AH S AY T S
ANTHRACITIC	AE N TH R AH S AH T AH K
ANTHRACNOSE	AE N TH R AH K N OW Z
ANTHRACNOSES	AE N TH R AH K N OW Z AH Z
ANTHRANILATE	AE N TH R AE N AH L EY T
ANTHRANILATES	AE N TH R AE N AH L EY T S
ANTHRAQUINONE	AE N TH R AE K W AH N OW N
ANTHRAQUINONES	AE N TH R AE K W AH N OW N Z
ANTHRAX	AE N TH R AE K S
ANTHROPIC	AE N TH R AH P AH K
ANTHROPICAL	AE N TH R AH P IH S AH L
ANTHROPOCENTRIC	AE N TH R AH P AH S EH N T R IH K
ANTHROPOCENTRICALLY	AE N TH R AH P AH S EH N T R AH K AE L IY
ANTHROPOCENTRICITIES	AE N TH R AA P AH S EH N T R IH S AH T AY Z
ANTHROPOCENTRICITY	AE N TH R AA P AH S EH N T R IH S AH T IY
ANTHROPOCENTRISM	AE N TH R AA P AH S AH N T R IH Z AH M
ANTHROPOCENTRISMS	AE N TH R AH P AH S EH N T R AH Z AH M Z
ANTHROPOGENIC	AE N TH R AH P AH JH EH N IH K
ANTHROPOID	AE N TH R AH P OY D
ANTHROPOIDS	AE N TH R AH P OY D Z
ANTHROPOLOGICAL	AE N TH R AH P AH L AA JH AH K AH L
ANTHROPOLOGICALLY	AE N TH R AH P AH L AA JH IH K AH L IY
ANTHROPOLOGIES	AE N TH R AH P AA L AH JH IY Z
ANTHROPOLOGIST	AE N TH R AH P AA L AH JH IH S T
ANTHROPOLOGISTS	AE N TH R AH P AA L AH JH IH S T S
ANTHROPOLOGY	AE N TH R AH P AA L AH JH IY
ANTHROPOMETRIC	AE N TH R AA P AH M AH T R AH K
ANTHROPOMETRIES	AE N TH R AH P AH M EH T R AY Z
ANTHROPOMETRY	AE N TH R AH P AH M EH T R IY
ANTHROPOMORPH	AE N TH R AA P AH M AH R F
ANTHROPOMORPHIC	AE N TH R AH P AH M AO R F IH K
ANTHROPOMORPHICALLY	AE N TH R AH P AH M AO R F IH K AH L IY
ANTHROPOMORPHISM	AE N TH R AH P AH M AO R F IH Z AH M
ANTHROPOMORPHISMS	AE N TH R AH P AH M AO R F AH Z AH M Z
ANTHROPOMORPHIST	AE N TH R AA P AH M AO R F AH S T
ANTHROPOMORPHISTS	AE N TH R AH P AH M AO R F AH S T S
ANTHROPOMORPHIZATION	AE N TH R AH P AH M AO R F AH Z EY SH AH N
ANTHROPOMORPHIZATIONS	AE N TH R AH P AH M AO R F AH Z EY T IY AH N Z
ANTHROPOMORPHIZE	AE N TH R AH P AA M AH R F AY Z
ANTHROPOMORPHIZED	AE N TH R AH P AA M AH R F AY Z D
ANTHROPOMORPHIZES	AE N TH R AH P AA M AH R F AY Z AH Z
ANTHROPOMORPHIZING	AE N TH R AH P AA M AH R F AY Z AH NG
ANTHROPOMORPHS	AE N TH R AA P AH M AH R F S
ANTHROPOPATHISM	AE N TH R AA P AH P AH TH IH Z AH M
ANTHROPOPATHISMS	AE N TH R AH P AA P AH TH AH Z AH M Z
ANTHROPOPHAGI	AE N TH R AH P AA F AH JH IY
ANTHROPOPHAGIES	AE N TH R AH P AA F AH JH AY Z
ANTHROPOPHAGOUS	AE N TH R AA P AH F EY JH AH S
ANTHROPOPHAGUS	AE N TH R AH P AA F AH JH AH S
ANTHROPOPHAGY	AE N TH R AH P AA F AH JH IY
ANTHROPOSOPHIES	AE N TH R AH P AA S AH F AY Z
ANTHROPOSOPHY	AE N TH R AH P AA S AH F IY
ANTHURIUM	AE N TH UH R IY AH M
ANTHURIUMS	AE N TH UH R IY AH M Z
ANTIAPARTHEID	AE N T AY AH P AA R T EY T
ANTIAPARTHEIDS	AE N T AY AH P AA R T EY T S
ANTIARRHYTHMIC	AE N T IY ER R IH DH M IH K
ANTIARRHYTHMICS	AE N T IY ER R IH DH M IH K S
ANTIARTHRITIC	AE N T IY ER TH R AY T IH K
ANTIARTHRITICS	AE N T IY ER TH R AY T IH K S
ANTIARTHRITIS	AE N T AY AA R TH R AY T AH S
ANTIASTHMA	AE N T AY AE Z M AH
ANTIAUTHORITARIAN	AE N T AY AH TH AO R AH T EH R IY AH N
ANTIAUTHORITARIANISM	AE N T AY AH TH AO R AH T EH R IY AH N IH Z AH M
ANTIAUTHORITARIANISMS	AE N T AY AH TH AO R AH T EH R IY AH N IH Z AH M Z
ANTIAUTHORITY	AE N T AY AH TH AO R AH T IY
ANTICATHODE	AE N T AY K AE TH OW D
ANTICATHODES	AE N T AY K AE TH OW D Z
ANTIGROWTH	AE N T AY G R OW TH
ANTILOGARITHM	AE N T AY L AA G AH R IH DH AH M
ANTILOGARITHMIC	AE N T AY L AA G AH R IH DH AH M IH K
ANTILOGARITHMS	AE N T AY L AA G AH R IH DH AH M Z
ANTIPATHETIC	AE N T AY P AH TH EH T IH K
ANTIPATHETICALLY	AE N T AY P AH TH EH T IH K AH L IY
ANTIPATHIES	AE N T IH P AH TH IY Z
ANTIPATHY	AE N T IH P AH TH IY
ANTITHEFT	AE N T AY TH EH F T
ANTITHEFT(2)	AE N T IY TH EH F T
ANTITHEORETICAL	AE N T AY TH IY AH R EH T IH K AH L
ANTITHESES	AE N T AY TH IY S IY Z
ANTITHESIS	AE N T IH TH AH S AH S
ANTITHETIC	AE N T AH TH EH T IH K
ANTITHETICAL	AE N T AH TH EH T IH K AH L
ANTITHETICALLY	AE N T AH TH EH T IH K AH L IY
ANTITHROMBIN	AE N T AY TH R AA M B AH N
ANTITHROMBINS	AE N T AY TH R AA M B AH N Z
ANTITHYROID	AE N T AY TH AY R OY D
ANYTHING	EH N IY TH IH NG
ANYTHINGS	EH N IY TH IH NG Z
APARTHEID	AH P AA R T AY T
APARTHEID(2)	AH P AA R T AY D
APARTHEIDS	AH P AA R T EY T S
APATHETIC	AE P AH TH EH T IH K
APATHETICALLY	AE P AH TH EH T IH K AH L IY
APATHIES	AE P AH TH IY Z
APATHY	AE P AH TH IY
APHTHA	AE F TH AH
APHTHAE	AE F TH IY
APHTHOUS	AE F TH AH S
APOPHTHEGM	AH P AA F TH AH M
APOPHTHEGMS	AH P AA F TH AH M Z
APOTHECARIES	AH P AA TH AH K EH R IY Z
APOTHECARY	AH P AA TH AH K EH R IY
APOTHECE	AE P AH TH IY S
APOTHECES	AE P AH TH IY S AH Z
APOTHECIA	AE P AH TH IY SH IY AH
APOTHECIAL	AE P AH TH IY SH AH L
APOTHECIUM	AE P AH TH IY S IY AH M
APOTHEGM	AE P AH TH AH M
APOTHEGMATIC	AH P AA TH AH M AH T AH K
APOTHEGMS	AE P AH TH AH M Z
APOTHEM	AH P AA T HH EH M
APOTHEMS	AH P AA T HH EH M Z
APOTHEOSES	AH P AA TH IY OW Z AH Z
APOTHEOSIS	AH P AA TH IY OW S AH S
APOTHEOSIZE	AH P AA TH IY AH Z AY Z
APOTHEOSIZED	AH P AA TH IY AH Z AY Z D
APOTHEOSIZES	AH P AA TH IY AH Z AY Z AH Z
APOTHEOSIZING	AH P AA TH IY AH Z AY Z AH NG
ARETHUSA	AE R AH TH UW S AH
ARETHUSAS	AE R AH TH UW S AH Z
ARITHMETIC	EH R IH TH M EH T IH K
ARITHMETIC(2)	ER IH TH M AH T IH K
ARITHMETICAL	AE R IH TH M EH T IH K AH L
ARITHMETICALLY	AE R IH TH M EH T IH K AH L IY
ARITHMETICIAN	AH R IH TH M AH T IH S IY AH N
ARITHMETICIANS	AH R IH TH M AH T IH S IY AH N Z
ARITHMETICS	AH R IH TH M AH T IH K S
AROMATHERAPIES	AH R OW M AH TH EH R AH P IY Z
AROMATHERAPIST	AH R OW M AH TH ER EY P IH S T
AROMATHERAPISTS	AH R OW M AH TH ER EY P IH S T S
AROMATHERAPY	AH R OW M AH TH ER AH P IY
ARRHYTHMIA	ER IH DH M IY AH
ARRHYTHMIAS	ER IH DH M IY AH Z
ARRHYTHMIC	AE R AH TH M AH K
ARTHRALGIA	AA R TH R AE L JH IY AH
ARTHRALGIAS	AA R TH R AE L JH IY AH Z
ARTHRALGIC	AA R TH R AH L JH AH K
ARTHRITIC	AA R TH R IH T IH K
ARTHRITICALLY	AA R TH R IH T AH K AE L IY
ARTHRITICS	AA R TH R AH T AH S Z
ARTHRITIDES	AA R TH R AH T AY D Z
ARTHRITIS	AA R TH R AY T AH S
ARTHRITIS(2)	AA R TH R AY T IH S
ARTHRODESES	AA R TH R AH D IY Z AH Z
ARTHRODESIS	AA R TH R OW D AH S AH S
ARTHROPATHIES	AA R TH R AA P AH TH AY Z
ARTHROPATHY	AA R TH R AA P AH TH IY
ARTHROPOD	AA R TH R AH P AA D
ARTHROPODAN	AA R TH R AA P AH D AH N
ARTHROPODS	AA R TH R AH P AA D Z
ARTHROSCOPE	AA R TH R AH S OW P
ARTHROSCOPES	AA R TH R AH S OW P S
ARTHROSCOPIC	AA R TH R AA S AH P AH K
ARTHROSCOPIES	AA R TH R AA S AH P AY Z
ARTHROSCOPY	AA R TH R AA S AH P IY
ARTHROSES	AA R TH R OW Z AH Z
ARTHROSIS	AA R TH R OW S AH S
ARTHROSPORE	AA R TH R AA S AH R
ARTHROSPORES	AA R TH R AA S AH R Z
ARYTHMIA	AH R IH TH M IY AH
ARYTHMIAS	AH R IH TH M IY AH Z
ARYTHMIC	AE R AH TH M AH K
ASTHENIA	AE S TH IY N Y AH
ASTHENIAS	AE S TH IY N Y AH Z
ASTHENIC	AH Z TH AH N IH K
ASTHENICS	AH Z TH AH N IH K S
ASTHENIES	AH Z TH AH N IY Z
ASTHENOSPHERE	AE S TH AH N AA S AH R
ASTHENOSPHERES	AE S TH EH N AH S IY R Z
ASTHENOSPHERIC	AE S TH AH N AA S AH R AH K
ASTHENY	AH Z TH AH N IY
ASTHMA	AE Z M AH
ASTHMAS	AE Z M AH Z
ASTHMATIC	AE Z M AE T IH K
ASTHMATICALLY	AH Z TH M EY T IH K AH L IY
ASTHMATICS	EH S TH M EH T IH K S
ATHANASIES	AH TH AE N AH S AY Z
ATHANASY	AH TH AE N AH Z IY
ATHEISM	AH TH AY S AH M
ATHEISM(2)	EY TH IY IH Z AH M
ATHEISMS	AH TH IY Z AH M Z
ATHEIST	EY TH IY AH S T
ATHEISTIC	EY TH IY IH S T IH K
ATHEISTICAL	EY TH IY IH S T IH K AH L
ATHEISTICALLY	EY TH IY IH S T IH K AH L IY
ATHEISTS	EY TH IY AH S T S
ATHELING	AH TH IY L AH NG
ATHELINGS	AE TH AH L AH NG Z
ATHENAEUM	AE TH AH N IY AH M
ATHENAEUMS	AH TH EH N IY AH M Z
ATHENEUM	AE TH AH N UW M
ATHENEUMS	AH TH IY N IY AH M Z
ATHEORETICAL	AH TH IY AH R EH T IH K AH L
ATHEROGENESES	AH TH AH R AA JH AH N IY Z AH Z
ATHEROGENESIS	AE TH AH R AH JH IY N AH S AH S
ATHEROGENIC	AH TH EH R AH JH AH N AH K
ATHEROMA	AH TH EH R AH M AH
ATHEROMAS	AH TH EH R AH M AH Z
ATHEROMATA	AE TH AH R AA M AH T AH
ATHEROMATOUS	AE TH AH R AA M AH T AH S
ATHEROSCLEROSES	AH TH AH R AA S L AH R OW Z AH Z
ATHEROSCLEROSIS	AE TH ER OW S K L ER OW S IH S
ATHEROSCLEROTIC	AE TH AH R AA S L AH R AH T AH K
ATHETOID	AE TH AH T OY D
ATHIRST	AH TH ER S T
ATHLETE	AE TH L IY T
ATHLETES	AE TH L IY T S
ATHLETIC	AE TH L EH T IH K
ATHLETICALLY	AE TH L EH T IH K L IY
ATHLETICISM	AE TH L EH T IH S IH Z M
ATHLETICISMS	AE TH L EH T AH S IH Z AH M Z
ATHLETICS	AE TH L EH T IH K S
ATHODYD	AE TH AH D AH D
ATHODYDS	AE TH AH D AH D Z
ATHROCYTE	AE TH R AH S AY T
ATHROCYTES	AE TH R AH S AY T S
ATHWART	AH TH W AO R T
ATHWARTSHIP	AH TH W AO R T SH IH P
ATHWARTSHIPS	AH TH W AO R T SH IH P S
AUNTHOOD	AE N T HH UH D
AUNTHOODS	AE N T HH UH D Z
AUSTRALOPITHECINE	AO S T R EY L OW P IH TH AH S AY N
AUSTRALOPITHECINES	AO S T R AH L AH P IH TH AH S AY N Z
AUTHENTIC	AH TH EH N T IH K
AUTHENTIC(2)	AO TH EH N T IH K
AUTHENTIC(3)	AO TH EH N IH K
AUTHENTIC(4)	AH TH EH N IH K
AUTHENTICALLY	AO TH EH N T IH K L IY
AUTHENTICALLY(2)	AO TH EH N IH K L IY
AUTHENTICATE	AO TH EH N T AH K EY T
AUTHENTICATED	AO TH EH N T AH K EY T AH D
AUTHENTICATES	AO TH EH N T IH K AH T S
AUTHENTICATING	AO TH EH N T AH K EY T IH NG
AUTHENTICATION	AO TH EH N T AH K EY SH AH N
AUTHENTICATIONS	AO TH EH N T AH K EY SH AH N Z
AUTHENTICATOR	AO TH EH N T IH K AH T ER
AUTHENTICATORS	AO TH EH N T IH K AH T ER Z
AUTHENTICITIES	AO TH EH N T IH S AH T IY Z
AUTHENTICITY	AO TH AH N T IH S IH T IY
AUTHOR	AO TH ER
AUTHORED	AO TH ER D
AUTHORESS	AO TH ER AH S
AUTHORESSES	AO TH ER AH S IH Z
AUTHORIAL	AO TH ER IY AH L
AUTHORING	AO TH ER IH NG
AUTHORISE	AO TH AH R AY Z
AUTHORISED	AO TH ER IY Z D
AUTHORISES	AO TH ER IY Z IH Z
AUTHORISING	AO TH ER IY Z IH NG
AUTHORITARIAN	AH TH AO R AH T EH R IY AH N
AUTHORITARIANISM	AH TH AO R AH T EH R IY AH N IH Z AH M
AUTHORITARIANISMS	AH TH AO R AH T EH R IY AH N IH Z AH M Z
AUTHORITARIANS	AH TH AO R AH T EH R IY AH N Z
AUTHORITATIVE	AH TH AO R AH T EY T IH V
AUTHORITATIVELY	AH TH AO R AH T EY T IH V L IY
AUTHORITATIVENESS	AH TH AO R AH T EY T IH V N AH S
AUTHORITATIVENESSES	AH TH AO R AH T EY T IH V N AH S IH Z
AUTHORITIES	AH TH AO R AH T IY Z
AUTHORITY	AH TH AO R AH T IY
AUTHORIZATION	AO TH ER AH Z EY SH AH N
AUTHORIZATIONS	AO TH ER AH Z EY SH AH N Z
AUTHORIZE	AO TH ER AY Z
AUTHORIZED	AO TH ER AY Z D
AUTHORIZER	AO TH ER AY Z ER
AUTHORIZERS	AO TH ER AY Z ER Z
AUTHORIZES	AO TH ER AY Z IH Z
AUTHORIZING	AO TH ER AY Z IH NG
AUTHORS	AO TH ER Z
AUTHORSHIP	AO TH ER SH IH P
AUTHORSHIPS	AO TH ER SH IH P S
AUTOCHTHON	AH T AA CH TH AH N
AUTOCHTHONES	AO T AH CH TH OW N Z
AUTOCHTHONOUS	AH T AA CH TH AH N AH S
AUTOCHTHONOUSLY	AH T AA CH TH AA N OW AH S L IY
AUTOCHTHONS	AH T AA CH TH AH N Z
AWEATHER	AH W EH DH ER
AZATHIOPRINE	AH Z AE TH IY AH P R AY N
AZATHIOPRINES	AH Z AE TH IY AH P R AY N Z
AZIDOTHYMIDINE	AH Z IH D AH TH AY M AH D IY N
AZIDOTHYMIDINE(2)	AH Z IH D AH TH AY M AH D AY N
AZIDOTHYMIDINE(3)	EY Z AY D AH TH AY M AH D IY N
AZIDOTHYMIDINE(4)	EY Z AY D AH TH AY M AH D AY N
AZIDOTHYMIDINES	AH Z AH D AH TH IH M AH D AY N Z
AZIMUTH	AE Z AH M AH TH
AZIMUTHAL	AH Z IH M AH TH AH L
AZIMUTHALLY	AH Z IH M AH TH AE L IY
AZIMUTHS	AE Z AH M AH TH S
AZOTH	AE Z AH TH
AZOTHS	AE Z AH TH S
BACKCLOTH	B AE K L AO TH
BACKCLOTHS	B AE K L AO TH S
BADMOUTH	B AE D M AW TH
BADMOUTHED	B AE D M AW TH T
BADMOUTHING	B AE D M AW TH IH NG
BADMOUTHS	B AE D M AW TH S
BAITH	B EY TH
BANDWIDTH	B AE N D W IH D TH
BANDWIDTHS	B AE N D W IH D TH S
BARATHEA	B AH R AE TH IY AH
BARATHEAS	B AE R AH TH IY Z
BATH	B AE TH
BATHE	B EY DH
BATHED	B EY DH D
BATHER	B EY DH ER
BATHER(2)	B AE DH ER
BATHERS	B EY DH ER Z
BATHERS(2)	B AE DH ER Z
BATHES	B EY DH Z
BATHETIC	B AE TH AH T AH K
BATHETICALLY	B AH TH EH T AH K AE L IY
BATHHOUSE	B AE TH HH AW S
BATHHOUSES	B AE TH AH S IH Z
BATHING	B EY DH IH NG
BATHLESS	B AE TH L AH S
BATHMAT	B AE TH M AE T
BATHMATS	B AE TH M AE T S
BATHOLITH	B AE TH AH L IH TH
BATHOLITHIC	B AE T HH OW L IY TH IH K
BATHOLITHS	B AE TH AH L IH TH S
BATHOS	B EY TH AA S
BATHOSES	B EY TH AA S IH Z
BATHROBE	B AE TH R OW B
BATHROBES	B AE TH R OW B Z
BATHROOM	B AE TH R UW M
BATHROOMS	B AE TH R UW M Z
BATHROOMS(2)	B AA TH R UW M Z
BATHS	B AE TH S
BATHTUB	B AE TH T AH B
BATHTUBS	B AE TH T AH B Z
BATHWATER	B AE TH W AO T ER
BATHWATERS	B AE TH W AO T ER Z
BATHYAL	B EY DH IY AH L
BATHYMETRIC	B EY DH IY M EH T R IH K
BATHYMETRICAL	B EY DH IY M EH T R IH K AH L
BATHYMETRICALLY	B EY DH IY M EH T R IH K AH L IY
BATHYMETRIES	B EY DH IY M IY T ER IY Z
BATHYMETRY	B EY DH IY M IY T ER IY
BATHYPELAGIC	B AH TH IH P AH L AH JH AH K
BATHYSCAPH	B AH TH IH S AH F
BATHYSCAPHE	B AH TH IH S AH F
BATHYSCAPHES	B AH TH IH S AH F S
BATHYSCAPHS	B AH TH IH S AH F S
BATHYSPHERE	B EY DH IY S F IH ER
BATHYSPHERES	B EY DH IY S F IH ER Z
BATHYTHERMOGRAPH	B AE TH AH TH AH R M AA G R AH F
BATHYTHERMOGRAPHS	B AE TH AH TH AH R M AA G R AH F S
BECLOTHE	B IH K L OW DH
BECLOTHED	B IH K L OW DH D
BECLOTHES	B IH K L OW DH Z
BECLOTHING	B IH K L OW DH IH NG
BEDCLOTHES	B EH D K L OW DH Z
BEHEMOTH	B AH HH IY M AH TH
BEHEMOTH(2)	B IY HH AH M AH TH
BEHEMOTHS	B IH HH IY M AH TH S
BELLWETHER	B EH L W EH DH ER
BELLWETHERS	B EH L W EH DH ER Z
BENEATH	B IH N IY TH
BENTHAL	B IY AH N TH AH L
BENTHIC	B IY AH N TH IH K
BENTHONIC	B IY AH N T HH OW N IH K
BENTHOS	B IY AH N TH AA S
BENTHOSES	B IY AH N T HH OW Z IH Z
BENZANTHRACENE	B IH N Z AE N TH R AH S IY N
BENZANTHRACENES	B IH N Z AE N TH R AH S IY N Z
BEQUEATH	B IH K W IY TH
BEQUEATHAL	B IH K W IY TH AH L
BEQUEATHALS	B IH K W IY TH AH L Z
BEQUEATHED	B AH K W IY TH T
BEQUEATHING	B IH K W IY TH IH NG
BEQUEATHS	B IH K W IY TH S
BERTH	B ER TH
BERTHA	B ER TH AH
BERTHAS	B ER TH AH Z
BERTHED	B ER TH T
BERTHING	B ER TH IH NG
BERTHS	B ER TH S
BERTHS(2)	B ER DH Z
BESMOOTH	B IH S M UW DH
BESMOOTHED	B IH S M UW DH D
BESMOOTHING	B IH S M UW DH IH NG
BESMOOTHS	B IH S M UW DH Z
BESOOTHE	B IH S UW DH
BESOOTHED	B IH S UW DH D
BESOOTHES	B IH S UW DH Z
BESOOTHING	B IH S UW DH IH NG
BETH	B EH TH
BETHANK	B IH TH AE NG K
BETHANKED	B IH TH AE NG K T
BETHANKING	B IH TH AE NG K IH NG
BETHANKS	B IH TH AE NG K S
BETHEL	B EH TH AH L
BETHEL(2)	B EH TH EH L
BETHELS	B EH TH AH L Z
BETHESDA	B AH TH EH Z D AH
BETHESDAS	B AH TH EH Z D AH Z
BETHINK	B IH TH IH NG K
BETHINKING	B IH TH IH NG K IH NG
BETHINKS	B IH TH IH NG K S
BETHORN	B IH TH AO R N
BETHORNED	B IH TH AO R N D
BETHORNING	B IH TH AO R N IH NG
BETHORNS	B IH TH AO R N Z
BETHOUGHT	B IH TH AO T
BETHS	B IY IH TH S
BETHUMP	B IH TH AH M P
BETHUMPED	B IH TH AH M P T
BETHUMPING	B IH TH AH M P IH NG
BETHUMPS	B IH TH AH M P S
BETROTH	B IH T R AO TH
BETROTHAL	B IH T R AO TH AH L
BETROTHALS	B IH T R AO TH AH L Z
BETROTHED	B IH T R AO TH T
BETROTHEDS	B IH T R AO TH T S
BETROTHING	B IH T R AO TH IH NG
BETROTHS	B IH T R AO TH S
BIATHLETE	B AY AE TH L IY T
BIATHLETES	B AY AE TH L IY T S
BIATHLON	B AY AE TH L AH N
BIATHLONS	B AY AE TH L AH N Z
BIBLIOTHECA	B AY B L AY AA TH AH K AH
BIBLIOTHECAE	B AY B L AY AA TH AH K IY
BIBLIOTHECAL	B AY B L AY AA TH AH K AH L
BIBLIOTHECAS	B AY B L AY AA TH AH K AH Z
BIBLIOTHERAPIES	B AY B L AY AH TH EH R AH P AY Z
BIBLIOTHERAPY	B AY B L AY AH TH EH R AH P IY
BIGMOUTH	B IH G M AW TH
BIGMOUTHED	B IH G M AW TH T
BIGMOUTHS	B IH G M AW TH S
BILLIONTH	B IH L Y AH N TH
BILLIONTHS	B IH L Y AH N TH S
BIMETHYL	B AY M EH TH AH L
BIMETHYLS	B AY M EH TH AH L Z
BIMONTHLIES	B AY M AH N TH L IY Z
BIMONTHLY	B AY M AH N TH L IY
BIOETHIC	B AY OW AH TH AH K
BIOETHICAL	B AY OW AH TH IH S AH L
BIOETHICIST	B AY OW AH TH IH S AH S T
BIOETHICISTS	B AY OW EH TH AH S AH S T S
BIOETHICS	B AY OW EH TH IH K S
BIOMATHEMATICAL	B AY AH M AH TH EH M AH T IH S AH L
BIOMATHEMATICIAN	B AY AH M AH TH EH M AH T IH S IY AH N
BIOMATHEMATICIANS	B AY AH M AE TH AH M AH T IH S IY AH N Z
BIOMATHEMATICS	B AY AH M AH TH EH M AH T AH S Z
BIORHYTHM	B AY AO R AH DH AH M
BIORHYTHMIC	B AY AO R AH TH M AH K
BIORHYTHMS	B AY AO R AH DH AH M Z
BIOSYNTHESES	B AY AA S AH N TH IY Z AH Z
BIOSYNTHESIS	B AY AH S IH N DH AH S AH S
BIOSYNTHETIC	B AY AH S IH N TH AH T AH K
BIOSYNTHETICALLY	B AY AH S IH N TH EH T AH K AE L IY
BIRDBATH	B ER D B AE TH
BIRDBATHS	B ER D B AE TH S
BIRTH	B ER TH
BIRTHDATE	B ER TH D EY T
BIRTHDATES	B ER TH D EY T S
BIRTHDAY	B ER TH D EY
BIRTHDAYS	B ER TH D EY Z
BIRTHED	B ER TH T
BIRTHING	B ER TH IH NG
BIRTHMARK	B ER TH M AA R K
BIRTHMARKS	B ER TH M AA R K S
BIRTHPLACE	B ER TH P L EY S
BIRTHPLACES	B ER TH P L EY S IH Z
BIRTHRATE	B ER TH R EY T
BIRTHRATES	B ER TH R EY T S
BIRTHRIGHT	B ER TH R AY T
BIRTHRIGHTS	B ER TH R AY T S
BIRTHROOT	B ER TH R UW T
BIRTHROOTS	B ER TH R UW T S
BIRTHS	B ER TH S
BIRTHSTONE	B ER TH S T OW N
BIRTHSTONES	B ER TH S T OW N Z
BIRTHWORT	B AY R TH W AH R T
BIRTHWORTS	B AY R TH W AH R T S
BISMUTH	B IH Z M AH TH
BISMUTHIC	B AY S M AH TH AH K
BISMUTHS	B AY S M AH TH S
BLABBERMOUTH	B L AE B ER M AW TH
BLABBERMOUTHS	B L AE B ER M AW TH S
BLACKSMITH	B L AE K S M IH TH
BLACKSMITHING	B L AE K S M IH TH IH NG
BLACKSMITHINGS	B L AE K S M IH TH IH NG Z
BLACKSMITHS	B L AE K S M IH TH S
BLACKTHORN	B L AE K TH AO R N
BLACKTHORNS	B L AE K TH AO R N Z
BLAMEWORTHINESS	B L EY M W ER DH IY N AH S
BLAMEWORTHINESSES	B L EY M W ER DH IY N AH S IH Z
BLAMEWORTHY	B L EY M W ER DH IY
BLATHER	B L AE DH ER
BLATHERED	B L AH TH IY R D
BLATHERER	B L AH TH IY R AH R
BLATHERERS	B L AE TH AH R AH R Z
BLATHERING	B L AH TH IY R AH NG
BLATHERS	B L AE TH AH R Z
BLATHERSKITE	B L AE TH AH R S AY T
BLATHERSKITES	B L AE TH AH R S AY T S
BLETHER	B L EH DH AH R
BLETHERED	B L AH TH IY R D
BLETHERING	B L AH TH IY R AH NG
BLETHERS	B L EH TH AH R Z
BLITHE	B L AY DH
BLITHELY	B L AY TH L IY
BLITHER	B L AY TH ER
BLITHERED	B L AY TH ER D
BLITHERING	B L AY TH ER IH NG
BLITHERS	B L AY TH ER Z
BLITHESOME	B L AY TH S AH M
BLITHESOMELY	B L AY TH S AH M L IY
BLITHEST	B L AY TH AH S T
BLOODBATH	B L AH D B AE TH
BLOODBATHS	B L AH D B AE TH S
BLOODTHIRSTILY	B L AH D TH ER S T IY L IY
BLOODTHIRSTINESS	B L AH D TH ER S T IY N AH S
BLOODTHIRSTINESSES	B L AH D TH ER S T IY N AH S IH Z
BLOODTHIRSTY	B L AH D TH ER S T IY
BOATHOOK	B OW T HH UH K
BOATHOOKS	B OW T HH UH K S
BOATHOUSE	B OW T HH AW S
BOATHOUSES	B OW AH TH AH S IH Z
BOLTHEAD	B OW L T HH EH D
BOLTHEADS	B OW L T HH EH D Z
BOLTHOLE	B OW L T HH OW L
BOLTHOLES	B OW L T HH OW L Z
BOOTH	B UW TH
BOOTHS	B UW TH S
BOTH	B OW TH
BOTHER	B AA DH ER
BOTHERATION	B AA DH ER EY SH AH N
BOTHERATIONS	B AA DH ER EY SH AH N Z
BOTHERED	B AA DH ER D
BOTHERING	B AA DH ER IH NG
BOTHERS	B AA DH ER Z
BOTHERSOME	B AA DH ER S AH M
BOTHIES	B AH TH AY Z
BOTHRIA	B AA TH R IY AH
BOTHRIUM	B AA TH R IY AH M
BOTHRIUMS	B AA TH R IY AH M Z
BOTHY	B AA TH IY
BOXTHORN	B AA K S TH AO R N
BOXTHORNS	B AA K S TH AO R N Z
BREADTH	B R EH D TH
BREADTHS	B R EH D TH S
BREADTHWISE	B R EH D TH W AY Z
BREAKTHROUGH	B R EY K TH R UW
BREAKTHROUGHS	B R EY K TH R UW Z
BREATH	B R EH TH
BREATHABILITIES	B R IY DH AH B IH L AH T EH Z
BREATHABILITY	B R IY DH AH B IH L AH T EH
BREATHABLE	B R IY DH AH B AH L
BREATHE	B R IY DH
BREATHED	B R IY DH D
BREATHER	B R IY DH ER
BREATHERS	B R IY DH ER Z
BREATHES	B R IY DH Z
BREATHIER	B R EH TH IY ER
BREATHIEST	B R EH TH IY AH S T
BREATHILY	B R EH TH IY L IY
BREATHINESS	B R EH TH IY N AH S
BREATHINESSES	B R EH TH IY N AH S IH Z
BREATHING	B R IY DH IH NG
BREATHINGS	B R IY DH IH NG Z
BREATHLESS	B R EH TH L AH S
BREATHLESSLY	B R EH TH L AH S L IY
BREATHLESSNESS	B R EH TH L AH S N AH S
BREATHLESSNESSES	B R EH TH L AH S N AH S IH Z
BREATHS	B R EH TH S
BREATHTAKING	B R EH TH T EY K IH NG
BREATHTAKINGLY	B R EH TH T EY K IH NG L IY
BREATHY	B R EH TH IY
BREECHCLOTH	B R IY CH K L AO TH
BREECHCLOTHS	B R IY CH K L AO TH S
BRETHREN	B R EH DH R AH N
BROADCLOTH	B R AO D K L AO TH
BROADCLOTHS	B R AO D K L AO TH S
BROTH	B R AO TH
BROTHEL	B R AA TH AH L
BROTHELS	B R AA TH AH L Z
BROTHER	B R AH DH ER
BROTHERED	B R AH DH ER D
BROTHERHOOD	B R AH DH ER HH UH D
BROTHERHOODS	B R AH DH ER HH UH D Z
BROTHERING	B R AH DH ER IH NG
BROTHERLINESS	B R AH DH ER L IY N AH S
BROTHERLINESSES	B R AH DH ER L IY N AH S IH Z
BROTHERLY	B R AH DH ER L IY
BROTHERS	B R AH DH ER Z
BROTHS	B R AO TH S
BROTHY	B R AO TH IY
BUCKTEETH	B AH K T IY TH
BUCKTHORN	B AH K TH AO R N
BUCKTHORNS	B AH K TH AO R N Z
BUCKTOOTH	B AH K T UW TH
BUCKTOOTHED	B AH K T UW TH T
BURTHEN	B AH R TH AH N
BURTHENED	B AH R TH IY N D
BURTHENING	B AH R TH IY N AH NG
BURTHENS	B AH R TH AH N Z
BYPATH	B AY P AE TH
BYPATHS	B AY P AE TH S
CACOETHES	K AE K OW AH DH Z
CALATHI	K AE L AH TH IY
CALATHOS	K AE L AH TH AH Z
CALATHUS	K AE L AH TH AH S
CALISTHENIC	K AE L AH S TH EH N IH K
CALISTHENICS	K AE L AH S TH EH N IH K S
CALLITHUMP	K AE L AH TH AH M P
CALLITHUMPIAN	K AE L AH TH AH M P IY AH N
CALLITHUMPS	K AE L AH TH AH M P S
CALTHROP	K AE L TH R AH P
CALTHROPS	K AE L TH R AH P S
CANTHAL	K AE N TH AH L
CANTHARIDES	K AE N TH AH R AY D Z
CANTHARIDIN	K AE N TH ER AH D IH N
CANTHARIDINS	K AE N TH ER AH D IH N Z
CANTHARIS	K AE N TH EH R IY Z
CANTHAXANTHIN	K AE N TH AH K S AE N TH AH N
CANTHAXANTHINS	K AE N TH AH K S AE N TH AH N Z
CANTHI	K AE N TH IY
CANTHUS	K AE N DH AH S
CARBOXYMETHYLCELLULOSE	K AA R B AA K S IY M EH TH AH L S EH L Y AH L OW S
CARBOXYMETHYLCELLULOSES	K AA R B AA K S IY M EH TH AH L S EH L Y AH L OW S IH
CARDIOMYOPATHIES	K AA R D IY AH M AY AA P AH TH AY Z
CARDIOMYOPATHY	K AA R D IY AH M AY AA P AH TH IY
CARDIOPATHIES	K AA R D IY AA P AH TH AY Z
CARDIOPATHY	K AA R D IY AA P AH TH IY
CARDIOTHORACIC	K AA R D IY AA TH AH R AH S AH K
CATHARSES	K AH TH AA R S AH Z
CATHARSIS	K AH TH AA R S AH S
CATHARTIC	K AH TH AA R T IH K
CATHARTICS	K AE T HH AA R T IH K S
CATHEAD	K AE T HH EH D
CATHEADS	K AE T HH EH D Z
CATHECT	K AE TH AH K T
CATHECTED	K AH TH EH K T AH D
CATHECTIC	K AE T HH EH K T IH K
CATHECTING	K AH TH EH K T AH NG
CATHECTS	K AE TH AH K T S
CATHEDRA	K AH TH EH D R AH
CATHEDRAE	K AH TH EH D R IY
CATHEDRAL	K AH TH IY D R AH L
CATHEDRALS	K AH TH IY D R AH L Z
CATHEDRAS	K AH TH EH D R AH Z
CATHEPSIN	K AH TH EH P S AH N
CATHEPSINS	K AH TH EH P S AH N Z
CATHETER	K AE TH AH T ER
CATHETERIZATION	K AE TH AH T ER AH Z EY SH AH N
CATHETERIZATIONS	K AE TH AH T ER AH Z EY SH AH N Z
CATHETERIZE	K AE TH AH T ER AY Z
CATHETERIZED	K AE TH AH T ER AY Z D
CATHETERIZES	K AE TH AH T ER AY Z IH Z
CATHETERIZING	K AE TH AH T ER AY Z IH NG
CATHETERS	K AE TH AH T ER Z
CATHEXES	K AE T HH EH K S IH Z
CATHEXIS	K AE T HH EH K S IY Z
CATHODAL	K AE TH OW D AH L
CATHODALLY	K AE TH OW D AH L IY
CATHODE	K AE TH OW D
CATHODES	K AE TH OW D Z
CATHODIC	K AE TH OW D IH K
CATHODICALLY	K AE TH OW D IH K AH L IY
CATHOLIC	K AE TH L IH K
CATHOLICALLY	K AE TH L IH K AH L IY
CATHOLICATE	K AE TH L IH K AH T
CATHOLICATES	K AE TH L IH K AH T S
CATHOLICITIES	K AE TH L IH K AH T IY Z
CATHOLICITY	K AE TH L IH K AH T IY
CATHOLICIZE	K AE TH L IH K AY Z
CATHOLICIZED	K AE TH L IH K AY Z D
CATHOLICIZES	K AE TH L IH K AY Z IH Z
CATHOLICIZING	K AE TH L IH K AY Z IH NG
CATHOLICOI	K AH TH AA L AH K OY
CATHOLICON	K AE TH L IH K AO N
CATHOLICONS	K AE TH L IH K AO N Z
CATHOLICOS	K AE TH L IH K AA S
CATHOLICOSES	K AE TH L IH K AA S IH Z
CATHOLICS	K AE TH L IH K S
CATHOUSE	K AE T HH AW S
CATHOUSES	K AE T HH AW S IH Z
CEANOTHUS	S IY N AH TH AH S
CEANOTHUSES	S IY N AH TH UW Z AH Z
CEPHALOTHIN	S AH F AE L AH TH AH N
CEPHALOTHINS	S AH F AE L AH TH AH N Z
CEPHALOTHORACES	S EH F AH L AH TH AO R AH S AH Z
CEPHALOTHORAX	S EH F AH L AA TH AH R AH K S
CEPHALOTHORAXES	S EH F AH L AA TH AH R AH K S
CERECLOTH	S AH R EH K L AH TH
CERECLOTHS	S AH R EH K L AH TH S
CHAETOGNATH	CH IY T AA G N AH TH
CHAETOGNATHS	CH IY T AA G N AH TH S
CHALLOTH	CH AE L AH TH
CHALOTH	CH AE L AH TH
CHEESECLOTH	CH IY Z K L AO TH
CHEESECLOTHS	CH IY Z K L AO TH S
CHEMOSYNTHESES	K AH M AA S AH N TH IY Z AH Z
CHEMOSYNTHESIS	K EH M AH S IH N DH AH S AH S
CHEMOSYNTHETIC	K EH M AH S IH N TH AH T AH K
CHEMOTHERAPEUTIC	K EH M AH TH AH R EY P AH Y UW T AH K
CHEMOTHERAPEUTICALLY	K AH M AA TH AH R EY P Y UW T AH K AE L IY
CHEMOTHERAPEUTICS	K EH M AH TH AH R EY P AH Y UW T AH S Z
CHEMOTHERAPIES	K EH M AH TH EH R AH P AY Z
CHEMOTHERAPIST	K EH M AH TH EH R AH P AH S T
CHEMOTHERAPISTS	K EH M AH TH EH R AH P AH S T S
CHEMOTHERAPY	K IY M OW TH EH R AH P IY
CHETH	CH EH TH
CHETHS	CH EH TH S
CHILDBIRTH	CH AY L D B ER TH
CHILDBIRTHS	CH AY L D B ER TH S
CHLOROFLUOROMETHANE	K L AH R AH F L AH W AH R AA M AH TH EY N
CHLOROFLUOROMETHANES	K L AH R AH F L AH W AH R AA M AH TH EY N Z
CHLOROTHIAZIDE	K L AH R AA TH IY AH Z AY D
CHLOROTHIAZIDES	K L AH R AA TH IY AH Z AY D Z
CHOLELITHIASES	CH AH L AH L IH TH IY EY Z AH Z
CHOLELITHIASIS	CH AA L AH L AH TH IY AH S AH S
CHRESTOMATHIES	K R EH S T AA M AH TH AY Z
CHRESTOMATHY	K R EH S T AA M AH TH IY
CHROMOLITHOGRAPH	K R AA M AH L AH TH AA G R AH F
CHROMOLITHOGRAPHED	K R AA M AH L AH TH AA G R AH F T
CHROMOLITHOGRAPHER	K R AA M AH L AH TH AA G R AH F AH R
CHROMOLITHOGRAPHERS	K R AA M AH L AH TH AA G R AH F AH R Z
CHROMOLITHOGRAPHIC	K R AA M AH L AH TH AA G R AH F AH K
CHROMOLITHOGRAPHIES	K R AA M AH L AH TH AA G R AH F AY Z
CHROMOLITHOGRAPHING	K R AA M AH L AH TH AA G R AH F AH NG
CHROMOLITHOGRAPHS	K R AA M AH L AH TH AA G R AH F S
CHROMOLITHOGRAPHY	K R AA M AH L AH TH AA G R AH F IY
CHRONOTHERAPIES	K R AA N AH TH EH R AH P AY Z
CHRONOTHERAPY	K R AA N AH TH EH R AH P IY
CHRYSANTHEMUM	K R IH S AE N TH AH M AH M
CHRYSANTHEMUMS	K R IH S AE N TH AH M AH M Z
CHTHONIAN	CH TH OW N IY AH N
CHTHONIC	CH TH AA N AH K
CINEMATHEQUE	S AH N EH M AH TH AH K
CINEMATHEQUES	S AH N EH M AH TH AH K S
CITHARA	S IH TH AH R AH
CITHARAS	S IH TH AH R AH Z
CITHER	S IH DH AH R
CITHERN	S IH TH AH R N
CITHERNS	S IH TH AH R N Z
CITHERS	S IH TH AH R Z
CITHREN	S IH TH R AH N
CITHRENS	S IH TH R AH N Z
CLATHRATE	K L AE TH R EY T
CLATHRATES	K L AE TH R EY T S
CLINICOPATHOLOGIC	K L IH N AH K AH P AE TH AH L AH JH AH K
CLINICOPATHOLOGICAL	K L AH N IH K AH P AH TH AA L AH JH IH S AH L
CLINICOPATHOLOGICALLY	K L AH N AH K AA P AH TH AH L AA JH AH K AE L IY
CLOSEMOUTHED	K L OW Z M AW TH T
CLOTH	K L AO TH
CLOTHBOUND	K L AO TH B AW N D
CLOTHE	K L OW DH
CLOTHED	K L OW DH D
CLOTHES	K L OW DH Z
CLOTHES(2)	K L OW Z
CLOTHESHORSE	K L OW Z HH AO R S
CLOTHESHORSES	K L OW DH Z HH AO R S IH Z
CLOTHESLINE	K L OW DH Z L AY N
CLOTHESLINED	K L OW DH Z L AY N D
CLOTHESLINES	K L OW DH Z L AY N Z
CLOTHESLINING	K L OW DH Z L AY N IH NG
CLOTHESPIN	K L OW DH S P IH N
CLOTHESPINS	K L OW DH S P IH N Z
CLOTHESPRESS	K L OW DH Z P R EH S
CLOTHESPRESSES	K L OW DH Z P R EH S IH Z
CLOTHIER	K L OW DH Y ER
CLOTHIERS	K L OW DH Y ER Z
CLOTHING	K L OW DH IH NG
CLOTHINGS	K L OW DH IH NG Z
CLOTHS	K L AO TH S
COAUTHOR	K OW AA TH ER
COAUTHORED	K OW AA TH ER D
COAUTHORING	K OW AA TH ER IH NG
COAUTHORS	K OW AA TH ER Z
COAUTHORSHIP	K OW AO TH ER SH IH P
COAUTHORSHIPS	K OW AO TH ER SH IH P S
COELACANTH	S IY L AH K AE N TH
COELACANTHS	K OW EH L AH K AH N TH S
COLOCYNTH	K OW L AA S AH N TH
COLOCYNTHS	K OW L AA S AH N TH S
COLOGARITHM	K OW L AA G AH R IH DH AH M
COLOGARITHMS	K OW L AA G AH R IH DH AH M Z
COMETH	K AH M IH TH
COMETHER	K AH M IY TH ER
COMETHERS	K AH M IY TH ER Z
COMMONWEALTH	K AA M AH N W EH L TH
COMMONWEALTHS	K AA M AH N W EH L TH S
COOLTH	K UW L TH
COOLTHS	K UW L TH S
COPPERSMITH	K AA P ER S M IH TH
COPPERSMITHS	K AA P ER S M IH TH S
COTHURN	K OW TH AH R N
COTHURNI	K OW TH AH R N IY
COTHURNS	K OW TH AH R N Z
COTHURNUS	K OW TH AH R N AH S
COTTONMOUTH	K AA T AH N M AW TH
COTTONMOUTHS	K AA T AH N M AW TH S
COUNTERHYPOTHESES	K AW N T ER HH AY P AA TH AH S IY Z
COUNTERHYPOTHESIS	K AW N T ER HH AY P AA TH AH S AH S
COUNTERMYTH	K AW N T ER M IH TH
COUNTERMYTHS	K AW N T ER M IH TH S
COUNTERTHREAT	K AW N T ER TH R EH T
COUNTERTHREATS	K AW N T ER TH R EH T S
COUNTERTHRUST	K AW N T ER TH R AH S T
COUNTERTHRUSTS	K AW N T ER TH R AH S T S
COURTHOUSE	K AO R T HH AW S
COURTHOUSES	K AO R T HH AW S IH Z
COUTH	K OW AH TH
COUTHER	K OW AH DH AH R
COUTHEST	K OW AH DH AH S T
COUTHIE	K OW AH TH AY
COUTHIER	K OW AH TH AY AH R
COUTHIEST	K OW AH TH AY AH S T
COUTHS	K OW AH TH S
CRASHWORTHINESS	K R AE SH W ER DH IY N AH S
CRASHWORTHINESSES	K R AE SH W ER DH IY N AH S IH Z
CRASHWORTHY	K R AE SH W ER DH IY
CREDITWORTHINESS	K R EH D IH T W ER DH IY N AH S
CREDITWORTHINESSES	K R EH D AH T W ER DH IY N AH S IH Z
CREDITWORTHY	K R EH D IH T W ER DH IY
CRWTH	S IY AA R D AH B AH L Y UW T IY
CRWTHS	S IY AA R D AH B AH L Y UW T IY EY CH S
CRYOTHERAPIES	K R AY AH DH ER EY P IY Z
CRYOTHERAPY	K R AY AH DH ER EY P IY
CRYPTARITHM	K R IH P T AH R AH DH AH M
CRYPTARITHMS	K R IH P T AH R AH DH AH M Z
CUTTHROAT	K AH T TH R OW T
CUTTHROATS	K AH T TH R OW T S
CYANOETHYLATE	S AY AH N OW EH TH AH L EY T
CYANOETHYLATED	S AY AH N OW EH TH AH L EY T AH D
CYANOETHYLATES	S AY AH N OW EH TH AH L EY T S
CYANOETHYLATING	S AY AH N OW EH TH AH L EY T AH NG
CYANOETHYLATION	S AY AH N OW EH TH AH L EY SH AH N
CYANOETHYLATIONS	S AY AH N OW AH TH AH L EY T IY AH N Z
CYCLOTHYMIA	S IH K L AH TH IH M IY AH
CYCLOTHYMIAS	S IH K L AH TH IH M IY AH Z
CYCLOTHYMIC	S IH K L AH TH AH M AH K
CYSTOLITH	S IH S T AH L AH TH
CYSTOLITHS	S IH S T AH L AH TH S
CYTOPATHIC	S IH T AH P AH TH AH K
CYTOPATHOGENIC	S IH T AH P AE TH AH JH AH N AH K
CYTOPATHOGENICITIES	S AH T AH P AE TH AH JH AH N IH S AH T AY Z
CYTOPATHOGENICITY	S IH T AH P AH TH AA JH AH N IH S AH T IY
DALETH	D AA L EH TH
DALETHS	D EY L IH TH S
DEARTH	D ER TH
DEARTHS	D ER TH S
DEATH	D EH TH
DEATHBED	D EH TH B EH D
DEATHBEDS	D EH TH B EH D Z
DEATHBLOW	D EH TH B L OW
DEATHBLOWS	D EH TH B L OW Z
DEATHCUP	D EH TH K AH P
DEATHCUPS	D EH TH K AH P S
DEATHFUL	D EH TH F AH L
DEATHLESS	D EH TH L AH S
DEATHLESSLY	D EH TH L AH S L IY
DEATHLESSNESS	D EH TH L AH S N AH S
DEATHLESSNESSES	D EH TH L AH S N AH S IH Z
DEATHLIKE	D EH TH L AY K
DEATHLY	D EH TH L IY
DEATHS	D EH TH S
DEATHSMAN	D EH TH S M AE N
DEATHSMEN	D EH TH S M EH N
DEATHTRAP	D EH TH T R AE P
DEATHTRAPS	D EH TH T R AE P S
DEATHWATCH	D EH TH W AA CH
DEATHWATCHES	D EH TH W AA CH IH Z
DEATHY	D EH TH IY
DECAMETHONIUM	D AH K AE M AH TH OW N IY AH M
DECAMETHONIUMS	D AH K AE M AH TH OW N IY AH M Z
DECATHLETE	D IY K AE TH L IY T
DECATHLETES	D AH K AE TH L IY T S
DECATHLON	D IY K AE TH L AO N
DECATHLONS	D IH K AE TH L AH N Z
DEMYTHOLOGIZATION	D AH M AH TH AH L AH JH AH Z EY SH AH N
DEMYTHOLOGIZATIONS	D AH M AH TH AA L AH JH AH Z EY T IY AH N Z
DEMYTHOLOGIZE	D AH M AH TH AA L AH JH AY Z
DEMYTHOLOGIZED	D AH M AH TH AA L AH JH AY Z D
DEMYTHOLOGIZER	D AH M AH TH AA L AH JH AY Z AH R
DEMYTHOLOGIZERS	D AH M IH TH AH L AA JH AH Z AH R Z
DEMYTHOLOGIZES	D AH M AH TH AA L AH JH AY Z AH Z
DEMYTHOLOGIZING	D AH M AH TH AA L AH JH AY Z AH NG
DEPTH	D EH P TH
DEPTHLESS	D EH P TH L AH S
DEPTHS	D EH P TH S
DETHRONE	D IH TH R OW N
DETHRONE(2)	D IY TH R OW N
DETHRONED	D IH TH R OW N D
DETHRONED(2)	D IY TH R OW N D
DETHRONEMENT	D IY TH R OW N M AH N T
DETHRONEMENTS	D IY TH R OW N M AH N T S
DETHRONER	D IY TH R OW N ER
DETHRONERS	D IY TH R OW N ER Z
DETHRONES	D IY TH R OW N Z
DETHRONING	D IY TH R OW N IH NG
DEXAMETHASONE	D AH Z AH M EH TH AH S OW N
DEXAMETHASONES	D AH Z AH M EH TH AH S OW N Z
DIANTHUS	D AY AE N TH AH S
DIANTHUSES	D AY AH N TH UW Z AH Z
DIARTHROSES	D AY ER TH R OW Z IH Z
DIARTHROSIS	D AY ER TH R OW Z IY Z
DIATHERMANOUS	D AY AH TH AH R M AH N AH S
DIATHERMIC	D AY AH TH AH R M AH K
DIATHERMIES	D AY AH TH ER M IY Z
DIATHERMY	D AY AH TH ER M IY
DIATHESES	D AY AH TH IY Z AH Z
DIATHESIS	D AY AE TH AH S AH S
DIATHETIC	D AY AH TH AH T AH K
DICHLORODIFLUOROMETHANE	D IH K L AH R AH D AH F L AH W AH R AA M AH TH EY N
DICHLORODIFLUOROMETHANES	D IH K L AH R AH D AH F L AH W AH R AA M AH TH EY N Z
DICHLOROETHANE	D IH K L AO R OW AH TH EY N
DICHLOROETHANES	D IH K L AO R OW AH TH EY N Z
DIETHER	D AY IH TH ER
DIETHERS	D AY IH TH ER Z
DIETHYLCARBAMAZINE	D IY TH AH L K AA R B AE M AH Z AY N
DIETHYLCARBAMAZINES	D IY TH AH L K AA R B AE M AH Z AY N Z
DIETHYLSTILBESTROL	D AY EH TH AH L S T IH L D EH S T R AO L
DIETHYLSTILBESTROLS	D AY EH TH AH L S T IH L D EH S T R AO L Z
DIMETHOATE	D AH M EH TH OW EY T
DIMETHOATES	D AH M EH TH OW EY T S
DIMETHYL	D IH M EH TH AH L
DIMETHYLHYDRAZINE	D AH M AH TH AH L HH IH D R AH Z AY N
DIMETHYLHYDRAZINES	D AH M AH TH AH L HH IH D R AH Z AY N Z
DIMETHYLNITROSAMINE	D AH M AH TH AH L N IH T R AA S AH M AY N
DIMETHYLNITROSAMINES	D AH M AH TH AH L N IH T R AA S AH M AY N Z
DIMETHYLS	D IH M EH TH AH L Z
DIMETHYLTRYPTAMINE	D AH M AH TH AH L T R IH P T AH M AY N
DIMETHYLTRYPTAMINES	D AH M AH TH AH L T R IH P T AH M AY N Z
DIPHTHERIA	D IH F TH IH R IY AA
DIPHTHERIAL	D IH F TH IY R IY AH L
DIPHTHERIAS	D IH F TH IY R IY AH Z
DIPHTHERITIC	D IH F TH AH R AH T AH K
DIPHTHEROID	D IH F TH AH R OY D
DIPHTHEROIDS	D IH F TH AH R OY D Z
DIPHTHONG	D IH F TH AO NG
DIPHTHONGAL	D IH F TH AA N G AH L
DIPHTHONGIZATION	D IH F TH AA N JH AH Z EY SH AH N
DIPHTHONGIZATIONS	D IH F TH AA N JH AH Z EY T IY AH N Z
DIPHTHONGIZE	D IH F TH AH N JH AY Z
DIPHTHONGIZED	D IH F TH AH N JH AY Z D
DIPHTHONGIZES	D IH F TH AH N JH AY Z AH Z
DIPHTHONGIZING	D IH F TH AH N JH AY Z AH NG
DIPHTHONGS	D IH F TH AH NG Z
DISCOTHEQUE	D IH S K OW T EH K
DISCOTHEQUES	D IH S K OW T EH K S
DISENTHRAL	D IH S IH N TH R AO L
DISENTHRALL	D IH S AH N TH R AE L
DISENTHRALLED	D IH S IH N TH R AO L D
DISENTHRALLING	D IH S IH N TH R AO L IH NG
DISENTHRALLS	D IH S AH N TH R AE L Z
DISENTHRALS	D IH S IH N TH R AO L Z
DISHCLOTH	D IH SH K L AO TH
DISHCLOTHS	D IH SH K L AO TH S
DITHEISM	D AY DH IY IH Z AH M
DITHEISMS	D AH TH IY Z AH M Z
DITHEIST	D AY DH IY AH S T
DITHEISTS	D AH TH IY S T S
DITHER	D IH DH ER
DITHERED	D AH TH IY R D
DITHERER	D AH TH IY R AH R
DITHERERS	D IH TH AH R AH R Z
DITHERING	D IH DH ER IH NG
DITHERS	D IH DH ER Z
DITHERY	D AH DH EH R IY
DITHIOCARBAMATE	D IH TH IY AH K AA R B AH M EY T
DITHIOCARBAMATES	D IH TH IY AH K AA R B AH M EY T S
DITHIOL	D IH TH IY AH L
DITHYRAMB	D IH TH ER AE M
DITHYRAMBIC	D IH TH AH R AH M B AH K
DITHYRAMBICALLY	D IH TH AH R AE M B AH K AE L IY
DITHYRAMBS	D IH TH AH R AH M Z
DOETH	D OW IH TH
DOGTEETH	D AO G T IY TH
DOGTOOTH	D AO G T UW TH
DOTH	D AO TH
DOUBLETHINK	D AH B AH L TH IH NG K
DOUBLETHINKS	D AH B AH L TH IH NG K S
DOZENTH	D AH Z AH N TH
DOZENTHS	D AH Z AH N TH S
DROPCLOTH	D R AA P K L AO TH
DROPCLOTHS	D R AA P K L AO TH S
DROUTH	D R AW TH
DROUTHIER	D R AW TH IY ER
DROUTHIEST	D R AW TH IY AH S T
DROUTHS	D R AW TH S
DROUTHY	D R AW TH IY
DRUTHERS	D R AH DH ER Z
DRYOPITHECINE	D R AY AH P IH TH AH S AY N
DRYOPITHECINES	D R AY AH P IH TH AH S AY N Z
DUSTHEAP	D AH S T HH IY P
DUSTHEAPS	D AH S T HH IY P S
DYSARTHRIA	D AH S AA R TH R IY AH
DYSARTHRIAS	D AH S AA R TH R IY AH Z
DYSRHYTHMIA	D IH Z R IH TH M IY AH
DYSRHYTHMIAS	D IH Z R IH TH M IY AH Z
DYSRHYTHMIC	D IH Z R AH TH M AH K
EARTH	ER TH
EARTHBORN	ER TH B AO R N
EARTHBOUND	ER TH B AW N D
EARTHED	ER TH T
EARTHEN	ER TH AH N
EARTHENWARE	ER TH AH N W EH R
EARTHENWARES	ER TH AH N W EH R Z
EARTHIER	ER TH IY ER
EARTHIEST	ER TH IY AH S T
EARTHILY	ER TH IY L IY
EARTHINESS	ER TH IY N AH S
EARTHINESSES	ER TH IY N AH S IH Z
EARTHING	ER TH IH NG
EARTHLIER	ER TH L IY ER
EARTHLIEST	ER TH L IY AH S T
EARTHLIGHT	ER TH L AY T
EARTHLIGHTS	ER TH L AY T S
EARTHLIKE	ER TH L AY K
EARTHLINESS	ER TH L IY N AH S
EARTHLINESSES	ER TH L IY N AH S IH Z
EARTHLING	ER TH L IH NG
EARTHLINGS	ER TH L IH NG Z
EARTHLY	ER TH L IY
EARTHMAN	ER TH M AE N
EARTHMEN	ER TH M EH N
EARTHMOVER	ER TH M UW V ER
EARTHMOVERS	ER TH M UW V ER Z
EARTHMOVING	ER TH M UW V IH NG
EARTHMOVINGS	ER TH M UW V IH NG Z
EARTHNUT	ER TH N AH T
EARTHNUTS	ER TH N AH T S
EARTHPEA	ER TH P IY
EARTHPEAS	ER TH P IY Z
EARTHQUAKE	ER TH K W EY K
EARTHQUAKES	ER TH K W EY K S
EARTHRISE	ER TH R AY Z
EARTHRISES	ER TH R IY Z IH Z
EARTHS	ER TH S
EARTHSET	ER TH S EH T
EARTHSETS	ER TH S EH T S
EARTHSHAKER	ER TH SH EY K ER
EARTHSHAKERS	ER TH SH EY K ER Z
EARTHSHAKING	ER TH SH EY K IH NG
EARTHSHAKINGLY	ER TH SH EY K IH NG L IY
EARTHSHINE	ER TH SH AY N
EARTHSHINES	ER TH SH AY N Z
EARTHSTAR	ER TH S T AA R
EARTHSTARS	ER TH S T AA R Z
EARTHWARD	ER TH W ER D
EARTHWARDS	ER TH W ER D Z
EARTHWORK	ER TH W ER K
EARTHWORKS	ER TH W ER K S
EARTHWORM	ER TH W ER M
EARTHWORMS	ER TH W ER M Z
EARTHY	ER TH IY
EATH	IY TH
ECTHYMA	EH K TH AH M AH
ECTHYMATA	EH K TH IH M AH T AH
ECTOTHERM	EH K T AH TH AH R M
ECTOTHERMIC	EH K T AH TH AH R M AH K
ECTOTHERMS	EH K T AH TH AH R M Z
EIGHTEENTH	EY T IY N TH
EIGHTEENTHS	EY T IY N TH S
EIGHTH	EY T TH
EIGHTH(2)	EY TH
EIGHTHLY	EY T TH L IY
EIGHTHS	EY T TH S
EIGHTIETH	EY T IY IH TH
EIGHTIETHS	EY T IY IH TH S
EITHER	IY DH ER
EITHER(2)	AY DH ER
ELECTROTHERAPIES	AH L EH K T R AH TH EH R AH P AY Z
ELECTROTHERAPY	AH L EH K T R AH TH EH R AH P IY
ELECTROTHERMAL	AH L EH K T R AH TH AH R M AH L
ELECTROTHERMALLY	AH L EH K T R AH TH AH R M AE L IY
ELEVENTH	IH L EH V AH N TH
ELEVENTH(2)	IY L EH V AH N TH
ELEVENTHS	IH L EH V AH N TH S
EMPATHETIC	EH M P AH TH EH T IH K
EMPATHETICALLY	IH M P AH TH EH T IH K AH L IY
EMPATHIC	IH M P AE TH IH K
EMPATHICALLY	IH M P AE TH IH K AH L IY
EMPATHIES	EH M P AH TH IY Z
EMPATHISE	IH M P AH TH AY Z
EMPATHISED	EH M P AH TH IY Z D
EMPATHISES	EH M P AH TH IY Z IH Z
EMPATHISING	EH M P AH TH IY Z IH NG
EMPATHIZE	EH M P AH TH AY Z
EMPATHIZED	IH M P AE TH AY Z D
EMPATHIZES	IH M P AE TH AY Z IH Z
EMPATHIZING	IH M P AE TH AY Z IH NG
EMPATHY	EH M P AH TH IY
ENCEPHALOPATHIC	IH N S AH F AE L AH P AH TH AH K
ENCEPHALOPATHIES	IH N S AH F AH L AA P AH TH AY Z
ENCEPHALOPATHY	EH N S EH F AH L AO P AH TH IY
ENDOLITHIC	EH N D UW L IY TH IH K
ENDOTHECIA	IH N D AH TH IY SH IY AH
ENDOTHECIUM	IH N D AH TH IY S IY AH M
ENDOTHELIA	IH N D AH TH IY L Y AH
ENDOTHELIAL	EH N D OW TH IY L IY AH L
ENDOTHELIOMA	IH N D AA TH AH L IY AH M AH
ENDOTHELIOMAS	IH N D AA TH AH L IY AH M AH Z
ENDOTHELIOMATA	IH N D AH TH IY L IY AA M AH T AH
ENDOTHELIUM	EH N D AA T HH IY L IY AH M
ENDOTHERM	EH N D UW TH ER M
ENDOTHERMIC	EH N D OW TH ER M IH K
ENDOTHERMIES	EH N D UW TH ER M IY Z
ENDOTHERMS	EH N D UW TH ER M Z
ENDOTHERMY	EH N D UW TH ER M IY
ENSHEATH	EH N SH IY TH
ENSHEATHE	EH N SH IY DH
ENSHEATHED	EH N SH IY DH D
ENSHEATHES	EH N SH IY DH Z
ENSHEATHING	EH N SH IY DH IH NG
ENSHEATHS	EH N SH IY TH S
ENSWATHE	IH N S W EY DH
ENSWATHED	EH N S W AA TH T
ENSWATHES	EH N S W AA TH S
ENSWATHING	EH N S W AA TH IH NG
ENTEROPATHIES	IH N T AH R AA P AH TH AY Z
ENTEROPATHOGENIC	IH N T EH R AH P AE TH AH JH AH N AH K
ENTEROPATHY	IH N T AH R AA P AH TH IY
ENTHALPIES	EH N TH AE L P IY Z
ENTHALPY	EH N TH AE L P IY
ENTHETIC	IH N TH IY T AH K
ENTHRAL	EH N TH R AO L
ENTHRALL	IH N TH R AE L
ENTHRALLED	EH N TH R AO L D
ENTHRALLING	IH N TH R AO L IH NG
ENTHRALLMENT	IH N TH R AE L M AH N T
ENTHRALLMENTS	IH N TH R AE L M AH N T S
ENTHRALLS	IH N TH R AE L Z
ENTHRALS	IH N TH R AO L Z
ENTHRONE	EH N TH R OW N
ENTHRONED	EH N TH R OW N D
ENTHRONEMENT	EH N TH R OW N M AH N T
ENTHRONEMENTS	EH N TH R OW N M AH N T S
ENTHRONES	EH N TH R OW N Z
ENTHRONING	EH N TH R OW N IH NG
ENTHUSE	IH N TH UW Z
ENTHUSED	IH N TH UW Z D
ENTHUSES	EH N DH AH S IH Z
ENTHUSIASM	IH N TH UW Z IY AE Z AH M
ENTHUSIASMS	IH N TH UW Z IY AE Z AH M Z
ENTHUSIAST	EH N TH UW Z IY AE S T
ENTHUSIASTIC	IH N TH UW Z IY AE S T IH K
ENTHUSIASTICALLY	IH N TH UW Z IY AE S T IH K L IY
ENTHUSIASTS	EH N TH UW Z IY AE S T S
ENTHUSING	EH N DH AH S IH NG
ENTHYMEME	IH N TH AH M IY M
ENTHYMEMES	IH N TH AH M IY M Z
ENWREATHE	EH N R IY DH
ENWREATHED	EH N R IY DH D
ENWREATHES	EH N R IY DH Z
ENWREATHING	EH N R IY DH IH NG
EOLITH	IY AH L AH TH
EOLITHIC	IY AH L AH TH AH K
EOLITHS	IY AH L AH TH S
EPENTHESES	EH P AH N TH IY Z AH Z
EPENTHESIS	AH P EH N DH AH S AH S
EPENTHETIC	AH P EH N TH AH T AH K
EPITHALAMIA	EH P AH TH AH L EY M IY AH
EPITHALAMIC	AH P IH TH AH L AH M AH K
EPITHALAMION	AH P IH TH AH L EY M IY AH N
EPITHALAMIUM	EH P AH TH AH L EY M IY AH M
EPITHALAMIUMS	EH P AH TH AH L EY M IY AH M Z
EPITHELIA	EH P AH TH IY L Y AH
EPITHELIAL	EH P IH TH EH L Y AH L
EPITHELIALIZATION	EH P AH TH AH L IY AH L AH Z EY SH AH N
EPITHELIALIZATIONS	AH P AH TH AH L IY AH L AH Z EY T IY AH N Z
EPITHELIALIZE	EH P AH TH IY L IY AH L AY Z
EPITHELIALIZED	EH P AH TH IY L IY AH L AY Z D
EPITHELIALIZES	EH P AH TH IY L IY AH L AY Z AH Z
EPITHELIALIZING	EH P AH TH IY L IY AH L AY Z AH NG
EPITHELIOID	EH P AH TH EH L AY OY D
EPITHELIOMA	EH P AH TH AH L IY AH M AH
EPITHELIOMAS	EH P AH TH AH L IY AH M AH Z
EPITHELIOMATA	AH P AH TH IY L IY AA M AH T AH
EPITHELIOMATOUS	EH P AH TH AH L IY AA M AH T AH S
EPITHELIUM	EH P AH TH IY L IY AH M
EPITHELIUMS	EH P AH TH IY L IY AH M Z
EPITHELIZATION	EH P AH TH AH L AH Z EY SH AH N
EPITHELIZATIONS	AH P IH TH AH L AH Z EY T IY AH N Z
EPITHELIZE	AH P IH TH AH L AY Z
EPITHELIZED	AH P IH TH AH L AY Z D
EPITHELIZES	AH P IH TH AH L AY Z AH Z
EPITHELIZING	AH P IH TH AH L AY Z AH NG
EPITHET	EH P AH TH EH T
EPITHETIC	EH P AH TH EH T IH K
EPITHETICAL	EH P AH TH EH T IH K AH L
EPITHETS	EH P AH TH EH T S
ERETHIC	EH R AH TH AH K
ERETHISM	EH R AH TH IH Z AH M
ERETHISMS	EH R AH TH AH Z AH M Z
ERYTHEMA	AH R IH TH AH M AH
ERYTHEMAS	AH R IH TH AH M AH Z
ERYTHEMATOUS	EH R AH TH EH M AH T AH S
ERYTHORBATE	AH R IH TH AH R B EY T
ERYTHORBATES	AH R IH TH AH R B EY T S
ERYTHREMIA	EH R AH TH R IY M IY AH
ERYTHREMIAS	EH R AH TH R IY M IY AH Z
ERYTHRISM	EH R AH TH R IH Z AH M
ERYTHRISMAL	AH R IH TH R IH Z M AH L
ERYTHRISMS	AH R IH TH R AH Z AH M Z
ERYTHRISTIC	AH R IH TH R AH S T AH K
ERYTHRITE	EH R AH TH R AY T
ERYTHRITES	EH R AH TH R AY T S
ERYTHROBLAST	EH R AH TH R AA B L AH S T
ERYTHROBLASTIC	EH R AH TH R AA B L AH S T AH K
ERYTHROBLASTOSES	AH R AH TH R AA B L AH S T OW Z AH Z
ERYTHROBLASTOSIS	EH R AH TH R AA B L AH S T OW S AH S
ERYTHROBLASTS	EH R AH TH R AA B L AH S T S
ERYTHROCYTE	AH R IH TH R AH S AY T
ERYTHROCYTES	AH R IH TH R AH S AY T S
ERYTHROCYTIC	AH R IH TH R AH S AH T AH K
ERYTHROID	EH R AH TH R OY D
ERYTHROMYCIN	EH R AH TH R AA M AH S AH N
ERYTHROMYCINS	EH R AH TH R AA M AH S AH N Z
ERYTHRON	AH R IH TH R AH N
ERYTHRONS	AH R IH TH R AH N Z
ERYTHROPOIESES	AH R IH TH R AA P OY IY Z AH Z
ERYTHROPOIESIS	AH R IH TH R AH P OY AH S AH S
ERYTHROPOIETIC	EH R AH TH R AA P OY AH T AH K
ERYTHROPOIETIN	EH R IH TH R AH P OY T IH N
ERYTHROPOIETINS	AH R IH TH R AH P OY AH T AH N Z
ERYTHROSIN	AH R IH TH R AH S AH N
ERYTHROSINE	AH R IH TH R AH S AY N
ERYTHROSINES	AH R IH TH R AH S AY N Z
ERYTHROSINS	AH R IH TH R AH S AH N Z
ESTHESES	EH S TH IY Z AH Z
ESTHESIA	EH S TH IY ZH IY AH
ESTHESIAS	EH S TH IY S IY AH Z
ESTHESIS	EH S DH AH S AH S
ESTHESISES	EH S TH AH S AY Z AH Z
ESTHETE	EH S TH IY T
ESTHETES	EH S TH IY T S
ESTHETIC	EH S TH EH T IH K
ESTHETICIAN	EH S TH AH T IH S IY AH N
ESTHETICIANS	EH S TH AH T IH S IY AH N Z
ESTHETICISM	EH S TH EH T IH K IH Z AH M
ESTHETICISMS	EH S TH EH T IH K IH Z AH M Z
ESTHETICS	EH S TH EH T IH K S
ETH	EH TH
ETHAMBUTOL	EH TH AH M B Y UW T AH L
ETHAMBUTOLS	EH TH AH M B Y UW T AH L Z
ETHANE	EH TH EY N
ETHANES	AH TH EY N Z
ETHANOL	EH TH AH N AO L
ETHANOLAMINE	EH TH AH N AO L AH M AY N
ETHANOLAMINES	EH TH AH N AO L AH M AY N Z
ETHANOLS	EH TH AH N AO L Z
ETHENE	EH TH IY N
ETHENES	AH TH IY N Z
ETHEPHON	EH TH AH F AH N
ETHEPHONS	EH TH AH F AH N Z
ETHER	IY TH ER
ETHEREAL	IH TH IH R IY AH L
ETHEREALITIES	IH TH IH R IY AH L AH T IY Z
ETHEREALITY	IH TH IH R IY AH L AH T IY
ETHEREALIZATION	IH TH IH R IY AH L AH Z EY SH AH N
ETHEREALIZATIONS	IH TH IH R IY AH L AH Z EY SH AH N Z
ETHEREALIZE	IH TH IH R IY AH L AY Z
ETHEREALIZED	IH TH IH R IY AH L AY Z D
ETHEREALIZES	IH TH IH R IY AH L AY Z IH Z
ETHEREALIZING	IH TH IH R IY AH L AY Z IH NG
ETHEREALLY	IH TH IH R IY AH L IY
ETHEREALNESS	IH TH IH R IY AH L N AH S
ETHEREALNESSES	IH TH IH R IY AH L N AH S IH Z
ETHERIC	IY TH ER IH K
ETHERIFIED	IY TH ER AH F AY D
ETHERIFIES	IY TH ER AH F AY Z
ETHERIFY	IY TH ER AH F AY
ETHERIFYING	IY TH ER AH F AY IH NG
ETHERISH	IY TH ER IH SH
ETHERIZATION	IY TH ER AH Z EY SH AH N
ETHERIZATIONS	IY TH ER AH Z EY SH AH N Z
ETHERIZE	IY TH ER AY Z
ETHERIZED	IY TH ER AY Z D
ETHERIZER	IY TH ER AY Z ER
ETHERIZERS	IY TH ER AY Z ER Z
ETHERIZES	IY TH ER AY Z IH Z
ETHERIZING	IY TH ER AY Z IH NG
ETHERS	IY TH ER Z
ETHIC	EH TH IH K
ETHICAL	EH TH IH K AH L
ETHICALITIES	EH TH IH K AH L AH T IY Z
ETHICALITY	EH TH IH K AH L AH T IY
ETHICALLY	EH TH IH K AH L IY
ETHICALNESS	EH TH IH K AH L N AH S
ETHICALNESSES	EH TH IH K AH L N AH S IH Z
ETHICALS	EH TH IH K AH L Z
ETHICIAN	AH TH IH S IY AH N
ETHICIANS	AH TH IH S IY AH N Z
ETHICIST	EH TH IH S IH S T
ETHICISTS	EH TH IH S IH S T S
ETHICIZE	EH TH IH K AY Z
ETHICIZED	EH TH IH K AY Z D
ETHICIZES	EH TH IH K AY Z IH Z
ETHICIZING	EH TH IH K AY Z IH NG
ETHICS	EH TH IH K S
ETHINYL	EH TH AH N AH L
ETHINYLS	EH TH AH N AH L Z
ETHION	EH TH IY AH N
ETHIONAMIDE	AH TH IY AA N AH M AY D
ETHIONAMIDES	AH TH IY AA N AH M AY D Z
ETHIONINE	EH TH IY AH N AY N
ETHIONINES	EH TH IY AH N AY N Z
ETHIONS	EH TH IY AH N Z
ETHMOID	EH TH M OY D
ETHMOIDAL	EH TH M OY D AH L
ETHMOIDS	EH TH M OY D Z
ETHNARCH	EH TH N AH R K
ETHNARCHS	EH TH N AH R K S
ETHNIC	EH TH N IH K
ETHNICAL	EH TH N IH K AH L
ETHNICALLY	EH TH N IH K L IY
ETHNICITIES	EH TH N IH K AH T IY Z
ETHNICITY	EH TH N IH S IH T IY
ETHNICS	EH TH N IH K S
ETHNOBOTANICAL	EH TH N AH B AA T AH N IH S AH L
ETHNOBOTANIES	EH TH N AH B AA T AH N AY Z
ETHNOBOTANIST	EH TH N AH B AA T AH N AH S T
ETHNOBOTANISTS	EH TH N AH B AA T AH N AH S T S
ETHNOBOTANY	EH TH N AH B AA T AH N IY
ETHNOCENTRIC	EH TH N OW S EH N T R IH K
ETHNOCENTRICITIES	EH TH N AH S EH N T R IH S AH T AY Z
ETHNOCENTRICITY	EH TH N AH S EH N T R IH S AH T IY
ETHNOCENTRISM	EH TH N OW S EH N T R IH Z AH M
ETHNOCENTRISMS	EH TH N AH S EH N T R AH Z AH M Z
ETHNOGRAPHER	EH TH N AA G R AH F AH R
ETHNOGRAPHERS	EH TH N AA G R AH F AH R Z
ETHNOGRAPHIC	EH TH N AH G R AE F IH K
ETHNOGRAPHICAL	EH TH N AA G R AH F IH S AH L
ETHNOGRAPHICALLY	EH TH N AA G R AE F AH K AE L IY
ETHNOGRAPHIES	EH TH N AA G R AH F AY Z
ETHNOGRAPHY	EH TH N AA G R AH F IY
ETHNOHISTORIAN	EH TH N AH HH IH S T AO R IY AH N
ETHNOHISTORIANS	EH TH N AH HH AH S T AO R IY AH N Z
ETHNOHISTORIC	EH TH N AH HH IH S T AH R AH K
ETHNOHISTORICAL	EH TH N AH HH IH S T AH R IH S AH L
ETHNOHISTORIES	EH TH N AH HH IH S T AH R AY Z
ETHNOHISTORY	EH TH N AH HH AH S T AO R IY
ETHNOLOGIC	EH TH N AH L AH JH AH K
ETHNOLOGICAL	EH TH N AA L AH JH IH S AH L
ETHNOLOGIES	EH TH N AA L AH JH AY Z
ETHNOLOGIST	EH TH N AA L AH JH AH S T
ETHNOLOGISTS	EH TH N AA L AH JH AH S T S
ETHNOLOGY	EH TH N AA L AH JH IY
ETHNOMETHODOLOGIES	EH TH N AA M AH TH AH D AA L AH JH AY Z
ETHNOMETHODOLOGIST	EH TH N AA M AH TH AH D AA L AH JH AH S T
ETHNOMETHODOLOGISTS	EH TH N AA M AH TH AH D AA L AH JH AH S T S
ETHNOMETHODOLOGY	EH TH N AA M AH TH AH D AA L AH JH IY
ETHNOMUSICOLOGICAL	EH TH N AA M Y AH S AH K AA L AH JH IH S AH L
ETHNOMUSICOLOGIES	EH TH N AH M Y AH S AH K AA L AH JH AY Z
ETHNOMUSICOLOGIST	EH TH N AH M Y UW Z AH K AA L AH JH IH S T
ETHNOMUSICOLOGISTS	EH TH N AH M Y UW S AH K AA L AH JH AH S T S
ETHNOMUSICOLOGY	EH TH N AA M Y AH S AH K AA L AH JH IY
ETHNOS	EH TH N OW S
ETHNOSCIENCE	EH TH N AH SH AH N S
ETHNOSCIENCES	EH TH N AH SH AH N S AH Z
ETHNOSES	EH TH N OW Z AH Z
ETHOLOGICAL	AH TH AA L AH JH IH S AH L
ETHOLOGIES	AH TH AA L AH JH AY Z
ETHOLOGIST	AH TH AA L AH JH AH S T
ETHOLOGISTS	AH TH AA L AH JH AH S T S
ETHOLOGY	IH TH AA L AH JH IY
ETHOS	IY TH AA S
ETHOSES	IY TH AA S IH Z
ETHOXIES	AH TH AA K S AY Z
ETHOXY	AH TH AA K S IY
ETHOXYL	AH TH AA K S AH L
ETHOXYLS	AH TH AA K S AH L Z
ETHS	EH TH S
ETHYL	EH TH AH L
ETHYLATE	EH TH AH L AH T
ETHYLATED	EH TH AH L EY T IH D
ETHYLATES	EH TH AH L AH T S
ETHYLATING	EH TH AH L EY T IH NG
ETHYLBENZENE	EH TH AH L B EH N Z IY N
ETHYLBENZENES	EH TH AH L B EH N Z IY N Z
ETHYLENE	EH TH AH L IY N
ETHYLENEDIAMINETETRAACETATE	AH TH AH L AH N IY D IY AE M AH N AH T EH T R AA S AH T EY T
ETHYLENEDIAMINETETRAACETATES	AH TH AH L AH N IY D IY AE M AH N AH T EH T R AA S AH T EY T S
ETHYLENES	EH TH AH L IY N Z
ETHYLENIC	EH TH AH L AH N IH K
ETHYLIC	EH TH AH L IH K
ETHYLS	EH TH AH L Z
ETHYNE	AH TH AY N
ETHYNES	AH TH AY N Z
ETHYNYL	EH TH AH N AH L
ETHYNYLS	EH TH AH N AH L Z
EURHYTHMIC	Y UW R AH TH M AH K
EURHYTHMICS	Y UW R IH TH M AH S Z
EURHYTHMIES	Y UW R IH TH M AY Z
EURHYTHMY	Y UW R IH TH M IY
EURYBATH	Y UW R AH B AH TH
EURYBATHIC	Y UW R AH B AH TH AH K
EURYBATHS	Y UW R AH B AH TH S
EURYTHERMAL	Y UW R AH TH AH R M AH L
EURYTHERMIC	Y UW R AH TH AH R M AH K
EURYTHERMOUS	Y UW R AH TH AH R M AH S
EURYTHMIC	Y UW R AH TH M AH K
EURYTHMICS	Y UW R IH TH M AH S Z
EURYTHMIES	Y UW R IH TH M AY Z
EURYTHMY	Y UW R IH TH M IY
EUTHANASIA	Y UW TH AH N EY ZH AH
EUTHANASIA(2)	Y UW TH AH N EY ZH Y AH
EUTHANASIAS	Y UW TH AH N EY S IY AH Z
EUTHANASIC	Y UW TH AH N AH Z AH K
EUTHANATIZE	Y UW TH AE N AH T AY Z
EUTHANATIZED	Y UW TH AE N AH T AY Z D
EUTHANATIZES	Y UW TH AE N AH T AY Z AH Z
EUTHANATIZING	Y UW TH AE N AH T AY Z AH NG
EUTHANIZE	Y UW TH AH N AY Z
EUTHANIZED	Y UW TH AH N AY Z D
EUTHANIZES	Y UW TH AH N AY Z AH Z
EUTHANIZING	Y UW TH AH N AY Z AH NG
EUTHENICS	Y UW TH AH N AH S Z
EUTHENIST	Y UW TH AH N AH S T
EUTHENISTS	Y UW TH AH N AH S T S
EUTHERIAN	Y UW TH IY R IY AH N
EUTHERIANS	Y UW TH IY R IY AH N Z
EUTHYROID	Y UW TH AH R OY D
EVERYTHING	EH V R IY TH IH NG
EXANTHEM	EH K S AE N TH AH M
EXANTHEMA	IH G Z AE N TH AH M AH
EXANTHEMAS	IH G Z AE N TH AH M AH Z
EXANTHEMATA	IH G Z AE N TH EH M AH T AH
EXANTHEMATIC	EH K S AE N TH AH M AH T IH K
EXANTHEMATOUS	EH K S AE N TH AH M AH T AH S
EXANTHEMS	EH K S AE N TH AH M Z
EXOERYTHROCYTIC	IH G Z AH R IH TH R AH S AH T AH K
EXOPHTHALMIC	IH G Z AA F TH AH M AH K
EXOPHTHALMOS	IH G Z AA F TH AE L M AH Z
EXOPHTHALMOSES	IH G Z AA F TH AH L M OW Z AH Z
EXOPHTHALMUS	IH G Z AA F TH AH M AH S
EXOPHTHALMUSES	IH G Z AA F TH AH L M Y UW Z AH Z
EXOTHERMAL	IH G Z AH TH AH R M AH L
EXOTHERMALLY	EH K S AH DH ER M AE L IY IY
EXOTHERMIC	EH K S OW TH ER M IH K
EXOTHERMICALLY	EH K S OW TH ER M IH K AH L IY
EXOTHERMICITIES	EH K S OW TH ER M IH K AH T IY Z
EXOTHERMICITY	EH K S OW TH ER M IH K AH T IY
EYETEETH	AY T IY TH
EYETOOTH	AY T UW TH
FACECLOTH	F EY S K L AO TH
FACECLOTHS	F EY S K L AO TH S
FAINTHEARTED	F EY N T HH AA R T IH D
FAINTHEARTEDLY	F EY N T HH AA R T AH D L IY
FAINTHEARTEDNESS	F EY N T HH AA R T AH D N AH S
FAINTHEARTEDNESSES	F EY N T HH AA R T AH D N AH S IH Z
FAITH	F EY TH
FAITHED	F EY TH T
FAITHFUL	F EY TH F AH L
FAITHFULLY	F EY TH F AH L IY
FAITHFULNESS	F EY TH F AH L N EH S
FAITHFULNESSES	F EY TH F AH L N AH S IH Z
FAITHFULS	F EY TH F AH L Z
FAITHING	F EY TH IH NG
FAITHLESS	F EY TH L AH S
FAITHLESSLY	F EY TH L AH S L IY
FAITHLESSNESS	F EY TH L AH S N AH S
FAITHLESSNESSES	F EY TH L AH S N AH S IH Z
FAITHS	F EY TH S
FARTHER	F AA R DH ER
FARTHERMOST	F AA R TH ER M OW S T
FARTHEST	F AA R DH AH S T
FARTHING	F AA R DH IH NG
FARTHINGALE	F AA R DH IH NG G EY L
FARTHINGALES	F AA R TH IH N G EY L Z
FARTHINGS	F AA R TH IH NG Z
FATHEAD	F AE T HH EH D
FATHEADED	F AE T HH EH D IH D
FATHEADEDLY	F AE T HH EH D AH D L IY
FATHEADEDNESS	F AE T HH EH D AH D N AH S
FATHEADEDNESSES	F AE T HH EH D AH D N AH S IH Z
FATHEADS	F AE T HH EH D Z
FATHER	F AA DH ER
FATHERED	F AA DH ER D
FATHERHOOD	F AA DH ER HH UH D
FATHERHOODS	F AA DH ER HH UH D Z
FATHERING	F AA DH ER IH NG
FATHERLAND	F AA DH ER L AE N D
FATHERLANDS	F AA DH ER L AE N D Z
FATHERLESS	F AA DH ER L AH S
FATHERLIKE	F AA DH ER L AY K
FATHERLINESS	F AA DH ER L IY N AH S
FATHERLINESSES	F AA DH ER L IY N AH S IH Z
FATHERLY	F AA DH ER L IY
FATHERS	F AA DH ER Z
FATHOM	F AE DH AH M
FATHOMABLE	F AE DH AH M AH B AH L
FATHOMED	F AE DH AH M D
FATHOMING	F AE DH AH M IH NG
FATHOMLESS	F AE DH AH M L AH S
FATHOMLESSLY	F AE DH AH M L AH S L IY
FATHOMLESSNESS	F AE DH AH M L AH S N AH S
FATHOMLESSNESSES	F AE DH AH M L AH S N AH S IH Z
FATHOMS	F AE DH AH M Z
FEATHER	F EH DH ER
FEATHERBED	F EH DH ER B EH D
FEATHERBEDDED	F EH DH ER B EH D IH D
FEATHERBEDDING	F EH DH ER B EH D IH NG
FEATHERBEDDINGS	F EH DH ER B EH D IH NG Z
FEATHERBEDS	F EH DH ER B EH D Z
FEATHERBRAIN	F EH DH ER B R EY N
FEATHERBRAINED	F EH DH ER B R EY N D
FEATHERBRAINS	F EH DH ER B R EY N Z
FEATHERED	F EH DH ER D
FEATHEREDGE	F EH DH ER EH JH
FEATHEREDGED	F EH DH ER EH JH D
FEATHEREDGES	F EH DH ER EH JH IH Z
FEATHEREDGING	F EH DH ER EH JH IH NG
FEATHERHEAD	F EH DH ER HH EH D
FEATHERHEADED	F EH DH ER HH EH D IH D
FEATHERHEADS	F EH DH ER HH EH D Z
FEATHERIER	F EH DH ER IY ER
FEATHERIEST	F EH DH ER IY AH S T
FEATHERING	F EH DH ER IH NG
FEATHERING(2)	F EH DH R IH NG
FEATHERINGS	F EH DH ER IH NG Z
FEATHERLESS	F EH DH ER L AH S
FEATHERLIGHT	F EH DH ER L AY T
FEATHERS	F EH DH ER Z
FEATHERSTITCH	F EH DH ER S T IH CH
FEATHERSTITCHED	F EH DH ER S T IH CH T
FEATHERSTITCHES	F EH DH ER S T IH CH IH Z
FEATHERSTITCHING	F EH DH ER S T IH CH IH NG
FEATHERWEIGHT	F EH DH ER W EY T
FEATHERWEIGHTS	F EH DH ER W EY T S
FEATHERY	F EH DH ER IY
FEATHERY(2)	F EH DH R IY
FELDSPATHIC	F EH L D S P AH TH AH K
FENTHION	F EH N TH AH N
FENTHIONS	F EH N TH AH N Z
FIFTEENTH	F IH F T IY N TH
FIFTEENTHS	F IH F T IY N TH S
FIFTH	F IH F TH
FIFTH(2)	F IH TH
FIFTHLY	F IH F TH L IY
FIFTHS	F IH F TH S
FIFTHS(2)	F IH F S
FIFTIETH	F IH F T IY IH TH
FIFTIETHS	F IH F T IY IH TH S
FILTH	F IH L TH
FILTHIER	F IH L TH IY ER
FILTHIEST	F IH L TH IY AH S T
FILTHILY	F IH L TH IY L IY
FILTHINESS	F IH L TH IY N AH S
FILTHINESSES	F IH L TH IY N AH S IH Z
FILTHS	F IH L TH S
FILTHY	F IH L TH IY
FIRETHORN	F AY ER TH AO R N
FIRETHORNS	F AY ER TH AO R N Z
FIRSTHAND	F ER S T HH AE N D
FIRSTHAND(2)	F ER S HH AE N D
FIRTH	F ER TH
FIRTHS	F ER TH S
FLAMETHROWER	F L EY M TH R OW ER
FLAMETHROWERS	F L EY M TH R OW ER Z
FLANNELMOUTHED	F L AE N AH L M AW TH T
FLATHEAD	F L AE T HH EH D
FLATHEADS	F L AE T HH EH D Z
FLOORCLOTH	F L OW R K L AO TH
FLOORCLOTHS	F L OW R K L AO TH S
FOOTBATH	F UH T B AE TH
FOOTBATHS	F UH T B AE TH S
FOOTCLOTH	F UH T K L AO TH
FOOTCLOTHS	F UH T K L AO TH S
FOOTHILL	F UH T HH IH L
FOOTHILLS	F UH T HH IH L Z
FOOTHOLD	F UH T HH OW L D
FOOTHOLDS	F UH T HH OW L D Z
FOOTPATH	F UH T P AE TH
FOOTPATHS	F UH T P AE TH S
FOREFATHER	F AO R F AA DH ER
FOREFATHERS	F AO R F AA DH ER Z
FOREGATHER	F OW R G AE DH ER
FOREGATHERED	F OW R G AE DH ER D
FOREGATHERING	F OW R G AE DH ER IH NG
FOREGATHERS	F OW R G AE DH ER Z
FOREMOTHER	F OW R M AH DH ER
FOREMOTHERS	F OW R M AH DH ER Z
FORETHOUGHT	F AO R TH AO T
FORETHOUGHTFUL	F OW R TH AO T F AH L
FORETHOUGHTFULLY	F OW R TH AO T F AH L IY
FORETHOUGHTFULNESS	F OW R TH AO T F AH L N AH S
FORETHOUGHTFULNESSES	F OW R TH AO T F AH L N AH S IH Z
FORETHOUGHTS	F OW R TH AO T S
FORGATHER	F AO R G AE DH ER
FORGATHERED	F AO R G AE DH ER D
FORGATHERING	F AO R G AE DH ER IH NG
FORGATHERS	F AO R G AE DH ER Z
FORSOOTH	F AO R S UW TH
FORSYTHIA	F AO R S IH TH IY AH
FORSYTHIA(2)	F AO R S IH DH IY AH
FORSYTHIAS	F AO R S IH TH IY AH Z
FORSYTHIAS(2)	F AO R S IH DH IY AH Z
FORTH	F AO R TH
FORTHCOMING	F AO R TH K AH M IH NG
FORTHRIGHT	F AO R TH R AY T
FORTHRIGHTLY	F AO R TH R AY T L IY
FORTHRIGHTNESS	F AO R TH R AY T N AH S
FORTHRIGHTNESSES	F OW R TH R AY T N AH S IH Z
FORTHRIGHTS	F OW R TH R AY T S
FORTHWITH	F AO R TH W IH TH
FORTIETH	F AO R T IY IH TH
FORTIETHS	F AO R T IY IH TH S
FOULMOUTHED	F AW L M AW TH T
FOURTEENTH	F AO R T IY N TH
FOURTEENTHS	F OW R T IY N TH S
FOURTH	F AO R TH
FOURTHLY	F AO R TH L IY
FOURTHS	F AO R TH S
FOURTHS(2)	F AO R S
FREETHINKER	F R IY TH IH NG K ER
FREETHINKERS	F R IY TH IH NG K ER Z
FREETHINKING	F R IY TH IH NG K IH NG
FREETHINKINGS	F R IY TH IH NG K IH NG Z
FRITH	F R IH TH
FRITHS	F R AY TH S
FROTH	F R AO TH
FROTHED	F R AO TH T
FROTHIER	F R AO TH IY ER
FROTHIEST	F R AO TH IY AH S T
FROTHILY	F R AO TH IY L IY
FROTHINESS	F R AO TH IY N IH S
FROTHINESSES	F R AO TH IY N AH S IH Z
FROTHING	F R AO TH IH NG
FROTHS	F R AO TH S
FROTHY	F R AO TH IY
FUCOXANTHIN	F Y UW K AH K S AE N TH AH N
FUCOXANTHINS	F Y UW K AH K S AE N TH AH N Z
FULLMOUTHED	F UH L M AW TH T
FURTHER	F ER DH ER
FURTHERANCE	F ER TH ER AH N S
FURTHERANCES	F Y UH R TH ER AH N S IH Z
FURTHERED	F ER DH ER D
FURTHERER	F Y UH R TH ER ER
FURTHERERS	F Y UH R TH ER ER Z
FURTHERING	F ER DH ER IH NG
FURTHERMORE	F ER DH ER M AO R
FURTHERMOST	F Y UH R TH ER M OW S T
FURTHERS	F ER DH ER Z
FURTHEST	F ER TH AH S T
FUTHARC	F AH TH AH R K
FUTHARCS	F AH TH AH R K S
FUTHARK	F AH TH AH R K
FUTHARKS	F AH TH AH R K S
FUTHORC	F AH TH AH R K
FUTHORCS	F AH TH AH R K S
FUTHORK	F AH TH AH R K
FUTHORKS	F AH TH AH R K S
GARTH	G AA R TH
GARTHS	G AA R TH S
GASTROLITH	G AE S T R AH L AH TH
GASTROLITHS	G AE S T R AH L AH TH S
GATHER	G AE DH ER
GATHERED	G AE DH ER D
GATHERER	G AE DH ER ER
GATHERERS	G AE DH ER ER Z
GATHERING	G AE DH ER IH NG
GATHERINGS	G AE DH ER IH NG Z
GATHERS	G AE DH ER Z
GEOTHERMAL	JH IY OW TH ER M AH L
GEOTHERMALLY	JH IY AH TH AH R M AE L IY
GILTHEAD	G IH L T HH EH D
GILTHEADS	G IH L T HH EH D Z
GIRTH	G ER TH
GIRTHED	G ER TH T
GIRTHING	G ER TH IH NG
GIRTHS	G ER TH S
GLUTATHIONE	G L UW T AE TH IY OW N
GLUTATHIONES	G L UW T AE TH IY OW N Z
GLUTETHIMIDE	G L UW T EH TH AH M AY D
GLUTETHIMIDES	G L UW T EH TH AH M AY D Z
GNATHAL	N AE TH AH L
GNATHIC	N AE TH AH K
GNATHION	N AE TH IY AH N
GNATHIONS	N AE TH IY AH N Z
GNATHITE	N AH TH AY T
GNATHITES	N AH TH AY T S
GOALMOUTH	G OW L M AW TH
GOALMOUTHS	G OW L M AW TH S
GOATHERD	G OW T HH ER D
GOATHERDS	G OW T HH ER D Z
GODFATHER	G AA D F AA DH ER
GODFATHERED	G AA D F AA DH ER D
GODFATHERING	G AA D F AA DH ER IH NG
GODFATHERS	G AA D F AA DH ER Z
GODMOTHER	G AA D M AH DH ER
GODMOTHERS	G AA D M AH DH ER Z
GOETHITE	G OW AH TH AY T
GOETHITES	G OW AH TH AY T S
GOLDSMITH	G OW L D S M IH TH
GOLDSMITHS	G OW L D S M IH TH S
GOLGOTHA	G OW L G AH TH AH
GOLGOTHAS	G OW L G AH TH AH Z
GOTHIC	G AA TH IH K
GOTHICALLY	G OW TH IH K AH L IY
GOTHICIZE	G OW TH IH K S AY Z
GOTHICIZED	G OW TH IH K S AY Z D
GOTHICIZES	G OW TH IH K S AY Z IH Z
GOTHICIZING	G OW TH IH K S AY Z IH NG
GOTHICS	G OW TH IH K S
GOTHITE	G AH TH AY T
GOTHITES	G AH TH AY T S
GRANDFATHER	G R AE N D F AA DH ER
GRANDFATHER(2)	G R AE N F AA DH ER
GRANDFATHERED	G R AE N D F AA DH ER D
GRANDFATHERED(2)	G R AE N F AA DH ER D
GRANDFATHERING	G R AE N D F AA DH ER IH NG
GRANDFATHERING(2)	G R AE N F AA DH ER IH NG
GRANDFATHERLY	G R AE N D F AA DH ER L IY
GRANDFATHERLY(2)	G R AE N F AA DH ER L IY
GRANDFATHERS	G R AE N D F AA DH ER Z
GRANDFATHERS(2)	G R AE N F AA DH ER Z
GRANDMOTHER	G R AE N D M AH DH ER
GRANDMOTHERLY	G R AE N D M AH DH ER L IY
GRANDMOTHERS	G R AE N D M AH DH ER Z
GRANDPARENTHOOD	G R AE N D P AE R AH N T HH UH D
GRANDPARENTHOODS	G R AE N D P AE R AH N T HH UH D Z
GRANOLITHIC	G R AE N AH L AH TH AH K
GREATHEARTED	G R EY T HH AA R T IH D
GREATHEARTEDLY	G R EY T HH AA R T AH D L IY
GREATHEARTEDNESS	G R EY T HH AA R T AH D N AH S
GREATHEARTEDNESSES	G R EY T HH AA R T AH D N AH S IH Z
GREENTH	G R IY N TH
GREENTHS	G R IY N TH S
GRITH	G R IH TH
GRITHS	G R IH TH S
GROUPTHINK	G R UW P TH IH NG K
GROUPTHINKS	G R UW P TH IH NG K S
GROWTH	G R OW TH
GROWTHIER	G R OW TH IY ER
GROWTHIEST	G R OW TH IY AH S T
GROWTHINESS	G R OW TH IY N AH S
GROWTHINESSES	G R OW TH IY N AH S IH Z
GROWTHS	G R OW TH S
GROWTHY	G R OW TH IY
GUANETHIDINE	G Y UW AH N EH TH AH D AY N
GUANETHIDINES	G Y UW AH N EH TH AH D AY N Z
GUESTHOUSE	G EH S T HH AW S
GUESTHOUSES	G EH S T HH AW S IH Z
GUNSMITH	G AH N S M IH TH
GUNSMITHING	G AH N S M IH TH IH NG
GUNSMITHINGS	G AH N S M IH TH IH NG Z
GUNSMITHS	G AH N S M IH TH S
HADITH	HH AE D AH TH
HADITHS	HH AE D AH TH S
HAFTAROTH	HH AE F T AH R AH TH
HAFTOROTH	HH AE F T AH R AH TH
HAGGADOTH	HH AE G AH D AH TH
HAIRBREADTH	HH EH R B R EH D TH
HAIRBREADTHS	HH EH R B R EH D TH S
HAIRCLOTH	HH EH R K L AO TH
HAIRCLOTHS	HH EH R K L AO TH S
HAIRSBREADTH	HH EH R Z B R EH D TH
HAIRSBREADTHS	HH EH R Z B R EH D TH S
HALACHOTH	HH AE L AH CH AH TH
HALAKOTH	HH AE L AH K AH TH
HALLOTH	HH AE L AH TH
HALOTHANE	HH AE L AH TH EY N
HALOTHANES	HH AE L AH TH EY N Z
HANDBREADTH	HH AE N D B R EH D TH
HANDBREADTHS	HH AE N D B R EH D TH S
HANDSBREADTH	HH AE N D Z B R EH D TH
HANDSBREADTHS	HH AE N D Z B R EH D TH S
HAPHTAROTH	HH AE F T AH R AH TH
HARDMOUTHED	HH AA R D M AW TH T
HATH	HH AE TH
HAWKMOTH	HH AO K M AO TH
HAWKMOTHS	HH AO K M AO TH S
HAWTHORN	HH AO TH AO R N
HAWTHORNS	HH AO TH AO R N Z
HEALTH	HH EH L TH
HEALTHFUL	HH EH L TH F AH L
HEALTHFULLY	HH EH L TH F AH L IY
HEALTHFULNESS	HH EH L TH F AH L N AH S
HEALTHFULNESSES	HH EH L TH F AH L N AH S IH Z
HEALTHIER	HH EH L TH IY ER
HEALTHIEST	HH EH L TH IY IH S T
HEALTHILY	HH EH L TH IY L IY
HEALTHINESS	HH EH L TH IY N AH S
HEALTHINESSES	HH EH L TH IY N AH S IH Z
HEALTHS	HH EH L TH S
HEALTHY	HH EH L TH IY
HEARTH	HH AA R TH
HEARTHS	HH AA R TH S
HEARTHSTONE	HH AA R TH S T OW N
HEARTHSTONES	HH AA R TH S T OW N Z
HEARTTHROB	HH AA R T TH R AA B
HEARTTHROBS	HH AA R T TH R AA B Z
HEATH	HH IY TH
HEATHEN	HH IY DH AH N
HEATHENDOM	HH IY DH AH N D AH M
HEATHENDOMS	HH IY DH AH N D AH M Z
HEATHENISH	HH IY DH AH N IH SH
HEATHENISHLY	HH IY DH AH N IH SH L IY
HEATHENISM	HH IY DH AH N IH Z AH M
HEATHENISMS	HH IY DH AH N IH Z AH M Z
HEATHENIZE	HH IY DH AH N AY Z
HEATHENIZED	HH IY DH AH N AY Z D
HEATHENIZES	HH IY DH AH N AY Z IH Z
HEATHENIZING	HH IY DH AH N AY Z IH NG
HEATHENS	HH IY DH AH N Z
HEATHER	HH EH DH ER
HEATHERS	HH EH DH ER Z
HEATHERY	HH EH DH ER IY
HEATHIER	HH IY TH AY AH R
HEATHIEST	HH IY TH AY AH S T
HEATHLAND	HH IY TH L AH N D
HEATHLANDS	HH IY TH L AH N D Z
HEATHLESS	HH IY TH L AH S
HEATHLIKE	HH IY TH L AY K
HEATHS	HH IY TH S
HEATHY	HH IY TH IY
HEIGHTH	HH AY TH
HEIGHTHS	HH EY TH S
HELLBROTH	HH EH L B R AO TH
HELLBROTHS	HH EH L B R AO TH S
HELMINTH	HH EH L M IH N TH
HELMINTHIASES	HH EH L M IH N TH IY EY Z AH Z
HELMINTHIASIS	HH EH L M IH N TH IY AH S AH S
HELMINTHIC	HH EH L M IH N TH IH K
HELMINTHOLOGIES	HH EH L M IH N TH AA L AH JH IY Z
HELMINTHOLOGY	HH EH L M IH N TH AA L AH JH IY
HELMINTHS	HH EH L M IH N TH S
HEMERYTHRIN	HH EH M AH R IH TH R AH N
HEMERYTHRINS	HH EH M AH R IH TH R AH N Z
HEMOGLOBINOPATHIES	HH AH M AA G L AH B AH N AA P AH TH AY Z
HEMOGLOBINOPATHY	HH AH M AA G L AH B AH N AA P AH TH IY
HENCEFORTH	HH EH N S F AO R TH
HENOTHEISM	HH AH N OW DH IY IH Z AH M
HENOTHEISMS	HH EH N AH TH IY Z AH M Z
HENOTHEIST	HH AH N OW DH IY AH S T
HENOTHEISTIC	HH EH N AH TH IY S T AH K
HENOTHEISTS	HH EH N AH TH IY S T S
HEREWITH	HH IH R W IH TH
HETEROTHALLIC	HH AH T EH R AH TH AH L AH K
HETEROTHALLISM	HH AH T EH R AH TH AH L IH Z AH M
HETEROTHALLISMS	HH EH T AH R AH TH AE L AH Z AH M Z
HETH	HH EH TH
HETHS	HH EH TH S
HEXACHLORETHANE	HH EH K S AE K L AO R AH TH EY N
HEXACHLORETHANES	HH EH K S AE K L AO R AH TH EY N Z
HEXACHLOROETHANE	HH EH K S AH K L AO R OW AH TH EY N
HEXACHLOROETHANES	HH EH K S AH K L AO R OW AH TH EY N Z
HEXAMETHONIUM	HH EH K S AH M AH TH OW N IY AH M
HEXAMETHONIUMS	HH EH K S AH M AH TH OW N IY AH M Z
HEXAMETHYLENETETRAMINE	HH EH K S AH M AH TH AH L AH N AH T EH T R AH M AY N
HEXAMETHYLENETETRAMINES	HH EH K S AH M AH TH AH L AH N AH T EH T R AH M AY N Z
HIGHTH	HH AY TH
HIGHTHS	HH AY TH S
HISTOPATHOLOGIC	HH IH S T AH P AE TH AH L AH JH AH K
HISTOPATHOLOGICAL	HH IH S T AH P AH TH AA L AH JH IH S AH L
HISTOPATHOLOGICALLY	HH IH S T AA P AH TH AH L AA JH AH K AE L IY
HISTOPATHOLOGIES	HH IH S T AH P AH TH AA L AH JH AY Z
HISTOPATHOLOGIST	HH IH S T AH P AH TH AA L AH JH AH S T
HISTOPATHOLOGISTS	HH IH S T AH P AH TH AA L AH JH AH S T S
HISTOPATHOLOGY	HH IH S T AH P AH TH AA L AH JH IY
HITHER	HH IH DH ER
HITHERMOST	HH IH TH AH R M OW S T
HITHERTO	HH IH DH ER T UW
HITHERWARD	HH AH TH AH R W AH R D
HOLOTHURIAN	HH AH L AA TH Y UH R IY AH N
HOLOTHURIANS	HH AA L AH TH UH R IY AH N Z
HOMEOPATH	HH OW M IY AH P AH TH
HOMEOPATHIC	HH OW M IY OW P AE TH AH K
HOMEOPATHICALLY	HH OW M IY AH P AE TH AH K AE L IY
HOMEOPATHIES	HH OW M IY AA P AH TH AY Z
HOMEOPATHS	HH OW M IY AH P AH TH S
HOMEOPATHY	HH OW M IY OW P AE TH IY
HOMEOTHERM	HH OW M IY AH TH AH R M
HOMEOTHERMIC	HH OW M IY AH TH AH R M AH K
HOMEOTHERMIES	HH OW M IY AH TH AH R M AY Z
HOMEOTHERMS	HH OW M IY AH TH AH R M Z
HOMEOTHERMY	HH OW M IY AH TH AH R M IY
HOMOIOTHERM	HH AH M OY AH TH AH R M
HOMOIOTHERMIC	HH AH M OY AH TH AH R M AH K
HOMOIOTHERMS	HH AH M OY AH TH AH R M Z
HOMOTHALLIC	HH OW M OW TH AH L IH K
HOMOTHALLISM	HH OW M OW TH AH L IH Z AH M
HOMOTHALLISMS	HH OW M OW TH AH L IH Z AH M Z
HORSEFEATHERS	HH AO R S F EH DH ER Z
HOTHEAD	HH AA T HH EH D
HOTHEADED	HH AA T HH EH D IH D
HOTHEADEDLY	HH AA T HH EH D AH D L IY
HOTHEADEDNESS	HH AA T HH EH D AH D N AH S
HOTHEADEDNESSES	HH AA T HH EH D AH D N AH S IH Z
HOTHEADS	HH AA T HH EH D Z
HOTHOUSE	HH AA T HH AW S
HOTHOUSES	HH AA T HH AW S IH Z
HOUSEFATHER	HH AW S F AA DH ER
HOUSEFATHERS	HH AW S F AA DH ER Z
HOUSEMOTHER	HH AW S M AH DH ER
HOUSEMOTHERS	HH AW S M AH DH ER Z
HUNDREDTH	HH AH N D R AH D TH
HUNDREDTHS	HH AH N D R AH D TH S
HYACINTH	HH AY AH S IH N TH
HYACINTHINE	HH AY AE S AH N TH AY N
HYACINTHS	HH AY AH S IH N TH S
HYDATHODE	HH IH D AH TH OW D
HYDATHODES	HH IH D AH TH OW D Z
HYDRANTH	HH IH D R AH N TH
HYDRANTHS	HH IH D R AH N TH S
HYDROCHLOROTHIAZIDE	HH IH D R AH K L AH R AA TH IY AH Z AY D
HYDROCHLOROTHIAZIDES	HH IH D R AH K L AH R AA TH IY AH Z AY D Z
HYDROPATHIC	HH IH D R AH P AH TH AH K
HYDROPATHIES	HH IH D R AA P AH TH AY Z
HYDROPATHY	HH IH D R AA P AH TH IY
HYDROTHERAPIES	HH IH D R AH TH EH R AH P AY Z
HYDROTHERAPY	HH AY D R OW TH EH R AH P IY
HYDROTHERMAL	HH AY D R OW TH ER M AH L
HYDROTHERMALLY	HH IH D R AH TH AH R M AE L IY
HYDROTHORACES	HH IH D R AH TH AO R AH S AH Z
HYDROTHORAX	HH IH D R AA TH AH R AH K S
HYDROTHORAXES	HH IH D R AA TH AH R AH K S
HYPAETHRAL	HH AH P IY TH R AH L
HYPANTHIA	HH AH P AE N TH IY AH
HYPANTHIUM	HH AH P AE N TH IY AH M
HYPERAESTHESIA	HH AY P AH R EH S TH IY ZH IY AH
HYPERAESTHESIAS	HH AY P AH R EH S TH IY S IY AH Z
HYPERAESTHETIC	HH AY P ER EH S TH EH T IH K
HYPERESTHESIA	HH AY P AH R EH S TH IY ZH IY AH
HYPERESTHESIAS	HH AY P AH R EH S TH IY S IY AH Z
HYPERESTHETIC	HH AY P ER EH S TH EH T IH K
HYPERPARATHYROIDISM	HH AY P ER P AA R AH TH AY R OY D IH Z AH M
HYPERPARATHYROIDISMS	HH AY P ER P AA R AH TH AY R OY D IH Z AH M Z
HYPERSTHENE	HH AY P AH R S TH IY N
HYPERSTHENES	HH AY P AH R S TH IY N Z
HYPERSTHENIC	HH AY P AH R S TH IY N AH K
HYPERTHERMIA	HH AY P AH R TH AH R M IY AH
HYPERTHERMIAS	HH AY P AH R TH AH R M IY AH Z
HYPERTHERMIC	HH AY P ER TH ER M IH K
HYPERTHYROID	HH AY P ER TH AY R OY D
HYPERTHYROIDISM	HH AY P ER TH AY R OY D IH Z AH M
HYPERTHYROIDISMS	HH AY P ER TH AY R OY D IH Z AH M Z
HYPNOTHERAPIES	HH IH P N AH TH EH R AH P AY Z
HYPNOTHERAPIST	HH IH P N AH TH EH R AH P AH S T
HYPNOTHERAPISTS	HH IH P N AH TH EH R AH P AH S T S
HYPNOTHERAPY	HH IH P N AH TH EH R AH P IY
HYPOPARATHYROIDISM	HH AH P AH P AH R AE TH AH R OY D IH Z AH M
HYPOPARATHYROIDISMS	HH AH P AH P AE R AH TH AH R OY D AH Z AH M Z
HYPOTHALAMI	HH IH P AH TH AE L AH M IY
HYPOTHALAMIC	HH AY P OW TH AH L AE M IH K
HYPOTHALAMUS	HH AY P OW TH AE L AH M AH S
HYPOTHEC	HH IH P AH TH AH K
HYPOTHECATE	HH AH P AA TH AH K EY T
HYPOTHECATED	HH AH P AA TH AH K EY T AH D
HYPOTHECATES	HH AH P AA TH AH K EY T S
HYPOTHECATING	HH AH P AA TH AH K EY T AH NG
HYPOTHECATION	HH AH P AA TH AH K EY SH AH N
HYPOTHECATIONS	HH IH P AH TH AH K EY T IY AH N Z
HYPOTHECATOR	HH AH P AA TH AH K EY T AH R
HYPOTHECATORS	HH IH P AH TH EH K AH T AH R Z
HYPOTHECS	HH IH P AH TH AH K S
HYPOTHENUSE	HH AH P AA TH AH N Y UW Z
HYPOTHENUSES	HH AH P AA TH AH N Y UW Z AH Z
HYPOTHERMAL	HH IH P AH TH AH R M AH L
HYPOTHERMIA	HH AY P AH TH ER M IY AH
HYPOTHERMIAS	HH IH P AH TH AH R M IY AH Z
HYPOTHERMIC	HH IH P AH TH AH R M AH K
HYPOTHESES	HH AY P AA TH AH S IY Z
HYPOTHESIS	HH AY P AA TH AH S AH S
HYPOTHESIZE	HH AY P AA TH AH S AY Z
HYPOTHESIZED	HH AY P AA TH AH S AY Z D
HYPOTHESIZES	HH AY P AA TH AH S AY Z IH Z
HYPOTHESIZING	HH AY P AA TH AH S AY Z IH NG
HYPOTHETICAL	HH AY P AH TH EH T AH K AH L
HYPOTHETICAL(2)	HH AY P AH TH EH T IH K AH L
HYPOTHETICALLY	HH AY P AH TH EH T IH K L IY
HYPOTHYROID	HH AY P OW TH AY R OY D
HYPOTHYROIDISM	HH AY P OW TH AY R OY D IH Z AH M
HYPOTHYROIDISMS	HH AY P OW TH AY R OY D IH Z AH M Z
HYPOXANTHINE	HH AH P AA K S AH N TH AY N
HYPOXANTHINES	HH AH P AA K S AH N TH AY N Z
ICHTHYIC	IH CH TH AY AH K
ICHTHYOFAUNA	IH CH TH AY AA F AH N AH
ICHTHYOFAUNAE	IH CH TH AY AA F AH N IY
ICHTHYOFAUNAL	IH CH TH AY AA F AH N AH L
ICHTHYOFAUNAS	IH CH TH AY AA F AH N AH Z
ICHTHYOLOGICAL	IH CH TH AY AA L AH JH IH S AH L
ICHTHYOLOGICALLY	IH CH TH AY AH L AA JH AH K AE L IY
ICHTHYOLOGIES	IH CH TH AY AA L AH JH AY Z
ICHTHYOLOGIST	IH CH TH AY AA L AH JH AH S T
ICHTHYOLOGISTS	IH CH TH AY AA L AH JH AH S T S
ICHTHYOLOGY	IH CH TH AY AA L AH JH IY
ICHTHYOPHAGOUS	IH CH TH AY AH F EY JH AH S
ICHTHYOSAUR	IH CH TH AY AH S AH R
ICHTHYOSAURIAN	IH CH TH AY AH S AH Y UH R IY AH N
ICHTHYOSAURIANS	IH CH TH AY AH S AO R IY AH N Z
ICHTHYOSAURS	IH CH TH AY AH S EY Y AH R Z
IDIOPATHIC	IH D IY OW P AE TH AH K
IDIOPATHICALLY	IH D IY AH P AE TH AH K AE L IY
IMMETHODICAL	IH M AH TH AA D IH K AH L
IMMETHODICALLY	IH M AH TH AA D IH K AH L IY
IMMUNOPATHOLOGIC	IH M Y UW N AH P AE TH AH L AH JH AH K
IMMUNOPATHOLOGICAL	IH M Y UW N AH P AH TH AA L AH JH IH S AH L
IMMUNOPATHOLOGIES	IH M Y UW N AH P AH TH AA L AH JH AY Z
IMMUNOPATHOLOGIST	IH M Y UW N AH P AH TH AA L AH JH AH S T
IMMUNOPATHOLOGISTS	IH M Y UW N AH P AH TH AA L AH JH AH S T S
IMMUNOPATHOLOGY	IH M Y UW N AH P AH TH AA L AH JH IY
IMMUNOTHERAPEUTIC	IH M Y UW N AH TH AH R EY P AH Y UW T AH K
IMMUNOTHERAPIES	IH M Y AH N AH TH EH R AH P AY Z
IMMUNOTHERAPY	IH M Y UW N OW TH EH R AH P IY
IMPOSTHUME	IH M P AA S TH UW M
IMPOSTHUMES	IH M P AA S TH UW M Z
INAUTHENTIC	IH N AO TH EH N T IH K
INAUTHENTICITIES	IH N AO TH EH N T IH S AH T IY Z
INAUTHENTICITY	IH N AO TH EH N T IH S AH T IY
INBREATHE	IH N B R IY DH
INBREATHED	IH N B R IY DH D
INBREATHES	IH N B R IY DH Z
INBREATHING	IH N B R IY DH IH NG
INDOMETHACIN	IH N D AH M EH TH AH S AH N
INDOMETHACINS	IH N D AH M EH TH AH S AH N Z
INEARTH	IH N ER TH
INEARTHED	IH N ER TH T
INEARTHING	IH N ER TH IH NG
INEARTHS	IH N ER TH S
INGATHER	IH N G AE DH ER
INGATHERED	IH N G AE DH ER D
INGATHERING	IH N G AE DH ER IH NG
INGATHERINGS	IH N G AE DH ER IH NG Z
INGATHERS	IH N G AE DH ER Z
INGROWTH	IH N G R OW TH
INGROWTHS	IH N G R OW TH S
INSHEATH	IH N SH IY TH
INSHEATHED	IH N SH IY DH D
INSHEATHING	IH N SH IY DH IH NG
INSHEATHS	IH N SH IY TH S
INSWATHE	IH N S W EY DH
INSWATHED	IH N S W AA TH T
INSWATHES	IH N S W AA TH S
INSWATHING	IH N S W AA TH IH NG
INTERETHNIC	IH N T ER EH TH N IH K
INTERFAITH	IH N T ER F EY TH
INTERGROWTH	IH N T ER G R OW TH
INTERGROWTHS	IH N T ER G R OW TH S
INTHRAL	IH N TH R AH L
INTHRALL	IH N TH R AE L
INTHRALLED	IH N TH R AO L D
INTHRALLING	IH N TH R AO L AH NG
INTHRALLS	IH N TH R AE L Z
INTHRALS	IH N TH R AE L Z
INTHRONE	IH N TH R OW N
INTHRONED	IH N TH R OW N D
INTHRONES	IH N TH R OW N Z
INTHRONING	IH N TH R OW N IH NG
INTRATHECAL	IH N T R AH TH IY K AH L
INTRATHECALLY	IH N T R AH TH AH K AE L IY
INTRATHORACIC	IH N T R AH TH AO R AH S AH K
INTRATHORACICALLY	IH N T R AH TH AH R AE S AH K AE L IY
ISARITHM	IH S AH R AH DH AH M
ISARITHMS	IH S AH R AH DH AH M Z
ISOBATH	IH S AH B AH TH
ISOBATHS	IH S AH B AH TH S
ISOPLETH	AH S AA P L AH TH
ISOPLETHIC	AH S AA P L AH TH AH K
ISOPLETHS	AH S AA P L AH TH S
ISOTHERE	IH S AH TH AH R
ISOTHERES	IH S AH TH IY R Z
ISOTHERM	IH S AH TH AH R M
ISOTHERMAL	AY S AH TH ER M AH L
ISOTHERMALLY	AY S AH TH EH R M AH L IY
ISOTHERMS	IH S AH TH AH R M Z
ISTHMI	IH S TH M IY
ISTHMIAN	IH S TH M IY AH N
ISTHMIANS	IH S TH M IY AH N Z
ISTHMIC	IH S TH M AH K
ISTHMOID	IH S TH M OY D
ISTHMUS	IH S M AH S
ISTHMUSES	AY Z TH M Y UW Z IH Z
ITHER	IH DH AH R
ITHYPHALLIC	IH TH AH F AH L AH K
JACINTH	JH AE S IH N TH
JACINTHE	JH AE S IH N TH
JACINTHES	JH AE S AH N DH Z
JACINTHS	JH AE S AH N TH S
KASHRUTH	K AE SH R AH TH
KASHRUTHS	K AE SH R AH TH S
KATHARSES	K AH TH AA R S AH Z
KATHARSIS	K AH TH AA R S AH S
KATHODAL	K AE TH AH D AH L
KATHODE	K AH TH OW D
KATHODES	K AH TH OW D Z
KATHODIC	K AE TH AH D AH K
KHETH	K HH EH TH
KHETHS	K HH EH TH S
KINESTHESES	K IH N AH S TH IY Z AH Z
KINESTHESIA	K IH N AH S TH IY ZH IY AH
KINESTHESIAS	K IH N AH S TH IY S IY AH Z
KINESTHESIS	K AH N EH S DH AH S AH S
KINESTHETIC	K IH N AH S TH EH T IH K
KINESTHETICALLY	K IH N AH S TH EH T IH K AH L IY
KITH	K IH TH
KITHARA	K IH TH AH R AH
KITHARAS	K IH TH AH R AH Z
KITHE	K AY DH
KITHED	K IH DH D
KITHES	K IH DH Z
KITHING	K IH DH AH NG
KITHS	K IH TH S
KNIGHTHOOD	N AY T HH UH D
KNIGHTHOODS	N AY T HH UH D Z
KNOTHOLE	N AA T HH OW L
KNOTHOLES	N AA T HH OW L Z
KRYOLITH	K R AY AH L AH TH
KRYOLITHS	K R AY AH L AH TH S
KYTHE	K IH DH
KYTHED	K IH DH D
KYTHES	K IH DH Z
KYTHING	K IH DH AH NG
LABYRINTH	L AE B ER IH N TH
LABYRINTHIAN	L AE B AH R IH N TH IY AH N
LABYRINTHINE	L AE B ER IH N TH IY N
LABYRINTHODONT	L AE B AH R IH N TH AH D AH N T
LABYRINTHODONTS	L AE B AH R IH N TH AH D AH N T S
LABYRINTHS	L AE B AH R IH N TH S
LACCOLITH	L AE K AH L AH TH
LACCOLITHIC	L AE K AH L AH TH AH K
LACCOLITHS	L AE K AH L IH TH S
LAITH	L EY TH
LAITHLY	L EY TH L IY
LANTHANIDE	L AE N TH AH N AY D
LANTHANIDES	L AE N TH AH N AY D Z
LANTHANUM	L AE N TH AH N AH M
LANTHANUMS	L AE N TH AH N AH M Z
LANTHORN	L AE N TH AH R N
LANTHORNS	L AE N TH AH R N Z
LARGEMOUTH	L AA R JH M AW TH
LARGEMOUTHS	L AA R JH M AW TH S
LATH	L AE TH
LATHE	L EY DH
LATHED	L EY DH D
LATHER	L AE DH ER
LATHERED	L AE DH ER D
LATHERER	L AE DH ER ER
LATHERERS	L AE DH ER ER Z
LATHERING	L AE DH ER IH NG
LATHERS	L AE DH ER Z
LATHERY	L EY DH AH R IY
LATHES	L EY DH Z
LATHI	L AE TH IY
LATHIER	L EY DH IY ER
LATHIEST	L EY DH IY AH S T
LATHING	L EY DH IH NG
LATHINGS	L EY DH IH NG Z
LATHIS	L EY DH IY Z
LATHS	L AE TH S
LATHWORK	L AE TH W ER K
LATHWORKS	L AE TH W ER K S
LATHY	L EY DH IY
LATHYRISM	L AE TH AH R IH Z AH M
LATHYRISMS	L AE TH AH R AH Z AH M Z
LATHYRITIC	L EY DH IY R AY T IH K
LEATHER	L EH DH ER
LEATHERBACK	L EH DH ER B AE K
LEATHERBACKS	L EH DH ER B AE K S
LEATHERED	L EH DH ER D
LEATHERETTE	L EH DH ER EH T
LEATHERETTES	L EH DH ER EH T S
LEATHERING	L EH DH ER IH NG
LEATHERLEAF	L EH DH ER L IY F
LEATHERLEAVES	L EH DH ER L IY V Z
LEATHERLIKE	L EH DH ER L AY K
LEATHERN	L IY TH AH R N
LEATHERNECK	L EH DH ER N EH K
LEATHERNECKS	L EH DH ER N EH K S
LEATHERS	L EH DH ER Z
LEATHERWOOD	L EH DH ER W UH D
LEATHERWOODS	L EH DH ER W UH D Z
LEATHERY	L EH DH ER IY
LECITHIN	L EH S AH TH AH N
LECITHIN(2)	L EH S IH TH IH N
LECITHINASE	L AH S IH TH AH N EY Z
LECITHINASES	L AH S IH TH AH N EY Z AH Z
LECITHINS	L EH S AH TH AH N Z
LECYTHI	L EH S AH TH IY
LECYTHIS	L EH S AH TH AH S
LECYTHUS	L EH S AH TH AH S
LEKYTHI	L EH K AH TH IY
LEKYTHOI	L EH K AH TH OY
LEKYTHOS	L EH K AH TH AH Z
LEKYTHUS	L EH K AH TH AH S
LENGTH	L EH NG K TH
LENGTH(2)	L EH NG TH
LENGTHEN	L EH NG TH AH N
LENGTHEN(2)	L EH NG K TH AH N
LENGTHENED	L EH NG TH AH N D
LENGTHENED(2)	L EH NG K TH AH N D
LENGTHENER	L EH NG TH AH N ER
LENGTHENERS	L EH NG TH AH N ER Z
LENGTHENING	L EH NG TH AH N IH NG
LENGTHENING(2)	L EH NG K TH AH N IH NG
LENGTHENS	L EH NG TH AH N Z
LENGTHENS(2)	L EH NG K TH AH N Z
LENGTHIER	L EH NG TH IY ER
LENGTHIEST	L EH NG TH IY AH S T
LENGTHILY	L EH NG TH IY L IY
LENGTHINESS	L EH NG TH IY N AH S
LENGTHINESSES	L EH NG TH IY N AH S IH Z
LENGTHS	L EH NG K TH S
LENGTHS(2)	L EH NG TH S
LENGTHWAYS	L EH NG TH W EY Z
LENGTHWISE	L EH NG TH W AY Z
LENGTHY	L EH NG TH IY
LETHAL	L IY TH AH L
LETHALITIES	L IY TH AE L AH T IY Z
LETHALITY	L IY TH AE L AH T IY
LETHALLY	L IY TH AH L IY
LETHALS	L IY TH AH L Z
LETHARGIC	L AH TH AA R JH IH K
LETHARGICALLY	L AH TH AA R JH AH K AE L IY
LETHARGIES	L EH TH ER JH IY Z
LETHARGY	L EH TH ER JH IY
LETHE	L EH DH
LETHEAN	L EH DH IY AH N
LETHES	L EH DH Z
LEVIATHAN	L EH V AY AH TH AH N
LEVIATHANS	L IY V IY AH TH AH N Z
LIGHTHEADED	L AY T HH EH D AH D
LIGHTHEARTED	L AY T HH AA R T IH D
LIGHTHEARTEDLY	L AY T HH AA R T AH D L IY
LIGHTHEARTEDNESS	L AY T HH AA R T AH D N AH S
LIGHTHEARTEDNESSES	L AY T HH AA R T AH D N AH S IH Z
LIGHTHOUSE	L AY T HH AW S
LIGHTHOUSES	L AY T HH AW S IH Z
LIGHTHOUSES(2)	L AY T HH AW Z AH Z
LIROTH	L IH R AH TH
LITHARGE	L IH TH AH R JH
LITHARGES	L AH TH AA R JH AH Z
LITHE	L AY DH
LITHELY	L AY DH L IY
LITHEMIA	L AH TH IY M IY AH
LITHEMIAS	L AH TH IY M IY AH Z
LITHEMIC	L IH T HH EH M IH K
LITHENESS	L AY DH N AH S
LITHENESSES	L AY DH N AH S IH Z
LITHER	L AY DH ER
LITHESOME	L AY DH S AH M
LITHEST	L AY DH AH S T
LITHIA	L IH TH IY AH
LITHIAS	L IH TH IY AH Z
LITHIASES	L IH TH IY EY Z AH Z
LITHIASIS	L AH TH IY AH S AH S
LITHIC	L IH TH IH K
LITHIFICATION	L AY DH AH F AH K EY SH AH N
LITHIFICATIONS	L AY DH AH F AH K EY SH AH N Z
LITHIFIED	L AY DH AH F AY D
LITHIFIES	L AY DH AH F AY Z
LITHIFY	L AY DH AH F AY
LITHIFYING	L AY DH AH F AY IH NG
LITHIUM	L IH TH IY AH M
LITHIUMS	L IH TH IY AH M Z
LITHO	L IH TH OW
LITHOED	L IH T HH OW D
LITHOGRAPH	L IH TH AH G R AE F
LITHOGRAPHED	L IH TH AH G R AE F T
LITHOGRAPHER	L IH TH AH G R AE F ER
LITHOGRAPHERS	L IH TH AH G R AE F ER Z
LITHOGRAPHIC	L IH TH AH G R AE F IH K
LITHOGRAPHICALLY	L IH TH AH G R AE F IH K AH L IY
LITHOGRAPHIES	L IH TH AH G R AE F IY Z
LITHOGRAPHING	L IH TH AH G R AE F IH NG
LITHOGRAPHS	L IH TH AH G R AE F S
LITHOGRAPHY	L AH TH AA G R AH F IY
LITHOID	L IH T HH OW AH D
LITHOING	L IH T HH OW IH NG
LITHOLOGIC	L IH TH AH L AH JH AH K
LITHOLOGICAL	L AH TH AA L AH JH IH S AH L
LITHOLOGICALLY	L IH TH AH L AA JH AH K AE L IY
LITHOLOGIES	L AY DH AA L AH JH IY Z
LITHOLOGY	L AY DH AA L AH JH IY
LITHOPHANE	L IH TH AH F EY N
LITHOPHANES	L IH TH AH F EY N Z
LITHOPHYTE	L IH TH AH F AY T
LITHOPHYTES	L IH TH AH F AY T S
LITHOPONE	L IH TH AH P OW N
LITHOPONES	L IH TH AH P OW N Z
LITHOS	L IH TH AH Z
LITHOSOL	L IH TH AH S AH L
LITHOSOLS	L IH TH AH S AH L Z
LITHOSPHERE	L AH TH AA S AH R
LITHOSPHERES	L IH TH AH S IY R Z
LITHOSPHERIC	L AH TH AA S AH R AH K
LITHOTOMIES	L AH TH AA T AH M AY Z
LITHOTOMY	L AH TH AA T AH M IY
LITHOTRIPSIES	L IH T HH AA T R IH P S IY Z
LITHOTRIPSY	L IH T HH AA T R IH P S IY
LITHOTRIPTER	L IH TH AH T R IH P T ER
LITHOTRIPTERS	L IH TH AH T R IH P T AH R Z
LITHOTRIPTOR	L AH TH AA T R IH P T AH R
LITHOTRIPTORS	L IH TH AH T R IH P T AH R Z
LOATH	L OW TH
LOATHE	L OW DH
LOATHED	L OW DH D
LOATHER	L OW TH ER
LOATHERS	L OW TH ER Z
LOATHES	L OW TH S
LOATHFUL	L OW TH F AH L
LOATHING	L OW TH IH NG
LOATHINGS	L OW TH IH NG Z
LOATHLY	L OW TH L IY
LOATHNESS	L OW TH N AH S
LOATHNESSES	L OW TH N AH S IH Z
LOATHSOME	L OW DH S AH M
LOATHSOME(2)	L OW TH S AH M
LOATHSOMELY	L OW TH S AH M L IY
LOATHSOMENESS	L OW TH S AH M N AH S
LOATHSOMENESSES	L OW TH S AH M N AH S IH Z
LOCKSMITH	L AA K S M IH TH
LOCKSMITHING	L AA K S M IH TH IH NG
LOCKSMITHINGS	L AA K S M IH TH IH NG Z
LOCKSMITHS	L AA K S M IH TH S
LOGARITHM	L AA G ER IH DH AH M
LOGARITHMIC	L AA G ER IH DH M IH K
LOGARITHMICALLY	L AA G AH R IH DH AH M IH K AH L IY
LOGARITHMS	L AA G ER IH DH AH M Z
LOINCLOTH	L OY N K L AO TH
LOINCLOTHS	L OY N K L AO TH S
LOTH	L AA TH
LOTHARIO	L OW TH AA R IY OW
LOTHARIOS	L OW TH AA R IY OW Z
LOTHSOME	L AA TH S AH M
LOUDMOUTH	L AW D M AW TH
LOUDMOUTHED	L AW D M AW TH T
LOUDMOUTHS	L AW D M AW TH S
LUTHERN	L AH TH AH R N
LUTHERNS	L AH TH AH R N Z
LUTHIER	L AH TH AY AH R
LUTHIERS	L AH TH IY R Z
LYCANTHROPE	L IH K AH N TH R OW P
LYCANTHROPES	L IH K AH N TH R OW P S
LYCANTHROPIC	L AH K AE N TH R AH P AH K
LYCANTHROPIES	L AH K AE N TH R AH P AY Z
LYCANTHROPY	L AH K AE N TH R AH P IY
LYMPHADENOPATHIES	L IH M F AH D AH N AA P AH TH AY Z
LYMPHADENOPATHY	L IH M F AH D EH N AH P AE TH IY
LYSOLECITHIN	L IH S AH L EH S AH TH AH N
LYSOLECITHINS	L IH S AH L EH S AH TH AH N Z
MALATHION	M AH L AE TH IY AO N
MALATHION(2)	M AH L AE TH IY AH N
MALATHIONS	M AH L AE TH IY AH N Z
MALTHA	M AE L TH AA
MALTHAS	M AE L TH AE Z
MAMMOTH	M AE M AH TH
MAMMOTHS	M AE M AH TH S
MARATHON	M EH R AH TH AA N
MARATHONER	M AE R AH TH AA N ER
MARATHONERS	M AE R AH TH AA N ER Z
MARATHONING	M AE R AH TH AA N IH NG
MARATHONINGS	M AE R AH TH AA N IH NG Z
MARATHONS	M EH R AH TH AA N Z
MASTHEAD	M AE S T HH EH D
MASTHEADED	M AE S T HH EH D IH D
MASTHEADING	M AE S T HH EH D IH NG
MASTHEADS	M AE S T HH EH D Z
MATH	M AE TH
MATHEMATIC	M AE TH AH M AE T IH K
MATHEMATICAL	M AE TH AH M AE T IH K AH L
MATHEMATICALLY	M AE TH AH M AE T IH K AH L IY
MATHEMATICALLY(2)	M AE TH AH M AE T IH K L IY
MATHEMATICIAN	M AE TH AH M AH T IH SH AH N
MATHEMATICIANS	M AE TH AH M AH T IH SH AH N Z
MATHEMATICS	M AE TH AH M AE T IH K S
MATHEMATIZATION	M AE T HH EH M AH T AH Z EY SH AH N
MATHEMATIZATIONS	M AE T HH EH M AH T AH Z EY SH AH N Z
MATHEMATIZE	M AE T HH EH M AH T AY Z
MATHEMATIZED	M AE T HH EH M AH T AY Z D
MATHEMATIZES	M AE T HH EH M AH T AY Z IH Z
MATHEMATIZING	M AE T HH EH M AH T AY Z IH NG
MATHS	M AE TH S
MATZOTH	M AE T S AH TH
MEALYMOUTHED	M IY L IY M AW TH T
MEATHEAD	M IY T HH EH D
MEATHEADS	M IY T HH EH D Z
MEGADEATH	M EH G AH D EH TH
MEGADEATHS	M EH G AH D IY TH S
MEGALITH	M EH G AH L AH TH
MEGALITHIC	M EH G AH L AH TH AH K
MEGALITHS	M EH G AH L AH TH S
MEGILLOTH	M AH JH IH L AH TH
MENTHENE	M EH N TH IY N
MENTHENES	M EH N TH IY N Z
MENTHOL	M EH N TH AO L
MENTHOLATED	M EH N TH AH L EY T AH D
MENTHOLS	M EH N TH AH L Z
MERRYTHOUGHT	M EH R IY TH AO T
MERRYTHOUGHTS	M EH R IY TH AO T S
MESEEMETH	M IY S IY M AH TH
MESEMBRYANTHEMUM	M AH S EH M B R AY AE N TH AH M AH M
MESEMBRYANTHEMUMS	M AH S EH M B R AY AE N TH AH M AH M Z
MESOTHELIA	M EH S AH TH IY L Y AH
MESOTHELIAL	M EH S AH TH IY L IY AH L
MESOTHELIOMA	M EH S AH TH IY L IY OW M AH
MESOTHELIOMAS	M EH S AH TH AH L IY AH M AH Z
MESOTHELIOMATA	M AH S AH TH IY L IY AA M AH T AH
MESOTHELIUM	M EH S AH TH IY L IY AH M
MESOTHORACES	M EH S AH TH AO R AH S AH Z
MESOTHORACIC	M AH S AA TH AH R AH S AH K
MESOTHORAX	M EH Z AH TH AO R AE K S
MESOTHORAXES	M AH S AA TH AH R AH K S
METAETHICAL	M EH T AH EH TH IH K AH L
METAETHICS	M EH T AH EH TH IH K S
METALSMITH	M EH T AH L S M IH TH
METALSMITHS	M EH T AH L S M IH TH S
METAMATHEMATICAL	M EH T AH M AE TH AH M AE T IH K AH L
METAMATHEMATICS	M EH T AH M AE TH AH M AE T IH K S
METATHESES	M EH T AH TH IY S IY Z
METATHESIS	M EH T AH TH IY S AH S
METATHETIC	M EH T AH TH AH T AH K
METATHETICAL	M AH T AE TH AH T IH S AH L
METATHETICALLY	M EH T AH TH EH T AH K AE L IY
METATHORACES	M EH T AH TH AO R AH S AH Z
METATHORACIC	M AH T AE TH AH R AH S AH K
METATHORAX	M EH T AH TH AO R AE K S
METATHORAXES	M AH T AE TH AH R AH K S
METH	M EH TH
METHACRYLATE	M AH TH AE K R AH L EY T
METHACRYLATES	M AH TH AE K R AH L EY T S
METHADON	M EH TH AH D AH N
METHADONE	M EH TH AH D OW N
METHADONES	M EH TH AH D OW N Z
METHADONS	M EH TH AH D AH N Z
METHAMPHETAMINE	M EH TH AE M F EH T AH M IY N
METHAMPHETAMINE(2)	M EH TH AE M F EH T AH M AY N
METHAMPHETAMINES	M AH TH AE M F EH T AH M AY N Z
METHANATION	M EH TH AH N EY SH AH N
METHANATIONS	M EH TH AH N EY T IY AH N Z
METHANE	M EH TH EY N
METHANES	M AH TH EY N Z
METHANOL	M EH TH AH N AA L
METHANOLS	M EH TH AH N AH L Z
METHAQUALONE	M AH TH AE K W AH L OW N
METHAQUALONES	M AH TH AE K W AH L OW N Z
METHEDRINE	M EH TH AH D R AY N
METHEDRINES	M EH TH AH D R AY N Z
METHEGLIN	M AH TH EH G L AH N
METHEGLINS	M AH TH EH G L AH N Z
METHEMOGLOBIN	M EH T HH IY M AH G L OW B AH N
METHEMOGLOBINEMIA	M AH TH AH M AA G L AH B AH N IY M IY AH
METHEMOGLOBINEMIAS	M AH TH AH M AA G L AH B AH N IY M IY AH Z
METHEMOGLOBINS	M EH T HH IY M AH G L OW B AH N Z
METHENAMINE	M EH T HH EH N AH M AY N
METHENAMINES	M EH T HH EH N AH M AY N Z
METHICILLIN	M EH TH AH S IH L AH N
METHICILLINS	M EH TH AH S IH L AH N Z
METHINKS	M EH TH AH NG K S
METHIONINE	M EH TH IY AH N AY N
METHIONINES	M EH TH IY AH N AY N Z
METHOD	M EH TH AH D
METHODIC	M AH TH AA D IH K
METHODICAL	M AH TH AA D AH K AH L
METHODICAL(2)	M AH TH AA D IH K AH L
METHODICALLY	M AH TH AA D IH K AH L IY
METHODICALLY(2)	M AH TH AA D IH K L IY
METHODICALNESS	M AH TH AA D IH K AH L N AH S
METHODICALNESSES	M AH TH AA D IH K AH L N AH S IH Z
METHODISE	M EH TH AH D AY Z
METHODISED	M EH TH AH D IY Z D
METHODISES	M EH TH AH D IY Z IH Z
METHODISING	M EH TH AH D IY Z IH NG
METHODISM	M EH TH AH D IH Z AH M
METHODISMS	M EH TH AH D IH Z AH M Z
METHODIST	M EH TH AH D AH S T
METHODIST(2)	M EH TH AH D IH S T
METHODISTIC	M EH TH AH D IH S T IH K
METHODISTS	M EH TH AH D IH S T S
METHODIZE	M EH TH AH D AY Z
METHODIZED	M EH TH AH D AY Z D
METHODIZES	M EH TH AH D AY Z IH Z
METHODIZING	M EH TH AH D AY Z IH NG
METHODOLOGICAL	M EH TH AH D AH L AA JH IH K AH L
METHODOLOGICALLY	M EH TH AH D AH L AA JH IH K AH L IY
METHODOLOGIES	M EH TH OW D AA L AH JH IY Z
METHODOLOGIST	M EH TH AH D AA L AH JH AH S T
METHODOLOGISTS	M EH TH AH D AA L AH JH AH S T S
METHODOLOGY	M EH TH AH D AA L AH JH IY
METHODS	M EH TH AH D Z
METHOTREXATE	M EH TH OW T R EH K S EY T
METHOTREXATES	M EH T HH AA T R EH K S AH T S
METHOUGHT	M EH TH AO T
METHOXY	M AH TH AA K S IY
METHOXYCHLOR	M AH TH AA K S IH K L AH R
METHOXYCHLORS	M EH TH AH K S IH K L AH R Z
METHOXYFLURANE	M AH TH AH K S IH F L AH R EY N
METHOXYFLURANES	M AH TH AH K S IH F L AH R EY N Z
METHOXYL	M AH TH AA K S AH L
METHS	M EH TH S
METHYL	M EH TH AH L
METHYLAL	M EH TH AH L AH L
METHYLALS	M EH TH AH L AH L Z
METHYLAMINE	M EH TH AH L AH M AY N
METHYLAMINES	M EH TH AH L AH M AY N Z
METHYLASE	M EH TH AH L EY Z
METHYLASES	M EH TH AH L EY Z AH Z
METHYLATE	M EH TH AH L AH T
METHYLATED	M EH TH AH L EY T IH D
METHYLATES	M EH TH AH L AH T S
METHYLATING	M EH TH AH L EY T IH NG
METHYLATION	M EH TH AH L EY SH AH N
METHYLATIONS	M EH TH AH L EY SH AH N Z
METHYLATOR	M EH TH AH L AH T ER
METHYLATORS	M EH TH AH L AH T ER Z
METHYLCELLULOSE	M EH TH AH L S EH L Y AH L OW S
METHYLCELLULOSES	M EH TH AH L S EH L Y AH L OW S IH Z
METHYLCHOLANTHRENE	M AH TH IH L CH AA L AH N TH R IY N
METHYLCHOLANTHRENES	M AH TH IH L CH AA L AH N TH R IY N Z
METHYLDOPA	M AH TH IH L D AH P AH
METHYLDOPAS	M AH TH IH L D AH P AH Z
METHYLENE	M EH TH IH L IY N
METHYLENES	M EH TH AH L IY N Z
METHYLIC	M EH TH AH L IH K
METHYLMERCURIES	M EH TH AH L M ER K Y AH R IY Z
METHYLMERCURY	M EH TH AH L M ER K Y AH R IY
METHYLNAPHTHALENE	M AH TH AH L N AE F TH AH L IY N
METHYLNAPHTHALENES	M AH TH AH L N AE F TH AH L IY N Z
METHYLPHENIDATE	M AH TH IH L F EH N AH D EY T
METHYLPHENIDATES	M AH TH IH L F EH N AH D EY T S
METHYLPREDNISOLONE	M AH TH AH L P R EH D N IH S AH L OW N
METHYLPREDNISOLONES	M AH TH AH L P R EH D N IH S AH L OW N Z
METHYLS	M EH TH AH L Z
METHYLXANTHINE	M AH TH IH L K S AH N TH AY N
METHYLXANTHINES	M AH TH IH L K S AH N TH AY N Z
METHYSERGIDE	M AH TH IH S AH R JH AY D
METHYSERGIDES	M AH TH IH S AH R JH AY D Z
MEZUZOTH	M AH Z UW Z AH TH
MICROEARTHQUAKE	M AY K R OW ER TH K W EY K
MICROEARTHQUAKES	M AY K R OW ER TH K W EY K S
MICROLITH	M AY K R AH L IH TH
MICROLITHIC	M AY K R OW L AY DH IH K
MICROLITHS	M AY K R AH L IH TH S
MICROMETHOD	M AY K R OW M EH TH AH D
MICROMETHODS	M AY K R OW M EH TH AH D Z
MIDMONTH	M IH D M AH N TH
MIDMONTHS	M IH D M AH N TH S
MIDRASHOTH	M IH D R AH SH AH TH
MIKVOTH	M IH K V AH TH
MILLIONTH	M IH L Y AH N TH
MILLIONTHS	M IH L Y AH N T TH S
MIRTH	M ER TH
MIRTHFUL	M ER TH F AH L
MIRTHFULLY	M ER TH F AH L IY
MIRTHFULNESS	M ER TH F AH L N AH S
MIRTHFULNESSES	M ER TH F AH L N AH S IH Z
MIRTHLESS	M ER TH L AH S
MIRTHLESSLY	M ER TH L AH S L IY
MIRTHS	M ER TH S
MISANTHROPE	M IH S AH N TH R OW P
MISANTHROPES	M IH S AH N TH R OW P S
MISANTHROPIC	M IH S AH N TH R OW P IH K
MISANTHROPICALLY	M IH S AH N TH R OW P IH K AH L IY
MISANTHROPIES	M IH S AH N TH R OW P IY Z
MISANTHROPY	M IH S AH N TH R OW P IY
MISFAITH	M IH S F EY TH
MISFAITHS	M IH S F EY TH S
MISTHINK	M IH S TH IH NG K
MISTHINKING	M IH S TH IH NG K IH NG
MISTHINKS	M IH S TH IH NG K S
MISTHOUGHT	M IH S TH AO T
MISTHREW	M IH S TH R UW
MISTHROW	M IH S TH R OW
MISTHROWING	M IH S TH R OW IH NG
MISTHROWN	M IH S TH R OW N
MISTHROWS	M IH S TH R OW Z
MISTRUTH	M IH S T R UW TH
MISTRUTHS	M IH S T R UW TH S
MITHER	M IH DH AH R
MITHERS	M IH TH AH R Z
MITHRIDATE	M IH TH R IH D EY T
MITHRIDATES	M IH TH R IH D EY T S
MITSVOTH	M IH T S V AH TH
MITZVOTH	M IH T S V AH TH
MONOLITH	M AA N AH L IH TH
MONOLITHIC	M AA N AH L IH TH IH K
MONOLITHICALLY	M AA N AH L IH TH IH K AH L IY
MONOLITHS	M AA N AH L IH TH S
MONOPHTHONG	M AH N AA F TH AH NG
MONOPHTHONGAL	M AH N AA F TH AA N G AH L
MONOPHTHONGS	M AH N AA F TH AH NG Z
MONOTHEISM	M AA N AH TH IY IH Z AH M
MONOTHEISMS	M AA N AH TH IY Z AH M Z
MONOTHEIST	M AH N OW DH IY AH S T
MONOTHEISTIC	M AA N OW TH IY IH S T IH K
MONOTHEISTICAL	M AA N OW TH IY IH S T IH K AH L
MONOTHEISTICALLY	M AA N OW TH IY IH S T IH K AH L IY
MONOTHEISTS	M AA N AH TH IY S T S
MONTEITH	M AA N T IY IY TH
MONTEITHS	M AA N T IY IY TH S
MONTH	M AH N TH
MONTHLIES	M AH N TH L IY Z
MONTHLONG	M AH N TH L AO NG
MONTHLY	M AH N TH L IY
MONTHS	M AH N TH S
MOTH	M AO TH
MOTHBALL	M AO TH B AO L
MOTHBALLED	M AO TH B AO L D
MOTHBALLING	M AO TH B AO L IH NG
MOTHBALLS	M AO TH B AO L Z
MOTHER	M AH DH ER
MOTHERBOARD	M AH DH ER B OW R D
MOTHERBOARDS	M AH DH ER B OW R D Z
MOTHERED	M AH DH ER D
MOTHERFUCKER	M AH DH ER F AH K ER
MOTHERFUCKERS	M AH DH ER F AH K ER Z
MOTHERFUCKING	M AH DH ER F AH K IH NG
MOTHERHOOD	M AH DH ER HH UH D
MOTHERHOODS	M AH DH ER HH UH D Z
MOTHERHOUSE	M AH DH ER HH AW S
MOTHERHOUSES	M AH DH ER HH AW S IH Z
MOTHERING	M AH DH ER IH NG
MOTHERLAND	M AH DH ER L AE N D
MOTHERLANDS	M AH DH ER L AE N D Z
MOTHERLESS	M AH DH ER L IH S
MOTHERLESSNESS	M AH DH ER L AH S N AH S
MOTHERLESSNESSES	M AH DH ER L AH S N AH S IH Z
MOTHERLINESS	M AH DH ER L IY N AH S
MOTHERLINESSES	M AH DH ER L IY N AH S IH Z
MOTHERLY	M AH DH ER L IY
MOTHERS	M AH DH ER Z
MOTHERY	M AO TH AH R IY
MOTHIER	M AO TH IY ER
MOTHIEST	M AO TH IY AH S T
MOTHLIKE	M AO TH L AY K
MOTHPROOF	M AO TH P R UW F
MOTHPROOFED	M AO TH P R UW F T
MOTHPROOFER	M AO TH P R UW F ER
MOTHPROOFERS	M AO TH P R UW F ER Z
MOTHPROOFING	M AO TH P R UW F IH NG
MOTHPROOFS	M AO TH P R UW F S
MOTHS	M AO TH S
MOTHY	M AO TH IY
MOTORMOUTH	M OW T ER M AW TH
MOTORMOUTHS	M OW T ER M AW TH S
MOUTH	M AW TH
MOUTHBREEDER	M AW TH B R IY D ER
MOUTHBREEDERS	M AW TH B R IY D ER Z
MOUTHED	M AW DH D
MOUTHER	M AW TH ER
MOUTHERS	M AW TH ER Z
MOUTHFUL	M AW TH F UH L
MOUTHFULS	M AW TH F UH L Z
MOUTHIER	M AW TH IY ER
MOUTHIEST	M AW TH IY AH S T
MOUTHILY	M AW TH IY L IY
MOUTHING	M AW DH IH NG
MOUTHLIKE	M AW TH L AY K
MOUTHPART	M AW TH P AA R T
MOUTHPARTS	M AW TH P AA R T S
MOUTHPIECE	M AW TH P IY S
MOUTHPIECES	M AW TH P IY S IH Z
MOUTHS	M AW DH Z
MOUTHWASH	M AW TH W AA SH
MOUTHWASHES	M AW TH W AA SH IH Z
MOUTHWATERING	M AW TH W AO T ER IH NG
MOUTHWATERINGLY	M AW TH W AO T ER IH NG L IY
MOUTHY	M AW TH IY
MULTIAUTHOR	M AH L T AY AO TH ER
MULTIETHNIC	M AH L T IY EH TH N IH K
MULTIPATH	M AH L T AY P AE TH
MULTIWAVELENGTH	M AH L T AY W EY V L EH NG TH
MURTHER	M AH R DH AH R
MURTHERED	M AH R TH IY R D
MURTHERING	M AH R TH IY R AH NG
MURTHERS	M AH R TH AH R Z
MUSTH	M AH S TH
MUSTHS	M AH S TH S
MYASTHENIA	M AY AH S TH IY N Y AH
MYASTHENIAS	M AY AH S TH IY N Y AH Z
MYASTHENIC	M AY AE S TH AH N AH K
MYASTHENICS	M AY AE S TH AH N AH S Z
MYELOPATHIC	M AY EH L AH P AH TH AH K
MYELOPATHIES	M AY AH L AA P AH TH AY Z
MYELOPATHY	M AY AH L AA P AH TH IY
MYOPATHIC	M AY AH P AH TH AH K
MYOPATHIES	M AY AA P AH TH AY Z
MYOPATHY	M AY AA P AH TH IY
MYTH	M IH TH
MYTHIC	M IH TH IH K
MYTHICAL	M IH TH AH K AH L
MYTHICAL(2)	M IH TH IH K AH L
MYTHICALLY	M IH TH IH K AH L IY
MYTHICIZE	M IH TH IH K S AY Z
MYTHICIZED	M IH TH IH K S AY Z D
MYTHICIZER	M IH TH IH K S AY Z ER
MYTHICIZERS	M IH TH IH K S AY Z ER Z
MYTHICIZES	M IH TH IH K S AY Z IH Z
MYTHICIZING	M IH TH IH K S AY Z IH NG
MYTHIER	M IH TH IY ER
MYTHIEST	M IH TH IY AH S T
MYTHMAKER	M IH TH M EY K ER
MYTHMAKERS	M IH TH M EY K ER Z
MYTHMAKING	M IH TH M EY K IH NG
MYTHMAKINGS	M IH TH M EY K IH NG Z
MYTHOGRAPHER	M AH TH AA G R AH F AH R
MYTHOGRAPHERS	M AH TH AA G R AH F AH R Z
MYTHOGRAPHIES	M AH TH AA G R AH F AY Z
MYTHOGRAPHY	M AH TH AA G R AH F IY
MYTHOI	M IH TH OY
MYTHOLOGER	M IH TH AH L OW JH AH R
MYTHOLOGERS	M AH TH AA L AH JH AH R Z
MYTHOLOGIC	M IH TH AH L AA JH IH K
MYTHOLOGICAL	M IH TH AH L AA JH IH K AH L
MYTHOLOGICALLY	M IH TH AH L AA JH IH K AH L IY
MYTHOLOGIES	M IH TH AA L AH JH IY Z
MYTHOLOGIST	M IH TH AA L AH JH AH S T
MYTHOLOGISTS	M IH TH AA L AH JH AH S T S
MYTHOLOGIZE	M AH TH AA L AH JH AY Z
MYTHOLOGIZED	M AH TH AA L AH JH AY Z D
MYTHOLOGIZER	M AH TH AA L AH JH AY Z AH R
MYTHOLOGIZERS	M IH TH AH L AA JH AH Z AH R Z
MYTHOLOGIZES	M AH TH AA L AH JH AY Z AH Z
MYTHOLOGIZING	M AH TH AA L AH JH AY Z AH NG
MYTHOLOGY	M AH TH AA L AH JH IY
MYTHOMANIA	M IH TH AH M EY N Y AH
MYTHOMANIAC	M IH TH AH M EY N IY AH K
MYTHOMANIACS	M IH TH AH M EY N IY AH S
MYTHOMANIAS	M IH TH AH M EY N Y AH Z
MYTHOPOEIA	M IH TH AH P OW EH IY AH
MYTHOPOEIAS	M IH TH AH P OW EH IY AH Z
MYTHOPOEIC	M AH TH AA P OW AH AH K
MYTHOPOETIC	M AH TH AA P OW AH T AH K
MYTHOPOETICAL	M IH TH AH P OW AH T IH S AH L
MYTHOS	M IH TH AA S
MYTHS	M IH TH S
MYTHY	M IH TH IY
NAETHING	N IY DH AH NG
NAETHINGS	N IY TH AH NG Z
NAPHTHA	N AE F TH AH
NAPHTHALENE	N AE F TH AH L IY N
NAPHTHALENES	N AE F TH AH L IY N Z
NAPHTHAS	N AE F TH AH Z
NAPHTHENE	N AE F TH IY N
NAPHTHENES	N AE F TH IY N Z
NAPHTHENIC	N AE F TH AH N AH K
NAPHTHOL	N AE F TH AH L
NAPHTHOLS	N AE F TH AH L Z
NAPHTHYL	N AE F TH AH L
NAPHTHYLAMINE	N AE F TH IH L AH M AY N
NAPHTHYLAMINES	N AE F TH IH L AH M AY N Z
NAPHTHYLS	N AE F TH AH L Z
NAPRAPATHIES	N AE P R AE P AH TH AY Z
NAPRAPATHY	N AE P R AE P AH TH IY
NARTHEX	N AA R TH AH K S
NARTHEXES	N AA R TH AH K S
NATHELESS	N EY DH L AH S
NATHLESS	N AE TH L AH S
NATUROPATH	N EY CH AH R AH P AE TH
NATUROPATHIC	N EY CH AH R AH P AE TH IH K
NATUROPATHIES	N EY CH AH R AH P AE TH IY Z
NATUROPATHS	N EY CH AH R AH P AE TH S
NATUROPATHY	N EY CH AH R AH P AE TH IY
NEANDERTHAL	N IY AE N D ER TH AO L
NEANDERTHALS	N IY AE N D ER TH AO L Z
NEATH	N IY TH
NEATHERD	N IY T HH ER D
NEATHERDS	N IY T HH ER D Z
NEITHER	N IY DH ER
NEITHER(2)	N AY DH ER
NEOLITH	N IY AH L IH TH
NEOLITHIC	N IY OW L AY DH IH K
NEOLITHS	N IY AH L IH TH S
NEOORTHODOX	N IY OW AO R TH AH D AA K S
NEOORTHODOXIES	N IY OW AO R TH AH D AA K S IY Z
NEOORTHODOXY	N IY OW AO R TH AH D AA K S IY
NEPENTHE	N EH P EH N TH IY
NEPENTHEAN	N AH P EH N DH IY AH N
NEPENTHES	N EH P AH N DH Z
NEPHROPATHIC	N EH F R AH P AH TH AH K
NEPHROPATHIES	N EH F R AA P AH TH AY Z
NEPHROPATHY	N EH F R AA P AH TH IY
NETHER	N EH DH ER
NETHERMOST	N EH DH ER M OW S T
NETHERWORLD	N EH DH ER W ER L D
NETHERWORLDS	N EH DH ER W ER L D Z
NEURASTHENIA	N UH R AE S TH IY N IY AH
NEURASTHENIAS	N Y UH R AH S TH IY N Y AH Z
NEURASTHENIC	N UH R AH S TH EH N IH K
NEURASTHENICALLY	N UH R AH S TH EH N IH K AH L IY
NEURASTHENICS	N UH R AH S TH EH N IH K S
NEUROPATHIC	N Y UH R AH P AH TH AH K
NEUROPATHICALLY	N Y UH R AH P AE TH AH K AE L IY
NEUROPATHIES	N Y AH R AA P AH TH AY Z
NEUROPATHOLOGIC	N Y UH R AH P AE TH AH L AH JH AH K
NEUROPATHOLOGICAL	N Y UH R AH P AH TH AA L AH JH IH S AH L
NEUROPATHOLOGIES	N Y UH R AH P AH TH AA L AH JH AY Z
NEUROPATHOLOGIST	N Y UH R AH P AH TH AA L AH JH AH S T
NEUROPATHOLOGISTS	N Y UH R AH P AH TH AA L AH JH AH S T S
NEUROPATHOLOGY	N Y UH R AH P AH TH AA L AH JH IY
NEUROPATHY	N UH R OW P AE TH IY
NEUROPATHY(2)	N UH R AO P AH TH IY
NEUROPATHY(3)	N Y UH R OW P AE TH IY
NEVERTHELESS	N EH V ER DH AH L EH S
NEWSWORTHINESS	N UW Z W ER DH IY N AH S
NEWSWORTHINESSES	N UW Z W ER DH IY N AH S IH Z
NEWSWORTHY	N UW Z W ER DH IY
NIGHTCLOTHES	N AY T K L OW DH Z
NIGHTHAWK	N AY T HH AO K
NIGHTHAWKS	N AY T HH AO K S
NINETEENTH	N AY N T IY N TH
NINETEENTHS	N AY N T IY N TH S
NINETIETH	N AY N T IY IH TH
NINETIETHS	N AY N T IY IH TH S
NINTH	N AY N TH
NINTHLY	N AY N TH L IY
NINTHS	N AY N TH S
NITROMETHANE	N IH T R AA M AH TH EY N
NITROMETHANES	N IH T R AA M AH TH EY N Z
NOMOTHETIC	N AA M AH TH AH T AH K
NONAESTHETIC	N AA N EH S TH EH T IH K
NONANTHROPOLOGICAL	N AA N AE N TH R AH P AH L AA JH IH K AH L
NONANTHROPOLOGIST	N AH N AE N TH R AH P AA L AH JH AH S T
NONANTHROPOLOGISTS	N AH N AE N TH R AH P AA L AH JH AH S T S
NONATHLETE	N AA N AE TH L IY T
NONATHLETES	N AA N AE TH L IY T S
NONATHLETIC	N AA N AE TH L EH T IH K
NONAUTHOR	N AA N AO TH ER
NONAUTHORITARIAN	N AA N AH TH AO R AH T EH R IY AH N
NONAUTHORS	N AA N AO TH ER Z
NONBREATHING	N AA N B R IY DH IH NG
NONETHELESS	N AH N DH AH L EH S
NONETHICAL	N AA N EH TH IH K AH L
NONETHNIC	N AA N EH TH N IH K
NONGROWTH	N AA N G R OW TH
NONLETHAL	N AA N L IY TH AH L
NONMATHEMATICAL	N AA N M AE TH AH M AE T IH K AH L
NONMATHEMATICIAN	N AA N M AE TH AH M AH T IH SH AH N
NONMATHEMATICIANS	N AA N M AE TH AH M AH T IH SH AH N Z
NONORTHODOX	N AA N AO R TH AH D AA K S
NONPATHOGENIC	N AA N P AE TH AH JH EH N IH K
NONTHEATRICAL	N AA N TH IY AE T R IH K AH L
NONTHEIST	N AA N DH IY AH S T
NONTHEISTIC	N AA N TH IY IH S T IH K
NONTHEISTS	N AA N TH IY S T S
NONTHEOLOGICAL	N AA N TH IY AH L AA JH IH K AH L
NONTHEORETICAL	N AA N TH IY AH R EH T IH K AH L
NONTHERAPEUTIC	N AA N TH EH R AH P Y UW T IH K
NONTHERMAL	N AA N TH ER M AH L
NONTHINKING	N AA N TH IH NG K IH NG
NONTHINKINGS	N AA N TH IH NG K IH NG Z
NONTHREATENING	N AA N TH R EH T AH N IH NG
NONTRUTH	N AA N T R UW TH
NONTRUTHS	N AA N T R UW TH S
NORETHINDRONE	N AH R EH TH AH N D R OW N
NORETHINDRONES	N AH R EH TH AH N D R OW N Z
NORMOTHERMIA	N AO R M AH TH AH R M IY AH
NORMOTHERMIAS	N AO R M AH TH AH R M IY AH Z
NORMOTHERMIC	N AO R M AH TH AH R M AH K
NORTH	N AO R TH
NORTHBOUND	N AO R TH B AW N D
NORTHEAST	N AO R TH IY S T
NORTHEASTER	N AO R TH IY S T ER
NORTHEASTERLY	N AO R TH IY S T ER L IY
NORTHEASTERN	N AO R TH IY S T ER N
NORTHEASTERNMOST	N AO R TH IY S T ER N M OW S T
NORTHEASTERS	N AO R TH IY S T ER Z
NORTHEASTS	N AO R TH IY S T S
NORTHEASTWARD	N AO R TH IY S T W ER D
NORTHEASTWARDS	N AO R TH IY S T W ER D Z
NORTHER	N AO R DH ER
NORTHERLIES	N AO R DH ER L IY Z
NORTHERLY	N AO R DH ER L IY
NORTHERN	N AO R DH ER N
NORTHERNER	N AO R DH ER N ER
NORTHERNERS	N AO R DH ER N ER Z
NORTHERNMOST	N AO R DH ER N M OW S T
NORTHERNS	N AO R DH ER N Z
NORTHERS	N AO R DH ER Z
NORTHING	N AO R TH IH NG
NORTHINGS	N AO R TH IH NG Z
NORTHLAND	N AO R TH L AE N D
NORTHLANDS	N AO R TH L AE N D Z
NORTHS	N AO R TH S
NORTHWARD	N AO R TH W ER D
NORTHWARDS	N AO R TH W ER D Z
NORTHWEST	N AO R TH W EH S T
NORTHWESTER	N AO R TH W EH S T ER
NORTHWESTERLY	N AO R TH W EH S T ER L IY
NORTHWESTERN	N AO R TH W EH S T ER N
NORTHWESTERNMOST	N AO R TH W EH S T ER N M OW S T
NORTHWESTERS	N AO R TH W EH S T ER Z
NORTHWESTS	N AO R TH W EH S T S
NORTHWESTWARD	N AO R TH W EH S T W ER D
NORTHWESTWARDS	N AO R TH W EH S T W ER D Z
NOTEWORTHILY	N OW T W ER DH IY L IY
NOTEWORTHINESS	N OW T W ER DH IY N AH S
NOTEWORTHINESSES	N OW T W ER DH IY N AH S IH Z
NOTEWORTHY	N OW T W ER DH IY
NOTHER	N AH DH ER
NOTHING	N AH TH IH NG
NOTHINGNESS	N AH TH IH NG N AH S
NOTHINGNESSES	N AH TH IH NG N AH S IH Z
NOTHINGS	N AH TH IH NG Z
NOTWITHSTANDING	N AA T W IH TH S T AE N D IH NG
NOWHITHER	N OW HH AH DH AH R
NTH	EH N TH
NUCLEOSYNTHESES	N AH K L IY AA S AH N TH IY Z AH Z
NUCLEOSYNTHESIS	N AH K L IY AH S IH N DH AH S AH S
NUCLEOSYNTHETIC	N AH K L IY AH S IH N TH AH T AH K
NUTHATCH	N AH T HH AE CH
NUTHATCHES	N AH T HH AE CH IH Z
NUTHOUSE	N AH T HH AW S
NUTHOUSES	N AH T HH AW S IH Z
OASTHOUSE	OW S TH AW Z
OASTHOUSES	OW S TH AW Z AH Z
OATH	OW TH
OATHS	OW DH Z
OATHS(2)	OW TH S
OCTOTHORP	AA K T AH TH AH R P
OCTOTHORPS	AA K T AH TH AH R P S
OILCLOTH	OY L K L AO TH
OILCLOTHS	OY L K L AO TH S
OOLITH	UW L AH TH
OOLITHS	UW L AH TH S
OOTHECA	UW TH AH K AH
OOTHECAE	UW TH AH K IY
OOTHECAL	UW TH AH K AH L
OPENMOUTHED	OW P AH N M AW TH T
OPENMOUTHEDLY	OW P AH N M AW TH AH D L IY
OPENMOUTHEDNESS	OW P AH N M AW TH AH D N AH S
OPENMOUTHEDNESSES	OW P AH N M AW TH AH D N AH S IH Z
OPHTHALMIA	AA F TH AE L M IY AH
OPHTHALMIAS	AA F TH AE L M IY AH Z
OPHTHALMIC	AA F TH AE L M IH K
OPHTHALMOLOGIC	AA F TH AE L M AH L AH JH AH K
OPHTHALMOLOGICAL	AA F TH AE L M AA L AH JH IH S AH L
OPHTHALMOLOGICALLY	AA F TH AE L M AH L AA JH AH K AE L IY
OPHTHALMOLOGIES	AA F TH AE L M AA L AH JH AY Z
OPHTHALMOLOGIST	AA P TH AH M AA L AH JH IH S T
OPHTHALMOLOGIST(2)	AA F TH AH M AA L AH JH IH S T
OPHTHALMOLOGISTS	AA P TH AH M AA L AH JH IH S T S
OPHTHALMOLOGISTS(2)	AA P TH AH M AA L AH JH IH S
OPHTHALMOLOGISTS(3)	AA F TH AH M AA L AH JH IH S T S
OPHTHALMOLOGISTS(4)	AA F TH AH M AA L AH JH IH S
OPHTHALMOLOGY	AA P TH AH M AA L AH JH IY
OPHTHALMOLOGY(2)	AA F TH AH M AA L AH JH IY
OPHTHALMOSCOPE	AA F TH AE L M AH S K OW P
OPHTHALMOSCOPES	AA F TH AE L M AH S OW P S
OPHTHALMOSCOPIC	AA F TH AH L M AA S AH P AH K
OPHTHALMOSCOPIES	AA F TH AH L M AA S AH P AY Z
OPHTHALMOSCOPY	AA F TH AH L M AA S AH P IY
OPISTHOBRANCH	AA P AH S TH AA B R AH N CH
OPISTHOBRANCHS	AA P AH S TH AA B R AH N CH S
ORNITHES	AO R N AH DH Z
ORNITHIC	AO R N AH TH AH K
ORNITHINE	AO R N AH TH AY N
ORNITHINES	AO R N AH TH AY N Z
ORNITHISCHIAN	AO R N AH TH IH S IY AH N
ORNITHISCHIANS	AO R N AH TH IH S IY AH N Z
ORNITHOLOGIC	AO R N IH TH AH L AH JH AH K
ORNITHOLOGICAL	AO R N IH TH AH L AO JH IH K AH L
ORNITHOLOGICALLY	AO R N AH TH AH L AA JH AH K AE L IY
ORNITHOLOGIES	AO R N AH TH AA L AH JH AY Z
ORNITHOLOGIST	AO R N AH TH AA L AH JH AH S T
ORNITHOLOGISTS	AO R N AH TH AA L AH JH AH S T S
ORNITHOLOGY	AO R N IH TH AA L AH JH IY
ORNITHOPOD	AO R N IH TH AH P AH D
ORNITHOPODS	AO R N IH TH AH P AH D Z
ORNITHOPTER	AO R N AH TH AA P T AH R
ORNITHOPTERS	AO R N AH TH AA P T AH R Z
ORNITHOSES	AO R N AH TH OW Z AH Z
ORNITHOSIS	AO R N AH TH OW S AH S
ORTHICON	AO R TH AH K AA N
ORTHICONS	AO R TH AH K AA N Z
ORTHO	AO R TH OW
ORTHOCENTER	AO R TH AH S EH N T AH R
ORTHOCENTERS	AO R TH AH S EH N T AH R Z
ORTHOCHROMATIC	AO R TH AA K R AH M AH T AH K
ORTHOCLASE	AO R TH AH K L EY S
ORTHOCLASES	AO R TH AH K L EY Z AH Z
ORTHODONTIA	AO R TH AH D AA N CH IY AH
ORTHODONTIAS	AO R TH AH D AA N T IY AH Z
ORTHODONTIC	AO R TH AH D AA N T IH K
ORTHODONTICALLY	AO R TH AH D AA N T IH K AH L IY
ORTHODONTICS	AO R TH AH D AA N T IH K S
ORTHODONTIST	AO R TH AH D AA N T AH S T
ORTHODONTISTS	AO R TH AH D AA N T AH S T S
ORTHODOX	AO R TH AH D AA K S
ORTHODOXES	AO R TH AH D AA K S IH Z
ORTHODOXIES	AO R TH AH D AA K S IY Z
ORTHODOXLY	AO R TH AH D AA K S L IY
ORTHODOXY	AO R TH AH D AA K S IY
ORTHOEPIC	AO R TH OW AH P AH K
ORTHOEPICALLY	AO R TH OW EH P AH K AE L IY
ORTHOEPIES	AO R TH OW AH P AY Z
ORTHOEPIST	AO R TH OW AH P AH S T
ORTHOEPISTS	AO R TH OW AH P AH S T S
ORTHOEPY	AO R TH OW AH P IY
ORTHOGENESES	AO R TH AA JH AH N IY Z AH Z
ORTHOGENESIS	AO R TH AH JH IY N AH S AH S
ORTHOGENETIC	AO R TH AA JH AH N AH T AH K
ORTHOGENETICALLY	AO R TH AH JH AH N EH T AH K AE L IY
ORTHOGONAL	AO R TH AO G AH N AH L
ORTHOGONALITIES	AO R TH AH G AH N AE L AH T AY Z
ORTHOGONALITY	AO R TH AA G AH N AE L AH T IY
ORTHOGONALIZATION	AO R TH AH G AH N AH L AH Z EY SH AH N
ORTHOGONALIZATIONS	AO R TH AH G AA N AH L AH Z EY T IY AH N Z
ORTHOGONALIZE	AO R TH AH G AA N AH L AY Z
ORTHOGONALIZED	AO R TH AH G AA N AH L AY Z D
ORTHOGONALIZES	AO R TH AH G AA N AH L AY Z AH Z
ORTHOGONALIZING	AO R TH AH G AA N AH L AY Z AH NG
ORTHOGONALLY	AO R TH AA G AH N AE L IY
ORTHOGRADE	AO R TH AH G R EY D
ORTHOGRAPHIC	AO R TH AH G R AE F IH K
ORTHOGRAPHICAL	AO R TH AH G R AE F IH K AH L
ORTHOGRAPHICALLY	AO R TH AH G R AE F IH K AH L IY
ORTHOGRAPHIES	AO R TH AA G R AH F IY Z
ORTHOGRAPHY	AO R TH AA G R AH F IY
ORTHOMOLECULAR	AO R TH AA M AH L EH K Y AH L AH R
ORTHONORMAL	AO R TH AH N AO R M AH L
ORTHOPAEDIC	AO R TH AH P IY D AH K
ORTHOPAEDICS	AO R TH AH P IY D AH S Z
ORTHOPEDIC	AO R TH AH P IY D IH K
ORTHOPEDICALLY	AO R TH AH P IY D IH K AH L IY
ORTHOPEDICS	AO R TH AH P IY D IH K S
ORTHOPEDIST	AO R TH AH P IY D AH S T
ORTHOPEDISTS	AO R TH AH P IY D AH S T S
ORTHOPHOSPHATE	AO R TH AH F AA S F EY T
ORTHOPHOSPHATES	AO R TH AH F AA S F EY T S
ORTHOPSYCHIATRIC	AO R TH AH S AY K IY AH T R AH K
ORTHOPSYCHIATRIES	AO R TH AH S AY K IY AE T R AY Z
ORTHOPSYCHIATRIST	AO R TH AH S AY K IY AE T R AH S T
ORTHOPSYCHIATRISTS	AO R TH AH S AY K IY AE T R AH S T S
ORTHOPSYCHIATRY	AO R TH AH S AY K IY AE T R IY
ORTHOPTERA	AO R TH AA P T AH R AH
ORTHOPTERAN	AO R TH AA P T AH R AH N
ORTHOPTERANS	AO R TH AA P T AH R AH N Z
ORTHOPTERIST	AO R TH AA P T AH R AH S T
ORTHOPTERISTS	AO R TH AA P T AH R AH S T S
ORTHOPTEROID	AO R TH AA P T AH R OY D
ORTHOPTEROIDS	AO R TH AA P T AH R OY D Z
ORTHORHOMBIC	AO R TH AH R AA M B IH K
ORTHOSCOPIC	AO R TH AA S AH P AH K
ORTHOSES	AO R TH OW Z AH Z
ORTHOSIS	AO R TH OW S AH S
ORTHOSTATIC	AO R TH AA S T AH T AH K
ORTHOTIC	AO R TH AH T AH K
ORTHOTICS	AO R TH AH T AH S Z
ORTHOTIST	AO R TH AH T AH S T
ORTHOTISTS	AO R TH AH T AH S T S
ORTHOTROPOUS	AO R TH AA T R AH P AH S
OSTEOARTHRITIC	AA S T IY OW R TH R AH T AH K
OSTEOARTHRITIDES	AA S T IY OW R TH R AH T AY D Z
OSTEOARTHRITIS	AA S T IY OW AA R TH R AY T AH S
OSTEOPATH	AA S T IY AH P AH TH
OSTEOPATHIC	AA S T IY AH P AE TH IH K
OSTEOPATHICALLY	AA S T IY AH P AE TH AH K AE L IY
OSTEOPATHIES	AA S T IY AA P AH TH AY Z
OSTEOPATHS	AA S T IY AH P AH TH S
OSTEOPATHY	AA S T IY AA P AH TH IY
OTHER	AH DH ER
OTHERGUESS	AH DH ER G EH S
OTHERNESS	AH DH ER N AH S
OTHERNESSES	AH DH ER N AH S IH Z
OTHERS	AH DH ER Z
OTHERWHERE	AH TH AH R W HH AH R
OTHERWHILE	AH TH AH R W AH L
OTHERWHILES	AH TH AH R W AH L Z
OTHERWISE	AH DH ER W AY Z
OTHERWORLD	AH DH ER W ER L D
OTHERWORLDLINESS	AH DH ER W ER L D L IY N AH S
OTHERWORLDLINESSES	AH DH ER W ER L D L IY N AH S IH Z
OTHERWORLDLY	AH DH ER W ER L D L IY
OTHERWORLDS	AH DH ER W ER L D Z
OTOLITH	AA T AH L AH TH
OTOLITHIC	AA T AH L AH TH AH K
OTOLITHS	AA T AH L AH TH S
OUTGROWTH	AW T G R OW TH
OUTGROWTHS	AW T G R OW TH S
OUTHAUL	AW T HH AO L
OUTHAULS	AW T HH AO L Z
OUTHEAR	AW T HH IH ER
OUTHEARD	AW T HH ER D
OUTHEARING	AW T HH IH ER IH NG
OUTHEARS	AW T HH IH ER Z
OUTHIT	AW T HH IH T
OUTHITS	AW T HH IH T S
OUTHITTING	AW T HH IH T IH NG
OUTHOMER	AW T HH OW M ER
OUTHOMERED	AW T HH OW M ER D
OUTHOMERING	AW T HH OW M ER IH NG
OUTHOMERS	AW T HH OW M ER Z
OUTHOUSE	AW T HH AW S
OUTHOUSES	AW T HH AW S IH Z
OUTHOWL	AW T HH AW L
OUTHOWLED	AW T HH AW L D
OUTHOWLING	AW T HH AW L IH NG
OUTHOWLS	AW T HH AW L Z
OUTHUMOR	AW T HH Y UW M ER
OUTHUMORED	AW T HH Y UW M ER D
OUTHUMORING	AW T HH Y UW M ER IH NG
OUTHUMORS	AW T HH Y UW M ER Z
OUTHUNT	AW T HH AH N T
OUTHUNTED	AW T HH AH N T IH D
OUTHUNTING	AW T HH AH N T IH NG
OUTHUNTS	AW T HH AH N T S
OUTHUSTLE	AW T HH AH S AH L
OUTHUSTLED	AW T HH AH S AH L D
OUTHUSTLES	AW T HH AH S AH L Z
OUTHUSTLING	AW T HH AH S AH L IH NG
OUTTHANK	AW T TH AE NG K
OUTTHANKED	AW T TH AE NG K T
OUTTHANKING	AW T TH AE NG K IH NG
OUTTHANKS	AW T TH AE NG K S
OUTTHINK	AW T TH IH NG K
OUTTHINKING	AW T TH IH NG K IH NG
OUTTHINKS	AW T TH IH NG K S
OUTTHOUGHT	AW T TH AO T
OUTTHREW	AW T TH R UW
OUTTHROB	AW T TH R AA B
OUTTHROBBED	AW T TH R AA B D
OUTTHROBBING	AW T TH R AA B IH NG
OUTTHROBS	AW T TH R AA B Z
OUTTHROW	AW T TH R OW
OUTTHROWING	AW T TH R OW IH NG
OUTTHROWN	AW T TH R OW N
OUTTHROWS	AW T TH R OW Z
OUTTHRUST	AW T TH R AH S T
OUTTHRUSTING	AW T TH R AH S T IH NG
OUTTHRUSTS	AW T TH R AH S T S
OVERBREATHING	OW V ER B R IY DH IH NG
OVERBREATHINGS	OW V ER B R IY DH IH NG Z
OVERENTHUSIASM	OW V ER IH N TH UW Z IY AE Z AH M
OVERENTHUSIASMS	OW V ER IH N TH UW Z IY AE Z AH M Z
OVERENTHUSIASTIC	OW V ER IH N TH UW Z IY AE S T IH K
OVERENTHUSIASTICALLY	OW V ER IH N TH UW Z IY AE S T IH K AH L IY
OVERGROWTH	OW V ER G R OW TH
OVERGROWTHS	OW V ER G R OW TH S
OVERLENGTH	OW V ER L EH NG TH
OVERLENGTHEN	OW V ER L EH NG TH AH N
OVERLENGTHENED	OW V ER L EH NG TH AH N D
OVERLENGTHENING	OW V ER L EH NG TH AH N IH NG
OVERLENGTHENS	OW V ER L EH NG TH AH N Z
OVERTHIN	OW V ER TH IH N
OVERTHINK	OW V ER TH IH NG K
OVERTHINKING	OW V ER TH IH NG K IH NG
OVERTHINKS	OW V ER TH IH NG K S
OVERTHOUGHT	OW V ER TH AO T
OVERTHREW	OW V ER TH R UW
OVERTHROW	OW V ER TH R OW
OVERTHROWING	OW V ER TH R OW IH NG
OVERTHROWN	OW V ER TH R OW N
OVERTHROWS	OW V ER TH R OW Z
OVERWITHHELD	OW V ER W IH TH HH EH L D
OVERWITHHOLD	OW V ER W IH TH HH OW L D
OVERWITHHOLDING	OW V ER W IH TH HH OW L D IH NG
OVERWITHHOLDS	OW V ER W IH TH HH OW L D Z
PACKTHREAD	P AE K TH R EH D
PACKTHREADS	P AE K TH R EH D Z
PALEOANTHROPOLOGICAL	P EY L IY OW N TH R AH P AA L AH JH IH S AH L
PALEOANTHROPOLOGIES	P EY L IY OW N TH R AH P AA L AH JH AY Z
PALEOANTHROPOLOGIST	P EY L IY OW N TH R AH P AA L AH JH AH S T
PALEOANTHROPOLOGISTS	P EY L IY OW N TH R AH P AA L AH JH AH S T S
PALEOANTHROPOLOGY	P EY L IY OW N TH R AH P AA L AH JH IY
PALEOPATHOLOGICAL	P EY L IY AH P AH TH AA L AH JH IH S AH L
PALEOPATHOLOGIES	P EY L IY AH P AH TH AA L AH JH AY Z
PALEOPATHOLOGIST	P EY L IY AH P AH TH AA L AH JH AH S T
PALEOPATHOLOGISTS	P EY L IY AH P AH TH AA L AH JH AH S T S
PALEOPATHOLOGY	P EY L IY AH P AH TH AA L AH JH IY
PANTHEISM	P AE N DH IY IH Z AH M
PANTHEISMS	P AE N TH IY Z AH M Z
PANTHEIST	P AE N TH IY AH S T
PANTHEISTIC	P AE N TH IY IH S T IH K
PANTHEISTICAL	P AE N TH IY AH S T IH K AH L
PANTHEISTICALLY	P AE N TH IY AH S T IH K AH L IY
PANTHEISTS	P AE N TH IY AH S T S
PANTHEON	P AE N TH IY AA N
PANTHEONS	P AE N TH IY AA N Z
PANTHER	P AE N TH ER
PANTHERS	P AE N TH ER Z
PANTOTHENATE	P AE N T AA T HH EH N AH T
PANTOTHENATES	P AE N T AA T HH EH N AH T S
PARAESTHESIA	P AE R IY S TH IY ZH IY AH
PARAESTHESIAS	P AE R IY S TH IY S IY AH Z
PARASHIOTH	P AH R AE SH IY AH TH
PARASHOTH	P AE R AH SH AH TH
PARASYMPATHETIC	P EH R AH S IH M P AH TH EH T IH K
PARASYMPATHETICS	P AE R AH S IH M P AH TH EH T IH K S
PARASYMPATHOMIMETIC	P AH R AH S IH M P AH TH AA M AH M AH T AH K
PARASYNTHESES	P AH R AE S AH N TH IY Z AH Z
PARASYNTHESIS	P AA R AH S IH N TH AH S AH S
PARASYNTHETIC	P AA R AH S IH N TH EH T IH K
PARATHION	P AH R AE TH IY AH N
PARATHIONS	P AH R AE TH IY AH N Z
PARATHORMONE	P AH R AE TH AH R M OW N
PARATHORMONES	P AH R AE TH AH R M OW N Z
PARATHYROID	P AA R AH TH AY R OY D
PARATHYROIDECTOMIES	P AH R AE TH AH R OY D EH K T AH M AY Z
PARATHYROIDECTOMIZED	P AE R AH TH AH R OY D EH K T AH M AY Z D
PARATHYROIDECTOMY	P AH R AE TH AH R OY D EH K T AH M IY
PARATHYROIDS	P AA R AH TH AY R OY D Z
PARENTHESES	P ER EH N TH AH S IY Z
PARENTHESIS	P ER EH N TH AH S IH S
PARENTHESIZE	P EH R AH N TH S AY Z
PARENTHESIZED	P EH R AH N TH S AY Z D
PARENTHESIZES	P EH R AH N TH S AY Z IH Z
PARENTHESIZING	P EH R AH N TH S AY Z IH NG
PARENTHETIC	P AE R AH N TH EH T IH K
PARENTHETICAL	P ER EH N TH EH T IH K AH L
PARENTHETICALLY	P ER EH N TH EH T IH K AH L IY
PARENTHETICALLY(2)	P ER EH N TH EH T IH K L IY
PARENTHOOD	P EH R AH N T HH UH D
PARENTHOODS	P AE R AH N T HH UH D Z
PARESTHESIA	P AE R AH S TH IY ZH IY AH
PARESTHESIAS	P AE R AH S TH IY S IY AH Z
PARESTHETIC	P AA R EH S TH EH T IH K
PARTHENOCARPIC	P AA R TH EH N AH K AH R P AH K
PARTHENOCARPIES	P AA R TH AH N AH K AA R P AY Z
PARTHENOCARPY	P AA R TH EH N AH K AA R P IY
PARTHENOGENESES	P AA R TH AH N AA JH AH N IY Z AH Z
PARTHENOGENESIS	P AA R TH AH N AH JH IY N AH S AH S
PARTHENOGENETIC	P AA R TH AH N OW JH AH N EH T IH K
PARTHENOGENETICALLY	P AA R TH EH N AH JH AH N EH T AH K AE L IY
PATH	P AE TH
PATHBREAKING	P AE TH B R EY K IH NG
PATHETIC	P AH TH EH T IH K
PATHETICAL	P AH TH EH T IH K AH L
PATHETICALLY	P AH TH EH T IH K AH L IY
PATHETICALLY(2)	P AH TH EH T IH K L IY
PATHFINDER	P AE TH F AY N D ER
PATHFINDERS	P AE TH F AY N D ER Z
PATHFINDING	P AE TH F AY N D IH NG
PATHFINDINGS	P AE TH F AY N D IH NG Z
PATHLESS	P AE TH L AH S
PATHLESSNESS	P AE TH L AH S N AH S
PATHLESSNESSES	P AE TH L AH S N AH S IH Z
PATHOBIOLOGIES	P AE T HH AA B IY AA L AH JH IY Z
PATHOBIOLOGY	P AE T HH AA B IY AA L AH JH IY
PATHOGEN	P AE TH AH JH AH N
PATHOGENESES	P AH TH AA JH AH N IY Z AH Z
PATHOGENESIS	P AE TH AH JH EH N AH S AH S
PATHOGENETIC	P AH TH AA JH AH N AH T AH K
PATHOGENIC	P AE TH AH JH EH N IH K
PATHOGENICITIES	P AE TH AH JH EH N IH K AH T IY Z
PATHOGENICITY	P AE TH AH JH EH N IH K AH T IY
PATHOGENS	P AE TH AH JH AH N Z
PATHOGNOMONIC	P AH TH AA G N AH M AH N AH K
PATHOLOGIC	P AE TH AH L AA JH IH K
PATHOLOGICAL	P AE TH AH L AA JH IH K AH L
PATHOLOGICALLY	P AE TH AH L AA JH IH K L IY
PATHOLOGIES	P AH TH AA L AH JH IY Z
PATHOLOGIST	P AH TH AA L AH JH AH S T
PATHOLOGISTS	P AH TH AA L AH JH AH S T S
PATHOLOGY	P AH TH AA L AH JH IY
PATHOPHYSIOLOGIC	P AE TH AH F AH S IY AH L AH JH AH K
PATHOPHYSIOLOGICAL	P AH TH AA F AH S IY AA L AH JH IH S AH L
PATHOPHYSIOLOGIES	P AH TH AA F AH S IY AA L AH JH AY Z
PATHOPHYSIOLOGY	P AH TH AA F AH S IY AA L AH JH IY
PATHOS	P EY TH AA S
PATHOSES	P EY TH AA S IH Z
PATHS	P AE DH Z
PATHS(2)	P AE TH S
PATHWAY	P AE TH W EY
PATHWAYS	P AE TH W EY Z
PENNYWORTH	P EH N IY W ER TH
PENNYWORTHS	P EH N IY W ER TH S
PENTATHLETE	P EH N T AH TH L IY T
PENTATHLETES	P EH N T AH TH L IY T S
PENTATHLON	P EH N T AE TH L AH N
PENTATHLONS	P EH N T AE TH L AH N Z
PENTHOUSE	P EH N T HH AW S
PENTHOUSES	P EH N T HH AW S IH Z
PERCHLOROETHYLENE	P AH R K L AH R OW EH TH AH L IY N
PERCHLOROETHYLENES	P AH R K L AH R OW EH TH AH L IY N Z
PERIANTH	P AH R AY AH N TH
PERIANTHS	P AH R AY AH N TH S
PERITHECIA	P AH R AH TH IY SH IY AH
PERITHECIAL	P AH R AH TH IY SH AH L
PERITHECIUM	P AH R AH TH IY S IY AH M
PERMETHRIN	P AH R M EH TH R AH N
PERMETHRINS	P AH R M EH TH R AH N Z
PESTHOLE	P EH S T HH OW L
PESTHOLES	P EH S T HH OW L Z
PESTHOUSE	P EH S T HH AW S
PESTHOUSES	P EH S T HH AW S IH Z
PHARMACOTHERAPIES	F AA R M AH K AH TH EH R AH P AY Z
PHARMACOTHERAPY	F AA R M AH K AH TH EH R AH P IY
PHENANTHRENE	F EH N AH N TH R IY N
PHENANTHRENES	F EH N AH N TH R IY N Z
PHENOLPHTHALEIN	F IY N AA L F TH EY L AH N
PHENOLPHTHALEIN(2)	F EH N AA L F TH EY L AH N
PHENOLPHTHALEINS	F AH N OW L F TH AH L IY N Z
PHENOTHIAZINE	F IY N OW TH AY AH Z IY N
PHENOTHIAZINES	F IY N OW TH AY AH Z IY N Z
PHENYLETHYLAMINE	F AH N AH L AH TH IH L AH M AY N
PHENYLETHYLAMINES	F AH N AH L AH TH IH L AH M AY N Z
PHENYLTHIOCARBAMIDE	F AH N AH L TH IY AH K AA R B AH M AY D
PHENYLTHIOCARBAMIDES	F AH N AH L TH IY AH K AA R B AH M AY D Z
PHENYLTHIOUREA	F AH N IH L TH IY AH R IY AH
PHENYLTHIOUREAS	F AH N IH L TH IY AH R IY Z
PHILANTHROPIC	F IH L AH N TH R AA P IH K
PHILANTHROPICAL	F IH L AH N TH R AA P IH K AH L
PHILANTHROPICALLY	F IH L AH N TH R AA P IH K AH L IY
PHILANTHROPIES	F AH L AE N TH R AH P IY Z
PHILANTHROPIST	F AH L AE N TH R AH P AH S T
PHILANTHROPIST(2)	F IH L AE N TH R AH P IH S T
PHILANTHROPISTS	F IH L AE N TH R AH P IH S T S
PHILANTHROPOID	F AH L AE N TH R AH P OY D
PHILANTHROPOIDS	F AH L AE N TH R AH P OY D Z
PHILANTHROPY	F IH L AE N TH R AH P IY
PHOSPHATIDYLETHANOLAMINE	F AA S AH T AH D AH L AH TH AH N AA L AH M AY N
PHOSPHATIDYLETHANOLAMINES	F AA S AH T AH D AH L AH TH AH N AA L AH M AY N Z
PHOTOCATHODE	F OW T OW K AE TH OW D
PHOTOCATHODES	F OW T OW K AE TH OW D Z
PHOTOLITHOGRAPH	F OW T OW L IH TH AH G R AE F
PHOTOLITHOGRAPHED	F OW T OW L IH TH AH G R AE F T
PHOTOLITHOGRAPHIC	F OW T OW L IH TH AH G R AE F IH K
PHOTOLITHOGRAPHICALLY	F OW T OW L IH TH AH G R AE F IH K AH L IY
PHOTOLITHOGRAPHIES	F OW T OW L IH TH AH G R AE F IY Z
PHOTOLITHOGRAPHING	F OW T OW L IH TH AH G R AE F IH NG
PHOTOLITHOGRAPHS	F OW T OW L IH TH AH G R AE F S
PHOTOLITHOGRAPHY	F OW T OW L IH TH AH G R AE F IY
PHOTOSYNTHATE	F AH T AA S AH N TH EY T
PHOTOSYNTHATES	F AH T AA S AH N TH EY T S
PHOTOSYNTHESES	F AH T AA S AH N TH IY Z AH Z
PHOTOSYNTHESIS	F OW T OW S IH N TH AH S IH S
PHOTOSYNTHESIZE	F OW T OW S IH N TH AH S AY Z
PHOTOSYNTHESIZED	F OW T OW S IH N TH AH S AY Z D
PHOTOSYNTHESIZES	F OW T OW S IH N TH AH S AY Z IH Z
PHOTOSYNTHESIZING	F OW T OW S IH N TH AH S AY Z IH NG
PHOTOSYNTHETIC	F OW T OW S IH N TH EH T IH K
PHOTOSYNTHETICALLY	F OW T OW S IH N TH EH T IH K AH L IY
PHTHALIC	F TH AE L AH K
PHTHALIN	F TH AE L AH N
PHTHALINS	F TH AE L AH N Z
PHTHALOCYANINE	F TH AH L AA S AY AH N AY N
PHTHALOCYANINES	F TH AH L AA S AY AH N AY N Z
PHTHISES	F TH AY Z AH Z
PHTHISIC	F TH IH Z AH K
PHTHISICAL	F TH AH Z IH S AH L
PHTHISICS	F TH IH Z AH S Z
PHTHISIS	F TH IH S AH S
PHYCOERYTHRIN	F IH K AH R IH TH R AH N
PHYCOERYTHRINS	F IH K AH R IH TH R AH N Z
PHYSIOPATHOLOGIC	F IH S IY AH P AE TH AH L AH JH AH K
PHYSIOPATHOLOGICAL	F AH S IY AH P AH TH AA L AH JH IH S AH L
PHYSIOPATHOLOGIES	F AH S IY AH P AH TH AA L AH JH AY Z
PHYSIOPATHOLOGY	F AH S IY AH P AH TH AA L AH JH IY
PHYSIOTHERAPIES	F IH S IY AH TH EH R AH P AY Z
PHYSIOTHERAPIST	F IH S IY AH TH EH R AH P AH S T
PHYSIOTHERAPISTS	F IH S IY AH TH EH R AH P AH S T S
PHYSIOTHERAPY	F IH S IY AH TH EH R AH P IY
PHYTOPATHOGEN	F IH T AH P AE TH AH JH AH N
PHYTOPATHOGENIC	F IH T AH P AE TH AH JH AH N AH K
PHYTOPATHOGENS	F IH T AH P AE TH AH JH AH N Z
PHYTOPATHOLOGICAL	F IH T AH P AH TH AA L AH JH IH S AH L
PHYTOPATHOLOGIES	F IH T AH P AH TH AA L AH JH AY Z
PHYTOPATHOLOGY	F IH T AH P AH TH AA L AH JH IY
PICKTHANK	P IH K TH AE NG K
PICKTHANKS	P IH K TH AE NG K S
PILOTHOUSE	P AY L AH T HH AW S
PILOTHOUSES	P AY L AH T HH AW S IH Z
PINFEATHER	P IH N F EH DH ER
PINFEATHERS	P IH N F EH DH ER Z
PITH	P IH TH
PITHEAD	P IH T HH EH D
PITHEADS	P IH T HH EH D Z
PITHECANTHROPI	P IH TH AH K AE N TH R AH P IY
PITHECANTHROPINE	P AH TH AH K AE N TH R AH P AY N
PITHECANTHROPINES	P AH TH AH K AE N TH R AH P AY N Z
PITHECANTHROPUS	P IH TH AH K AE N TH R AH P AH S
PITHED	P IH TH T
PITHIER	P IH TH IY ER
PITHIEST	P IH TH IY AH S T
PITHILY	P IH TH IY L IY
PITHINESS	P IH TH IY N AH S
PITHINESSES	P IH TH IY N AH S IH Z
PITHING	P IH TH IH NG
PITHLESS	P IH TH L AH S
PITHS	P IH TH S
PITHY	P IH TH IY
PLAINCLOTHES	P L EY N K L OW Z
PLAINCLOTHESMAN	P L EY N K L OW DH Z M AE N
PLAINCLOTHESMEN	P L EY N K L OW DH Z M EH N
PLATYHELMINTH	P L EY T IY HH EH L M IH N TH
PLATYHELMINTHIC	P L EY T IY HH EH L M IH N TH IH K
PLATYHELMINTHS	P L EY T IY HH EH L M IH N TH S
PLAYTHING	P L EY TH IH NG
PLAYTHINGS	P L EY TH IH NG Z
PLETHORA	P L EH TH ER AH
PLETHORA(2)	P L AH TH AO R AH
PLETHORAS	P L EH TH AH R AH Z
PLETHORIC	P L EH TH AH R AH K
PLETHYSMOGRAM	P L EH TH AH Z M AA G R AH M
PLETHYSMOGRAMS	P L EH TH AH Z M AA G R AH M Z
PLETHYSMOGRAPH	P L EH TH AH Z M AA G R AH F
PLETHYSMOGRAPHIC	P L EH TH AH Z M AA G R AH F AH K
PLETHYSMOGRAPHICALLY	P L AH TH IH Z M AA G R AE F AH K AE L IY
PLETHYSMOGRAPHIES	P L EH TH AH Z M AA G R AH F AY Z
PLETHYSMOGRAPHS	P L EH TH AH Z M AA G R AH F S
PLETHYSMOGRAPHY	P L EH TH AH Z M AA G R AH F IY
PLINTH	P L IH N TH
PLINTHS	P L IH N TH S
PNEUMOTHORACES	N Y UW M AH TH AO R AH S AH Z
PNEUMOTHORAX	N Y UW M AA TH AH R AH K S
PNEUMOTHORAXES	N Y UW M AA TH AH R AH K S
POIKILOTHERM	P OY K IH L AH TH AH R M
POIKILOTHERMIC	P OY K IH L AH TH AH R M AH K
POIKILOTHERMS	P OY K IH L AH TH AH R M Z
POLYANTHA	P AA L AY AE N TH AH
POLYANTHAS	P AA L AY AE N TH AH Z
POLYANTHI	P AA L AY AE N TH IY
POLYANTHUS	P AA L AY AE N TH AH S
POLYANTHUSES	P AA L AY AH N TH UW Z AH Z
POLYCYTHEMIA	P AA L AH S AH TH IY M IY AH
POLYCYTHEMIAS	P AA L AH S AH TH IY M IY AH Z
POLYCYTHEMIC	P AH L IH S AH TH AH M AH K
POLYETHYLENE	P AA L IY EH TH AH L IY N
POLYETHYLENES	P AA L IY EH TH AH L IY N Z
POLYMATH	P OW L IY M AE TH
POLYMATHIC	P OW L IY M AE TH IH K
POLYMATHIES	P OW L IY M AE TH IY Z
POLYMATHS	P OW L IY M AE TH S
POLYMATHY	P OW L IY M AE TH IY
POLYRHYTHM	P OW L IY R IH DH AH M
POLYRHYTHMIC	P OW L IY R IH DH M IH K
POLYRHYTHMICALLY	P OW L IY R IH DH M IH K AH L IY
POLYRHYTHMS	P OW L IY R IH DH AH M Z
POLYTHEISM	P AA L IY TH IY IH Z AH M
POLYTHEISMS	P AA L AH TH IY Z AH M Z
POLYTHEIST	P AH L IH DH IY AH S T
POLYTHEISTIC	P AA L IY TH IY IH S T IH K
POLYTHEISTICAL	P OW L IY TH IY IH S T IH K AH L
POLYTHEISTS	P AA L AH TH IY S T S
POLYTHENE	P AA L AH TH IY N
POLYTHENES	P AA L AH TH IY N Z
POLYURETHANE	P AA L IY UH R AH TH EY N
POLYURETHANES	P OW L IY Y UH R AH TH EY N Z
POORTITH	P UH R T AH TH
POORTITHS	P UH R T AH TH S
PORTHOLE	P OW R T HH OW L
PORTHOLES	P OW R T HH OW L Z
POSTHARVEST	P OW S T HH AA R V AH S T
POSTHASTE	P OW S T HH EY S T
POSTHASTES	P OW S T HH EY S T S
POSTHEAT	P OW S T HH IY T
POSTHEATS	P OW S T HH IY T S
POSTHEMORRHAGIC	P OW S T HH EH M AH R IH JH IH K
POSTHOLE	P OW S T HH OW L
POSTHOLES	P OW S T HH OW L Z
POSTHOLIDAY	P OW S T HH AA L AH D EY
POSTHOLOCAUST	P OW S T HH AA L AH K AO S T
POSTHOSPITAL	P OW S T HH AA S P IH T AH L
POSTHUMOUS	P AA S CH UH M AH S
POSTHUMOUSLY	P AA S CH UH M AH S L IY
POSTHUMOUSNESS	P AA S CH AH M AH S N AH S
POSTHUMOUSNESSES	P AA S CH AH M AH S N AH S IH Z
POSTHYPNOTIC	P OW S T HH IH P N AA T IH K
POTHEAD	P AA T HH EH D
POTHEADS	P AA T HH EH D Z
POTHEEN	P OW DH IY AH N
POTHEENS	P AH TH IY N Z
POTHER	P AA DH AH R
POTHERB	P AA T ER B
POTHERBS	P AA T ER B Z
POTHERED	P AH TH IY R D
POTHERING	P AH TH IY R AH NG
POTHERS	P AA TH AH R Z
POTHOLDER	P AA T HH OW L D ER
POTHOLDERS	P AA T HH OW L D ER Z
POTHOLE	P AA T HH OW L
POTHOLED	P AA T HH OW L D
POTHOLES	P AA T HH OW L Z
POTHOOK	P AA T HH UH K
POTHOOKS	P AA T HH UH K S
POTHOUSE	P AA T HH AW S
POTHOUSES	P AA T HH AW S IH Z
POTHUNTER	P AA T HH AH N T ER
POTHUNTERS	P AA T HH AH N T ER Z
POTHUNTING	P AA T HH AH N T IH NG
POTHUNTINGS	P AA T HH AH N T IH NG Z
PRAISEWORTHILY	P R EY Z W ER DH IY L IY
PRAISEWORTHINESS	P R EY Z W ER DH IY N AH S
PRAISEWORTHINESSES	P R EY Z W ER DH IY N AH S IH Z
PRAISEWORTHY	P R EY Z W ER DH IY
PREANESTHETIC	P R IY AE N AH S TH EH T IH K
PREANESTHETICS	P R IY AE N AH S TH EH T IH K S
PREETHICAL	P R IY EH TH IH K AH L
PRETHEATER	P R IY TH IY AH T ER
PRIESTHOOD	P R IY S T HH UH D
PRIESTHOODS	P R IY S T HH UH D Z
PRINTHEAD	P R IH N T HH EH D
PRINTHEADS	P R IH N T HH EH D Z
PRITHEE	P R AY TH IY
PROCATHEDRAL	P R OW K AH TH IY D R AH L
PROCATHEDRALS	P R OW K AH TH IY D R AH L Z
PROGNATHISM	P R OW N AH TH IH Z AH M
PROGNATHISMS	P R OW N AE TH AH Z AH M Z
PROGNATHOUS	P R OW N AE TH AH S
PROMETHIUM	P R AH M IY TH IY AH M
PROMETHIUMS	P R OW M EH TH IY AH M Z
PROPHETHOOD	P R AA F AH T HH UH D
PROPHETHOODS	P R AA F AH T HH UH D Z
PROSTHESES	P R AA S TH IY S IY Z
PROSTHESIS	P R AO S TH EH S IH S
PROSTHESIS(2)	P R AO S TH IY S IH S
PROSTHETIC	P R AA S TH EH T IH K
PROSTHETICALLY	P R OW S TH EH T AH K AE L IY
PROSTHETICS	P R AA S TH EH T IH K S
PROSTHETIST	P R OW S TH IY T AH S T
PROSTHETISTS	P R OW S TH EH T AH S T S
PROSTHODONTICS	P R OW S TH AH D AA N T AH S Z
PROSTHODONTIST	P R OW S TH AH D AA N T AH S T
PROSTHODONTISTS	P R OW S TH AH D AA N T AH S T S
PROTHALAMIA	P R OW TH AH L EY M IY AH
PROTHALAMION	P R OW TH AH L EY M IY AH N
PROTHALAMIUM	P R OW TH AH L EY M IY AH M
PROTHALLI	P R OW TH AE L IY
PROTHALLIA	P R OW TH AE L IY AH
PROTHALLIUM	P R OW TH AE L IY AH M
PROTHALLUS	P R OW TH AE L AH S
PROTHALLUSES	P R OW TH AE L UW Z AH Z
PROTHESES	P R OW TH IY S IY Z
PROTHESIS	P R OW TH IY S AH S
PROTHETIC	P R OW TH IY T AH K
PROTHONOTARIAL	P R OW TH AA N AH T AE R IY AH L
PROTHONOTARIES	P R OW TH AH N AA T AH R AY Z
PROTHONOTARY	P R OW TH AA N AH T EH R IY
PROTHORACES	P R OW TH AO R AH S AH Z
PROTHORACIC	P R OW TH AO R AH S AH K
PROTHORAX	P R OW TH AO R AE K S
PROTHORAXES	P R OW TH AO R AH K S
PROTHROMBIN	P R OW TH R AA M B AH N
PROTHROMBINS	P R OW TH R AA M B AH N Z
PROTOPATHIC	P R OW T AA P AH TH AH K
PRUTOTH	P R UW T AH TH
PRYTHEE	P R AY TH IY
PSYCHASTHENIA	S AY K AH S TH IY N Y AH
PSYCHASTHENIAS	S AY K AH S TH IY N Y AH Z
PSYCHASTHENIC	S AY K AE S TH AH N AH K
PSYCHASTHENICS	S AY K AE S TH AH N AH S Z
PSYCHOPATH	S AY K OW P AE TH
PSYCHOPATHIC	S AY K AH P AE TH IH K
PSYCHOPATHICALLY	S AY K AH P AE TH IH K AH L IY
PSYCHOPATHICS	S AY K AH P AE TH IH K S
PSYCHOPATHIES	S AY K AH P AE TH IY Z
PSYCHOPATHOLOGIC	S AY K OW P AE TH AH L AA JH IH K
PSYCHOPATHOLOGICAL	S AY K OW P AE TH AH L AA JH IH K AH L
PSYCHOPATHOLOGICALLY	S AY K OW P AE TH AH L AA JH IH K AH L IY
PSYCHOPATHOLOGIES	S AY K OW P AH TH AA L AH JH IY Z
PSYCHOPATHOLOGIST	S AY K OW P AH TH AA L AH JH AH S T
PSYCHOPATHOLOGISTS	S AY K OW P AH TH AA L AH JH AH S T S
PSYCHOPATHOLOGY	S AY K OW P AH TH AA L AH JH IY
PSYCHOPATHS	S AY K OW P AE TH S
PSYCHOPATHY	S AY K AA P AH TH IY
PSYCHOSYNTHESES	S AY K AH S IH N TH IY Z AH Z
PSYCHOSYNTHESIS	S AY K OW S IH N TH AH S AH S
PSYCHOTHERAPEUTIC	S AY K OW TH EH R AH P Y UW T IH K
PSYCHOTHERAPEUTICALLY	S AY K OW TH EH R AH P Y UW T IH K AH L IY
PSYCHOTHERAPIES	S AY K OW TH EH R AH P IY Z
PSYCHOTHERAPIST	S AY K AH TH EH R AH P IH S T
PSYCHOTHERAPISTS	S AY K AH TH EH R AH P IH S T S
PSYCHOTHERAPY	S AY K OW TH EH R AH P IY
PYRACANTHA	P IH R AH K AE N TH AH
PYRACANTHAS	P IH R AH K AE N TH AH Z
PYRETHRIN	P AH R EH TH R AH N
PYRETHRINS	P AH R EH TH R AH N Z
PYRETHROID	P AY ER TH R OW AH D
PYRETHROIDS	P AY ER TH R OW AH D Z
PYRETHRUM	P AY ER TH R AH M
PYRETHRUMS	P AY ER TH R AH M Z
PYRIMETHAMINE	P AH R AH M EH TH AH M AY N
PYRIMETHAMINES	P AH R AH M EH TH AH M AY N Z
PYTHON	P AY TH AA N
PYTHONESS	P AY TH AA N AH S
PYTHONESSES	P AY TH AA N AH S IH Z
PYTHONIC	P AY TH AA N IH K
PYTHONS	P AY TH AA N Z
QUADRILLIONTH	K W AA D R IH L Y AH N TH
QUADRILLIONTHS	K W AA D R IH L Y AH N TH S
QUINTILLIONTH	K W IH N T IH L Y AH N TH
QUINTILLIONTHS	K W IH N T IH L Y AH N TH S
QUOTH	K W OW TH
QUOTHA	K W AA TH AH
RADIOTHERAPIES	R EY D IY OW TH EH R AH P IY Z
RADIOTHERAPIST	R EY D IY OW TH ER EY P IH S T
RADIOTHERAPISTS	R EY D IY OW TH ER EY P IH S T S
RADIOTHERAPY	R EY D IY OW TH EH R AH P IY
RADIOTHORIUM	R EY D IY AH TH AO R IY AH M
RADIOTHORIUMS	R EY D IY AH TH AO R IY AH M Z
RATH	R AE TH
RATHE	R EY DH
RATHER	R AE DH ER
RATHER(2)	R AH DH ER
RATHOLE	R AE T HH OW L
RATHOLES	R AE T HH OW L Z
RATHSKELLER	R AE TH S K EH L ER
RATHSKELLERS	R AE TH S EH L AH R Z
REAUTHORIZATION	R IY AO TH ER IH Z EY SH AH N
REAUTHORIZATIONS	R IY AO TH ER AH Z EY SH AH N Z
REAUTHORIZE	R IY AO TH ER AY Z
REAUTHORIZED	R IY AO TH ER AY Z D
REAUTHORIZES	R IY AO TH ER AY Z IH Z
REAUTHORIZING	R IY AO TH ER AY Z IH NG
REBIRTH	R IY B ER TH
REBIRTHS	R IY B ER TH S
RECLOTHE	R IY K L OW DH
RECLOTHED	R IY K L OW DH D
RECLOTHES	R IY K L OW DH Z
RECLOTHING	R IY K L OW DH IH NG
REENTHRONE	R IY EH N TH R OW N
REENTHRONED	R IY EH N TH R OW N D
REENTHRONES	R IY EH N TH R OW N Z
REENTHRONING	R IY EH N TH R OW N IH NG
REGATHER	R IY G AE DH ER
REGATHERED	R IY G AE DH ER D
REGATHERING	R IY G AE DH ER IH NG
REGATHERS	R IY G AE DH ER Z
REGOLITH	R IY G OW L IY TH
REGOLITHS	R IY G OW L IY TH S
REGROWTH	R IY G R OW TH
REGROWTHS	R IY G R OW TH S
REMYTHOLOGIZE	R AH M AH TH AA L AH JH AY Z
REMYTHOLOGIZED	R AH M AH TH AA L AH JH AY Z D
REMYTHOLOGIZES	R AH M AH TH AA L AH JH AY Z AH Z
REMYTHOLOGIZING	R AH M AH TH AA L AH JH AY Z AH NG
RESMOOTH	R IY S M UW DH
RESMOOTHED	R IY S M UW DH D
RESMOOTHING	R IY S M UW DH IH NG
RESMOOTHS	R IY S M UW DH Z
RESTRENGTHEN	R IY S T R EH NG TH AH N
RESTRENGTHENED	R IY S T R EH NG TH AH N D
RESTRENGTHENING	R IY S T R EH NG TH AH N IH NG
RESTRENGTHENS	R IY S T R EH NG TH AH N Z
RESYNTHESES	R AH S IH N TH IY Z AH Z
RESYNTHESIS	R IY S IH N TH AH S AH S
RESYNTHESIZE	R IY S IH N TH AH S AY Z
RESYNTHESIZED	R IY S IH N TH AH S AY Z D
RESYNTHESIZES	R IY S IH N TH AH S AY Z IH Z
RESYNTHESIZING	R IY S IH N TH AH S AY Z IH NG
RETHINK	R IY TH IH NG K
RETHINKER	R IY TH IH NG K ER
RETHINKERS	R IY TH IH NG K ER Z
RETHINKING	R IY TH IH NG K IH NG
RETHINKS	R IY TH IH NG K S
RETHOUGHT	R IY TH AO T
RETHREAD	R IY TH R EH D
RETHREADED	R IY TH R EH D IH D
RETHREADING	R IY TH R EH D IH NG
RETHREADS	R IY TH R EH D Z
RETICULOENDOTHELIAL	R AH T AH K Y UW L OW EH N D AH TH IY L IY AH L
RETINOPATHIES	R AH T AH N AA P AH TH AY Z
RETINOPATHY	R AH T AH N AA P AH TH IY
RHADAMANTHINE	R AH D AE M AH N TH AY N
RHYTHM	R IH DH AH M
RHYTHMIC	R IH DH M IH K
RHYTHMICAL	R IH DH M IH K AH L
RHYTHMICALLY	R IH DH M IH K L IY
RHYTHMICITIES	R IH DH M IH K AH T IY Z
RHYTHMICITY	R IH DH M IH K AH T IY
RHYTHMICS	R IH DH M IH K S
RHYTHMIST	R IH DH AH M IH S T
RHYTHMISTS	R IH DH AH M IH S T S
RHYTHMIZATION	R IH DH AH M AH Z EY SH AH N
RHYTHMIZATIONS	R IH DH AH M AH Z EY SH AH N Z
RHYTHMIZE	R IH DH AH M AY Z
RHYTHMIZED	R IH DH AH M AY Z D
RHYTHMIZES	R IH DH AH M AY Z IH Z
RHYTHMIZING	R IH DH AH M AY Z IH NG
RHYTHMS	R IH DH AH M Z
ROADWORTHINESS	R OW D W ER DH IY N AH S
ROADWORTHINESSES	R OW D W ER DH IY N AH S IH Z
ROADWORTHY	R OW D W ER DH IY
ROOTHOLD	R UW T HH OW L D
ROOTHOLDS	R UW T HH OW L D Z
ROUTH	R AW TH
ROUTHS	R AW TH S
ROWTH	R OW TH
ROWTHS	R OW TH S
RUBYTHROAT	R UW B IY TH R OW T
RUBYTHROATS	R UW B IY TH R OW T S
RUTH	R UW TH
RUTHENIC	R UW TH AH N IH K
RUTHENIUM	R UW TH IY N IY AH M
RUTHENIUMS	R UW TH IY N IY AH M Z
RUTHERFORDIUM	R AH TH AH R F AO R D IY AH M
RUTHERFORDIUMS	R AH TH AH R F AO R D IY AH M Z
RUTHFUL	R UW TH F AH L
RUTHFULLY	R UW TH F AH L IY
RUTHFULNESS	R UW TH F AH L N AH S
RUTHFULNESSES	R UW TH F AH L N AH S IH Z
RUTHLESS	R UW TH L AH S
RUTHLESSLY	R UW TH L AH S L IY
RUTHLESSNESS	R UW TH L AH S N AH S
RUTHLESSNESSES	R UW TH L AH S N AH S IH Z
RUTHS	R UW TH S
SABBATH	S AE B AH TH
SABBATHS	S AE B AH TH S
SACKCLOTH	S AE K L AO TH
SACKCLOTHS	S AE K L AO TH S
SADDLECLOTH	S AE D AH L K L AO TH
SADDLECLOTHS	S AE D AH L K L AO TH S
SAILCLOTH	S EY L K L AO TH
SAILCLOTHS	S EY L K L AO TH S
SAINTHOOD	S EY N T HH UH D
SAINTHOODS	S EY N T HH UH D Z
SAITH	S EY TH
SAITHE	S EY DH
SAWTEETH	S AO T IY TH
SAWTOOTH	S AO T UW TH
SCATHE	S K EY DH
SCATHED	S K EY DH D
SCATHELESS	S K EY DH L AH S
SCATHES	S K EY DH Z
SCATHING	S K EY DH IH NG
SCATHINGLY	S K EY DH IH NG L IY
SCOUTH	S K AW TH
SCOUTHER	S K AW DH AH R
SCOUTHERED	S K AW TH IY R D
SCOUTHERING	S K AW TH IY R AH NG
SCOUTHERS	S K AW TH AH R Z
SCOUTHS	S K AW TH S
SCYTHE	S IH TH
SCYTHE(2)	S AY TH
SCYTHED	S IH DH D
SCYTHES	S IH DH Z
SCYTHING	S IH DH AH NG
SEAWORTHINESS	S IY W ER DH IY N AH S
SEAWORTHINESSES	S IY W ER DH IY N AH S IH Z
SEAWORTHY	S IY W AO R DH IY
SEETHE	S IY DH
SEETHED	S IY TH T
SEETHES	S IY TH S
SEETHING	S IY DH IH NG
SELCOUTH	S EH L K AW TH
SEMILETHAL	S EH M IY L IY TH AH L
SEMILETHALS	S EH M IY L IY TH AH L Z
SEMILOGARITHMIC	S EH M IY L AA G AH R IH DH AH M IH K
SEMIMONTHLIES	S EH M IY M AH N TH L IY Z
SEMIMONTHLY	S EH M IY M AH N TH L IY
SEMISYNTHETIC	S EH M IY S IH N TH EH T IH K
SERVANTHOOD	S ER V AH N T HH UH D
SERVANTHOODS	S ER V AH N T HH UH D Z
SEVENTEENTH	S EH V AH N T IY N TH
SEVENTEENTHS	S EH V AH N T IY N TH S
SEVENTH	S EH V AH N TH
SEVENTHS	S EH V AH N TH S
SEVENTIETH	S EH V AH N T IY IH TH
SEVENTIETHS	S EH V AH N T IY IH TH S
SHEATH	SH IY TH
SHEATHBILL	SH IY TH B IH L
SHEATHBILLS	SH IY TH B IH L Z
SHEATHE	SH IY DH
SHEATHED	SH IY DH D
SHEATHER	SH IY DH ER
SHEATHERS	SH IY DH ER Z
SHEATHES	SH IY DH Z
SHEATHING	SH IY DH IH NG
SHEATHINGS	SH IY DH IH NG Z
SHEATHS	SH IY TH S
SHIBBOLETH	SH IH B AH L EH TH
SHIBBOLETHS	SH IH B AH L AH TH S
SHITHEAD	SH IH T HH EH D
SHITHEADS	SH IH T HH EH D Z
SHOFROTH	SH AA F R AH TH
SHOPHROTH	SH AA F R AH TH
SHORTHAIR	SH AO R T HH EH R
SHORTHAIRED	SH AO R T HH EH R D
SHORTHAIRS	SH AO R T HH EH R Z
SHORTHAND	SH AO R T HH AE N D
SHORTHANDED	SH AO R T HH AE N D IH D
SHORTHANDS	SH AO R T HH AE N D Z
SHORTHORN	SH AO R T HH AO R N
SHORTHORNS	SH AO R T HH AO R N Z
SILVERSMITH	S IH L V ER S M IH TH
SILVERSMITHING	S IH L V ER S M IH TH IH NG
SILVERSMITHINGS	S IH L V ER S M IH TH IH NG Z
SILVERSMITHS	S IH L V ER S M IH TH S
SITH	S IH TH
SITHENCE	S IH TH AH N S
SITHENS	S IH T HH EH N Z
SIXTEENTH	S IH K S T IY N TH
SIXTEENTHS	S IH K S T IY N TH S
SIXTH	S IH K S TH
SIXTHLY	S IH K S TH L IY
SIXTHS	S IH K S TH S
SIXTIETH	S IH K S T IY IH TH
SIXTIETHS	S IH K S T IY IH TH S
SLATHER	S L AE DH ER
SLATHERED	S L AE DH ER D
SLATHERING	S L AE DH ER IH NG
SLATHERS	S L AE DH ER Z
SLEUTH	S L UW TH
SLEUTHED	S L UW TH T
SLEUTHHOUND	S L UW TH HH AW N D
SLEUTHHOUNDS	S L UW TH HH AW N D Z
SLEUTHING	S L UW TH IH NG
SLEUTHS	S L UW TH S
SLITHER	S L IH DH ER
SLITHERED	S L IH TH ER D
SLITHERING	S L IH DH ER IH NG
SLITHERS	S L IH TH ER Z
SLITHERY	S L IH TH AH R IY
SLOTH	S L OW TH
SLOTHFUL	S L OW TH F AH L
SLOTHFULLY	S L OW TH F AH L IY
SLOTHFULNESS	S L OW TH F AH L N AH S
SLOTHFULNESSES	S L OW TH F AH L N AH S IH Z
SLOTHS	S L OW TH S
SMALLCLOTHES	S M AO L K L OW DH Z
SMALLMOUTH	S M AO L M AW TH
SMALLMOUTHS	S M AO L M AW TH S
SMITH	S M IH TH
SMITHEREENS	S M IH DH ER IY N Z
SMITHERIES	S M IH TH AH R IY Z
SMITHERS	S M IH DH ER Z
SMITHERY	S M IH TH AH R IY
SMITHIES	S M IH TH IY Z
SMITHS	S M IH TH S
SMITHSONITE	S M IH TH S AH N AY T
SMITHSONITES	S M IH TH S AH N AY T S
SMITHY	S M IH TH IY
SMOOTH	S M UW DH
SMOOTHBORE	S M UW DH B OW R
SMOOTHBORES	S M UW DH B OW R Z
SMOOTHED	S M UW DH D
SMOOTHEN	S M UW DH IH N
SMOOTHENED	S M UW DH AH N D
SMOOTHENING	S M UW DH AH N IH NG
SMOOTHENS	S M UW DH IH N Z
SMOOTHER	S M UW DH ER
SMOOTHERS	S M UW DH ER Z
SMOOTHES	S M UW DH Z
SMOOTHEST	S M UW DH AH S T
SMOOTHIE	S M UW DH IY
SMOOTHIES	S M UW DH IY Z
SMOOTHING	S M UW DH IH NG
SMOOTHLY	S M UW DH L IY
SMOOTHNESS	S M UW DH N AH S
SMOOTHNESSES	S M UW DH N AH S IH Z
SMOOTHS	S M UW DH Z
SMOOTHY	S M UW DH IY
SMOTHER	S M AH DH ER
SMOTHERED	S M AH DH ER D
SMOTHERING	S M AH DH ER IH NG
SMOTHERS	S M AH DH ER Z
SMOTHERY	S M AH DH ER IY
SNAGGLETEETH	S N AE G L IY T IY AH TH
SNAGGLETOOTH	S N AE G L AH T UW TH
SNAGGLETOOTHED	S N AE G L AH T UW DH D
SNATH	S N AE TH
SNATHE	S N EY DH
SNATHES	S N AE DH Z
SNATHS	S N AE TH S
SOCIOPATH	S OW S IY OW P AE TH
SOCIOPATHIC	S OW S IY AH P AH TH AH K
SOCIOPATHIES	S OW S IY AA P AH TH AY Z
SOCIOPATHS	S OW S IY OW P AE DH Z
SOCIOPATHY	S OW S IY AA P AH TH IY
SOFTHEAD	S AO F T HH EH D
SOFTHEADED	S AO F T HH EH D IH D
SOFTHEADEDLY	S AO F T HH EH D AH D L IY
SOFTHEADEDNESS	S AO F T HH EH D AH D N AH S
SOFTHEADEDNESSES	S AO F T HH EH D AH D N AH S IH Z
SOFTHEADS	S AO F T HH EH D Z
SOFTHEARTED	S AO F T HH AA R T IH D
SOFTHEARTEDLY	S AO F T HH AA R T AH D L IY
SOFTHEARTEDNESS	S AO F T HH AA R T AH D N AH S
SOFTHEARTEDNESSES	S AO F T HH AA R T AH D N AH S IH Z
SOMETHING	S AH M TH IH NG
SOMEWHITHER	S AA M Y UW HH AH DH AH R
SONGSMITH	S AO NG S M IH TH
SONGSMITHS	S AO NG S M IH TH S
SOOTH	S UW TH
SOOTHE	S UW DH
SOOTHED	S UW DH D
SOOTHER	S UW DH ER
SOOTHERS	S UW DH ER Z
SOOTHES	S UW DH Z
SOOTHEST	S UW DH AH S T
SOOTHFAST	S UW TH AH S T
SOOTHING	S UW DH IH NG
SOOTHINGLY	S UW DH IH NG L IY
SOOTHINGNESS	S UW DH IH NG N AH S
SOOTHINGNESSES	S UW DH IH NG N AH S IH Z
SOOTHLY	S UW TH L IY
SOOTHS	S UW TH S
SOOTHSAID	S UW TH S EY D
SOOTHSAY	S UW TH S EY IY
SOOTHSAYER	S UW TH S EY ER
SOOTHSAYERS	S UW TH S EY ER Z
SOOTHSAYING	S UW TH S EY AH NG
SOOTHSAYINGS	S UW TH S EY AH NG Z
SOOTHSAYS	S UW TH S EY Z
SOTH	S AA TH
SOTHS	S AA TH S
SOUTH	S AW TH
SOUTHBOUND	S AW TH B AW N D
SOUTHEAST	S AW TH IY S T
SEICENTO	S AY S EH N T OW
GEANTICLINE	JH IY N T AH K L AY N
EIRENIC	IY R AH N AH K
IMAGE	IH M AH JH
IMAGE(2)	IH M IH JH
GILBERT	G IH L B ER T
MECAMYLAMINE	M AH K AH M IH L AH M AY N
IKON	AY K AA N
