TT	T IY T
ABATTIS	AH B AE T IY Z
ABATTISES	AH B AE T IY Z IH Z
ABATTOIR	AE B AH T OY R
ABATTOIRS	AE B AH T OY R Z
ABETTAL	AH B EH T AH L
ABETTALS	AH B EH T AH L Z
ABETTED	AH B EH T IH D
ABETTER	AH B EH T ER
ABETTERS	AH B EH T ER Z
ABETTING	AH B EH T IH NG
ABETTOR	AH B EH T ER
ABETTORS	AH B EH T ER Z
ABUTTAL	AH B AH T AH L
ABUTTALS	AH B AH T AH L Z
ABUTTED	AH B AH T AH D
ABUTTER	AH B AH T ER
ABUTTERS	AH B AH T ER Z
ABUTTING	AH B AH T IH NG
ABWATT	AE B W AH T
ABWATTS	AE B W AH T S
ACQUITTAL	AH K W IH T AH L
ACQUITTALS	AH K W IH T AH L Z
ACQUITTANCE	AH K W IH T AH N S
ACQUITTANCES	AH K W IH T AH N S IH Z
ACQUITTED	AH K W IH T IH D
ACQUITTER	AH K W IH T ER
ACQUITTERS	AH K W IH T ER Z
ACQUITTING	AH K W IH T IH NG
ADMITTANCE	AH D M IH T AH N S
ADMITTANCES	AH D M IH T AH N S IH Z
ADMITTED	AH D M IH T AH D
ADMITTEDLY	AE D M IH T IH D L IY
ADMITTER	AH D M IH T ER
ADMITTERS	AH D M IH T ER Z
ADMITTING	AE D M IH T IH NG
ADMITTING(2)	AH D M IH T IH NG
AFLUTTER	AH F L AH T ER
AGLITTER	AH G L IH T ER
AIGRETTE	EY G R EH T
AIGRETTES	EY G R EH T S
AIGUILLETTE	EY G W AH L EH T
AIGUILLETTES	EY G W IH L EH T S
ALLEGRETTO	AE L AH G R EH T OW
ALLEGRETTOS	AE L AH G R EH T AH Z
ALLOTTED	AH L AA T IH D
ALLOTTEE	AH L AA T IY
ALLOTTEES	AH L AA T IY Z
ALLOTTER	AH L AA T ER
ALLOTTERS	AH L AA T ER Z
ALLOTTING	AH L AA T IH NG
AMARETTI	AE M AH R EH T IY
AMARETTO	AE M AH R EH T OW
AMARETTOS	AE M AH R EH T AH Z
AMORETTI	AE M AH R EH T IY
AMORETTO	AE M AH R EH T OW
AMORETTOS	AE M AH R EH T AH Z
ANATTO	AH N AE T OW
ANATTOS	AH N AE T AH Z
ANCHOVETTA	AE NG K AH V EH T AH
ANCHOVETTAS	AE NG K AH V EH T AH Z
ANDOUILLETTE	AE N D AW AH L EH T
ANDOUILLETTES	AE N D AW IH L EH T S
ANISETTE	AE N AH S EH T
ANISETTES	AE N AH S EH T S
ANNATTO	AE N AE T OW
ANNATTOS	AE N AE T AH Z
ANTIBOYCOTT	AE N T AY B OY K AA T
ANTIBOYCOTTS	AE N T AY B OY K AA T S
ANTICIGARETTE	AE N T AY S IH G AH R EH T
ANTICLOTTING	AE N T AY K L AA T IH NG
ANTILITTER	AE N T AY L IH T ER
ANTILITTERING	AE N T AY L IH T ER IH NG
ANTIMATTER	AE T AY M AE T ER
ANTIMATTERS	AE N T AY M AE T ER Z
ARIETTA	AH R IY T AH
ARIETTAS	AH R IY T AH Z
ARIETTE	AE R AY EH T
ARIETTES	AE R AY EH T S
ARNATTO	AA R N AE T OW
ARNATTOS	AA R N AE T AH Z
ARNOTTO	AA R N AA T OW
ARNOTTOS	AA R N AA T AH Z
ATT	AE T
ATTABOY	AE T AH B OY
ATTACH	AH T AE CH
ATTACHABLE	AH T AE CH AH B AH L
ATTACHE	AE T AH SH EY
ATTACHED	AH T AE CH T
ATTACHER	AH T AE CH ER
ATTACHERS	AH T AE CH ER Z
ATTACHES	AH T AE CH IH Z
ATTACHING	AH T AE CH IH NG
ATTACHMENT	AH T AE CH M AH N T
ATTACHMENTS	AH T AE CH M AH N T S
ATTACK	AH T AE K
ATTACKED	AH T AE K T
ATTACKER	AH T AE K ER
ATTACKERS	AH T AE K ER Z
ATTACKING	AH T AE K IH NG
ATTACKMAN	AH T AE K M AE N
ATTACKMEN	AH T AE K M EH N
ATTACKS	AH T AE K S
ATTAIN	AH T EY N
ATTAINABILITIES	AH T EY N AH B IH L AH T EH Z
ATTAINABILITY	AH T EY N AH B IH L AH T EH
ATTAINABLE	AH T EY N AH B AH L
ATTAINDER	AH T EY N D ER
ATTAINDERS	AE T EY N D AH R Z
ATTAINED	AH T EY N D
ATTAINER	AH T EY N ER
ATTAINERS	AH T EY N ER Z
ATTAINING	AH T EY N IH NG
ATTAINMENT	AH T EY N M AH N T
ATTAINMENTS	AH T EY N M AH N T S
ATTAINS	AH T EY N Z
ATTAINT	AE T EY N T
ATTAINTED	AH T EY N T EH D
ATTAINTING	AE T EY N T AH NG
ATTAINTS	AE T EY N T S
ATTAR	AE T AA R
ATTARS	AE T AH R Z
ATTEMPER	AE T EH M P AH R
ATTEMPERED	AE T AH M P IY R D
ATTEMPERING	AE T AH M P IY R AH NG
ATTEMPERS	AE T EH M P AH R Z
ATTEMPT	AH T EH M P T
ATTEMPTABLE	AH T EH M P T AH B AH L
ATTEMPTED	AH T EH M P T AH D
ATTEMPTING	AH T EH M P T IH NG
ATTEMPTS	AH T EH M P T S
ATTEND	AH T EH N D
ATTENDANCE	AH T EH N D AH N S
ATTENDANCES	AH T EH N D AH N S IH Z
ATTENDANT	AH T EH N D AH N T
ATTENDANTS	AH T EH N D AH N T S
ATTENDED	AH T EH N D AH D
ATTENDEE	AH T EH N D IY
ATTENDEES	AH T EH N D IY Z
ATTENDER	AH T EH N D ER
ATTENDERS	AH T EH N D ER Z
ATTENDING	AH T EH N D IH NG
ATTENDS	AH T EH N D Z
ATTENT	AE T AH N T
ATTENTION	AH T EH N SH AH N
ATTENTIONAL	AH T EH N CH AH N AH L
ATTENTIONS	AH T EH N SH AH N Z
ATTENTIVE	AH T EH N T IH V
ATTENTIVELY	AH T EH N T IH V L IY
ATTENTIVENESS	AH T EH N T IH V N AH S
ATTENTIVENESSES	AH T EH N T IH V N AH S IH Z
ATTENUATE	AH T EH N Y UW EY T
ATTENUATED	AH T EH N Y UW EY T IH D
ATTENUATES	AH T EH N Y UW EY T S
ATTENUATING	AE T EH N Y UW EY T AH NG
ATTENUATION	AE T EH N Y UW EY SH AH N
ATTENUATIONS	AE T EH N Y UW EY T IY AH N Z
ATTENUATOR	AE T EH N Y UW EY T AH R
ATTENUATORS	AE T AH N Y UW AH T AH R Z
ATTEST	AH T EH S T
ATTESTATION	AH T EH S T EY SH AH N
ATTESTATIONS	AH T EH S T EY SH AH N Z
ATTESTED	AH T EH S T IH D
ATTESTER	AH T EH S T ER
ATTESTERS	AH T EH S T ER Z
ATTESTING	AH T EH S T IH NG
ATTESTOR	AH T EH S T ER
ATTESTORS	AH T EH S T ER Z
ATTESTS	AH T EH S T S
ATTESTS(2)	AH T EH S
ATTIC	AE T IH K
ATTICISM	AE T IH K IH Z AH M
ATTICISMS	AE T IH K IH Z AH M Z
ATTICIST	AE T IH K IH S T
ATTICISTS	AE T IH K IH S T S
ATTICS	AE T IH K S
ATTIRE	AH T AY ER
ATTIRED	AH T AY R D
ATTIRES	AH T AY ER Z
ATTIRING	AH T AY ER IH NG
ATTITUDE	AE T AH T UW D
ATTITUDES	AE T AH T UW D Z
ATTITUDINAL	AE T AH T UW D AH N AH L
ATTITUDINALLY	AE T AH T Y UW D AH N AE L IY
ATTITUDINISE	AE T AH T Y UW D AH N AY Z
ATTITUDINISED	AE T AH T Y UW D AH N AH S T
ATTITUDINISES	AE T AH T Y UW D AH N AY Z AH Z
ATTITUDINISING	AE T AH T Y UW D AH N AY Z AH NG
ATTITUDINIZE	AE T AH T Y UW D AH N AY Z
ATTITUDINIZED	AE T AH T Y UW D AH N AY Z D
ATTITUDINIZES	AE T AH T Y UW D AH N AY Z AH Z
ATTITUDINIZING	AE T AH T Y UW D AH N AY Z AH NG
ATTORN	AE T AH R N
ATTORNED	AE T AH R N D
ATTORNEY	AH T ER N IY
ATTORNEYS	AH T ER N IY Z
ATTORNEYSHIP	AH T ER N IY SH IH P
ATTORNEYSHIPS	AH T ER N IY SH IH P S
ATTORNING	AE T AO R N AH NG
ATTORNMENT	AE T AO R N M AH N T
ATTORNMENTS	AE T AO R N M AH N T S
ATTORNS	AE T AH R N Z
ATTRACT	AH T R AE K T
ATTRACTANCE	AH T R AE K T AH N S
ATTRACTANCES	AH T R AE K T AH N S IH Z
ATTRACTANCIES	AH T R AE K T AH N S IY Z
ATTRACTANCY	AH T R AE K T AH N S IY
ATTRACTANT	AH T R AE K T AH N T
ATTRACTANTS	AH T R AE K T AH N T S
ATTRACTED	AH T R AE K T AH D
ATTRACTING	AH T R AE K T IH NG
ATTRACTION	AH T R AE K SH AH N
ATTRACTIONS	AH T R AE K SH AH N Z
ATTRACTIVE	AH T R AE K T IH V
ATTRACTIVELY	AH T R AE K T IH V L IY
ATTRACTIVENESS	AH T R AE K T IH V N AH S
ATTRACTIVENESSES	AH T R AE K T IH V N AH S IH Z
ATTRACTOR	AH T R AE K T ER
ATTRACTORS	AH T R AE K T ER Z
ATTRACTS	AH T R AE K T S
ATTRIBUTABLE	AH T R IH B Y AH T AH B AH L
ATTRIBUTE	AH T R IH B Y UW T
ATTRIBUTED	AH T R IH B Y AH T AH D
ATTRIBUTES	AH T R IH B Y UW T S
ATTRIBUTING	AH T R IH B Y AH T IH NG
ATTRIBUTION	AE T R IH B Y UW SH AH N
ATTRIBUTIONAL	AE T R AH B Y UW SH AH N AH L
ATTRIBUTIONS	AE T R AH B Y UW SH AH N Z
ATTRIBUTIVE	AE T R AH B Y UW T IH V
ATTRIBUTIVELY	AE T R AH B Y UW T IH V L IY
ATTRIBUTIVES	AE T R AH B Y UW T IH V Z
ATTRITE	AE T R AY T
ATTRITED	AE T R AY T AH D
ATTRITION	AH T R IH SH AH N
ATTRITIONAL	AH T R IH SH AH N AH L
ATTRITIONS	AH T R IH SH AH N Z
ATTUNE	AH T UW N
ATTUNED	AH T UW N D
ATTUNEMENT	AH T UW N M AH N T
ATTUNEMENTS	AH T UW N M AH N T S
ATTUNES	AH T UW N Z
ATTUNING	AH T UW N IH NG
ATWITTER	AH T W IH T ER
AUDIOCASSETTE	AH D IY AA K AH S EH T
AUDIOCASSETTES	AH D IY AH K AE S EH T S
BABBITT	B AE B IH T
BABBITTED	B AE B AH T IH D
BABBITTING	B AE B AH T IH NG
BABBITTS	B AE B IH T S
BABYSITTER	B EY B IY S IH T ER
BABYSITTERS	B EY B IY S IH T ER Z
BABYSITTING	B EY B IY S IH T IH NG
BACHELORETTE	B AE CH L ER EH T
BACHELORETTES	B AE CH L ER EH T S
BACKBITTEN	B AE K B IH T AH N
BACKFITTED	B AE K F IH T IH D
BACKFITTING	B AE K F IH T IH NG
BACKSCATTER	B AE K S K AE T ER
BACKSCATTERED	B AE K S K AE T ER D
BACKSCATTERING	B AE K S K AE T ER IH NG
BACKSCATTERINGS	B AE K S K AE T ER IH NG Z
BACKSCATTERS	B AE K S K AE T ER Z
BAGUETTE	B AE G EH T
BAGUETTES	B AE G Y UW EH T S
BANDITTI	B AE N D IH T IY
BANNERETTE	B AE N ER EH T
BANNERETTES	B AE N ER EH T S
BANQUETTE	B AE NG K W EH T
BANQUETTES	B AE NG K W EH T S
BARBETTE	B AA R B EH T
BARBETTES	B AA R B EH T S
BARQUETTE	B AA R K W EH T
BARQUETTES	B AA R K W EH T S
BARRETTE	B ER EH T
BARRETTES	B AA R EH T S
BASSETTED	B EY S EH T IH D
BASSETTING	B EY S EH T IH NG
BATT	B AE T
BATTAILOUS	B AE T EY L AH S
BATTALIA	B AE T EY L Y AH
BATTALIAS	B AE T EY L Y AH Z
BATTALION	B AH T AE L Y AH N
BATTALIONS	B AH T AE L Y AH N Z
BATTEAU	B AE T IY UW
BATTEAUX	B AE T IY AH K S
BATTED	B AE T IH D
BATTEMENT	B AE T M AH N T
BATTEMENTS	B AE T AH M AH N T S
BATTEN	B AE T AH N
BATTENED	B AE T AH N D
BATTENER	B AE T AH N ER
BATTENERS	B AE T AH N ER Z
BATTENING	B AE T AH N IH NG
BATTENS	B AE T AH N Z
BATTER	B AE T ER
BATTERED	B AE T ER D
BATTERIE	B AE T ER IY
BATTERIES	B AE T ER IY Z
BATTERING	B AE T ER IH NG
BATTERS	B AE T ER Z
BATTERY	B AE T ER IY
BATTIER	B AE T IY ER
BATTIEST	B AE T IY AH S T
BATTIK	B AE T AH K
BATTIKS	B AE T AH K S
BATTINESS	B AE T IY N AH S
BATTINESSES	B AE T IY N AH S IH Z
BATTING	B AE T IH NG
BATTINGS	B AE T IH NG Z
BATTLE	B AE T AH L
BATTLED	B AE T AH L D
BATTLEFIELD	B AE T AH L F IY L D
BATTLEFIELDS	B AE T AH L F IY L D Z
BATTLEFRONT	B AE T AH L F R AH N T
BATTLEFRONTS	B AE T AH L F R AH N T S
BATTLEGROUND	B AE T AH L G R AW N D
BATTLEGROUNDS	B AE T AH L G R AW N D Z
BATTLEMENT	B AE T AH L M AH N T
BATTLEMENT(2)	B AE T AH L M EH N T
BATTLEMENTED	B AE T AH L M AH N T IH D
BATTLEMENTS	B AE T AH L M AH N T S
BATTLER	B AE T AH L ER
BATTLERS	B AE T AH L ER Z
BATTLES	B AE T AH L Z
BATTLESHIP	B AE T AH L SH IH P
BATTLESHIPS	B AE T AH L SH IH P S
BATTLEWAGON	B AE T AH L W AE G AH N
BATTLEWAGONS	B AE T AH L W AE G AH N Z
BATTLING	B AE T AH L IH NG
BATTLING(2)	B AE T L IH NG
BATTS	B AE T S
BATTU	B AE T UW
BATTUE	B AE T UW
BATTUES	B AE T Y UW S
BATTY	B AE T IY
BAYONETTED	B EY AH N AH T IH D
BAYONETTING	B EY AH N AH T IH NG
BEDOTTED	B IH D AA T IH D
BEDWETTER	B EH D W EH T ER
BEDWETTERS	B EH D W EH T ER Z
BEFITTED	B IH F IH T IH D
BEFITTING	B IH F IH T IH NG
BEFITTINGLY	B IH F IH T IH NG L IY
BEFRETTED	B IH F R EH T IH D
BEFRETTING	B IH F R EH T IH NG
BEGETTER	B IH G EH T ER
BEGETTERS	B IH G EH T ER Z
BEGETTING	B IH G EH T IH NG
BEGOTTEN	B IY G AO T IH N
BEKNOTTED	B IH N AA T IH D
BEKNOTTING	B IH N AA T IH NG
BELITTLE	B IH L IH T AH L
BELITTLED	B IH L IH T AH L D
BELITTLEMENT	B IH L IH T AH L M AH N T
BELITTLEMENTS	B IH L IH T AH L M AH N T S
BELITTLER	B IH L IH T AH L ER
BELITTLERS	B IH L IH T AH L ER Z
BELITTLES	B IH L IH T AH L Z
BELITTLING	B IH L IH T AH L IH NG
BELITTLING(2)	B IH L IH T L IH NG
BELLYBUTTON	B EH L IY B AH T AH N
BELLYBUTTONS	B EH L IY B AH T AH N Z
BENEFITTED	B EH N AH F IH T IH D
BENEFITTING	B EH N AH F IH T IH NG
BERETTA	B ER EH T AH
BERETTAS	B ER EH T AH S
BERRETTA	B IH R EH T AH
BERRETTAS	B IH R EH T AH Z
BESETTER	B IH S EH T ER
BESETTERS	B IH S EH T ER Z
BESETTING	B IH S EH T IH NG
BESMUTTED	B IH S M AH T AH D
BESMUTTING	B IH S M AH T AH NG
BESOTTED	B AH S AA T AH D
BESOTTING	B AH S AA T AH NG
BESPATTER	B IH S P AE T ER
BESPATTERED	B IH S P AE T ER D
BESPATTERING	B IH S P AE T ER IH NG
BESPATTERS	B IH S P AE T ER Z
BETATTER	B IH T AE T ER
BETATTERED	B IH T AE T ER D
BETATTERING	B IH T AE T ER IH NG
BETATTERS	B IH T AE T ER Z
BETTA	B EH T AH
BETTAS	B IH T AE Z
BETTED	B EH T IH D
BETTER	B EH T ER
BETTERED	B EH T ER D
BETTERING	B EH T ER IH NG
BETTERMENT	B EH T ER M AH N T
BETTERMENTS	B EH T ER M AH N T S
BETTERS	B EH T ER Z
BETTING	B EH T IH NG
BETTOR	B EH T ER
BETTORS	B EH T ER Z
BIRETTA	B AY R AH T AA
BIRETTAS	B AY R AH T AE Z
BIRRETTA	B AY R EH T AH
BIRRETTAS	B AY R EH T AH Z
BITT	B IH T
BITTED	B IH T IH D
BITTEN	B IH T AH N
BITTER	B IH T ER
BITTERBRUSH	B IH T ER B R AH SH
BITTERBRUSHES	B IH T ER B R AH SH IH Z
BITTERED	B IH T ER D
BITTERER	B IH T ER ER
BITTEREST	B IH T ER AH S T
BITTERING	B IH T ER IH NG
BITTERISH	B IH T ER IH SH
BITTERLY	B IH T ER L IY
BITTERN	B AY T AH R N
BITTERNESS	B IH T ER N AH S
BITTERNESSES	B IH T ER N AH S IH Z
BITTERNS	B AY T AH R N Z
BITTERROOT	B IH T ER R UW T
BITTERROOTS	B IH T ER R UW T S
BITTERS	B IH T ER Z
BITTERSWEET	B IH T ER S W IY T
BITTERSWEETLY	B IH T ER S W IY T L IY
BITTERSWEETNESS	B IH T ER S W IY T N AH S
BITTERSWEETNESSES	B IH T ER S W IY T N AH S IH Z
BITTERSWEETS	B IH T ER S W IY T S
BITTERWEED	B IH T ER W IY D
BITTERWEEDS	B IH T ER W IY D Z
BITTIER	B IH T IY ER
BITTIEST	B IH T IY AH S T
BITTING	B IH T IH NG
BITTINGS	B IH T IH NG Z
BITTOCK	B AY T AA K
BITTOCKS	B AY T AA K S
BITTS	B IH T S
BITTY	B IH T IY
BLANQUETTE	B L AE NG K W EH T
BLANQUETTES	B L AE NG K W EH T S
BLATTED	B L AE T AH D
BLATTER	B L AE T ER
BLATTERED	B L EY T ER D
BLATTERING	B L EY T ER IH NG
BLATTERS	B L EY T ER Z
BLATTING	B L AE T AH NG
BLOODLETTING	B L AH D L EH T IH NG
BLOODLETTINGS	B L AH D L AH T IH NG Z
BLOTTED	B L AA T AH D
BLOTTER	B L AA T ER
BLOTTERS	B L AA T ER Z
BLOTTIER	B L AA T IY ER
BLOTTIEST	B L AA T IY AH S T
BLOTTING	B L AA T IH NG
BLOTTO	B L AA T OW
BLOTTY	B L AA T IY
BLUEBOTTLE	B L UW B AO T AH L
BLUEBOTTLES	B L UW B AO T AH L Z
BODDHISATTVA	B AA D HH AH S AE T V AH
BODDHISATTVAS	B AA D HH AH S AE T V AH Z
BODHISATTVA	B OW D IH S AH T B AH
BODHISATTVAS	B OW D IH S AA T V AH S
BONESETTER	B OW N S EH T ER
BONESETTERS	B OW N S EH T ER Z
BOTT	B AA T
BOTTLE	B AA T AH L
BOTTLEBRUSH	B AA T AH L B R AH SH
BOTTLEBRUSHES	B AA T AH L B R AH SH IH Z
BOTTLED	B AA T AH L D
BOTTLEFUL	B AA T AH L F AH L
BOTTLEFULS	B AA T AH L F AH L Z
BOTTLENECK	B AA T AH L N EH K
BOTTLENECKED	B AA T AH L N EH K T
BOTTLENECKING	B AA T AH L N EH K IH NG
BOTTLENECKS	B AA T AH L N EH K S
BOTTLER	B AA T L ER
BOTTLERS	B AA T L ER Z
BOTTLES	B AA T AH L Z
BOTTLING	B AA T AH L IH NG
BOTTLING(2)	B AA T L IH NG
BOTTLINGS	B AA T AH L IH NG Z
BOTTOM	B AA T AH M
BOTTOMED	B AA T AH M D
BOTTOMER	B AA T AH M ER
BOTTOMERS	B AA T AH M ER Z
BOTTOMING	B AA T AH M IH NG
BOTTOMLAND	B AA T AH M L AE N D
BOTTOMLANDS	B AA T AH M L AE N D Z
BOTTOMLESS	B AA T AH M L AH S
BOTTOMLESSLY	B AA T AH M L AH S L IY
BOTTOMLESSNESS	B AA T AH M L AH S N AH S
BOTTOMLESSNESSES	B AA T AH M L AH S N AH S IH Z
BOTTOMMOST	B AA T AH M OW S T
BOTTOMRIES	B AA T AH M R IY Z
BOTTOMRY	B AA T AH M R IY
BOTTOMS	B AA T AH M Z
BOTTS	B AA T S
BOYCOTT	B OY K AA T
BOYCOTTED	B OY K AA T IH D
BOYCOTTER	B OY K AA T ER
BOYCOTTERS	B OY K AA T ER Z
BOYCOTTING	B OY K AA T IH NG
BOYCOTTS	B OY K AA T S
BRATTICE	B R AE T AH S
BRATTICED	B R AE T AH S T
BRATTICES	B R AE T AH S
BRATTICING	B R AE T IH S AH NG
BRATTIER	B R AE T AY AH R
BRATTIEST	B R AE T AY AH S T
BRATTINESS	B R AE T AH N AH S
BRATTINESSES	B R AE T AH N EH S AH Z
BRATTISH	B R AE T AH SH
BRATTLE	B R AE T AH L
BRATTLED	B R AE T AH L D
BRATTLES	B R AE T AH L Z
BRATTLING	B R AE T L AH NG
BRATTY	B R AE T IY
BREVETTED	B R AH V EH T IH D
BREVETTING	B R AH V EH T IH NG
BRIOLETTE	B R AY AH L EH T
BRIOLETTES	B R AY AH L EH T S
BRIQUETTE	B R IH K W EH T
BRIQUETTED	B R IH K W EH T AH D
BRIQUETTES	B R IH K W EH T S
BRIQUETTING	B R IH K W EH T AH NG
BRITT	B R IH T
BRITTLE	B R IH T AH L
BRITTLED	B R IH T AH L D
BRITTLELY	B R IH T AH L IY
BRITTLENESS	B R IH T AH L N AH S
BRITTLENESSES	B R IH T AH L N AH S IH Z
BRITTLER	B R IH T L ER
BRITTLES	B R IH T AH L Z
BRITTLEST	B R IH T L IH S T
BRITTLING	B R IH T AH L IH NG
BRITTLY	B R IH T AH L IY
BRITTS	B R IH T S
BROCHETTE	B R AH CH EH T
BROCHETTES	B R AH CH EH T S
BRUNETTE	B R UW N EH T
BRUNETTES	B R UW N EH T S
BULLSHITTED	B UH L SH IH T IH D
BULLSHITTING	B UH L SH IH T IH NG
BURETTE	B IY Y ER EH T
BURETTES	B IY Y ER EH T S
BUTT	B AH T
BUTTALS	B AH T AH L Z
BUTTE	B Y UW T
BUTTED	B AH T IH D
BUTTER	B AH T ER
BUTTERBALL	B AH T ER B AO L
BUTTERBALLS	B AH T ER B AO L Z
BUTTERCUP	B AH T ER K AH P
BUTTERCUPS	B AH T ER K AH P S
BUTTERED	B AH T ER D
BUTTERFAT	B AH T ER F AE T
BUTTERFATS	B AH T ER F AE T S
BUTTERFINGERED	B AH T ER F IH NG G ER D
BUTTERFINGERS	B AH T ER F IH NG G ER Z
BUTTERFISH	B AH T ER F IH SH
BUTTERFISHES	B AH T ER F IH SH IH Z
BUTTERFLIED	B AH T ER F L AY D
BUTTERFLIES	B AH T ER F L AY Z
BUTTERFLY	B AH T ER F L AY
BUTTERFLYER	B AH T ER F L AY ER
BUTTERFLYERS	B AH T ER F L AY ER Z
BUTTERFLYING	B AH T ER F L AY IH NG
BUTTERIER	B AH T AH R IY ER
BUTTERIES	B AH T AH R IY Z
BUTTERIEST	B AH T AH R IY AH S T
BUTTERING	B AH T ER IH NG
BUTTERLESS	B AH T ER L AH S
BUTTERMILK	B AH T ER M IH L K
BUTTERMILKS	B AH T ER M IH L K S
BUTTERNUT	B AH T ER N AH T
BUTTERNUTS	B AH T ER N AH T S
BUTTERS	B AH T ER Z
BUTTERSCOTCH	B AH T ER S K AA CH
BUTTERSCOTCHES	B AH T ER S K AA CH IH Z
BUTTERWEED	B AH T ER W IY D
BUTTERWEEDS	B AH T ER W IY D Z
BUTTERWORT	B AH T AH R W AH R T
BUTTERWORTS	B AH T AH R W AH R T S
BUTTERY	B AH T ER IY
BUTTES	B Y UW T S
BUTTIES	B AH T IY Z
BUTTING	B AH T IH NG
BUTTINSKI	B AH T IH N S K IY
BUTTINSKIES	B AH T IH N S K AY Z
BUTTINSKY	B AH T IH N S K AY
BUTTOCK	B AH T AH K
BUTTOCKS	B AH T AH K S
BUTTON	B AH T AH N
BUTTONBALL	B AH T AH N B AO L
BUTTONBALLS	B AH T AH N B AO L Z
BUTTONBUSH	B AH T AH N B UH SH
BUTTONBUSHES	B AH T AH N B UH SH IH Z
BUTTONED	B AH T AH N D
BUTTONER	B AH T AH N ER
BUTTONERS	B AH T AH N ER Z
BUTTONHOLE	B AH T AH N HH OW L
BUTTONHOLED	B AH T AH N HH OW L D
BUTTONHOLER	B AH T AH N HH OW L ER
BUTTONHOLERS	B AH T AH N HH OW L ER Z
BUTTONHOLES	B AH T AH N HH OW L Z
BUTTONHOLING	B AH T AH N HH OW L IH NG
BUTTONHOOK	B AH T AH N HH UH K
BUTTONHOOKED	B AH T AH N HH UH K T
BUTTONHOOKING	B AH T AH N HH UH K IH NG
BUTTONHOOKS	B AH T AH N HH UH K S
BUTTONING	B AH T AH N IH NG
BUTTONLESS	B AH T AH N L AH S
BUTTONS	B AH T AH N Z
BUTTONWOOD	B AH T AH N W UH D
BUTTONWOODS	B AH T AH N W UH D Z
BUTTONY	B AH T AH N IY
BUTTRESS	B AH T R AH S
BUTTRESSED	B AH T R AH S T
BUTTRESSES	B AH T R AH S AH Z
BUTTRESSES(2)	B AH T R AH S IH Z
BUTTRESSING	B AH T R AH S IH NG
BUTTS	B AH T S
BUTTSTOCK	B AH T S T AA K
BUTTSTOCKS	B AH T S T AA K S
BUTTY	B AH T IY
CABALETTA	K AE B AH L EH T AH
CABALETTAS	K AE B AH L EH T AH Z
CABRETTA	K AE B R EH T AH
CABRETTAS	K AE B R EH T AH Z
CALOTTE	K AE L AH T
CALOTTES	K AE L AH T S
CAPPELLETTI	K AA P EH L EH T IY
CARBURETTED	K AA R B IY Y ER EH T IH D
CARBURETTER	K AA R B IY Y ER EH T ER
CARBURETTERS	K AA R B IY Y ER EH T ER Z
CARBURETTING	K AA R B IY Y ER EH T IH NG
CARBURETTOR	K AA R B IY Y ER EH T ER
CARBURETTORS	K AA R B IY Y ER EH T ER Z
CARROTTOP	K AE R AH T AA P
CARROTTOPPED	K AE R AH T AA P T
CARROTTOPS	K AE R AH T AA P S
CASETTE	K EY S EH T
CASETTES	K EY S EH T S
CASSETTE	K AH S EH T
CASSETTES	K AH S EH T S
CATTAIL	K AE T EY L
CATTAILS	K AE T EY L Z
CATTALO	K AE T AH L OW
CATTALOES	K AE T AH L OW Z
CATTALOS	K AE T AH L AA S
CATTED	K AE T IH D
CATTERIES	K AE T AH R IY Z
CATTERY	K AE T AH R IY
CATTIE	K AE T IY
CATTIER	K AE T IY ER
CATTIES	K AE T IY Z
CATTIEST	K AE T IY AH S T
CATTILY	K AE T IY L IY
CATTINESS	K AE T IY N AH S
CATTINESSES	K AE T IY N AH S IH Z
CATTING	K AE T IH NG
CATTISH	K AE T IH SH
CATTLE	K AE T AH L
CATTLEMAN	K AE T AH L M AE N
CATTLEMEN	K AE T AH L M AH N
CATTLEMEN(2)	K AE T AH L M IH N
CATTLEYA	K AE T L EY AH
CATTLEYAS	K AE T L EY AH Z
CATTY	K AE T IY
CAVALETTI	K AE V AH L EH T IY
CAVALLETTI	K AE V AH L EH T IY
CAVETTI	K AH V EH T IY
CAVETTO	K AH V EH T OW
CAVETTOS	K AH V EH T AH Z
CELLARETTE	S EH L ER EH T
CELLARETTES	S EH L ER EH T S
CHAPATTI	CH AH P AE T IY
CHAPATTIES	CH AH P AE T AY Z
CHAPATTIS	CH AH P AE T AH S
CHARLOTTE	SH AA R L AH T
CHARLOTTES	SH AA R L AH T S
CHATTED	CH AE T AH D
CHATTED(2)	CH AE T IH D
CHATTEL	CH AE T AH L
CHATTELS	CH AE T AH L Z
CHATTER	CH AE T ER
CHATTERBOX	CH AE T ER B AA K S
CHATTERBOXES	CH AE T ER B AA K S IH Z
CHATTERED	CH AE T ER D
CHATTERER	CH AE T ER ER
CHATTERERS	CH AE T ER ER Z
CHATTERING	CH AE T ER IH NG
CHATTERS	CH AE T ER Z
CHATTERY	CH AE T AH R IY
CHATTIER	CH AE T IY ER
CHATTIEST	CH AE T IY AH S T
CHATTILY	CH AE T IY L IY
CHATTINESS	CH AE T IY N AH S
CHATTINESSES	CH AE T IY N AH S IH Z
CHATTING	CH AE T IH NG
CHATTY	CH AE T IY
CHEMISETTE	SH AH M IY Z EH T
CHEMISETTES	SH AH M IY Z EH T S
CHITCHATTED	CH AH CH AE T AH D
CHITCHATTING	CH AH CH AE T AH NG
CHITTER	CH IH T ER
CHITTERED	CH IH T IY R D
CHITTERING	CH IH T IY R AH NG
CHITTERLINGS	CH IH T ER L IH NG Z
CHITTERS	CH IH T AH R Z
CHITTIES	CH IH T AY Z
CHITTY	CH IH T IY
CHOTT	CH AA T
CHOTTS	CH AA T S
CIGARETTE	S IH G AH R EH T
CIGARETTES	S IH G AH R EH T S
CITTERN	S IH T AH R N
CITTERNS	S IH T AH R N Z
CLARINETTIST	K L AE R AH N EH T IH S T
CLARINETTISTS	K L AE R AH N EH T IH S T S
CLATTER	K L AE T ER
CLATTERED	K L AE T ER D
CLATTERER	K L AE T ER ER
CLATTERERS	K L AE T ER ER Z
CLATTERING	K L AE T ER IH NG
CLATTERINGLY	K L AE T ER IH NG L IY
CLATTERS	K L AE T ER Z
CLATTERY	K L AE T ER IY
CLOTTED	K L AA T AH D
CLOTTED(2)	K L AA T IH D
CLOTTING	K L AA T IH NG
CLOTTY	K L AA T IY
CLUTTER	K L AH T ER
CLUTTERED	K L AH T ER D
CLUTTERING	K L AH T ER IH NG
CLUTTERS	K L AH T ER Z
CLUTTERY	K L AH T ER IY
COADMITTED	K OW AH D M IH T IH D
COADMITTING	K OW AH D M IH T IH NG
COATTAIL	K OW T T EY L
COATTAILS	K OW T T EY L Z
COATTEND	K OW AH T EH N D
COATTENDED	K OW AH T EH N D IH D
COATTENDING	K OW AH T EH N D IH NG
COATTENDS	K OW AH T EH N D Z
COATTEST	K OW AH T EH S T
COATTESTED	K OW AH T EH S T IH D
COATTESTING	K OW AH T EH S T IH NG
COATTESTS	K OW AH T EH S T S
COCOTTE	K OW K AH T IY
COCOTTES	K OW K AA T S
COMBATTED	K AH M B AE T IH D
COMBATTING	K AH M B AE T IH NG
COMMITTABLE	K AH M IH T AH B AH L
COMMITTAL	K AH M IH T AH L
COMMITTALS	K AH M IH T AH L Z
COMMITTED	K AH M IH T IH D
COMMITTEE	K AH M IH T IY
COMMITTEEMAN	K AH M IH T IY M AH N
COMMITTEEMEN	K AH M IH T IY M EH N
COMMITTEES	K AH M IH T IY Z
COMMITTEEWOMAN	K AH M IH T IY W UH M AH N
COMMITTEEWOMEN	K AH M IH T IY W IH M AH N
COMMITTING	K AH M IH T IH NG
COMPLOTTED	K AH M P L AA T IH D
COMPLOTTING	K AH M P L AA T IH NG
CONDOTTIERE	K AA N D AA T IY R
CONDOTTIERI	K AA N D AA T AH R IY
CONFETTI	K AH N F EH T IY
CONFETTO	K AA N F EH T OW
COPLOTTED	K OW P L AA T IH D
COPLOTTING	K OW P L AA T IH NG
COPYCATTED	K AA P IY K AE T IH D
COPYCATTING	K AA P IY K AE T IH NG
COQUETTE	K OW K EH T
COQUETTED	K OW K EH T IH D
COQUETTES	K OW K EH T S
COQUETTING	K OW K EH T IH NG
COQUETTISH	K OW K EH T IH SH
COQUETTISHLY	K OW K EH T IH SH L IY
COQUETTISHNESS	K OW K EH T IH SH N AH S
COQUETTISHNESSES	K OW K EH T IH SH N AH S IH Z
CORNETTIST	K AO R N EH T AH S T
CORNETTISTS	K AO R N EH T IH S T S
CORSELETTE	K AA R S AH L EH T
CORSELETTES	K AA R S AH L EH T S
CORVETTE	K AO R V EH T
CORVETTES	K AO R V EH T S
COTTA	K AA T AH
COTTAE	K AA T IY
COTTAGE	K AA T AH JH
COTTAGE(2)	K AA T IH JH
COTTAGER	K AA T IH JH ER
COTTAGERS	K AA T IH JH ER Z
COTTAGES	K AA T IH JH IH Z
COTTAGEY	K AA T IH JH IY
COTTAR	K AA T ER
COTTARS	K AA T ER Z
COTTAS	K AA T AE Z
COTTER	K AA T ER
COTTERED	K AA T ER D
COTTERLESS	K AA T ER L AH S
COTTERS	K AA T ER Z
COTTIER	K AA T IY ER
COTTIERS	K AA T IY ER Z
COTTON	K AA T AH N
COTTON(2)	K AO T AH N
COTTONED	K AA T AH N D
COTTONING	K AA T AH N IH NG
COTTONMOUTH	K AA T AH N M AW TH
COTTONMOUTHS	K AA T AH N M AW TH S
COTTONS	K AA T AH N Z
COTTONSEED	K AA T AH N S IY D
COTTONSEEDS	K AA T AH N S IY D Z
COTTONTAIL	K AA T AH N T EY L
COTTONTAILS	K AA T AH N T EY L Z
COTTONWEED	K AA T AH N W IY D
COTTONWEEDS	K AA T AH N W IY D Z
COTTONWOOD	K AA T AH N W UH D
COTTONWOODS	K AA T AH N W UH D Z
COTTONY	K AA T AH N IY
COUNTERATTACK	K AW N T ER AH T AE K
COUNTERATTACK(2)	K AW N ER AH T AE K
COUNTERATTACKED	K AW N T ER AH T AE K T
COUNTERATTACKED(2)	K AW N ER AH T AE K T
COUNTERATTACKER	K AW N T ER AH T AE K ER
COUNTERATTACKERS	K AW N T ER AH T AE K ER Z
COUNTERATTACKING	K AW N T ER AH T AE K IH NG
COUNTERATTACKING(2)	K AW N ER AH T AE K IH NG
COUNTERATTACKS	K AW N T ER AH T AE K S
COUNTERATTACKS(2)	K AW N ER AH T AE K S
COUNTERPLOTTED	K AW N T ER P L AA T IH D
COUNTERPLOTTING	K AW N T ER P L AA T IH NG
COURGETTE	K OW ER JH EH T
COURGETTES	K OW ER JH EH T S
COWRITTEN	K OW R IH T AH N
CRITTER	K R IH T ER
CRITTERS	K R IH T ER Z
CRITTUR	K R IH T AH R
CRITTURS	K R IH T Y AH R Z
CROQUETTE	K R AA K W EH T
CROQUETTES	K R AA K W EH T S
CROSSCUTTING	K R AO S K AH T IH NG
CROSSCUTTINGS	K R AO S K AH T IH NG Z
CUITTLE	K IH T AH L
CUITTLED	K IH T AH L D
CUITTLES	K IH T AH L Z
CUITTLING	K IH T L AH NG
CULOTTE	K Y UW L AH T
CULOTTES	K Y UW L AH T S
CURETTAGE	K Y UH R EH T IH JH
CURETTAGES	K Y UH R EH T IH JH IH Z
CURETTE	K Y UH R EH T
CURETTED	K Y UH R EH T IH D
CURETTEMENT	K Y UH R EH T M AH N T
CURETTEMENTS	K Y UH R EH T M AH N T S
CURETTES	K Y UH R EH T S
CURETTING	K Y UH R EH T IH NG
CURVETTED	K ER V EH T IH D
CURVETTING	K ER V EH T IH NG
CUTTABLE	K AH T AH B AH L
CUTTAGE	K AH T IH JH
CUTTAGES	K AH T IH JH IH Z
CUTTER	K AH T ER
CUTTERS	K AH T ER Z
CUTTHROAT	K AH T TH R OW T
CUTTHROATS	K AH T TH R OW T S
CUTTIES	K AH T IY Z
CUTTING	K AH T IH NG
CUTTINGLY	K AH T IH NG L IY
CUTTINGS	K AH T IH NG Z
CUTTLE	K AH T AH L
CUTTLEBONE	K AH T L AH B OW N
CUTTLEBONES	K AH T L AH B OW N Z
CUTTLED	K AH T AH L D
CUTTLEFISH	K AH T AH L F IH SH
CUTTLEFISHES	K AH T L EH F AH SH AH Z
CUTTLES	K AH T AH L Z
CUTTLING	K AH T L AH NG
CUTTY	K AH T IY
CUVETTE	K Y UW V EH T
CUVETTES	K Y UW V EH T S
DATTO	D AE T OW
DATTOS	D AE T AH Z
DEFATTED	D IY F AE T IH D
DEFATTING	D IY F AE T IH NG
DEMITTED	D IH M IH T IH D
DEMITTING	D IH M IH T IH NG
DERATTED	D IY R AE T IH D
DERATTING	D IY R AE T IH NG
DILETTANTE	D IH L AH T AA N T
DILETTANTES	D IH L AH T AA N T S
DILETTANTI	D IH L AH T AE N T IY
DILETTANTISH	D IH L AH T AA N T IH SH
DILETTANTISM	D IH L AH T AA N T IH Z AH M
DILETTANTISMS	D IH L AH T AA N T IH Z AH M Z
DIMWITTED	D IH M W IH T IH D
DINETTE	D AY N EH T
DINETTES	D AY N EH T S
DIPNETTED	D IH P N EH T IH D
DIPNETTING	D IH P N EH T IH NG
DISKETTE	D IH S K EH T
DISKETTES	D IH S K EH T S
DITTANIES	D IH T AH N AY Z
DITTANY	D IH T AH N IY
DITTIES	D IH T IY Z
DITTO	D IH T OW
DITTOED	D IH T OW D
DITTOING	D IH T OW AH NG
DITTOS	D IH T AH Z
DITTY	D IH T IY
DOGTROTTED	D AO G T R AA T IH D
DOGTROTTING	D AO G T R AA T IH NG
DOTTED	D AA T AH D
DOTTED(2)	D AA T IH D
DOTTEL	D AA T AH L
DOTTELS	D AA T AH L Z
DOTTER	D AA T ER
DOTTEREL	D AA T AH R AH L
DOTTERELS	D AA T AH R AH L Z
DOTTERS	D AA T ER Z
DOTTIER	D AA T IY ER
DOTTIEST	D AA T IY AH S T
DOTTILY	D AA T IY L IY
DOTTINESS	D AA T IY N AH S
DOTTINESSES	D AA T IY N AH S IH Z
DOTTING	D AA T IH NG
DOTTLE	D AA T AH L
DOTTLES	D AA T AH L Z
DOTTREL	D AA T R AH L
DOTTRELS	D AA T R AH L Z
DOTTY	D AA T IY
DRATTED	D R AE T AH D
DRATTING	D R AE T AH NG
DUETTED	D UW EH T IH D
DUETTING	D UW EH T IH NG
DUETTIST	D UW EH T IH S T
DUETTISTS	D UW EH T IH S T S
EARSPLITTING	IH ER S P L IH T IH NG
EMBATTLE	EH M B AE T AH L
EMBATTLED	EH M B AE T AH L D
EMBATTLEMENT	IH M B AE T AH L M AH N T
EMBATTLEMENTS	IH M B AE T AH L M AH N T S
EMBATTLES	IH M B AE T AH L Z
EMBATTLING	IH M B AE T AH L IH NG
EMBITTER	EH M B IH T ER
EMBITTERED	EH M B IH T ER D
EMBITTERING	IH M B IH T ER IH NG
EMBITTERMENT	IH M B IH T ER M AH N T
EMBITTERMENTS	IH M B IH T ER M AH N T S
EMBITTERS	IH M B IH T ER Z
EMBRITTLE	IH M B R IH T AH L
EMBRITTLED	IH M B R IH T AH L D
EMBRITTLEMENT	IH M B R IH T AH L M AH N T
EMBRITTLEMENTS	IH M B R IH T AH L M AH N T S
EMBRITTLES	IH M B R IH T AH L Z
EMBRITTLING	IH M B R IH T AH L IH NG
EMITTANCE	IY M IH T AH N S
EMITTANCES	IY M IH T AH N S IH Z
EMITTED	IH M IH T AH D
EMITTED(2)	IH M IH T IH D
EMITTER	IH M IH T ER
EMITTERS	IY M IH T ER Z
EMITTING	IH M IH T IH NG
ENFETTER	EH N F EH T ER
ENFETTERED	EH N F EH T ER D
ENFETTERING	EH N F EH T ER IH NG
ENFETTERS	EH N F EH T ER Z
ENGLUTTED	EH N G L AH T IH D
ENGLUTTING	EH N G L AH T IH NG
EPAULETTE	EH P EY AH L EH T
EPAULETTED	EH P AH L EH T IH D
EPAULETTES	AH P EY AH L EH T S
EPIGLOTTAL	AH P IH G L AA T AH L
EPIGLOTTIC	AH P IH G L AH T AH K
EPIGLOTTIDES	AH P IH G L AH T AY D Z
EPIGLOTTIS	AH P IH G L AA T AH S
EPIGLOTTISES	AH P IH G L AH T AY Z AH Z
ETIQUETTE	EH T AH K AH T
ETIQUETTES	EH T IH K AH T S
EYELETTED	AY L AH T IH D
EYELETTING	AY L AH T IH NG
FACETTED	F AE S AH T IH D
FACETTING	F AE S AH T IH NG
FALSETTO	F AO L S EH T OW
FALSETTOS	F AO L S EH T OW Z
FARMERETTE	F AA R M ER EH T
FARMERETTES	F AA R M ER EH T S
FATTED	F AE T IH D
FATTEN	F AE T AH N
FATTENED	F AE T AH N D
FATTENER	F AE T AH N ER
FATTENERS	F AE T AH N ER Z
FATTENING	F AE T AH N IH NG
FATTENING(2)	F AE T N IH NG
FATTENS	F AE T AH N Z
FATTER	F AE T ER
FATTEST	F AE T AH S T
FATTIER	F AE T IY ER
FATTIES	F AE T IY Z
FATTIEST	F AE T IY AH S T
FATTILY	F AE T IY L IY
FATTINESS	F AE T IY N AH S
FATTINESSES	F AE T IY N AH S IH Z
FATTING	F AE T IH NG
FATTISH	F AE T IH SH
FATTY	F AE T IY
FEATURETTE	F IY CH ER EH T
FEATURETTES	F IY CH ER EH T S
FETTED	F EH T AH D
FETTER	F EH T ER
FETTERED	F EH T ER D
FETTERER	F EH T ER ER
FETTERERS	F EH T ER ER Z
FETTERING	F EH T ER IH NG
FETTERS	F EH T ER Z
FETTING	F EH T IH NG
FETTLE	F EH T AH L
FETTLED	F EH T AH L D
FETTLES	F EH T AH L Z
FETTLING	F EH T L AH NG
FETTLINGS	F EH T L AH NG Z
FETTUCCINE	F EH T AH CH IY N IY
FETTUCCINI	F EH T AH K S AH N IY
FETTUCINE	F EH T Y AH S AY N
FETTUCINI	F EH T Y UW S AH N IY
FIANCHETTI	F AY AH NG K EH T IY
FIANCHETTO	F AY AH NG K EH T OW
FIANCHETTOED	F AY AE NG K EH T OW D
FIANCHETTOING	F AY AH NG K EH T OW AH NG
FIANCHETTOS	F AY AH NG K EH T AH Z
FILMSETTER	F IH L M S EH T ER
FILMSETTERS	F IH L M S EH T ER Z
FILMSETTING	F IH L M S EH T IH NG
FILMSETTINGS	F IH L M S EH T IH NG Z
FITTABLE	F IH T AH B AH L
FITTED	F IH T AH D
FITTED(2)	F IH T IH D
FITTER	F IH T ER
FITTERS	F IH T ER Z
FITTEST	F IH T AH S T
FITTING	F IH T IH NG
FITTINGLY	F IH T IH NG L IY
FITTINGNESS	F IH T IH NG N AH S
FITTINGNESSES	F IH T IH NG N AH S IH Z
FITTINGS	F IH T IH NG Z
FLANNELETTE	F L AE N AH L EH T
FLANNELETTES	F L AE N AH L EH T S
FLATTED	F L AE T IH D
FLATTEN	F L AE T AH N
FLATTENED	F L AE T AH N D
FLATTENER	F L AE T AH N ER
FLATTENERS	F L AE T AH N ER Z
FLATTENING	F L AE T AH N IH NG
FLATTENING(2)	F L AE T N IH NG
FLATTENS	F L AE T AH N Z
FLATTER	F L AE T ER
FLATTERED	F L AE T ER D
FLATTERER	F L AE T ER ER
FLATTERERS	F L AE T ER ER Z
FLATTERIES	F L AE T AH R IY Z
FLATTERING	F L AE T ER IH NG
FLATTERINGLY	F L AE T ER IH NG L IY
FLATTERS	F L AE T ER Z
FLATTERY	F L AE T ER IY
FLATTEST	F L AE T AH S T
FLATTING	F L AE T IH NG
FLATTISH	F L AE T IH SH
FLATTOP	F L AE T AA P
FLATTOPS	F L AE T AA P S
FLECHETTE	F L AH CH EH T
FLECHETTES	F L AH CH EH T S
FLITTED	F L IH T IH D
FLITTER	F L IH T ER
FLITTERED	F L IH T ER D
FLITTERING	F L IH T ER IH NG
FLITTERS	F L IH T ER Z
FLITTING	F L IH T IH NG
FLOWERETTE	F L AW ER EH T
FLOWERETTES	F L AW ER EH T S
FLUTTER	F L AH T ER
FLUTTERBOARD	F L AH T ER B OW R D
FLUTTERBOARDS	F L AH T ER B OW R D Z
FLUTTERED	F L AH T ER D
FLUTTERER	F L AH T ER ER
FLUTTERERS	F L AH T ER ER Z
FLUTTERING	F L AH T ER IH NG
FLUTTERS	F L AH T ER Z
FLUTTERY	F L AH T ER IY
FLYSWATTER	F L AY Z W AA T ER
FLYSWATTERS	F L AY Z W AA T ER Z
FORGETTABLE	F AO R G EH T AH B AH L
FORGETTABLE(2)	F ER G EH T AH B AH L
FORGETTER	F OW R JH EH T ER
FORGETTERS	F OW R JH EH T ER Z
FORGETTING	F ER G EH T IH NG
FORGETTING(2)	F AO R G EH T IH NG
FORGOTTEN	F ER G AA T AH N
FORGOTTEN(2)	F AO R G AA T AH N
FORMATTED	F AO R M AE T IH D
FORMATTER	F AO R M AE T ER
FORMATTERS	F AO R M AE T ER Z
FORMATTING	F AO R M AE T IH NG
FORMFITTING	F AO R M F IH T IH NG
FOSSETTE	F AA S EH T
FOSSETTES	F AA S EH T S
FOUETTE	F AW EH T
FOUETTES	F AW EH T S
FOXTROTTED	F AA K S T R AA T IH D
FOXTROTTING	F AA K S T R AA T IH NG
FRETTED	F R EH T IH D
FRETTER	F R EH T ER
FRETTERS	F R EH T ER Z
FRETTIER	F R EH T IY ER
FRETTIEST	F R EH T IY AH S T
FRETTING	F R EH T IH NG
FRETTY	F R EH T IY
FRISETTE	F R AY Z EH T
FRISETTES	F R AY Z EH T S
FRITT	F R IH T
FRITTATA	F R IH T AH T AH
FRITTATAS	F R IH T AH T AH Z
FRITTED	F R IH T AH D
FRITTER	F R IH T ER
FRITTERED	F R IH T ER D
FRITTERER	F R IH T ER ER
FRITTERERS	F R IH T ER ER Z
FRITTERING	F R IH T ER IH NG
FRITTERS	F R IH T ER Z
FRITTING	F R IH T AH NG
FRITTS	F R IH T S
FRIZETTE	F R AY Z EH T
FRIZETTES	F R AY Z EH T S
FROSTBITTEN	F R AO S T B IH T AH N
FROTTAGE	F R AA T AH JH
FROTTAGES	F R AA T AH JH AH Z
FROTTEUR	F R AA T AH R
FROTTEURS	F R AA T IY Y AH R Z
FUMETTE	F Y UW M EH T
FUMETTES	F Y UW M EH T S
FUTTOCK	F AH T AH K
FUTTOCKS	F AH T AH K S
FYTTE	F IH T
FYTTES	F IH T S
GAROTTE	G AE R AH T
GAROTTED	G AH R AA T AH D
GAROTTER	G AH R AA T AH R
GAROTTERS	G AH R AA T AH R Z
GAROTTES	G AE R AH T S
GAROTTING	G AH R AA T AH NG
GARROTTE	G AE R AH T
GARROTTED	G AE R AA T AH D
GARROTTES	G AE R AH T S
GARROTTING	G AE R AA T AH NG
GAVOTTE	G AH V AA T
GAVOTTED	G AH V AA T IH D
GAVOTTES	G AH V AA T S
GAVOTTING	G AH V AA T IH NG
GAZETTE	G AH Z EH T
GAZETTED	G AH Z EH T IH D
GAZETTEER	G AH Z EH T IH R
GAZETTEERS	G AH Z EH T IH R Z
GAZETTES	G AH Z EH T S
GAZETTING	G AH Z EH T IH NG
GENETTE	JH IY N EH T
GENETTES	JH IY N EH T S
GEORGETTE	JH AO R JH EH T
GEORGETTES	JH IY AO R JH EH T S
GETTABLE	G EH T AH B AH L
GETTER	G EH T ER
GETTERED	G EH T ER D
GETTERING	G EH T ER IH NG
GETTERS	G EH T ER Z
GETTING	G EH T IH NG
GETTING(2)	G IH T IH NG
GHETTO	G EH T OW
GHETTOED	G EH T OW D
GHETTOES	G EH T OW Z
GHETTOING	G EH T OW IH NG
GHETTOIZATION	G EH T OW AH Z EY SH AH N
GHETTOIZATIONS	G EH T OW AH Z EY SH AH N Z
GHETTOIZE	G EH T OW AY Z
GHETTOIZED	G EH T OW AY Z D
GHETTOIZES	G EH T OW AY Z IH Z
GHETTOIZING	G EH T OW AY Z IH NG
GHETTOS	G EH T OW Z
GHOSTWRITTEN	G OW S T R IH T AH N
GIBBETTED	JH IH B AH T IH D
GIBBETTING	JH IH B AH T IH NG
GIGAWATT	G IH G AH W AA T
GIGAWATTS	G IH G AH W AA T S
GILLNETTED	G IH L N EH T IH D
GILLNETTER	G IH L N EH T ER
GILLNETTERS	G IH L N EH T ER Z
GILLNETTING	G IH L N EH T IH NG
GITTERN	JH IH T AH R N
GITTERNS	JH IH T AH R N Z
GITTIN	JH IH T AH N
GLITTER	G L IH T ER
GLITTERATI	G L IH T EH R AH T IY
GLITTERED	G L IH T ER D
GLITTERING	G L IH T ER IH NG
GLITTERINGLY	G L IH T ER IH NG L IY
GLITTERS	G L IH T ER Z
GLITTERY	G L IH T ER IY
GLOTTAL	G L AA T AH L
GLOTTIC	G L AA T AH K
GLOTTIDES	G L AA T AY D Z
GLOTTIS	G L AA T AH S
GLOTTISES	G L AA T AY Z AH Z
GLOTTOCHRONOLOGICAL	G L AA T AA K R AH N AA L AH JH IH S AH L
GLOTTOCHRONOLOGIES	G L AA T OW K R AH N AA L AH JH IY Z
GLOTTOCHRONOLOGY	G L AA T OW K R AH N AA L AH JH IY
GLUTTED	G L AH T IH D
GLUTTING	G L AH T IH NG
GLUTTON	G L AH T AH N
GLUTTONIES	G L AH T AH N IY Z
GLUTTONOUS	G L AH T AH N AH S
GLUTTONOUSLY	G L AH T AH N AH S L IY
GLUTTONOUSNESS	G L AH T AH N AH S N AH S
GLUTTONOUSNESSES	G L AH T AH N AH S N AH S IH Z
GLUTTONS	G L AH T AH N Z
GLUTTONY	G L AH T AH N IY
GNATTIER	N AE T AY AH R
GNATTIEST	N AE T AY AH S T
GNATTY	N AE T IY
GOTTEN	G AA T AH N
GOTTEN(2)	G AO T AH N
GRISETTE	G R AY Z EH T
GRISETTES	G R AY Z EH T S
GRITTED	G R IH T IH D
GRITTIER	G R IH T IY ER
GRITTIEST	G R IH T IY AH S T
GRITTILY	G R IH T IY L IY
GRITTINESS	G R IH T IY N AH S
GRITTINESSES	G R IH T IY N AH S IH Z
GRITTING	G R IH T IH NG
GRITTY	G R IH T IY
GROTTIER	G R AA T AY AH R
GROTTIEST	G R AA T AY AH S T
GROTTO	G R AA T OW
GROTTOES	G R AA T OW Z
GROTTOS	G R AA T OW Z
GROTTY	G R AA T IY
GRUTTEN	G R AH T AH N
GUNCOTTON	G AH N K AA T AH N
GUNCOTTONS	G AH N K AA T AH N Z
GUTTA	G AH T AH
GUTTAE	G AH T IY
GUTTATE	G AH T AH T
GUTTATED	G AH T EY T IH D
GUTTATION	G AH T EY SH AH N
GUTTATIONS	G AH T EY SH AH N Z
GUTTED	G AH T IH D
GUTTER	G AH T ER
GUTTERED	G AH T ER D
GUTTERING	G AH T ER IH NG
GUTTERINGS	G AH T ER IH NG Z
GUTTERS	G AH T ER Z
GUTTERSNIPE	G AH T ER S N AY P
GUTTERSNIPES	G AH T ER S N AY P S
GUTTERSNIPISH	G AH T ER S N AY P IH SH
GUTTERY	G AH T AH R IY
GUTTIER	G AH T IY ER
GUTTIEST	G AH T IY AH S T
GUTTING	G AH T IH NG
GUTTLE	G AH T AH L
GUTTLED	G AH T AH L D
GUTTLER	G AH T L AH R
GUTTLERS	G AH T L AH R Z
GUTTLES	G AH T AH L Z
GUTTLING	G AH T L AH NG
GUTTURAL	G AH T ER AH L
GUTTURALISM	G AH T AH R AH L IH Z AH M
GUTTURALISMS	G AH T AH R AH L IH Z AH M Z
GUTTURALS	G AH T AH R AH L Z
GUTTY	G AH T IY
HAIRCUTTER	HH EH R K AH T ER
HAIRCUTTERS	HH EH R K AH T ER Z
HAIRCUTTING	HH EH R K AH T IH NG
HAIRCUTTINGS	HH EH R K AH T IH NG Z
HAIRSPLITTER	HH EH R S P L IH T ER
HAIRSPLITTERS	HH EH R S P L IH T ER Z
HAIRSPLITTING	HH EH R S P L IH T IH NG
HAIRSPLITTINGS	HH EH R S P L IH T IH NG Z
HANDWRITTEN	HH AE N D R IH T AH N
HARMATTAN	HH AA R M AH T AE N
HARMATTANS	HH AA R M AE T AH N Z
HARVESTTIME	HH AA R V AH S T AY M
HARVESTTIMES	HH AA R V AH S T AY M Z
HATTED	HH AE T IH D
HATTER	HH AE T ER
HATTERIA	HH AE T IY R IY AH
HATTERIAS	HH AE T IY R IY AH Z
HATTERS	HH AE T ER Z
HATTING	HH AE T IH NG
HEARTTHROB	HH AA R T TH R AA B
HEARTTHROBS	HH AA R T TH R AA B Z
HITTER	HH IH T ER
HITTERS	HH IH T ER Z
HITTING	HH IH T IH NG
HOTTED	HH AA T IH D
HOTTER	HH AA T ER
HOTTEST	HH AA T AH S T
HOTTING	HH AA T IH NG
HOTTISH	HH AA T IH SH
HOUSESITTING	HH AW S IH T IH NG
HUTTED	HH AH T IH D
HUTTING	HH AH T IH NG
IMBITTER	IH M B IH T ER
IMBITTERED	IH M B IH T ER D
IMBITTERING	IH M B IH T ER IH NG
IMBITTERS	IH M B IH T ER Z
IMMITTANCE	IH M IH T AH N S
IMMITTANCES	IH M IH T AH N S IH Z
IMMUNOBLOTTING	IH M Y AH N AA B L AA T AH NG
IMMUNOBLOTTINGS	IH M Y UW N AH B L AA T AH NG Z
INATTENTION	IH N AH T EH N CH AH N
INATTENTIONS	IH N AH T EH N CH AH N Z
INATTENTIVE	IH N AH T EH N T IH V
INATTENTIVELY	IH N AH T EH N T IH V L IY
INATTENTIVENESS	IH N AH T EH N T IH V N AH S
INATTENTIVENESSES	IH N AH T EH N T IH V N AH S IH Z
INLETTING	IH N L EH T IH NG
INPUTTED	IH N P UH T IH D
INPUTTING	IH N P UH T IH NG
INSETTED	IH N S EH T IH D
INSETTER	IH N S EH T ER
INSETTERS	IH N S EH T ER Z
INSETTING	IH N S EH T IH NG
INTERCUTTING	IH N T ER K AH T IH NG
INTERKNITTED	IH N T ER N IH T IH D
INTERKNITTING	IH N T ER N IH T IH NG
INTERMITTED	IH N T ER M IH T IH D
INTERMITTENCE	IH N T ER M IH T AH N S
INTERMITTENCES	IH N T ER M IH T AH N S IH Z
INTERMITTENCIES	IH N T ER M IH T AH N S IY Z
INTERMITTENCY	IH N T ER M IH T AH N S IY
INTERMITTENT	IH N T ER M IH T AH N T
INTERMITTENTLY	IH N T ER M IH T AH N T L IY
INTERMITTER	IH N T ER M IH T ER
INTERMITTERS	IH N T ER M IH T ER Z
INTERMITTING	IH N T ER M IH T IH NG
INTROMITTED	IH N T R AH M IH T AH D
INTROMITTENT	IH N T R AH M IH T AH N T
INTROMITTER	IH N T R AH M IH T AH R
INTROMITTERS	IH N T R AH M IH T AH R Z
INTROMITTING	IH N T R AH M IH T AH NG
JETTED	JH EH T IH D
JETTIED	JH EH T IY D
JETTIER	JH EH T IY ER
JETTIES	JH EH T IY Z
JETTIEST	JH EH T IY AH S T
JETTING	JH EH T IH NG
JETTISON	JH EH T IH S AH N
JETTISONABLE	JH EH T IY Z AO N AH B AH L
JETTISONED	JH EH T IH S AH N D
JETTISONING	JH EH T AH S AH N IH NG
JETTISONS	JH EH T IY Z AO N Z
JETTON	JH EH T AH N
JETTONS	JH EH T AH N Z
JETTY	JH EH T IY
JETTYING	JH EH T IY IH NG
JITTER	JH IH T ER
JITTERBUG	JH IH T ER B AH G
JITTERBUGGED	JH IH T ER B AH G D
JITTERBUGGING	JH IH T ER B AH G IH NG
JITTERBUGS	JH IH T ER B AH G Z
JITTERED	JH IH T ER D
JITTERIER	JH IH T ER IY ER
JITTERIEST	JH IH T ER IY AH S T
JITTERINESS	JH IH T ER IY N AH S
JITTERINESSES	JH IH T ER IY N AH S IH Z
JITTERING	JH IH T ER IH NG
JITTERS	JH IH T ER Z
JITTERY	JH IH T ER IY
JOCKETTE	JH AA K EH T
JOCKETTES	JH AA K EH T S
JOTTED	JH AA T IH D
JOTTER	JH AA T ER
JOTTERS	JH AA T ER Z
JOTTING	JH AA T IH NG
JOTTINGS	JH AA T IH NG Z
JOTTY	JH AA T IY
JUTTED	JH AH T IH D
JUTTIED	JH AH T IY D
JUTTIES	JH AH T IY Z
JUTTING	JH AH T IH NG
JUTTY	JH AH T IY
JUTTYING	JH AH T IY IH NG
KAPUTT	K AE P AH T
KETTLE	K EH T AH L
KETTLEDRUM	K EH T AH L D R AH M
KETTLEDRUMS	K EH T AH L D R AH M Z
KETTLES	K EH T AH L Z
KEYBUTTON	K IY B AH T AH N
KEYBUTTONS	K IY B AH T AH N Z
KILOWATT	K IH L AH W AA T
KILOWATTS	K IH L AH W AA T S
KITCHENETTE	K IH CH AH N EH T
KITCHENETTES	K IH CH AH N EH T S
KITTED	K IH T IH D
KITTEL	K IH T AH L
KITTEN	K IH T AH N
KITTENED	K IH T AH N D
KITTENING	K IH T AH N IH NG
KITTENISH	K IH T AH N IH SH
KITTENISHLY	K IH T AH N IH SH L IY
KITTENISHNESS	K IH T AH N IH SH N AH S
KITTENISHNESSES	K IH T AH N IH SH N AH S IH Z
KITTENS	K IH T AH N Z
KITTIES	K IH T IY Z
KITTING	K IH T IH NG
KITTIWAKE	K IH T IH W EY K
KITTIWAKES	K IH T AH W EY K S
KITTLE	K IH T AH L
KITTLED	K IH T AH L D
KITTLER	K IH T AH L ER
KITTLES	K IH T AH L Z
KITTLEST	K IH T AH L AH S T
KITTLING	K IH T AH L IH NG
KITTY	K IH T IY
KNITTED	N IH T AH D
KNITTED(2)	N IH T IH D
KNITTER	N IH T ER
KNITTERS	N IH T ER Z
KNITTING	N IH T IH NG
KNITTINGS	N IH T IH NG Z
KNOTTED	N AA T IH D
KNOTTER	N AA T ER
KNOTTERS	N AA T ER Z
KNOTTIER	N AA T IY ER
KNOTTIEST	N AA T IY AH S T
KNOTTILY	N AA T IY L IY
KNOTTINESS	N AA T IY N AH S
KNOTTINESSES	N AA T IY N AH S IH Z
KNOTTING	N AA T IH NG
KNOTTINGS	N AA T IH NG Z
KNOTTY	N AA T IY
LARGHETTO	L AH R EH T OW
LARGHETTOS	L AH R EH T AH Z
LATTE	L AA T EY
LATTEN	L EY T AH N
LATTENS	L EY T AH N Z
LATTER	L AE T ER
LATTERLY	L AE T ER L IY
LATTES	L AE T S
LATTICE	L AE T AH S
LATTICED	L AE T AH S T
LATTICES	L AE T AH S IH Z
LATTICEWORK	L AE T AH S W ER K
LATTICEWORKS	L AE T AH S W ER K S
LATTICING	L AE T AH S IH NG
LATTIN	L AE T IH N
LATTINS	L AE T AH N Z
LAUNDERETTE	L AO N D ER EH T
LAUNDERETTES	L AO N D ER EH T S
LAUNDRETTE	L AO N D R EH T
LAUNDRETTES	L AO N D R EH T S
LAYETTE	L EY EH T
LAYETTES	L EY EH T S
LAZARETTE	L EY Z ER EH T
LAZARETTES	L EY Z ER EH T S
LAZARETTO	L AE Z AH R EH T OW
LAZARETTOS	L AE Z AH R EH T AH Z
LEAFLETTED	L IY F L AH T IH D
LEAFLETTING	L IY F L AH T IH NG
LEATHERETTE	L EH DH ER EH T
LEATHERETTES	L EH DH ER EH T S
LETTED	L EH T IH D
LETTER	L EH T ER
LETTERBOMB	L EH T ER B AA M
LETTERBOMBS	L EH T ER B AA M Z
LETTERBOXED	L EH T ER B AA K S T
LETTERBOXING	L EH T ER B AA K S IH NG
LETTERBOXINGS	L EH T ER B AA K S IH NG Z
LETTERED	L EH T ER D
LETTERER	L EH T ER ER
LETTERERS	L EH T ER ER Z
LETTERFORM	L EH T ER F AO R M
LETTERFORMS	L EH T ER F AO R M Z
LETTERHEAD	L EH T ER HH EH D
LETTERHEADS	L EH T ER HH EH D Z
LETTERING	L EH T ER IH NG
LETTERINGS	L EH T ER IH NG Z
LETTERMAN	L EH T ER M AH N
LETTERMEN	L EH T ER M AH N
LETTERPRESS	L EH T ER P R EH S
LETTERPRESSES	L EH T ER P R EH S IH Z
LETTERS	L EH T ER Z
LETTERSPACE	L EH T ER S P EY S
LETTERSPACES	L EH T ER S P EY S IH Z
LETTERSPACING	L EH T ER S P EY S IH NG
LETTERSPACINGS	L EH T ER S P EY S IH NG Z
LETTING	L EH T IH NG
LETTUCE	L EH T AH S
LETTUCES	L EH T Y UW S AH Z
LIBRETTI	L IH B R EH T IY
LIBRETTIST	L AH B R EH T IH S T
LIBRETTISTS	L AH B R EH T AH S T S
LIBRETTO	L IH B R EH T OW
LIBRETTOS	L AH B R EH T OW Z
LICKSPITTLE	L IH K S P IH T AH L
LICKSPITTLES	L IH K S P IH T AH L Z
LIGHTTIGHT	L AY T AY T
LITTEN	L IH T AH N
LITTER	L IH T ER
LITTERATEUR	L IH T AH R EY T AH R
LITTERATEURS	L IH T AH R AH T IY Y AH R Z
LITTERBAG	L IH T ER B AE G
LITTERBAGS	L IH T ER B AE G Z
LITTERBUG	L IH T ER B AH G
LITTERBUGS	L IH T ER B AH G Z
LITTERED	L IH T ER D
LITTERER	L IH T ER ER
LITTERERS	L IH T ER ER Z
LITTERING	L IH T ER IH NG
LITTERMATE	L IH T ER M EY T
LITTERMATES	L IH T ER M EY T S
LITTERS	L IH T ER Z
LITTERY	L IH T ER IY
LITTLE	L IH T AH L
LITTLENECK	L IH T AH L N EH K
LITTLENECKS	L IH T AH L N EH K S
LITTLENESS	L IH T AH L N AH S
LITTLENESSES	L IH T AH L N AH S IH Z
LITTLER	L IH T AH L ER
LITTLER(2)	L IH T L ER
LITTLES	L IH T AH L Z
LITTLEST	L IH T AH L AH S T
LITTLISH	L IH T AH L IH SH
LITTORAL	L IH T ER AH L
LITTORALS	L IH T ER AH L Z
LORGNETTE	L AO R N Y EH T
LORGNETTES	L AO R N Y EH T S
LOTTE	L AA T
LOTTED	L AA T IH D
LOTTERIES	L AA T ER IY Z
LOTTERY	L AA T ER IY
LOTTES	L AA T S
LOTTING	L AA T IH NG
LOTTO	L AA T OW
LOTTOS	L AA T AH Z
LUNCHEONETTE	L AH N CH IH N EH T
LUNCHEONETTES	L AH N CH IH N EH T S
LUNETTE	L UW N EH T
LUNETTES	L UW N EH T S
LYTTA	L IH T AH
LYTTAE	L IH T IY
LYTTAS	L IH T AH Z
MAISONETTE	M EY Z AO N EH T
MAISONETTES	M EY Z AO N EH T S
MAJORETTE	M EY JH ER EH T
MAJORETTES	M EY JH ER EH T S
MANHATTAN	M AE N HH AE T AH N
MANHATTANS	M AE N HH AE T AH N Z
MANICOTTI	M AE N AH K AA T IY
MANUMITTED	M AE N Y AH M IH T IH D
MANUMITTING	M AE N Y AH M IH T IH NG
MAQUETTE	M AE K W EH T
MAQUETTES	M AE K W EH T S
MARIONETTE	M AE R IY AH N EH T
MARIONETTES	M AE R IY AH N EH T S
MARQUISETTE	M AA R K IY Z EH T
MARQUISETTES	M AA R K IY Z EH T S
MATT	M AE T
MATTE	M AE T
MATTED	M AE T IH D
MATTEDLY	M AE T AH D L IY
MATTER	M AE T ER
MATTERED	M AE T ER D
MATTERING	M AE T ER IH NG
MATTERS	M AE T ER Z
MATTERY	M AE T AH R IY
MATTES	M AE T S
MATTIN	M AE T IH N
MATTING	M AE T IH NG
MATTINGS	M AE T IH NG Z
MATTINS	M AE T IH N Z
MATTOCK	M AE T AH K
MATTOCKS	M AE T AH K S
MATTOID	M AE T OW AH D
MATTOIDS	M AE T OW AH D Z
MATTRASS	M AE T R AH S
MATTRASSES	M AE T R AE S AH Z
MATTRESS	M AE T R AH S
MATTRESSES	M AE T R AH S AH Z
MATTRESSES(2)	M AE T R AH S IH Z
MATTS	M AE T S
MEGAWATT	M EH G AH W AA T
MEGAWATTS	M EH G AH W AA T S
METTLE	M EH T AH L
METTLED	M EH T AH L D
METTLES	M EH T AH L Z
METTLESOME	M EH T AH L S AH M
MICROCASSETTE	M AY K R AH K AE S EH T
MICROCASSETTES	M AY K R AH K AE S EH T S
MICROPIPETTE	M AY K R OW P AY P EH T
MICROPIPETTES	M AY K R OW P AY P EH T S
MICROWATT	M AY K R OW W AA T
MICROWATTS	M AY K R OW W AA T S
MIDSAGITTAL	M IH D S AH JH IH T AH L
MIGNONETTE	M IH G N AH N EH T
MIGNONETTES	M IH G N AH N EH T S
MILLIWATT	M IH L AH W AH T
MILLIWATTS	M IH L AH W AH T S
MISATTRIBUTE	M IH S AE T R AH B Y UW T
MISATTRIBUTED	M IH S AE T R AH B Y UW T IH D
MISATTRIBUTES	M IH S AE T R AH B Y UW T S
MISATTRIBUTING	M IH S AE T R AH B Y UW T IH NG
MISATTRIBUTION	M IH S AE T R AH B Y UW SH AH N
MISATTRIBUTIONS	M IH S AE T R AH B Y UW SH AH N Z
MISBEGOTTEN	M IH S B AH G AA T AH N
MISBUTTON	M IH S B AH T AH N
MISBUTTONED	M IH S B AH T AH N D
MISBUTTONING	M IH S B AH T AH N IH NG
MISBUTTONS	M IH S B AH T AH N Z
MISCUTTING	M IH S K AH T IH NG
MISFITTED	M IH S F IH T IH D
MISFITTING	M IH S F IH T IH NG
MISHITTING	M IH S HH IH T IH NG
MISSETTING	M IH S EH T IH NG
MISWRITTEN	M IH S R IH T AH N
MITT	M IH T
MITTEN	M IH T AH N
MITTENS	M IH T AH N Z
MITTIMUS	M IH T AH M AH S
MITTIMUSES	M IH T AH M Y UW Z AH Z
MITTS	M IH T S
MOFETTE	M OW F EH T
MOFETTES	M OW F EH T S
MOFFETTE	M AA F EH T
MOFFETTES	M AA F EH T S
MOQUETTE	M AA K W EH T
MOQUETTES	M AA K W EH T S
MOTT	M AA T
MOTTE	M AA T
MOTTES	M AA T S
MOTTLE	M AA T AH L
MOTTLED	M AA T AH L D
MOTTLER	M AA T AH L ER
MOTTLERS	M AA T AH L ER Z
MOTTLES	M AA T AH L Z
MOTTLING	M AA T AH L IH NG
MOTTLING(2)	M AA T L IH NG
MOTTO	M AA T OW
MOTTOES	M AA T OW Z
MOTTOS	M AA T OW Z
MOTTS	M AA T S
MOZETTA	M AH Z EH T AH
MOZETTAS	M AH Z EH T AH Z
MOZETTE	M OW Z EH T
MOZZETTA	M AA Z EH T AH
MOZZETTAS	M AA Z EH T AH Z
MOZZETTE	M AA Z EH T
MULATTO	M AH L AA T OW
MULATTOES	M Y UH L AE T OW Z
MULATTOS	M Y UH L AE T OW Z
MULTIMEGAWATT	M AH L T AY M EH G AH W AA T
MULTIMEGAWATTS	M AH L T AY M EH G AH W AA T S
MUSETTE	M Y UW Z EH T
MUSETTES	M Y UW Z EH T S
MUTT	M AH T
MUTTER	M AH T ER
MUTTERED	M AH T ER D
MUTTERER	M AH T ER ER
MUTTERERS	M AH T ER ER Z
MUTTERING	M AH T ER IH NG
MUTTERS	M AH T ER Z
MUTTON	M AH T AH N
MUTTONCHOPS	M AH T AH N CH AA P S
MUTTONFISH	M AH T AH N F IH SH
MUTTONFISHES	M AH T AH N F IH SH IH Z
MUTTONS	M AH T AH N Z
MUTTONY	M AH T AH N IY
MUTTS	M AH T S
NANOWATT	N AE N OW AH T
NANOWATTS	N AE N OW AH T S
NATTER	N AE T ER
NATTERED	N EY T ER D
NATTERING	N AE T ER IH NG
NATTERS	N EY T ER Z
NATTIER	N AE T IY ER
NATTIEST	N AE T IY AH S T
NATTILY	N AE T AH L IY
NATTINESS	N AE T IY N AH S
NATTINESSES	N AE T IY N AH S IH Z
NATTY	N AE T IY
NAVETTE	N EY V EH T
NAVETTES	N EY V EH T S
NETIQUETTE	N EH T AH K AH T
NETIQUETTES	N AH T IH K W EH T S
NETT	N EH T
NETTABLE	N EH T AH B AH L
NETTED	N EH T IH D
NETTER	N EH T ER
NETTERS	N EH T ER Z
NETTIER	N EH T IY ER
NETTIEST	N EH T IY AH S T
NETTING	N EH T IH NG
NETTINGS	N EH T IH NG Z
NETTLE	N EH T AH L
NETTLED	N EH T AH L D
NETTLER	N EH T AH L ER
NETTLERS	N EH T AH L ER Z
NETTLES	N EH T AH L Z
NETTLESOME	N EH T AH L S AH M
NETTLIER	N EH T AH L IY ER
NETTLIEST	N EH T AH L IY AH S T
NETTLING	N EH T AH L IH NG
NETTLY	N EH T AH L IY
NETTS	N EH T S
NETTY	N EH T IY
NEUROTRANSMITTER	N Y AH R AA T R AE N S M IH T AH R
NEUROTRANSMITTERS	N Y AH R AA T R AH N S M IH T AH R Z
NEWSLETTER	N UW Z L EH T ER
NEWSLETTERS	N UW Z L EH T ER Z
NIGHTTIME	N AY T T AY M
NIGHTTIMES	N AY T T AY M Z
NITTIER	N IH T AY AH R
NITTIEST	N IH T AY AH S T
NITTY	N IH T IY
NOISETTE	N OY Z EH T
NOISETTES	N OY Z EH T S
NONATTACHED	N AA N AH T AE CH T
NONATTACHMENT	N AA N AH T AE CH M AH N T
NONATTACHMENTS	N AA N AH T AE CH M AH N T S
NONATTENDANCE	N AA N AH T EH N D AH N S
NONATTENDANCES	N AA N AH T EH N D AH N S IH Z
NONATTENDER	N AA N AH T EH N D ER
NONATTENDERS	N AA N AH T EH N D ER Z
NONBETTING	N AA N B EH T IH NG
NONCOMMITTAL	N AA N K AH M IH T AH L
NONCOMMITTALLY	N AA N K AH M IH T AH L IY
NONCOMMITTED	N AA N K AH M IH T IH D
NONFATTENING	N AA N F AE T AH N IH NG
NONFATTY	N AA N F AE T IY
NONGHETTO	N AA N G EH T OW
NOTTURNI	N AA T AH R N IY
NOTTURNO	N AA T AH R N OW
NOVELETTE	N AA V AH L EH T
NOVELETTES	N AA V AH L EH T S
NOVELETTISH	N AA V AH L EH T IH SH
NUTTED	N AH T IH D
NUTTER	N AH T ER
NUTTERS	N AH T ER Z
NUTTIER	N AH T IY ER
NUTTIEST	N AH T IY AH S T
NUTTILY	N AH T IY L IY
NUTTINESS	N AH T IY N AH S
NUTTINESSES	N AH T IY N AH S IH Z
NUTTING	N AH T IH NG
NUTTINGS	N AH T IH NG Z
NUTTY	N AH T IY
NYMPHETTE	N IH M F EH T
NYMPHETTES	N IH M F EH T S
OCTETTE	AA K T EH T
OCTETTES	AA K T EH T S
OFFSETTING	AO F S EH T IH NG
OFTTIMES	AA F T AY M Z
OMELETTE	AA M AH L EH T
OMELETTES	AA M AH L EH T S
OMITTED	OW M IH T AH D
OMITTED(2)	OW M IH T IH D
OMITTER	OW M IH T ER
OMITTERS	OW M IH T ER Z
OMITTING	OW M IH T IH NG
OPERETTA	AA P ER EH T AH
OPERETTAS	AA P ER EH T AH Z
OPERETTIST	AA P ER EH T IH S T
OPERETTISTS	AA P ER EH T IH S T S
OTTAR	AA T AH R
OTTARS	AA T AH R Z
OTTAVA	AA T AH V AH
OTTAVAS	AA T AH V AH Z
OTTER	AA T ER
OTTERS	AA T ER Z
OTTO	AA T OW
OTTOMAN	AA T AH M AH N
OTTOMANS	AA T AH M AH N Z
OTTOS	AA T OW Z
OUBLIETTE	AW B L AY EH T
OUBLIETTES	AW B L AY EH T S
OUTFITTED	AW T F IH T IH D
OUTFITTER	AW T F IH T ER
OUTFITTERS	AW T F IH T ER Z
OUTFITTING	AW T F IH T IH NG
OUTGLITTER	AW T G L IH T ER
OUTGLITTERED	AW T G L IH T ER D
OUTGLITTERING	AW T G L IH T ER IH NG
OUTGLITTERS	AW T G L IH T ER Z
OUTHITTING	AW T HH IH T IH NG
OUTJUTTED	AW T JH AH T IH D
OUTJUTTING	AW T JH AH T IH NG
OUTPLOTTED	AW T P L AA T IH D
OUTPLOTTING	AW T P L AA T IH NG
OUTPUTTED	AW T P UH T IH D
OUTPUTTING	AW T P UH T IH NG
OUTSITTING	AW T S IH T IH NG
OUTTAKE	AW T T EY K
OUTTAKE(2)	AW T EY K
OUTTAKES	AW T T EY K S
OUTTAKES(2)	AW T EY K S
OUTTALK	AW T AO K
OUTTALKED	AW T AO K T
OUTTALKING	AW T AO K IH NG
OUTTALKS	AW T AO K S
OUTTASK	AW T AE S K
OUTTASKED	AW T AE S K T
OUTTASKING	AW T AE S K IH NG
OUTTASKS	AW T AE S K S
OUTTELL	AW T EH L
OUTTELLING	AW T EH L IH NG
OUTTELLS	AW T EH L Z
OUTTHANK	AW T TH AE NG K
OUTTHANKED	AW T TH AE NG K T
OUTTHANKING	AW T TH AE NG K IH NG
OUTTHANKS	AW T TH AE NG K S
OUTTHINK	AW T TH IH NG K
OUTTHINKING	AW T TH IH NG K IH NG
OUTTHINKS	AW T TH IH NG K S
OUTTHOUGHT	AW T TH AO T
OUTTHREW	AW T TH R UW
OUTTHROB	AW T TH R AA B
OUTTHROBBED	AW T TH R AA B D
OUTTHROBBING	AW T TH R AA B IH NG
OUTTHROBS	AW T TH R AA B Z
OUTTHROW	AW T TH R OW
OUTTHROWING	AW T TH R OW IH NG
OUTTHROWN	AW T TH R OW N
OUTTHROWS	AW T TH R OW Z
OUTTHRUST	AW T TH R AH S T
OUTTHRUSTING	AW T TH R AH S T IH NG
OUTTHRUSTS	AW T TH R AH S T S
OUTTOLD	AW T OW L D
OUTTOWER	AW T AW ER
OUTTOWERED	AW T AW ER D
OUTTOWERING	AW T AW ER IH NG
OUTTOWERS	AW T AW ER Z
OUTTRADE	AW T R EY D
OUTTRADED	AW T R EY D IH D
OUTTRADES	AW T R EY D Z
OUTTRADING	AW T R EY D IH NG
OUTTRICK	AW T R IH K
OUTTRICKED	AW T R IH K T
OUTTRICKING	AW T R IH K IH NG
OUTTRICKS	AW T R IH K S
OUTTROT	AW T R AA T
OUTTROTS	AW T R AA T S
OUTTROTTED	AW T R AA T IH D
OUTTROTTING	AW T R AA T IH NG
OUTTRUMP	AW T R AH M P
OUTTRUMPED	AW T R AH M P T
OUTTRUMPING	AW T R AH M P IH NG
OUTTRUMPS	AW T R AH M P S
OUTTURN	AW T ER N
OUTTURNS	AW T ER N Z
OUTWITTED	AW T W IH T AH D
OUTWITTING	AW T W IH T IH NG
OUTWRITTEN	AW T R IH T AH N
OVERATTENTION	OW V ER AH T EH N CH AH N
OVERATTENTIONS	OW V ER AH T EH N CH AH N Z
OVERBETTED	OW V ER B EH T IH D
OVERBETTING	OW V ER B EH T IH NG
OVERCOMMITTED	OW V ER K AH M IH T IH D
OVERCOMMITTING	OW V ER K AH M IH T IH NG
OVERCUTTING	OW V ER K AH T IH NG
OVERLETTING	OW V ER L AH T IH NG
OVERPLOTTED	OW V ER P L AA T IH D
OVERPLOTTING	OW V ER P L AA T IH NG
OVERSETTING	OW V ER S EH T IH NG
OVERWETTED	OW V ER W EH T IH D
OVERWETTING	OW V ER W EH T IH NG
OVERWRITTEN	OW V ER R IH T AH N
PACESETTER	P EY S EH T ER
PACESETTERS	P EY S EH T ER Z
PACESETTING	P EY S EH T IH NG
PAILLETTE	P EY L EH T
PAILLETTES	P EY L EH T S
PALETTE	P AE L AH T
PALETTES	P AE L AH T S
PALLETTE	P AE L EH T
PALLETTES	P AE L EH T S
PALMETTE	P AA M EH T
PALMETTES	P AA M EH T S
PALMETTO	P AE L M EH T OW
PALMETTO(2)	P AA L M EH T OW
PALMETTOES	P AE L M EH T OW Z
PALMETTOS	P AE L M EH T AH Z
PANCETTA	P AE N S EH T AH
PANCETTAS	P AE N S EH T AH Z
PANETTONE	P AE N AH T OW N
PANETTONES	P AE N AH T OW N Z
PANETTONI	P AH N EH T AH N IY
PANTALETTES	P AE N T AH L EH T S
PARGETTED	P AA R G EH T IH D
PARGETTING	P AA R G EH T IH NG
PATTAMAR	P AE T EY M ER
PATTAMARS	P AE T EY M ER Z
PATTED	P AE T AH D
PATTED(2)	P AE T IH D
PATTEE	P AE T IY
PATTEN	P AE T AH N
PATTENS	P AE T AH N Z
PATTER	P AE T ER
PATTERED	P AE T ER D
PATTERER	P AE T ER ER
PATTERERS	P AE T ER ER Z
PATTERING	P AE T ER IH NG
PATTERN	P AE T ER N
PATTERNED	P AE T ER N D
PATTERNING	P AE T ER N IH NG
PATTERNINGS	P AE T ER N IH NG Z
PATTERNLESS	P AE T ER N L AH S
PATTERNS	P AE T ER N Z
PATTERS	P AE T ER Z
PATTIE	P AE T IY
PATTIES	P AE T IY Z
PATTING	P AE T IH NG
PATTY	P AE T IY
PATTYPAN	P AE T IY P AE N
PATTYPANS	P AE T IY P AE N Z
PAUPIETTE	P AO P AY EH T
PAUPIETTES	P AO P AY EH T S
PERMITTED	P ER M IH T AH D
PERMITTED(2)	P ER M IH T IH D
PERMITTEE	P ER M IH T IY
PERMITTEES	P ER M IH T IY Z
PERMITTER	P ER M IH T ER
PERMITTERS	P ER M IH T ER Z
PERMITTING	P ER M IH T IH NG
PERMITTIVITIES	P ER M IH T IH V AH T IY Z
PERMITTIVITY	P ER M IH T IH V AH T IY
PETTED	P EH T AH D
PETTED(2)	P EH T IH D
PETTEDLY	P EH T AH D L IY
PETTER	P EH T ER
PETTERS	P EH T ER Z
PETTI	P EH T IY
PETTICOAT	P EH T IY K OW T
PETTICOATED	P EH T IH K OW T IH D
PETTICOATS	P EH T IY K OW T S
PETTIER	P EH T IY ER
PETTIEST	P EH T IY AH S T
PETTIFOG	P EH T AH F AH G
PETTIFOGGED	P EH T AH F AH G D
PETTIFOGGER	P EH T AH F AA G AH R
PETTIFOGGERIES	P EH T AH F AA JH AH R AY Z
PETTIFOGGERS	P EH T AH F AA JH AH R Z
PETTIFOGGERY	P EH T AH F AH G EH R IY
PETTIFOGGING	P EH T AH F AA G AH NG
PETTIFOGGINGS	P EH T AH F AA JH AH NG Z
PETTIFOGS	P EH T AH F AH G Z
PETTILY	P EH T IY L IY
PETTINESS	P EH T IY N EH S
PETTINESSES	P EH T IY N AH S IH Z
PETTING	P EH T IH NG
PETTINGS	P EH T IH NG Z
PETTISH	P EH T IH SH
PETTISHLY	P EH T IH SH L IY
PETTISHNESS	P EH T IH SH N AH S
PETTISHNESSES	P EH T IH SH N AH S IH Z
PETTITOES	P EH T AH T OW Z
PETTLE	P EH T AH L
PETTLED	P EH T AH L D
PETTLES	P EH T AH L Z
PETTLING	P EH T L AH NG
PETTO	P EH T OW
PETTY	P EH T IY
PHOTOSETTER	F OW T OW S EH T ER
PHOTOSETTERS	F OW T OW S EH T ER Z
PHOTOSETTING	F OW T OW S EH T IH NG
PHOTOSTATTED	F OW T OW Z T AE T IH D
PHOTOSTATTING	F OW T OW Z T AE T IH NG
PHOTOTYPESETTER	F OW T OW T AY P S EH T ER
PHOTOTYPESETTERS	F OW T OW T AY P S EH T ER Z
PHOTOTYPESETTING	F OW T OW T AY P S EH T IH NG
PHOTOTYPESETTINGS	F OW T OW T AY P S EH T IH NG Z
PINSETTER	P IH N S EH T ER
PINSETTERS	P IH N S EH T ER Z
PINSPOTTER	P IH N S P AA T ER
PINSPOTTERS	P IH N S P AA T ER Z
PIPETTE	P AY P EH T
PIPETTED	P AY P EH T IH D
PIPETTES	P AY P EH T S
PIPETTING	P AY P EH T IH NG
PIROUETTE	P IH R UW EH
PIROUETTED	P AY R AH W EH T IH D
PIROUETTES	P IH R UW EH T S
PIROUETTING	P AY R AH W EH T IH NG
PITAPATTED	P IH T AH P AE T IH D
PITAPATTING	P IH T AH P AE T IH NG
PITTANCE	P IH T AH N S
PITTANCES	P IH T AH N S IH Z
PITTED	P IH T AH D
PITTED(2)	P IH T IH D
PITTING	P IH T IH NG
PITTINGS	P IH T IH NG Z
PITTOSPORUM	P IH T AA S AH R AH M
PITTOSPORUMS	P IH T AA S AH R AH M Z
PLANCHETTE	P L AE N CH EH T
PLANCHETTES	P L AE N CH EH T S
PLATTED	P L AE T IH D
PLATTER	P L AE T ER
PLATTERFUL	P L AE T ER F AH L
PLATTERFULS	P L AE T ER F AH L Z
PLATTERS	P L AE T ER Z
PLATTERSFUL	P L AE T ER Z F AH L
PLATTING	P L AE T IH NG
PLOTTAGE	P L AA T IH JH
PLOTTAGES	P L AA T IH JH IH Z
PLOTTED	P L AA T AH D
PLOTTED(2)	P L AA T IH D
PLOTTER	P L AA T ER
PLOTTERS	P L AA T ER Z
PLOTTIER	P L AA T IY ER
PLOTTIES	P L AA T IY Z
PLOTTIEST	P L AA T IY AH S T
PLOTTING	P L AA T IH NG
PLOTTY	P L AA T IY
POINSETTIA	P OY N S EH T IY AH
POINSETTIAS	P OY N S EH T IY AH Z
POINTTILLIST	P OY N T IH L IH S T
POLYGLOTTISM	P AH L IH G L AH T IH Z AH M
POLYGLOTTISMS	P AA L AH G L AA T AH Z AH M Z
POSTATTACK	P OW S T AH T AE K
POSTTAX	P OW S T AE K S
POSTTEEN	P OW S T IY N
POSTTENSION	P OW S T EH N CH AH N
POSTTENSIONED	P OW S T EH N CH AH N D
POSTTENSIONING	P OW S T EH N CH AH N IH NG
POSTTENSIONS	P OW S T EH N CH AH N Z
POSTTEST	P OW S T AH S T
POSTTESTS	P OW S T AH S T S
POSTTRANSCRIPTIONAL	P OW S T R AE N S K R IH P SH AH N AH L
POSTTRANSFUSION	P OW S T R AE N S F Y UW ZH AH N
POSTTRANSLATIONAL	P OW S T R AE N Z L EY SH AH N AH L
POSTTRAUMATIC	P OW S T R AO M AE T IH K
POSTTREATMENT	P OW S T R IY T M AH N T
POSTTRIAL	P OW S T R AY AH L
POTSHOTTING	P AA T SH AA T IH NG
POTTAGE	P OW T IH JH
POTTAGES	P OW T IH JH IH Z
POTTED	P AA T IH D
POTTEEN	P AA T IY N
POTTEENS	P AA T IY N Z
POTTER	P AA T ER
POTTERED	P OW T ER D
POTTERER	P OW T ER ER
POTTERERS	P OW T ER ER Z
POTTERIES	P OW T AH R IY Z
POTTERING	P OW T ER IH NG
POTTERINGLY	P OW T ER IH NG L IY
POTTERS	P AA T ER Z
POTTERY	P AA T ER IY
POTTIER	P OW T IY ER
POTTIES	P OW T IY Z
POTTIEST	P OW T IY AH S T
POTTING	P AA T IH NG
POTTLE	P AA T AH L
POTTLES	P AA T AH L Z
POTTO	P AA T OW
POTTOS	P AA T AH Z
POTTY	P AA T IY
POUSSETTE	P AW S EH T
POUSSETTED	P AW S EH T AH D
POUSSETTES	P AW S EH T S
POUSSETTING	P AW S EH T AH NG
PRATTLE	P R AE T AH L
PRATTLED	P R AE T AH L D
PRATTLER	P R AE T L AH R
PRATTLERS	P R AE T L AH R Z
PRATTLES	P R AE T AH L Z
PRATTLING	P R AE T L IH NG
PRATTLINGLY	P R AE T L IH NG L IY
PREADMITTED	P R IY AH D M IH T IH D
PREADMITTING	P R IY AH D M IH T IH NG
PREALLOTTED	P R IY AH L AA T IH D
PREALLOTTING	P R IY AH L AA T IH NG
PREBATTLE	P R IY B AE T AH L
PRECUTTING	P R IY K AH T IH NG
PREFORMATTED	P R IY F AO R M AE T IH D
PREFORMATTING	P R IY F AO R M AE T IH NG
PRESETTING	P R IY S EH T IH NG
PRESETTLEMENT	P R IY S EH T AH L M AH N T
PRESETTLEMENTS	P R IY S EH T AH L M AH N T S
PRETERMITTED	P R IY T AH R M IH T AH D
PRETERMITTING	P R IY T AH R M IH T AH NG
PRETTIED	P R IH T IY D
PRETTIER	P R IH T IY ER
PRETTIES	P R IH T IY Z
PRETTIEST	P R IH T IY AH S T
PRETTIFICATION	P R EH T AH F AH K EY SH AH N
PRETTIFICATIONS	P R IY T IH F AH K EY T IY AH N Z
PRETTIFIED	P R IY T AH F AY D
PRETTIFIER	P R IY T IH F AY AH R
PRETTIFIERS	P R IY T AH F IY R Z
PRETTIFIES	P R IY T AH F AY Z
PRETTIFY	P R EH T AH F AY
PRETTIFYING	P R IY T IH F AY AH NG
PRETTILY	P R IH T IY L IY
PRETTINESS	P R IH T IY N AH S
PRETTINESSES	P R IH T IY N AH S IH Z
PRETTY	P R IH T IY
PRETTYING	P R IH T IY IH NG
PRETTYISH	P R IH T IY IH SH
PROETTE	P R OW EH T
PROETTES	P R OW EH T S
PROGLOTTID	P R OW G L AA T AH D
PROGLOTTIDES	P R OW G L AA T AY D Z
PROGLOTTIDS	P R OW G L AA T AH D Z
PROGLOTTIS	P R OW G L AA T AH S
PROSCIUTTI	P R OW S AY AH T IY
PROSCIUTTO	P R OW S AY AH T OW
PROSCIUTTOS	P R OW S AY AH T AH Z
PSITTACINE	S IH T AH S AY N
PSITTACINES	S IH T AH S AY N Z
PSITTACOSES	S IH T AH K OW Z AH Z
PSITTACOSIS	S IH T AH S OW S AH S
PSITTACOTIC	S IH T AH K AH T AH K
PUTT	P AH T
PUTTED	P AH T IH D
PUTTEE	P AH T IY
PUTTEES	P AH T IY Z
PUTTER	P AH T ER
PUTTERED	P AH T ER D
PUTTERER	P AH T ER ER
PUTTERERS	P AH T ER ER Z
PUTTERING	P AH T ER IH NG
PUTTERS	P AH T ER Z
PUTTI	P AH T IY
PUTTIED	P AH T IY D
PUTTIER	P AH T IY ER
PUTTIERS	P AH T IY ER Z
PUTTIES	P AH T IY Z
PUTTING	P AH T IH NG
PUTTING(2)	P UH T IH NG
PUTTO	P AH T OW
PUTTS	P AH T S
PUTTY	P AH T IY
PUTTYING	P AH T IY IH NG
PUTTYLESS	P AH T IY L AH S
PUTTYLIKE	P AH T IY L AY K
PUTTYROOT	P AH T IY R UW T
PUTTYROOTS	P AH T IY R UW T S
QUARTETTE	K W AO R T EH T
QUARTETTES	K W AO R T EH T S
QUATTROCENTO	K W AA T R AH S EH N T OW
QUATTROCENTOS	K W AA T R AH S EH N T AH Z
QUATTUORDECILLION	K W AA T Y UW AO R D AH S IH L IY AH N
QUATTUORDECILLIONS	K W AA T Y UW AO R D AH S IH L IY AH N Z
QUINTETTE	K W IH N T EH T
QUINTETTES	K W IH N T EH T S
QUITTANCE	K W IH T AH N S
QUITTANCES	K W IH T AH N S IH Z
QUITTED	K W IH T IH D
QUITTER	K W IH T ER
QUITTERS	K W IH T ER Z
QUITTING	K W IH T IH NG
QUITTOR	K W IH T ER
QUITTORS	K W IH T ER Z
RACLETTE	R AE K L EH T
RACLETTES	R AE K L EH T S
RATTAIL	R AE T EY L
RATTAILS	R AE T EY L Z
RATTAN	R AE T AE N
RATTANS	R AE T AE N Z
RATTED	R AE T IH D
RATTEEN	R AE T IY N
RATTEENS	R AE T IY N Z
RATTEN	R AE T AH N
RATTENED	R AE T AH N D
RATTENER	R AE T AH N ER
RATTENERS	R AE T AH N ER Z
RATTENING	R AE T AH N IH NG
RATTENS	R AE T AH N Z
RATTER	R AE T ER
RATTERS	R AE T ER Z
RATTIER	R AE T IY ER
RATTIEST	R AE T IY AH S T
RATTING	R AE T IH NG
RATTISH	R AE T IH SH
RATTLE	R AE T AH L
RATTLEBRAIN	R AE T AH L B R EY N
RATTLEBRAINED	R AE T AH L B R EY N D
RATTLEBRAINS	R AE T AH L B R EY N Z
RATTLED	R AE T AH L D
RATTLER	R AE T AH L ER
RATTLER(2)	R AE T L ER
RATTLERS	R AE T AH L ER Z
RATTLES	R AE T AH L Z
RATTLESNAKE	R AE T AH L S N EY K
RATTLESNAKES	R AE T AH L S N EY K S
RATTLETRAP	R AE T AH L T R AE P
RATTLETRAPS	R AE T AH L T R AE P S
RATTLING	R AE T L IH NG
RATTLING(2)	R AE T AH L IH NG
RATTLINGLY	R AE T AH L IH NG L IY
RATTLINGS	R AE T AH L IH NG Z
RATTLY	R AE T AH L IY
RATTON	R AE T AH N
RATTONS	R AE T AH N Z
RATTOON	R AE T UW N
RATTOONED	R AE T UW N D
RATTOONING	R AE T UW N AH NG
RATTOONS	R AE T UW N Z
RATTRAP	R AE T R AE P
RATTRAPS	R AE T R AE P S
RATTY	R AE T IY
READMITTED	R IY AH D M IH T IH D
READMITTING	R IY AH D M IH T IH NG
REALLOTTED	R IY AH L AA T IH D
REALLOTTING	R IY AH L AA T IH NG
REATTACH	R IY AH T AE CH
REATTACHED	R IY AH T AE CH T
REATTACHES	R IY AH T AE CH IH Z
REATTACHING	R IY AH T AE CH IH NG
REATTACHMENT	R IY AH T AE CH M AH N T
REATTACHMENTS	R IY AH T AE CH M AH N T S
REATTACK	R IY AH T AE K
REATTACKED	R IY AH T AE K T
REATTACKING	R IY AH T AE K IH NG
REATTACKS	R IY AH T AE K S
REATTAIN	R IY AH T EY N
REATTAINED	R IY AH T EY N D
REATTAINING	R IY AH T EY N IH NG
REATTAINS	R IY AH T EY N Z
REATTEMPT	R IY AH T EH M P T
REATTEMPTED	R IY AH T EH M P T IH D
REATTEMPTING	R IY AH T EH M P T IH NG
REATTEMPTS	R IY AH T EH M P T S
REATTRIBUTE	R IY AE T R AH B Y UW T
REATTRIBUTED	R IY AE T R AH B Y UW T IH D
REATTRIBUTES	R IY AE T R AH B Y UW T S
REATTRIBUTING	R IY AE T R AH B Y UW T IH NG
REATTRIBUTION	R IY AE T R AH B Y UW SH AH N
REATTRIBUTIONS	R IY AE T R AH B Y UW SH AH N Z
REBOTTLE	R IY B AA T AH L
REBOTTLED	R IY B AA T AH L D
REBOTTLES	R IY B AA T AH L Z
REBOTTLING	R IY B AA T AH L IH NG
REBUTTABLE	R IH B AH T AH B AH L
REBUTTAL	R IH B AH T AH L
REBUTTAL(2)	R IY B AH T AH L
REBUTTALS	R IH B AH T AH L Z
REBUTTED	R IH B AH T IH D
REBUTTER	R IY B AH T ER
REBUTTERS	R IY B AH T ER Z
REBUTTING	R IH B AH T IH NG
REBUTTING(2)	R IY B AH T IH NG
REBUTTON	R IY B AH T AH N
REBUTTONED	R IY B AH T AH N D
REBUTTONING	R IY B AH T AH N IH NG
REBUTTONS	R IY B AH T AH N Z
RECOMMITTAL	R IY K AH M IH T AH L
RECOMMITTALS	R IY K AH M IH T AH L Z
RECOMMITTED	R IY K AH M IH T IH D
RECOMMITTING	R IY K AH M IH T IH NG
RECUTTING	R IY K AH T IH NG
REEMITTED	R IY IY M IH T IH D
REEMITTING	R IY IY M IH T IH NG
REFITTED	R IY F IH T IH D
REFITTING	R IY F IH T IH NG
REFORMATTED	R IY F AO R M AE T IH D
REFORMATTING	R IY F AO R M AE T IH NG
REGATTA	R IH G AA T AH
REGATTAS	R AH G AA T AH Z
REGRETTABLE	R IH G R EH T AH B AH L
REGRETTABLY	R IH G R EH T AH B L IY
REGRETTED	R IH G R EH T IH D
REGRETTER	R IH G R EH T ER
REGRETTERS	R IH G R EH T ER Z
REGRETTING	R IH G R EH T IH NG
REKNITTED	R IY N IH T IH D
REKNITTING	R IY N IH T IH NG
RELETTER	R IY L EH T ER
RELETTERED	R IY L EH T ER D
RELETTERING	R IY L EH T ER IH NG
RELETTERS	R IY L EH T ER Z
RELETTING	R IY L EH T IH NG
REMITTABLE	R IH M IH T AH B AH L
REMITTAL	R IH M IH T AH L
REMITTALS	R IH M IH T AH L Z
REMITTANCE	R IY M IH T AH N S
REMITTANCE(2)	R AH M IH T AH N S
REMITTANCES	R IY M IH T AH N S IH Z
REMITTANCES(2)	R AH M IH T AH N S IH Z
REMITTED	R IY M IH T IH D
REMITTENT	R IH M IH T AH N T
REMITTER	R IH M IH T ER
REMITTERS	R IH M IH T ER Z
REMITTING	R IH M IH T IH NG
REMITTOR	R IH M IH T ER
REMITTORS	R IH M IH T ER Z
REOUTFITTED	R IY AW T F IH T IH D
REOUTFITTING	R IY AW T F IH T IH NG
REPATTERN	R IY P AE T ER N
REPATTERNED	R IY P AE T ER N D
REPATTERNING	R IY P AE T ER N IH NG
REPATTERNS	R IY P AE T ER N Z
REPLOTTED	R IY P L AA T IH D
REPLOTTING	R IY P L AA T IH NG
REPOTTED	R IY P AA T IH D
REPOTTING	R IY P AA T IH NG
RESETTABLE	R IY S EH T AH B AH L
RESETTER	R IY S EH T ER
RESETTERS	R IY S EH T ER Z
RESETTING	R IY S EH T IH NG
RESETTLE	R IY S EH T AH L
RESETTLED	R IY S EH T AH L D
RESETTLEMENT	R IY S EH T AH L M AH N T
RESETTLEMENTS	R IY S EH T AH L M AH N T S
RESETTLES	R IY S EH T AH L Z
RESETTLING	R IY S EH T AH L IH NG
RESITTING	R IY S IH T IH NG
RESITTINGS	R IY S IH T IH NG Z
RESPLITTING	R IY S P L IH T IH NG
RESPOTTED	R IY S P AA T IH D
RESPOTTING	R IY S P AA T IH NG
RESUBMITTED	R IY S AH B M IH T IH D
RESUBMITTING	R IY S AH B M IH T IH NG
RETRANSMITTED	R IY T R AE N S M IH T IH D
RETRANSMITTING	R IY T R AE N S M IH T IH NG
RETROFITTED	R EH T R OW F IH T IH D
RETROFITTING	R EH T R OW F IH T IH NG
RETTED	R EH T AH D
RETTING	R EH T AH NG
REUTTER	R OY T ER
REUTTERED	R IY AH T ER D
REUTTERING	R IY AH T ER IH NG
REUTTERS	R IY AH T ER Z
REVETTED	R IH V EH T IH D
REVETTING	R IH V EH T IH NG
REWETTED	R IY W EH T IH D
REWETTING	R IY W EH T IH NG
REWRITTEN	R IY R IH T AH N
RICKETTSIA	R IH K EH T S IY AH
RICKETTSIAE	R IH K EH T S IY IY
RICKETTSIAL	R IH K EH T S IY AH L
RICKETTSIAS	R IH K EH T S IY AH Z
RICOCHETTED	R IH K AH SH EY D
RICOCHETTING	R IH K AH SH EY IH NG
RICOTTA	R AH K AA T AH
RICOTTAS	R AH K AA T AH Z
RIDOTTO	R IH D AA T OW
RIDOTTOS	R IH D AA T OW Z
RIJSTTAFEL	R IH JH S T AH F AH L
RIJSTTAFELS	R IH JH S T AH F AH L Z
RILLETTES	R IH L EH T S
RISOTTO	R IY S AO T OW
RISOTTOS	R AH S AA T AH Z
RITTER	R IH T ER
RITTERS	R IH T AH R Z
RIVETTED	R IH V AH T IH D
RIVETTING	R IH V AH T IH NG
ROOMETTE	R UW M EH T
ROOMETTES	R UW M EH T S
ROSETTE	R AH S EH T
ROSETTES	R OW Z EH T S
ROTTE	R AA T
ROTTED	R AA T IH D
ROTTEN	R AA T AH N
ROTTENER	R OW T AH N ER
ROTTENEST	R OW T AH N AH S T
ROTTENLY	R OW T AH N L IY
ROTTENNESS	R OW T AH N AH S
ROTTENNESSES	R OW T AH N AH S IH Z
ROTTENSTONE	R OW T AH N S T OW N
ROTTENSTONES	R OW T AH N S T OW N Z
ROTTER	R AA T ER
ROTTERS	R OW T ER Z
ROTTES	R AA T S
ROTTING	R AA T IH NG
ROTTWEILER	R AA T W IY AH L AH R
ROTTWEILERS	R AA T W IY L AH R Z
ROULETTE	R UW L EH T
ROULETTED	R UW L EH T IH D
ROULETTES	R UW L EH T S
ROULETTING	R UW L EH T IH NG
RUSSETTING	R AH S AH T IH NG
RUSSETTINGS	R AH S AH T IH NG Z
RUTTED	R AH T IH D
RUTTIER	R AH T IY ER
RUTTIEST	R AH T IY AH S T
RUTTILY	R AH T IY L IY
RUTTING	R AH T IH NG
RUTTISH	R AH T IH SH
RUTTISHLY	R AH T IH SH L IY
RUTTISHNESS	R AH T IH SH N AH S
RUTTISHNESSES	R AH T IH SH N AH S IH Z
RUTTY	R AH T IY
SAGITTAL	S AE JH AH T AH L
SAGITTALLY	S AH JH IH T AE L IY
SAGITTATE	S AE JH AH T EY T
SANDLOTTER	S AE N D L AA T ER
SANDLOTTERS	S AE N D L AA T ER Z
SANSCULOTTE	S AE N S Y UW L AH T
SANSCULOTTES	S AE N S Y UW L AH T S
SANSCULOTTIC	S AE N S Y UW L AH T AH K
SANSCULOTTISH	S AE N S Y AH L AA T AH SH
SANSCULOTTISM	S AE N S Y UW L AH T IH Z AH M
SANSCULOTTISMS	S AE N S Y AH L AA T AH Z AH M Z
SCATT	S K AE T
SCATTED	S K AE T AH D
SCATTER	S K AE T ER
SCATTERATION	S K AE T ER EY SH AH N
SCATTERATIONS	S K AE T ER EY SH AH N Z
SCATTERBRAIN	S K AE T ER B R EY N
SCATTERBRAINED	S K AE T ER B R EY N D
SCATTERBRAINS	S K AE T ER B R EY N Z
SCATTERED	S K AE T ER D
SCATTERER	S K AE T ER ER
SCATTERERS	S K AE T ER ER Z
SCATTERGOOD	S K AE T ER G UH D
SCATTERGOODS	S K AE T ER G UH D Z
SCATTERGRAM	S K AE T ER G R AE M
SCATTERGRAMS	S K AE T ER G R AE M Z
SCATTERGUN	S K AE T ER G AH N
SCATTERGUNS	S K AE T ER G AH N Z
SCATTERING	S K AE T ER IH NG
SCATTERINGLY	S K AE T ER IH NG L IY
SCATTERINGS	S K AE T ER IH NG Z
SCATTERS	S K AE T ER Z
SCATTERSHOT	S K AE T ER SH AA T
SCATTIER	S K AE T AY AH R
SCATTIEST	S K AE T AY AH S T
SCATTING	S K AE T AH NG
SCATTS	S K AE T S
SCATTY	S K AE T IY
SCHOTTISCHE	S K AA T AH S
SCHOTTISCHES	S K AA T AH S
SCOTTIE	S K AA T IY
SCOTTIES	S K AA T IY Z
SCUTTER	S K AH T AH R
SCUTTERED	S K AH T IY R D
SCUTTERING	S K AH T IY R AH NG
SCUTTERS	S K AH T AH R Z
SCUTTLE	S K AH T AH L
SCUTTLEBUTT	S K AH T AH L B AH T
SCUTTLEBUTTS	S K AH T AH L B AH T S
SCUTTLED	S K AH T AH L D
SCUTTLES	S K AH T AH L Z
SCUTTLING	S K AH T AH L IH NG
SCUTTLING(2)	S K AH T L IH NG
SEMIFITTED	S EH M IY F IH T IH D
SEMIMATT	S EH M IY M AE T
SEMIMATTE	S EH M AH M AE T
SEPTETTE	S EH P T EH T
SEPTETTES	S EH P T EH T S
SERMONETTE	S ER M AH N EH T
SERMONETTES	S ER M AH N EH T S
SERVIETTE	S ER V IY EH T
SERVIETTES	S ER V IY EH T S
SETT	S EH T
SETTEE	S EH T IY
SETTEES	S EH T IY Z
SETTER	S EH T ER
SETTERS	S EH T ER Z
SETTING	S EH T IH NG
SETTINGS	S EH T IH NG Z
SETTLE	S EH T AH L
SETTLEABLE	S EH T AH L AH B AH L
SETTLED	S EH T AH L D
SETTLEMENT	S EH T AH L M AH N T
SETTLEMENTS	S EH T AH L M AH N T S
SETTLER	S EH T AH L ER
SETTLER(2)	S EH T L ER
SETTLERS	S EH T L ER Z
SETTLERS(2)	S EH T AH L ER Z
SETTLES	S EH T AH L Z
SETTLING	S EH T AH L IH NG
SETTLING(2)	S EH T L IH NG
SETTLINGS	S EH T AH L IH NG Z
SETTLOR	S EH T AH L ER
SETTLORS	S EH T AH L ER Z
SETTS	S EH T S
SEXTETTE	S EH K S T EH T
SEXTETTES	S EH K S T EH T S
SHATTER	SH AE T ER
SHATTERED	SH AE T ER D
SHATTERING	SH AE T ER IH NG
SHATTERINGLY	SH AE T ER IH NG L IY
SHATTERPROOF	SH AE T ER P R UW F
SHATTERS	SH AE T ER Z
SHERGOTTITE	SH AH R G AH T AY T
SHERGOTTITES	SH AH R G AH T AY T S
SHIPFITTER	SH IH P F IH T ER
SHIPFITTERS	SH IH P F IH T ER Z
SHIRTTAIL	SH ER T EY L
SHIRTTAILS	SH ER T EY L Z
SHITTAH	SH IH T AH
SHITTAHS	SH IH T AH Z
SHITTED	SH IH T IH D
SHITTIER	SH IH T IY ER
SHITTIEST	SH IH T IY AH S T
SHITTIM	SH IH T AH M
SHITTIMS	SH IH T AH M Z
SHITTIMWOOD	SH IH T AH M W UW D
SHITTIMWOODS	SH IH T AH M W UW D Z
SHITTING	SH IH T IH NG
SHITTY	SH IH T IY
SHORTCUTTING	SH AO R T K AH T IH NG
SHOTT	SH AA T
SHOTTED	SH AA T IH D
SHOTTEN	SH AA T AH N
SHOTTING	SH AA T IH NG
SHOTTS	SH AA T S
SHUTTER	SH AH T ER
SHUTTERBUG	SH AH T ER B AH G
SHUTTERBUGS	SH AH T ER B AH G Z
SHUTTERED	SH AH T ER D
SHUTTERING	SH AH T ER IH NG
SHUTTERLESS	SH AH T ER L AH S
SHUTTERS	SH AH T ER Z
SHUTTING	SH AH T IH NG
SHUTTLE	SH AH T AH L
SHUTTLECOCK	SH AH T AH L K AA K
SHUTTLECOCKED	SH AH T AH L K AA K T
SHUTTLECOCKING	SH AH T AH L K AA K IH NG
SHUTTLECOCKS	SH AH T AH L K AA K S
SHUTTLED	SH AH T AH L D
SHUTTLELESS	SH AH T AH L AH S
SHUTTLES	SH AH T AH L Z
SHUTTLING	SH AH T AH L IH NG
SHUTTLING(2)	SH AH T L IH NG
SIDESPLITTING	S AY D S P L IH T IH NG
SIDESPLITTINGLY	S AY D S P L IH T IH NG L IY
SILHOUETTE	S IH L AH W EH T
SILHOUETTED	S IH L AH W EH T IH D
SILHOUETTES	S IH L AH W EH T S
SILHOUETTING	S IH L AH W EH T IH NG
SILHOUETTIST	S IH L AH W EH T IH S T
SILHOUETTISTS	S IH L AH W EH T IH S T S
SINFONIETTA	S IH N F AH N IY T AH
SINFONIETTAS	S IH N F AH N IY T AH Z
SITTEN	S IH T AH N
SITTER	S IH T ER
SITTERS	S IH T ER Z
SITTING	S IH T IH NG
SITTINGS	S IH T IH NG Z
SKITTER	S K IH T ER
SKITTERED	S K IH T ER D
SKITTERIER	S K IH T AH R IY ER
SKITTERIEST	S K IH T AH R IY AH S T
SKITTERING	S K IH T ER IH NG
SKITTERS	S K IH T ER Z
SKITTERY	S K IH T AH R IY
SKITTISH	S K IH T IH SH
SKITTISHLY	S K IH T IH SH L IY
SKITTISHNESS	S K IH T IH SH N AH S
SKITTISHNESSES	S K IH T IH SH N AH S IH Z
SKITTLE	S K IH T AH L
SKITTLES	S K IH T AH L Z
SKYWRITTEN	S K AY R IH T AH N
SLATTED	S L AE T IH D
SLATTERN	S L AE T AH R N
SLATTERNLINESS	S L AE T AH R N L AH N AH S
SLATTERNLINESSES	S L AE T AH R N L AH N EH S AH Z
SLATTERNLY	S L AE T AH R N L IY
SLATTERNS	S L AE T AH R N Z
SLATTING	S L AE T IH NG
SLATTINGS	S L AE T IH NG Z
SLITTED	S L IH T IH D
SLITTER	S L IH T ER
SLITTERS	S L IH T ER Z
SLITTING	S L IH T IH NG
SLOTTED	S L AA T IH D
SLOTTING	S L AA T IH NG
SLUTTIER	S L AH T AY AH R
SLUTTIEST	S L AH T AY AH S T
SLUTTISH	S L AH T AH SH
SLUTTISHLY	S L AH T IH SH L IY
SLUTTISHNESS	S L AH T IH SH N AH S
SLUTTISHNESSES	S L AH T IH SH N EH S AH Z
SLUTTY	S L AH T IY
SMATTER	S M AE T ER
SMATTERED	S M AE T ER D
SMATTERER	S M AE T ER ER
SMATTERERS	S M AE T ER ER Z
SMATTERING	S M AE T ER IH NG
SMATTERINGS	S M AE T ER IH NG Z
SMATTERS	S M AE T ER Z
SMITTEN	S M IH T AH N
SMUTTED	S M AH T AH D
SMUTTIER	S M AH T AY AH R
SMUTTIEST	S M AH T AY AH S T
SMUTTILY	S M AH T AH L IY
SMUTTINESS	S M AH T AH N AH S
SMUTTINESSES	S M AH T AH N EH S AH Z
SMUTTING	S M AH T AH NG
SMUTTY	S M AH T IY
SNAKEBITTEN	S N EY K B IH T AH N
SNAPSHOTTED	S N AE P SH AA T IH D
SNAPSHOTTING	S N AE P SH AA T IH NG
SNOTTIER	S N AA T AY AH R
SNOTTIEST	S N AA T AY AH S T
SNOTTILY	S N AA T AH L IY
SNOTTINESS	S N AA T AH N AH S
SNOTTINESSES	S N AA T AH N EH S AH Z
SNOTTY	S N AO T IY
SOMERSETTED	S AH M ER S EH T IH D
SOMERSETTING	S AH M ER S EH T IH NG
SONNETTED	S AA N AH T IH D
SONNETTING	S AA N AH T IH NG
SOTTED	S AA T AH D
SOTTISH	S AA T AH SH
SOTTISHLY	S AA T IH SH L IY
SOTTISHNESS	S AA T IH SH N AH S
SOTTISHNESSES	S AA T IH SH N EH S AH Z
SOUBRETTE	S AW B R EH T
SOUBRETTES	S AW B R EH T S
SPAGHETTI	S P AH G EH T IY
SPAGHETTILIKE	S P AH G EH T IY L AY K
SPAGHETTINI	S P AE EH T AH N IY
SPAGHETTINIS	S P AE EH T AH N AH S
SPAGHETTIS	S P AH G EH T IY Z
SPATTED	S P AE T IH D
SPATTER	S P AE T ER
SPATTERDOCK	S P AE T ER D AA K
SPATTERDOCKS	S P AE T ER D AA K S
SPATTERED	S P AE T ER D
SPATTERING	S P AE T ER IH NG
SPATTERS	S P AE T ER Z
SPATTING	S P AE T IH NG
SPINNERETTE	S P IH N ER EH T
SPINNERETTES	S P IH N ER EH T S
SPITTED	S P IH T IH D
SPITTER	S P IH T ER
SPITTERS	S P IH T ER Z
SPITTING	S P IH T IH NG
SPITTLE	S P IH T AH L
SPITTLEBUG	S P IH T AH L B AH G
SPITTLEBUGS	S P IH T AH L B AH G Z
SPITTLES	S P IH T AH L Z
SPITTOON	S P IH T UW N
SPITTOONS	S P IH T UW N Z
SPLATTED	S P L AE T AH D
SPLATTER	S P L AE T ER
SPLATTERED	S P L AE T ER D
SPLATTERING	S P L AE T AH R IH NG
SPLATTERS	S P L AE T ER Z
SPLATTING	S P L AE T AH NG
SPLITTER	S P L IH T ER
SPLITTERS	S P L IH T ER Z
SPLITTING	S P L IH T IH NG
SPLUTTER	S P L AH T AH R
SPLUTTERED	S P L AH T IY R D
SPLUTTERER	S P L AH T IY R AH R
SPLUTTERERS	S P L AH T AH R AH R Z
SPLUTTERING	S P L AH T IY R AH NG
SPLUTTERS	S P L AH T AH R Z
SPLUTTERY	S P L AH T AH R IY
SPOTTABLE	S P AA T AH B AH L
SPOTTED	S P AA T AH D
SPOTTED(2)	S P AA T IH D
SPOTTER	S P AA T ER
SPOTTERS	S P AA T ER Z
SPOTTIER	S P AA T IY ER
SPOTTIEST	S P AA T IY AH S T
SPOTTILY	S P AA T IY L IY
SPOTTINESS	S P AA T IY N AH S
SPOTTINESSES	S P AA T IY N AH S IH Z
SPOTTING	S P AA T IH NG
SPOTTY	S P AA T IY
SPRATTLE	S P R AE T AH L
SPRATTLED	S P R AE T AH L D
SPRATTLES	S P R AE T AH L Z
SPRATTLING	S P R AE T L AH NG
SPUTTER	S P AH T ER
SPUTTERED	S P AH T ER D
SPUTTERER	S P AH T ER ER
SPUTTERERS	S P AH T ER ER Z
SPUTTERING	S P AH T ER IH NG
SPUTTERS	S P AH T ER Z
SQUATTED	S K W AA T IH D
SQUATTER	S K W AA T ER
SQUATTERED	S K W AA T ER D
SQUATTERING	S K W AA T ER IH NG
SQUATTERS	S K W AA T ER Z
SQUATTEST	S K W AA T AH S T
SQUATTIER	S K W AA T IY ER
SQUATTIEST	S K W AA T IY AH S T
SQUATTING	S K W AA T IH NG
SQUATTY	S K W AA T IY
STANDPATTER	S T AE N D P AE T ER
STANDPATTERS	S T AE N D P AE T ER Z
STANDPATTISM	S T AE N D P AE T IH Z AH M
STANDPATTISMS	S T AE N D P AE T IH Z AH M Z
STATUETTE	S T AE CH UW EH T
STATUETTES	S T AE CH UW EH T S
STEAMFITTER	S T IY M F IH T ER
STEAMFITTERS	S T IY M F IH T ER Z
STETTED	S T EH T AH D
STETTING	S T EH T AH NG
STILETTO	S T AH L EH T OW
STILETTOED	S T AH L EH T OW D
STILETTOES	S T AH L EH T OW Z
STILETTOING	S T AH L EH T OW IH NG
STILETTOS	S T AH L EH T OW Z
STOCKINETTE	S T AA K IH N EH T
STOCKINETTES	S T AA K IH N EH T S
STONECUTTER	S T OW N K AH T ER
STONECUTTERS	S T OW N K AH T ER Z
STONECUTTING	S T OW N K AH T IH NG
STONECUTTINGS	S T OW N K AH T IH NG Z
STRETTA	S T R EH T AH
STRETTAS	S T R EH T AH Z
STRETTE	S T R EH T
STRETTI	S T R EH T IY
STRETTO	S T R EH T OW
STRETTOS	S T R EH T AH Z
STRUTTED	S T R AH T IH D
STRUTTER	S T R AH T ER
STRUTTERS	S T R AH T ER Z
STRUTTING	S T R AH T IH NG
STUTTER	S T AH T ER
STUTTERED	S T AH T IY R D
STUTTERER	S T AH T IY R AH R
STUTTERERS	S T AH T AH R AH R Z
STUTTERING	S T AH T ER IH NG
STUTTERS	S T AH T ER Z
SUBCOMMITTEE	S AH B K AH M IH T IY
SUBCOMMITTEES	S AH B K AH M IH T IY Z
SUBLETTING	S AH B L EH T IH NG
SUBLITTORAL	S AH B L IH T ER AH L
SUBLITTORALS	S AH B L IH T ER AH L Z
SUBMITTAL	S AH B M IH T AH L
SUBMITTALS	S AH B M IH T AH L Z
SUBMITTED	S AH B M IH T AH D
SUBMITTING	S AH B M IH T IH NG
SUFFRAGETTE	S AH F R AH JH EH T
SUFFRAGETTES	S AH F R AH JH EH T S
SULFURETTED	S AH L F ER EH T IH D
SULFURETTING	S AH L F ER EH T IH NG
SUPERETTE	S UW P ER EH T
SUPERETTES	S UW P ER EH T S
SUPERFATTED	S UW P ER F AE T IH D
SURREBUTTER	S ER R IY B AH T ER
SURREBUTTERS	S ER R IY B AH T ER Z
SUTTA	S AH T AH
SUTTAS	S AH T AH Z
SUTTEE	S AH T IY IY
SUTTEES	S AH T IY Z
SWATTED	S W AA T IH D
SWATTER	S W AA T AH R
SWATTERS	S W AA T AH R Z
SWATTING	S W AA T AH NG
SWOTTED	S W AA T AH D
SWOTTER	S W AA T AH R
SWOTTERS	S W AA T AH R Z
SWOTTING	S W AA T AH NG
TABLETTED	T AE B L AH T IH D
TABLETTING	T AE B L AH T IH NG
TATTED	T AE T IH D
TATTER	T AE T ER
TATTERDEMALION	T AE T ER D IY M AE L Y AH N
TATTERDEMALIONS	T AE T ER D IY M AE L Y AH N Z
TATTERED	T AE T ER D
TATTERING	T AE T ER IH NG
TATTERS	T AE T ER Z
TATTERSALL	T AE T ER S AH L
TATTERSALLS	T AE T ER Z AO L Z
TATTIE	T AE T IY
TATTIER	T AE T IY ER
TATTIES	T AE T IY Z
TATTIEST	T AE T IY AH S T
TATTILY	T AE T IY L IY
TATTINESS	T AE T IY N AH S
TATTINESSES	T AE T IY N AH S IH Z
TATTING	T AE T IH NG
TATTINGS	T AE T IH NG Z
TATTLE	T AE T AH L
TATTLED	T AE T AH L D
TATTLER	T AE T L ER
TATTLERS	T AE T L AH R Z
TATTLES	T AE T AH L Z
TATTLETALE	T AE T L AH T EY L
TATTLETALES	T AE T L AH T EY L Z
TATTLING	T AE T L AH NG
TATTOO	T AE T UW
TATTOOED	T AE T UW D
TATTOOER	T AE T UW ER
TATTOOERS	T AE T UW ER Z
TATTOOING	T AE T UW IH NG
TATTOOIST	T AE T UW IH S T
TATTOOISTS	T AE T UW IH S T S
TATTOOS	T AE T UW Z
TATTY	T AE T IY
TEAKETTLE	T IY K EH T AH L
TEAKETTLES	T IY K EH T AH L Z
TELNETTED	T EH L N EH T AH D
TELNETTING	T EH L N EH T AH NG
TERAWATT	T EH R AH AH T
TERAWATTS	T EH R AH AH T S
TETTER	T EH T AH R
TETTERS	T EH T AH R Z
THERMOSETTING	TH ER M OW S EH T IH NG
THERMOSTATTED	TH ER M AH S T AE T IH D
THERMOSTATTING	TH ER M AH S T AE T IH NG
THROTTLE	TH R AA T AH L
THROTTLEABLE	TH R AA T AH L AH B AH L
THROTTLED	TH R AA T AH L D
THROTTLEHOLD	TH R AA T AH L HH OW L D
THROTTLEHOLDS	TH R AA T AH L HH OW L D Z
THROTTLER	TH R AA T AH L ER
THROTTLERS	TH R AA T AH L ER Z
THROTTLES	TH R AA T AH L Z
THROTTLING	TH R AA T AH L IH NG
THROTTLING(2)	TH R AA T L IH NG
TITTER	T IH T ER
TITTERED	T IH T ER D
TITTERER	T IH T ER ER
TITTERERS	T IH T ER ER Z
TITTERING	T IH T ER IH NG
TITTERS	T IH T ER Z
TITTIE	T IH T IY
TITTIES	T IH T IY Z
TITTIVATE	T IH T IH V AH T
TITTIVATED	T IH T IH V EY T IH D
TITTIVATES	T IH T IH V AH T S
TITTIVATING	T IH T IH V EY T IH NG
TITTLE	T IH T AH L
TITTLES	T IH T AH L Z
TITTUP	T IH T AH P
TITTUPED	T IH T Y UW P T
TITTUPING	T IH T Y UW P AH NG
TITTUPPED	T IH T AH P T
TITTUPPING	T IH T AH P AH NG
TITTUPPY	T IH T AH P IY
TITTUPS	T IH T AH P S
TITTY	T IH T IY
TOILETTE	T OY L EH T
TOILETTES	T OY L EH T S
TOMCATTED	T AA M K AE T IH D
TOMCATTING	T AA M K AE T IH NG
TONETTE	T OW N EH T
TONETTES	T OW N EH T S
TOTTED	T AA T IH D
TOTTER	T AA T ER
TOTTERED	T AA T ER D
TOTTERER	T AA T ER ER
TOTTERERS	T AA T ER ER Z
TOTTERING	T AA T ER IH NG
TOTTERINGLY	T AA T ER IH NG L IY
TOTTERS	T AA T ER Z
TOTTERY	T AA T AH R IY
TOTTING	T AA T IH NG
TOWELETTE	T AW AH L EH T
TOWELETTES	T AW AH L EH T S
TRANSMITTABLE	T R AE N Z M IH T AH B AH L
TRANSMITTAL	T R AE N S M IH T AH L
TRANSMITTALS	T R AE N S M IH T AH L Z
TRANSMITTANCE	T R AE N S M IH T AH N S
TRANSMITTANCES	T R AE N S M IH T AH N S IH Z
TRANSMITTED	T R AE N S M IH T IH D
TRANSMITTED(2)	T R AE N Z M IH T AH D
TRANSMITTER	T R AE N S M IH T ER
TRANSMITTERS	T R AE N S M IH T ER Z
TRANSMITTING	T R AE N S M IH T IH NG
TRATTORIA	T R AE T AO R IY AH
TRATTORIAS	T R AE T AO R IY AH Z
TRATTORIE	T R AE T AH R AY
TRENDSETTER	T R EH N D S EH T ER
TRENDSETTERS	T R EH N D S EH T ER Z
TRENDSETTING	T R EH N D S EH T IH NG
TRICOLETTE	T R IH K AH L EH T
TRICOLETTES	T R IH K AH L EH T S
TROTTED	T R AA T AH D
TROTTED(2)	T R AA T IH D
TROTTER	T R AA T ER
TROTTERS	T R AA T ER Z
TROTTING	T R AA T IH NG
TUTTED	T AH T AH D
TUTTI	T UW T IY
TUTTIES	T AH T AY Z
TUTTING	T AH T AH NG
TUTTIS	T AH T AH S
TUTTY	T AH T IY
TWATTLE	T W AA T AH L
TWATTLED	T W AA T AH L D
TWATTLES	T W AA T AH L Z
TWATTLING	T W AA T L AH NG
TWITTED	T W IH T AH D
TWITTER	T W IH T ER
TWITTERED	T W IH T ER D
TWITTERING	T W IH T ER IH NG
TWITTERS	T W IH T ER Z
TWITTERY	T W IH T ER IY
TWITTING	T W IH T AH NG
TYPESETTER	T AY P S EH T ER
TYPESETTERS	T AY P S EH T ER Z
TYPESETTING	T AY P S EH T IH NG
TYPESETTINGS	T AY P S EH T IH NG Z
TYPEWRITTEN	T AY P R IH T AH N
UMBRETTE	AH M B R EH T
UMBRETTES	AH M B R EH T S
UNADMITTED	AH N AH D M IH T IH D
UNATTACHED	AH N AH T AE CH T
UNATTAINABLE	AH N AH T EY N AH B AH L
UNATTENDED	AH N AH T EH N D IH D
UNATTENUATED	AH N AE T EH N Y UW EY T AH D
UNATTESTED	AH N AH T EH S T IH D
UNATTRACTIVE	AH N AH T R AE K T IH V
UNATTRACTIVELY	AH N AH T R AE K T IH V L IY
UNATTRACTIVENESS	AH N AH T R AE K T IH V N AH S
UNATTRACTIVENESSES	AH N AH T R AE K T IH V N AH S IH Z
UNATTRIBUTABLE	AH N AE T R AH B Y UW T AH B AH L
UNATTRIBUTED	AH N AE T R AH B Y UW T IH D
UNATTUNED	AH N AH T UW N D
UNBEFITTING	AH N B IH F IH T IH NG
UNBITTED	AH N B IH T IH D
UNBITTEN	AH N B IH T AH N
UNBITTER	AH N B IH T ER
UNBUTTERED	AH N B AH T ER D
UNBUTTON	AH N B AH T AH N
UNBUTTONED	AH N B AH T AH N D
UNBUTTONING	AH N B AH T AH N IH NG
UNBUTTONS	AH N B AH T AH N Z
UNCLUTTER	AH N K L AH T ER
UNCLUTTERED	AH N K L AH T ER D
UNCLUTTERING	AH N K L AH T ER IH NG
UNCLUTTERS	AH N K L AH T ER Z
UNCOMMITTED	AH N K AH M IH T IH D
UNDERCUTTING	AH N D ER K AH T IH NG
UNDERLETTING	AH N D ER L AH T IH NG
UNDERWRITTEN	AH N D ER R IH T AH N
UNDOTTED	AH N D AA T IH D
UNEMBITTERED	AH N IH M B IH T ER D
UNFETTER	AH N F EH T ER
UNFETTERED	AH N F EH T ER D
UNFETTERING	AH N F EH T ER IH NG
UNFETTERS	AH N F EH T ER Z
UNFITTED	AH N F IH T IH D
UNFITTING	AH N F IH T IH NG
UNFLATTERING	AH N F L AE T ER IH NG
UNFLATTERINGLY	AH N F L AE T ER IH NG L IY
UNFORGETTABLE	AH N F ER G EH T AH B AH L
UNFORGETTABLY	AH N F OW R JH EH T AH B L IY
UNGOTTEN	AH N G AA T AH N
UNHATTED	AH N HH AE T IH D
UNHATTING	AH N HH AE T IH NG
UNKNITTED	AH N IH T IH D
UNKNITTING	AH N IH T IH NG
UNKNOTTED	AH N AA T IH D
UNKNOTTING	AH N AA T IH NG
UNLETTED	AH N L EH T IH D
UNLETTERED	AH N L EH T ER D
UNMATTED	AH N M AE T IH D
UNPOTTED	AH N P AA T IH D
UNPRETTY	AH N P R IH T IY
UNREMITTING	AH N R IH M IH T IH NG
UNREMITTING(2)	AH N R IY M IH T IH NG
UNREMITTINGLY	AH N R IH M IH T IH NG L IY
UNSETTING	AH N S EH T IH NG
UNSETTLE	AH N S EH T AH L
UNSETTLED	AH N S EH T AH L D
UNSETTLEDNESS	AH N S EH T AH L AH D N AH S
UNSETTLEDNESSES	AH N S EH T AH L AH D N AH S IH Z
UNSETTLEMENT	AH N S EH T AH L M AH N T
UNSETTLEMENTS	AH N S EH T AH L M AH N T S
UNSETTLES	AH N S EH T AH L Z
UNSETTLING	AH N S EH T AH L IH NG
UNSETTLING(2)	AH N S EH T L IH NG
UNSETTLINGLY	AH N S EH T AH L IH NG L IY
UNSPOTTED	AH N S P AA T IH D
UNUTTERABLE	AH N AH T ER AH B AH L
UNUTTERABLY	AH N AH T ER AH B L IY
UNWETTED	AH N W EH T IH D
UNWITTED	AH N W IH T IH D
UNWITTING	AH N W IH T IH NG
UNWITTINGLY	AH N W IH T IH NG L IY
UNWRITTEN	AH N R IH T AH N
UPPERCUTTING	AH P ER K AH T IH NG
UPSETTER	AH P S EH T ER
UPSETTERS	AH P S EH T ER Z
UPSETTING	AH P S EH T IH NG
USHERETTE	AH SH ER EH T
USHERETTES	AH SH ER EH T S
UTTER	AH T ER
UTTERABLE	AH T ER AH B AH L
UTTERANCE	AH T ER AH N S
UTTERANCES	AH T ER AH N S IH Z
UTTERED	AH T ER D
UTTERER	AH T ER ER
UTTERERS	AH T ER ER Z
UTTERING	AH T ER IH NG
UTTERLY	AH T ER L IY
UTTERMOST	AH T ER M OW S T
UTTERMOSTS	AH T ER M OW S T S
UTTERS	AH T ER Z
VAPORETTI	V AE P AH R EH T IY
VAPORETTO	V AE P AH R EH T OW
VAPORETTOS	V AE P AH R EH T AH Z
VATTED	V AE T IH D
VATTING	V AE T AH NG
VEDETTE	V IH D EH T
VEDETTES	V IY D EH T S
VENDETTA	V EH N D EH T AH
VENDETTAS	V EH N D EH T AH Z
VETTED	V EH T IH D
VETTING	V EH T IH NG
VIDEOCASSETTE	V IH D IY OW K AE S EH T
VIDEOCASSETTES	V IH D IY OW K AE S EH T S
VIDETTE	V AY D EH T
VIDETTES	V AY D EH T S
VIGNETTE	V IH N Y EH T
VIGNETTE(2)	V IY N Y EH T
VIGNETTED	V IH N Y EH T IH D
VIGNETTER	V IH N Y EH T ER
VIGNETTERS	V IH N Y EH T ER Z
VIGNETTES	V IH N Y EH T S
VIGNETTING	V IH N Y EH T IH NG
VIGNETTIST	V IH N Y EH T IH S T
VIGNETTISTS	V IH N Y EH T IH S T S
VINAIGRETTE	V AH N EY G R EH T
VINAIGRETTES	V AH N EY G R EH T S
VITTA	V IH T AH
VITTAE	V IH T IY
VITTATE	V IH T EY T
VITTLE	V IH T AH L
VITTLED	V IH T AH L D
VITTLES	V IH T AH L Z
VITTLING	V IH T L AH NG
WADSETTED	W AA D S EH T IH D
WADSETTING	W AA D S EH T IH NG
WAGONETTE	W AE G AH N EH T
WAGONETTES	W AE G AH N EH T S
WAINSCOTTED	W EY N S K AA T IH D
WAINSCOTTING	W EY N S K AO T IH NG
WAINSCOTTINGS	W EY N S K AA T IH NG Z
WATT	W AA T
WATTAGE	W AA T AH JH
WATTAGES	W AA T IH JH IH Z
WATTAPE	W AA T EY P
WATTAPES	W AA T EY P S
WATTER	W AA T ER
WATTEST	W AA T AH S T
WATTHOUR	W AA T AW ER
WATTHOURS	W AA T AW ER Z
WATTLE	W AA T AH L
WATTLEBIRD	W AA T AH L B ER D
WATTLEBIRDS	W AA T AH L B ER D Z
WATTLED	W AA T AH L D
WATTLES	W AA T AH L Z
WATTLESS	W AA T L AH S
WATTLING	W AA T L IH NG
WATTMETER	W AA T M IY T ER
WATTMETERS	W AA T M IY T ER Z
WATTS	W AA T S
WETTABILITIES	W EH T AH B IH L AH T EH Z
WETTABILITY	W EH T AH B IH L AH T EH
WETTABLE	W EH T AH B AH L
WETTED	W EH T IH D
WETTER	W EH T ER
WETTERS	W EH T ER Z
WETTEST	W EH T AH S T
WETTING	W EH T IH NG
WETTING(2)	HH W EH T IH NG
WETTINGS	W EH T IH NG Z
WETTISH	W EH T IH SH
WHETTED	W EH T IH D
WHETTED(2)	HH W EH T IH D
WHETTER	W EH T ER
WHETTERS	W EH T ER Z
WHETTING	W EH T IH NG
WHITTER	W IH T ER
WHITTERS	W IH T ER Z
WHITTLE	W IH T AH L
WHITTLE(2)	HH W IH T AH L
WHITTLED	W IH T AH L D
WHITTLED(2)	HH W IH T AH L D
WHITTLER	W IH T L AH R
WHITTLERS	W IH T L AH R Z
WHITTLES	W IH T AH L Z
WHITTLING	W IH T L IH NG
WHITTLING(2)	HH W IH T L IH NG
WHITTLINGS	W IH T L AH NG Z
WHITTRET	W IH T R AH T
WHITTRETS	W IH T R AH T S
WILDCATTED	W AY L D K AE T IH D
WILDCATTER	W AY L D K AE T ER
WILDCATTERS	W AY L D K AE T ER Z
WILDCATTING	W AY L D K AE T IH NG
WITTED	W IH T IH D
WITTICISM	W IH T IH K S IH Z AH M
WITTICISMS	W IH T IH K S IH Z AH M Z
WITTIER	W IH T IY ER
WITTIEST	W IH T IY AH S T
WITTILY	W IH T AH L IY
WITTINESS	W IH T IY N AH S
WITTINESSES	W IH T IY N AH S IH Z
WITTING	W IH T IH NG
WITTINGLY	W IH T IH NG L IY
WITTINGS	W IH T IH NG Z
WITTOL	W IH T AH L
WITTOLS	W IH T AH L Z
WITTY	W IH T IY
WOODCUTTER	W UH D K AH T ER
WOODCUTTERS	W UH D K AH T ER Z
WOODCUTTING	W UH D K AH T IH NG
WOODCUTTINGS	W UH D K AH T IH NG Z
WOTTED	W AA T AH D
WOTTING	W AA T AH NG
WRITTEN	R IH T AH N
WYANDOTTE	W AY AE N D AH T
WYANDOTTES	W AY AE N D AH T S
YATTER	Y AE T AH R
YATTERED	Y AE T IY R D
YATTERING	Y AE T IY R AH NG
YATTERS	Y AE T AH R Z
YETT	Y EH T
YETTS	Y EH T S
YOTTABYTE	Y AA T AH B AY T
YOTTABYTES	Y AA T AH B AY T S
YTTERBIA	Y T AH R B IY AH
YTTERBIAS	Y T AH R B IY AH Z
YTTERBIC	Y T AH R B AH K
YTTERBIUM	Y T AH R B IY AH M
YTTERBIUMS	Y T AH R B IY AH M Z
YTTRIA	Y T R IY AH
YTTRIAS	Y T R IY AH Z
YTTRIC	Y T R K
YTTRIUM	IH T R IY AH M
YTTRIUMS	Y T R IY AH M Z
ZETTABYTE	Z EH T AH B AY T
ZETTABYTES	Z EH T AH B AY T S
ZUCCHETTO	Z AH K EH T OW
ZUCCHETTOS	Z AH K EH T AH Z
ZWITTERION	Z W IH T IY R IY AH N
ZWITTERIONIC	Z W IH T IY R IY AH N AH K
ZWITTERIONS	Z W IH T IY R IY AH N Z
EICOSANOID	IY K AA S AH N OY D
HWAN	HH W AA N
MY	M AY
UBIETIES	Y UW B AH T AY Z
SHH	EH S EY CH
EALDORMAN	EH L D AO R M AH N
NTH	EH N TH
