WH	D AH B AH L Y UW
ANTIWHALING	AE N T AY W EY L IH NG
ANTIWHITE	AE N T AY W AY T
ANYWHERE	EH N IY W EH R
ANYWHERE(2)	EH N IY HH W EH R
ANYWHERES	EH N IY W EH ER Z
ARROWHEAD	AE R OW HH EH D
ARROWHEAD(2)	EH R OW HH EH D
ARROWHEADS	AE R OW HH EH D Z
ARROWHEADS(2)	EH R OW HH EH D Z
AWHILE	AH W AY L
AWHIRL	AH W ER L
BETWEENWHILES	B IH T W IY N W AH L Z
BEWHISKERED	B IH W IH S K ER D
BLOWHARD	B L OW HH AA R D
BLOWHARDS	B L OW HH AA R D Z
BLOWHOLE	B L OW HH OW L
BLOWHOLES	B L OW HH OW L Z
BOBWHITE	B AA B W AY T
BOBWHITES	B AA B W AY T S
BOWHEAD	B AW HH EH D
BOWHEADS	B AW HH EH D Z
BUCKWHEAT	B AH K W IY T
BUCKWHEATS	B AH K W IY T S
BULLWHIP	B UH L W IH P
BULLWHIPPED	B UH L W IH P T
BULLWHIPPING	B UH L W IH P IH NG
BULLWHIPS	B UH L W IH P S
BUSHWHACK	B UH SH W AE K
BUSHWHACKED	B UH SH W AE K T
BUSHWHACKER	B UH SH W AE K ER
BUSHWHACKERS	B UH SH W AE K ER Z
BUSHWHACKING	B UH SH W AE K IH NG
BUSHWHACKS	B UH SH W AE K S
CARTWHEEL	K AA R T W IY L
CARTWHEELED	K AA R T W IY L D
CARTWHEELER	K AA R T W IY L ER
CARTWHEELERS	K AA R T W IY L ER Z
CARTWHEELING	K AA R T W IY L IH NG
CARTWHEELS	K AA R T W IY L Z
CHAINWHEEL	CH EY N W IY L
CHAINWHEELS	CH EY N W IY L Z
CHOWHOUND	CH AW HH AW N D
CHOWHOUNDS	CH AW HH AW N D Z
CLAWHAMMER	K L AO HH AE M ER
COGWHEEL	K AA G W IY L
COGWHEELS	K AA G W IY L Z
COWHAGE	K OW AH JH
COWHAGES	K OW AH JH AH Z
COWHAND	K AW HH AE N D
COWHANDS	K AW HH AE N D Z
COWHERB	K AW ER B
COWHERBS	K AW ER B Z
COWHERD	K AW HH ER D
COWHERDS	K AW HH ER D Z
COWHIDE	K AW HH AY D
COWHIDED	K AW HH AY D IH D
COWHIDES	K AW HH AY D Z
COWHIDING	K AW HH AY D IH NG
ELSEWHERE	EH L S W EH R
ENWHEEL	EH N W IY L
ENWHEELED	EH N W IY L D
ENWHEELING	EH N W IY L IH NG
ENWHEELS	EH N W IY L Z
EREWHILE	EH R UW AH L
EREWHILES	EH R UW AH L Z
ERSTWHILE	ER S T W AY L
EVERYWHERE	EH V R IY W EH R
EVERYWHERE(2)	EH V R IY HH W EH R
FLYWHEEL	F L AY W IY L
FLYWHEELS	F L AY W IY L Z
FORWHY	F AO R W IY
FREEWHEEL	F R IY W IY L
FREEWHEELED	F R IY W IY L D
FREEWHEELER	F R IY W IY L ER
FREEWHEELERS	F R IY W IY L ER Z
FREEWHEELING	F R IY W IY L IH NG
FREEWHEELING(2)	F R IY HH W IY L IH NG
FREEWHEELINGLY	F R IY W IY L IH NG L IY
FREEWHEELS	F R IY W IY L Z
GEARWHEEL	G IH ER W IY L
GEARWHEELS	G IH ER W IY L Z
HANDWHEEL	HH AE N D W IY L
HANDWHEELS	HH AE N D W IY L Z
HORSEWHIP	HH AO R S W IH P
HORSEWHIPPED	HH AO R S W IH P T
HORSEWHIPPER	HH AO R S W IH P ER
HORSEWHIPPERS	HH AO R S W IH P ER Z
HORSEWHIPPING	HH AO R S W IH P IH NG
HORSEWHIPS	HH AO R S W IH P S
LINTWHITE	L IH N T W AY T
LINTWHITES	L IH N T W AY T S
MEANWHILE	M IY N W AY L
MEANWHILES	M IY N W AY L Z
NARWHAL	N AA R W AH L
NARWHALE	N AA R W HH EY L
NARWHALES	N AA R W HH EY L Z
NARWHALS	N AA R W HH AH L Z
NONWHITE	N AA N W AY T
NONWHITE(2)	N AA N HH W AY T
NONWHITES	N AA N W AY T S
NONWHITES(2)	N AA N HH W AY T S
NOSEWHEEL	N OW Z W IY L
NOSEWHEELS	N OW Z W IY L Z
NOWHERE	N OW W EH R
NOWHERE(2)	N OW HH W EH R
NOWHERES	N OW W EH ER Z
NOWHITHER	N OW HH AH DH AH R
OTHERWHERE	AH TH AH R W HH AH R
OTHERWHILE	AH TH AH R W AH L
OTHERWHILES	AH TH AH R W AH L Z
OUTWHIRL	AW T W ER L
OUTWHIRLED	AW T W ER L D
OUTWHIRLING	AW T W ER L IH NG
OUTWHIRLS	AW T W ER L Z
OVERWHELM	OW V ER W EH L M
OVERWHELM(2)	OW V ER HH W EH L M
OVERWHELMED	OW V ER W EH L M D
OVERWHELMED(2)	OW V ER HH W EH L M D
OVERWHELMING	OW V ER W EH L M IH NG
OVERWHELMING(2)	OW V ER HH W EH L M IH NG
OVERWHELMINGLY	OW V ER W EH L M IH NG L IY
OVERWHELMINGLY(2)	OW V ER HH W EH L M IH NG L IY
OVERWHELMS	OW V ER W EH L M Z
OVERWHELMS(2)	OW V ER HH W EH L M Z
PENNYWHISTLE	P EH N IY W IH S AH L
PENNYWHISTLES	P EH N IY W IH S AH L Z
PEWHOLDER	P Y UW HH OW L D ER
PEWHOLDERS	P Y UW HH OW L D ER Z
PINWHEEL	P IH N W IY L
PINWHEELED	P IH N W IY L D
PINWHEELING	P IH N W IY L IH NG
PINWHEELS	P IH N W IY L Z
PLOWHEAD	P L AW HH EH D
PLOWHEADS	P L AW HH EH D Z
RAWHIDE	R AO HH AY D
RAWHIDED	R AO HH AY D IH D
RAWHIDES	R AO HH AY D Z
RAWHIDING	R AO HH AY D IH NG
SAWHORSE	S AO HH AO R S
SAWHORSES	S AO HH AO R S IH Z
SOMEWHAT	S AH M W AH T
SOMEWHAT(2)	S AH M HH W AH T
SOMEWHATS	S AH M W AH T S
SOMEWHEN	S AA M Y UW AH N
SOMEWHERE	S AH M W EH R
SOMEWHERES	S AH M W EH R Z
SOMEWHITHER	S AA M Y UW HH AH DH AH R
STRAWHAT	S T R AO HH AE T
THUMBWHEEL	TH AH M W IY L
THUMBWHEELS	TH AH M W IY L Z
TOWHEAD	T OW HH EH D
TOWHEADED	T OW HH EH D IH D
TOWHEADS	T OW HH EH D Z
TOWHEE	T OW IY IY
TOWHEES	T OW HH IY Z
UNDERWHELM	AH N D ER W EH L M
UNDERWHELMED	AH N D ER W EH L M D
UNDERWHELMING	AH N D ER W EH L M IH NG
UNDERWHELMS	AH N D ER W EH L M Z
UNWHITE	AH N W AY T
UNWHOLESOME	AH N HH OW L S AH M
UNWHOLESOMELY	AH N HH OW L S AH M L IY
WATERWHEEL	W AO T ER W IY L
WATERWHEELS	W AO T ER W IY L Z
WHA	W AA
WHACK	W AE K
WHACK(2)	HH W AE K
WHACKED	W AE K T
WHACKED(2)	HH W AE K T
WHACKER	W AE K ER
WHACKER(2)	HH W AE K ER
WHACKERS	W AE K ER Z
WHACKIER	W AE K IY ER
WHACKIEST	W AE K IY AH S T
WHACKING	W AE K IH NG
WHACKING(2)	HH W AE K IH NG
WHACKO	W AE K OW
WHACKOS	W AE K OW Z
WHACKS	W AE K S
WHACKS(2)	HH W AE K S
WHACKY	W AE K IY
WHALE	W EY L
WHALE(2)	HH W EY L
WHALEBACK	W EY L B AE K
WHALEBACKS	W EY L B AE K S
WHALEBOAT	W EY L B OW T
WHALEBOATS	W EY L B OW T S
WHALEBONE	W EY L B OW N
WHALEBONES	W EY L B OW N Z
WHALED	W EY L D
WHALELIKE	W EY L AY K
WHALEMAN	W EY L M AE N
WHALEMEN	W EY L M EH N
WHALER	W EY L ER
WHALER(2)	HH W EY L ER
WHALERS	W EY L ER Z
WHALERS(2)	HH W EY L ER Z
WHALES	W EY L Z
WHALES(2)	HH W EY L Z
WHALING	W EY L IH NG
WHALING(2)	HH W EY L IH NG
WHALINGS	W EY L IH NG Z
WHAM	W AE M
WHAM(2)	HH W AE M
WHAMMED	W AA M D
WHAMMIES	W AA M AY Z
WHAMMING	W AA M AH NG
WHAMMO	W AA M OW
WHAMMY	W AE M IY
WHAMMY(2)	HH W AE M IY
WHAMO	W AA M OW
WHAMS	W AA M Z
WHANG	W AE NG
WHANG(2)	HH W AE NG
WHANGED	W AA NG D
WHANGEE	W AA N JH IY IY
WHANGEES	W AH NG IY Z
WHANGING	W AA NG AH NG
WHANGS	W AA NG Z
WHAP	W AA P
WHAPPED	W AA P T
WHAPPER	W AA P AH R
WHAPPERS	W AA P AH R Z
WHAPPING	W AA P AH NG
WHAPS	W AA P S
WHARF	W AO R F
WHARF(2)	HH W AO R F
WHARFAGE	W AO R F IH JH
WHARFAGES	W AO R F IH JH IH Z
WHARFED	W AO R F T
WHARFING	W AO R F IH NG
WHARFINGER	W AO R F IH NG ER
WHARFINGERS	W AO R F IH NG ER Z
WHARFMASTER	W AO R F M AE S T ER
WHARFMASTERS	W AO R F M AE S T ER Z
WHARFS	W AO R F S
WHARFS(2)	HH W AO R F S
WHARVE	W AO R V
WHARVES	W AO R V Z
WHAT	W AH T
WHAT(2)	HH W AH T
WHATCHAMACALLIT	W AA CH AH M AH K AE L AH T
WHATCHAMACALLITS	W AA CH AH M AH K AE L AH T S
WHATEVER	W AH T EH V ER
WHATEVER(2)	HH W AH T EH V ER
WHATNESS	W AA T N AH S
WHATNESSES	W AA T N EH S AH Z
WHATNOT	W AH T N AA T
WHATNOT(2)	HH W AH T N AA T
WHATNOTS	W AA T N AH T S
WHATS	W AH T S
WHATS(2)	HH W AH T S
WHATSHISNAME	W AA T AH Z N EY M
WHATSIS	W AA T S IY Z
WHATSISES	W AA T S IY Z IH Z
WHATSIT	W AA T S AH T
WHATSITS	W AA T S AH T S
WHATSOEVER	W AH T S OW EH V ER
WHATSOEVER(2)	HH W AH T S OW EH V ER
WHAUP	W AO P
WHAUPS	W AO P S
WHEAL	W IY AH L
WHEALS	W IY L Z
WHEAT	W IY T
WHEAT(2)	HH W IY T
WHEATEAR	W IY T IH ER
WHEATEARS	W IY T IH ER Z
WHEATEN	W IY T AH N
WHEATEN(2)	HH W IY T AH N
WHEATENS	W IY T AH N Z
WHEATS	W IY T S
WHEE	W IY
WHEEDLE	W IY D AH L
WHEEDLED	W IY D AH L D
WHEEDLER	W IY D AH L ER
WHEEDLERS	W IY D AH L ER Z
WHEEDLES	W IY D AH L Z
WHEEDLING	W IY D AH L IH NG
WHEEL	W IY L
WHEEL(2)	HH W IY L
WHEELBARROW	W IY L B EH R OW
WHEELBARROW(2)	HH W IY L B EH R OW
WHEELBARROWED	W IY L B AE R OW D
WHEELBARROWING	W IY L B AE R OW IH NG
WHEELBARROWS	W IY L B EH R OW Z
WHEELBARROWS(2)	HH W IY L B EH R OW Z
WHEELBASE	W IY L B EY S
WHEELBASE(2)	HH W IY L B EY S
WHEELBASES	W IY L B EY S IH Z
WHEELCHAIR	W IY L CH EH R
WHEELCHAIR(2)	HH W IY L CH EH R
WHEELCHAIRS	W IY L CH EH R Z
WHEELCHAIRS(2)	HH W IY L CH EH R Z
WHEELED	W IY L D
WHEELED(2)	HH W IY L D
WHEELER	W IY L ER
WHEELER(2)	HH W IY L ER
WHEELERS	W IY L ER Z
WHEELERS(2)	HH W IY L ER Z
WHEELHORSE	W IY L HH AO R S
WHEELHORSES	W IY L HH AO R S IH Z
WHEELHOUSE	W IY L HH AW S
WHEELHOUSES	W IY L HH AW S IH Z
WHEELIE	W IY L IY
WHEELIES	W IY L IY Z
WHEELING	W IY L IH NG
WHEELING(2)	HH W IY L IH NG
WHEELINGS	W IY L IH NG Z
WHEELLESS	W IY L AH S
WHEELMAN	W IY L M AE N
WHEELMEN	W IY L M EH N
WHEELS	W IY L Z
WHEELS(2)	HH W IY L Z
WHEELSMAN	W IY L Z M AE N
WHEELSMEN	W IY L Z M EH N
WHEELWORK	W IY L W ER K
WHEELWORKS	W IY L W ER K S
WHEELWRIGHT	W IY L R AY T
WHEELWRIGHT(2)	HH W IY L R AY T
WHEELWRIGHTS	W IY L R AY T S
WHEEN	W IY AH N
WHEENS	W IY N Z
WHEEP	W IY P
WHEEPED	W IY P T
WHEEPING	W IY P AH NG
WHEEPLE	W IY P AH L
WHEEPLED	W IY P AH L D
WHEEPLES	W IY P AH L Z
WHEEPLING	W IY P L AH NG
WHEEPS	W IY P S
WHEEZE	W IY Z
WHEEZE(2)	HH W IY Z
WHEEZED	W IY Z D
WHEEZER	W IY Z ER
WHEEZERS	W IY Z ER Z
WHEEZES	W IY Z AH Z
WHEEZES(2)	HH W IY Z AH Z
WHEEZES(3)	W IY Z IH Z
WHEEZIER	W IY Z IY ER
WHEEZIEST	W IY Z IY AH S T
WHEEZILY	W IY Z IY L IY
WHEEZINESS	W IY Z IY N AH S
WHEEZINESSES	W IY Z IY N AH S IH Z
WHEEZING	W IY Z IH NG
WHEEZING(2)	HH W IY Z IH NG
WHEEZY	W IY Z IY
WHELK	W EH K
WHELKIER	W EH L K AY AH R
WHELKIEST	W EH L K AY AH S T
WHELKS	W EH K S
WHELKY	W EH L K IY
WHELM	W EH L M
WHELMED	W EH L M D
WHELMING	W EH L M IH NG
WHELMS	W EH L M Z
WHELP	W EH L P
WHELPED	W EH L P T
WHELPING	W EH L P AH NG
WHELPS	W EH L P S
WHEN	W EH N
WHEN(2)	HH W EH N
WHEN(3)	W IH N
WHEN(4)	HH W IH N
WHENAS	W EH N AH Z
WHENCE	W EH N S
WHENCE(2)	HH W EH N S
WHENCESOEVER	W EH N S AH S OW AH V AH R
WHENEVER	W EH N EH V ER
WHENEVER(2)	HH W EH N EH V ER
WHENS	W EH N Z
WHENSOEVER	W EH N S OW AH V AH R
WHERE	W EH R
WHERE(2)	HH W EH R
WHEREABOUT	W IY R AH B AW T
WHEREABOUTS	W EH R AH B AW T S
WHEREABOUTS(2)	HH W EH R AH B AW T S
WHEREAS	W EH R AE Z
WHEREAS(2)	HH W EH R AE Z
WHEREASES	W EH R AE Z IH Z
WHEREAT	W IY R IY T
WHEREBY	W EH R B AY
WHEREBY(2)	HH W EH R B AY
WHEREFORE	W EH ER F OW R
WHEREFORES	W EH ER F OW R Z
WHEREFROM	W AH R EH F R AH M
WHEREIN	W EH R IH N
WHEREIN(2)	HH W EH R IH N
WHEREINTO	W IY R IY N T OW
WHEREOF	W EH ER AH V
WHEREON	W EH ER AO N
WHERES	W EH ER Z
WHERESOEVER	W EH R AH S OW AH V AH R
WHERETHROUGH	W AH R EH TH R UW
WHERETO	W EH R AH T OW
WHEREUNTO	W IY R UW N T OW
WHEREUPON	W EH R AH P AA N
WHEREUPON(2)	HH W EH R AH P AA N
WHEREVER	W EH R EH V ER
WHEREVER(2)	HH W EH R EH V ER
WHEREWITH	W EH ER W IH TH
WHEREWITHAL	W EH R W IH DH AO L
WHEREWITHAL(2)	HH W EH R W IH DH AO L
WHEREWITHALS	W AH R UW AH TH AH L Z
WHERRIED	W EH R AY D
WHERRIES	W EH R AY Z
WHERRY	W EH R IY
WHERRY(2)	HH W EH R IY
WHERRYING	W EH R AY AH NG
WHERVE	W AH R V
WHERVES	W AH R V Z
WHET	W EH T
WHET(2)	HH W EH T
WHETHER	W EH DH ER
WHETHER(2)	HH W EH DH ER
WHETS	W EH T S
WHETSTONE	W EH T S T OW N
WHETSTONE(2)	HH W EH T S T OW N
WHETSTONES	W EH T S T OW N Z
WHETTED	W EH T IH D
WHETTED(2)	HH W EH T IH D
WHETTER	W EH T ER
WHETTERS	W EH T ER Z
WHETTING	W EH T IH NG
WHEW	W UW
WHEW(2)	HH W UW
WHEW(3)	HH Y UW
WHEWS	W UW Z
WHEY	W EY
WHEY(2)	HH W EY
WHEYEY	W EY IY
WHEYFACE	W EY F AH S
WHEYFACES	W EY F AH S AH Z
WHEYISH	W EY AH SH
WHEYLIKE	W EY L AY K
WHEYS	W EY Z
WHICH	W IH CH
WHICH(2)	HH W IH CH
WHICHEVER	W IH CH EH V ER
WHICHEVER(2)	HH W IH CH EH V ER
WHICHSOEVER	W IH CH S OW AH V AH R
WHICKER	W IH K ER
WHICKER(2)	HH W IH K ER
WHICKERED	W IH K IY R D
WHICKERING	W IH K IY R AH NG
WHICKERS	W IH K AH R Z
WHID	W IH D
WHIDAH	W IH D AH
WHIDAHS	W IH D AH Z
WHIDDED	W IH D AH D
WHIDDING	W IH D AH NG
WHIDS	W IH D Z
WHIFF	W IH F
WHIFF(2)	HH W IH F
WHIFFED	W IH F T
WHIFFER	W IH F ER
WHIFFERS	W IH F ER Z
WHIFFET	W IH F AH T
WHIFFETS	W IH F AH T S
WHIFFING	W IH F IH NG
WHIFFLE	W IH F AH L
WHIFFLED	W IH F L EH D
WHIFFLER	W IH F L AH R
WHIFFLERS	W IH F L AH R Z
WHIFFLES	W IH F AH L Z
WHIFFLETREE	W IH F L AH T R IY IY
WHIFFLETREES	W IH F L EH T R IY Z
WHIFFLING	W IH F L IH NG
WHIFFS	W IH F S
WHIG	W IH G
WHIG(2)	HH W IH G
WHIGMALEERIE	W IH G M EY L AH R AY
WHIGMALEERIES	W IH G M EY L AH R AY Z
WHIGS	W IH G Z
WHIGS(2)	HH W IH G Z
WHILE	W AY L
WHILE(2)	HH W AY L
WHILED	W AY L D
WHILES	W AY L Z
WHILES(2)	HH W AY L Z
WHILING	W AY L IH NG
WHILOM	W IH L AH M
WHILST	W AY L S T
WHIM	W IH M
WHIM(2)	HH W IH M
WHIMBREL	W IH M B R AH L
WHIMBRELS	W IH M B R AH L Z
WHIMPER	W IH M P ER
WHIMPER(2)	HH W IH M P ER
WHIMPERED	W IH M P ER D
WHIMPERING	W IH M P ER IH NG
WHIMPERING(2)	HH W IH M P ER IH NG
WHIMPERS	W IH M P ER Z
WHIMS	W IH M Z
WHIMS(2)	HH W IH M Z
WHIMSEY	W IH M Z IY
WHIMSEYS	W IH M Z IY Z
WHIMSICAL	W IH M Z IH K AH L
WHIMSICAL(2)	HH W IH M Z IH K AH L
WHIMSICALITIES	W IH M Z IH K AH L AH T IY Z
WHIMSICALITY	W IH M Z IH K AH L AH T IY
WHIMSICALLY	W IH M Z IH K L IY
WHIMSICALLY(2)	HH W IH M Z IH K L IY
WHIMSICALNESS	W IH M Z IH K AH L N AH S
WHIMSICALNESSES	W IH M Z IH K AH L N AH S IH Z
WHIMSIED	W IH M Z IY D
WHIMSIES	W IH M Z IY Z
WHIMSY	W IH M S IY
WHIMSY(2)	HH W IH M S IY
WHIN	W IH N
WHINCHAT	W IH NG K AH T
WHINCHATS	W IH N CH EY T S
WHINE	W AY N
WHINE(2)	HH W AY N
WHINED	W AY N D
WHINER	W AY N ER
WHINER(2)	HH W AY N ER
WHINERS	W AY N ER Z
WHINERS(2)	HH W AY N ER Z
WHINES	W AY N Z
WHINES(2)	HH W AY N Z
WHINEY	W AY N IY
WHINGE	W IH N JH
WHINGED	W IH NG D
WHINGEING	W IH NG IY AH NG
WHINGES	W IH N JH AH Z
WHINGING	W IH NG AH NG
WHINIER	W AY N IY ER
WHINIEST	W AY N IY AH S T
WHINING	W AY N IH NG
WHINING(2)	HH W AY N IH NG
WHININGLY	W AY N IH NG L IY
WHINNIED	W IH N IY D
WHINNIER	W IH N IY ER
WHINNIES	W IH N IY Z
WHINNIEST	W IH N IY AH S T
WHINNY	W IH N IY
WHINNYING	W IH N IY IH NG
WHINS	W IH N Z
WHINSTONE	W IH N S T OW N
WHINSTONES	W IH N S T OW N Z
WHINY	W AY N IY
WHINY(2)	HH W AY N IY
WHIP	W IH P
WHIP(2)	HH W IH P
WHIPCORD	W IH P K AO R D
WHIPCORDS	W IH P K AO R D Z
WHIPLASH	W IH P L AE SH
WHIPLASH(2)	HH W IH P L AE SH
WHIPLASHES	W IH P L AE SH AH Z
WHIPLASHES(2)	HH W IH P L AE SH AH Z
WHIPLIKE	W IH P L AY K
WHIPPED	W IH P T
WHIPPED(2)	HH W IH P T
WHIPPER	W IH P ER
WHIPPERS	W IH P ER Z
WHIPPERSNAPPER	W IH P ER S N AE P ER
WHIPPERSNAPPERS	W IH P ER S N AE P ER Z
WHIPPET	W IH P AH T
WHIPPETS	W IH P AH T S
WHIPPIER	W IH P IY ER
WHIPPIEST	W IH P IY AH S T
WHIPPING	W IH P IH NG
WHIPPING(2)	HH W IH P IH NG
WHIPPINGS	W IH P IH NG Z
WHIPPLETREE	W IH P L AH T R IY IY
WHIPPLETREES	W IH P L EH T R IY Z
WHIPPOORWILL	W IH P UH R W IH L
WHIPPOORWILLS	W IH P ER W IH L Z
WHIPPOORWILLS(2)	HH W IH P ER W IH L Z
WHIPPY	W IH P IY
WHIPRAY	W IH P R EY
WHIPRAYS	W IH P R EY Z
WHIPS	W IH P S
WHIPS(2)	HH W IH P S
WHIPSAW	W IH P S AO
WHIPSAW(2)	HH W IH P S AO
WHIPSAWED	W IH P S AO D
WHIPSAWED(2)	HH W IH P S AO D
WHIPSAWING	W IH P S AO IH NG
WHIPSAWING(2)	HH W IH P S AO IH NG
WHIPSAWN	W IH P S AH N
WHIPSAWS	W IH P S AO Z
WHIPSTITCH	W IH P S T IH CH
WHIPSTITCHED	W IH P S T IH CH T
WHIPSTITCHES	W IH P S T IH CH IH Z
WHIPSTITCHING	W IH P S T IH CH IH NG
WHIPSTOCK	W IH P S T AA K
WHIPSTOCKS	W IH P S T AA K S
WHIPT	W IH P T
WHIPTAIL	W IH P T EY L
WHIPTAILS	W IH P T EY L Z
WHIPWORM	W IH P W ER M
WHIPWORMS	W IH P W ER M Z
WHIR	W ER
WHIRL	W ER L
WHIRL(2)	HH W ER L
WHIRLED	W ER L D
WHIRLED(2)	HH W ER L D
WHIRLER	W ER L ER
WHIRLERS	W ER L ER Z
WHIRLIER	W ER L IY ER
WHIRLIES	W ER L IY Z
WHIRLIEST	W ER L IY AH S T
WHIRLIGIG	W AH R L AH JH AH G
WHIRLIGIGS	W AH R L AH JH AH G Z
WHIRLING	W ER L IH NG
WHIRLING(2)	HH W ER L IH NG
WHIRLPOOL	W ER L P UW L
WHIRLPOOL(2)	HH W ER L P UW L
WHIRLPOOLS	W ER L P UW L Z
WHIRLPOOLS(2)	HH W ER L P UW L Z
WHIRLS	W ER L Z
WHIRLWIND	W ER L W IH N D
WHIRLWIND(2)	HH W ER L W IH N D
WHIRLWINDS	W ER L W IH N D Z
WHIRLY	W ER L IY
WHIRLYBIRD	W ER L IY B ER D
WHIRLYBIRDS	W ER L IY B ER D Z
WHIRR	W AH R
WHIRRED	W ER D
WHIRRIED	W ER R IY D
WHIRRIES	W ER R IY Z
WHIRRING	W ER IH NG
WHIRRING(2)	HH W ER IH NG
WHIRRS	W AH R Z
WHIRRY	W ER R IY
WHIRRYING	W ER R IY IH NG
WHIRS	W ER Z
WHISH	W IH SH
WHISHED	W IH SH T
WHISHES	W IH SH AH Z
WHISHING	W IH SH AH NG
WHISHT	W IH SH T
WHISHTED	W IH SH T AH D
WHISHTING	W IH SH T AH NG
WHISHTS	W IH SH T S
WHISK	W IH S K
WHISK(2)	HH W IH S K
WHISKED	W IH S K T
WHISKED(2)	HH W IH S K T
WHISKER	W IH S K ER
WHISKER(2)	HH W IH S K ER
WHISKERED	W IH S K ER D
WHISKERS	W IH S K ER Z
WHISKERS(2)	HH W IH S K ER Z
WHISKERY	W IH S K AH R IY
WHISKEY	W IH S K IY
WHISKEY(2)	HH W IH S K IY
WHISKEYS	W IH S K IY Z
WHISKEYS(2)	HH W IH S K IY Z
WHISKIES	W IH S K IY Z
WHISKING	W IH S K IH NG
WHISKS	W IH S K S
WHISKS(2)	HH W IH S K S
WHISKY	W IH S K IY
WHISKY(2)	HH W IH S K IY
WHISPER	W IH S P ER
WHISPER(2)	HH W IH S P ER
WHISPERED	W IH S P ER D
WHISPERED(2)	HH W IH S P ER D
WHISPERER	W IH S P AH R ER
WHISPERERS	W IH S P AH R ER Z
WHISPERING	W IH S P ER IH NG
WHISPERING(2)	HH W IH S P ER IH NG
WHISPERINGLY	W IH S P ER IH NG L IY
WHISPERINGS	W IH S P ER IH NG Z
WHISPERS	W IH S P ER Z
WHISPERS(2)	HH W IH S P ER Z
WHISPERY	W IH S P ER IY
WHIST	W IH S T
WHISTED	W AY Z T EH D
WHISTING	W IH S T AH NG
WHISTLE	W IH S AH L
WHISTLE(2)	HH W IH S AH L
WHISTLEABLE	W IH S AH L AH B AH L
WHISTLEBLOWER	W IH S AH L B L OW ER
WHISTLEBLOWER(2)	HH W IH S AH L B L OW ER
WHISTLEBLOWERS	W IH S AH L B L OW ER Z
WHISTLEBLOWERS(2)	HH W IH S AH L B L OW ER Z
WHISTLEBLOWING	W IH S AH L B L OW IH NG
WHISTLEBLOWINGS	W IH S AH L B L OW IH NG Z
WHISTLED	W IH S AH L D
WHISTLED(2)	HH W IH S AH L D
WHISTLER	W IH S L ER
WHISTLER(2)	HH W IH S L ER
WHISTLERS	W IH S L ER Z
WHISTLERS(2)	HH W IH S L ER Z
WHISTLES	W IH S AH L Z
WHISTLES(2)	HH W IH S AH L Z
WHISTLING	W IH S L IH NG
WHISTLING(2)	HH W IH S L IH NG
WHISTLINGS	W IH S AH L IH NG Z
WHISTS	W IH S T S
WHIT	W IH T
WHIT(2)	HH W IH T
WHITE	W AY T
WHITE(2)	HH W AY T
WHITEBAIT	W AY T B EY T
WHITEBAITS	W AY T B EY T S
WHITEBEARD	W AY T B IH ER D
WHITEBEARDS	W AY T B IH ER D Z
WHITEBOARD	W AY T B OW R D
WHITEBOARDS	W AY T B OW R D Z
WHITECAP	W AY T K AE P
WHITECAPS	W AY T K AE P S
WHITED	W AY T IH D
WHITED(2)	HH W AY T IH D
WHITEFACE	W AY T F EY S
WHITEFACES	W AY T F EY S IH Z
WHITEFISH	W AY T F IH SH
WHITEFISH(2)	HH W AY T F IH SH
WHITEFISHES	W AY T F IH SH IH Z
WHITEFLIES	W AY T F L AY Z
WHITEFLY	W AY T F L AY
WHITEHEAD	W AY T HH EH D
WHITEHEAD(2)	HH W AY T HH EH D
WHITEHEADS	W AY T HH EH D Z
WHITELY	W AY T L IY
WHITELY(2)	HH W AY T L IY
WHITEN	W AY T AH N
WHITEN(2)	HH W AY T AH N
WHITENED	W AY T AH N D
WHITENER	W AY T N ER
WHITENER(2)	HH W AY T N ER
WHITENERS	W AY T AH N ER Z
WHITENESS	W AY T N AH S
WHITENESS(2)	HH W AY T N AH S
WHITENESSES	W AY T N AH S IH Z
WHITENING	W AY T IH N IH NG
WHITENING(2)	W AY T N IH NG
WHITENING(3)	HH W AY T IH N IH NG
WHITENING(4)	HH W AY T N IH NG
WHITENINGS	W AY T AH N IH NG Z
WHITENS	W AY T AH N Z
WHITEOUT	W AY T AW T
WHITEOUTS	W AY T AW T S
WHITER	W AY T ER
WHITER(2)	HH W AY T ER
WHITES	W AY T S
WHITES(2)	HH W AY T S
WHITESMITH	W AY T S M IH TH
WHITESMITHS	W AY T S M IH TH S
WHITEST	W AY T IH S T
WHITEST(2)	HH W AY T IH S T
WHITETAIL	W AY T T EY L
WHITETAIL(2)	HH W AY T T EY L
WHITETAIL(3)	HH W AY T EY L
WHITETAILS	W AY T EY L Z
WHITETHROAT	W AY T TH R OW T
WHITETHROATS	W AY T TH R OW T S
WHITEWALL	W AY T W AO L
WHITEWALLS	W AY T W AO L Z
WHITEWASH	W AY T W AA SH
WHITEWASH(2)	HH W AY T W AA SH
WHITEWASHED	W AY T W AA SH T
WHITEWASHED(2)	HH W AY T W AA SH T
WHITEWASHER	W AY T W AA SH ER
WHITEWASHERS	W AY T W AA SH ER Z
WHITEWASHES	W AY T W AA SH IH Z
WHITEWASHING	W AY T W AA SH IH NG
WHITEWASHINGS	W AY T W AA SH IH NG Z
WHITEWING	W AY T W IH NG
WHITEWINGS	W AY T W IH NG Z
WHITEWOOD	W AY T W UH D
WHITEWOODS	W AY T W UH D Z
WHITEY	W AY T IY
WHITEY(2)	HH W AY T IY
WHITEYS	W AY T IY Z
WHITHER	W IH DH ER
WHITHER(2)	HH W IH DH ER
WHITHERSOEVER	W AH TH AH R S OW AH V AH R
WHITHERWARD	W AH TH AH R W AH R D
WHITIER	W AY T IY ER
WHITIES	W AY T IY Z
WHITIEST	W AY T IY AH S T
WHITING	W AY T IH NG
WHITING(2)	HH W AY T IH NG
WHITINGS	W AY T IH NG Z
WHITINGS(2)	HH W AY T IH NG Z
WHITISH	W AY T IH SH
WHITISH(2)	HH W AY T IH SH
WHITLOW	W IH T L OW
WHITLOW(2)	HH W IH T L OW
WHITLOWS	W IH T L OW Z
WHITRACK	W IH T R AE K
WHITRACKS	W IH T R AE K S
WHITS	W IH T S
WHITTER	W IH T ER
WHITTERS	W IH T ER Z
WHITTLE	W IH T AH L
WHITTLE(2)	HH W IH T AH L
WHITTLED	W IH T AH L D
WHITTLED(2)	HH W IH T AH L D
WHITTLER	W IH T L AH R
WHITTLERS	W IH T L AH R Z
WHITTLES	W IH T AH L Z
WHITTLING	W IH T L IH NG
WHITTLING(2)	HH W IH T L IH NG
WHITTLINGS	W IH T L AH NG Z
WHITTRET	W IH T R AH T
WHITTRETS	W IH T R AH T S
WHITY	W AY T IY
WHIZ	W IH Z
WHIZ(2)	HH W IH Z
WHIZBANG	W IH Z B AE NG
WHIZBANGS	W IH Z B AE NG Z
WHIZZ	W IH Z
WHIZZBANG	W IH Z AH NG
WHIZZBANGS	W IH Z AH NG Z
WHIZZED	W IH Z D
WHIZZED(2)	HH W IH Z D
WHIZZER	W IH Z ER
WHIZZER(2)	HH W IH Z ER
WHIZZERS	W IH Z ER Z
WHIZZES	W IH Z IH Z
WHIZZES(2)	HH W IH Z IH Z
WHIZZING	W IH Z IH NG
WHIZZING(2)	HH W IH Z IH NG
WHO	HH UW
WHOA	W OW
WHOA(2)	HH W OW
WHOA(3)	HH OW
WHODUNIT	HH UW D AH N IH T
WHODUNITS	HH UW D AH N IH T S
WHODUNNIT	W AH D AH N AH T
WHODUNNITS	W AH D AH N AH T S
WHOEVER	HH UW EH V ER
WHOLE	HH OW L
WHOLEHEARTED	HH OW L HH AA R T IH D
WHOLEHEARTEDLY	HH OW L HH AA R T IH D L IY
WHOLENESS	HH OW L N IH S
WHOLENESSES	HH OW L N AH S IH Z
WHOLES	HH OW L Z
WHOLESALE	HH OW L S EY L
WHOLESALED	HH OW L S EY L D
WHOLESALER	HH OW L S EY L ER
WHOLESALERS	HH OW L S EY L ER Z
WHOLESALES	HH OW L S EY L Z
WHOLESALING	HH OW L S EY L IH NG
WHOLESOME	HH OW L S AH M
WHOLESOMELY	HH OW L S AH M L IY
WHOLESOMENESS	HH OW L S AH M N AH S
WHOLESOMENESSES	HH OW L S AH M N AH S IH Z
WHOLISM	HH OW L IH Z AH M
WHOLISMS	HH OW L IH Z AH M Z
WHOLISTIC	HH OW L IH S T IH K
WHOLLY	HH OW L IY
WHOM	HH UW M
WHOMEVER	HH UW M EH V ER
WHOMP	W AA M P
WHOMPED	W AA M P T
WHOMPING	W AA M P AH NG
WHOMPS	W AA M P S
WHOMSO	W AA M Z OW
WHOMSOEVER	HH UW M S OW EH V ER
WHOOF	W UW F
WHOOFED	W UW F T
WHOOFING	W UW F AH NG
WHOOFS	W UW F S
WHOOP	W UW P
WHOOP(2)	HH W UW P
WHOOPED	W UW P T
WHOOPED(2)	HH W UW P T
WHOOPEE	W UW P IY
WHOOPEE(2)	HH W UW P IY
WHOOPEES	W UW P IY Z
WHOOPER	W UW P ER
WHOOPERS	W UW P ER Z
WHOOPIE	W UW P IY
WHOOPIE(2)	HH W UW P IY
WHOOPING	W UW P IH NG
WHOOPING(2)	HH W UW P IH NG
WHOOPLA	W UW P L AH
WHOOPLAS	W UW P L AH Z
WHOOPS	W UW P S
WHOOPS(2)	HH W UW P S
WHOOSH	W UW SH
WHOOSH(2)	HH W UW SH
WHOOSHED	W UW SH T
WHOOSHES	W UW SH IH Z
WHOOSHING	W UW SH IH NG
WHOOSIS	W OW OW S AH S
WHOOSISES	W UW S AY Z AH Z
WHOP	W AA P
WHOPPED	W AA P T
WHOPPER	W AA P ER
WHOPPER(2)	HH W AA P ER
WHOPPERS	W AA P ER Z
WHOPPERS(2)	HH W AA P ER Z
WHOPPING	W AA P IH NG
WHOPPING(2)	HH W AA P IH NG
WHOPS	W AA P S
WHORE	HH AO R
WHORED	HH OW R D
WHOREDOM	HH OW R D AH M
WHOREDOMS	HH OW R D AH M Z
WHOREHOUSE	HH AO R HH AW S
WHOREHOUSES	HH OW R HH AW S IH Z
WHOREMASTER	HH OW R M AE S T ER
WHOREMASTERS	HH OW R M AE S T ER Z
WHOREMONGER	HH OW R M AH NG G ER
WHOREMONGERS	HH OW R M AH NG G ER Z
WHORES	HH AO R Z
WHORESON	HH OW R S AH N
WHORESONS	HH OW R S AH N Z
WHORING	HH OW R IH NG
WHORISH	HH OW R IH SH
WHORL	W ER L
WHORL(2)	W AO R L
WHORL(3)	HH W AO R L
WHORLED	W ER L D
WHORLS	W ER L Z
WHORLS(2)	W AO R L Z
WHORLS(3)	HH W AO R L Z
WHORT	W AH R T
WHORTLE	W AH R T AH L
WHORTLEBERRIES	W AH R T L AH B EH R AY Z
WHORTLEBERRY	W AH R T L AH B EH R IY
WHORTLES	W AH R T AH L Z
WHORTS	W AH R T S
WHOSE	HH UW Z
WHOSESOEVER	W AA S AH S OW AH V AH R
WHOSEVER	HH UW Z EH V ER
WHOSIS	HH UW Z IY Z
WHOSISES	HH UW Z IY Z IH Z
WHOSO	W AA S OW
WHOSOEVER	HH UW S OW EH V ER
WHUMP	W AH M P
WHUMPED	W AH M P T
WHUMPING	W AH M P AH NG
WHUMPS	W AH M P S
WHY	W AY
WHY(2)	HH W AY
WHYDAH	W IH D AH
WHYDAHS	W IH D AH Z
WHYS	W AY Z
WHYS(2)	HH W AY Z
WIDOWHOOD	W IH D OW HH UH D
WIDOWHOODS	W IH D OW HH UH D Z
WORTHWHILE	W ER TH W AY L
WORTHWHILENESS	W ER TH W AY L N AH S
WORTHWHILENESSES	W ER TH W AY L N AH S IH Z
YELLOWHAMMER	Y EH L OW HH AE M ER
YELLOWHAMMERS	Y EH L OW HH AE M ER Z
OVOID	OW V OY D
EIGENMODE	EY JH AH N M OW D
IF	IH F
BAIL	B EY L
NOG	N AA G
DO	D UW
PE	P IY
